Player,Age,Pos,Date,Tm,Opp,GS,MP,FG,FGA,FG%,2P,2PA,2P%,3P,3PA,3P%,FT,FTA,FT%,ORB,DRB,TRB,AST,STL,BLK,TOV,PF,PTS,GmSc
Devin Booker,20-145,G,3/24/17,PHO,BOS,1,45,21,40,0.525,17,29,0.586,4,11,0.364,24,26,0.923,2,6,8,6,3,1,5,3,70,54.5
Klay Thompson,26-301,G,12/5/16,GSW,IND,1,29,21,33,0.636,13,19,0.684,8,14,0.571,10,11,0.909,0,2,2,1,0,0,0,0,60,46.2
Damian Lillard,26-267,G,4/8/17,POR,UTA,1,42,18,34,0.529,9,20,0.45,9,14,0.643,14,16,0.875,0,6,6,5,1,1,0,0,59,48.6
Russell Westbrook,28-115,G,3/7/17,OKC,POR,1,36,21,39,0.538,18,30,0.6,3,9,0.333,13,16,0.813,1,2,3,9,3,1,4,4,58,43.6
Russell Westbrook,28-137,G,3/29/17,OKC,ORL,1,42,21,40,0.525,15,25,0.6,6,15,0.4,9,11,0.818,3,10,13,11,3,0,7,3,57,44.2
DeMarcus Cousins,26-129,C-F,12/20/16,SAC,POR,1,41,17,28,0.607,12,20,0.6,5,8,0.625,16,17,0.941,1,12,13,1,1,3,5,5,55,42.9
James Harden,27-127,G,12/31/16,HOU,NYK,1,42,14,26,0.538,5,10,0.5,9,16,0.563,16,18,0.889,3,13,16,17,0,0,8,2,53,48.7
Jimmy Butler,27-110,G-F,1/2/17,CHI,CHO,1,38,15,24,0.625,14,20,0.7,1,4,0.25,21,22,0.955,3,9,12,6,3,1,2,0,52,51.5
Isaiah Thomas,27-327,G,12/30/16,BOS,MIA,1,37,15,26,0.577,6,13,0.462,9,13,0.692,13,13,1,1,1,2,0,1,0,2,2,52,39
John Wall,26-091,G,12/6/16,WAS,ORL,1,42,18,31,0.581,13,23,0.565,5,8,0.625,11,14,0.786,1,3,4,8,3,0,4,3,52,41.3
James Harden,27-154,G,1/27/17,HOU,PHI,1,39,16,28,0.571,10,17,0.588,6,11,0.545,13,14,0.929,1,12,13,13,2,1,5,4,51,46.9
Russell Westbrook,27-351,G,10/28/16,OKC,PHO,1,45,17,44,0.386,15,34,0.441,2,10,0.2,15,20,0.75,3,10,13,10,2,0,5,3,51,32.9
Russell Westbrook,28-148,G,4/9/17,OKC,DEN,1,37,17,32,0.531,12,20,0.6,5,12,0.417,11,11,1,2,14,16,10,1,0,2,1,50,45.6
Anthony Davis,23-229,F-C,10/26/16,NOP,DEN,1,41,17,34,0.5,17,32,0.531,0,2,0,16,17,0.941,1,14,15,5,5,4,3,4,50,44.2
Damian Lillard,26-247,G,3/19/17,POR,MIA,1,36,14,21,0.667,5,9,0.556,9,12,0.75,12,12,1,0,1,1,5,0,1,3,1,49,41
Russell Westbrook,28-054,G,1/5/17,OKC,HOU,1,38,16,34,0.471,8,19,0.421,8,15,0.533,9,11,0.818,1,7,8,5,2,0,5,2,49,33.3
Kyrie Irving,24-306,G,1/23/17,CLE,NOP,1,42,15,28,0.536,7,14,0.5,8,14,0.571,11,11,1,0,2,2,4,2,1,0,4,49,39.9
Russell Westbrook,28-111,G,3/3/17,OKC,PHO,1,38,14,30,0.467,11,18,0.611,3,12,0.25,17,18,0.944,1,16,17,9,3,0,4,4,48,41.4
Karl-Anthony Towns,21-015,C-F,11/30/16,MIN,NYK,1,42,15,22,0.682,15,19,0.789,0,3,0,17,20,0.85,3,15,18,2,1,3,4,2,47,42.7
Russell Westbrook,28-091,G,2/11/17,OKC,GSW,1,37,14,26,0.538,11,16,0.688,3,10,0.3,16,18,0.889,1,10,11,8,1,0,11,5,47,30.9
Andrew Wiggins,21-264,F-G,11/13/16,MIN,LAL,1,41,14,21,0.667,12,16,0.75,2,5,0.4,17,22,0.773,1,3,4,3,0,1,2,2,47,37.5
DeMarcus Cousins,26-170,C-F,1/30/17,SAC,PHI,1,32,11,16,0.688,7,10,0.7,4,6,0.667,20,22,0.909,4,11,15,5,1,1,8,6,46,39.3
Anthony Davis,24-000,F-C,3/11/17,NOP,CHO,1,45,18,31,0.581,14,26,0.538,4,5,0.8,6,8,0.75,4,17,21,3,0,1,0,1,46,41
Stephen Curry,28-238,G,11/7/16,GSW,NOP,1,36,16,26,0.615,3,9,0.333,13,17,0.765,1,2,0.5,3,2,5,5,2,0,4,2,46,37.2
Kyrie Irving,24-361,G,3/19/17,CLE,LAL,1,38,15,21,0.714,9,11,0.818,6,10,0.6,10,10,1,0,2,2,3,0,0,3,2,46,36.2
Russell Westbrook,28-037,G,12/19/16,OKC,ATL,1,35,16,33,0.485,13,23,0.565,3,10,0.3,11,13,0.846,2,9,11,7,1,0,4,2,46,33.7
Russell Westbrook,28-110,G,3/2/17,OKC,POR,1,37,12,36,0.333,6,20,0.3,6,16,0.375,15,15,1,2,5,7,4,1,1,4,0,45,28
Carmelo Anthony,32-245,F,1/29/17,NYK,ATL,1,46,18,36,0.5,15,27,0.556,3,9,0.333,6,7,0.857,0,6,6,4,0,1,3,6,45,26.5
Anthony Davis,23-231,F-C,10/28/16,NOP,GSW,1,40,17,31,0.548,16,29,0.552,1,2,0.5,10,14,0.714,6,11,17,3,2,2,1,2,45,39.7
Russell Westbrook,28-144,G,4/5/17,OKC,MEM,1,38,14,25,0.56,6,12,0.5,8,13,0.615,9,12,0.75,0,9,9,10,4,0,7,4,45,37
Russell Westbrook,28-075,G,1/26/17,OKC,DAL,1,35,16,29,0.552,12,21,0.571,4,8,0.5,9,11,0.818,1,7,8,3,2,0,4,2,45,32.4
Anthony Davis,23-257,F-C,11/23/16,NOP,MIN,1,39,17,27,0.63,15,23,0.652,2,4,0.5,9,10,0.9,1,9,10,3,2,1,4,1,45,36.3
Kyrie Irving,25-017,G,4/9/17,CLE,ATL,1,45,16,30,0.533,8,18,0.444,8,12,0.667,5,6,0.833,0,2,2,9,1,0,3,3,45,33.7
Russell Westbrook,28-041,G,12/23/16,OKC,BOS,1,35,13,25,0.52,8,18,0.444,5,7,0.714,14,16,0.875,1,10,11,11,1,0,4,1,45,39.9
LeBron James,31-346,F-G,12/10/16,CLE,CHO,1,42,17,24,0.708,12,14,0.857,5,10,0.5,5,9,0.556,1,8,9,10,3,1,5,3,44,40
Isaiah Thomas,27-360,G,2/1/17,BOS,TOR,1,38,12,22,0.545,7,10,0.7,5,12,0.417,15,16,0.938,0,4,4,7,0,0,3,3,44,34.9
Isaiah Thomas,27-317,G,12/20/16,BOS,MEM,1,38,10,16,0.625,3,6,0.5,7,10,0.7,17,17,1,0,3,3,6,2,1,1,1,44,43.2
Kyrie Irving,24-345,G,3/3/17,CLE,ATL,1,36,14,21,0.667,9,13,0.692,5,8,0.625,10,10,1,0,2,2,9,4,1,3,0,43,42.5
Stephen Curry,28-320,G,1/28/17,GSW,LAC,1,29,15,23,0.652,6,8,0.75,9,15,0.6,4,4,1,0,9,9,6,0,0,2,1,43,37.4
Russell Westbrook,28-108,G,2/28/17,OKC,UTA,1,39,13,28,0.464,7,19,0.368,6,9,0.667,11,12,0.917,0,11,11,10,0,0,8,1,43,30.1
DeMar DeRozan,27-201,G,2/24/17,TOR,BOS,1,37,15,28,0.536,14,25,0.56,1,3,0.333,12,12,1,0,5,5,5,0,0,3,2,43,30.6
Blake Griffin,27-347,F,2/26/17,LAC,CHO,1,42,15,26,0.577,12,22,0.545,3,4,0.75,10,16,0.625,4,6,10,5,2,0,1,4,43,35.9
Paul George,26-335,F,4/2/17,IND,CLE,1,48,16,33,0.485,10,17,0.588,6,16,0.375,5,7,0.714,0,9,9,9,3,1,3,5,43,33.2
C.J. McCollum,25-104,G,1/1/17,POR,MIN,1,39,16,25,0.64,13,19,0.684,3,6,0.5,8,9,0.889,1,4,5,3,3,1,3,3,43,35
Stephen Curry,29-022,G,4/5/17,GSW,PHO,1,35,15,25,0.6,7,13,0.538,8,12,0.667,4,7,0.571,0,4,4,11,2,2,3,0,42,38.6
James Harden,27-161,G,2/3/17,HOU,CHI,1,44,13,33,0.394,8,20,0.4,5,13,0.385,11,14,0.786,1,11,12,9,1,1,2,4,42,31.3
Anthony Davis,23-336,F-C,2/10/17,NOP,MIN,1,36,16,22,0.727,14,19,0.737,2,3,0.667,8,11,0.727,2,11,13,2,1,1,2,3,42,36.4
Marc Gasol,31-362,C,1/25/17,MEM,TOR,1,38,14,25,0.56,9,15,0.6,5,10,0.5,9,10,0.9,0,7,7,2,1,2,2,1,42,33.2
Stephen Curry,29-019,G,4/2/17,GSW,WAS,1,36,15,22,0.682,6,8,0.75,9,14,0.643,3,3,1,0,1,1,8,1,0,1,3,42,37.3
Bradley Beal,23-146,G,11/21/16,WAS,PHO,1,40,14,22,0.636,9,12,0.75,5,10,0.5,9,11,0.818,1,3,4,1,0,0,1,2,42,31.9
Russell Westbrook,28-039,G,12/21/16,OKC,NOP,1,34,12,26,0.462,10,19,0.526,2,7,0.286,16,18,0.889,1,9,10,7,1,0,4,2,42,32.3
DeMar DeRozan,27-226,G,3/21/17,TOR,CHI,1,43,17,38,0.447,16,33,0.485,1,5,0.2,7,11,0.636,4,3,7,8,2,1,2,1,42,30.2
DeMarcus Cousins,26-161,C-F,1/21/17,SAC,CHI,1,35,16,28,0.571,14,21,0.667,2,7,0.286,8,9,0.889,2,12,14,3,1,2,2,4,42,34.3
Jimmy Butler,27-115,G-F,1/7/17,CHI,TOR,1,44,10,25,0.4,6,17,0.353,4,8,0.5,18,20,0.9,4,6,10,5,2,0,4,1,42,33.4
Damian Lillard,26-112,G,11/4/16,POR,DAL,1,37,12,18,0.667,7,12,0.583,5,6,0.833,13,14,0.929,0,4,4,4,0,0,1,4,42,35.2
Russell Westbrook,28-085,G,2/5/17,OKC,POR,1,35,16,34,0.471,15,28,0.536,1,6,0.167,9,11,0.818,1,3,4,8,0,0,4,3,42,25.8
Karl-Anthony Towns,21-032,C-F,12/17/16,MIN,HOU,1,43,15,28,0.536,14,24,0.583,1,4,0.25,10,12,0.833,2,14,16,5,0,1,6,4,41,28.8
Andrew Wiggins,21-318,F-G,1/6/17,MIN,WAS,1,39,16,30,0.533,15,27,0.556,1,3,0.333,8,10,0.8,1,0,1,2,2,0,2,2,41,26.9
Russell Westbrook,28-001,G,11/13/16,OKC,ORL,1,38,14,21,0.667,14,18,0.778,0,3,0,13,18,0.722,2,10,12,16,0,0,2,2,41,42.7
Bradley Beal,23-173,G,12/18/16,WAS,LAC,1,38,13,23,0.565,7,13,0.538,6,10,0.6,9,11,0.818,0,3,3,3,1,0,1,2,41,31.5
Andrew Wiggins,21-357,F-G,2/14/17,MIN,CLE,1,41,16,29,0.552,12,21,0.571,4,8,0.5,5,6,0.833,1,2,3,2,1,0,0,1,41,30
John Wall,26-204,G,3/29/17,WAS,LAC,1,39,16,23,0.696,15,20,0.75,1,3,0.333,8,11,0.727,2,5,7,8,3,0,6,5,41,33.6
Isaiah Thomas,27-358,G,1/30/17,BOS,DET,1,37,11,23,0.478,7,12,0.583,4,11,0.364,15,15,1,0,0,0,8,2,0,3,4,41,32.3
Bradley Beal,23-223,G,2/6/17,WAS,CLE,1,45,16,28,0.571,10,14,0.714,6,14,0.429,3,3,1,0,5,5,8,0,0,0,1,41,34.5
Russell Westbrook,28-106,G,2/26/17,OKC,NOP,1,37,14,29,0.483,12,21,0.571,2,8,0.25,11,12,0.917,2,9,11,11,1,0,9,2,41,28.9
Eric Bledsoe,27-054,G,2/1/17,PHO,LAC,1,40,13,22,0.591,11,18,0.611,2,4,0.5,13,15,0.867,0,4,4,8,0,0,6,3,41,29.6
James Harden,27-203,G,3/17/17,HOU,NOP,1,40,12,21,0.571,8,11,0.727,4,10,0.4,13,14,0.929,2,12,14,11,2,0,5,2,41,39.6
Isaiah Thomas,27-349,G,1/21/17,BOS,POR,1,44,14,28,0.5,10,17,0.588,4,11,0.364,9,11,0.818,1,2,3,6,0,0,6,1,41,25.3
Anthony Davis,23-263,F-C,11/29/16,NOP,LAL,1,41,14,27,0.519,13,23,0.565,1,4,0.25,12,14,0.857,6,10,16,3,4,2,1,4,41,39
LeBron James,32-093,F-G,4/2/17,CLE,IND,1,52,16,29,0.552,13,19,0.684,3,10,0.3,6,12,0.5,4,10,14,11,2,1,1,4,41,38.3
DeMarcus Cousins,26-220,C-F,3/21/17,NOP,MEM,1,37,14,27,0.519,9,18,0.5,5,9,0.556,8,9,0.889,4,12,16,2,2,2,2,5,41,34.5
Kawhi Leonard,25-206,F,1/21/17,SAS,CLE,1,46,15,30,0.5,12,22,0.545,3,8,0.375,8,8,1,0,6,6,5,1,1,6,3,41,25.8
Giannis Antetokounmpo,22-066,F-G,2/10/17,MIL,LAL,1,42,11,20,0.55,10,14,0.714,1,6,0.167,18,21,0.857,1,7,8,6,2,3,5,3,41,35.1
Anthony Davis,24-024,F-C,4/4/17,NOP,DEN,1,41,18,31,0.581,16,26,0.615,2,5,0.4,3,3,1,2,3,5,0,1,4,0,3,41,31.4
Klay Thompson,27-055,G,4/4/17,GSW,MIN,1,33,13,24,0.542,6,10,0.6,7,14,0.5,8,9,0.889,0,2,2,3,2,1,1,2,41,32.6
Kyle Lowry,30-282,G,1/1/17,TOR,LAL,1,39,12,16,0.75,6,9,0.667,6,7,0.857,11,11,1,1,8,9,7,0,0,4,3,41,37.4
Andrew Wiggins,22-045,F-G,4/9/17,MIN,LAL,1,38,13,26,0.5,11,21,0.524,2,5,0.4,13,14,0.929,1,1,2,1,0,0,2,2,41,26.5
DeMar DeRozan,27-156,G,1/10/17,TOR,BOS,1,38,16,29,0.552,15,27,0.556,1,2,0.5,8,9,0.889,2,11,13,0,2,0,1,1,41,32
Eric Bledsoe,27-050,G,1/28/17,PHO,DEN,1,45,12,27,0.444,9,19,0.474,3,8,0.375,14,15,0.933,2,4,6,7,2,0,3,3,41,31.8
James Harden,27-160,G,2/2/17,HOU,ATL,1,39,10,23,0.435,5,11,0.455,5,12,0.417,16,21,0.762,2,6,8,8,4,0,4,3,41,34.5
James Harden,27-067,G,11/1/16,HOU,CLE,1,38,13,20,0.65,8,11,0.727,5,9,0.556,10,14,0.714,1,6,7,15,1,0,1,3,41,42.4
James Harden,27-137,G,1/10/17,HOU,CHO,1,38,11,24,0.458,4,10,0.4,7,14,0.5,11,14,0.786,1,14,15,10,0,0,4,3,40,33.1
Damian Lillard,26-153,G,12/15/16,POR,DEN,1,38,13,22,0.591,9,14,0.643,4,8,0.5,10,11,0.909,0,3,3,10,0,0,5,2,40,31.5
DeMar DeRozan,27-080,G,10/26/16,TOR,DET,1,34,17,27,0.63,17,25,0.68,0,2,0,6,6,1,1,3,4,1,1,0,6,1,40,24.8
Bradley Beal,23-241,G,2/24/17,WAS,PHI,1,42,15,25,0.6,13,17,0.765,2,8,0.25,8,10,0.8,0,4,4,2,1,0,1,3,40,29.1
Andrew Wiggins,21-358,F-G,2/15/17,MIN,DEN,1,38,15,26,0.577,13,22,0.591,2,4,0.5,8,11,0.727,1,3,4,2,2,0,1,2,40,29.8
Lou Williams,30-037,G,12/3/16,LAL,MEM,0,32,11,20,0.55,7,12,0.583,4,8,0.5,14,14,1,0,2,2,1,2,0,2,0,40,31.7
DeMar DeRozan,27-228,G,3/23/17,TOR,MIA,1,36,14,25,0.56,14,23,0.609,0,2,0,12,13,0.923,1,5,6,3,1,0,1,0,40,32
Jimmy Butler,27-105,G-F,12/28/16,CHI,BRK,1,38,14,29,0.483,13,27,0.481,1,2,0.5,11,11,1,6,4,10,4,4,0,3,2,40,33.7
Kemba Walker,26-187,G,11/11/16,CHO,TOR,1,35,12,19,0.632,5,7,0.714,7,12,0.583,9,11,0.818,1,9,10,7,0,0,1,2,40,37.2
DeMar DeRozan,27-236,G,3/31/17,TOR,IND,1,38,11,26,0.423,8,22,0.364,3,4,0.75,15,20,0.75,2,7,9,4,1,0,3,1,40,28.1
Jimmy Butler,27-133,G-F,1/25/17,CHI,ATL,1,40,13,22,0.591,9,14,0.643,4,8,0.5,10,10,1,2,2,4,3,3,0,1,0,40,35.9
Anthony Davis,23-304,F-C,1/9/17,NOP,NYK,1,29,14,22,0.636,13,21,0.619,1,1,1,11,12,0.917,4,14,18,2,0,3,0,2,40,39.5
Kevin Love,28-077,F,11/23/16,CLE,POR,1,32,12,20,0.6,4,8,0.5,8,12,0.667,8,8,1,4,4,8,3,1,1,1,2,40,36.8
Kevin Durant,28-111,F-G,1/18/17,GSW,OKC,1,34,13,16,0.813,8,9,0.889,5,7,0.714,9,10,0.9,2,10,12,4,0,3,2,2,40,40.1
James Harden,27-169,G,2/11/17,HOU,PHO,1,29,9,17,0.529,1,2,0.5,8,15,0.533,14,16,0.875,1,5,6,8,0,0,8,2,40,29.9
Nikola Jokic,21-357,C-F,2/10/17,DEN,NYK,1,37,17,23,0.739,15,20,0.75,2,3,0.667,4,5,0.8,4,5,9,5,2,0,2,2,40,37.3
Jimmy Butler,27-067,G-F,11/20/16,CHI,LAL,1,40,14,23,0.609,14,22,0.636,0,1,0,12,14,0.857,4,3,7,6,1,0,1,1,40,36.2
James Harden,27-135,G,1/8/17,HOU,TOR,1,38,13,26,0.5,9,17,0.529,4,9,0.444,10,10,1,3,7,10,11,2,2,10,3,40,31.1
Stephen Curry,28-298,G,1/6/17,GSW,MEM,1,42,15,27,0.556,10,14,0.714,5,13,0.385,5,5,1,0,3,3,6,1,1,4,2,40,29.1
James Harden,27-144,G,1/17/17,HOU,MIA,1,39,12,30,0.4,8,15,0.533,4,15,0.267,12,13,0.923,1,11,12,10,2,0,6,3,40,29.2
Russell Westbrook,28-141,G,4/2/17,OKC,CHO,1,36,14,31,0.452,7,16,0.438,7,15,0.467,5,5,1,1,12,13,10,2,0,8,1,40,28.8
D'Angelo Russell,21-024,G,3/19/17,LAL,CLE,1,41,14,22,0.636,7,10,0.7,7,12,0.583,5,7,0.714,0,2,2,6,2,0,1,2,40,34.4
James Harden,27-204,G,3/18/17,HOU,DEN,1,37,11,23,0.478,8,15,0.533,3,8,0.375,15,17,0.882,0,10,10,10,2,0,8,3,40,30.3
Damian Lillard,26-131,G,11/23/16,POR,CLE,1,38,13,21,0.619,8,14,0.571,5,7,0.714,9,9,1,0,7,7,11,0,0,2,4,40,36.7
Zach LaVine,21-288,G,12/23/16,MIN,SAC,1,39,13,21,0.619,6,9,0.667,7,12,0.583,7,7,1,0,6,6,2,1,0,2,5,40,30.7
Karl-Anthony Towns,21-145,C-F,4/9/17,MIN,LAL,1,41,17,22,0.773,16,20,0.8,1,2,0.5,5,8,0.625,3,18,21,4,1,1,3,3,40,38
DeMar DeRozan,27-087,G,11/2/16,TOR,WAS,1,37,14,23,0.609,13,21,0.619,1,2,0.5,11,16,0.688,1,4,5,5,2,0,1,3,40,32.7
DeMarcus Cousins,26-185,C-F,2/14/17,SAC,LAL,1,36,13,24,0.542,11,17,0.647,2,7,0.286,12,19,0.632,2,10,12,8,2,1,6,2,40,31.5
Eric Bledsoe,27-044,G,1/22/17,PHO,TOR,1,42,11,17,0.647,7,10,0.7,4,7,0.571,14,14,1,0,6,6,13,0,0,4,3,40,38.2
Kevin Durant,28-035,F-G,11/3/16,GSW,OKC,1,31,15,24,0.625,8,13,0.615,7,11,0.636,2,3,0.667,1,6,7,1,0,1,2,3,39,28.5
Stephen Curry,28-324,G,2/1/17,GSW,CHO,1,30,14,20,0.7,3,5,0.6,11,15,0.733,0,0,,1,4,5,8,3,0,1,2,39,39.3
Jimmy Butler,27-200,G-F,4/2/17,CHI,NOP,1,39,14,26,0.538,11,23,0.478,3,3,1,8,10,0.8,3,3,6,5,1,1,1,0,39,32.8
Russell Westbrook,28-134,G,3/26/17,OKC,HOU,1,39,13,24,0.542,10,15,0.667,3,9,0.333,10,16,0.625,0,11,11,13,0,0,5,4,39,30.8
Damian Lillard,26-102,G,10/25/16,POR,UTA,1,35,13,20,0.65,9,14,0.643,4,6,0.667,9,9,1,1,8,9,6,0,0,4,3,39,32.3
Giannis Antetokounmpo,22-017,F-G,12/23/16,MIL,WAS,1,33,12,19,0.632,12,18,0.667,0,1,0,15,17,0.882,1,7,8,6,2,1,1,1,39,38
Kevin Love,28-152,F,2/6/17,CLE,WAS,1,42,11,17,0.647,5,7,0.714,6,10,0.6,11,11,1,4,8,12,3,3,0,4,3,39,36.6
Isaiah Thomas,27-346,G,1/18/17,BOS,NYK,1,37,12,25,0.48,7,13,0.538,5,12,0.417,10,10,1,2,1,3,2,1,0,2,0,39,28.4
Devin Booker,20-074,G,1/12/17,PHO,DAL,1,37,14,20,0.7,8,13,0.615,6,7,0.857,5,7,0.714,0,1,1,3,1,0,7,4,39,24.6
Gordon Hayward,27-015,F-G,4/7/17,UTA,MIN,1,39,14,22,0.636,10,17,0.588,4,5,0.8,7,8,0.875,0,3,3,5,2,0,2,3,39,32
Devin Booker,20-076,G,1/14/17,PHO,SAS,1,37,12,22,0.545,9,17,0.529,3,5,0.6,12,12,1,2,0,2,2,0,0,3,4,39,26.6
James Harden,27-192,G,3/6/17,HOU,SAS,1,36,13,20,0.65,7,11,0.636,6,9,0.667,7,8,0.875,1,2,3,12,0,0,7,2,39,31.7
C.J. McCollum,25-190,G,3/28/17,POR,DEN,1,40,15,24,0.625,12,19,0.632,3,5,0.6,6,6,1,0,5,5,3,1,0,1,2,39,31
James Harden,27-206,G,3/20/17,HOU,DEN,1,40,13,29,0.448,9,18,0.5,4,11,0.364,9,11,0.818,1,6,7,11,4,0,6,4,39,29.7
Kyrie Irving,24-249,G,11/27/16,CLE,PHI,1,41,14,27,0.519,9,16,0.563,5,11,0.455,6,6,1,1,3,4,2,0,0,1,0,39,27.7
Jimmy Butler,27-056,G-F,11/9/16,CHI,ATL,1,39,13,24,0.542,9,15,0.6,4,9,0.444,9,12,0.75,1,3,4,7,6,0,4,1,39,34.3
Devin Booker,20-007,G,11/6/16,PHO,LAL,1,45,13,29,0.448,10,22,0.455,3,7,0.429,10,10,1,1,2,3,7,0,0,2,3,39,26.9
Damian Lillard,26-240,G,3/12/17,POR,PHO,1,38,13,26,0.5,9,16,0.563,4,10,0.4,9,9,1,1,5,6,2,1,0,4,3,39,25.4
Paul George,26-317,F,3/15/17,IND,CHO,1,33,15,21,0.714,9,11,0.818,6,10,0.6,3,3,1,1,4,5,3,3,0,3,3,39,33.1
Kawhi Leonard,25-250,F,3/6/17,SAS,HOU,1,39,12,18,0.667,8,13,0.615,4,5,0.8,11,11,1,0,6,6,5,1,2,1,1,39,37.5
Kevin Durant,28-063,F-G,12/1/16,GSW,HOU,1,49,12,28,0.429,9,17,0.529,3,11,0.273,12,12,1,1,13,14,2,3,3,2,3,39,32.1
Anthony Davis,23-351,F-C,2/25/17,NOP,DAL,1,39,17,34,0.5,16,30,0.533,1,4,0.25,4,9,0.444,3,11,14,0,1,2,2,2,39,25
John Wall,26-186,G,3/11/17,WAS,POR,1,40,13,23,0.565,10,18,0.556,3,5,0.6,10,12,0.833,0,2,2,9,0,1,5,0,39,29.9
Karl-Anthony Towns,21-118,C-F,3/13/17,MIN,WAS,1,35,17,26,0.654,15,22,0.682,2,4,0.5,3,3,1,3,10,13,2,1,0,0,2,39,34.3
Anthony Davis,23-253,F-C,11/19/16,NOP,CHO,1,42,15,27,0.556,13,22,0.591,2,5,0.4,6,8,0.75,2,14,16,2,1,3,2,3,38,31.2
Isaiah Thomas,27-353,G,1/25/17,BOS,HOU,1,38,15,27,0.556,11,17,0.647,4,10,0.4,4,4,1,3,2,5,9,1,0,3,1,38,31.7
Lou Williams,30-039,G,12/5/16,LAL,UTA,0,34,13,27,0.481,9,18,0.5,4,9,0.444,8,9,0.889,0,6,6,7,1,0,3,1,38,28.2
Isaiah Thomas,27-335,G,1/7/17,BOS,NOP,1,38,13,24,0.542,7,13,0.538,6,11,0.545,6,6,1,1,2,3,0,2,1,1,2,38,28.6
Kentavious Caldwell-Pope,23-349,G,2/1/17,DET,NOP,1,39,12,18,0.667,4,7,0.571,8,11,0.727,6,8,0.75,0,4,4,1,4,0,2,2,38,32.5
DeMar DeRozan,27-243,G,4/7/17,TOR,MIA,1,38,14,32,0.438,14,31,0.452,0,1,0,10,11,0.909,1,5,6,2,1,1,6,1,38,19.7
Marc Gasol,31-327,C,12/21/16,MEM,DET,1,37,14,17,0.824,12,14,0.857,2,3,0.667,8,11,0.727,0,5,5,4,2,2,3,3,38,34
Russell Westbrook,28-095,G,2/15/17,OKC,NYK,1,38,13,22,0.591,10,17,0.588,3,5,0.6,9,13,0.692,3,11,14,12,3,1,6,0,38,37.7
James Harden,27-173,G,2/15/17,HOU,MIA,1,42,10,21,0.476,6,11,0.545,4,10,0.4,14,16,0.875,3,9,12,12,0,1,4,5,38,34.4
Sean Kilpatrick,26-328,G,11/29/16,BRK,LAC,1,47,14,34,0.412,10,22,0.455,4,12,0.333,6,8,0.75,0,14,14,2,0,0,5,4,38,18
Damian Lillard,26-116,G,11/8/16,POR,PHO,1,37,12,23,0.522,9,15,0.6,3,8,0.375,11,12,0.917,2,3,5,3,0,0,4,4,38,25.1
Russell Westbrook,28-072,G,1/23/17,OKC,UTA,1,36,11,29,0.379,8,22,0.364,3,7,0.429,13,17,0.765,1,10,11,10,4,1,6,3,38,28.7
Anthony Davis,23-352,F-C,2/26/17,NOP,OKC,1,32,15,28,0.536,13,25,0.52,2,3,0.667,6,6,1,3,4,7,4,1,0,1,4,38,28.9
Anthony Davis,23-252,F-C,11/18/16,NOP,POR,1,37,14,22,0.636,12,17,0.706,2,5,0.4,8,10,0.8,0,9,9,6,2,4,2,2,38,36.3
Isaiah Thomas,27-362,G,2/3/17,BOS,LAL,1,38,13,24,0.542,8,13,0.615,5,11,0.455,7,7,1,0,2,2,4,1,0,6,2,38,24
James Harden,27-093,G,11/27/16,HOU,POR,1,34,11,22,0.5,6,10,0.6,5,12,0.417,11,13,0.846,1,1,2,10,2,1,5,3,38,30.7
James Harden,27-198,G,3/12/17,HOU,CLE,1,40,13,28,0.464,9,14,0.643,4,14,0.286,8,12,0.667,3,7,10,11,1,1,4,2,38,30.8
James Harden,27-145,G,1/18/17,HOU,MIL,1,37,14,25,0.56,10,14,0.714,4,11,0.364,6,6,1,0,6,6,8,0,2,2,2,38,32.1
James Harden,27-210,G,3/24/17,HOU,NOP,1,38,12,24,0.5,7,12,0.583,5,12,0.417,9,11,0.818,1,6,7,17,2,1,3,2,38,38.5
Mike Conley,29-111,G,1/30/17,MEM,PHO,1,33,12,18,0.667,5,8,0.625,7,10,0.7,7,8,0.875,0,6,6,9,2,0,2,2,38,37.1
Gordon Hayward,26-362,F-G,3/20/17,UTA,IND,1,37,16,24,0.667,13,18,0.722,3,6,0.5,3,4,0.75,0,3,3,2,2,1,3,2,38,28.4
Bradley Beal,23-255,G,3/10/17,WAS,SAC,1,43,13,24,0.542,8,15,0.533,5,9,0.556,7,7,1,2,8,10,3,1,1,2,1,38,31.6
LeBron James,32-063,F-G,3/3/17,CLE,ATL,1,39,14,27,0.519,8,17,0.471,6,10,0.6,4,8,0.5,1,12,13,8,0,0,2,4,38,29.4
Isaiah Thomas,27-339,G,1/11/17,BOS,WAS,1,38,14,29,0.483,9,18,0.5,5,11,0.455,5,6,0.833,3,2,5,5,0,0,4,1,38,24.7
Kawhi Leonard,25-199,F,1/14/17,SAS,PHO,1,32,12,20,0.6,10,15,0.667,2,5,0.4,12,14,0.857,1,3,4,3,1,0,3,2,38,28.9
Devin Booker,20-005,G,11/4/16,PHO,NOP,1,41,13,22,0.591,10,15,0.667,3,7,0.429,9,9,1,0,4,4,3,0,0,6,6,38,22.7
DeMarcus Cousins,26-097,C-F,11/18/16,SAC,LAC,1,37,12,29,0.414,10,22,0.455,2,7,0.286,12,14,0.857,4,9,13,7,3,1,4,4,38,30.2
Russell Westbrook,28-083,G,2/3/17,OKC,MEM,1,38,8,20,0.4,3,13,0.231,5,7,0.714,17,17,1,2,11,13,12,3,0,5,2,38,37.5
Kemba Walker,26-237,G,12/31/16,CHO,CLE,1,35,13,22,0.591,10,14,0.714,3,8,0.375,8,8,1,0,5,5,5,0,0,4,2,37,27
Damian Lillard,26-106,G,10/29/16,POR,DEN,1,41,15,28,0.536,13,20,0.65,2,8,0.25,5,5,1,1,4,5,7,2,1,5,2,37,27.1
Jimmy Butler,27-188,G-F,3/21/17,CHI,TOR,1,44,11,21,0.524,8,14,0.571,3,7,0.429,12,14,0.857,2,8,10,6,1,2,0,1,37,35.9
DeMarcus Cousins,26-230,C-F,3/31/17,NOP,SAC,1,35,12,21,0.571,7,13,0.538,5,8,0.625,8,11,0.727,2,11,13,4,3,1,5,5,37,30.1
Karl-Anthony Towns,21-102,C-F,2/25/17,MIN,HOU,1,37,16,24,0.667,15,22,0.682,1,2,0.5,4,4,1,9,13,22,3,1,1,4,2,37,35.8
Isaiah Thomas,27-300,G,12/3/16,BOS,PHI,1,33,11,19,0.579,9,16,0.563,2,3,0.667,13,15,0.867,1,3,4,7,1,0,2,2,37,32
Zach LaVine,21-244,G,11/9/16,MIN,ORL,1,36,14,22,0.636,7,13,0.538,7,9,0.778,2,3,0.667,0,4,4,3,1,0,0,1,37,30.7
DeMarcus Cousins,26-106,C-F,11/27/16,SAC,BRK,1,36,13,24,0.542,9,19,0.474,4,5,0.8,7,9,0.778,2,9,11,2,4,1,1,2,37,33
Devin Booker,20-159,G,4/7/17,PHO,OKC,1,38,13,29,0.448,8,20,0.4,5,9,0.556,6,8,0.75,0,5,5,4,1,0,1,3,37,24.2
C.J. McCollum,25-048,G,11/6/16,POR,MEM,1,39,13,23,0.565,7,11,0.636,6,12,0.5,5,6,0.833,0,4,4,2,1,1,1,4,37,27.4
Paul George,26-341,F,4/8/17,IND,ORL,1,40,14,22,0.636,10,13,0.769,4,9,0.444,5,7,0.714,0,7,7,6,0,0,2,2,37,29.9
DeMar DeRozan,27-094,G,11/9/16,TOR,OKC,1,39,13,22,0.591,13,20,0.65,0,2,0,11,15,0.733,0,4,4,6,3,0,4,2,37,28.8
John Wall,26-200,G,3/25/17,WAS,CLE,1,37,14,21,0.667,12,19,0.632,2,2,1,7,8,0.875,1,3,4,11,2,1,3,2,37,35.7
Paul George,26-222,F,12/10/16,IND,POR,1,36,13,27,0.481,8,17,0.471,5,10,0.5,6,7,0.857,1,4,5,3,3,0,2,2,37,27.1
Kevin Durant,28-031,F-G,10/30/16,GSW,PHO,1,38,10,16,0.625,8,12,0.667,2,4,0.5,15,16,0.938,0,4,4,4,4,1,4,2,37,33.3
Marcus Morris,27-179,F,2/28/17,DET,POR,1,42,13,23,0.565,10,16,0.625,3,7,0.429,8,9,0.889,3,5,8,6,0,0,0,2,37,32.7
Russell Westbrook,28-135,G,3/27/17,OKC,DAL,1,36,15,30,0.5,13,21,0.619,2,9,0.222,5,5,1,0,13,13,10,2,0,6,0,37,28.9
Karl-Anthony Towns,21-065,C-F,1/19/17,MIN,LAC,1,41,17,24,0.708,16,22,0.727,1,2,0.5,2,2,1,5,7,12,5,1,0,2,3,37,33.9
James Harden,27-101,G,12/5/16,HOU,BOS,1,35,8,14,0.571,5,9,0.556,3,5,0.6,18,18,1,1,7,8,7,3,0,10,2,37,30.3
Karl-Anthony Towns,21-074,C-F,1/28/17,MIN,BRK,1,36,15,26,0.577,13,23,0.565,2,3,0.667,5,8,0.625,4,9,13,1,1,4,2,1,37,31.2
Carmelo Anthony,32-272,F,2/25/17,NYK,PHI,1,37,15,25,0.6,13,18,0.722,2,7,0.286,5,7,0.714,1,5,6,2,0,1,3,4,37,24.4
Karl-Anthony Towns,21-133,C-F,3/28/17,MIN,IND,1,41,12,22,0.545,9,16,0.563,3,6,0.5,10,10,1,2,10,12,1,1,1,1,1,37,31.8
Paul George,26-330,F,3/28/17,IND,MIN,1,39,12,21,0.571,8,14,0.571,4,7,0.571,9,9,1,2,5,7,2,4,1,1,2,37,34.3
Isaiah Thomas,27-356,G,1/28/17,BOS,MIL,1,41,11,21,0.524,5,10,0.5,6,11,0.545,9,9,1,0,3,3,8,1,0,3,3,37,30
Paul George,26-324,F,3/22/17,IND,BOS,1,42,11,26,0.423,6,13,0.462,5,13,0.385,10,13,0.769,1,4,5,2,3,1,5,3,37,22.8
Jimmy Butler,27-059,G-F,11/12/16,CHI,WAS,1,38,11,23,0.478,10,20,0.5,1,3,0.333,14,14,1,2,6,8,9,3,0,2,2,37,35
DeMarcus Cousins,26-075,C-F,10/27/16,SAC,SAS,1,37,10,22,0.455,7,17,0.412,3,5,0.6,14,16,0.875,3,13,16,2,1,0,3,3,37,29
Kemba Walker,26-331,G,4/4/17,CHO,WAS,1,37,13,25,0.52,7,11,0.636,6,14,0.429,5,6,0.833,0,5,5,4,2,0,2,3,37,27.4
Eric Bledsoe,27-066,G,2/13/17,PHO,NOP,1,39,11,22,0.5,8,15,0.533,3,7,0.429,12,14,0.857,1,1,2,5,3,0,5,3,37,26.5
Anthony Davis,23-268,F-C,12/4/16,NOP,OKC,1,43,14,32,0.438,14,31,0.452,0,1,0,9,11,0.818,5,10,15,2,2,4,3,3,37,27.9
DeMar DeRozan,27-204,G,2/27/17,TOR,NYK,1,37,13,25,0.52,12,22,0.545,1,3,0.333,10,13,0.769,3,5,8,2,2,0,2,1,37,28.1
Russell Westbrook,28-029,G,12/11/16,OKC,BOS,1,36,14,26,0.538,12,21,0.571,2,5,0.4,7,12,0.583,3,9,12,6,2,0,7,3,37,25.2
Isaiah Thomas,27-281,G,11/14/16,BOS,NOP,1,36,13,29,0.448,10,19,0.526,3,10,0.3,8,10,0.8,0,3,3,7,2,0,1,3,37,26.7
Paul Millsap,31-354,F,1/29/17,ATL,NYK,1,60,13,29,0.448,10,21,0.476,3,8,0.375,8,10,0.8,8,11,19,7,1,0,3,4,37,31.3
Gordon Hayward,26-323,F-G,2/9/17,UTA,DAL,1,43,13,27,0.481,9,17,0.529,4,10,0.4,6,7,0.857,1,3,4,3,1,0,1,2,36,24.8
Ian Clark,26-004,G,3/11/17,GSW,SAS,0,34,15,21,0.714,12,18,0.667,3,3,1,3,6,0.5,1,4,5,0,1,0,4,3,36,23.8
LeBron James,32-096,F-G,4/5/17,CLE,BOS,1,39,14,22,0.636,13,18,0.722,1,4,0.25,7,7,1,2,8,10,6,1,2,3,3,36,32.4
Kawhi Leonard,25-228,F,2/12/17,SAS,NYK,1,36,13,27,0.481,12,20,0.6,1,7,0.143,9,11,0.818,2,7,9,4,4,0,3,3,36,27.6
Andrew Wiggins,22-042,F-G,4/6/17,MIN,POR,1,40,14,27,0.519,13,22,0.591,1,5,0.2,7,9,0.778,1,7,8,3,2,0,3,2,36,25
Mike Conley,29-169,G,3/29/17,MEM,IND,1,38,13,21,0.619,6,9,0.667,7,12,0.583,3,3,1,0,3,3,6,4,0,1,1,36,34.2
Devin Booker,20-132,G,3/11/17,PHO,DAL,1,35,12,20,0.6,10,15,0.667,2,5,0.4,10,10,1,1,4,5,2,0,0,1,2,36,28.3
Terrence Jones,25-014,F,1/23/17,NOP,CLE,1,36,13,18,0.722,10,14,0.714,3,4,0.75,7,10,0.7,3,8,11,1,2,3,1,1,36,35.3
Andrew Wiggins,22-029,F-G,3/24/17,MIN,LAL,1,44,14,28,0.5,9,21,0.429,5,7,0.714,3,5,0.6,3,1,4,2,1,1,2,6,36,22.3
DeMar DeRozan,27-154,G,1/8/17,TOR,HOU,1,39,13,21,0.619,13,21,0.619,0,0,,10,10,1,0,6,6,5,0,1,6,4,36,24.9
Klay Thompson,27-002,G,2/10/17,GSW,MEM,1,38,13,23,0.565,5,8,0.625,8,15,0.533,2,2,1,0,1,1,3,0,0,1,5,36,24.5
Karl-Anthony Towns,21-087,C-F,2/10/17,MIN,NOP,1,38,13,22,0.591,12,17,0.706,1,5,0.2,9,9,1,4,4,8,1,0,0,4,5,36,24.5
Damian Lillard,26-243,G,3/15/17,POR,SAS,1,34,12,22,0.545,9,14,0.643,3,8,0.375,9,9,1,1,2,3,4,2,0,2,0,36,29.5
Marc Gasol,31-314,C,12/8/16,MEM,POR,1,34,13,24,0.542,9,18,0.5,4,6,0.667,6,9,0.667,2,7,9,2,0,0,2,3,36,24.9
Tim Hardaway,24-352,G,3/3/17,ATL,CLE,0,35,13,20,0.65,8,11,0.727,5,9,0.556,5,6,0.833,1,1,2,2,0,0,1,0,36,28.2
Russell Westbrook,28-013,G,11/25/16,OKC,DEN,1,41,9,25,0.36,6,21,0.286,3,4,0.75,15,17,0.882,1,10,11,17,0,1,7,3,36,29.4
DeMar DeRozan,27-153,G,1/7/17,TOR,CHI,1,43,10,23,0.435,10,22,0.455,0,1,0,16,17,0.941,1,7,8,2,2,1,2,3,36,27.2
DeMarcus Cousins,26-113,C-F,12/4/16,SAC,NYK,1,43,9,31,0.29,5,21,0.238,4,10,0.4,14,16,0.875,5,8,13,4,1,3,2,0,36,26.9
LeBron James,32-007,F-G,1/6/17,CLE,BRK,1,35,14,20,0.7,14,19,0.737,0,1,0,8,10,0.8,0,9,9,6,3,0,5,2,36,30.9
Paul George,26-308,F,3/6/17,IND,CHO,1,36,15,25,0.6,9,11,0.818,6,14,0.429,0,0,,0,10,10,5,0,0,6,4,36,23.4
Damian Lillard,26-119,G,11/11/16,POR,SAC,1,42,12,19,0.632,7,9,0.778,5,10,0.5,7,9,0.778,0,1,1,7,0,0,5,1,36,26.5
Russell Westbrook,27-363,G,11/9/16,OKC,TOR,1,39,9,26,0.346,6,14,0.429,3,12,0.25,15,18,0.833,2,5,7,7,1,2,8,2,36,21.6
C.J. McCollum,25-092,G,12/20/16,POR,SAC,1,39,13,22,0.591,11,15,0.733,2,7,0.286,8,10,0.8,1,1,2,4,0,1,2,3,36,26.3
James Harden,27-108,G,12/12/16,HOU,BRK,1,39,12,27,0.444,8,16,0.5,4,11,0.364,8,12,0.667,3,5,8,11,2,0,4,3,36,28.4
Jimmy Butler,27-191,G-F,3/24/17,CHI,PHI,1,42,10,24,0.417,10,23,0.435,0,1,0,16,21,0.762,3,4,7,11,3,0,0,1,36,34.8
Kyle Lowry,30-273,G,12/23/16,TOR,UTA,1,33,15,20,0.75,11,12,0.917,4,8,0.5,2,3,0.667,0,4,4,5,2,0,4,2,36,29.5
Wilson Chandler,29-300,F,3/6/17,DEN,SAC,1,43,13,23,0.565,8,13,0.615,5,10,0.5,5,7,0.714,2,9,11,4,2,1,5,3,36,27.7
DeMar DeRozan,27-163,G,1/17/17,TOR,BRK,1,37,13,28,0.464,13,28,0.464,0,0,,10,10,1,2,9,11,6,1,0,3,2,36,27.1
Anthony Davis,23-309,F-C,1/14/17,NOP,CHI,1,39,14,23,0.609,14,23,0.609,0,0,,8,10,0.8,3,11,14,2,1,3,3,3,36,30.4
Anthony Davis,23-302,F-C,1/7/17,NOP,BOS,1,38,14,21,0.667,13,20,0.65,1,1,1,7,9,0.778,3,13,16,2,0,2,3,0,36,31.9
Andrew Wiggins,21-259,F-G,11/8/16,MIN,BRK,1,41,13,29,0.448,7,22,0.318,6,7,0.857,4,8,0.5,5,3,8,2,1,0,4,2,36,21.3
DeMar DeRozan,27-232,G,3/27/17,TOR,ORL,1,36,13,21,0.619,12,20,0.6,1,1,1,9,14,0.643,0,2,2,3,0,0,2,3,36,24
Blake Griffin,28-016,F,4/1/17,LAC,LAL,1,40,12,15,0.8,8,8,1,4,7,0.571,8,9,0.889,2,6,8,5,1,0,2,5,36,33.6
Anthony Davis,24-016,F-C,3/27/17,NOP,UTA,1,41,12,23,0.522,11,21,0.524,1,2,0.5,11,14,0.786,1,16,17,3,3,3,1,1,36,34.8
Russell Westbrook,28-064,G,1/15/17,OKC,SAC,1,36,11,21,0.524,7,16,0.438,4,5,0.8,10,11,0.909,2,9,11,10,4,0,7,1,36,33
Anthony Davis,23-324,F-C,1/29/17,NOP,WAS,1,40,15,25,0.6,14,23,0.609,1,2,0.5,5,6,0.833,2,15,17,3,3,2,6,2,36,29.7
Anthony Davis,23-261,F-C,11/27/16,NOP,DAL,1,40,12,22,0.545,12,21,0.571,0,1,0,12,14,0.857,3,10,13,3,1,1,2,3,36,30.3
DeMarcus Cousins,26-102,C-F,11/23/16,SAC,OKC,1,35,14,28,0.5,11,23,0.478,3,5,0.6,5,6,0.833,2,11,13,2,0,0,2,3,36,24.5
Kevin Durant,28-087,F-G,12/25/16,GSW,CLE,1,38,11,23,0.478,9,15,0.6,2,8,0.25,12,12,1,0,15,15,3,1,1,0,2,36,31.8
DeMarcus Cousins,26-107,C-F,11/28/16,SAC,WAS,1,40,16,34,0.471,15,28,0.536,1,6,0.167,3,10,0.3,4,16,20,4,2,1,5,5,36,21.9
Brook Lopez,28-320,C,2/15/17,BRK,MIL,1,35,12,20,0.6,6,10,0.6,6,10,0.6,6,8,0.75,2,2,4,1,1,8,0,2,36,34.5
Marcus Morris,27-154,F,2/3/17,DET,MIN,1,38,12,19,0.632,7,10,0.7,5,9,0.556,7,11,0.636,2,3,5,2,1,0,2,1,36,28.2
Kawhi Leonard,25-216,F,1/31/17,SAS,OKC,1,36,13,26,0.5,12,22,0.545,1,4,0.25,9,11,0.818,1,7,8,4,0,2,3,0,36,26.2
John Wall,26-113,G,12/28/16,WAS,IND,1,39,11,19,0.579,9,16,0.563,2,3,0.667,12,13,0.923,2,9,11,9,2,0,5,4,36,32.5
Jordan Clarkson,24-290,G,3/24/17,LAL,MIN,1,47,13,20,0.65,5,10,0.5,8,10,0.8,1,1,1,0,2,2,5,0,0,1,3,35,28.1
Russell Westbrook,28-018,G,11/30/16,OKC,WAS,1,41,12,35,0.343,11,29,0.379,1,6,0.167,10,10,1,4,10,14,11,2,0,5,3,35,24.6
Carmelo Anthony,32-180,F,11/25/16,NYK,CHO,1,41,14,25,0.56,11,19,0.579,3,6,0.5,4,4,1,1,12,13,5,2,1,2,2,35,30.8
Eric Bledsoe,26-354,G,11/27/16,PHO,DEN,1,40,10,23,0.435,6,15,0.4,4,8,0.5,11,11,1,0,6,6,6,2,2,3,3,35,28.1
DeMar DeRozan,27-245,G,4/9/17,TOR,NYK,1,29,11,15,0.733,11,15,0.733,0,0,,13,15,0.867,0,2,2,0,0,0,2,2,35,25.9
C.J. McCollum,25-124,G,1/21/17,POR,BOS,1,46,11,21,0.524,8,15,0.533,3,6,0.5,10,13,0.769,0,2,2,3,3,0,0,2,35,28.4
Stephen Curry,28-346,G,2/23/17,GSW,LAC,1,32,10,16,0.625,4,6,0.667,6,10,0.6,9,10,0.9,1,6,7,5,4,0,4,5,35,31.4
Karl-Anthony Towns,21-083,C-F,2/6/17,MIN,MIA,1,38,13,20,0.65,11,17,0.647,2,3,0.667,7,10,0.7,4,4,8,0,2,1,2,4,35,28.1
Carmelo Anthony,32-205,F,12/20/16,NYK,IND,1,37,13,25,0.52,6,14,0.429,7,11,0.636,2,2,1,0,4,4,4,2,0,0,3,35,27.5
Bradley Beal,23-197,G,1/11/17,WAS,BOS,1,37,13,26,0.5,7,16,0.438,6,10,0.6,3,4,0.75,2,0,2,4,1,1,2,4,35,23.9
Kawhi Leonard,25-118,F,10/25/16,SAS,GSW,1,32,10,21,0.476,10,18,0.556,0,3,0,15,15,1,3,2,5,3,5,0,2,1,35,31.7
Stephen Curry,28-247,G,11/16/16,GSW,TOR,1,37,10,19,0.526,7,10,0.7,3,9,0.333,12,13,0.923,2,1,3,7,1,0,3,3,35,28.7
DeMarcus Cousins,26-168,C-F,1/28/17,SAC,CHO,1,34,13,22,0.591,11,20,0.55,2,2,1,7,9,0.778,7,11,18,4,0,1,2,4,35,32.1
James Harden,27-226,G,4/9/17,HOU,SAC,1,36,9,22,0.409,4,9,0.444,5,13,0.385,12,13,0.923,0,11,11,15,1,0,10,2,35,26.8
Isaiah Thomas,28-026,G,3/5/17,BOS,PHO,1,32,10,25,0.4,5,13,0.385,5,12,0.417,10,11,0.909,0,2,2,5,2,0,1,4,35,24.6
Anthony Davis,23-279,F-C,12/15/16,NOP,IND,1,39,11,24,0.458,9,21,0.429,2,3,0.667,11,15,0.733,2,14,16,0,0,5,4,2,35,25.3
Isaiah Thomas,28-058,G,4/6/17,BOS,ATL,1,35,10,21,0.476,6,13,0.462,4,8,0.5,11,13,0.846,3,2,5,4,0,1,3,3,35,25.5
Isaiah Thomas,28-052,G,3/31/17,BOS,ORL,1,36,10,23,0.435,6,13,0.462,4,10,0.4,11,13,0.846,1,2,3,7,1,1,3,1,35,26.6
Will Barton,26-069,G,3/16/17,DEN,LAC,0,36,12,18,0.667,5,8,0.625,7,10,0.7,4,5,0.8,2,3,5,3,1,0,2,1,35,29.8
C.J. McCollum,25-111,G,1/8/17,POR,DET,1,44,16,28,0.571,13,19,0.684,3,9,0.333,0,0,,0,3,3,6,1,1,1,0,35,27.6
Carmelo Anthony,32-191,F,12/6/16,NYK,MIA,1,36,13,27,0.481,10,18,0.556,3,9,0.333,6,7,0.857,1,2,3,2,0,1,1,2,35,22.5
Andrew Wiggins,21-268,F-G,11/17/16,MIN,PHI,1,38,14,20,0.7,11,14,0.786,3,6,0.5,4,4,1,4,6,10,4,1,0,3,0,35,32
Anthony Davis,23-235,F-C,11/1/16,NOP,MIL,1,37,9,21,0.429,9,18,0.5,0,3,0,17,18,0.944,3,12,15,2,3,3,1,2,35,33.9
C.J. McCollum,25-107,G,1/4/17,POR,GSW,1,38,13,31,0.419,9,20,0.45,4,11,0.364,5,5,1,2,7,9,5,0,2,5,4,35,20.3
Giannis Antetokounmpo,22-025,F-G,12/31/16,MIL,CHI,1,41,13,19,0.684,12,18,0.667,1,1,1,8,11,0.727,3,6,9,8,2,7,4,2,35,37.3
Paul George,26-337,F,4/4/17,IND,TOR,1,40,12,25,0.48,7,15,0.467,5,10,0.5,6,6,1,2,8,10,3,2,0,3,2,35,26.4
Russell Westbrook,27-356,G,11/2/16,OKC,LAC,1,33,14,30,0.467,14,23,0.609,0,7,0,7,9,0.778,1,5,6,5,3,0,10,4,35,15.9
Isaiah Thomas,27-344,G,1/16/17,BOS,CHO,1,31,14,25,0.56,7,10,0.7,7,15,0.467,0,0,,1,4,5,4,0,0,3,1,35,24.4
Deron Williams,32-288,G,4/10/17,CLE,MIA,1,46,14,25,0.56,9,16,0.563,5,9,0.556,2,4,0.5,0,7,7,9,1,1,10,3,35,21.2
Dwyane Wade,34-292,G,11/4/16,CHI,NYK,1,33,12,20,0.6,7,13,0.538,5,7,0.714,6,8,0.75,2,8,10,1,0,0,3,3,35,25.3
Rudy Gobert,24-269,C,3/22/17,UTA,NYK,1,38,13,15,0.867,13,15,0.867,0,0,,9,12,0.75,13,2,15,1,1,4,3,2,35,38.9
Klay Thompson,27-007,G,2/15/17,GSW,SAC,1,31,12,18,0.667,5,6,0.833,7,12,0.583,4,7,0.571,2,3,5,4,2,0,0,1,35,32.7
Nikola Jokic,21-335,C-F,1/19/17,DEN,SAS,1,38,14,22,0.636,12,18,0.667,2,4,0.5,5,5,1,4,8,12,4,0,2,3,2,35,30.8
James Harden,27-194,G,3/8/17,HOU,UTA,1,37,10,22,0.455,10,14,0.714,0,8,0,15,16,0.938,0,4,4,6,2,1,6,1,35,24.9
Jimmy Butler,27-069,G-F,11/22/16,CHI,DEN,1,39,11,20,0.55,9,16,0.563,2,4,0.5,11,12,0.917,0,7,7,5,0,2,1,3,35,29.8
Stephen Curry,28-327,G,2/4/17,GSW,SAC,1,42,11,20,0.55,3,6,0.5,8,14,0.571,5,6,0.833,0,4,4,9,3,0,3,2,35,31.7
Lou Williams,30-043,G,12/9/16,LAL,PHO,0,35,10,19,0.526,4,7,0.571,6,12,0.5,9,11,0.818,0,5,5,2,1,0,2,2,35,26
Karl-Anthony Towns,21-116,C-F,3/11/17,MIN,MIL,1,40,14,21,0.667,11,16,0.688,3,5,0.6,4,6,0.667,4,10,14,1,1,2,4,4,35,28.4
Stephen Curry,28-296,G,1/4/17,GSW,POR,1,36,12,25,0.48,7,12,0.583,5,13,0.385,6,8,0.75,1,6,7,5,1,0,5,1,35,23.1
Kristaps Porzingis,21-106,F-C,11/16/16,NYK,DET,1,40,13,22,0.591,10,15,0.667,3,7,0.429,6,7,0.857,4,3,7,3,1,1,1,2,35,30.1
LeBron James,31-341,F-G,12/5/16,CLE,TOR,1,42,12,26,0.462,10,19,0.526,2,7,0.286,8,9,0.889,3,5,8,7,2,0,1,2,34,28.9
Stephen Curry,28-257,G,11/26/16,GSW,MIN,1,37,13,19,0.684,9,11,0.818,4,8,0.5,4,4,1,1,7,8,6,2,0,6,4,34,27.3
LeBron James,31-356,F-G,12/20/16,CLE,MIL,1,47,12,25,0.48,7,16,0.438,5,9,0.556,5,6,0.833,3,9,12,7,1,1,2,2,34,29.5
Anthony Davis,23-285,F-C,12/21/16,NOP,OKC,1,36,14,26,0.538,13,24,0.542,1,2,0.5,5,7,0.714,2,12,14,2,1,2,2,5,34,25.4
Anthony Davis,23-246,F-C,11/12/16,NOP,LAL,1,35,13,26,0.5,13,24,0.542,0,2,0,8,11,0.727,1,7,8,2,0,2,1,0,34,24.4
George Hill,30-303,G,3/3/17,UTA,BRK,1,32,10,12,0.833,7,9,0.778,3,3,1,11,12,0.917,0,2,2,7,0,0,4,4,34,29.1
Harrison Barnes,24-160,F,11/6/16,DAL,MIL,1,48,13,26,0.5,11,21,0.524,2,5,0.4,6,7,0.857,3,5,8,2,2,0,1,0,34,26.6
C.J. McCollum,25-082,G,12/10/16,POR,IND,1,37,12,22,0.545,5,11,0.455,7,11,0.636,3,3,1,1,3,4,4,0,3,3,1,34,26.5
Kawhi Leonard,25-202,F,1/17/17,SAS,MIN,1,39,12,17,0.706,10,14,0.714,2,3,0.667,8,9,0.889,1,6,7,5,1,0,1,4,34,30.9
Giannis Antetokounmpo,22-108,F-G,3/24/17,MIL,ATL,1,36,13,22,0.591,12,19,0.632,1,3,0.333,7,9,0.778,4,9,13,5,2,3,1,2,34,34.3
Kemba Walker,26-291,G,2/23/17,CHO,DET,1,42,11,19,0.579,8,13,0.615,3,6,0.5,9,9,1,1,6,7,6,2,0,0,3,34,32.6
Kyrie Irving,24-339,G,2/25/17,CLE,CHI,1,35,13,25,0.52,11,15,0.733,2,10,0.2,6,7,0.857,0,9,9,7,0,1,2,2,34,26.8
DeMar DeRozan,27-096,G,11/11/16,TOR,CHO,1,36,14,26,0.538,14,25,0.56,0,1,0,6,7,0.857,0,3,3,3,2,0,1,1,34,24.6
DeMar DeRozan,27-101,G,11/16/16,TOR,GSW,1,38,8,18,0.444,7,14,0.5,1,4,0.25,17,17,1,1,5,6,4,1,0,5,3,34,24.4
Klay Thompson,27-040,G,3/20/17,GSW,OKC,1,32,12,21,0.571,5,6,0.833,7,15,0.467,3,3,1,1,5,6,2,2,0,1,2,34,27.9
Kemba Walker,26-239,G,1/2/17,CHO,CHI,1,38,13,20,0.65,7,12,0.583,6,8,0.75,2,2,1,0,9,9,4,1,1,1,2,34,30.6
Giannis Antetokounmpo,21-359,F-G,11/29/16,MIL,CLE,1,35,13,19,0.684,12,17,0.706,1,2,0.5,7,10,0.7,1,11,12,5,5,2,6,4,34,31
Paul George,26-240,F,12/28/16,IND,WAS,1,37,10,20,0.5,4,10,0.4,6,10,0.6,8,8,1,0,3,3,4,1,0,0,5,34,26.7
DeMar DeRozan,27-131,G,12/16/16,TOR,ATL,1,37,15,26,0.577,15,26,0.577,0,0,,4,6,0.667,0,5,5,4,2,1,3,3,34,23.8
Otto Porter,23-159,F,11/9/16,WAS,BOS,1,38,14,19,0.737,11,14,0.786,3,5,0.6,3,3,1,7,7,14,4,3,3,0,2,34,40.4
Dwyane Wade,34-323,G,12/5/16,CHI,POR,1,36,11,23,0.478,10,20,0.5,1,3,0.333,11,13,0.846,2,2,4,3,1,2,4,3,34,22.8
Carmelo Anthony,32-235,F,1/19/17,NYK,WAS,1,35,13,27,0.481,10,20,0.5,3,7,0.429,5,7,0.714,1,9,10,2,1,0,1,2,34,23.5
Isaiah Thomas,27-320,G,12/23/16,BOS,OKC,1,34,12,22,0.545,10,14,0.714,2,8,0.25,8,9,0.889,0,2,2,10,1,0,5,3,34,25.4
John Wall,26-203,G,3/28/17,WAS,LAL,1,37,14,25,0.56,13,21,0.619,1,4,0.25,5,5,1,0,3,3,14,4,0,3,3,34,32.6
C.J. McCollum,25-173,G,3/11/17,POR,WAS,1,42,13,23,0.565,8,14,0.571,5,9,0.556,3,3,1,0,0,0,6,0,0,0,0,34,27.3
Goran Dragic,30-220,G,12/12/16,MIA,WAS,1,31,14,23,0.609,12,18,0.667,2,5,0.4,4,4,1,2,3,5,5,1,0,3,4,34,25.7
James Harden,27-123,G,12/27/16,HOU,DAL,1,30,9,16,0.563,5,9,0.556,4,7,0.571,12,12,1,2,3,5,11,0,1,7,2,34,29.3
Anthony Davis,23-332,F-C,2/6/17,NOP,PHO,1,40,12,21,0.571,11,19,0.579,1,2,0.5,9,11,0.818,2,7,9,1,1,5,2,3,34,28.8
Kawhi Leonard,25-259,F,3/15/17,SAS,POR,1,37,12,21,0.571,8,14,0.571,4,7,0.571,6,7,0.857,0,9,9,6,3,2,2,4,34,31.4
Karl-Anthony Towns,21-139,C-F,4/3/17,MIN,POR,1,39,15,25,0.6,15,25,0.6,0,0,,4,4,1,4,8,12,0,0,0,1,2,34,25.9
Kristaps Porzingis,21-133,F-C,12/13/16,NYK,PHO,1,42,12,23,0.522,8,19,0.421,4,4,1,6,7,0.857,1,7,8,0,3,3,2,6,34,25.8
Brook Lopez,28-215,C,11/2/16,BRK,DET,1,29,12,21,0.571,8,13,0.615,4,8,0.5,6,9,0.667,2,9,11,1,2,1,2,2,34,27.6
Isaiah Thomas,28-002,G,2/9/17,BOS,POR,1,38,11,26,0.423,9,15,0.6,2,11,0.182,10,11,0.909,0,1,1,4,1,0,2,1,34,21.5
DeMar DeRozan,27-089,G,11/4/16,TOR,MIA,1,37,14,26,0.538,14,24,0.583,0,2,0,6,6,1,1,3,4,4,0,0,4,2,34,21
Karl-Anthony Towns,21-055,C-F,1/9/17,MIN,DAL,1,37,15,19,0.789,13,16,0.813,2,3,0.667,2,2,1,1,10,11,4,1,3,3,4,34,31.7
Kawhi Leonard,25-204,F,1/19/17,SAS,DEN,1,36,12,22,0.545,10,17,0.588,2,5,0.4,8,8,1,0,5,5,4,2,1,1,1,34,29
Isaiah Thomas,28-045,G,3/24/17,BOS,PHO,1,33,10,20,0.5,7,11,0.636,3,9,0.333,11,11,1,1,1,2,7,0,0,2,2,34,27.1
Danilo Gallinari,28-244,F,4/9/17,DEN,OKC,1,38,12,20,0.6,8,11,0.727,4,9,0.444,6,6,1,0,10,10,3,2,0,2,2,34,29.1
Kawhi Leonard,25-248,F,3/4/17,SAS,MIN,1,44,11,25,0.44,10,20,0.5,1,5,0.2,11,12,0.917,1,9,10,5,6,1,1,1,34,32.7
Kevin Durant,28-079,F-G,12/17/16,GSW,POR,1,31,11,13,0.846,7,8,0.875,4,5,0.8,8,10,0.8,1,10,11,4,2,1,5,2,34,31.9
Kevin Durant,28-135,F-G,2/11/17,GSW,OKC,1,33,12,21,0.571,9,15,0.6,3,6,0.5,7,7,1,1,8,9,3,0,0,3,5,34,24.3
LeBron James,32-079,F-G,3/19/17,CLE,LAL,1,38,13,22,0.591,10,14,0.714,3,8,0.375,5,8,0.625,0,6,6,7,1,0,3,2,34,26.5
Anthony Davis,23-242,F-C,11/8/16,NOP,SAC,1,37,14,22,0.636,14,20,0.7,0,2,0,6,7,0.857,1,7,8,1,2,4,3,2,34,28.3
LeBron James,32-091,F-G,3/31/17,CLE,PHI,1,30,14,22,0.636,11,15,0.733,3,7,0.429,3,6,0.5,2,7,9,6,0,0,2,2,34,27.9
Damian Lillard,26-182,G,1/13/17,POR,ORL,1,37,12,26,0.462,10,15,0.667,2,11,0.182,8,9,0.889,1,7,8,3,0,0,2,1,34,22.7
Kawhi Leonard,25-133,F,11/9/16,SAS,HOU,1,39,11,26,0.423,7,20,0.35,4,6,0.667,8,8,1,2,5,7,1,1,2,2,1,34,23.8
Kemba Walker,26-294,G,2/26/17,CHO,LAC,1,43,11,19,0.579,5,9,0.556,6,10,0.6,6,8,0.75,0,2,2,2,1,0,3,2,34,23.5
James Harden,27-061,G,10/26/16,HOU,LAL,1,37,9,19,0.474,8,12,0.667,1,7,0.143,15,16,0.938,3,4,7,17,1,0,7,5,34,31.1
John Wall,26-074,G,11/19/16,WAS,MIA,1,37,12,23,0.522,7,17,0.412,5,6,0.833,5,8,0.625,1,2,3,8,0,0,3,3,34,24.2
Damian Lillard,26-228,G,2/28/17,POR,DET,1,41,13,25,0.52,10,17,0.588,3,8,0.375,5,6,0.833,1,10,11,9,1,0,4,2,34,27.5
Tyler Ulis,21-087,G,4/2/17,PHO,HOU,1,45,15,22,0.682,12,15,0.8,3,7,0.429,1,1,1,2,7,9,9,1,0,4,4,34,29.8
Kyle Lowry,30-259,G,12/9/16,TOR,BOS,1,36,9,18,0.5,5,10,0.5,4,8,0.5,12,13,0.923,1,6,7,2,3,0,2,4,34,27.9
Russell Westbrook,28-010,G,11/22/16,OKC,LAL,1,36,13,30,0.433,9,21,0.429,4,9,0.444,4,5,0.8,3,5,8,13,2,0,8,3,34,23.3
Bradley Beal,23-144,G,11/19/16,WAS,MIA,1,40,12,26,0.462,8,15,0.533,4,11,0.364,6,6,1,2,3,5,4,1,0,3,4,34,22.1
Paul George,26-307,F,3/5/17,IND,ATL,1,38,12,19,0.632,6,10,0.6,6,9,0.667,4,5,0.8,0,5,5,4,1,0,5,3,34,24.2
Jrue Holiday,26-225,G,1/23/17,NOP,CLE,1,39,12,19,0.632,8,12,0.667,4,7,0.571,5,5,1,0,6,6,10,3,2,3,5,33,32.7
Jimmy Butler,27-199,G-F,4/1/17,CHI,ATL,1,43,11,20,0.55,10,18,0.556,1,2,0.5,10,10,1,1,4,5,8,0,1,1,3,33,29.4
Dwyane Wade,35-008,G,1/25/17,CHI,ATL,1,31,14,24,0.583,14,23,0.609,0,1,0,5,8,0.625,3,2,5,2,2,1,1,2,33,25.6
Russell Westbrook,28-119,G,3/11/17,OKC,UTA,1,36,9,26,0.346,6,16,0.375,3,10,0.3,12,13,0.923,1,10,11,14,2,2,5,1,33,29.5
Carmelo Anthony,32-257,F,2/10/17,NYK,DEN,1,35,13,20,0.65,7,10,0.7,6,10,0.6,1,2,0.5,1,5,6,4,2,0,2,2,33,28
Paul George,26-272,F,1/29/17,IND,HOU,1,37,13,23,0.565,10,16,0.625,3,7,0.429,4,4,1,0,9,9,3,1,1,2,2,33,25.8
Chris Paul,31-311,G,3/13/17,LAC,UTA,1,35,11,21,0.524,6,10,0.6,5,11,0.455,6,6,1,1,5,6,7,1,0,1,4,33,28.2
Goran Dragic,30-276,G,2/6/17,MIA,MIN,1,35,13,17,0.765,6,8,0.75,7,9,0.778,0,0,,1,1,2,9,1,0,4,4,33,29
Dion Waiters,25-042,G,1/21/17,MIA,MIL,1,33,12,19,0.632,7,11,0.636,5,8,0.625,4,8,0.5,0,3,3,3,1,0,3,1,33,23.5
Kyrie Irving,24-364,G,3/22/17,CLE,DEN,1,27,11,22,0.5,7,17,0.412,4,5,0.8,7,7,1,1,1,2,3,0,0,0,2,33,24.3
DeMarcus Cousins,26-082,C-F,11/3/16,SAC,ORL,1,36,12,20,0.6,11,17,0.647,1,3,0.333,8,9,0.889,1,6,7,4,2,1,2,3,33,28.2
Kyle Lowry,30-312,G,1/31/17,TOR,NOP,1,45,11,21,0.524,5,7,0.714,6,14,0.429,5,7,0.714,0,4,4,10,0,0,3,3,33,25.9
Dennis Schroder,23-085,G,12/9/16,ATL,MIL,1,40,12,19,0.632,8,12,0.667,4,7,0.571,5,5,1,0,3,3,4,1,1,7,4,33,21.3
Russell Westbrook,27-353,G,10/30/16,OKC,LAL,1,34,11,21,0.524,6,15,0.4,5,6,0.833,6,6,1,4,7,11,16,1,1,7,3,33,32.3
Dion Waiters,25-044,G,1/23/17,MIA,GSW,1,33,13,20,0.65,7,12,0.583,6,8,0.75,1,1,1,1,4,5,4,1,0,3,1,33,26.5
John Wall,26-149,G,2/2/17,WAS,LAL,1,41,11,23,0.478,8,16,0.5,3,7,0.429,8,10,0.8,1,2,3,11,2,1,3,2,33,28.4
Kyle Lowry,30-310,G,1/29/17,TOR,ORL,1,38,9,18,0.5,3,9,0.333,6,9,0.667,9,12,0.75,1,4,5,8,1,0,4,2,33,26.5
Damian Lillard,26-239,G,3/11/17,POR,WAS,1,36,13,27,0.481,9,16,0.563,4,11,0.364,3,4,0.75,0,3,3,7,0,0,6,5,33,16.7
Kevin Durant,28-122,F-G,1/29/17,GSW,POR,1,36,13,26,0.5,12,19,0.632,1,7,0.143,6,6,1,2,8,10,6,0,1,7,2,33,20.9
Joel Embiid,22-277,C-F,12/18/16,PHI,BRK,1,27,12,17,0.706,10,14,0.714,2,3,0.667,7,8,0.875,2,8,10,1,2,3,3,2,33,30.3
Damian Lillard,26-196,G,1/27/17,POR,MEM,1,40,9,21,0.429,4,10,0.4,5,11,0.455,10,11,0.909,1,4,5,6,0,0,4,1,33,23.2
Damian Lillard,26-148,G,12/10/16,POR,IND,1,37,10,24,0.417,5,10,0.5,5,14,0.357,8,9,0.889,1,2,3,9,0,0,2,4,33,23.8
Anthony Davis,23-355,F-C,3/1/17,NOP,DET,1,36,11,17,0.647,11,15,0.733,0,2,0,11,11,1,1,13,14,3,0,1,2,2,33,30.1
C.J. McCollum,25-062,G,11/20/16,POR,BRK,1,31,12,19,0.632,6,9,0.667,6,10,0.6,3,3,1,0,4,4,5,0,0,5,5,33,22.2
Isaiah Thomas,28-008,G,2/15/17,BOS,PHI,1,34,9,19,0.474,5,12,0.417,4,7,0.571,11,13,0.846,1,3,4,3,0,0,4,3,33,21
Karl-Anthony Towns,21-072,C-F,1/26/17,MIN,IND,1,38,13,23,0.565,9,17,0.529,4,6,0.667,3,4,0.75,2,8,10,4,2,0,2,2,33,27.5
Kevin Durant,28-118,F-G,1/25/17,GSW,CHO,1,37,11,20,0.55,10,16,0.625,1,4,0.25,10,10,1,0,5,5,2,0,4,6,3,33,21.9
DeMarcus Cousins,26-127,C-F,12/18/16,SAC,DAL,1,35,12,24,0.5,10,18,0.556,2,6,0.333,7,10,0.7,0,6,6,0,0,1,2,3,33,19.1
Tim Hardaway,24-323,G,2/2/17,ATL,HOU,1,33,12,18,0.667,8,9,0.889,4,9,0.444,5,7,0.714,0,6,6,3,0,1,3,2,33,25.2
Giannis Antetokounmpo,22-080,F-G,2/24/17,MIL,UTA,1,34,10,16,0.625,8,12,0.667,2,4,0.5,11,15,0.733,4,8,12,3,4,1,6,4,33,28.6
Goran Dragic,30-334,G,4/5/17,MIA,CHO,1,33,13,21,0.619,8,12,0.667,5,9,0.556,2,2,1,0,1,1,4,2,0,1,1,33,27.2
James Harden,27-224,G,4/7/17,HOU,DET,1,38,10,25,0.4,3,6,0.5,7,19,0.368,6,7,0.857,2,7,9,12,0,1,1,4,33,29.1
LaMarcus Aldridge,31-159,F-C,12/25/16,SAS,CHI,1,38,15,20,0.75,15,20,0.75,0,0,,3,6,0.5,3,6,9,1,0,0,1,4,33,25.8
Paul George,26-270,F,1/27/17,IND,SAC,1,45,8,18,0.444,7,13,0.538,1,5,0.2,16,17,0.941,1,3,4,3,2,0,4,2,33,24.1
John Wall,26-057,G,11/2/16,WAS,TOR,1,37,13,19,0.684,13,16,0.813,0,3,0,7,9,0.778,1,4,5,11,3,1,9,3,33,27.2
Kyle Lowry,30-286,G,1/5/17,TOR,UTA,1,41,10,17,0.588,6,9,0.667,4,8,0.5,9,11,0.818,1,5,6,5,3,0,2,2,33,30.2
Jimmy Butler,27-206,G-F,4/8/17,CHI,BRK,1,38,12,22,0.545,7,17,0.412,5,5,1,4,4,1,1,6,7,4,0,0,3,0,33,24.7
Gordon Hayward,26-318,F-G,2/4/17,UTA,CHO,1,37,13,20,0.65,11,16,0.688,2,4,0.5,5,6,0.833,1,7,8,2,1,0,2,1,33,26.6
Damian Lillard,26-223,G,2/23/17,POR,ORL,1,32,12,23,0.522,8,16,0.5,4,7,0.571,5,6,0.833,0,5,5,2,0,0,2,3,33,21
Stephen Curry,28-241,G,11/10/16,GSW,DEN,1,30,10,17,0.588,3,4,0.75,7,13,0.538,6,6,1,1,4,5,6,1,0,4,1,33,27.8
Damian Lillard,26-230,G,3/2/17,POR,OKC,1,38,11,23,0.478,8,14,0.571,3,9,0.333,8,9,0.889,1,3,4,5,1,0,2,1,33,24.6
C.J. McCollum,25-050,G,11/8/16,POR,PHO,1,37,11,18,0.611,7,12,0.583,4,6,0.667,7,8,0.875,0,6,6,7,2,1,3,2,33,30
DeMarcus Cousins,26-090,C-F,11/11/16,SAC,POR,1,39,12,22,0.545,9,15,0.6,3,7,0.429,6,9,0.667,2,7,9,3,1,2,3,5,33,24.2
Russell Westbrook,28-002,G,11/14/16,OKC,DET,1,34,11,21,0.524,11,19,0.579,0,2,0,11,12,0.917,2,13,15,8,0,0,7,4,33,24.6
Jabari Parker,21-240,F,11/10/16,MIL,NOP,1,35,13,26,0.5,10,20,0.5,3,6,0.5,4,4,1,1,8,9,1,1,1,0,1,33,25.1
James Harden,27-138,G,1/11/17,HOU,MIN,1,39,10,23,0.435,8,12,0.667,2,11,0.182,11,13,0.846,0,6,6,12,1,2,6,0,33,26.7
Kentavious Caldwell-Pope,24-005,G,2/23/17,DET,CHO,1,43,11,25,0.44,4,10,0.4,7,15,0.467,4,4,1,1,8,9,3,0,0,0,1,33,24.7
Kevin Durant,28-051,F-G,11/19/16,GSW,MIL,1,36,10,17,0.588,5,9,0.556,5,8,0.625,8,11,0.727,0,6,6,5,2,1,0,5,33,29.9
Jusuf Nurkic,22-217,C,3/28/17,POR,DEN,1,33,12,15,0.8,12,15,0.8,0,0,,9,11,0.818,5,10,15,2,1,2,3,4,33,32.2
Bradley Beal,23-286,G,4/10/17,WAS,DET,1,33,13,20,0.65,10,12,0.833,3,8,0.375,4,4,1,0,2,2,3,0,1,1,2,33,25.8
Anthony Davis,23-241,F-C,11/7/16,NOP,GSW,1,35,11,18,0.611,10,16,0.625,1,2,0.5,10,13,0.769,1,12,13,1,0,0,3,1,33,25.2
Kawhi Leonard,25-177,F,12/23/16,SAS,POR,1,32,9,15,0.6,4,8,0.5,5,7,0.714,10,10,1,0,3,3,2,1,0,2,2,33,26.6
DeMar DeRozan,27-203,G,2/26/17,TOR,POR,1,36,9,16,0.563,9,14,0.643,0,2,0,15,16,0.938,0,6,6,2,2,1,4,2,33,26.1
DeMar DeRozan,27-097,G,11/12/16,TOR,NYK,1,36,11,23,0.478,10,22,0.455,1,1,1,10,13,0.769,2,5,7,4,2,0,2,1,33,25.4
Carmelo Anthony,32-194,F,12/9/16,NYK,SAC,1,36,9,22,0.409,6,12,0.5,3,10,0.3,12,14,0.857,0,7,7,4,1,1,2,3,33,23.8
Ricky Rubio,26-160,G,3/30/17,MIN,LAL,1,38,12,20,0.6,8,15,0.533,4,5,0.8,5,6,0.833,1,4,5,10,2,0,3,1,33,30.9
Giannis Antetokounmpo,22-071,F-G,2/15/17,MIL,BRK,1,40,13,25,0.52,13,24,0.542,0,1,0,7,10,0.7,2,7,9,3,4,1,0,2,33,29
Goran Dragic,30-313,G,3/15/17,MIA,NOP,1,32,11,18,0.611,6,9,0.667,5,9,0.556,6,8,0.75,1,4,5,2,1,1,1,2,33,27.2
DeMar DeRozan,27-085,G,10/31/16,TOR,DEN,1,39,13,23,0.565,13,22,0.591,0,1,0,7,9,0.778,2,3,5,1,1,0,1,1,33,23.9
LeBron James,32-076,F-G,3/16/17,CLE,UTA,1,38,13,20,0.65,11,15,0.733,2,5,0.4,5,10,0.5,0,10,10,6,2,1,6,0,33,26.1
Brook Lopez,28-299,C,1/25/17,BRK,MIA,1,33,11,23,0.478,4,9,0.444,7,14,0.5,4,4,1,0,4,4,3,0,0,2,4,33,21
Russell Westbrook,28-053,G,1/4/17,OKC,CHO,1,34,10,31,0.323,8,19,0.421,2,12,0.167,11,13,0.846,3,12,15,8,2,1,4,5,33,22.5
Brook Lopez,28-271,C,12/28/16,BRK,CHI,1,34,12,20,0.6,7,14,0.5,5,6,0.833,4,4,1,1,2,3,4,0,0,3,4,33,23.3
Karl-Anthony Towns,20-356,C-F,11/5/16,MIN,OKC,1,31,13,20,0.65,10,16,0.625,3,4,0.75,4,5,0.8,4,2,6,0,0,1,3,1,33,24.5
Anthony Davis,24-013,F-C,3/24/17,NOP,HOU,1,41,14,24,0.583,14,23,0.609,0,1,0,5,6,0.833,3,13,16,1,3,1,1,2,33,30
Karl-Anthony Towns,21-124,C-F,3/19/17,MIN,NOP,1,39,14,27,0.519,10,19,0.526,4,8,0.5,1,2,0.5,2,4,6,2,1,0,3,2,33,20.5
James Harden,27-080,G,11/14/16,HOU,PHI,1,33,12,20,0.6,8,12,0.667,4,8,0.5,5,5,1,1,6,7,9,1,1,5,2,33,28.5
Isaiah Thomas,28-019,G,2/26/17,BOS,DET,1,35,10,23,0.435,5,11,0.455,5,12,0.417,8,9,0.889,0,2,2,3,3,0,2,3,33,23
Cory Joseph,25-150,G,1/17/17,TOR,BRK,1,37,15,22,0.682,14,18,0.778,1,4,0.25,2,2,1,2,2,4,4,0,0,1,0,33,27.4
Giannis Antetokounmpo,22-040,F-G,1/15/17,MIL,ATL,1,40,13,22,0.591,13,20,0.65,0,2,0,7,7,1,5,2,7,6,2,3,4,4,33,29.6
Devin Booker,20-151,G,3/30/17,PHO,LAC,1,37,13,22,0.591,9,15,0.6,4,7,0.571,3,6,0.5,0,2,2,9,1,0,3,6,33,24.1
Kemba Walker,26-304,G,3/8/17,CHO,MIA,1,38,11,24,0.458,6,13,0.462,5,11,0.455,6,6,1,0,4,4,1,1,1,3,2,33,20.4
Devin Booker,20-096,G,2/3/17,PHO,SAC,1,41,11,24,0.458,7,16,0.438,4,8,0.5,7,10,0.7,0,2,2,2,2,1,1,4,33,21.5
James Harden,27-190,G,3/4/17,HOU,MEM,1,36,9,15,0.6,3,5,0.6,6,10,0.6,9,13,0.692,1,6,7,11,2,0,5,2,33,30.9
Aaron Gordon,21-089,F,12/14/16,ORL,LAC,1,40,13,21,0.619,9,13,0.692,4,8,0.5,3,6,0.5,4,3,7,2,0,0,3,3,33,23.2
Andrew Wiggins,22-037,F-G,4/1/17,MIN,SAC,1,39,13,20,0.65,9,13,0.692,4,7,0.571,2,6,0.333,1,2,3,3,0,1,1,1,32,24.3
Bradley Beal,23-250,G,3/5/17,WAS,ORL,1,41,12,21,0.571,9,16,0.563,3,5,0.6,5,5,1,1,2,3,4,2,1,1,1,32,27.5
Jimmy Butler,27-083,G-F,12/6/16,CHI,DET,1,43,11,21,0.524,11,17,0.647,0,4,0,10,10,1,0,6,6,4,0,1,3,1,32,23.6
Karl-Anthony Towns,20-354,C-F,11/3/16,MIN,DEN,1,38,11,19,0.579,9,15,0.6,2,4,0.5,8,10,0.8,5,9,14,2,1,2,2,4,32,28.7
Blake Griffin,28-020,F,4/5/17,LAC,DAL,1,38,11,14,0.786,9,10,0.9,2,4,0.5,8,10,0.8,0,4,4,6,1,0,1,3,32,30
Kyrie Irving,24-223,G,11/1/16,CLE,HOU,1,35,10,19,0.526,6,13,0.462,4,6,0.667,8,8,1,1,1,2,4,0,0,3,1,32,23.1
DeMar DeRozan,27-082,G,10/28/16,TOR,CLE,1,38,12,28,0.429,12,27,0.444,0,1,0,8,8,1,2,5,7,2,2,0,3,3,32,19.3
Otto Porter,23-206,F,12/26/16,WAS,MIL,1,41,13,18,0.722,8,9,0.889,5,9,0.556,1,2,0.5,0,13,13,1,0,1,2,4,32,25.9
Gordon Hayward,26-255,F-G,12/3/16,UTA,DEN,1,37,9,18,0.5,6,14,0.429,3,4,0.75,11,11,1,0,4,4,0,2,0,4,2,32,21.4
Kemba Walker,26-257,G,1/20/17,CHO,TOR,1,29,11,16,0.688,5,7,0.714,6,9,0.667,4,5,0.8,1,3,4,8,0,0,2,2,32,29.2
Kyrie Irving,24-281,G,12/29/16,CLE,BOS,1,42,12,17,0.706,10,12,0.833,2,5,0.4,6,7,0.857,2,3,5,12,3,0,4,0,32,34.2
Yogi Ferrell,23-270,G,2/3/17,DAL,POR,1,39,11,17,0.647,2,6,0.333,9,11,0.818,1,2,0.5,0,2,2,5,0,0,2,4,32,24.6
Russell Westbrook,28-023,G,12/5/16,OKC,ATL,1,34,10,22,0.455,7,14,0.5,3,8,0.375,9,14,0.643,1,12,13,12,1,1,4,1,32,28.6
Anthony Davis,23-338,F-C,2/12/17,NOP,SAC,1,40,11,24,0.458,10,22,0.455,1,2,0.5,9,9,1,1,9,10,3,2,1,6,4,32,20.2
Tyler Johnson,24-227,G,12/20/16,MIA,ORL,0,38,13,20,0.65,10,15,0.667,3,5,0.6,3,5,0.6,0,5,5,3,3,0,0,6,32,26.6
Aaron Gordon,21-208,F,4/12/17,ORL,DET,1,35,11,20,0.55,8,13,0.615,3,7,0.429,7,7,1,2,10,12,0,1,2,0,2,32,28.4
Kyle Lowry,30-313,G,2/1/17,TOR,BOS,1,38,12,20,0.6,8,9,0.889,4,11,0.364,4,6,0.667,0,2,2,5,2,0,3,2,32,24.3
Russell Westbrook,27-349,G,10/26/16,OKC,PHI,1,36,11,21,0.524,10,19,0.526,1,2,0.5,9,11,0.818,1,11,12,9,0,0,2,2,32,28.4
Damian Lillard,26-121,G,11/13/16,POR,DEN,1,33,7,18,0.389,4,11,0.364,3,7,0.429,15,15,1,2,6,8,6,4,0,1,0,32,32.6
Paul George,26-345,F,4/12/17,IND,ATL,1,40,12,21,0.571,7,11,0.636,5,10,0.5,3,3,1,0,11,11,3,1,0,1,3,32,26.3
Kyrie Irving,24-289,G,1/6/17,CLE,BRK,1,36,10,26,0.385,7,17,0.412,3,9,0.333,9,9,1,0,3,3,4,2,0,0,1,32,23.1
Jeremy Lin,28-226,G,4/6/17,BRK,ORL,1,31,11,20,0.55,6,11,0.545,5,9,0.556,5,6,0.833,0,5,5,3,2,1,2,5,32,24.3
Kevin Durant,28-113,F-G,1/20/17,GSW,HOU,1,34,12,19,0.632,10,12,0.833,2,7,0.286,6,7,0.857,0,4,4,7,2,2,1,2,32,30.8
Isaiah Thomas,28-060,G,4/8/17,BOS,CHO,1,34,10,18,0.556,5,7,0.714,5,11,0.455,7,8,0.875,0,2,2,6,1,0,6,2,32,22
Isaiah Thomas,28-027,G,3/6/17,BOS,LAC,1,35,10,19,0.526,6,11,0.545,4,8,0.5,8,9,0.889,0,2,2,5,3,0,3,4,32,24.8
Wilson Chandler,29-199,F,11/25/16,DEN,OKC,1,37,14,25,0.56,12,20,0.6,2,5,0.4,2,2,1,3,8,11,4,0,1,2,3,32,24.9
LeBron James,32-084,F-G,3/24/17,CLE,CHO,1,40,9,14,0.643,9,13,0.692,0,1,0,14,16,0.875,0,9,9,11,1,2,4,2,32,33
C.J. McCollum,25-141,G,2/7/17,POR,DAL,1,39,13,21,0.619,11,17,0.647,2,4,0.5,4,4,1,2,0,2,3,1,0,2,4,32,23.4
LeBron James,32-038,F-G,2/6/17,CLE,WAS,1,42,12,18,0.667,6,10,0.6,6,8,0.75,2,5,0.4,0,7,7,17,2,2,6,6,32,32
Marc Gasol,31-358,C,1/21/17,MEM,HOU,1,37,12,20,0.6,10,15,0.667,2,5,0.4,6,11,0.545,2,3,5,1,1,3,5,4,32,20.3
Paul Millsap,31-326,F,1/1/17,ATL,SAS,1,47,11,23,0.478,8,17,0.471,3,6,0.5,7,10,0.7,3,10,13,3,0,1,2,5,32,23
Paul George,26-242,F,12/30/16,IND,CHI,1,37,10,20,0.5,7,10,0.7,3,10,0.3,9,9,1,0,4,4,1,2,0,4,4,32,20.3
LeBron James,32-100,F-G,4/9/17,CLE,ATL,1,47,11,21,0.524,10,18,0.556,1,3,0.333,9,10,0.9,3,13,16,10,1,0,3,6,32,29.9
Kawhi Leonard,25-224,F,2/8/17,SAS,PHI,1,37,9,18,0.5,6,11,0.545,3,7,0.429,11,11,1,1,5,6,5,0,0,2,2,32,25.9
Nick Young,31-199,G-F,12/17/16,LAL,CLE,1,38,12,19,0.632,4,5,0.8,8,14,0.571,0,0,,0,2,2,3,1,0,0,5,32,25.2
Kemba Walker,26-242,G,1/5/17,CHO,DET,1,36,12,24,0.5,8,15,0.533,4,9,0.444,4,5,0.8,1,6,7,5,0,0,3,4,32,21
Giannis Antetokounmpo,22-106,F-G,3/22/17,MIL,SAC,1,40,12,22,0.545,11,20,0.55,1,2,0.5,7,10,0.7,3,11,14,5,2,1,0,2,32,31
Skal Labissiere,20-362,F,3/15/17,SAC,PHO,0,30,11,15,0.733,10,14,0.714,1,1,1,9,11,0.818,2,9,11,0,2,0,3,2,32,27.4
DeMar DeRozan,27-208,G,3/3/17,TOR,WAS,1,38,10,17,0.588,7,14,0.5,3,3,1,9,12,0.75,2,11,13,5,0,0,4,2,32,26.3
Russell Westbrook,28-139,G,3/31/17,OKC,SAS,1,37,8,22,0.364,6,15,0.4,2,7,0.286,14,15,0.933,2,13,15,12,0,0,8,1,32,24.7
Gordon Hayward,26-253,F-G,12/1/16,UTA,MIA,1,40,12,22,0.545,9,15,0.6,3,7,0.429,5,6,0.833,1,2,3,7,2,0,0,0,32,29.2
LeBron James,32-036,F-G,2/4/17,CLE,NYK,1,40,12,20,0.6,8,12,0.667,4,8,0.5,4,5,0.8,0,5,5,10,0,0,5,1,32,25.5
C.J. McCollum,25-187,G,3/25/17,POR,MIN,1,29,11,13,0.846,7,8,0.875,4,5,0.8,6,6,1,1,3,4,4,1,0,4,2,32,27.9
Karl-Anthony Towns,21-068,C-F,1/22/17,MIN,DEN,1,40,13,19,0.684,13,19,0.684,0,0,,6,8,0.75,2,10,12,7,0,4,6,4,32,27.6
D'Angelo Russell,20-266,G,11/15/16,LAL,BRK,1,31,11,20,0.55,4,7,0.571,7,13,0.538,3,4,0.75,1,7,8,4,3,0,3,1,32,27.2
Hassan Whiteside,27-161,C,11/21/16,MIA,PHI,1,33,13,19,0.684,13,19,0.684,0,0,,6,8,0.75,7,6,13,0,0,2,3,5,32,26.2
Giannis Antetokounmpo,22-043,F-G,1/18/17,MIL,HOU,1,37,13,20,0.65,12,16,0.75,1,4,0.25,5,6,0.833,1,10,11,6,1,3,4,3,32,28.6
Shabazz Napier,25-270,G,4/10/17,POR,SAS,1,37,9,20,0.45,5,13,0.385,4,7,0.571,10,11,0.909,2,4,6,5,0,0,4,3,32,22.1
Kevin Durant,28-085,F-G,12/23/16,GSW,DET,1,32,13,18,0.722,10,14,0.714,3,4,0.75,3,4,0.75,0,8,8,3,0,0,4,5,32,22.7
Kawhi Leonard,25-229,F,2/13/17,SAS,IND,1,39,13,23,0.565,11,20,0.55,2,3,0.667,4,5,0.8,0,6,6,3,5,0,2,0,32,27.6
Eric Bledsoe,27-002,G,12/11/16,PHO,NOP,1,40,13,26,0.5,10,15,0.667,3,11,0.273,3,4,0.75,1,2,3,8,2,0,4,6,32,21.1
Goran Dragic,30-258,G,1/19/17,MIA,DAL,1,38,11,15,0.733,7,11,0.636,4,4,1,6,10,0.6,2,4,6,2,0,0,1,3,32,26.1
Giannis Antetokounmpo,22-092,F-G,3/8/17,MIL,NYK,1,41,11,21,0.524,11,20,0.55,0,1,0,10,13,0.769,6,7,13,7,4,2,1,2,32,35.3
DeMarcus Cousins,26-132,C-F,12/23/16,SAC,MIN,1,37,13,24,0.542,10,18,0.556,3,6,0.5,3,5,0.6,2,5,7,7,4,2,5,3,32,26.6
Aaron Gordon,21-196,F,3/31/17,ORL,BOS,1,36,11,24,0.458,8,19,0.421,3,5,0.6,7,8,0.875,5,11,16,1,1,2,0,2,32,28.3
James Harden,27-122,G,12/26/16,HOU,PHO,1,30,9,18,0.5,7,9,0.778,2,9,0.222,12,15,0.8,1,4,5,12,0,0,7,4,32,23.5
Danilo Gallinari,28-173,F,1/28/17,DEN,PHO,1,37,9,14,0.643,6,9,0.667,3,5,0.6,11,11,1,1,7,8,1,0,0,1,0,32,28.3
DeMarcus Cousins,26-175,C-F,2/4/17,SAC,GSW,1,40,13,30,0.433,13,25,0.52,0,5,0,6,6,1,3,12,15,8,2,1,7,5,32,21.2
Paul George,26-246,F,1/3/17,IND,DET,1,36,10,17,0.588,8,14,0.571,2,3,0.667,10,10,1,1,5,6,2,0,2,2,0,32,27.1
Karl-Anthony Towns,21-135,C-F,3/30/17,MIN,LAL,1,41,11,22,0.5,9,19,0.474,2,3,0.667,8,10,0.8,6,3,9,2,2,1,3,5,32,24.4
Kyle Lowry,30-308,G,1/27/17,TOR,MIL,1,39,9,18,0.5,6,12,0.5,3,6,0.5,11,14,0.786,2,1,3,6,1,0,2,1,32,26.3
Marc Gasol,31-364,C,1/27/17,MEM,POR,1,40,12,21,0.571,10,16,0.625,2,5,0.4,6,6,1,1,7,8,5,0,4,2,5,32,27.2
Mike Conley,29-125,G,2/13/17,MEM,BRK,1,37,10,16,0.625,8,12,0.667,2,4,0.5,10,11,0.909,1,0,1,6,1,0,1,3,32,28.1
Dario Saric,22-350,F,3/24/17,PHI,CHI,1,34,12,19,0.632,10,14,0.714,2,5,0.4,6,8,0.75,2,8,10,2,1,0,4,4,32,23.3
Julius Randle,22-106,F,3/15/17,LAL,HOU,1,29,13,17,0.765,13,16,0.813,0,1,0,6,9,0.667,3,5,8,2,0,0,2,4,32,25.5
Brandon Knight,24-350,G,11/16/16,PHO,DEN,0,28,12,20,0.6,9,15,0.6,3,5,0.6,5,7,0.714,1,3,4,4,1,0,1,1,32,26
Kawhi Leonard,25-226,F,2/10/17,SAS,DET,1,33,11,22,0.5,8,14,0.571,3,8,0.375,7,9,0.778,0,6,6,5,1,0,3,2,32,22.7
Karl-Anthony Towns,21-143,C-F,4/7/17,MIN,UTA,1,32,12,21,0.571,9,16,0.563,3,5,0.6,5,5,1,3,10,13,2,1,0,3,4,32,25
James Harden,27-073,G,11/7/16,HOU,WAS,1,40,9,19,0.474,6,12,0.5,3,7,0.429,11,11,1,0,5,5,15,0,0,7,2,32,26.5
Jonas Valanciunas,24-173,C,10/26/16,TOR,DET,1,35,10,15,0.667,10,15,0.667,0,0,,12,14,0.857,6,5,11,1,0,0,1,4,32,28.5
Kawhi Leonard,25-279,F,4/4/17,SAS,MEM,1,40,10,24,0.417,5,16,0.313,5,8,0.625,7,8,0.875,0,12,12,4,2,1,1,5,32,24.9
Joel Embiid,22-317,C-F,1/27/17,PHI,HOU,1,28,11,20,0.55,7,14,0.5,4,6,0.667,6,6,1,1,6,7,4,3,2,5,3,32,25.9
Kyrie Irving,24-348,G,3/6/17,CLE,MIA,1,40,11,25,0.44,7,16,0.438,4,9,0.444,6,7,0.857,2,5,7,3,0,1,3,1,32,20.8
Stephen Curry,29-014,G,3/28/17,GSW,HOU,1,33,11,22,0.5,8,11,0.727,3,11,0.273,7,10,0.7,2,8,10,7,2,0,6,5,32,22.5
Hassan Whiteside,27-190,C,12/20/16,MIA,ORL,1,47,14,22,0.636,14,22,0.636,0,0,,4,6,0.667,4,11,15,0,1,5,1,5,32,29
DeMarcus Cousins,26-104,C-F,11/25/16,SAC,HOU,1,30,12,22,0.545,7,13,0.538,5,9,0.556,3,5,0.6,0,9,9,1,0,5,4,5,32,21.5
Russell Westbrook,28-056,G,1/7/17,OKC,DEN,1,35,10,20,0.5,3,8,0.375,7,12,0.583,5,6,0.833,2,15,17,11,3,0,5,3,32,32
Isaiah Thomas,28-050,G,3/29/17,BOS,MIL,1,37,9,17,0.529,4,8,0.5,5,9,0.556,9,9,1,1,4,5,4,3,0,4,2,32,26.6
Paul George,26-269,F,1/26/17,IND,MIN,1,37,12,22,0.545,9,18,0.5,3,4,0.75,5,6,0.833,1,3,4,5,1,0,3,4,32,22.5
Blake Griffin,27-329,F,2/8/17,LAC,NYK,1,36,11,23,0.478,9,20,0.45,2,3,0.667,8,11,0.727,3,5,8,5,2,0,0,2,32,27.4
LeBron James,32-001,F-G,12/31/16,CLE,CHO,1,36,12,25,0.48,8,17,0.471,4,8,0.5,4,6,0.667,2,4,6,9,1,0,1,1,32,27
Brandon Jennings,27-099,G,12/31/16,NYK,HOU,1,41,12,22,0.545,9,14,0.643,3,8,0.375,5,7,0.714,1,4,5,7,0,1,2,0,32,26.1
Mike Conley,29-146,G,3/6/17,MEM,BRK,1,39,9,15,0.6,6,10,0.6,3,5,0.6,11,14,0.786,0,3,3,6,1,0,2,5,32,26
Ersan Ilyasova,29-259,F,1/29/17,PHI,CHI,1,35,11,19,0.579,9,12,0.75,2,7,0.286,7,9,0.778,5,6,11,1,1,0,3,2,31,24.5
Dennis Schroder,23-095,G,12/19/16,ATL,OKC,1,40,10,16,0.625,9,13,0.692,1,3,0.333,10,10,1,2,3,5,8,0,0,4,1,31,27.3
Paul George,26-266,F,1/23/17,IND,NYK,1,39,11,24,0.458,8,14,0.571,3,10,0.3,6,7,0.857,1,6,7,3,2,0,3,3,31,20.6
Giannis Antetokounmpo,22-048,F-G,1/23/17,MIL,HOU,1,36,11,17,0.647,9,14,0.643,2,3,0.667,7,8,0.875,3,4,7,3,1,4,5,3,31,26.1
James Harden,27-116,G,12/20/16,HOU,SAS,1,37,10,26,0.385,9,15,0.6,1,11,0.091,10,10,1,2,8,10,7,0,0,3,1,31,22.1
Troy Daniels,25-141,G,12/3/16,MEM,LAL,0,34,12,23,0.522,6,11,0.545,6,12,0.5,1,3,0.333,1,1,2,4,1,1,0,2,31,23.6
Kawhi Leonard,25-247,F,3/3/17,SAS,NOP,1,40,11,26,0.423,10,21,0.476,1,5,0.2,8,10,0.8,1,6,7,6,3,0,1,1,31,24.7
Bradley Beal,23-210,G,1/24/17,WAS,BOS,1,35,12,18,0.667,10,13,0.769,2,5,0.4,5,5,1,0,2,2,5,2,0,5,3,31,23.1
Jimmy Butler,27-087,G-F,12/10/16,CHI,MIA,1,38,8,15,0.533,8,15,0.533,0,0,,15,16,0.938,1,6,7,4,3,0,2,2,31,28.8
Doug McDermott,25-012,F,1/15/17,CHI,MEM,0,33,9,16,0.563,6,10,0.6,3,6,0.5,10,11,0.909,0,6,6,0,1,1,1,0,31,25.5
LeBron James,31-361,F-G,12/25/16,CLE,GSW,1,40,12,22,0.545,8,14,0.571,4,8,0.5,3,7,0.429,5,8,13,4,2,1,5,2,31,24.4
LeBron James,32-028,F-G,1/27/17,CLE,BRK,1,34,13,18,0.722,12,15,0.8,1,3,0.333,4,7,0.571,0,5,5,11,0,0,5,1,31,26.2
Anthony Davis,23-284,F-C,12/20/16,NOP,PHI,1,35,12,30,0.4,12,29,0.414,0,1,0,7,10,0.7,5,11,16,2,0,2,1,2,31,21.4
LeBron James,32-005,F-G,1/4/17,CLE,CHI,1,37,12,21,0.571,11,19,0.579,1,2,0.5,6,9,0.667,2,6,8,7,1,0,5,2,31,23.2
Eric Bledsoe,26-335,G,11/8/16,PHO,POR,1,31,9,13,0.692,7,10,0.7,2,3,0.667,11,12,0.917,0,4,4,4,0,0,2,3,31,25.9
DeMarcus Cousins,26-143,C-F,1/3/17,SAC,DEN,1,34,10,25,0.4,7,18,0.389,3,7,0.429,8,8,1,0,6,6,6,0,1,0,3,31,23
Jabari Parker,21-288,F,12/28/16,MIL,DET,1,34,13,18,0.722,9,11,0.818,4,7,0.571,1,1,1,0,9,9,7,1,0,1,2,31,30.4
DeMarcus Cousins,26-197,C-F,2/26/17,NOP,OKC,1,21,8,15,0.533,8,12,0.667,0,3,0,15,15,1,2,8,10,3,0,0,1,6,31,26.2
J.J. Redick,32-278,G,3/29/17,LAC,WAS,1,33,9,15,0.6,2,4,0.5,7,11,0.636,6,6,1,0,0,0,1,0,0,1,2,31,23
Bradley Beal,23-153,G,11/28/16,WAS,SAC,1,41,12,24,0.5,5,11,0.455,7,13,0.538,0,2,0,1,5,6,3,0,1,2,0,31,21.2
DeMar DeRozan,27-133,G,12/18/16,TOR,ORL,1,30,13,21,0.619,12,18,0.667,1,3,0.333,4,4,1,0,5,5,4,1,0,3,2,31,23
Gordon Hayward,26-279,F-G,12/27/16,UTA,LAL,1,34,10,17,0.588,7,11,0.636,3,6,0.5,8,9,0.889,3,6,9,3,0,1,0,0,31,29.4
Damian Lillard,26-109,G,11/1/16,POR,GSW,1,32,8,19,0.421,4,9,0.444,4,10,0.4,11,13,0.846,0,1,1,2,1,0,1,3,31,20.6
Damian Lillard,26-258,G,3/30/17,POR,HOU,1,38,10,18,0.556,6,9,0.667,4,9,0.444,7,7,1,0,4,4,11,2,0,3,1,31,29.9
Kemba Walker,26-264,G,1/27/17,CHO,NYK,1,37,13,29,0.448,11,18,0.611,2,11,0.182,3,4,0.75,2,8,10,5,0,1,1,1,31,22.1
C.J. McCollum,25-053,G,11/11/16,POR,SAC,1,39,13,24,0.542,11,16,0.688,2,8,0.25,3,4,0.75,0,1,1,5,4,0,1,5,31,23.8
Russell Westbrook,28-043,G,12/25/16,OKC,MIN,1,33,11,25,0.44,10,21,0.476,1,4,0.25,8,9,0.889,3,4,7,15,1,1,5,2,31,27.2
Carmelo Anthony,32-175,F,11/20/16,NYK,ATL,1,38,12,22,0.545,8,14,0.571,4,8,0.5,3,3,1,2,5,7,3,2,0,3,4,31,22.8
Anthony Davis,24-015,F-C,3/26/17,NOP,DEN,1,28,12,17,0.706,11,15,0.733,1,2,0.5,6,7,0.857,1,12,13,3,0,1,3,3,31,26.4
Stephen Curry,28-264,G,12/3/16,GSW,PHO,1,30,10,15,0.667,5,8,0.625,5,7,0.714,6,6,1,0,2,2,1,1,0,3,2,31,23
Mike Conley,29-041,G,11/21/16,MEM,CHO,1,37,11,21,0.524,6,13,0.462,5,8,0.625,4,4,1,0,4,4,2,3,0,1,3,31,24.1
DeMar DeRozan,27-147,G,1/1/17,TOR,LAL,1,35,10,25,0.4,10,25,0.4,0,0,,11,13,0.846,0,1,1,3,1,1,1,3,31,18.6
Zach LaVine,21-236,G,11/1/16,MIN,MEM,1,29,11,18,0.611,6,9,0.667,5,9,0.556,4,4,1,0,4,4,2,0,0,3,2,31,21.6
Karl-Anthony Towns,21-122,C-F,3/17/17,MIN,MIA,1,38,11,17,0.647,10,14,0.714,1,3,0.333,8,8,1,6,5,11,1,0,1,3,3,31,26.4
Goran Dragic,30-226,G,12/18/16,MIA,BOS,1,37,12,21,0.571,7,15,0.467,5,6,0.833,2,4,0.5,0,4,4,7,0,0,5,4,31,19.8
C.J. McCollum,25-166,G,3/4/17,POR,BRK,1,38,13,22,0.591,9,17,0.529,4,5,0.8,1,1,1,0,5,5,5,1,1,0,1,31,27.1
DeMarcus Cousins,26-155,C-F,1/15/17,SAC,OKC,1,34,8,20,0.4,7,14,0.5,1,6,0.167,14,17,0.824,6,5,11,7,3,1,6,2,31,26.5
Dwight Howard,30-330,C,11/2/16,ATL,LAL,1,32,12,16,0.75,12,16,0.75,0,0,,7,10,0.7,3,8,11,0,3,0,3,4,31,26.3
Stephen Curry,28-356,G,3/5/17,GSW,NYK,1,37,11,24,0.458,6,11,0.545,5,13,0.385,4,6,0.667,2,6,8,6,2,0,2,2,31,24.4
Jeff Teague,28-195,G,12/22/16,IND,BOS,1,35,9,15,0.6,7,11,0.636,2,4,0.5,11,11,1,1,3,4,8,0,1,4,4,31,26.4
Avery Bradley,25-338,G,10/29/16,BOS,CHO,1,36,11,19,0.579,3,8,0.375,8,11,0.727,1,2,0.5,1,10,11,4,1,0,1,4,31,26.6
Klay Thompson,27-046,G,3/26/17,GSW,MEM,1,35,12,18,0.667,5,7,0.714,7,11,0.636,0,0,,0,2,2,1,0,0,1,1,31,23.1
Kemba Walker,26-327,G,3/31/17,CHO,DEN,1,41,9,23,0.391,5,13,0.385,4,10,0.4,9,11,0.818,1,2,3,8,1,0,1,0,31,24.6
Devin Booker,20-048,G,12/17/16,PHO,OKC,1,33,11,22,0.5,8,17,0.471,3,5,0.6,6,7,0.857,1,2,3,5,1,0,6,3,31,18.2
Harrison Barnes,24-241,F,1/26/17,DAL,OKC,1,39,13,26,0.5,11,24,0.458,2,2,1,3,3,1,0,2,2,2,1,0,0,2,31,20.2
Kawhi Leonard,25-160,F,12/6/16,SAS,MIN,1,36,11,15,0.733,9,12,0.75,2,3,0.667,7,8,0.875,0,1,1,4,2,0,1,1,31,28.2
Dennis Schroder,23-174,G,3/8/17,ATL,BRK,1,36,10,21,0.476,9,17,0.529,1,4,0.25,10,10,1,0,2,2,5,3,0,4,3,31,22.2
Carmelo Anthony,32-237,F,1/21/17,NYK,PHO,1,41,9,17,0.529,4,11,0.364,5,6,0.833,8,10,0.8,1,6,7,6,1,0,3,2,31,25.8
Harrison Barnes,24-307,F,4/2/17,DAL,MIL,1,39,9,13,0.692,6,8,0.75,3,5,0.6,10,10,1,0,2,2,0,1,0,3,2,31,23.3
Gordon Hayward,26-325,F-G,2/11/17,UTA,BOS,1,38,10,19,0.526,6,10,0.6,4,9,0.444,7,7,1,0,1,1,4,1,0,1,2,31,24
Isaiah Thomas,27-326,G,12/29/16,BOS,CLE,1,34,8,13,0.615,6,8,0.75,2,5,0.4,13,13,1,1,2,3,9,2,0,3,1,31,31.3
Serge Ibaka,27-056,F-C,11/13/16,ORL,OKC,1,37,13,19,0.684,11,17,0.647,2,2,1,3,3,1,3,6,9,0,0,4,2,4,31,26
Dennis Schroder,23-076,G,11/30/16,ATL,PHO,1,36,13,23,0.565,11,17,0.647,2,6,0.333,3,3,1,1,3,4,9,0,1,5,3,31,22.5
Isaiah Thomas,28-022,G,3/1/17,BOS,CLE,1,35,10,20,0.5,7,11,0.636,3,9,0.333,8,12,0.667,1,1,2,5,2,1,4,2,31,21.8
Damian Lillard,26-260,G,4/1/17,POR,PHO,1,35,7,16,0.438,3,5,0.6,4,11,0.364,13,13,1,1,4,5,7,1,0,4,3,31,25.2
Kyrie Irving,24-273,G,12/21/16,CLE,MIL,1,35,11,17,0.647,10,15,0.667,1,2,0.5,8,9,0.889,0,6,6,13,1,0,4,2,31,30.2
Blake Griffin,28-014,F,3/30/17,LAC,PHO,1,38,12,19,0.632,10,17,0.588,2,2,1,5,7,0.714,0,7,7,2,2,0,3,4,31,22.6
Kawhi Leonard,25-197,F,1/12/17,SAS,LAL,1,26,10,13,0.769,7,8,0.875,3,5,0.6,8,9,0.889,0,2,2,2,2,0,0,0,31,29.5
Russell Westbrook,28-011,G,11/23/16,OKC,SAC,1,35,7,18,0.389,6,13,0.462,1,5,0.2,16,19,0.842,1,10,11,9,2,0,3,1,31,28.6
LeBron James,32-047,F-G,2/15/17,CLE,IND,1,33,12,17,0.706,8,12,0.667,4,5,0.8,3,4,0.75,0,5,5,4,1,0,4,2,31,24
Andrew Wiggins,21-336,F-G,1/24/17,MIN,PHO,1,39,11,22,0.5,9,18,0.5,2,4,0.5,7,8,0.875,2,4,6,3,2,0,2,1,31,23.9
Stephen Curry,28-254,G,11/23/16,GSW,LAL,1,29,11,18,0.611,4,6,0.667,7,12,0.583,2,2,1,0,5,5,9,1,0,1,1,31,30.2
Mike Conley,29-178,G,4/7/17,MEM,NYK,1,34,12,17,0.706,5,6,0.833,7,11,0.636,0,0,,0,3,3,6,1,0,3,0,31,27
Eric Bledsoe,27-030,G,1/8/17,PHO,CLE,1,39,12,18,0.667,8,10,0.8,4,8,0.5,3,3,1,0,2,2,8,2,1,3,3,31,27.9
Ryan Anderson,28-231,F,12/23/16,HOU,MEM,1,35,10,18,0.556,2,4,0.5,8,14,0.571,3,3,1,1,6,7,0,0,2,2,4,31,22.7
Damian Lillard,26-249,G,3/21/17,POR,MIL,1,40,13,26,0.5,11,17,0.647,2,9,0.222,3,6,0.5,1,4,5,7,4,0,1,0,31,26.6
Devin Booker,20-097,G,2/4/17,PHO,MIL,1,38,9,19,0.474,4,11,0.364,5,8,0.625,8,8,1,1,2,3,4,0,0,5,5,31,18.4
Mike Conley,29-138,G,2/26/17,MEM,DEN,1,35,9,16,0.563,4,7,0.571,5,9,0.556,8,11,0.727,0,4,4,5,2,0,1,1,31,27.5
Will Barton,26-031,G,2/6/17,DEN,DAL,1,37,12,18,0.667,7,11,0.636,5,7,0.714,2,2,1,1,7,8,5,0,2,3,5,31,25.9
Giannis Antetokounmpo,21-325,F-G,10/26/16,MIL,CHO,1,39,13,21,0.619,12,19,0.632,1,2,0.5,4,6,0.667,1,8,9,5,1,1,1,5,31,26
Harrison Barnes,24-151,F,10/28/16,DAL,HOU,1,39,13,23,0.565,11,19,0.579,2,4,0.5,3,3,1,1,4,5,1,1,0,1,2,31,21.9
Seth Curry,26-185,G,2/24/17,DAL,MIN,1,37,13,17,0.765,10,11,0.909,3,6,0.5,2,2,1,0,1,1,1,1,0,4,1,31,21.9
Paul George,26-284,F,2/10/17,IND,WAS,1,36,12,23,0.522,10,17,0.588,2,6,0.333,5,7,0.714,1,3,4,2,0,1,1,2,31,20.8
DeMar DeRozan,27-129,G,12/14/16,TOR,PHI,1,30,11,18,0.611,11,17,0.647,0,1,0,9,11,0.818,2,3,5,3,0,0,2,1,31,24
Eric Bledsoe,27-004,G,12/13/16,PHO,NYK,1,39,9,21,0.429,8,17,0.471,1,4,0.25,12,12,1,2,4,6,8,2,1,5,2,31,25
DeMar DeRozan,27-120,G,12/5/16,TOR,CLE,1,39,12,23,0.522,12,21,0.571,0,2,0,7,7,1,0,4,4,5,3,0,1,3,31,25.2
Bradley Beal,23-225,G,2/8/17,WAS,BRK,1,41,12,25,0.48,9,19,0.474,3,6,0.5,4,4,1,2,4,6,2,2,0,4,4,31,18.7
Carmelo Anthony,32-167,F,11/12/16,NYK,TOR,1,38,10,21,0.476,7,14,0.5,3,7,0.429,8,9,0.889,0,6,6,4,0,0,1,5,31,21.5
Harrison Barnes,24-255,F,2/9/17,DAL,UTA,1,43,12,20,0.6,10,17,0.588,2,3,0.667,5,7,0.714,0,4,4,1,0,0,1,3,31,20.7
Kawhi Leonard,25-245,F,3/1/17,SAS,IND,1,34,11,22,0.5,8,13,0.615,3,9,0.333,6,6,1,2,9,11,2,3,0,2,4,31,24.9
James Harden,27-222,G,4/5/17,HOU,DEN,1,39,8,19,0.421,4,9,0.444,4,10,0.4,11,15,0.733,0,7,7,10,1,3,4,3,31,26.3
Lou Williams,30-090,G,1/25/17,LAL,POR,0,28,10,20,0.5,4,9,0.444,6,11,0.545,5,5,1,0,4,4,5,3,0,1,1,31,27.3
Eric Gordon,28-008,G,1/2/17,HOU,WAS,0,36,11,18,0.611,5,6,0.833,6,12,0.5,3,4,0.75,0,2,2,3,0,1,3,4,31,21.2
Zach LaVine,21-261,G,11/26/16,MIN,GSW,1,39,13,24,0.542,8,12,0.667,5,12,0.417,0,0,,0,3,3,3,1,0,4,4,31,17.8
Nicolas Batum,28-115,F-G,4/8/17,CHO,BOS,1,41,11,23,0.478,7,15,0.467,4,8,0.5,5,7,0.714,1,7,8,3,0,0,1,1,31,22
Lou Williams,30-150,G,3/26/17,HOU,OKC,0,31,11,15,0.733,4,7,0.571,7,8,0.875,2,2,1,0,3,3,4,1,0,3,1,31,26.2
James Harden,27-085,G,11/19/16,HOU,UTA,1,35,10,24,0.417,6,14,0.429,4,10,0.4,7,9,0.778,0,4,4,10,0,2,0,3,31,25.8
DeMar DeRozan,27-183,G,2/6/17,TOR,LAC,1,38,11,22,0.5,9,19,0.474,2,3,0.667,7,9,0.778,2,3,5,2,1,0,0,1,31,23.5
Nikola Jokic,22-013,C-F,3/4/17,DEN,CHO,1,33,13,15,0.867,13,15,0.867,0,0,,5,8,0.625,3,11,14,4,1,0,4,1,31,29.3
Kristaps Porzingis,21-112,F-C,11/22/16,NYK,POR,1,40,13,23,0.565,10,15,0.667,3,8,0.375,2,2,1,3,6,9,1,0,1,2,4,31,21.8
Reggie Jackson,26-267,G,1/8/17,DET,POR,1,47,13,26,0.5,11,20,0.55,2,6,0.333,3,4,0.75,1,0,1,3,2,0,2,4,31,18.8
Gordon Hayward,26-251,F-G,11/29/16,UTA,HOU,1,36,8,16,0.5,5,10,0.5,3,6,0.5,12,13,0.923,0,5,5,7,0,0,0,0,31,29
Giannis Antetokounmpo,22-117,F-G,4/2/17,MIL,DAL,1,40,10,18,0.556,10,15,0.667,0,3,0,11,12,0.917,1,14,15,9,4,2,5,2,31,32.8
LeBron James,31-329,F-G,11/23/16,CLE,POR,1,38,11,21,0.524,9,18,0.5,2,3,0.667,7,8,0.875,1,9,10,13,3,0,3,0,31,32.8
Andrew Wiggins,21-351,F-G,2/8/17,MIN,TOR,1,38,11,19,0.579,10,17,0.588,1,2,0.5,8,9,0.889,2,3,5,6,2,1,3,2,31,27.1
Devin Booker,20-153,G,4/1/17,PHO,POR,1,42,10,25,0.4,10,21,0.476,0,4,0,11,14,0.786,1,2,3,7,3,0,7,2,31,17.7
Dwyane Wade,35-020,G,2/6/17,CHI,SAC,1,30,12,18,0.667,12,18,0.667,0,0,,7,10,0.7,0,6,6,3,1,2,0,3,31,27.1
DeMarcus Cousins,26-121,C-F,12/12/16,SAC,LAL,1,35,12,22,0.545,10,19,0.526,2,3,0.667,5,7,0.714,2,15,17,5,2,3,8,3,31,23.9
Eric Bledsoe,27-038,G,1/16/17,PHO,UTA,1,37,11,20,0.55,9,14,0.643,2,6,0.333,7,7,1,2,7,9,9,1,0,2,1,31,29.8
Anthony Davis,23-359,F-C,3/5/17,NOP,LAL,1,36,10,22,0.455,10,21,0.476,0,1,0,11,17,0.647,2,7,9,2,2,3,1,0,31,25.2
Blake Griffin,27-323,F,2/2/17,LAC,GSW,1,30,10,19,0.526,10,19,0.526,0,0,,11,13,0.846,5,3,8,2,3,1,3,2,31,26.6
Nicolas Batum,28-074,F-G,2/26/17,CHO,LAC,1,43,9,18,0.5,1,5,0.2,8,13,0.615,5,5,1,0,8,8,4,0,1,5,3,31,21.7
Kawhi Leonard,25-257,F,3/13/17,SAS,ATL,1,39,10,24,0.417,7,16,0.438,3,8,0.375,8,10,0.8,0,5,5,4,0,1,5,4,31,15.8
Kemba Walker,26-322,G,3/26/17,CHO,PHO,1,38,10,18,0.556,6,9,0.667,4,9,0.444,7,7,1,0,4,4,9,0,1,1,1,31,29.2
Andrew Wiggins,21-336,F-G,1/24/17,MIN,PHO,1,39,11,22,0.5,9,18,0.5,2,4,0.5,7,8,0.875,2,4,6,3,2,0,2,1,31,23.9
Anthony Davis,23-327,F-C,2/1/17,NOP,DET,1,41,13,24,0.542,13,23,0.565,0,1,0,5,6,0.833,2,10,12,2,2,4,5,3,31,23.4
Bradley Beal,23-155,G,11/30/16,WAS,OKC,1,42,10,21,0.476,6,11,0.545,4,10,0.4,7,10,0.7,1,4,5,1,2,0,4,5,31,17.7
Harrison Barnes,24-162,F,11/8/16,DAL,LAL,1,40,11,18,0.611,10,15,0.667,1,3,0.333,8,9,0.889,0,2,2,2,0,0,1,3,31,22.2
Anthony Davis,23-259,F-C,11/25/16,NOP,POR,1,43,10,17,0.588,8,13,0.615,2,4,0.5,9,13,0.692,0,13,13,2,0,5,1,1,31,28.9
Marc Gasol,32-005,C,2/3/17,MEM,OKC,1,42,14,24,0.583,14,20,0.7,0,4,0,3,3,1,0,4,4,8,2,1,1,4,31,26.7
Russell Westbrook,28-008,G,11/20/16,OKC,IND,1,40,13,34,0.382,11,26,0.423,2,8,0.25,3,5,0.6,5,6,11,15,2,0,7,3,31,21.2
Jordan Clarkson,24-278,G,3/12/17,LAL,PHI,0,34,10,16,0.625,10,14,0.714,0,2,0,10,11,0.909,2,4,6,8,1,1,2,0,30,30.3
Allen Crabbe,24-274,G-F,1/8/17,POR,DET,0,43,12,15,0.8,7,10,0.7,5,5,1,1,1,1,0,1,1,1,1,0,2,3,30,23.1
Sam Dekker,22-260,F,1/21/17,HOU,MEM,1,35,12,19,0.632,6,8,0.75,6,11,0.545,0,0,,0,5,5,0,2,0,0,4,30,23.4
John Wall,26-183,G,3/8/17,WAS,DEN,1,35,12,19,0.632,10,13,0.769,2,6,0.333,4,5,0.8,1,2,3,10,1,0,4,1,30,26
Goran Dragic,30-281,G,2/11/17,MIA,PHI,1,37,12,21,0.571,10,17,0.588,2,4,0.5,4,4,1,0,5,5,2,2,0,7,3,30,16.8
Carmelo Anthony,32-241,F,1/25/17,NYK,DAL,1,39,13,24,0.542,10,17,0.588,3,7,0.429,1,2,0.5,1,7,8,3,0,0,7,3,30,14.7
Russell Westbrook,28-006,G,11/18/16,OKC,BRK,1,34,13,21,0.619,13,20,0.65,0,1,0,4,5,0.8,3,7,10,13,1,0,3,0,30,31.4
Kawhi Leonard,25-147,F,11/23/16,SAS,CHO,1,37,14,21,0.667,12,14,0.857,2,7,0.286,0,1,0,2,3,5,4,1,1,0,2,30,26.5
Brook Lopez,28-315,C,2/10/17,BRK,MIA,1,31,10,17,0.588,9,14,0.643,1,3,0.333,9,12,0.75,3,5,8,1,0,2,3,0,30,23.6
Damian Lillard,26-143,G,12/5/16,POR,CHI,1,34,11,24,0.458,8,18,0.444,3,6,0.5,5,5,1,0,3,3,7,2,3,0,2,30,26.7
Damian Lillard,26-251,G,3/23/17,POR,NYK,1,31,9,17,0.529,5,10,0.5,4,7,0.571,8,8,1,0,4,4,5,2,0,2,1,30,26
Gordon Hayward,27-012,F-G,4/4/17,UTA,POR,1,35,12,20,0.6,8,14,0.571,4,6,0.667,2,2,1,0,4,4,2,0,1,1,0,30,23.1
Derrick Rose,28-106,G,1/18/17,NYK,BOS,1,33,13,24,0.542,13,24,0.542,0,0,,4,4,1,4,6,10,5,2,2,4,3,30,24.7
Dwyane Wade,35-004,G,1/21/17,CHI,SAC,1,35,9,20,0.45,9,18,0.5,0,2,0,12,15,0.8,3,3,6,4,4,4,2,0,30,29
Gordon Hayward,26-340,F-G,2/26/17,UTA,WAS,1,40,11,22,0.5,7,16,0.438,4,6,0.667,4,8,0.5,2,7,9,2,0,0,3,2,30,18.5
Damian Lillard,26-145,G,12/7/16,POR,MIL,1,39,8,18,0.444,3,5,0.6,5,13,0.385,9,9,1,0,7,7,6,0,0,2,1,30,24.5
Kemba Walker,26-296,G,2/28/17,CHO,LAL,1,34,9,18,0.5,4,9,0.444,5,9,0.556,7,7,1,0,5,5,7,0,0,3,0,30,24.4
James Harden,27-216,G,3/30/17,HOU,POR,1,37,11,30,0.367,9,17,0.529,2,13,0.154,6,7,0.857,2,6,8,4,1,0,6,2,30,13.2
Emmanuel Mudiay,20-246,G,11/6/16,DEN,BOS,1,39,11,18,0.611,8,13,0.615,3,5,0.6,5,5,1,2,6,8,2,1,1,7,3,30,19.9
LeBron James,32-072,F-G,3/12/17,CLE,HOU,1,40,12,20,0.6,8,9,0.889,4,11,0.364,2,3,0.667,0,7,7,5,2,0,8,2,30,19.2
Stephen Curry,28-244,G,11/13/16,GSW,PHO,1,37,9,17,0.529,4,8,0.5,5,9,0.556,7,7,1,0,6,6,6,2,0,3,2,30,25.9
Gordon Hayward,26-285,F-G,1/2/17,UTA,BRK,1,35,9,18,0.5,6,14,0.429,3,4,0.75,9,9,1,0,4,4,3,2,1,2,1,30,24.6
Jeff Teague,28-152,G,11/9/16,IND,PHI,1,41,10,16,0.625,9,13,0.692,1,3,0.333,9,10,0.9,0,2,2,9,2,1,1,1,30,30.6
Mike Conley,29-036,G,11/16/16,MEM,LAC,1,38,9,12,0.75,2,3,0.667,7,9,0.778,5,6,0.833,0,5,5,8,3,0,4,2,30,30.1
Kawhi Leonard,25-125,F,11/1/16,SAS,UTA,1,36,10,18,0.556,5,11,0.455,5,7,0.714,5,5,1,0,7,7,2,2,0,2,1,30,24.5
Kyle Lowry,30-305,G,1/24/17,TOR,SAS,1,42,9,23,0.391,8,16,0.5,1,7,0.143,11,12,0.917,0,5,5,2,0,1,5,4,30,14.1
Paul George,26-183,F,11/1/16,IND,LAL,1,37,8,16,0.5,6,11,0.545,2,5,0.4,12,12,1,2,5,7,1,4,1,6,2,30,23.5
Kevin Durant,28-048,F-G,11/16/16,GSW,TOR,1,36,11,21,0.524,8,13,0.615,3,8,0.375,5,6,0.833,2,7,9,6,1,0,4,3,30,22.8
LeBron James,32-066,F-G,3/6/17,CLE,MIA,1,39,11,22,0.5,9,17,0.529,2,5,0.4,6,10,0.6,3,14,17,6,1,1,3,2,30,25.8
Brook Lopez,28-228,C,11/15/16,BRK,LAL,1,31,10,25,0.4,6,14,0.429,4,11,0.364,6,7,0.857,3,7,10,3,0,3,2,2,30,21.7
Kawhi Leonard,25-195,F,1/10/17,SAS,MIL,1,36,10,16,0.625,8,13,0.615,2,3,0.667,8,10,0.8,2,5,7,2,3,3,1,1,30,30
John Wall,26-097,G,12/12/16,WAS,MIA,1,38,12,26,0.462,11,21,0.524,1,5,0.2,5,6,0.833,2,4,6,8,1,1,5,1,30,20.7
Paul Millsap,31-313,F,12/19/16,ATL,OKC,1,39,12,18,0.667,9,13,0.692,3,5,0.6,3,3,1,2,9,11,1,1,1,4,3,30,23.5
Russell Westbrook,28-004,G,11/16/16,OKC,HOU,1,36,9,20,0.45,7,16,0.438,2,4,0.5,10,11,0.909,1,6,7,9,2,0,6,0,30,24
Kawhi Leonard,25-164,F,12/10/16,SAS,BRK,1,27,10,18,0.556,6,11,0.545,4,7,0.571,6,6,1,1,6,7,3,1,1,0,1,30,27.3
George Hill,30-262,G,1/21/17,UTA,IND,1,34,9,16,0.563,6,11,0.545,3,5,0.6,9,11,0.818,1,5,6,5,1,0,1,4,30,25.7
Carmelo Anthony,32-262,F,2/15/17,NYK,OKC,1,39,11,20,0.55,5,13,0.385,6,7,0.857,2,2,1,0,4,4,4,1,2,4,4,30,21.2
Chris Paul,31-309,G,3/11/17,LAC,PHI,1,34,11,16,0.688,7,12,0.583,4,4,1,4,4,1,0,3,3,7,2,0,3,1,30,27.6
Hassan Whiteside,27-236,C,2/4/17,MIA,PHI,1,27,14,17,0.824,14,17,0.824,0,0,,2,3,0.667,6,14,20,0,0,3,3,1,30,30.4
LeBron James,31-309,F-G,11/3/16,CLE,BOS,1,36,12,22,0.545,11,18,0.611,1,4,0.25,5,5,1,1,6,7,12,1,0,2,2,30,28.5
Klay Thompson,27-030,G,3/10/17,GSW,MIN,1,36,12,22,0.545,9,16,0.563,3,6,0.5,3,4,0.75,0,5,5,2,1,0,2,1,30,20.5
Giannis Antetokounmpo,21-349,F-G,11/19/16,MIL,GSW,1,41,10,23,0.435,9,20,0.45,1,3,0.333,9,11,0.818,0,4,4,6,2,1,4,5,30,19.2
Stephen Curry,28-300,G,1/8/17,GSW,SAC,1,37,11,22,0.5,6,11,0.545,5,11,0.455,3,3,1,2,2,4,6,2,0,4,3,30,22
Klay Thompson,26-279,G,11/13/16,GSW,PHO,1,33,11,18,0.611,6,10,0.6,5,8,0.625,3,3,1,0,2,2,1,0,0,5,3,30,16.9
Myles Turner,20-216,F-C,10/26/16,IND,DAL,1,37,13,19,0.684,12,17,0.706,1,2,0.5,3,5,0.6,6,10,16,1,2,4,2,4,30,30.2
Isaiah Thomas,28-047,G,3/26/17,BOS,MIA,1,35,10,18,0.556,8,12,0.667,2,6,0.333,8,9,0.889,0,2,2,3,0,0,6,2,30,16.9
Kevin Love,28-113,F,12/29/16,CLE,BOS,1,34,10,22,0.455,4,6,0.667,6,16,0.375,4,4,1,3,12,15,2,2,0,4,4,30,22.1
Damian Lillard,26-189,G,1/20/17,POR,PHI,1,36,12,25,0.48,10,18,0.556,2,7,0.286,4,5,0.8,2,3,5,1,1,0,5,2,30,15.1
James Harden,27-126,G,12/30/16,HOU,LAC,1,34,10,15,0.667,8,10,0.8,2,5,0.4,8,9,0.889,1,12,13,10,5,2,6,1,30,34.4
Eric Bledsoe,27-000,G,12/9/16,PHO,LAL,1,33,10,18,0.556,7,13,0.538,3,5,0.6,7,8,0.875,0,4,4,9,3,1,1,0,30,31.2
Isaiah Thomas,27-273,G,11/6/16,BOS,DEN,1,33,9,17,0.529,8,13,0.615,1,4,0.25,11,12,0.917,0,1,1,5,1,0,4,3,30,20.9
John Wall,26-178,G,3/3/17,WAS,TOR,1,38,9,24,0.375,5,16,0.313,4,8,0.5,8,10,0.8,2,6,8,7,1,3,1,3,30,25
Harrison Barnes,24-224,F,1/9/17,DAL,MIN,1,34,13,23,0.565,9,18,0.5,4,5,0.8,0,0,,0,2,2,1,0,0,1,3,30,18.2
Lou Williams,30-139,G,3/15/17,HOU,LAL,0,32,11,17,0.647,4,8,0.5,7,9,0.778,1,1,1,0,4,4,7,2,1,3,3,30,27.1
Jrue Holiday,26-239,G,2/6/17,NOP,PHO,1,37,11,22,0.5,8,15,0.533,3,7,0.429,5,6,0.833,2,8,10,7,2,3,4,4,30,25.8
Giannis Antetokounmpo,22-060,F-G,2/4/17,MIL,PHO,1,34,12,20,0.6,12,17,0.706,0,3,0,6,9,0.667,2,10,12,6,0,4,4,4,30,25.4
Jabari Parker,21-280,F,12/20/16,MIL,CLE,1,46,13,25,0.52,13,23,0.565,0,2,0,4,7,0.571,3,6,9,3,0,0,0,3,30,21.3
Devin Booker,20-022,G,11/21/16,PHO,WAS,1,37,12,26,0.462,6,17,0.353,6,9,0.667,0,0,,1,1,2,2,0,0,2,4,30,15.4
Giannis Antetokounmpo,22-006,F-G,12/12/16,MIL,TOR,1,39,13,23,0.565,13,20,0.65,0,3,0,4,6,0.667,5,4,9,5,3,0,0,4,30,27.9
Nikola Vucevic,26-081,C,1/13/17,ORL,POR,1,32,13,18,0.722,13,18,0.722,0,0,,4,4,1,1,9,10,4,1,2,1,1,30,29.8
Mike Conley,29-143,G,3/3/17,MEM,DAL,1,36,9,15,0.6,6,9,0.667,3,6,0.5,9,10,0.9,0,2,2,4,1,0,1,4,30,24.5
Anthony Davis,23-244,F-C,11/10/16,NOP,MIL,1,41,11,24,0.458,11,24,0.458,0,0,,8,8,1,3,5,8,2,2,4,2,3,30,24.2
Kemba Walker,26-180,G,11/4/16,CHO,BRK,1,32,11,22,0.5,8,14,0.571,3,8,0.375,5,8,0.625,1,6,7,1,0,0,4,2,30,16.2
DeMar DeRozan,27-185,G,2/8/17,TOR,MIN,1,38,12,25,0.48,11,21,0.524,1,4,0.25,5,7,0.714,1,3,4,2,1,0,2,3,30,17.3
Devin Booker,20-028,G,11/27/16,PHO,DEN,1,36,11,27,0.407,7,17,0.412,4,10,0.4,4,5,0.8,0,3,3,4,1,0,1,5,30,16.8
Buddy Hield,23-115,G,4/11/17,SAC,PHO,1,33,12,20,0.6,8,12,0.667,4,8,0.5,2,3,0.667,1,4,5,0,1,0,2,4,30,19.7
Klay Thompson,26-307,G,12/11/16,GSW,MIN,1,39,11,21,0.524,7,9,0.778,4,12,0.333,4,4,1,2,4,6,2,1,1,2,2,30,22.6
James Harden,27-152,G,1/25/17,HOU,BOS,1,37,6,18,0.333,4,7,0.571,2,11,0.182,16,19,0.842,0,6,6,12,1,1,7,3,30,22.3
Solomon Hill,25-364,F,3/17/17,NOP,HOU,1,38,8,13,0.615,2,4,0.5,6,9,0.667,8,9,0.889,1,5,6,7,1,0,2,3,30,28.6
James Harden,27-068,G,11/2/16,HOU,NYK,1,34,9,16,0.563,4,4,1,5,12,0.417,7,8,0.875,1,5,6,15,2,0,3,1,30,33.3
Giannis Antetokounmpo,22-009,F-G,12/15/16,MIL,CHI,1,39,13,27,0.481,11,23,0.478,2,4,0.5,2,2,1,3,11,14,3,3,1,2,4,30,23.9
DeMar DeRozan,27-103,G,11/18/16,TOR,DEN,1,36,12,25,0.48,12,24,0.5,0,1,0,6,10,0.6,0,5,5,4,2,0,4,5,30,16
Kevin Durant,28-097,F-G,1/4/17,GSW,POR,1,38,9,16,0.563,6,8,0.75,3,8,0.375,9,9,1,0,5,5,4,2,3,2,3,30,27.6
James Harden,27-167,G,2/9/17,HOU,CHO,1,39,8,21,0.381,4,12,0.333,4,9,0.444,10,12,0.833,1,10,11,8,1,1,9,4,30,18.1
Khris Middleton,25-217,F-G,3/17/17,MIL,LAL,1,33,11,18,0.611,11,16,0.688,0,2,0,8,9,0.889,0,2,2,0,1,0,2,5,30,19
DeMarcus Cousins,26-080,C-F,11/1/16,SAC,MIA,1,35,8,16,0.5,8,16,0.5,0,0,,14,18,0.778,1,6,7,4,0,1,4,6,30,20
Carmelo Anthony,32-220,F,1/4/17,NYK,MIL,1,37,10,23,0.435,6,13,0.462,4,10,0.4,6,8,0.75,1,10,11,7,2,0,2,3,30,24.5
Jeff Teague,28-163,G,11/20/16,IND,OKC,1,40,9,16,0.563,6,12,0.5,3,4,0.75,9,9,1,0,5,5,9,6,0,3,2,30,32.4
Brook Lopez,29-000,C,4/1/17,BRK,ORL,1,28,12,22,0.545,10,16,0.625,2,6,0.333,4,5,0.8,2,5,7,1,0,2,1,1,30,22.6
T.J. Warren,23-053,F,10/28/16,PHO,OKC,1,46,13,18,0.722,12,16,0.75,1,2,0.5,3,4,0.75,1,8,9,1,3,0,4,5,30,23
DeMar DeRozan,27-127,G,12/12/16,TOR,MIL,1,32,7,11,0.636,6,10,0.6,1,1,1,15,15,1,1,2,3,3,0,0,2,0,30,26.5
Isaiah Thomas,27-270,G,11/3/16,BOS,CLE,1,34,8,19,0.421,8,13,0.615,0,6,0,14,14,1,0,3,3,6,0,0,3,3,30,20.8
Russell Westbrook,28-051,G,1/2/17,OKC,MIL,1,36,9,28,0.321,7,18,0.389,2,10,0.2,10,11,0.909,0,7,7,6,3,0,5,3,30,16.7
Kawhi Leonard,25-120,F,10/27/16,SAS,SAC,1,35,11,21,0.524,10,16,0.625,1,5,0.2,7,7,1,0,3,3,5,5,0,1,5,30,26.1
Anthony Davis,24-022,F-C,4/2/17,NOP,CHI,1,40,8,19,0.421,7,15,0.467,1,4,0.25,13,14,0.929,2,9,11,2,3,1,3,2,30,24.9
Aaron Gordon,21-101,F,12/26/16,ORL,MEM,1,34,11,14,0.786,7,10,0.7,4,4,1,4,5,0.8,1,1,2,1,1,1,0,4,30,26
Kevin Durant,28-029,F-G,10/28/16,GSW,NOP,1,39,9,19,0.474,9,16,0.563,0,3,0,12,12,1,0,17,17,6,2,2,2,2,30,30.2
Jrue Holiday,26-233,G,1/31/17,NOP,TOR,1,41,13,21,0.619,10,16,0.625,3,5,0.6,1,2,0.5,1,1,2,3,2,2,3,3,30,22.4
James Harden,27-071,G,11/5/16,HOU,ATL,1,37,10,19,0.526,6,11,0.545,4,8,0.5,6,7,0.857,1,8,9,11,3,0,8,4,30,24.5
Jamal Murray,20-043,G,4/7/17,DEN,NOP,1,38,10,14,0.714,8,8,1,2,6,0.333,8,8,1,2,2,4,5,2,0,3,0,30,28.7
Stephen Curry,28-274,G,12/13/16,GSW,NOP,1,34,11,23,0.478,6,14,0.429,5,9,0.556,3,4,0.75,2,2,4,7,1,0,2,2,30,23
Andrew Wiggins,22-002,F-G,2/25/17,MIN,HOU,1,37,11,22,0.5,10,17,0.588,1,5,0.2,7,8,0.875,2,0,2,2,3,0,6,5,30,16.4
Nikola Jokic,21-332,C-F,1/16/17,DEN,ORL,1,36,13,19,0.684,12,17,0.706,1,2,0.5,3,5,0.6,3,8,11,5,3,1,2,2,30,30
Anthony Davis,24-018,F-C,3/29/17,NOP,DAL,1,36,11,22,0.5,11,21,0.524,0,1,0,8,8,1,4,10,14,2,2,1,1,1,30,27.5
Carmelo Anthony,32-232,F,1/16/17,NYK,ATL,1,35,10,16,0.625,8,12,0.667,2,4,0.5,8,11,0.727,2,5,7,2,1,0,5,5,30,19.9
Kemba Walker,26-191,G,11/15/16,CHO,MIN,1,35,12,19,0.632,10,16,0.625,2,3,0.667,4,4,1,0,5,5,6,5,0,2,3,30,29
Gordon Hayward,26-320,F-G,2/6/17,UTA,ATL,1,30,12,18,0.667,10,13,0.769,2,5,0.4,4,5,0.8,2,5,7,5,2,0,2,3,30,27
Blake Griffin,28-004,F,3/20/17,LAC,NYK,1,31,12,19,0.632,9,15,0.6,3,4,0.75,3,7,0.429,3,3,6,2,1,1,1,3,30,23.8
DeMarcus Cousins,26-135,C-F,12/26/16,SAC,PHI,1,34,10,20,0.5,8,16,0.5,2,4,0.5,8,9,0.889,2,5,7,5,3,2,5,4,30,23.8
Nikola Jokic,22-033,C-F,3/24/17,DEN,IND,1,34,12,18,0.667,11,16,0.688,1,2,0.5,5,5,1,4,12,16,5,1,0,4,2,30,28.3
Isaiah Thomas,27-283,G,11/16/16,BOS,DAL,1,33,7,18,0.389,4,13,0.308,3,5,0.6,13,16,0.813,2,2,4,6,0,0,5,2,30,19.4
Derrick Rose,28-055,G,11/28/16,NYK,OKC,1,38,10,20,0.5,10,18,0.556,0,2,0,10,10,1,2,5,7,4,0,0,1,0,30,24.7
Eric Bledsoe,27-088,G,3/7/17,PHO,WAS,1,27,9,18,0.5,5,9,0.556,4,9,0.444,8,8,1,0,3,3,5,0,0,6,3,30,18.2
Mike Conley,29-024,G,11/4/16,MEM,LAC,1,37,9,20,0.45,2,9,0.222,7,11,0.636,5,7,0.714,0,2,2,10,1,2,0,2,30,28
Rudy Gay,30-076,F,11/1/16,SAC,MIA,1,42,11,24,0.458,9,20,0.45,2,4,0.5,6,6,1,0,12,12,1,1,0,2,2,30,20.1
Hassan Whiteside,27-299,C,4/8/17,MIA,WAS,1,37,12,19,0.632,12,19,0.632,0,0,,6,9,0.667,5,7,12,2,2,3,3,2,30,27.6
DeMarcus Cousins,26-234,C-F,4/4/17,NOP,DEN,1,36,10,22,0.455,7,14,0.5,3,8,0.375,7,8,0.875,5,9,14,9,1,1,2,6,30,28
James Harden,27-089,G,11/23/16,HOU,TOR,1,41,7,13,0.538,4,5,0.8,3,8,0.375,12,12,1,0,6,6,15,2,0,12,4,29,23.4
Damian Lillard,26-159,G,12/21/16,POR,DAL,1,39,10,23,0.435,7,14,0.5,3,9,0.333,6,6,1,0,3,3,4,1,0,6,0,29,15.6
C.J. McCollum,25-102,G,12/30/16,POR,SAS,1,33,10,19,0.526,9,15,0.6,1,4,0.25,8,8,1,0,2,2,1,1,0,3,3,29,17.8
Tim Hardaway,24-291,G,1/1/17,ATL,SAS,0,31,11,13,0.846,5,6,0.833,6,7,0.857,1,2,0.5,1,4,5,1,0,0,1,2,29,24.7
Karl-Anthony Towns,21-104,C-F,2/27/17,MIN,SAC,1,38,13,19,0.684,12,18,0.667,1,1,1,2,5,0.4,8,9,17,2,0,3,2,3,29,28.3
Kemba Walker,26-281,G,2/13/17,CHO,PHI,1,38,10,18,0.556,9,14,0.643,1,4,0.25,8,10,0.8,0,7,7,3,2,0,2,2,29,23
Anthony Davis,23-357,F-C,3/3/17,NOP,SAS,1,42,7,18,0.389,6,15,0.4,1,3,0.333,14,16,0.875,1,7,8,3,1,1,3,4,29,20.4
Kyle Lowry,30-220,G,10/31/16,TOR,DEN,1,36,10,20,0.5,9,15,0.6,1,5,0.2,8,10,0.8,0,5,5,7,3,0,3,4,29,23
D'Angelo Russell,21-001,G,2/24/17,LAL,OKC,1,36,12,26,0.462,9,14,0.643,3,12,0.25,2,3,0.667,1,3,4,6,4,0,4,2,29,20.2
LeBron James,31-357,F-G,12/21/16,CLE,MIL,1,34,12,24,0.5,8,17,0.471,4,7,0.571,1,1,1,1,8,9,6,0,0,2,0,29,22.3
Klay Thompson,26-359,G,2/1/17,GSW,CHO,1,33,10,19,0.526,4,9,0.444,6,10,0.6,3,3,1,1,4,5,8,1,2,1,1,29,28.2
Eric Bledsoe,26-348,G,11/21/16,PHO,WAS,1,40,10,25,0.4,7,16,0.438,3,9,0.333,6,7,0.857,2,7,9,6,2,2,4,2,29,21.4
Evan Fournier,24-005,G-F,11/3/16,ORL,SAC,1,36,10,15,0.667,7,8,0.875,3,7,0.429,6,7,0.857,0,1,1,1,0,0,3,0,29,20.1
Jimmy Butler,27-155,G-F,2/16/17,CHI,BOS,1,40,9,20,0.45,7,15,0.467,2,5,0.4,9,9,1,2,2,4,7,0,1,1,2,29,24.4
Karl-Anthony Towns,21-085,C-F,2/8/17,MIN,TOR,1,37,8,14,0.571,8,12,0.667,0,2,0,13,13,1,6,8,14,1,1,2,1,3,29,29.9
Blake Griffin,27-345,F,2/24/17,LAC,SAS,1,38,9,17,0.529,9,15,0.6,0,2,0,11,11,1,2,7,9,5,1,0,3,5,29,23.7
C.J. McCollum,25-194,G,4/1/17,POR,PHO,1,35,10,19,0.526,5,13,0.385,5,6,0.833,4,4,1,1,4,5,7,1,0,2,1,29,25.1
Ryan Anderson,28-209,F,12/1/16,HOU,GSW,1,45,9,17,0.529,4,7,0.571,5,10,0.5,6,7,0.857,2,3,5,0,0,0,2,4,29,19
DeAndre Jordan,28-182,C,1/19/17,LAC,MIN,1,39,12,15,0.8,12,15,0.8,0,0,,5,12,0.417,6,10,16,2,0,2,1,4,29,27.9
Mike Conley,29-140,G,2/28/17,MEM,PHO,1,39,10,19,0.526,7,13,0.538,3,6,0.5,6,8,0.75,1,2,3,8,0,0,0,2,29,25
Kyrie Irving,24-233,G,11/11/16,CLE,WAS,1,36,11,23,0.478,7,14,0.5,4,9,0.444,3,4,0.75,0,2,2,6,0,0,2,3,29,18.5
Tim Hardaway,25-006,G,3/22/17,ATL,WAS,1,36,9,16,0.563,6,8,0.75,3,8,0.375,8,9,0.889,2,0,2,3,2,1,0,4,29,25.6
Lou Williams,30-110,G,2/14/17,LAL,SAC,0,24,10,18,0.556,6,7,0.857,4,11,0.364,5,5,1,0,1,1,5,2,1,1,0,29,25.9
Blake Griffin,27-247,F,11/18/16,LAC,SAC,1,37,7,15,0.467,7,14,0.5,0,1,0,15,16,0.938,2,5,7,6,2,1,2,4,29,27.1
Brook Lopez,29-001,C,4/2/17,BRK,ATL,1,31,12,20,0.6,9,13,0.692,3,7,0.429,2,2,1,1,4,5,5,2,5,5,1,29,25.3
Andrew Wiggins,21-284,F-G,12/3/16,MIN,CHO,1,37,11,20,0.55,9,13,0.692,2,7,0.286,5,5,1,0,1,1,4,3,0,4,3,29,20.3
Eric Gordon,27-357,G,12/16/16,HOU,NOP,0,28,10,17,0.588,3,5,0.6,7,12,0.583,2,2,1,0,1,1,1,1,1,2,1,29,21.4
Seth Curry,26-188,G,2/27/17,DAL,MIA,1,36,10,17,0.588,5,10,0.5,5,7,0.714,4,4,1,0,1,1,3,0,0,1,3,29,21.3
Damian Lillard,26-205,G,2/5/17,POR,OKC,1,36,9,22,0.409,5,13,0.385,4,9,0.444,7,7,1,0,7,7,3,1,2,1,3,29,21.6
Andrew Wiggins,21-260,F-G,11/9/16,MIN,ORL,1,39,10,18,0.556,8,14,0.571,2,4,0.5,7,9,0.778,1,3,4,6,0,0,2,2,29,22.6
Russell Westbrook,28-045,G,12/27/16,OKC,MIA,1,37,11,22,0.5,11,21,0.524,0,1,0,7,10,0.7,0,17,17,11,0,0,7,0,29,22.6
James Harden,27-148,G,1/21/17,HOU,MEM,1,34,7,9,0.778,3,3,1,4,6,0.667,11,12,0.917,1,5,6,10,3,2,6,3,29,31.5
Andrew Wiggins,21-249,F-G,10/29/16,MIN,SAC,1,37,10,20,0.5,9,15,0.6,1,5,0.2,8,11,0.727,0,1,1,0,1,1,3,2,29,16
Andrew Wiggins,21-266,F-G,11/15/16,MIN,CHO,1,42,10,24,0.417,7,18,0.389,3,6,0.5,6,9,0.667,0,2,2,3,0,2,4,1,29,14.7
Gordon Hayward,26-338,F-G,2/24/17,UTA,MIL,1,34,11,17,0.647,10,13,0.769,1,4,0.25,6,7,0.857,1,2,3,4,0,0,1,3,29,23
Dennis Schroder,23-198,G,4/1/17,ATL,CHI,1,37,12,19,0.632,11,16,0.688,1,3,0.333,4,4,1,2,5,7,6,1,0,3,3,29,24.4
Damian Lillard,26-104,G,10/27/16,POR,LAC,1,36,11,24,0.458,9,19,0.474,2,5,0.4,5,7,0.714,1,9,10,3,0,0,4,6,29,14.9
Kawhi Leonard,25-128,F,11/4/16,SAS,UTA,1,32,9,18,0.5,8,13,0.615,1,5,0.2,10,10,1,4,7,11,4,1,1,1,2,29,27.6
DeMarcus Cousins,26-228,C-F,3/29/17,NOP,DAL,1,40,9,19,0.474,8,14,0.571,1,5,0.2,10,12,0.833,2,14,16,6,0,1,1,3,29,26.8
Kevin Durant,28-057,F-G,11/25/16,GSW,LAL,1,33,11,19,0.579,8,13,0.615,3,6,0.5,4,6,0.667,1,5,6,9,1,2,2,4,29,26.6
Kyrie Irving,24-230,G,11/8/16,CLE,ATL,1,39,11,27,0.407,10,20,0.5,1,7,0.143,6,7,0.857,0,1,1,4,0,1,0,3,29,16.7
Isaiah Thomas,28-006,G,2/13/17,BOS,DAL,1,34,9,19,0.474,5,9,0.556,4,10,0.4,7,9,0.778,0,1,1,8,0,0,1,2,29,22.6
Anthony Davis,23-349,F-C,2/23/17,NOP,HOU,1,33,8,21,0.381,8,19,0.421,0,2,0,13,16,0.813,3,6,9,1,2,2,3,2,29,20.5
Rudy Gay,30-086,F,11/11/16,SAC,POR,1,43,9,18,0.5,7,14,0.5,2,4,0.5,9,10,0.9,4,10,14,3,2,1,6,2,29,23.4
Kyle Lowry,30-306,G,1/25/17,TOR,MEM,1,40,11,21,0.524,7,11,0.636,4,10,0.4,3,3,1,2,2,4,8,1,1,0,1,29,27.6
LeBron James,32-011,F-G,1/10/17,CLE,UTA,1,37,10,20,0.5,7,14,0.5,3,6,0.5,6,7,0.857,1,5,6,5,4,0,4,0,29,24.3
Serge Ibaka,27-086,F-C,12/13/16,ORL,ATL,1,32,11,18,0.611,7,10,0.7,4,8,0.5,3,3,1,0,3,3,2,1,0,0,3,29,22.9
Enes Kanter,24-240,C,1/15/17,OKC,SAC,0,32,10,18,0.556,10,17,0.588,0,1,0,9,11,0.818,7,5,12,2,1,1,4,5,29,23.1
Giannis Antetokounmpo,21-355,F-G,11/25/16,MIL,TOR,1,35,12,17,0.706,12,16,0.75,0,1,0,5,6,0.833,0,6,6,11,1,0,4,4,29,26.4
Carmelo Anthony,32-210,F,12/25/16,NYK,BOS,1,39,9,24,0.375,7,17,0.412,2,7,0.286,9,9,1,2,5,7,2,1,1,2,2,29,19
Chris Paul,31-330,G,4/1/17,LAC,LAL,1,37,9,14,0.643,8,11,0.727,1,3,0.333,10,10,1,0,4,4,12,0,0,6,1,29,26
Kyrie Irving,24-322,G,2/8/17,CLE,IND,1,34,12,22,0.545,12,17,0.706,0,5,0,5,5,1,0,0,0,7,2,0,3,2,29,21.5
Isaiah Thomas,27-288,G,11/21/16,BOS,MIN,1,32,9,20,0.45,7,11,0.636,2,9,0.222,9,10,0.9,0,2,2,3,1,0,1,3,29,19.7
Mike Conley,29-166,G,3/26/17,MEM,GSW,1,37,9,15,0.6,5,9,0.556,4,6,0.667,7,7,1,1,0,1,7,1,0,6,1,29,22.3
Stephen Curry,29-000,G,3/14/17,GSW,PHI,1,37,8,23,0.348,3,10,0.3,5,13,0.385,8,8,1,2,4,6,5,3,0,5,3,29,19
Willie Cauley-Stein,23-189,F-C,2/23/17,SAC,DEN,0,35,14,22,0.636,14,22,0.636,0,0,,1,1,1,3,7,10,0,0,1,3,3,29,19.9
Carmelo Anthony,32-202,F,12/17/16,NYK,DEN,1,36,10,14,0.714,8,12,0.667,2,2,1,7,8,0.875,1,3,4,3,1,0,4,4,29,21.9
Klay Thompson,27-025,G,3/5/17,GSW,NYK,1,37,8,21,0.381,4,12,0.333,4,9,0.444,9,9,1,2,2,4,1,1,0,1,1,29,19.8
LeBron James,32-022,F-G,1/21/17,CLE,SAS,1,45,11,16,0.688,9,11,0.818,2,5,0.4,5,7,0.714,0,6,6,7,2,0,7,5,29,21.1
Isaiah Thomas,28-009,G,2/16/17,BOS,CHI,1,34,8,18,0.444,4,9,0.444,4,9,0.444,9,9,1,0,3,3,7,0,0,3,3,29,21.2
Danilo Gallinari,28-237,F,4/2/17,DEN,MIA,1,37,11,19,0.579,8,12,0.667,3,7,0.429,4,4,1,1,5,6,2,0,0,1,1,29,22.3
DeMarcus Cousins,26-223,C-F,3/24/17,NOP,HOU,1,30,10,25,0.4,5,16,0.313,5,9,0.556,4,5,0.8,2,4,6,4,1,4,3,4,29,19.7
Kevin Love,28-097,F,12/13/16,CLE,MEM,1,35,9,17,0.529,6,11,0.545,3,6,0.5,8,8,1,3,10,13,3,2,0,2,0,29,27.9
C.J. McCollum,25-098,G,12/26/16,POR,TOR,1,34,12,23,0.522,9,16,0.563,3,7,0.429,2,2,1,2,1,3,7,1,0,4,4,29,19.7
DeMar DeRozan,27-143,G,12/28/16,TOR,GSW,1,39,10,23,0.435,10,22,0.455,0,1,0,9,10,0.9,1,4,5,6,3,1,0,2,29,25.5
Russell Westbrook,28-113,G,3/5/17,OKC,DAL,1,34,8,24,0.333,6,14,0.429,2,10,0.2,11,13,0.846,0,6,6,5,2,1,1,4,29,20
Terrence Ross,26-062,F-G,4/8/17,ORL,IND,1,36,10,17,0.588,4,6,0.667,6,11,0.545,3,3,1,0,4,4,2,2,0,4,3,29,20.5
Stephen Curry,28-325,G,2/2/17,GSW,LAC,1,37,11,23,0.478,8,13,0.615,3,10,0.3,4,4,1,1,2,3,11,3,0,4,1,29,24.9
Kyrie Irving,24-312,G,1/29/17,CLE,OKC,1,35,12,22,0.545,10,16,0.625,2,6,0.333,3,3,1,0,3,3,10,1,0,2,3,29,24.1
James Harden,27-112,G,12/16/16,HOU,NOP,1,34,7,15,0.467,1,3,0.333,6,12,0.5,9,11,0.818,2,9,11,13,0,0,4,2,29,28.9
Kawhi Leonard,25-269,F,3/25/17,SAS,NYK,1,39,11,18,0.611,7,12,0.583,4,6,0.667,3,5,0.6,0,5,5,5,1,2,2,1,29,25
Harrison Barnes,24-189,F,12/5/16,DAL,CHO,1,38,10,21,0.476,8,17,0.471,2,4,0.5,7,7,1,4,3,7,2,1,0,0,4,29,22.8
Stephen Curry,29-015,G,3/29/17,GSW,SAS,1,35,9,20,0.45,5,12,0.417,4,8,0.5,7,7,1,1,3,4,11,1,0,2,5,29,24.9
Bojan Bogdanovic,27-211,G-F,11/15/16,BRK,LAL,1,30,11,18,0.611,9,13,0.692,2,5,0.4,5,5,1,0,3,3,1,2,0,2,2,29,21.6
Kemba Walker,26-329,G,4/2/17,CHO,OKC,1,34,10,20,0.5,4,8,0.5,6,12,0.5,3,4,0.75,0,3,3,4,4,0,4,1,29,21.9
Isaiah Thomas,27-278,G,11/11/16,BOS,NYK,1,28,9,17,0.529,6,12,0.5,3,5,0.6,8,8,1,2,1,3,4,1,0,2,1,29,23.8
Tyreke Evans,27-115,G-F,1/12/17,NOP,BRK,0,28,10,15,0.667,8,11,0.727,2,4,0.5,7,7,1,0,4,4,3,4,1,2,3,29,27.3
Klay Thompson,27-036,G,3/16/17,GSW,ORL,1,29,12,20,0.6,7,11,0.636,5,9,0.556,0,0,,0,4,4,5,0,1,3,1,29,21.8
Kyle Lowry,30-250,G,11/30/16,TOR,MEM,1,37,8,13,0.615,4,6,0.667,4,7,0.571,9,10,0.9,0,3,3,8,2,0,2,4,29,27.6
Russell Westbrook,27-365,G,11/11/16,OKC,LAC,1,35,9,25,0.36,6,20,0.3,3,5,0.6,8,9,0.889,1,13,14,9,1,0,4,5,29,20.6
Bojan Bogdanovic,27-323,G-F,3/7/17,WAS,PHO,0,29,5,9,0.556,2,3,0.667,3,6,0.5,16,16,1,2,7,9,0,0,0,0,0,29,28.2
Brook Lopez,28-354,C,3/21/17,BRK,DET,1,33,13,24,0.542,10,15,0.667,3,9,0.333,0,2,0,2,5,7,1,0,0,1,3,29,18
Bradley Beal,23-167,G,12/12/16,WAS,MIA,1,35,11,20,0.55,9,12,0.75,2,8,0.25,5,5,1,0,2,2,1,4,0,2,5,29,20.7
Andrew Wiggins,22-039,F-G,4/3/17,MIN,POR,1,38,11,25,0.44,8,20,0.4,3,5,0.6,4,4,1,1,3,4,0,0,0,0,1,29,17.1
Kyrie Irving,24-216,G,10/25/16,CLE,NYK,1,30,12,22,0.545,8,15,0.533,4,7,0.571,1,1,1,1,1,2,4,2,0,0,1,29,23.8
Kevin Durant,28-045,F-G,11/13/16,GSW,PHO,1,38,10,21,0.476,8,16,0.5,2,5,0.4,7,7,1,0,9,9,5,1,2,4,2,29,22.1
LeBron James,32-069,F-G,3/9/17,CLE,DET,1,39,12,22,0.545,12,16,0.75,0,6,0,5,8,0.625,4,10,14,10,1,0,3,1,29,27.6
LaMarcus Aldridge,31-182,F-C,1/17/17,SAS,MIN,1,36,12,20,0.6,12,19,0.632,0,1,0,5,6,0.833,1,3,4,3,0,2,1,3,29,22.3
Kristaps Porzingis,21-120,F-C,11/30/16,NYK,MIN,1,39,11,20,0.55,8,13,0.615,3,7,0.429,4,5,0.8,3,5,8,4,0,2,1,4,29,24.2
Nikola Jokic,21-342,C-F,1/26/17,DEN,PHO,1,36,12,21,0.571,12,19,0.632,0,2,0,5,6,0.833,8,6,14,8,1,2,3,2,29,30.3
Joe Johnson,35-118,G-F,10/25/16,UTA,POR,1,31,12,16,0.75,9,12,0.75,3,4,0.75,2,2,1,0,4,4,3,1,0,2,0,29,24.9
Dario Saric,22-338,F,3/12/17,PHI,LAL,1,35,10,20,0.5,7,13,0.538,3,7,0.429,6,9,0.667,0,7,7,5,2,1,5,4,29,19.5
Kyrie Irving,24-304,G,1/21/17,CLE,SAS,1,41,13,22,0.591,10,14,0.714,3,8,0.375,0,1,0,1,2,3,9,2,0,2,2,29,25.2
Karl-Anthony Towns,21-113,C-F,3/8/17,MIN,LAC,1,35,14,21,0.667,13,16,0.813,1,5,0.2,0,0,,4,10,14,2,0,0,1,3,29,24.9
Isaiah Thomas,27-331,G,1/3/17,BOS,UTA,1,35,10,18,0.556,5,10,0.5,5,8,0.625,4,4,1,0,4,4,15,1,0,1,3,29,30.9
Isaiah Thomas,28-004,G,2/11/17,BOS,UTA,1,35,9,16,0.563,5,9,0.556,4,7,0.571,7,9,0.778,0,2,2,5,0,0,3,2,29,20.9
Damian Lillard,26-207,G,2/7/17,POR,DAL,1,40,12,22,0.545,7,13,0.538,5,9,0.556,0,0,,1,4,5,6,2,0,2,5,29,22.5
DeMarcus Cousins,26-077,C-F,10/29/16,SAC,MIN,1,33,9,16,0.563,9,14,0.643,0,2,0,11,14,0.786,5,2,7,4,1,0,3,6,29,22.7
Kemba Walker,26-174,G,10/29/16,CHO,BOS,1,36,10,16,0.625,6,8,0.75,4,8,0.5,5,6,0.833,0,2,2,3,3,0,4,2,29,22.3
Blake Griffin,27-322,F,2/1/17,LAC,PHO,1,34,10,14,0.714,10,14,0.714,0,0,,9,10,0.9,1,7,8,5,1,1,1,1,29,29.4
Montrezl Harrell,22-339,F-C,12/30/16,HOU,LAC,0,30,10,14,0.714,10,14,0.714,0,0,,9,11,0.818,2,0,2,3,1,1,0,4,29,26
John Wall,26-101,G,12/16/16,WAS,DET,1,35,8,14,0.571,4,10,0.4,4,4,1,9,12,0.75,0,2,2,11,3,0,0,2,29,31.7
John Wall,26-171,G,2/24/17,WAS,PHI,1,41,8,21,0.381,8,18,0.444,0,3,0,13,14,0.929,2,6,8,14,0,2,6,2,29,24.7
Klay Thompson,26-285,G,11/19/16,GSW,MIL,1,38,9,17,0.529,4,7,0.571,5,10,0.5,6,6,1,0,3,3,2,0,0,3,1,29,19.6
Carmelo Anthony,32-187,F,12/2/16,NYK,MIN,1,34,9,20,0.45,4,10,0.4,5,10,0.5,6,6,1,0,5,5,3,3,0,1,2,29,23.4
Goran Dragic,30-214,G,12/6/16,MIA,NYK,1,40,11,17,0.647,7,13,0.538,4,4,1,3,4,0.75,1,3,4,7,2,0,5,1,29,24.2
Damian Lillard,26-242,G,3/14/17,POR,NOP,1,31,8,18,0.444,4,11,0.364,4,7,0.571,9,9,1,1,3,4,2,0,0,4,1,29,18.2
Nikola Jokic,21-333,C-F,1/17/17,DEN,LAL,1,34,12,22,0.545,11,17,0.647,1,5,0.2,4,6,0.667,7,8,15,1,0,3,2,3,29,24.5
Kyle Korver,35-328,G-F,2/8/17,CLE,IND,0,26,10,12,0.833,2,3,0.667,8,9,0.889,1,1,1,0,5,5,0,0,0,1,2,29,24.3
JaMychal Green,26-228,F,2/4/17,MEM,MIN,1,30,8,11,0.727,7,9,0.778,1,2,0.5,12,12,1,2,5,7,1,1,1,1,2,29,28
James Harden,27-097,G,12/1/16,HOU,GSW,1,46,8,23,0.348,6,12,0.5,2,11,0.182,11,14,0.786,1,14,15,13,2,1,7,4,29,23
Chris Paul,31-328,G,3/30/17,LAC,PHO,1,35,10,17,0.588,9,13,0.692,1,4,0.25,8,9,0.889,1,4,5,10,1,0,1,2,29,28.8
John Wall,26-135,G,1/19/17,WAS,NYK,1,37,11,21,0.524,10,18,0.556,1,3,0.333,6,8,0.75,0,5,5,13,3,0,2,2,29,28.7
Karl-Anthony Towns,21-059,C-F,1/13/17,MIN,OKC,1,37,11,17,0.647,11,15,0.733,0,2,0,7,7,1,2,15,17,1,2,3,2,4,29,28.6
Troy Daniels,25-143,G,12/5/16,MEM,NOP,0,44,10,20,0.5,3,9,0.333,7,11,0.636,2,2,1,0,0,0,3,0,0,1,2,29,19.3
Nikola Jokic,22-052,C-F,4/12/17,DEN,OKC,1,40,9,14,0.643,9,14,0.643,0,0,,11,14,0.786,2,14,16,8,1,5,4,4,29,31.7
Dion Waiters,25-086,G,3/6/17,MIA,CLE,1,35,12,24,0.5,7,15,0.467,5,9,0.556,0,0,,0,2,2,5,0,1,0,2,29,21
J.J. Redick,32-145,G,11/16/16,LAC,MEM,1,30,9,17,0.529,2,5,0.4,7,12,0.583,4,5,0.8,0,2,2,0,1,1,1,2,29,20.8
Gordon Hayward,26-231,F-G,11/9/16,UTA,CHO,1,36,10,19,0.526,7,11,0.636,3,8,0.375,6,6,1,0,7,7,4,1,1,4,3,29,21.1
Kevin Durant,28-195,F-G,4/12/17,GSW,LAL,1,27,11,16,0.688,6,9,0.667,5,7,0.714,2,4,0.5,0,8,8,5,1,1,3,1,29,25.6
Russell Westbrook,28-089,G,2/9/17,OKC,CLE,1,35,11,27,0.407,9,21,0.429,2,6,0.333,5,5,1,1,11,12,11,4,0,7,4,29,21.6
Andrew Wiggins,21-353,F-G,2/10/17,MIN,NOP,1,37,11,17,0.647,10,14,0.714,1,3,0.333,6,7,0.857,2,2,4,2,3,0,3,0,29,24.5
Klay Thompson,26-326,G,12/30/16,GSW,DAL,1,36,11,19,0.579,6,8,0.75,5,11,0.455,2,2,1,0,4,4,2,1,1,2,0,29,22.4
Zach LaVine,21-273,G,12/8/16,MIN,TOR,1,39,12,20,0.6,9,12,0.75,3,8,0.375,2,2,1,2,0,2,6,0,0,1,3,29,23.2
Victor Oladipo,24-196,G,11/16/16,OKC,HOU,1,40,12,18,0.667,7,11,0.636,5,7,0.714,0,0,,1,9,10,5,2,0,3,4,29,25.5
LaMarcus Aldridge,31-170,F-C,1/5/17,SAS,DEN,1,33,11,18,0.611,10,17,0.588,1,1,1,5,6,0.833,1,3,4,1,1,1,1,2,28,21.6
Jabari Parker,21-299,F,1/8/17,MIL,WAS,1,41,9,21,0.429,6,15,0.4,3,6,0.5,7,9,0.778,3,5,8,7,2,1,2,5,28,23.3
Aaron Gordon,21-117,F,1/11/17,ORL,LAC,1,39,11,17,0.647,7,9,0.778,4,8,0.5,2,4,0.5,1,2,3,3,0,0,2,3,28,19.9
Kevin Durant,28-041,F-G,11/9/16,GSW,DAL,1,35,10,16,0.625,6,9,0.667,4,7,0.571,4,5,0.8,0,10,10,4,0,1,3,3,28,22.7
Kevin Love,28-089,F,12/5/16,CLE,TOR,1,38,8,18,0.444,2,7,0.286,6,11,0.545,6,6,1,2,12,14,0,0,0,2,2,28,20.8
Dennis Schroder,23-054,G,11/8/16,ATL,CLE,1,32,10,16,0.625,7,10,0.7,3,6,0.5,5,5,1,1,1,2,6,0,0,4,3,28,20.8
D'Angelo Russell,21-033,G,3/28/17,LAL,WAS,1,40,10,21,0.476,6,9,0.667,4,12,0.333,4,4,1,1,5,6,9,0,1,4,1,28,22.1
Carmelo Anthony,32-161,F,11/6/16,NYK,UTA,1,35,12,20,0.6,12,14,0.857,0,6,0,4,6,0.667,1,8,9,3,0,0,1,5,28,20.2
Russell Westbrook,28-126,G,3/18/17,OKC,SAC,1,36,9,20,0.45,5,11,0.455,4,9,0.444,6,7,0.857,3,5,8,10,4,0,7,1,28,24.4
Stephen Curry,29-027,G,4/10/17,GSW,UTA,1,30,9,16,0.563,3,8,0.375,6,8,0.75,4,5,0.8,1,3,4,4,1,0,1,1,28,24
Jimmy Butler,27-184,G-F,3/17/17,CHI,WAS,1,38,10,17,0.588,8,14,0.571,2,3,0.667,6,8,0.75,2,3,5,5,3,0,2,2,28,25.3
Brook Lopez,28-265,C,12/22/16,BRK,GSW,1,31,9,16,0.563,5,7,0.714,4,9,0.444,6,6,1,0,8,8,2,0,2,6,3,28,18.4
Kemba Walker,26-302,G,3/6/17,CHO,IND,1,35,10,22,0.455,6,13,0.462,4,9,0.444,4,4,1,2,4,6,7,1,0,1,1,28,23.7
Andre Drummond,23-151,C,1/8/17,DET,POR,1,52,13,20,0.65,13,20,0.65,0,0,,2,3,0.667,2,12,14,0,4,2,1,4,28,26.6
Paul Millsap,31-260,F,10/27/16,ATL,WAS,1,31,11,20,0.55,8,14,0.571,3,6,0.5,3,4,0.75,2,5,7,6,0,1,2,0,28,23.8
Dario Saric,22-335,F,3/9/17,PHI,POR,1,41,11,16,0.688,7,9,0.778,4,7,0.571,2,3,0.667,2,7,9,1,1,0,5,5,28,19
Jusuf Nurkic,22-198,C,3/9/17,POR,PHI,1,38,9,18,0.5,9,18,0.5,0,0,,10,13,0.769,7,13,20,8,2,6,3,5,28,33.4
Mike Conley,29-096,G,1/15/17,MEM,CHI,1,37,9,17,0.529,6,8,0.75,3,9,0.333,7,7,1,0,5,5,8,2,0,2,3,28,25.6
DeMarcus Cousins,26-165,C-F,1/25/17,SAC,CLE,1,39,11,30,0.367,11,25,0.44,0,5,0,6,9,0.667,2,9,11,9,3,1,2,3,28,21.1
Danilo Gallinari,28-239,F,4/4/17,DEN,NOP,1,42,9,15,0.6,4,5,0.8,5,10,0.5,5,6,0.833,1,4,5,3,0,0,0,1,28,24.3
Lou Williams,30-123,G,2/27/17,HOU,IND,0,28,8,15,0.533,3,5,0.6,5,10,0.5,7,8,0.875,1,2,3,1,1,1,1,4,28,21.4
Austin Rivers,24-156,G,1/4/17,LAC,MEM,1,44,10,16,0.625,8,12,0.667,2,4,0.5,6,7,0.857,0,4,4,7,1,1,4,3,28,23
Gordon Hayward,26-273,F-G,12/21/16,UTA,SAC,1,40,9,18,0.5,7,13,0.538,2,5,0.4,8,9,0.889,1,9,10,3,0,0,3,3,28,19.9
Blake Griffin,27-234,F,11/5/16,LAC,SAS,1,29,13,19,0.684,13,17,0.765,0,2,0,2,3,0.667,1,4,5,3,1,0,0,2,28,23.7
Stephen Curry,28-232,G,11/1/16,GSW,POR,1,30,10,21,0.476,5,11,0.455,5,10,0.5,3,4,0.75,1,3,4,3,1,0,4,3,28,16.4
Kyrie Irving,24-259,G,12/7/16,CLE,NYK,1,30,9,17,0.529,5,11,0.455,4,6,0.667,6,6,1,0,3,3,6,0,0,2,1,28,22.4
James Harden,27-087,G,11/21/16,HOU,DET,1,38,6,17,0.353,4,8,0.5,2,9,0.222,14,19,0.737,2,6,8,11,0,1,6,2,28,21.3
Nikola Mirotic,26-043,F,3/26/17,CHI,MIL,1,35,11,14,0.786,5,5,1,6,9,0.667,0,0,,1,7,8,1,0,0,1,2,28,24.3
Anthony Davis,24-008,F-C,3/19/17,NOP,MIN,1,35,11,16,0.688,11,14,0.786,0,2,0,6,6,1,4,7,11,3,0,0,5,1,28,22.8
Nicolas Batum,28-021,F-G,1/4/17,CHO,OKC,1,36,7,18,0.389,6,13,0.462,1,5,0.2,13,15,0.867,1,2,3,4,0,0,2,2,28,18.7
Kyrie Irving,24-253,G,12/1/16,CLE,LAC,1,34,8,19,0.421,7,15,0.467,1,4,0.25,11,12,0.917,0,2,2,2,0,0,4,2,28,14.7
Dennis Schroder,23-123,G,1/16/17,ATL,NYK,1,34,13,16,0.813,12,14,0.857,1,2,0.5,1,1,1,1,2,3,3,0,0,2,0,28,23.4
Nikola Mirotic,26-047,F,3/30/17,CHI,CLE,1,38,9,14,0.643,3,3,1,6,11,0.545,4,4,1,1,9,10,1,0,1,2,2,28,23.8
Damian Lillard,26-209,G,2/9/17,POR,BOS,1,40,8,20,0.4,6,13,0.462,2,7,0.286,10,11,0.909,2,4,6,7,0,0,3,4,28,19.7
Damian Lillard,26-226,G,2/26/17,POR,TOR,1,36,10,20,0.5,6,13,0.462,4,7,0.571,4,5,0.8,0,6,6,8,2,0,4,2,28,22.2
Marcus Morris,27-100,F,12/11/16,DET,PHI,1,37,10,16,0.625,6,9,0.667,4,7,0.571,4,5,0.8,1,1,2,1,0,1,1,1,28,21.4
C.J. McCollum,25-137,G,2/3/17,POR,DAL,1,35,11,20,0.55,9,13,0.692,2,7,0.286,4,4,1,2,5,7,6,0,1,2,5,28,22.2
DeMarcus Cousins,26-137,C-F,12/28/16,SAC,POR,1,35,8,19,0.421,5,13,0.385,3,6,0.5,9,10,0.9,1,7,8,6,2,1,2,5,28,23.2
Giannis Antetokounmpo,22-015,F-G,12/21/16,MIL,CLE,1,32,7,13,0.538,6,9,0.667,1,4,0.25,13,14,0.929,1,4,5,5,2,1,1,1,28,28
Giannis Antetokounmpo,22-004,F-G,12/10/16,MIL,WAS,1,41,11,18,0.611,10,16,0.625,1,2,0.5,5,7,0.714,3,10,13,7,0,0,7,3,28,20.8
Nikola Mirotic,26-039,F,3/22/17,CHI,DET,1,39,12,15,0.8,8,9,0.889,4,6,0.667,0,0,,1,4,5,2,3,1,1,1,28,27.9
Gary Harris,22-187,G,3/20/17,DEN,HOU,1,39,10,16,0.625,7,10,0.7,3,6,0.5,5,6,0.833,1,1,2,4,3,0,3,2,28,23.4
Tobias Harris,24-239,F,3/11/17,DET,NYK,1,33,11,21,0.524,8,13,0.615,3,8,0.375,3,5,0.6,2,5,7,5,0,2,0,0,28,24.7
Anthony Davis,23-277,F-C,12/13/16,NOP,GSW,1,36,10,14,0.714,9,13,0.692,1,1,1,7,8,0.875,0,8,8,3,2,5,6,2,28,25
Harrison Barnes,24-205,F,12/21/16,DAL,POR,1,36,10,22,0.455,10,20,0.5,0,2,0,8,8,1,1,6,7,0,0,0,0,3,28,17.9
Russell Westbrook,28-081,G,2/1/17,OKC,CHI,1,29,10,23,0.435,8,16,0.5,2,7,0.286,6,8,0.75,1,4,5,8,2,1,3,1,28,21.9
Paul George,26-191,F,11/9/16,IND,PHI,1,32,13,22,0.591,11,15,0.733,2,7,0.286,0,0,,1,6,7,3,1,0,5,3,28,17.2
Tim Hardaway,24-331,G,2/10/17,ATL,SAC,1,36,9,17,0.529,6,8,0.75,3,9,0.333,7,8,0.875,0,4,4,2,0,0,2,2,28,19.1
Stephen Curry,28-317,G,1/25/17,GSW,CHO,1,36,11,23,0.478,5,11,0.455,6,12,0.5,0,0,,0,2,2,6,1,1,4,2,28,18
Dwyane Wade,34-328,G,12/10/16,CHI,MIA,1,35,11,24,0.458,11,22,0.5,0,2,0,6,7,0.857,0,3,3,3,1,2,3,2,28,16.8
Bradley Beal,23-217,G,1/31/17,WAS,NYK,1,32,12,18,0.667,10,12,0.833,2,6,0.333,2,2,1,1,1,2,4,1,0,3,1,28,21.6
DeMarcus Cousins,26-089,C-F,11/10/16,SAC,LAL,1,36,10,25,0.4,7,19,0.368,3,6,0.5,5,8,0.625,3,6,9,4,2,0,4,3,28,16.8
D'Angelo Russell,20-313,G,1/1/17,LAL,TOR,1,31,9,18,0.5,3,6,0.5,6,12,0.5,4,6,0.667,1,3,4,5,1,0,0,2,28,23.5
Kevin Durant,28-055,F-G,11/23/16,GSW,LAL,1,30,11,15,0.733,9,11,0.818,2,4,0.5,4,5,0.8,1,5,6,5,1,1,1,3,28,26.7
Kevin Durant,28-058,F-G,11/26/16,GSW,MIN,1,38,10,17,0.588,7,13,0.538,3,4,0.75,5,5,1,3,7,10,5,0,6,3,1,28,28.6
Kevin Love,28-115,F,12/31/16,CLE,CHO,1,39,8,20,0.4,4,12,0.333,4,8,0.5,8,8,1,2,8,10,0,0,0,2,0,28,19
Giannis Antetokounmpo,22-115,F-G,3/31/17,MIL,DET,1,45,7,16,0.438,7,15,0.467,0,1,0,14,21,0.667,2,12,14,9,1,2,4,3,28,25.3
Bradley Beal,23-129,G,11/4/16,WAS,ATL,1,39,6,16,0.375,3,8,0.375,3,8,0.375,13,14,0.929,1,1,2,3,0,1,5,1,28,17.2
Montrezl Harrell,22-348,F-C,1/8/17,HOU,TOR,0,26,12,13,0.923,12,13,0.923,0,0,,4,6,0.667,3,2,5,0,0,1,1,2,28,24.5
Jabari Parker,21-314,F,1/23/17,MIL,HOU,1,39,11,19,0.579,9,14,0.643,2,5,0.4,4,4,1,0,8,8,7,3,1,3,3,28,25.9
Damian Lillard,26-138,G,11/30/16,POR,IND,1,35,11,18,0.611,10,12,0.833,1,6,0.167,5,7,0.714,0,5,5,10,4,0,1,3,28,29.3
Devin Booker,20-052,G,12/21/16,PHO,HOU,1,36,11,25,0.44,9,21,0.429,2,4,0.5,4,5,0.8,2,4,6,7,0,0,1,3,28,19.8
Hassan Whiteside,27-173,C,12/3/16,MIA,POR,1,41,12,16,0.75,12,16,0.75,0,0,,4,6,0.667,3,13,16,1,0,5,1,1,28,29.6
Kyrie Irving,24-310,G,1/27/17,CLE,BRK,1,31,10,17,0.588,7,12,0.583,3,5,0.6,5,5,1,0,4,4,6,0,2,3,3,28,22.7
Jahlil Okafor,21-072,C-F,2/25/17,PHI,NYK,1,29,11,19,0.579,11,19,0.579,0,0,,6,6,1,6,4,10,1,0,0,0,2,28,24.4
Kyrie Irving,24-272,G,12/20/16,CLE,MIL,1,45,8,23,0.348,5,16,0.313,3,7,0.429,9,9,1,0,5,5,5,0,0,2,1,28,17.7
DeMarcus Cousins,26-087,C-F,11/8/16,SAC,NOP,1,33,11,20,0.55,11,17,0.647,0,3,0,6,8,0.75,1,3,4,4,2,2,2,5,28,21.4
Jabari Parker,21-249,F,11/19/16,MIL,GSW,1,37,11,18,0.611,10,16,0.625,1,2,0.5,5,6,0.833,3,2,5,5,2,0,2,1,28,25.2
Klay Thompson,26-263,G,10/28/16,GSW,NOP,1,39,11,21,0.524,9,12,0.75,2,9,0.222,4,4,1,0,2,2,4,1,0,1,0,28,21.1
Jimmy Butler,27-140,G-F,2/1/17,CHI,OKC,1,30,11,17,0.647,11,16,0.688,0,1,0,6,8,0.75,2,2,4,5,3,0,1,2,28,26.4
Klay Thompson,27-034,G,3/14/17,GSW,PHI,1,38,10,22,0.455,5,13,0.385,5,9,0.556,3,3,1,1,1,2,1,0,0,1,1,28,16.9
Gordon Hayward,26-258,F-G,12/6/16,UTA,PHO,1,36,8,16,0.5,6,13,0.462,2,3,0.667,10,13,0.769,0,5,5,4,3,0,1,1,28,24.7
Klay Thompson,27-000,G,2/8/17,GSW,CHI,1,29,10,18,0.556,4,9,0.444,6,9,0.667,2,2,1,0,5,5,3,0,0,3,2,28,19.2
C.J. McCollum,25-132,G,1/29/17,POR,GSW,1,38,10,16,0.625,5,9,0.556,5,7,0.714,3,4,0.75,1,6,7,3,1,0,4,3,28,20.8
DeAndre Jordan,28-202,C,2/8/17,LAC,NYK,1,31,12,14,0.857,12,14,0.857,0,0,,4,9,0.444,5,10,15,0,0,2,1,4,28,26.3
Dion Waiters,24-352,G,11/26/16,MIA,MEM,1,36,10,19,0.526,6,14,0.429,4,5,0.8,4,6,0.667,0,5,5,6,0,0,1,2,28,21.8
Zach LaVine,21-299,G,1/3/17,MIN,PHI,1,40,11,20,0.55,8,12,0.667,3,8,0.375,3,4,0.75,0,4,4,1,1,1,3,3,28,17.4
Stephen Curry,28-262,G,12/1/16,GSW,HOU,1,38,9,22,0.409,5,9,0.556,4,13,0.308,6,6,1,1,2,3,5,3,1,5,6,28,17.3
Kyrie Irving,24-343,G,3/1/17,CLE,BOS,1,32,10,19,0.526,8,13,0.615,2,6,0.333,6,6,1,0,2,2,1,1,1,2,4,28,18.1
Kyle Lowry,30-235,G,11/15/16,TOR,CLE,1,40,11,23,0.478,7,15,0.467,4,8,0.5,2,2,1,3,2,5,9,4,0,1,3,28,27.1
Devin Booker,20-144,G,3/23/17,PHO,BRK,1,40,9,26,0.346,6,17,0.353,3,9,0.333,7,8,0.875,0,2,2,0,3,0,3,6,28,11.2
Gordon Hayward,26-228,F-G,11/6/16,UTA,NYK,1,36,6,17,0.353,4,9,0.444,2,8,0.25,14,14,1,1,4,5,0,0,0,3,3,28,16.2
Derrick Rose,28-152,G,3/5/17,NYK,GSW,1,35,9,18,0.5,9,17,0.529,0,1,0,10,11,0.909,0,1,1,4,1,0,2,4,28,19.1
Kemba Walker,26-226,G,12/20/16,CHO,LAL,1,41,11,26,0.423,7,16,0.438,4,10,0.4,2,2,1,5,3,8,10,0,0,3,4,28,21
D'Angelo Russell,21-038,G,4/2/17,LAL,MEM,1,36,9,17,0.529,6,11,0.545,3,6,0.5,7,7,1,0,6,6,5,0,0,5,2,28,19.2
Zach LaVine,21-263,G,11/28/16,MIN,UTA,1,44,9,17,0.529,7,11,0.636,2,6,0.333,8,9,0.889,1,7,8,8,1,0,4,2,28,23.9
Wilson Chandler,29-190,F,11/16/16,DEN,PHO,0,35,11,22,0.5,9,19,0.474,2,3,0.667,4,4,1,3,8,11,5,1,1,2,3,28,23.5
Andrew Wiggins,21-323,F-G,1/11/17,MIN,HOU,1,38,11,20,0.55,9,16,0.563,2,4,0.5,4,5,0.8,0,4,4,2,0,1,3,4,28,16.7
Goran Dragic,30-341,G,4/12/17,MIA,WAS,1,37,11,21,0.524,9,17,0.529,2,4,0.5,4,4,1,2,2,4,5,1,0,7,2,28,16.4
Jimmy Butler,27-137,G-F,1/29/17,CHI,PHI,1,39,8,18,0.444,8,18,0.444,0,0,,12,15,0.8,1,7,8,7,4,0,3,2,28,25.3
DeMar DeRozan,27-215,G,3/10/17,TOR,ATL,1,37,12,30,0.4,11,22,0.5,1,8,0.125,3,4,0.75,1,7,8,6,2,0,3,5,28,15.4
Isaiah Thomas,27-319,G,12/22/16,BOS,IND,1,32,9,21,0.429,7,10,0.7,2,11,0.182,8,9,0.889,0,1,1,9,0,0,0,4,28,21.5
Stephen Curry,28-230,G,10/30/16,GSW,PHO,1,34,9,17,0.529,4,9,0.444,5,8,0.625,5,5,1,0,1,1,3,0,0,1,5,28,19.1
Mike Conley,29-171,G,3/31/17,MEM,DAL,1,34,8,15,0.533,6,9,0.667,2,6,0.333,10,11,0.909,0,5,5,6,1,1,3,3,28,23.5
Carmelo Anthony,32-255,F,2/8/17,NYK,LAC,1,37,10,20,0.5,7,13,0.538,3,7,0.429,5,6,0.833,2,7,9,1,1,2,1,5,28,21.2
Evan Fournier,24-033,G-F,12/1/16,ORL,MEM,1,36,11,14,0.786,8,9,0.889,3,5,0.6,3,4,0.75,0,0,0,4,0,0,3,2,28,21.2
Kyrie Irving,24-323,G,2/9/17,CLE,OKC,1,34,11,18,0.611,7,13,0.538,4,5,0.8,2,2,1,0,1,1,4,2,1,6,3,28,18.4
DeMar DeRozan,27-234,G,3/29/17,TOR,CHO,1,39,11,24,0.458,11,22,0.5,0,2,0,6,7,0.857,1,5,6,8,0,0,2,1,28,20.6
Rodney Hood,24-136,G-F,3/5/17,UTA,SAC,1,33,10,17,0.588,6,9,0.667,4,8,0.5,4,5,0.8,1,3,4,0,2,0,1,2,28,21.5
Kevin Durant,28-101,F-G,1/8/17,GSW,SAC,1,36,9,15,0.6,7,11,0.636,2,4,0.5,8,9,0.889,0,7,7,6,1,4,1,1,28,29.4
Kevin Durant,28-103,F-G,1/10/17,GSW,MIA,1,37,10,21,0.476,7,15,0.467,3,6,0.5,5,5,1,1,7,8,0,1,2,2,2,28,19.7
Karl-Anthony Towns,21-148,C-F,4/12/17,MIN,HOU,1,36,12,17,0.706,9,13,0.692,3,4,0.75,1,1,1,1,20,21,3,1,0,0,2,28,29.9
Anthony Davis,23-290,F-C,12/26/16,NOP,DAL,1,37,8,14,0.571,8,13,0.615,0,1,0,12,14,0.857,5,11,16,4,0,2,6,4,28,24
Kawhi Leonard,25-283,F,4/8/17,SAS,LAC,1,35,10,19,0.526,5,11,0.455,5,8,0.625,3,4,0.75,0,5,5,5,1,0,3,1,28,20.9
Jimmy Butler,27-122,G-F,1/14/17,CHI,NOP,1,39,9,16,0.563,6,12,0.5,3,4,0.75,7,10,0.7,1,7,8,6,4,2,3,1,28,28.2
Eric Bledsoe,27-086,G,3/5/17,PHO,BOS,1,35,9,20,0.45,7,15,0.467,2,5,0.4,8,8,1,0,6,6,9,0,0,4,2,28,20.9
Stephen Curry,29-004,G,3/18/17,GSW,MIL,1,30,9,13,0.692,3,5,0.6,6,8,0.75,4,4,1,0,4,4,4,1,1,3,3,28,24
DeMar DeRozan,27-159,G,1/13/17,TOR,BRK,1,30,11,22,0.5,11,21,0.524,0,1,0,6,8,0.75,2,2,4,2,0,0,0,1,28,19.2
Marc Gasol,31-302,C,11/26/16,MEM,MIA,1,35,11,16,0.688,9,12,0.75,2,4,0.5,4,4,1,0,3,3,6,0,0,0,2,28,25.5
Goran Dragic,30-326,G,3/28/17,MIA,DET,1,34,9,16,0.563,8,12,0.667,1,4,0.25,9,13,0.692,1,3,4,4,0,1,1,3,28,21.7
Bradley Beal,23-267,G,3/22/17,WAS,ATL,1,35,10,21,0.476,6,12,0.5,4,9,0.444,4,7,0.571,3,6,9,2,4,1,3,2,28,22.3
Kawhi Leonard,25-275,F,3/31/17,SAS,OKC,1,38,10,22,0.455,8,13,0.615,2,9,0.222,6,8,0.75,2,6,8,2,3,2,0,2,28,24
Marc Gasol,31-311,C,12/5/16,MEM,NOP,1,46,11,25,0.44,8,19,0.421,3,6,0.5,3,4,0.75,1,10,11,10,3,2,3,2,28,25.8
James Harden,27-113,G,12/17/16,HOU,MIN,1,43,8,20,0.4,5,9,0.556,3,11,0.273,9,11,0.818,0,9,9,13,1,2,7,5,28,21.6
Elfrid Payton,22-327,G,1/14/17,ORL,UTA,1,39,10,17,0.588,9,14,0.643,1,3,0.333,7,11,0.636,3,6,9,9,2,1,1,4,28,28.8
Kevin Love,28-093,F,12/9/16,CLE,MIA,1,31,11,18,0.611,8,10,0.8,3,8,0.375,3,4,0.75,5,10,15,3,1,1,3,1,28,26.3
Ryan Anderson,28-225,F,12/17/16,HOU,MIN,1,36,9,19,0.474,2,3,0.667,7,16,0.438,3,4,0.75,3,3,6,0,3,1,2,2,28,21.8
LeBron James,32-009,F-G,1/8/17,CLE,PHO,1,40,11,17,0.647,9,13,0.692,2,4,0.5,4,6,0.667,3,5,8,4,1,0,7,3,28,18.9
Russell Westbrook,27-359,G,11/5/16,OKC,MIN,1,28,9,18,0.5,5,13,0.385,4,5,0.8,6,8,0.75,2,4,6,8,3,0,2,3,28,26.2
Michael Beasley,28-001,F,1/10/17,MIL,SAS,0,34,11,18,0.611,10,17,0.588,1,1,1,5,6,0.833,1,4,5,4,2,3,4,2,28,23.4
Andre Drummond,23-173,C,1/30/17,DET,BOS,1,41,12,19,0.632,12,19,0.632,0,0,,4,7,0.571,7,15,22,3,2,2,1,2,28,31.4
Dwyane Wade,34-307,G,11/19/16,CHI,LAC,1,36,9,20,0.45,4,11,0.364,5,9,0.556,5,6,0.833,3,5,8,3,1,2,3,2,28,21.5
Giannis Antetokounmpo,22-082,F-G,2/26/17,MIL,PHO,1,36,11,13,0.846,11,13,0.846,0,0,,6,7,0.857,1,7,8,6,1,2,4,3,28,27.1
Stephen Curry,28-289,G,12/28/16,GSW,TOR,1,36,9,18,0.5,6,12,0.5,3,6,0.5,7,7,1,1,6,7,7,0,0,2,3,28,23.2
Kemba Walker,26-202,G,11/26/16,CHO,NYK,1,40,9,21,0.429,7,15,0.467,2,6,0.333,8,11,0.727,0,2,2,3,1,3,1,0,28,20.5
Paul George,26-314,F,3/12/17,IND,MIA,1,37,9,19,0.474,8,15,0.533,1,4,0.25,9,9,1,0,10,10,1,1,1,2,2,28,20.9
LeBron James,31-321,F-G,11/15/16,CLE,TOR,1,38,10,15,0.667,8,10,0.8,2,5,0.4,6,10,0.6,0,9,9,15,1,0,5,2,28,28.3
Dennis Schroder,23-190,G,3/24/17,ATL,MIL,1,37,11,25,0.44,8,21,0.381,3,4,0.75,3,3,1,3,4,7,7,1,1,4,2,28,20
Karl-Anthony Towns,21-034,C-F,12/19/16,MIN,PHO,1,35,11,18,0.611,10,15,0.667,1,3,0.333,5,5,1,4,11,15,3,0,2,4,4,28,23.8
Marc Gasol,31-357,C,1/20/17,MEM,SAC,1,33,9,19,0.474,6,13,0.462,3,6,0.5,7,7,1,1,8,9,4,1,0,2,3,28,22
John Wall,26-066,G,11/11/16,WAS,CLE,1,35,12,24,0.5,11,21,0.524,1,3,0.333,3,5,0.6,1,1,2,3,2,1,6,3,28,13.8
Damian Lillard,26-190,G,1/21/17,POR,BOS,1,37,9,21,0.429,7,14,0.5,2,7,0.286,8,8,1,0,1,1,7,0,1,3,3,28,18.6
DeMarcus Cousins,26-111,C-F,12/2/16,SAC,BOS,1,34,10,26,0.385,8,19,0.421,2,7,0.286,6,8,0.75,3,6,9,3,1,4,2,4,28,19.2
James Harden,27-065,G,10/30/16,HOU,DAL,1,39,8,23,0.348,5,14,0.357,3,9,0.333,9,12,0.75,1,6,7,8,1,0,8,4,28,13.4
Marc Gasol,32-030,C,2/28/17,MEM,PHO,1,31,10,16,0.625,5,11,0.455,5,5,1,3,4,0.75,3,4,7,5,1,1,2,1,28,26.5
Carmelo Anthony,32-227,F,1/11/17,NYK,PHI,1,37,11,25,0.44,9,19,0.474,2,6,0.333,4,4,1,1,1,2,1,1,3,1,1,28,18.3
Kevin Love,28-209,F,4/4/17,CLE,ORL,1,28,9,18,0.5,4,9,0.444,5,9,0.556,5,6,0.833,2,9,11,2,2,1,1,2,28,25
C.J. McCollum,25-069,G,11/27/16,POR,HOU,1,37,9,19,0.474,5,9,0.556,4,10,0.4,6,6,1,0,3,3,7,2,0,1,4,28,23.5
Marcus Morris,27-209,F,3/30/17,DET,BRK,1,37,12,18,0.667,11,16,0.688,1,2,0.5,3,4,0.75,3,10,13,0,0,2,4,0,28,22.3
Devin Booker,20-133,G,3/12/17,PHO,POR,1,41,13,26,0.5,13,26,0.5,0,0,,2,4,0.5,1,4,5,3,1,0,3,1,28,15.8
Paul George,26-333,F,3/31/17,IND,TOR,1,39,10,22,0.455,6,12,0.5,4,10,0.4,4,5,0.8,0,9,9,3,1,0,3,3,28,17.8
Kristaps Porzingis,21-096,F-C,11/6/16,NYK,UTA,1,33,10,18,0.556,7,11,0.636,3,7,0.429,5,5,1,1,7,8,1,0,2,2,4,28,20.7
Eric Bledsoe,27-048,G,1/26/17,PHO,DEN,1,28,9,19,0.474,6,12,0.5,3,7,0.429,7,9,0.778,2,2,4,5,0,0,1,5,28,20
D'Angelo Russell,21-014,G,3/9/17,LAL,PHO,1,34,10,20,0.5,4,11,0.364,6,9,0.667,2,2,1,1,3,4,4,3,0,0,3,28,24.2
DeMarcus Cousins,26-118,C-F,12/9/16,SAC,NYK,1,36,9,25,0.36,9,19,0.474,0,6,0,10,12,0.833,3,9,12,6,3,1,3,2,28,22.2
Greg Monroe,26-235,C-F,1/25/17,MIL,PHI,0,30,11,17,0.647,11,17,0.647,0,0,,6,7,0.857,6,3,9,2,1,0,4,2,28,22.8
Zach Randolph,35-196,F,1/28/17,MEM,UTA,0,34,12,20,0.6,12,19,0.632,0,1,0,4,4,1,3,6,9,1,1,0,1,1,28,23
Harrison Barnes,24-170,F,11/16/16,DAL,BOS,1,41,12,24,0.5,12,23,0.522,0,1,0,4,5,0.8,0,2,2,1,2,0,2,5,28,14.9
Serge Ibaka,27-142,F-C,2/7/17,ORL,HOU,1,41,13,20,0.65,11,16,0.688,2,4,0.5,0,0,,1,7,8,0,0,1,2,2,28,19.9
Russell Westbrook,28-022,G,12/4/16,OKC,NOP,1,38,10,23,0.435,8,15,0.533,2,8,0.25,6,9,0.667,1,16,17,12,1,0,10,1,28,19.2
Devin Booker,20-070,G,1/8/17,PHO,CLE,1,45,12,24,0.5,10,17,0.588,2,7,0.286,2,4,0.5,3,2,5,4,2,0,2,2,28,19.9
Gordon Hayward,26-293,F-G,1/10/17,UTA,CLE,1,37,10,12,0.833,6,7,0.857,4,5,0.8,4,5,0.8,0,9,9,2,1,1,1,1,28,27.6
Kyrie Irving,24-354,G,3/12/17,CLE,HOU,1,37,10,23,0.435,7,13,0.538,3,10,0.3,5,6,0.833,0,3,3,8,0,2,3,4,28,18.8
Jabari Parker,21-275,F,12/15/16,MIL,CHI,1,35,11,19,0.579,8,14,0.571,3,5,0.6,3,7,0.429,1,4,5,3,2,0,0,2,28,22.7
Marc Gasol,31-355,C,1/18/17,MEM,WAS,1,39,9,16,0.563,9,13,0.692,0,3,0,10,11,0.909,1,1,2,7,0,1,1,1,28,25.2
Isaiah Thomas,27-364,G,2/5/17,BOS,LAC,1,36,7,18,0.389,4,7,0.571,3,11,0.273,11,12,0.917,0,2,2,8,2,0,3,1,28,22.6
Anthony Davis,23-269,F-C,12/5/16,NOP,MEM,1,48,10,27,0.37,9,23,0.391,1,4,0.25,7,7,1,0,16,16,1,1,4,1,1,28,21
DeMarcus Cousins,26-183,C-F,2/12/17,SAC,NOP,1,36,7,14,0.5,7,10,0.7,0,4,0,14,16,0.875,2,12,14,7,2,1,7,3,28,24.6
Kemba Walker,26-320,G,3/24/17,CHO,CLE,1,39,10,20,0.5,5,10,0.5,5,10,0.5,3,4,0.75,0,1,1,5,2,1,4,0,28,20.1
Brook Lopez,28-291,C,1/17/17,BRK,TOR,1,32,11,23,0.478,11,20,0.55,0,3,0,6,6,1,5,4,9,2,0,2,3,2,28,20
Rudy Gay,30-073,F,10/29/16,SAC,MIN,1,33,11,20,0.55,11,20,0.55,0,0,,6,8,0.75,2,4,6,2,1,2,2,3,28,20.8
Klay Thompson,26-284,G,11/18/16,GSW,BOS,1,31,12,21,0.571,9,15,0.6,3,6,0.5,1,1,1,1,3,4,3,0,0,2,2,28,19
Isaiah Thomas,27-341,G,1/13/17,BOS,ATL,1,36,9,21,0.429,4,8,0.5,5,13,0.385,5,5,1,1,3,4,9,0,0,5,1,28,19.4
Jamal Crawford,37-005,G,3/25/17,LAC,UTA,0,25,8,12,0.667,5,6,0.833,3,6,0.5,9,9,1,0,2,2,3,2,0,0,2,28,26.7
LeBron James,32-061,F-G,3/1/17,CLE,BOS,1,40,10,21,0.476,7,15,0.467,3,6,0.5,5,8,0.625,5,8,13,10,1,1,4,3,28,25.5
Anthony Davis,23-287,F-C,12/23/16,NOP,MIA,1,37,10,17,0.588,8,14,0.571,2,3,0.667,6,9,0.667,7,15,22,1,1,4,3,3,28,28.6
Isaiah Thomas,28-062,G,4/10/17,BOS,BRK,1,30,10,21,0.476,8,11,0.727,2,10,0.2,5,5,1,1,3,4,3,1,0,4,4,27,15.4
Damian Lillard,26-133,G,11/25/16,POR,NOP,1,36,9,19,0.474,6,12,0.5,3,7,0.429,6,7,0.857,0,4,4,11,0,1,1,2,27,24.7
Brook Lopez,28-242,C,11/29/16,BRK,LAC,1,43,11,20,0.55,7,11,0.636,4,9,0.444,1,1,1,3,5,8,4,2,1,1,1,27,25.1
Anthony Davis,24-004,F-C,3/15/17,NOP,MIA,1,35,7,17,0.412,7,16,0.438,0,1,0,13,18,0.722,2,6,8,1,3,3,2,2,27,22.1
Rodney Hood,24-085,G-F,1/13/17,UTA,DET,1,29,10,14,0.714,3,6,0.5,7,8,0.875,0,0,,0,4,4,2,0,1,2,3,27,21.3
Kevin Durant,28-026,F-G,10/25/16,GSW,SAS,1,37,11,18,0.611,10,15,0.667,1,3,0.333,4,5,0.8,0,10,10,4,2,2,0,2,27,26.8
Damian Lillard,26-126,G,11/18/16,POR,NOP,1,36,8,24,0.333,4,13,0.308,4,11,0.364,7,7,1,2,1,3,2,1,0,3,3,27,13.3
Jimmy Butler,27-062,G-F,11/15/16,CHI,POR,1,34,9,16,0.563,8,15,0.533,1,1,1,8,8,1,3,9,12,5,0,0,4,2,27,22.9
Sean Kilpatrick,27-061,G,3/8/17,BRK,ATL,0,30,8,14,0.571,5,7,0.714,3,7,0.429,8,9,0.889,0,4,4,1,1,0,2,0,27,20.9
Andrew Wiggins,21-355,F-G,2/12/17,MIN,CHI,1,34,10,19,0.526,8,14,0.571,2,5,0.4,5,6,0.833,2,4,6,4,2,1,1,2,27,23.6
Marc Gasol,32-045,C,3/15/17,MEM,CHI,1,37,10,21,0.476,7,15,0.467,3,6,0.5,4,5,0.8,0,6,6,7,0,1,0,1,27,22.9
Wilson Chandler,29-211,F,12/7/16,DEN,BRK,0,35,10,24,0.417,4,13,0.308,6,11,0.545,1,3,0.333,5,10,15,0,1,0,2,3,27,17.7
Lou Williams,30-056,G,12/22/16,LAL,MIA,0,28,8,17,0.471,5,10,0.5,3,7,0.429,8,8,1,0,2,2,1,0,0,1,1,27,18.2
Damian Lillard,26-110,G,11/2/16,POR,PHO,1,40,9,22,0.409,8,14,0.571,1,8,0.125,8,10,0.8,0,5,5,5,1,0,2,5,27,16.4
Russell Westbrook,28-074,G,1/25/17,OKC,NOP,1,36,7,22,0.318,3,13,0.231,4,9,0.444,9,12,0.75,1,11,12,10,1,1,8,3,27,16.7
Jimmy Butler,27-173,G-F,3/6/17,CHI,DET,1,39,7,16,0.438,6,10,0.6,1,6,0.167,12,13,0.923,3,6,9,4,1,1,5,0,27,21.6
DeMarcus Cousins,26-194,C-F,2/23/17,NOP,HOU,1,35,11,19,0.579,10,14,0.714,1,5,0.2,4,5,0.8,4,10,14,5,5,4,1,4,27,32.2
Nikola Vucevic,26-159,C,4/1/17,ORL,BRK,1,32,13,20,0.65,12,18,0.667,1,2,0.5,0,0,,4,7,11,1,1,1,3,4,27,20.9
Andrew Wiggins,21-342,F-G,1/30/17,MIN,ORL,1,41,10,21,0.476,9,18,0.5,1,3,0.333,6,8,0.75,2,1,3,5,2,1,3,1,27,20
Juan Hernangomez,21-138,F,2/13/17,DEN,GSW,1,43,9,17,0.529,3,7,0.429,6,10,0.6,3,4,0.75,3,7,10,2,1,0,1,3,27,22.7
Devin Booker,20-065,G,1/3/17,PHO,MIA,1,35,9,19,0.474,6,13,0.462,3,6,0.5,6,7,0.857,1,1,2,4,1,0,6,3,27,14.5
Bojan Bogdanovic,27-321,G-F,3/5/17,WAS,ORL,0,27,9,12,0.75,1,2,0.5,8,10,0.8,1,1,1,1,1,2,1,0,0,1,2,27,22.1
Marc Gasol,31-299,C,11/23/16,MEM,PHI,1,45,10,20,0.5,8,15,0.533,2,5,0.4,5,6,0.833,3,1,4,4,3,3,5,4,27,20.3
DeMar DeRozan,27-240,G,4/4/17,TOR,IND,1,40,9,21,0.429,9,19,0.474,0,2,0,9,10,0.9,1,2,3,2,3,0,2,3,27,18
Danilo Gallinari,28-129,F,12/15/16,DEN,POR,1,36,8,13,0.615,5,7,0.714,3,6,0.5,8,8,1,0,4,4,3,1,0,2,2,27,22.6
Blake Griffin,27-261,F,12/2/16,LAC,NOP,1,34,12,22,0.545,11,20,0.55,1,2,0.5,2,3,0.667,1,8,9,4,0,0,2,4,27,18.3
Rudy Gobert,24-208,C,1/20/17,UTA,DAL,1,41,8,11,0.727,8,11,0.727,0,0,,11,17,0.647,10,15,25,1,1,2,3,3,27,30.5
Jabari Parker,21-281,F,12/21/16,MIL,CLE,1,29,11,20,0.55,7,15,0.467,4,5,0.8,1,1,1,0,1,1,2,0,1,1,1,27,18.4
Isaiah Thomas,27-297,G,11/30/16,BOS,DET,1,33,10,20,0.5,7,13,0.538,3,7,0.429,4,4,1,0,0,0,4,0,0,2,0,27,17.8
Tyler Johnson,24-214,G,12/7/16,MIA,ATL,0,35,8,16,0.5,4,11,0.364,4,5,0.8,7,8,0.875,0,2,2,5,1,1,0,1,27,24
Paul George,26-231,F,12/19/16,IND,WAS,1,40,10,21,0.476,8,15,0.533,2,6,0.333,5,6,0.833,2,7,9,2,1,0,4,4,27,16.2
Kevin Love,28-079,F,11/25/16,CLE,DAL,1,28,8,14,0.571,1,5,0.2,7,9,0.778,4,4,1,1,9,10,4,3,0,1,1,27,28.2
Goran Dragic,30-271,G,2/1/17,MIA,ATL,1,30,8,13,0.615,4,8,0.5,4,5,0.8,7,9,0.778,0,5,5,5,1,0,2,4,27,22.7
Stephen Curry,29-010,G,3/24/17,GSW,SAC,1,33,9,18,0.5,4,7,0.571,5,11,0.455,4,4,1,1,6,7,12,6,0,3,0,27,31.9
LeBron James,32-043,F-G,2/11/17,CLE,DEN,1,33,11,16,0.688,10,15,0.667,1,1,1,4,4,1,0,5,5,12,2,0,6,1,27,25.7
Bojan Bogdanovic,27-317,G-F,3/1/17,WAS,TOR,0,25,9,12,0.75,3,5,0.6,6,7,0.857,3,3,1,0,2,2,0,0,0,2,2,27,20
Nikola Jokic,21-358,C-F,2/11/17,DEN,CLE,1,38,9,18,0.5,8,16,0.5,1,2,0.5,8,10,0.8,6,7,13,4,0,2,5,2,27,21.9
Joe Johnson,35-224,G-F,2/8/17,UTA,NOP,0,24,10,14,0.714,4,6,0.667,6,8,0.75,1,1,1,1,2,3,1,0,0,0,1,27,22.8
Kemba Walker,26-300,G,3/4/17,CHO,DEN,1,38,8,21,0.381,3,12,0.25,5,9,0.556,6,6,1,1,3,4,4,2,1,1,0,27,21.6
Al Horford,30-289,C-F,3/19/17,BOS,PHI,1,33,11,16,0.688,10,14,0.714,1,2,0.5,4,5,0.8,1,7,8,6,1,2,1,1,27,27.8
Andrew Wiggins,22-004,F-G,2/27/17,MIN,SAC,1,35,10,22,0.455,9,19,0.474,1,3,0.333,6,8,0.75,2,2,4,1,4,0,0,1,27,21.1
Jimmy Butler,27-090,G-F,12/13/16,CHI,MIN,1,39,9,22,0.409,8,20,0.4,1,2,0.5,8,9,0.889,1,8,9,6,3,1,2,2,27,23
Kyle Lowry,30-241,G,11/21/16,TOR,LAC,1,42,8,18,0.444,5,11,0.455,3,7,0.429,8,9,0.889,0,6,6,7,0,0,3,4,27,19.3
Trey Burke,24-151,G,4/12/17,WAS,MIA,0,31,10,13,0.769,5,6,0.833,5,7,0.714,2,2,1,0,0,0,4,1,0,2,0,27,23.7
Bryn Forbes,23-258,G,4/7/17,SAS,DAL,0,29,10,19,0.526,6,10,0.6,4,9,0.444,3,3,1,0,3,3,6,0,0,1,3,27,20.6
Kristaps Porzingis,21-190,F-C,2/8/17,NYK,LAC,1,27,10,19,0.526,6,12,0.5,4,7,0.571,3,4,0.75,4,2,6,2,2,0,1,5,27,21.1
Isaiah Thomas,28-036,G,3/15/17,BOS,MIN,1,32,8,15,0.533,4,6,0.667,4,9,0.444,7,7,1,0,3,3,4,1,0,2,2,27,21.6
DeMar DeRozan,27-123,G,12/8/16,TOR,MIN,1,37,7,20,0.35,6,19,0.316,1,1,1,12,13,0.923,1,7,8,5,0,0,2,2,27,18.9
Derrick Rose,28-044,G,11/17/16,NYK,WAS,1,39,8,18,0.444,5,13,0.385,3,5,0.6,8,8,1,2,0,2,4,1,0,2,1,27,20.4
Trevor Ariza,31-120,F,10/28/16,HOU,DAL,1,36,8,12,0.667,3,5,0.6,5,7,0.714,6,6,1,0,4,4,0,1,0,0,3,27,22.8
Eric Bledsoe,26-360,G,12/3/16,PHO,GSW,1,30,10,19,0.526,5,11,0.455,5,8,0.625,2,2,1,0,5,5,4,5,0,1,3,27,24.8
Ryan Anderson,28-268,F,1/29/17,HOU,IND,1,35,9,16,0.563,4,7,0.571,5,9,0.556,4,5,0.8,1,6,7,0,1,0,0,2,27,21.7
Kevin Durant,28-099,F-G,1/6/17,GSW,MEM,1,43,7,17,0.412,7,12,0.583,0,5,0,13,18,0.722,2,11,13,4,0,3,4,1,27,21.1
Dion Waiters,24-340,G,11/14/16,MIA,SAS,1,36,12,26,0.462,9,20,0.45,3,6,0.5,0,0,,0,2,2,3,3,3,4,5,27,15.4
Hassan Whiteside,27-139,C,10/30/16,MIA,SAS,1,35,10,15,0.667,10,15,0.667,0,0,,7,10,0.7,1,14,15,1,1,4,1,2,27,26.9
Tyler Ulis,21-096,G,4/11/17,PHO,SAC,1,35,10,25,0.4,7,17,0.412,3,8,0.375,4,6,0.667,2,2,4,6,1,0,1,0,27,18.9
Chris Paul,31-319,G,3/21/17,LAC,LAL,1,25,9,15,0.6,5,7,0.714,4,8,0.5,5,5,1,2,6,8,4,1,0,2,2,27,24.3
Marquese Chriss,19-217,F,2/4/17,PHO,MIL,1,24,9,15,0.6,6,10,0.6,3,5,0.6,6,9,0.667,3,3,6,0,0,2,0,4,27,21.7
James Harden,27-229,G,4/12/17,HOU,MIN,1,35,8,13,0.615,3,3,1,5,10,0.5,6,8,0.75,1,9,10,12,4,1,4,3,27,31.6
Bradley Beal,23-276,G,3/31/17,WAS,UTA,1,39,10,20,0.5,7,13,0.538,3,7,0.429,4,4,1,1,2,3,0,1,0,5,2,27,13.5
Eric Bledsoe,26-346,G,11/19/16,PHO,PHI,1,30,12,24,0.5,11,20,0.55,1,4,0.25,2,2,1,2,3,5,6,0,0,4,3,27,16.3
Gordon Hayward,26-304,F-G,1/21/17,UTA,IND,1,31,8,13,0.615,6,10,0.6,2,3,0.667,9,10,0.9,0,2,2,0,0,0,1,1,27,19.9
Dennis Schroder,23-194,G,3/28/17,ATL,PHO,1,39,12,27,0.444,10,19,0.526,2,8,0.25,1,1,1,0,6,6,9,1,0,8,4,27,12.4
Lou Williams,30-119,G,2/23/17,HOU,NOP,0,25,9,16,0.563,2,5,0.4,7,11,0.636,2,2,1,1,1,2,2,0,0,1,1,27,20.4
Russell Westbrook,28-032,G,12/14/16,OKC,UTA,1,31,7,25,0.28,5,20,0.25,2,5,0.4,11,13,0.846,1,5,6,5,1,0,5,4,27,11.6
Kyrie Irving,24-325,G,2/11/17,CLE,DEN,1,35,10,24,0.417,5,13,0.385,5,11,0.455,2,2,1,1,3,4,5,1,1,3,4,27,16.4
Evan Fournier,24-029,G-F,11/27/16,ORL,MIL,1,38,11,21,0.524,8,11,0.727,3,10,0.3,2,3,0.667,2,4,6,7,2,0,1,4,27,23.2
Stephen Curry,28-348,G,2/25/17,GSW,BRK,1,35,9,21,0.429,4,11,0.364,5,10,0.5,4,4,1,1,4,5,5,3,0,4,2,27,19.5
John Wall,26-119,G,1/3/17,WAS,DAL,1,39,10,19,0.526,9,16,0.563,1,3,0.333,6,6,1,0,4,4,8,3,1,4,0,27,24.2
Goran Dragic,30-206,G,11/28/16,MIA,BOS,1,38,8,15,0.533,8,13,0.615,0,2,0,11,12,0.917,0,2,2,17,1,0,1,5,27,29.8
Klay Thompson,26-356,G,1/29/17,GSW,POR,1,35,6,21,0.286,4,15,0.267,2,6,0.333,13,15,0.867,1,5,6,2,1,1,0,0,27,19.2
C.J. Miles,29-349,G-F,4/2/17,IND,CLE,0,34,8,13,0.615,3,4,0.75,5,9,0.556,6,6,1,2,4,6,2,1,0,0,1,27,25.7
Kristaps Porzingis,21-094,F-C,11/4/16,NYK,CHI,1,33,10,15,0.667,6,8,0.75,4,7,0.571,3,5,0.6,2,3,5,1,0,0,0,5,27,20.7
Kyle Lowry,30-278,G,12/28/16,TOR,GSW,1,40,9,22,0.409,4,10,0.4,5,12,0.417,4,5,0.8,2,4,6,11,2,0,3,3,27,22.9
Karl-Anthony Towns,21-018,C-F,12/3/16,MIN,CHO,1,34,10,22,0.455,10,20,0.5,0,2,0,7,7,1,4,11,15,1,1,2,2,3,27,21.6
Wesley Matthews,30-112,G,2/3/17,DAL,POR,1,40,8,17,0.471,5,11,0.455,3,6,0.5,8,9,0.889,0,6,6,3,0,0,2,3,27,18.6
John Wall,26-071,G,11/16/16,WAS,PHI,1,24,8,19,0.421,7,16,0.438,1,3,0.333,10,12,0.833,0,4,4,6,1,0,2,2,27,19.7
Jamal Crawford,36-310,G,1/24/17,LAC,PHI,0,33,9,14,0.643,3,5,0.6,6,9,0.667,3,3,1,0,1,1,2,1,0,3,0,27,20.5
Frank Kaminsky,23-317,F-C,2/15/17,CHO,TOR,1,37,11,18,0.611,8,11,0.727,3,7,0.429,2,2,1,0,5,5,3,1,1,2,4,27,20.5
Paul George,26-343,F,4/10/17,IND,PHI,1,36,11,20,0.55,8,12,0.667,3,8,0.375,2,2,1,1,1,2,5,2,1,1,0,27,23.6
Devin Booker,20-117,G,2/24/17,PHO,CHI,1,41,10,21,0.476,8,17,0.471,2,4,0.5,5,8,0.625,0,3,3,2,2,0,4,4,27,13.8
LaMarcus Aldridge,31-162,F-C,12/28/16,SAS,PHO,1,33,10,12,0.833,10,12,0.833,0,0,,7,9,0.778,3,5,8,2,1,1,0,2,27,27.7
Kyrie Irving,24-351,G,3/9/17,CLE,DET,1,40,11,22,0.5,10,16,0.625,1,6,0.167,4,6,0.667,1,4,5,3,0,1,3,1,27,16.5
Eric Bledsoe,27-010,G,12/19/16,PHO,MIN,1,33,9,20,0.45,6,16,0.375,3,4,0.75,6,9,0.667,0,1,1,3,2,2,3,1,27,17.8
Damian Lillard,26-200,G,1/31/17,POR,CHO,1,31,10,18,0.556,8,13,0.615,2,5,0.4,5,5,1,0,4,4,4,1,0,1,3,27,21.2
Kentavious Caldwell-Pope,23-265,G,11/9/16,DET,PHO,1,42,9,22,0.409,4,12,0.333,5,10,0.5,4,5,0.8,1,5,6,1,1,0,1,3,27,16.5
Bradley Beal,23-270,G,3/25/17,WAS,CLE,1,43,9,19,0.474,7,13,0.538,2,6,0.333,7,7,1,0,4,4,6,0,0,2,1,27,20.3
Bradley Beal,23-215,G,1/29/17,WAS,NOP,1,39,11,16,0.688,8,10,0.8,3,6,0.5,2,3,0.667,0,6,6,2,1,0,4,1,27,19.6
Gordon Hayward,26-355,F-G,3/13/17,UTA,LAC,1,36,9,18,0.5,5,13,0.385,4,5,0.8,5,7,0.714,0,3,3,4,0,0,3,2,27,17.1
Dwight Howard,31-008,C,12/16/16,ATL,TOR,1,34,10,13,0.769,10,13,0.769,0,0,,7,10,0.7,7,8,15,1,0,0,1,3,27,26.5
Kyle Lowry,31-011,G,4/5/17,TOR,DET,1,42,9,16,0.563,7,11,0.636,2,5,0.4,7,7,1,0,5,5,10,2,0,2,2,27,27.1
Giannis Antetokounmpo,22-029,F-G,1/4/17,MIL,NYK,1,39,10,18,0.556,9,14,0.643,1,4,0.25,6,7,0.857,1,12,13,4,1,3,3,2,27,24.4
Jabari Parker,21-272,F,12/12/16,MIL,TOR,1,35,11,17,0.647,9,14,0.643,2,3,0.667,3,5,0.6,2,1,3,2,1,0,2,2,27,20
John Wall,26-140,G,1/24/17,WAS,BOS,1,38,11,20,0.55,10,18,0.556,1,2,0.5,4,5,0.8,0,7,7,7,3,1,4,2,27,22.9
LeBron James,31-338,F-G,12/2/16,CLE,CHI,1,45,13,22,0.591,12,19,0.632,1,3,0.333,0,0,,0,5,5,13,0,0,8,2,27,18.6
Kyrie Irving,24-291,G,1/8/17,CLE,PHO,1,40,10,20,0.5,6,13,0.462,4,7,0.571,3,3,1,1,1,2,7,1,0,7,0,27,16.9
Dennis Schroder,23-099,G,12/23/16,ATL,DEN,1,36,9,19,0.474,7,15,0.467,2,4,0.5,7,7,1,0,6,6,5,1,0,3,2,27,19.8
Reggie Jackson,26-260,G,1/1/17,DET,MIA,1,33,10,17,0.588,8,12,0.667,2,5,0.4,5,5,1,0,2,2,4,1,0,3,1,27,20.1
Eric Gordon,27-323,G,11/12/16,HOU,SAS,0,32,10,16,0.625,3,4,0.75,7,12,0.583,0,0,,0,5,5,2,1,1,2,2,27,21.6
Karl-Anthony Towns,21-006,C-F,11/21/16,MIN,BOS,1,38,11,19,0.579,9,15,0.6,2,4,0.5,3,6,0.5,6,12,18,3,0,2,1,3,27,26
Kevin Durant,28-075,F-G,12/13/16,GSW,NOP,1,37,10,19,0.526,9,16,0.563,1,3,0.333,6,7,0.857,0,2,2,3,0,2,3,2,27,17.6
Boban Marjanovic,28-235,C,4/7/17,DET,HOU,0,28,12,18,0.667,12,18,0.667,0,0,,3,4,0.75,2,10,12,2,0,0,0,2,27,23.8
Chris Paul,31-174,G,10/27/16,LAC,POR,1,33,9,19,0.474,6,11,0.545,3,8,0.375,6,7,0.857,0,5,5,5,1,0,1,2,27,21.1
Marvin Williams,30-265,F,3/11/17,CHO,NOP,1,40,12,20,0.6,10,12,0.833,2,8,0.25,1,1,1,3,7,10,3,1,0,1,1,27,23.7
James Harden,27-140,G,1/13/17,HOU,MEM,1,37,6,14,0.429,4,7,0.571,2,7,0.286,13,14,0.929,0,3,3,9,1,0,7,3,27,19.2
Paul George,26-287,F,2/13/17,IND,SAS,1,37,8,15,0.533,4,8,0.5,4,7,0.571,7,8,0.875,0,6,6,3,0,0,2,5,27,19.2
Jamal Murray,20-048,G,4/12/17,DEN,OKC,1,41,10,17,0.588,6,12,0.5,4,5,0.8,3,3,1,0,2,2,6,0,1,3,1,27,21.2
Kevin Durant,28-116,F-G,1/23/17,GSW,MIA,1,36,12,23,0.522,11,15,0.733,1,8,0.125,2,2,1,0,6,6,3,1,0,2,2,27,17.8
Kevin Durant,28-151,F-G,2/27/17,GSW,PHI,1,33,8,17,0.471,7,13,0.538,1,4,0.25,10,11,0.909,3,5,8,4,0,1,2,2,27,22.2
John Wall,26-188,G,3/13/17,WAS,MIN,1,38,6,16,0.375,5,13,0.385,1,3,0.333,14,19,0.737,0,2,2,5,1,0,4,5,27,15.3
LeBron James,31-317,F-G,11/11/16,CLE,WAS,1,38,9,18,0.5,6,14,0.429,3,4,0.75,6,9,0.667,0,10,10,5,2,2,6,1,27,20.3
Devin Booker,20-154,G,4/2/17,PHO,HOU,1,39,7,22,0.318,6,16,0.375,1,6,0.167,12,12,1,0,5,5,9,1,0,8,4,27,13.6
Russell Westbrook,28-016,G,11/28/16,OKC,NYK,1,36,9,23,0.391,7,20,0.35,2,3,0.667,7,7,1,5,12,17,14,2,0,7,3,27,25.2
Bradley Beal,23-188,G,1/2/17,WAS,HOU,1,35,9,18,0.5,4,8,0.5,5,10,0.5,4,4,1,0,3,3,2,2,0,3,0,27,19.3
LaMarcus Aldridge,31-166,F-C,1/1/17,SAS,ATL,1,43,12,17,0.706,11,16,0.688,1,1,1,2,2,1,3,10,13,2,0,3,2,0,27,26.5
Jabari Parker,21-291,F,12/31/16,MIL,CHI,1,40,10,15,0.667,9,12,0.75,1,3,0.333,6,6,1,0,5,5,3,1,1,2,2,27,23
Goran Dragic,30-209,G,12/1/16,MIA,UTA,1,37,10,21,0.476,8,18,0.444,2,3,0.667,5,7,0.714,2,2,4,6,0,0,2,4,27,18.1
Russell Westbrook,28-027,G,12/9/16,OKC,HOU,1,36,8,25,0.32,8,18,0.444,0,7,0,11,12,0.917,1,9,10,10,3,0,8,3,27,16.5
Karl-Anthony Towns,21-063,C-F,1/17/17,MIN,SAS,1,43,10,18,0.556,8,16,0.5,2,2,1,5,5,1,4,12,16,0,0,1,5,4,27,18.9
J.J. Redick,32-179,G,12/20/16,LAC,DEN,1,26,10,16,0.625,3,7,0.429,7,9,0.778,0,0,,0,3,3,2,1,0,0,0,27,23.1
Kawhi Leonard,25-176,F,12/22/16,SAS,LAC,1,34,8,19,0.421,7,16,0.438,1,3,0.333,10,11,0.909,4,5,9,5,1,2,4,2,27,21.9
Russell Westbrook,28-080,G,1/31/17,OKC,SAS,1,34,7,17,0.412,4,10,0.4,3,7,0.429,10,10,1,1,5,6,14,1,0,6,4,27,23.3
Damian Lillard,26-135,G,11/27/16,POR,HOU,1,38,7,20,0.35,5,12,0.417,2,8,0.25,11,13,0.846,1,4,5,5,1,0,7,2,27,13.6
Kyle Lowry,30-266,G,12/16/16,TOR,ATL,1,37,9,16,0.563,3,8,0.375,6,8,0.75,3,6,0.5,0,2,2,6,0,0,3,5,27,18
Joel Embiid,22-282,C-F,12/23/16,PHI,PHO,1,28,8,15,0.533,7,12,0.583,1,3,0.333,10,11,0.909,0,7,7,1,0,2,3,3,27,19.3
Stephen Curry,28-314,G,1/22/17,GSW,ORL,1,30,8,15,0.533,1,2,0.5,7,13,0.538,4,4,1,1,3,4,6,0,0,3,2,27,21.7
Nikola Jokic,21-304,C-F,12/19/16,DEN,DAL,1,38,13,17,0.765,12,16,0.75,1,1,1,0,0,,3,12,15,9,0,0,3,1,27,28.9
Jabari Parker,21-269,F,12/9/16,MIL,ATL,1,39,11,24,0.458,8,17,0.471,3,7,0.429,2,4,0.5,2,2,4,4,3,0,2,3,27,18.4
Bradley Beal,23-252,G,3/7/17,WAS,PHO,1,33,10,20,0.5,8,15,0.533,2,5,0.4,5,7,0.714,1,2,3,0,2,0,2,1,27,17.1
Damian Lillard,26-110,G,11/2/16,POR,PHO,1,40,9,22,0.409,8,14,0.571,1,8,0.125,8,10,0.8,0,5,5,5,1,0,2,5,27,16.4
Andrew Wiggins,21-349,F-G,2/6/17,MIN,MIA,1,37,11,23,0.478,9,19,0.474,2,4,0.5,3,3,1,1,3,4,0,2,0,1,2,27,17.1
Dennis Schroder,23-104,G,12/28/16,ATL,NYK,1,40,11,21,0.524,10,18,0.556,1,3,0.333,4,6,0.667,0,0,0,5,2,0,2,2,27,18.6
Mason Plumlee,26-290,C-F,12/20/16,POR,SAC,1,36,10,13,0.769,10,12,0.833,0,1,0,7,11,0.636,4,9,13,5,1,2,1,5,27,28.7
Kyle Lowry,30-276,G,12/26/16,TOR,POR,1,40,8,18,0.444,3,5,0.6,5,13,0.385,6,7,0.857,1,5,6,4,2,0,3,4,27,19.6
C.J. McCollum,25-114,G,1/11/17,POR,CLE,1,32,11,20,0.55,6,10,0.6,5,10,0.5,0,0,,0,4,4,2,1,3,1,3,27,20.9
Isaiah Thomas,27-338,G,1/10/17,BOS,TOR,1,37,8,19,0.421,5,11,0.455,3,8,0.375,8,9,0.889,0,1,1,7,0,0,1,0,27,20.7
Chris Paul,31-327,G,3/29/17,LAC,WAS,1,37,9,15,0.6,7,10,0.7,2,5,0.4,7,8,0.875,1,2,3,13,1,0,1,2,27,29.3
Austin Rivers,24-175,G,1/23/17,LAC,ATL,1,41,10,21,0.476,5,11,0.455,5,10,0.5,2,2,1,0,4,4,6,0,0,4,1,27,17.3
Chris Paul,31-182,G,11/4/16,LAC,MEM,1,33,6,16,0.375,5,8,0.625,1,8,0.125,14,15,0.933,1,3,4,11,6,2,1,4,27,31.9
Russell Westbrook,28-086,G,2/6/17,OKC,IND,1,37,10,27,0.37,6,17,0.353,4,10,0.4,3,4,0.75,2,16,18,9,1,2,4,3,27,21.4
Kawhi Leonard,25-123,F,10/30/16,SAS,MIA,1,30,8,16,0.5,7,13,0.538,1,3,0.333,10,12,0.833,0,2,2,6,1,1,4,3,27,19.5
Bradley Beal,23-248,G,3/3/17,WAS,TOR,1,36,10,21,0.476,7,13,0.538,3,8,0.375,4,5,0.8,4,3,7,4,1,0,2,4,27,19.8
Enes Kanter,24-192,C,11/28/16,OKC,NYK,0,28,12,17,0.706,12,16,0.75,0,1,0,3,5,0.6,6,4,10,0,0,3,1,4,27,24
Kevin Love,28-101,F,12/17/16,CLE,LAL,1,33,11,20,0.55,8,13,0.615,3,7,0.429,2,3,0.667,3,14,17,4,1,0,2,1,27,24.7
Kevin Durant,28-036,F-G,11/4/16,GSW,LAL,1,35,10,16,0.625,8,12,0.667,2,4,0.5,5,8,0.625,1,4,5,3,2,1,2,1,27,22.9
Blake Griffin,27-225,F,10/27/16,LAC,POR,1,37,9,22,0.409,8,19,0.421,1,3,0.333,8,9,0.889,5,8,13,2,3,1,1,5,27,22.8
Lou Williams,30-085,G,1/20/17,LAL,IND,0,30,7,15,0.467,3,7,0.429,4,8,0.5,9,10,0.9,0,4,4,3,1,1,3,2,27,20.1
Derrick Rose,28-174,G,3/27/17,NYK,DET,1,33,12,17,0.706,12,17,0.706,0,0,,3,3,1,0,4,4,6,1,0,0,0,27,26.3
Jabari Parker,21-233,F,11/3/16,MIL,IND,1,33,11,17,0.647,7,11,0.636,4,6,0.667,1,1,1,3,5,8,3,0,1,4,2,27,21.1
Brook Lopez,28-352,C,3/19/17,BRK,DAL,1,33,8,18,0.444,5,12,0.417,3,6,0.5,8,10,0.8,4,3,7,0,0,0,4,4,27,14.9
Jabari Parker,21-325,F,2/3/17,MIL,DEN,1,35,10,20,0.5,8,13,0.615,2,7,0.286,5,5,1,1,10,11,4,2,1,3,3,27,22
LeBron James,32-098,F-G,4/7/17,CLE,ATL,1,41,12,15,0.8,11,13,0.846,1,2,0.5,2,6,0.333,1,7,8,7,2,0,5,0,27,24.4
LeBron James,32-033,F-G,2/1/17,CLE,MIN,1,34,11,14,0.786,10,12,0.833,1,2,0.5,4,7,0.571,0,8,8,12,2,1,2,1,27,31.5
Gordon Hayward,26-315,F-G,2/1/17,UTA,MIL,1,32,8,13,0.615,5,7,0.714,3,6,0.5,8,10,0.8,1,4,5,5,3,0,2,2,27,25.9
Jabari Parker,21-267,F,12/7/16,MIL,POR,1,34,11,23,0.478,10,18,0.556,1,5,0.2,4,5,0.8,0,3,3,1,0,0,1,0,27,15.5
T.J. Warren,23-058,F,11/2/16,PHO,POR,1,38,11,22,0.5,11,22,0.5,0,0,,5,5,1,4,3,7,0,2,1,0,2,27,21.6
Andrew Wiggins,21-331,F-G,1/19/17,MIN,LAC,1,38,9,19,0.474,8,17,0.471,1,2,0.5,8,10,0.8,1,3,4,4,0,1,2,2,27,18.8
Andrew Wiggins,22-001,F-G,2/24/17,MIN,DAL,1,38,11,21,0.524,10,18,0.556,1,3,0.333,4,5,0.8,2,5,7,3,1,1,4,3,27,17.8
Kevin Love,28-070,F,11/16/16,CLE,IND,1,33,11,23,0.478,7,13,0.538,4,10,0.4,1,4,0.25,3,13,16,1,0,0,2,0,27,18.8
Devin Booker,20-103,G,2/10/17,PHO,CHI,1,33,10,19,0.526,8,15,0.533,2,4,0.5,5,6,0.833,3,2,5,4,0,0,1,1,27,21.4
Karl-Anthony Towns,21-081,C-F,2/4/17,MIN,MEM,1,38,8,15,0.533,6,11,0.545,2,4,0.5,9,10,0.9,5,10,15,2,1,1,2,5,27,24.9
Giannis Antetokounmpo,21-333,F-G,11/3/16,MIL,IND,1,34,11,18,0.611,11,16,0.688,0,2,0,5,7,0.714,2,5,7,9,2,2,4,1,27,26.2
James Harden,27-117,G,12/21/16,HOU,PHO,1,35,8,18,0.444,3,7,0.429,5,11,0.455,6,8,0.75,1,4,5,14,1,0,2,1,27,27.1
Giannis Antetokounmpo,21-342,F-G,11/12/16,MIL,MEM,1,38,9,13,0.692,9,12,0.75,0,1,0,9,13,0.692,0,6,6,5,4,4,5,5,27,25
Andrew Wiggins,22-035,F-G,3/30/17,MIN,LAL,1,40,9,20,0.45,8,17,0.471,1,3,0.333,8,10,0.8,2,2,4,2,1,0,0,4,27,18.6
Zach Randolph,35-174,F,1/6/17,MEM,GSW,0,35,12,17,0.706,11,16,0.688,1,1,1,2,2,1,4,7,11,6,0,0,1,4,27,26.4
Mike Conley,29-087,G,1/6/17,MEM,GSW,1,41,10,19,0.526,7,10,0.7,3,9,0.333,4,5,0.8,0,4,4,12,1,0,2,1,27,25.5
Paul George,26-326,F,3/24/17,IND,DEN,1,35,10,18,0.556,6,13,0.462,4,5,0.8,3,5,0.6,0,9,9,3,3,1,2,5,27,22.1
Carmelo Anthony,32-287,F,3/12/17,NYK,BRK,1,37,10,26,0.385,9,21,0.429,1,5,0.2,6,7,0.857,1,6,7,3,0,1,3,2,27,13.9
Russell Westbrook,28-067,G,1/18/17,OKC,GSW,1,35,8,23,0.348,7,17,0.412,1,6,0.167,10,11,0.909,4,11,15,13,2,2,10,5,27,20.3
LeBron James,31-345,F-G,12/9/16,CLE,MIA,1,37,12,22,0.545,11,19,0.579,1,3,0.333,2,4,0.5,2,6,8,8,3,0,3,2,27,23.6
Kyle Lowry,30-288,G,1/7/17,TOR,CHI,1,44,7,17,0.412,5,8,0.625,2,9,0.222,11,14,0.786,2,7,9,12,3,1,3,3,27,28.1
Isaiah Thomas,27-322,G,12/25/16,BOS,NYK,1,33,9,23,0.391,6,10,0.6,3,13,0.231,6,8,0.75,0,3,3,4,0,0,2,3,27,14.2
C.J. McCollum,25-108,G,1/5/17,POR,LAL,1,35,11,21,0.524,8,10,0.8,3,11,0.273,2,2,1,1,3,4,7,1,0,2,4,27,20.6
Bradley Beal,23-274,G,3/29/17,WAS,LAC,1,40,10,22,0.455,5,11,0.455,5,11,0.455,2,4,0.5,0,0,0,4,0,0,0,4,27,16
Nikola Jokic,21-297,C-F,12/12/16,DEN,DAL,0,26,10,12,0.833,10,12,0.833,0,0,,7,7,1,7,4,11,4,1,1,1,1,27,31.8
Trey Burke,24-048,G,12/30/16,WAS,BRK,0,30,10,12,0.833,5,7,0.714,5,5,1,2,2,1,0,2,2,2,2,0,2,0,27,24.6
Paul Millsap,32-021,F,3/3/17,ATL,CLE,1,37,9,16,0.563,8,12,0.667,1,4,0.25,8,10,0.8,2,7,9,1,0,1,0,3,27,22.3
Mike Conley,29-155,G,3/15/17,MEM,CHI,1,36,8,12,0.667,3,4,0.75,5,8,0.625,6,6,1,0,9,9,7,1,0,4,3,27,25.2
Kemba Walker,26-265,G,1/28/17,CHO,SAC,1,39,8,16,0.5,5,10,0.5,3,6,0.5,7,8,0.875,1,2,3,7,1,1,2,3,26,22.3
DeMarre Carroll,30-165,F,1/8/17,TOR,HOU,1,34,7,12,0.583,1,2,0.5,6,10,0.6,6,6,1,0,8,8,0,1,0,1,1,26,22.4
Jeremy Lin,28-230,G,4/10/17,BRK,BOS,1,34,4,9,0.444,2,4,0.5,2,5,0.4,16,17,0.941,3,9,12,4,0,0,1,4,26,25.9
Harrison Barnes,24-218,F,1/3/17,DAL,WAS,1,35,8,18,0.444,6,14,0.429,2,4,0.5,8,9,0.889,0,7,7,5,0,1,2,5,26,18.5
Markieff Morris,27-161,F,2/10/17,WAS,IND,1,31,11,18,0.611,8,12,0.667,3,6,0.5,1,2,0.5,2,8,10,3,1,0,0,1,26,23.9
Blake Griffin,28-013,F,3/29/17,LAC,WAS,1,40,10,16,0.625,10,14,0.714,0,2,0,6,8,0.75,1,9,10,9,2,0,2,3,26,26.5
Tobias Harris,24-161,F,12/23/16,DET,GSW,0,32,8,14,0.571,4,8,0.5,4,6,0.667,6,6,1,0,7,7,1,0,0,1,3,26,20
John Wall,26-157,G,2/10/17,WAS,IND,1,37,7,16,0.438,5,11,0.455,2,5,0.4,10,15,0.667,0,3,3,14,2,0,7,4,26,19.7
John Wall,26-080,G,11/25/16,WAS,ORL,1,39,10,18,0.556,9,14,0.643,1,4,0.25,5,6,0.833,0,7,7,10,3,0,4,2,26,24.3
Carmelo Anthony,32-215,F,12/30/16,NYK,NOP,1,40,8,22,0.364,7,17,0.412,1,5,0.2,9,10,0.9,1,12,13,3,1,0,4,3,26,15.6
Nikola Vucevic,26-057,C,12/20/16,ORL,MIA,0,40,11,20,0.55,10,19,0.526,1,1,1,3,5,0.6,1,11,12,3,0,2,4,5,26,17.1
Elfrid Payton,22-295,G,12/13/16,ORL,ATL,0,35,9,12,0.75,6,9,0.667,3,3,1,5,7,0.714,1,2,3,14,2,0,2,2,26,30.7
DeMar DeRozan,27-110,G,11/25/16,TOR,MIL,1,35,9,18,0.5,9,16,0.563,0,2,0,8,10,0.8,1,6,7,4,0,0,1,1,26,20.1
Blake Griffin,27-248,F,11/19/16,LAC,CHI,1,39,8,15,0.533,8,15,0.533,0,0,,10,10,1,2,11,13,5,1,0,3,3,26,23.7
Tim Hardaway,24-231,G,11/2/16,ATL,LAL,0,21,8,10,0.8,3,3,1,5,7,0.714,5,7,0.714,0,0,0,1,0,1,3,0,26,19.8
Giannis Antetokounmpo,21-346,F-G,11/16/16,MIL,ATL,1,40,11,22,0.5,11,20,0.55,0,2,0,4,6,0.667,4,11,15,7,1,2,4,4,26,22
Al-Farouq Aminu,26-141,F,2/9/17,POR,BOS,0,31,8,12,0.667,5,7,0.714,3,5,0.6,7,9,0.778,0,5,5,1,0,0,2,1,26,19.8
Khris Middleton,25-221,F-G,3/21/17,MIL,POR,1,33,11,22,0.5,8,19,0.421,3,3,1,1,1,1,0,3,3,3,2,1,4,2,26,15.9
C.J. McCollum,25-174,G,3/12/17,POR,PHO,1,39,11,20,0.55,10,16,0.625,1,4,0.25,3,4,0.75,1,3,4,4,1,1,2,3,26,18.9
DeMarcus Cousins,26-232,C-F,4/2/17,NOP,CHI,1,42,8,16,0.5,6,10,0.6,2,6,0.333,8,8,1,1,17,18,3,0,1,7,5,26,17.6
John Wall,26-126,G,1/10/17,WAS,CHI,1,40,11,21,0.524,10,19,0.526,1,2,0.5,3,4,0.75,0,6,6,14,1,1,5,2,26,22.8
Raymond Felton,32-187,G,12/30/16,LAC,HOU,0,31,10,20,0.5,6,13,0.462,4,7,0.571,2,2,1,1,4,5,8,1,0,5,1,26,19.1
Avery Bradley,26-041,G,1/6/17,BOS,PHI,1,36,10,24,0.417,4,13,0.308,6,11,0.545,0,0,,2,7,9,2,1,0,0,1,26,18.7
Andrew Wiggins,22-022,F-G,3/17/17,MIN,MIA,1,39,10,23,0.435,9,21,0.429,1,2,0.5,5,6,0.833,1,2,3,0,1,1,2,2,26,13.7
James Harden,27-063,G,10/28/16,HOU,DAL,1,36,9,18,0.5,5,9,0.556,4,9,0.444,4,5,0.8,1,6,7,8,1,0,4,4,26,20.1
Karl-Anthony Towns,21-078,C-F,2/1/17,MIN,CLE,1,39,11,19,0.579,9,17,0.529,2,2,1,2,2,1,3,9,12,4,1,2,1,0,26,26.1
Kyrie Irving,24-219,G,10/28/16,CLE,TOR,1,38,10,23,0.435,5,14,0.357,5,9,0.556,1,1,1,1,5,6,6,0,0,7,4,26,11.7
Jrue Holiday,26-264,G,3/3/17,NOP,SAS,1,43,12,27,0.444,10,21,0.476,2,6,0.333,0,0,,1,6,7,5,1,0,4,1,26,14.5
Eric Bledsoe,27-027,G,1/5/17,PHO,DAL,1,30,9,16,0.563,7,9,0.778,2,7,0.286,6,7,0.857,0,0,0,7,1,0,3,1,26,20.5
Jahlil Okafor,21-030,C-F,1/14/17,PHI,WAS,1,35,10,16,0.625,10,16,0.625,0,0,,6,11,0.545,5,4,9,0,1,1,3,2,26,19.4
Kyrie Irving,24-296,G,1/13/17,CLE,SAC,1,35,10,22,0.455,8,15,0.533,2,7,0.286,4,4,1,1,3,4,5,1,0,3,5,26,15.7
Kemba Walker,26-298,G,3/2/17,CHO,PHO,1,36,10,24,0.417,7,13,0.538,3,11,0.273,3,4,0.75,0,4,4,8,2,0,1,4,26,19
Kentavious Caldwell-Pope,23-277,G,11/21/16,DET,HOU,1,38,9,15,0.6,6,9,0.667,3,6,0.5,5,7,0.714,0,1,1,2,2,0,4,4,26,16.4
Derrick Rose,28-109,G,1/21/17,NYK,PHO,1,36,12,26,0.462,12,25,0.48,0,1,0,2,2,1,3,0,3,5,0,0,0,2,26,17.4
Eric Gordon,27-338,G,11/27/16,HOU,POR,0,30,9,15,0.6,3,6,0.5,6,9,0.667,2,3,0.667,1,4,5,4,1,0,1,1,26,23
LeBron James,31-353,F-G,12/17/16,CLE,LAL,1,39,9,18,0.5,7,13,0.538,2,5,0.4,6,11,0.545,1,6,7,9,2,2,2,1,26,24.8
Bradley Beal,23-163,G,12/8/16,WAS,DEN,1,37,8,15,0.533,4,8,0.5,4,7,0.571,6,6,1,0,3,3,5,0,0,2,1,26,20.7
Paul George,26-248,F,1/5/17,IND,BRK,1,31,10,18,0.556,8,14,0.571,2,4,0.5,4,6,0.667,0,1,1,3,3,0,0,0,26,22
Terrence Jones,24-312,F,11/16/16,NOP,ORL,1,38,9,20,0.45,7,16,0.438,2,4,0.5,6,7,0.857,0,9,9,2,0,1,1,2,26,18.2
Carmelo Anthony,32-247,F,1/31/17,NYK,WAS,1,32,10,17,0.588,9,14,0.643,1,3,0.333,5,5,1,1,4,5,0,0,0,1,1,26,18.6
Jimmy Butler,27-072,G-F,11/25/16,CHI,PHI,1,31,10,15,0.667,9,13,0.692,1,2,0.5,5,6,0.833,1,3,4,3,1,0,0,1,26,23.4
Karl-Anthony Towns,21-137,C-F,4/1/17,MIN,SAC,1,40,8,17,0.471,7,12,0.583,1,5,0.2,9,10,0.9,3,8,11,2,1,0,5,4,26,17.2
Tony Snell,25-138,G-F,3/28/17,MIL,CHO,1,31,10,14,0.714,6,6,1,4,8,0.5,2,2,1,0,3,3,1,0,0,1,1,26,20.4
Stephen Curry,28-225,G,10/25/16,GSW,SAS,1,34,9,18,0.5,6,8,0.75,3,10,0.3,5,6,0.833,0,3,3,4,0,0,4,1,26,15.9
Marc Gasol,31-312,C,12/6/16,MEM,PHI,1,34,9,17,0.529,9,15,0.6,0,2,0,8,10,0.8,1,11,12,3,1,2,4,3,26,20.2
Carmelo Anthony,32-239,F,1/23/17,NYK,IND,1,34,9,17,0.529,8,14,0.571,1,3,0.333,7,8,0.875,1,4,5,2,0,1,4,4,26,15.7
James Johnson,30-044,F,4/5/17,MIA,CHO,1,32,10,12,0.833,4,5,0.8,6,7,0.857,0,0,,0,4,4,3,2,0,2,0,26,24.9
LeBron James,32-090,F-G,3/30/17,CLE,CHI,1,39,11,20,0.55,10,13,0.769,1,7,0.143,3,7,0.429,1,9,10,8,1,1,4,0,26,21.5
Kemba Walker,26-199,G,11/23/16,CHO,SAS,1,32,9,16,0.563,5,12,0.417,4,4,1,4,4,1,3,6,9,7,0,0,2,2,26,24.4
Kentavious Caldwell-Pope,24-014,G,3/4/17,DET,PHI,1,31,9,11,0.818,6,6,1,3,5,0.6,5,6,0.833,1,2,3,1,1,0,1,1,26,23.1
Victor Oladipo,24-198,G,11/18/16,OKC,BRK,1,36,11,17,0.647,8,11,0.727,3,6,0.5,1,1,1,1,4,5,6,0,0,3,4,26,20
LeBron James,31-333,F-G,11/27/16,CLE,PHI,1,42,9,19,0.474,8,15,0.533,1,4,0.25,7,9,0.778,2,8,10,13,1,0,5,0,26,24.4
Victor Oladipo,24-205,G,11/25/16,OKC,DEN,1,42,11,19,0.579,9,13,0.692,2,6,0.333,2,2,1,1,3,4,7,3,0,1,1,26,25.2
Blake Griffin,27-327,F,2/6/17,LAC,TOR,1,37,11,19,0.579,9,16,0.563,2,3,0.667,2,3,0.667,4,7,11,11,1,0,2,3,26,27.1
Blake Griffin,27-277,F,12/18/16,LAC,WAS,1,38,10,21,0.476,10,21,0.476,0,0,,6,8,0.75,1,6,7,7,1,0,2,1,26,20.5
Carmelo Anthony,32-222,F,1/6/17,NYK,MIL,1,39,8,20,0.4,4,15,0.267,4,5,0.8,6,9,0.667,0,6,6,10,1,0,2,1,26,21.4
Will Barton,26-011,G,1/17/17,DEN,LAL,1,35,9,16,0.563,4,11,0.364,5,5,1,3,5,0.6,1,3,4,8,0,0,1,3,26,22.6
T.J. Warren,23-055,F,10/30/16,PHO,GSW,1,37,10,21,0.476,8,16,0.5,2,5,0.4,4,4,1,3,3,6,1,1,1,0,5,26,18.7
Chris Paul,31-207,G,11/29/16,LAC,BRK,1,45,11,26,0.423,7,19,0.368,4,7,0.571,0,0,,3,7,10,13,2,1,4,2,26,23.4
Gordon Hayward,26-303,F-G,1/20/17,UTA,DAL,1,38,8,22,0.364,5,15,0.333,3,7,0.429,7,8,0.875,2,5,7,4,1,1,3,3,26,16.6
Giannis Antetokounmpo,22-027,F-G,1/2/17,MIL,OKC,1,41,10,19,0.526,9,16,0.563,1,3,0.333,5,10,0.5,2,8,10,5,1,1,1,0,26,22.7
Russell Westbrook,28-035,G,12/17/16,OKC,PHO,1,34,9,17,0.529,8,15,0.533,1,2,0.5,7,7,1,0,11,11,22,2,1,5,3,26,32.9
Rudy Gobert,24-220,C,2/1/17,UTA,MIL,1,34,9,13,0.692,9,13,0.692,0,0,,8,10,0.8,5,9,14,1,1,1,2,6,26,23.9
Jimmy Butler,27-108,G-F,12/31/16,CHI,MIL,1,38,7,16,0.438,5,10,0.5,2,6,0.333,10,15,0.667,3,4,7,8,2,0,3,1,26,23.1
Brook Lopez,28-255,C,12/12/16,BRK,HOU,1,32,9,17,0.529,9,15,0.6,0,2,0,8,8,1,1,0,1,2,1,2,4,1,26,17.8
Harrison Barnes,24-253,F,2/7/17,DAL,POR,1,38,10,19,0.526,9,16,0.563,1,3,0.333,5,8,0.625,0,5,5,0,2,0,2,2,26,16.2
Derrick Rose,28-155,G,3/8/17,NYK,MIL,1,39,13,16,0.813,13,16,0.813,0,0,,0,0,,0,1,1,6,0,0,2,0,26,22.5
Devin Booker,20-083,G,1/21/17,PHO,NYK,1,37,10,21,0.476,7,17,0.412,3,4,0.75,3,3,1,1,0,1,2,1,1,5,4,26,12.5
Bradley Beal,23-256,G,3/11/17,WAS,POR,1,33,9,18,0.5,4,8,0.5,5,10,0.5,3,4,0.75,0,1,1,6,1,0,1,2,26,20.3
DeMarcus Cousins,26-167,C-F,1/27/17,SAC,IND,1,39,8,17,0.471,7,12,0.583,1,5,0.2,9,14,0.643,3,13,16,5,0,1,6,5,26,17.5
Langston Galloway,24-362,G,12/5/16,NOP,MEM,0,36,9,18,0.5,3,5,0.6,6,13,0.462,2,2,1,0,1,1,2,0,0,1,0,26,17.7
Nick Young,31-254,G-F,2/10/17,LAL,MIL,1,29,8,11,0.727,3,3,1,5,8,0.625,5,5,1,1,1,2,4,2,0,1,3,26,25.1
Jamal Crawford,36-278,G,12/23/16,LAC,DAL,0,30,10,16,0.625,7,11,0.636,3,5,0.6,3,3,1,0,1,1,6,0,0,4,0,26,19.3
LaMarcus Aldridge,31-245,F-C,3/21/17,SAS,MIN,1,38,12,24,0.5,12,24,0.5,0,0,,2,2,1,3,1,4,3,2,2,2,3,26,18.7
Kevin Durant,28-084,F-G,12/22/16,GSW,BRK,1,34,10,23,0.435,9,16,0.563,1,7,0.143,5,6,0.833,0,9,9,7,3,1,0,2,26,24
Nikola Jokic,22-040,C-F,3/31/17,DEN,CHO,1,37,11,16,0.688,9,13,0.692,2,3,0.667,2,3,0.667,3,10,13,10,0,0,2,4,26,27.3
Jimmy Butler,27-082,G-F,12/5/16,CHI,POR,1,37,8,16,0.5,6,12,0.5,2,4,0.5,8,8,1,2,5,7,5,1,2,2,1,26,24.4
Kyrie Irving,24-302,G,1/19/17,CLE,PHO,1,33,10,20,0.5,8,13,0.615,2,7,0.286,4,5,0.8,0,2,2,4,2,0,2,2,26,18.2
Hassan Whiteside,27-272,C,3/12/17,MIA,IND,1,34,11,21,0.524,11,21,0.524,0,0,,4,5,0.8,10,11,21,0,0,1,2,2,26,23.5
Goran Dragic,30-266,G,1/27/17,MIA,CHI,1,34,12,20,0.6,11,16,0.688,1,4,0.25,1,1,1,1,4,5,11,3,0,5,1,26,24
LeBron James,32-024,F-G,1/23/17,CLE,NOP,1,44,11,21,0.524,10,17,0.588,1,4,0.25,3,4,0.75,2,8,10,12,2,0,6,2,26,22.7
Jimmy Butler,27-080,G-F,12/3/16,CHI,DAL,1,36,8,18,0.444,8,15,0.533,0,3,0,10,12,0.833,1,8,9,4,2,0,3,3,26,19.5
James Johnson,29-357,F,2/11/17,MIA,PHI,0,36,8,15,0.533,7,12,0.583,1,3,0.333,9,13,0.692,1,3,4,3,0,2,4,4,26,16.6
Karl-Anthony Towns,21-040,C-F,12/25/16,MIN,OKC,1,32,10,20,0.5,10,18,0.556,0,2,0,6,6,1,2,6,8,0,0,0,3,1,26,15.8
Hassan Whiteside,27-211,C,1/10/17,MIA,GSW,1,37,12,17,0.706,12,17,0.706,0,0,,2,3,0.667,3,17,20,2,1,2,4,3,26,24.3
Blake Griffin,27-271,F,12/12/16,LAC,POR,1,40,12,25,0.48,12,25,0.48,0,0,,2,3,0.667,4,8,12,6,0,1,5,3,26,16.8
Gordon Hayward,26-262,F-G,12/10/16,UTA,SAC,1,32,9,19,0.474,6,12,0.5,3,7,0.429,5,5,1,0,7,7,3,1,0,3,3,26,17.3
Darren Collison,29-169,G,2/8/17,SAC,BOS,1,38,12,21,0.571,10,17,0.588,2,4,0.5,0,0,,0,1,1,5,4,0,2,4,26,20.3
John Wall,26-190,G,3/15/17,WAS,DAL,1,36,10,20,0.5,8,15,0.533,2,5,0.4,4,6,0.667,0,1,1,11,3,0,3,1,26,22.8
Andre Drummond,23-119,C,12/7/16,DET,CHO,1,34,11,14,0.786,11,14,0.786,0,0,,4,7,0.571,2,18,20,1,0,2,1,5,26,25.3
DeMarcus Cousins,26-204,C-F,3/5/17,NOP,LAL,1,31,9,21,0.429,6,16,0.375,3,5,0.6,5,6,0.833,4,11,15,2,0,1,4,6,26,16.3
Devin Booker,20-086,G,1/24/17,PHO,MIN,1,43,9,23,0.391,5,16,0.313,4,7,0.571,4,4,1,0,2,2,4,0,0,4,3,26,11.7
Darren Collison,29-133,G,1/3/17,SAC,DEN,1,36,10,16,0.625,8,11,0.727,2,5,0.4,4,4,1,1,1,2,7,0,0,2,1,26,22.3
DeMar DeRozan,27-149,G,1/3/17,TOR,SAS,1,32,12,21,0.571,12,21,0.571,0,0,,2,3,0.667,1,3,4,2,0,0,3,2,26,14.9
Bojan Bogdanovic,27-252,G-F,12/26/16,BRK,CHO,0,27,7,11,0.636,3,4,0.75,4,7,0.571,8,9,0.889,1,3,4,2,0,0,0,1,26,23.3
Klay Thompson,27-003,G,2/11/17,GSW,OKC,1,33,7,12,0.583,2,4,0.5,5,8,0.625,7,8,0.875,1,0,1,0,1,0,3,3,26,17.5
Gary Harris,22-175,G,3/8/17,DEN,WAS,1,37,10,15,0.667,4,6,0.667,6,9,0.667,0,0,,1,1,2,4,0,0,0,0,26,23.3
Karl-Anthony Towns,21-091,C-F,2/14/17,MIN,CLE,1,39,11,19,0.579,10,15,0.667,1,4,0.25,3,3,1,2,6,8,4,0,1,2,4,26,20.2
James Harden,27-095,G,11/29/16,HOU,UTA,1,35,8,23,0.348,6,17,0.353,2,6,0.333,8,10,0.8,3,2,5,7,2,0,2,3,26,18.7
Wesley Matthews,30-050,G,12/3/16,DAL,CHI,1,35,9,17,0.529,2,6,0.333,7,11,0.636,1,1,1,0,3,3,2,2,0,3,4,26,17.4
Jimmy Butler,27-100,G-F,12/23/16,CHI,CHO,1,39,11,19,0.579,9,15,0.6,2,4,0.5,2,2,1,0,4,4,4,0,1,2,2,26,19
C.J. McCollum,25-059,G,11/17/16,POR,HOU,1,35,11,19,0.579,10,15,0.667,1,4,0.25,3,3,1,2,1,3,4,0,0,4,2,26,16.8
Wilson Chandler,29-266,F,1/31/17,DEN,LAL,0,36,10,20,0.5,6,14,0.429,4,6,0.667,2,2,1,4,5,9,4,3,1,0,3,26,25.6
Andrew Wiggins,21-300,F-G,12/19/16,MIN,PHO,1,39,11,20,0.55,10,18,0.556,1,2,0.5,3,4,0.75,0,4,4,2,3,0,3,5,26,16.6
Rudy Gobert,24-272,C,3/25/17,UTA,LAC,1,36,10,13,0.769,10,13,0.769,0,0,,6,10,0.6,7,7,14,1,0,2,4,2,26,23.6
C.J. McCollum,25-177,G,3/15/17,POR,SAS,1,39,8,16,0.5,6,14,0.429,2,2,1,8,8,1,1,3,4,4,1,0,1,0,26,22.4
James Harden,27-132,G,1/5/17,HOU,OKC,1,38,6,16,0.375,4,9,0.444,2,7,0.286,12,14,0.857,1,7,8,12,1,1,6,2,26,22.5
Kyrie Irving,25-001,G,3/24/17,CLE,CHO,1,38,11,22,0.5,9,16,0.563,2,6,0.333,2,2,1,0,1,1,7,4,0,4,2,26,19.4
Jonathan Gibson,29-011,G,11/19/16,DAL,ORL,0,32,8,16,0.5,3,7,0.429,5,9,0.556,5,6,0.833,0,6,6,3,2,0,6,5,26,15.5
DeMar DeRozan,27-100,G,11/15/16,TOR,CLE,1,34,10,27,0.37,8,22,0.364,2,5,0.4,4,8,0.5,1,5,6,4,3,0,2,1,26,15.1
Justin Anderson,23-144,G,4/12/17,PHI,NYK,1,35,9,11,0.818,6,7,0.857,3,4,0.75,5,7,0.714,0,2,2,3,3,1,2,3,26,24.3
Paul Millsap,32-055,F,4/6/17,ATL,BOS,0,29,8,15,0.533,7,12,0.583,1,3,0.333,9,12,0.75,4,8,12,4,2,0,3,2,26,23.7
C.J. McCollum,25-116,G,1/13/17,POR,ORL,1,37,10,21,0.476,6,15,0.4,4,6,0.667,2,2,1,1,2,3,2,1,3,2,4,26,17.5
C.J. McCollum,25-147,G,2/13/17,POR,ATL,1,41,9,24,0.375,6,16,0.375,3,8,0.375,5,6,0.833,2,5,7,5,0,0,1,2,26,17
DeMarcus Cousins,26-153,C-F,1/13/17,SAC,CLE,1,39,9,16,0.563,8,11,0.727,1,5,0.2,7,9,0.778,0,7,7,11,1,0,6,3,26,21.2
Blake Griffin,27-250,F,11/21/16,LAC,TOR,1,36,10,17,0.588,10,17,0.588,0,0,,6,8,0.75,1,6,7,7,1,1,0,5,26,24.4
Klay Thompson,26-362,G,2/4/17,GSW,SAC,1,43,10,25,0.4,6,14,0.429,4,11,0.364,2,2,1,3,2,5,1,1,0,3,1,26,13.5
James Harden,27-150,G,1/23/17,HOU,MIL,1,40,6,10,0.6,4,6,0.667,2,4,0.5,12,14,0.857,0,8,8,12,3,1,11,3,26,22.9
Robert Covington,26-000,F,12/14/16,PHI,TOR,1,31,10,20,0.5,7,13,0.538,3,7,0.429,3,4,0.75,7,5,12,2,0,0,3,5,26,18.4
Derrick Rose,28-085,G,12/28/16,NYK,ATL,1,43,9,28,0.321,9,26,0.346,0,2,0,8,9,0.889,2,5,7,6,0,0,2,3,26,13.5
Wesley Matthews,30-047,G,11/30/16,DAL,SAS,1,37,8,19,0.421,3,8,0.375,5,11,0.455,5,6,0.833,0,2,2,1,2,1,1,1,26,18.1
Bradley Beal,23-194,G,1/8/17,WAS,MIL,1,36,10,19,0.526,8,9,0.889,2,10,0.2,4,5,0.8,1,3,4,2,0,1,3,5,26,15
Reggie Jackson,26-324,G,3/6/17,DET,CHI,1,31,11,16,0.688,9,13,0.692,2,3,0.667,2,2,1,0,2,2,6,0,0,1,1,26,22.6
Bojan Bogdanovic,27-194,G-F,10/29/16,BRK,MIL,1,31,9,15,0.6,7,9,0.778,2,6,0.333,6,6,1,2,6,8,1,0,0,2,2,26,20.2
Kemba Walker,26-324,G,3/28/17,CHO,MIL,1,33,10,19,0.526,6,9,0.667,4,10,0.4,2,3,0.667,1,2,3,5,0,0,0,0,26,21.1
Kyrie Irving,24-329,G,2/15/17,CLE,IND,1,34,7,17,0.412,4,10,0.4,3,7,0.429,9,9,1,0,2,2,7,2,0,2,3,26,21.2
Al Horford,30-182,C-F,12/2/16,BOS,SAC,1,36,10,18,0.556,6,11,0.545,4,7,0.571,2,2,1,2,6,8,3,2,6,1,2,26,27.1
Wesley Matthews,30-057,G,12/10/16,DAL,HOU,1,35,8,22,0.364,3,9,0.333,5,13,0.385,5,7,0.714,1,2,3,2,1,0,0,1,26,16.3
Brook Lopez,28-361,C,3/28/17,BRK,PHI,1,31,10,15,0.667,7,8,0.875,3,7,0.429,3,4,0.75,3,6,9,6,0,2,1,2,26,26.8
Nick Young,31-214,G-F,1/1/17,LAL,TOR,1,30,8,14,0.571,1,5,0.2,7,9,0.778,3,3,1,0,2,2,0,2,0,2,3,26,18.8
Tyreke Evans,27-170,G-F,3/8/17,SAC,SAS,1,29,9,13,0.692,6,9,0.667,3,4,0.75,5,7,0.714,1,1,2,4,2,0,2,1,26,23.1
Stephen Curry,28-269,G,12/8/16,GSW,UTA,1,36,7,16,0.438,4,7,0.571,3,9,0.333,9,9,1,0,5,5,2,2,0,3,2,26,18.7
Jeremy Lamb,24-287,G-F,3/13/17,CHO,CHI,1,31,10,17,0.588,7,12,0.583,3,5,0.6,3,4,0.75,2,2,4,2,2,0,3,4,26,18.5
Klay Thompson,26-343,G,1/16/17,GSW,CLE,1,31,8,17,0.471,3,6,0.5,5,11,0.455,5,5,1,0,4,4,0,0,1,2,5,26,15.2
Hassan Whiteside,27-184,C,12/14/16,MIA,IND,1,34,10,16,0.625,10,16,0.625,0,0,,6,11,0.545,6,16,22,0,0,2,3,3,26,23
Karl-Anthony Towns,21-101,C-F,2/24/17,MIN,DAL,1,39,12,18,0.667,12,18,0.667,0,0,,2,3,0.667,4,14,18,3,1,0,7,1,26,20.5
Ricky Rubio,26-168,G,4/7/17,MIN,UTA,1,37,7,14,0.5,6,11,0.545,1,3,0.333,11,11,1,0,3,3,12,0,0,3,3,26,24.1
James Harden,27-187,G,3/1/17,HOU,LAC,1,36,7,15,0.467,3,6,0.5,4,9,0.444,8,8,1,0,3,3,9,1,0,7,4,26,17.9
Brook Lopez,28-221,C,11/8/16,BRK,MIN,1,28,10,16,0.625,7,9,0.778,3,7,0.429,3,3,1,0,3,3,1,0,3,5,2,26,16.7
Paul George,26-193,F,11/11/16,IND,PHI,1,40,9,20,0.45,8,16,0.5,1,4,0.25,7,7,1,3,5,8,4,2,0,1,5,26,21
Isaiah Thomas,28-001,G,2/8/17,BOS,SAC,1,33,6,16,0.375,2,5,0.4,4,11,0.364,10,10,1,0,4,4,7,0,0,3,2,26,19.5
DeMar DeRozan,27-189,G,2/12/17,TOR,DET,1,38,10,21,0.476,10,20,0.5,0,1,0,6,7,0.857,1,6,7,2,0,1,2,1,26,17.1
Kyrie Irving,24-356,G,3/14/17,CLE,DET,1,30,9,14,0.643,5,10,0.5,4,4,1,4,4,1,1,0,1,6,0,0,2,1,26,22.3
Jimmy Butler,27-202,G-F,4/4/17,CHI,NYK,1,40,9,18,0.5,8,15,0.533,1,3,0.333,7,9,0.778,1,2,3,4,1,2,3,4,26,18.1
Dennis Schroder,23-176,G,3/10/17,ATL,TOR,1,35,9,18,0.5,8,14,0.571,1,4,0.25,7,8,0.875,1,5,6,5,0,0,4,0,26,18.3
Klay Thompson,26-299,G,12/3/16,GSW,PHO,1,34,10,17,0.588,4,10,0.4,6,7,0.857,0,0,,1,4,5,3,2,1,2,1,26,22.4
DeMarcus Cousins,26-140,C-F,12/31/16,SAC,MEM,1,38,7,18,0.389,7,15,0.467,0,3,0,12,13,0.923,2,2,4,8,5,0,5,4,26,21.8
Rodney Hood,24-005,G-F,10/25/16,UTA,POR,1,38,9,17,0.529,6,10,0.6,3,7,0.429,5,5,1,0,2,2,1,2,1,0,3,26,20.5
Paul Millsap,31-324,F,12/30/16,ATL,DET,1,37,9,20,0.45,8,16,0.5,1,4,0.25,7,8,0.875,3,3,6,5,2,0,3,3,26,19.5
Carmelo Anthony,32-253,F,2/6/17,NYK,LAL,1,37,10,17,0.588,10,15,0.667,0,2,0,6,8,0.75,0,3,3,5,1,0,4,3,26,17.5
Eric Gordon,27-348,G,12/7/16,HOU,LAL,0,24,9,13,0.692,1,1,1,8,12,0.667,0,0,,0,4,4,2,0,0,2,1,26,20.7
Karl-Anthony Towns,21-147,C-F,4/11/17,MIN,OKC,1,40,10,20,0.5,8,14,0.571,2,6,0.333,4,4,1,4,8,12,1,1,0,1,2,26,21.1
Giannis Antetokounmpo,22-101,F-G,3/17/17,MIL,LAL,1,35,11,16,0.688,10,15,0.667,1,1,1,3,6,0.5,2,6,8,4,0,2,4,6,26,19
Brook Lopez,28-282,C,1/8/17,BRK,PHI,1,32,8,16,0.5,5,9,0.556,3,7,0.429,7,7,1,1,1,2,2,1,1,2,3,26,18.9
Darren Collison,29-157,G,1/27/17,SAC,IND,1,46,10,17,0.588,6,11,0.545,4,6,0.667,2,2,1,1,3,4,5,3,0,3,3,26,22
Kentavious Caldwell-Pope,23-325,G,1/8/17,DET,POR,1,48,9,14,0.643,5,7,0.714,4,7,0.571,4,5,0.8,2,2,4,2,4,0,3,1,26,23.4
Myles Turner,20-266,F-C,12/15/16,IND,NOP,1,30,11,14,0.786,11,14,0.786,0,0,,4,5,0.8,2,6,8,1,0,1,0,5,26,22.8
Avery Bradley,25-343,G,11/3/16,BOS,CLE,1,39,11,20,0.55,9,14,0.643,2,6,0.333,2,2,1,1,9,10,2,1,0,3,2,26,18.4
Joel Embiid,22-308,C-F,1/18/17,PHI,TOR,1,27,6,13,0.462,4,8,0.5,2,5,0.4,12,14,0.857,0,9,9,2,1,2,4,5,26,19
Patrick Beverley,28-264,G,4/2/17,HOU,PHO,1,35,11,19,0.579,7,10,0.7,4,9,0.444,0,0,,3,5,8,9,1,0,2,4,26,24.4
James Harden,27-083,G,11/17/16,HOU,POR,1,32,7,17,0.412,4,9,0.444,3,8,0.375,9,11,0.818,1,11,12,14,3,0,4,3,26,27.7
Kristaps Porzingis,21-131,F-C,12/11/16,NYK,LAL,1,39,8,15,0.533,5,11,0.455,3,4,0.75,7,9,0.778,3,10,13,2,1,7,1,3,26,28.1
Kevin Love,28-057,F,11/3/16,CLE,BOS,1,33,5,15,0.333,1,7,0.143,4,8,0.5,12,13,0.923,2,6,8,0,0,0,1,0,26,19.3
Jrue Holiday,26-231,G,1/29/17,NOP,WAS,1,39,11,19,0.579,7,12,0.583,4,7,0.571,0,0,,2,2,4,11,1,0,2,0,26,25.8
Evan Fournier,24-052,G-F,12/20/16,ORL,MIA,1,44,11,22,0.5,8,17,0.471,3,5,0.6,1,2,0.5,0,5,5,4,0,0,1,4,26,16.3
Dwyane Wade,34-313,G,11/25/16,CHI,PHI,1,29,11,18,0.611,10,15,0.667,1,3,0.333,3,5,0.6,1,4,5,2,3,1,1,2,26,22.2
Kelly Olynyk,25-269,C-F,1/13/17,BOS,ATL,0,32,9,11,0.818,5,6,0.833,4,5,0.8,4,4,1,2,6,8,3,0,0,0,4,26,25.6
Blake Griffin,27-334,F,2/13/17,LAC,UTA,1,34,11,18,0.611,10,17,0.588,1,1,1,3,4,0.75,2,8,10,6,0,2,0,1,26,26.4
Stephen Curry,28-334,G,2/11/17,GSW,OKC,1,34,9,19,0.474,5,8,0.625,4,11,0.364,4,4,1,3,5,8,9,2,0,0,2,26,27.4
T.J. Warren,23-193,F,3/17/17,PHO,ORL,1,37,8,13,0.615,8,12,0.667,0,1,0,10,10,1,2,3,5,1,2,2,3,4,26,21.9
Jimmy Butler,27-079,G-F,12/2/16,CHI,CLE,1,42,8,20,0.4,8,17,0.471,0,3,0,10,12,0.833,3,5,8,6,3,2,1,1,26,25.2
Kawhi Leonard,25-168,F,12/14/16,SAS,BOS,1,37,9,17,0.529,8,12,0.667,1,5,0.2,7,7,1,1,2,3,6,2,1,4,1,26,21.5
Wesley Matthews,30-056,G,12/9/16,DAL,IND,1,36,8,16,0.5,3,6,0.5,5,10,0.5,5,8,0.625,0,4,4,3,1,0,1,2,26,19.3
Klay Thompson,26-289,G,11/23/16,GSW,LAL,1,24,9,14,0.643,5,7,0.714,4,7,0.571,4,4,1,0,2,2,2,0,0,1,4,26,19.2
Kemba Walker,26-262,G,1/25/17,CHO,GSW,1,38,9,23,0.391,7,16,0.438,2,7,0.286,6,6,1,1,2,3,8,1,1,3,2,26,18.3
Zach LaVine,21-258,G,11/23/16,MIN,NOP,1,37,9,22,0.409,8,17,0.471,1,5,0.2,7,8,0.875,0,1,1,3,1,0,2,2,26,14.4
LeBron James,32-003,F-G,1/2/17,CLE,NOP,1,39,9,21,0.429,9,17,0.529,0,4,0,8,10,0.8,2,5,7,6,2,1,4,1,26,19.5
Brook Lopez,28-337,C,3/4/17,BRK,POR,1,32,11,19,0.579,9,14,0.643,2,5,0.4,2,4,0.5,0,5,5,1,1,2,2,3,26,17.7
Jimmy Butler,27-051,G-F,11/4/16,CHI,NYK,1,37,7,15,0.467,6,11,0.545,1,4,0.25,11,11,1,2,3,5,2,1,0,2,0,26,21
Stephen Curry,28-361,G,3/10/17,GSW,MIN,1,35,10,27,0.37,9,19,0.474,1,8,0.125,5,5,1,3,3,6,7,1,0,6,4,26,12.4
Isaiah Thomas,27-313,G,12/16/16,BOS,CHO,1,35,9,20,0.45,7,14,0.5,2,6,0.333,6,7,0.857,1,2,3,5,0,0,2,1,26,17.6
Lou Williams,30-080,G,1/15/17,LAL,DET,0,27,7,14,0.5,2,5,0.4,5,9,0.556,7,8,0.875,0,3,3,4,0,0,1,2,26,20.5
J.J. Redick,32-147,G,11/18/16,LAC,SAC,1,26,8,12,0.667,2,4,0.5,6,8,0.75,4,4,1,1,1,2,2,0,1,3,3,26,19.7
Joel Embiid,22-248,C-F,11/19/16,PHI,PHO,1,20,9,14,0.643,6,9,0.667,3,5,0.6,5,6,0.833,0,7,7,2,0,2,3,4,26,19.7
Isaiah Thomas,28-057,G,4/5/17,BOS,CLE,1,33,9,19,0.474,8,11,0.727,1,8,0.125,7,8,0.875,0,4,4,6,0,1,4,1,26,17.6
Dario Saric,22-307,F,2/9/17,PHI,ORL,0,28,8,15,0.533,5,10,0.5,3,5,0.6,7,8,0.875,3,5,8,1,3,0,0,1,26,25.2
Nikola Vucevic,26-147,C,3/20/17,ORL,PHI,1,37,10,23,0.435,10,22,0.455,0,1,0,6,6,1,5,8,13,2,2,0,0,2,26,22.4
Blake Griffin,27-355,F,3/6/17,LAC,BOS,1,36,8,15,0.533,7,12,0.583,1,3,0.333,9,10,0.9,2,6,8,3,0,0,1,4,26,21
James Johnson,29-356,F,2/10/17,MIA,BRK,0,35,11,17,0.647,11,15,0.733,0,2,0,4,4,1,1,7,8,2,1,3,3,1,26,22.4
Kevin Durant,28-126,F-G,2/2/17,GSW,LAC,1,37,8,18,0.444,6,11,0.545,2,7,0.286,8,8,1,0,8,8,10,1,0,0,3,26,25.8
Anthony Davis,23-272,F-C,12/8/16,NOP,PHI,1,41,8,21,0.381,8,19,0.421,0,2,0,10,12,0.833,1,10,11,2,0,2,3,1,26,16.8
Marc Gasol,31-292,C,11/16/16,MEM,LAC,1,37,10,21,0.476,6,16,0.375,4,5,0.8,2,3,0.667,2,4,6,6,1,0,2,2,26,19.9
DeMarcus Cousins,26-095,C-F,11/16/16,SAC,SAS,1,37,7,16,0.438,6,12,0.5,1,4,0.25,11,14,0.786,3,14,17,6,1,0,3,4,26,23.3
Reggie Jackson,26-277,G,1/18/17,DET,ATL,1,32,10,20,0.5,8,16,0.5,2,4,0.5,4,4,1,2,3,5,4,0,0,3,2,26,17.3
LaMarcus Aldridge,31-098,F-C,10/25/16,SAS,GSW,1,35,10,20,0.5,9,19,0.474,1,1,1,5,6,0.833,8,6,14,3,1,0,2,1,26,23.7
Paul George,26-229,F,12/17/16,IND,DET,1,34,11,21,0.524,9,15,0.6,2,6,0.333,2,3,0.667,1,6,7,2,2,1,0,2,26,21.1
Chris Paul,31-199,G,11/21/16,LAC,TOR,1,35,8,14,0.571,5,6,0.833,3,8,0.375,7,7,1,0,3,3,12,2,0,4,1,26,26.3
Marc Gasol,31-333,C,12/27/16,MEM,BOS,1,38,9,20,0.45,6,14,0.429,3,6,0.5,5,6,0.833,0,4,4,9,2,3,3,1,26,23.4
Marcus Morris,27-164,F,2/13/17,DET,MIL,1,40,10,17,0.588,6,9,0.667,4,8,0.5,2,2,1,0,5,5,3,0,0,1,2,26,19.9
Dirk Nowitzki,38-204,F,1/9/17,DAL,MIN,1,31,8,16,0.5,3,6,0.5,5,10,0.5,5,7,0.714,0,5,5,4,0,0,0,5,26,19.5
Brook Lopez,28-248,C,12/5/16,BRK,WAS,1,31,8,15,0.533,6,11,0.545,2,4,0.5,7,9,0.778,4,2,6,5,0,2,1,3,25,23
Isaiah Thomas,28-041,G,3/20/17,BOS,WAS,1,35,7,19,0.368,5,9,0.556,2,10,0.2,9,11,0.818,1,3,4,4,1,0,3,3,25,14.9
Jabari Parker,21-311,F,1/20/17,MIL,ORL,1,38,8,17,0.471,5,11,0.455,3,6,0.5,6,7,0.857,2,4,6,6,0,0,4,3,25,17.5
Tobias Harris,24-174,F,1/5/17,DET,CHO,0,31,10,16,0.625,7,8,0.875,3,8,0.375,2,2,1,0,2,2,1,1,0,0,2,25,19.3
Zach LaVine,21-271,G,12/6/16,MIN,SAS,1,38,9,16,0.563,5,8,0.625,4,8,0.5,3,4,0.75,0,2,2,1,0,0,3,1,25,14.9
Nicolas Batum,28-059,F-G,2/11/17,CHO,LAC,1,37,7,13,0.538,3,6,0.5,4,7,0.571,7,8,0.875,1,5,6,8,0,1,2,2,25,24
Nikola Vucevic,26-130,C,3/3/17,ORL,MIA,1,32,11,18,0.611,10,16,0.625,1,2,0.5,2,3,0.667,2,7,9,1,1,3,0,2,25,22.9
Stephen Curry,29-002,G,3/16/17,GSW,ORL,1,28,8,15,0.533,6,8,0.75,2,7,0.286,7,7,1,0,1,1,9,3,0,2,1,25,24.9
Kawhi Leonard,25-179,F,12/25/16,SAS,CHI,1,38,7,14,0.5,4,9,0.444,3,5,0.6,8,8,1,4,6,10,5,3,1,2,1,25,27.4
Kyrie Irving,24-247,G,11/25/16,CLE,DAL,1,28,10,13,0.769,6,8,0.75,4,5,0.8,1,1,1,0,1,1,1,0,1,2,0,25,19.6
John Wall,26-099,G,12/14/16,WAS,CHO,1,36,9,19,0.474,9,17,0.529,0,2,0,7,8,0.875,2,4,6,10,6,0,8,2,25,21.7
LaMarcus Aldridge,31-196,F-C,1/31/17,SAS,OKC,1,28,8,15,0.533,7,13,0.538,1,2,0.5,8,9,0.889,1,5,6,0,0,3,3,4,25,17
Lou Williams,30-024,G,11/20/16,LAL,CHI,0,30,8,14,0.571,3,8,0.375,5,6,0.833,4,6,0.667,1,0,1,3,2,0,2,2,25,19.6
Marc Gasol,31-307,C,12/1/16,MEM,ORL,1,32,8,14,0.571,6,11,0.545,2,3,0.667,7,7,1,0,2,2,3,1,5,3,3,25,21.4
Kentavious Caldwell-Pope,23-286,G,11/30/16,DET,BOS,1,35,10,17,0.588,8,13,0.615,2,4,0.5,3,4,0.75,2,3,5,4,1,1,1,2,25,21.7
Tim Hardaway,24-334,G,2/13/17,ATL,POR,1,43,8,19,0.421,4,10,0.4,4,9,0.444,5,5,1,0,7,7,4,1,0,1,1,25,19.4
Rodney Hood,24-055,G-F,12/14/16,UTA,OKC,1,31,9,14,0.643,4,5,0.8,5,9,0.556,2,2,1,0,1,1,1,0,0,1,3,25,17.6
LeBron James,32-046,F-G,2/14/17,CLE,MIN,1,40,10,14,0.714,8,11,0.727,2,3,0.667,3,6,0.5,1,7,8,14,0,0,6,3,25,23.4
Harrison Barnes,24-214,F,12/30/16,DAL,GSW,1,28,11,18,0.611,8,11,0.727,3,7,0.429,0,0,,0,3,3,1,2,1,1,0,25,20.1
Gordon Hayward,26-242,F-G,11/20/16,UTA,DEN,1,33,9,21,0.429,7,16,0.438,2,5,0.4,5,6,0.833,1,6,7,2,0,0,3,3,25,13.2
J.J. Redick,32-285,G,4/5/17,LAC,DAL,1,39,6,14,0.429,1,6,0.167,5,8,0.625,8,8,1,0,2,2,1,3,0,1,1,25,20.5
Kawhi Leonard,25-277,F,4/2/17,SAS,UTA,1,36,8,15,0.533,5,12,0.417,3,3,1,6,7,0.857,2,2,4,7,0,2,3,1,25,22.2
Dennis Schroder,23-127,G,1/20/17,ATL,CHI,1,27,11,14,0.786,9,11,0.818,2,3,0.667,1,1,1,1,2,3,6,1,0,5,1,25,20.7
Tobias Harris,24-109,F,11/1/16,DET,NYK,1,36,8,12,0.667,6,9,0.667,2,3,0.667,7,8,0.875,1,9,10,3,0,1,3,2,25,21.8
Kyle Lowry,30-258,G,12/8/16,TOR,MIN,1,38,8,14,0.571,3,7,0.429,5,7,0.714,4,6,0.667,1,1,2,11,1,0,2,1,25,24.9
Giannis Antetokounmpo,22-014,F-G,12/20/16,MIL,CLE,1,44,5,13,0.385,3,10,0.3,2,3,0.667,13,15,0.867,2,11,13,2,2,3,2,6,25,22.9
Bradley Beal,23-151,G,11/26/16,WAS,SAS,1,38,11,23,0.478,8,14,0.571,3,9,0.333,0,0,,2,4,6,5,2,0,0,0,25,21.4
Andrew Wiggins,22-024,F-G,3/19/17,MIN,NOP,1,37,10,20,0.5,10,17,0.588,0,3,0,5,7,0.714,1,1,2,2,2,1,4,3,25,14.1
Bradley Beal,23-171,G,12/16/16,WAS,DET,1,34,10,16,0.625,8,8,1,2,8,0.25,3,3,1,0,2,2,4,0,0,0,1,25,20.8
Isaiah Thomas,27-295,G,11/28/16,BOS,MIA,1,35,7,23,0.304,5,13,0.385,2,10,0.2,9,9,1,0,4,4,8,1,0,1,3,25,17.3
Ryan Anderson,28-270,F,1/31/17,HOU,SAC,1,27,7,14,0.5,1,2,0.5,6,12,0.5,5,8,0.625,3,8,11,3,1,0,1,3,25,22.2
Otto Porter,23-248,F,2/6/17,WAS,CLE,1,45,8,11,0.727,3,4,0.75,5,7,0.714,4,5,0.8,0,6,6,2,2,1,2,3,25,22.8
Brook Lopez,28-347,C,3/14/17,BRK,OKC,1,29,9,15,0.6,6,9,0.667,3,6,0.5,4,4,1,0,5,5,0,1,0,2,2,25,17.8
Kristaps Porzingis,21-237,F-C,3/27/17,NYK,DET,1,37,10,16,0.625,9,12,0.75,1,4,0.25,4,4,1,0,8,8,3,2,3,1,5,25,23.4
Eric Bledsoe,27-068,G,2/15/17,PHO,LAL,1,36,7,14,0.5,4,8,0.5,3,6,0.5,8,9,0.889,2,8,10,13,2,0,3,1,25,29.1
Stephen Curry,28-281,G,12/20/16,GSW,UTA,1,30,8,18,0.444,4,9,0.444,4,9,0.444,5,5,1,0,3,3,4,3,0,0,0,25,22.3
Deron Williams,32-122,G,10/26/16,DAL,IND,1,40,10,18,0.556,5,10,0.5,5,8,0.625,0,0,,1,2,3,7,0,1,6,4,25,15.7
Kevin Durant,28-060,F-G,11/28/16,GSW,ATL,1,36,8,16,0.5,7,13,0.538,1,3,0.333,8,8,1,0,14,14,3,1,2,4,1,25,21.3
DeMarcus Cousins,26-158,C-F,1/18/17,SAC,IND,1,38,7,19,0.368,6,17,0.353,1,2,0.5,10,14,0.714,1,11,12,10,1,3,9,3,25,16.8
Joel Embiid,22-293,C-F,1/3/17,PHI,MIN,1,30,8,20,0.4,7,17,0.412,1,3,0.333,8,11,0.727,5,3,8,3,1,2,3,3,25,17.7
Jordan Clarkson,24-141,G,10/26/16,LAL,HOU,0,25,8,12,0.667,6,9,0.667,2,3,0.667,7,7,1,1,2,3,1,3,0,4,3,25,19.6
Robert Covington,26-072,F,2/24/17,PHI,WAS,1,39,9,14,0.643,4,5,0.8,5,9,0.556,2,2,1,2,9,11,3,4,0,2,3,25,25.8
Tobias Harris,24-223,F,2/23/17,DET,CHO,0,37,9,17,0.529,5,9,0.556,4,8,0.5,3,3,1,2,5,7,4,0,1,1,1,25,21.7
Skal Labissiere,21-022,F,4/9/17,SAC,HOU,1,31,10,12,0.833,10,12,0.833,0,0,,5,6,0.833,2,4,6,3,2,1,0,3,25,26.4
Rajon Rondo,31-038,G,4/1/17,CHI,ATL,1,36,11,18,0.611,8,12,0.667,3,6,0.5,0,0,,2,9,11,6,3,0,7,3,25,19.9
Brook Lopez,28-302,C,1/28/17,BRK,MIN,1,30,10,15,0.667,7,9,0.778,3,6,0.5,2,3,0.667,1,6,7,0,1,2,2,4,25,19.4
Nikola Vucevic,26-097,C,1/29/17,ORL,TOR,1,33,9,17,0.529,6,13,0.462,3,4,0.75,4,4,1,2,8,10,5,1,4,2,4,25,24.2
Kevin Durant,28-105,F-G,1/12/17,GSW,DET,1,31,10,15,0.667,7,10,0.7,3,5,0.6,2,2,1,0,6,6,9,1,0,3,0,25,24.6
Austin Rivers,24-135,G,12/14/16,LAC,ORL,1,38,9,12,0.75,2,2,1,7,10,0.7,0,1,0,0,4,4,2,1,0,1,2,25,21.6
Wesley Matthews,30-059,G,12/12/16,DAL,DEN,1,32,10,14,0.714,5,7,0.714,5,7,0.714,0,0,,0,4,4,0,2,0,0,1,25,22
Robin Lopez,28-350,C,3/17/17,CHI,WAS,1,33,12,16,0.75,12,15,0.8,0,1,0,1,1,1,7,5,12,2,0,0,2,2,25,23.6
Joel Embiid,22-261,C-F,12/2/16,PHI,ORL,1,27,10,21,0.476,7,16,0.438,3,5,0.6,2,2,1,4,6,10,4,0,0,0,3,25,20.5
Giannis Antetokounmpo,22-121,F-G,4/6/17,MIL,IND,1,35,7,14,0.5,7,13,0.538,0,1,0,11,13,0.846,2,5,7,6,0,1,3,2,25,21.2
Julius Randle,22-028,F,12/27/16,LAL,UTA,1,31,9,12,0.75,8,11,0.727,1,1,1,6,8,0.75,6,6,12,3,1,0,2,2,25,25.7
Jonas Valanciunas,24-306,C,3/8/17,TOR,NOP,1,34,9,13,0.692,9,13,0.692,0,0,,7,11,0.636,3,9,12,2,0,1,2,4,25,21.2
Jamal Crawford,36-349,G,3/4/17,LAC,CHI,0,26,10,17,0.588,8,12,0.667,2,5,0.4,3,3,1,1,1,2,2,2,0,2,2,25,18.7
Kawhi Leonard,25-242,F,2/26/17,SAS,LAL,1,26,9,18,0.5,7,11,0.636,2,7,0.286,5,6,0.833,1,2,3,1,0,0,2,0,25,15.6
Klay Thompson,27-048,G,3/28/17,GSW,HOU,1,37,10,20,0.5,5,8,0.625,5,12,0.417,0,0,,0,5,5,1,2,2,2,3,25,17.4
Kemba Walker,26-247,G,1/10/17,CHO,HOU,1,36,9,21,0.429,4,9,0.444,5,12,0.417,2,3,0.667,1,5,6,10,1,1,5,1,25,19
C.J. McCollum,25-162,G,2/28/17,POR,DET,1,44,10,17,0.588,6,10,0.6,4,7,0.571,1,1,1,0,4,4,2,1,1,6,4,25,13.8
Klay Thompson,26-287,G,11/21/16,GSW,IND,1,26,10,18,0.556,6,8,0.75,4,10,0.4,1,2,0.5,0,1,1,0,2,0,2,3,25,15.1
LeBron James,32-030,F-G,1/29/17,CLE,OKC,1,37,9,18,0.5,9,16,0.563,0,2,0,7,10,0.7,1,13,14,8,1,0,2,1,25,23.6
Kemba Walker,26-213,G,12/7/16,CHO,DET,1,34,9,22,0.409,7,17,0.412,2,5,0.4,5,6,0.833,0,3,3,4,2,0,2,1,25,16.1
Andrew Wiggins,21-276,F-G,11/25/16,MIN,PHO,1,41,7,18,0.389,6,15,0.4,1,3,0.333,10,11,0.909,0,5,5,1,0,0,2,3,25,13.8
Rodney Hood,24-030,G-F,11/19/16,UTA,HOU,1,34,8,13,0.615,3,5,0.6,5,8,0.625,4,4,1,0,4,4,3,0,0,1,2,25,20.6
Evan Fournier,24-139,G-F,3/17/17,ORL,PHO,1,35,8,19,0.421,5,10,0.5,3,9,0.333,6,7,0.857,0,3,3,2,1,0,1,3,25,15.6
Kenneth Faried,27-028,F,12/17/16,DEN,NYK,0,29,10,11,0.909,10,11,0.909,0,0,,5,10,0.5,5,2,7,2,0,3,2,4,25,23.3
Joel Embiid,22-285,C-F,12/26/16,PHI,SAC,1,29,8,17,0.471,7,13,0.538,1,4,0.25,8,9,0.889,4,4,8,1,2,2,8,5,25,14
C.J. McCollum,25-036,G,10/25/16,POR,UTA,1,35,8,16,0.5,6,14,0.429,2,2,1,7,7,1,1,1,2,3,1,0,3,3,25,16.9
Allen Crabbe,24-362,G-F,4/6/17,POR,MIN,0,32,8,12,0.667,0,2,0,8,10,0.8,1,1,1,0,5,5,3,1,0,1,4,25,21.8
Jimmy Butler,27-197,G-F,3/30/17,CHI,CLE,1,38,10,17,0.588,8,15,0.533,2,2,1,3,6,0.5,2,4,6,5,2,0,1,0,25,23
Dwyane Wade,34-297,G,11/9/16,CHI,ATL,1,34,10,17,0.588,8,12,0.667,2,5,0.4,3,4,0.75,2,1,3,3,5,0,3,1,25,22.1
Ersan Ilyasova,29-263,F,2/2/17,PHI,SAS,1,39,8,17,0.471,6,11,0.545,2,6,0.333,7,8,0.875,2,7,9,2,4,1,3,5,25,20.5
Jabari Parker,21-297,F,1/6/17,MIL,NYK,1,38,10,18,0.556,6,12,0.5,4,6,0.667,1,4,0.25,1,3,4,5,0,0,2,3,25,17.1
J.J. Redick,32-198,G,1/8/17,LAC,MIA,1,33,9,19,0.474,5,11,0.455,4,8,0.5,3,4,0.75,1,6,7,2,0,0,1,3,25,16.6
Dario Saric,22-340,F,3/14/17,PHI,GSW,1,37,11,20,0.55,9,14,0.643,2,6,0.333,1,2,0.5,1,8,9,6,2,2,6,2,25,18.9
LeBron James,32-040,F-G,2/8/17,CLE,IND,1,38,9,16,0.563,8,14,0.571,1,2,0.5,6,8,0.75,1,5,6,9,1,1,4,2,25,22
Brook Lopez,28-210,C,10/28/16,BRK,IND,1,26,10,18,0.556,10,14,0.714,0,4,0,5,6,0.833,3,2,5,1,1,0,5,1,25,15
Kent Bazemore,27-130,G-F,11/8/16,ATL,CLE,1,33,8,13,0.615,4,7,0.571,4,6,0.667,5,7,0.714,1,5,6,3,0,0,1,2,25,20.8
Kentavious Caldwell-Pope,24-038,G,3/28/17,DET,MIA,1,37,9,22,0.409,7,12,0.583,2,10,0.2,5,6,0.833,2,3,5,0,0,0,0,3,25,13.9
Derrick Rose,28-068,G,12/11/16,NYK,LAL,1,34,12,16,0.75,12,15,0.8,0,1,0,1,2,0.5,0,3,3,2,0,1,2,1,25,18.8
Kyrie Irving,24-240,G,11/18/16,CLE,DET,1,29,11,15,0.733,8,11,0.727,3,4,0.75,0,0,,0,2,2,11,1,0,0,1,25,27.8
Gary Harris,22-163,G,2/24/17,DEN,BRK,1,27,9,15,0.6,5,9,0.556,4,6,0.667,3,3,1,0,2,2,1,1,0,0,1,25,20
Carmelo Anthony,32-159,F,11/4/16,NYK,CHI,1,36,9,22,0.409,7,16,0.438,2,6,0.333,5,5,1,3,4,7,4,0,1,1,4,25,17.4
Courtney Lee,31-143,G,2/23/17,NYK,CLE,1,36,10,15,0.667,7,10,0.7,3,5,0.6,2,2,1,1,5,6,5,1,0,1,1,25,23.8
Karl-Anthony Towns,21-129,C-F,3/24/17,MIN,LAL,1,43,11,19,0.579,11,17,0.647,0,2,0,3,3,1,4,10,14,4,1,2,1,1,25,25.7
Andrew Wiggins,21-292,F-G,12/11/16,MIN,GSW,1,41,8,14,0.571,6,11,0.545,2,3,0.667,7,10,0.7,0,5,5,2,0,0,4,2,25,15.3
Wilson Chandler,29-201,F,11/27/16,DEN,PHO,1,39,8,17,0.471,5,11,0.455,3,6,0.5,6,6,1,2,6,8,2,3,0,1,0,25,22.9
Anthony Davis,23-330,F-C,2/4/17,NOP,WAS,1,39,11,17,0.647,11,17,0.647,0,0,,3,4,0.75,2,8,10,2,1,2,1,1,25,23.3
George Hill,30-276,G,2/4/17,UTA,CHO,1,32,8,11,0.727,3,3,1,5,8,0.625,4,4,1,0,1,1,1,0,1,0,4,25,20.6
Kevin Love,28-081,F,11/27/16,CLE,PHI,1,28,6,13,0.462,2,5,0.4,4,8,0.5,9,9,1,3,8,11,1,0,0,1,0,25,22.5
Jae Crowder,26-263,F,3/26/17,BOS,MIA,1,36,8,13,0.615,5,8,0.625,3,5,0.6,6,7,0.857,2,4,6,1,2,2,3,4,25,20.8
Jeff Teague,28-262,G,2/27/17,IND,HOU,1,36,5,13,0.385,2,6,0.333,3,7,0.429,12,12,1,1,6,7,6,0,0,3,3,25,20.4
Tim Hardaway,25-008,G,3/24/17,ATL,MIL,1,40,8,17,0.471,5,10,0.5,3,7,0.429,6,6,1,1,1,2,4,0,1,2,3,25,17.6
Karl-Anthony Towns,21-002,C-F,11/17/16,MIN,PHI,1,38,12,18,0.667,11,16,0.688,1,2,0.5,0,0,,3,7,10,0,0,2,1,2,25,21
Bradley Beal,23-282,G,4/6/17,WAS,NYK,1,36,7,16,0.438,3,7,0.429,4,9,0.444,7,7,1,0,3,3,1,2,1,2,1,25,18.5
Giannis Antetokounmpo,22-031,F-G,1/6/17,MIL,NYK,1,38,9,21,0.429,7,16,0.438,2,5,0.4,5,6,0.833,2,3,5,2,2,6,5,4,25,16.8
Dirk Nowitzki,38-233,F,2/7/17,DAL,POR,1,30,7,16,0.438,3,9,0.333,4,7,0.571,7,7,1,0,5,5,3,0,2,0,2,25,20.8
James Harden,27-103,G,12/7/16,HOU,LAL,1,30,8,14,0.571,4,7,0.571,4,7,0.571,5,6,0.833,0,6,6,7,4,0,4,0,25,24.7
Klay Thompson,26-329,G,1/2/17,GSW,DEN,1,37,9,19,0.474,5,12,0.417,4,7,0.571,3,3,1,0,5,5,1,0,1,0,1,25,17.8
Kentavious Caldwell-Pope,23-309,G,12/23/16,DET,GSW,1,41,9,18,0.5,5,6,0.833,4,12,0.333,3,4,0.75,1,0,1,2,2,1,1,3,25,18.2
DeMar DeRozan,27-164,G,1/18/17,TOR,PHI,1,38,11,21,0.524,11,21,0.524,0,0,,3,4,0.75,1,2,3,6,1,0,2,1,25,18.4
Shabazz Napier,25-272,G,4/12/17,POR,NOP,1,26,10,18,0.556,7,12,0.583,3,6,0.5,2,3,0.667,0,4,4,2,1,0,4,2,25,14.8
Isaiah Thomas,27-263,G,10/27/16,BOS,CHI,1,35,10,15,0.667,7,8,0.875,3,7,0.429,2,6,0.333,0,3,3,4,2,0,5,2,25,16.8
Harrison Barnes,24-193,F,12/9/16,DAL,IND,1,36,10,17,0.588,7,14,0.5,3,3,1,2,4,0.5,2,5,7,2,0,0,0,2,25,19.8
Richaun Holmes,23-165,F-C,3/29/17,PHI,ATL,1,32,11,16,0.688,10,13,0.769,1,3,0.333,2,2,1,5,3,8,1,1,1,1,3,25,22.8
Goran Dragic,30-177,G,10/30/16,MIA,SAS,1,34,9,17,0.529,6,10,0.6,3,7,0.429,4,6,0.667,0,3,3,5,1,0,2,3,25,18.1
Isaiah Thomas,28-029,G,3/8/17,BOS,GSW,1,34,7,20,0.35,3,10,0.3,4,10,0.4,7,7,1,0,0,0,3,3,0,3,3,25,14.7
Mirza Teletovic,31-083,F,12/10/16,MIL,WAS,0,26,8,12,0.667,3,6,0.5,5,6,0.833,4,4,1,0,3,3,0,0,1,0,2,25,20.6
Greg Monroe,26-254,C-F,2/13/17,MIL,DET,0,31,12,15,0.8,12,15,0.8,0,0,,1,1,1,2,11,13,2,3,0,1,1,25,27
Elfrid Payton,22-288,G,12/6/16,ORL,WAS,0,35,9,12,0.75,6,9,0.667,3,3,1,4,4,1,1,0,1,9,3,3,2,4,25,28.7
Derrick Rose,28-099,G,1/11/17,NYK,PHI,1,32,11,16,0.688,11,16,0.688,0,0,,3,4,0.75,0,2,2,4,1,0,2,1,25,19.8
Elfrid Payton,22-305,G,12/23/16,ORL,LAL,0,30,11,16,0.688,8,10,0.8,3,6,0.5,0,0,,0,3,3,9,1,1,0,2,25,26.3
Goran Dragic,30-179,G,11/1/16,MIA,SAC,1,41,8,14,0.571,3,6,0.5,5,8,0.625,4,7,0.571,1,6,7,8,2,2,3,2,25,24.9
Danilo Gallinari,28-171,F,1/26/17,DEN,PHO,1,35,7,16,0.438,5,9,0.556,2,7,0.286,9,12,0.75,1,6,7,1,0,1,1,0,25,18.3
Stephen Curry,28-284,G,12/23/16,GSW,DET,1,35,7,16,0.438,2,6,0.333,5,10,0.5,6,6,1,0,3,3,8,2,0,5,1,25,19.7
Anthony Davis,24-027,F-C,4/7/17,NOP,DEN,1,24,11,27,0.407,11,24,0.458,0,3,0,3,5,0.6,2,4,6,0,1,0,1,2,25,11.5
Andrew Wiggins,21-289,F-G,12/8/16,MIN,TOR,1,36,10,19,0.526,9,15,0.6,1,4,0.25,4,6,0.667,3,2,5,1,0,0,2,5,25,14.3
Wilson Chandler,29-192,F,11/18/16,DEN,TOR,0,36,9,17,0.529,6,12,0.5,3,5,0.6,4,6,0.667,4,6,10,3,0,0,0,2,25,21.8
LeBron James,31-343,F-G,12/7/16,CLE,NYK,1,32,7,10,0.7,6,8,0.75,1,2,0.5,10,14,0.714,2,4,6,7,1,2,4,2,25,24.3
Kevin Love,28-215,F,4/10/17,CLE,MIA,1,36,8,18,0.444,7,12,0.583,1,6,0.167,8,8,1,1,9,10,0,1,0,1,6,25,16.6
Khris Middleton,25-231,F-G,3/31/17,MIL,DET,1,43,9,16,0.563,5,9,0.556,4,7,0.571,3,3,1,1,8,9,1,1,0,3,2,25,18.4
DeMar DeRozan,27-218,G,3/13/17,TOR,DAL,1,32,10,17,0.588,9,15,0.6,1,2,0.5,4,4,1,1,5,6,2,2,0,2,0,25,20.7
Brook Lopez,28-345,C,3/12/17,BRK,NYK,1,29,8,17,0.471,2,8,0.25,6,9,0.667,3,4,0.75,2,4,6,2,1,1,4,1,25,17.2
C.J. McCollum,25-197,G,4/4/17,POR,UTA,1,34,11,22,0.5,11,19,0.579,0,3,0,3,3,1,3,3,6,1,0,0,2,3,25,14.5
Wesley Matthews,30-016,G,10/30/16,DAL,HOU,1,41,9,25,0.36,6,10,0.6,3,15,0.2,4,4,1,1,3,4,3,2,0,1,6,25,13.4
Stephen Curry,28-259,G,11/28/16,GSW,ATL,1,38,6,17,0.353,2,6,0.333,4,11,0.364,9,11,0.818,0,3,3,3,2,0,3,2,25,15.9
Andrew Wiggins,21-289,F-G,12/8/16,MIN,TOR,1,36,10,19,0.526,9,15,0.6,1,4,0.25,4,6,0.667,3,2,5,1,0,0,2,5,25,14.3
Julius Randle,22-017,F,12/16/16,LAL,PHI,1,33,10,13,0.769,10,13,0.769,0,0,,5,6,0.833,1,8,9,4,3,0,5,4,25,21.8
Anthony Davis,23-248,F-C,11/14/16,NOP,BOS,1,38,7,22,0.318,7,21,0.333,0,1,0,11,13,0.846,1,15,16,0,4,2,7,2,25,14.4
John Wall,26-134,G,1/18/17,WAS,MEM,1,37,7,18,0.389,6,13,0.462,1,5,0.2,10,10,1,1,1,2,13,2,1,4,2,25,23.2
Bradley Beal,23-202,G,1/16/17,WAS,POR,1,29,7,11,0.636,4,8,0.5,3,3,1,8,8,1,1,1,2,5,3,0,1,2,25,25.8
Hassan Whiteside,27-168,C,11/28/16,MIA,BOS,1,37,10,13,0.769,10,13,0.769,0,0,,5,10,0.5,3,14,17,2,0,2,2,4,25,23.4
Otto Porter,23-258,F,2/16/17,WAS,IND,1,35,9,15,0.6,3,5,0.6,6,10,0.6,1,1,1,1,7,8,2,0,1,0,1,25,22.6
Kawhi Leonard,25-188,F,1/3/17,SAS,TOR,1,28,8,12,0.667,3,5,0.6,5,7,0.714,4,5,0.8,1,3,4,2,2,3,0,2,25,25.7
Kyrie Irving,24-341,G,2/27/17,CLE,MIL,1,37,10,20,0.5,8,16,0.5,2,4,0.5,3,3,1,0,4,4,9,2,0,4,1,25,20.1
Emmanuel Mudiay,20-258,G,11/18/16,DEN,TOR,1,46,10,18,0.556,10,11,0.909,0,7,0,5,7,0.714,0,6,6,9,1,0,5,4,25,18.1
Julius Randle,22-129,F,4/7/17,LAL,SAC,1,34,10,14,0.714,10,12,0.833,0,2,0,5,7,0.714,5,1,6,2,0,0,2,3,25,20.4
Paul George,26-177,F,10/26/16,IND,DAL,1,43,7,14,0.5,3,9,0.333,4,5,0.8,7,8,0.875,0,8,8,6,0,0,2,2,25,21.4
Andre Drummond,23-144,C,1/1/17,DET,MIA,1,36,12,19,0.632,12,19,0.632,0,0,,1,6,0.167,6,12,18,0,2,2,3,4,25,21.1
Terrence Ross,25-311,F-G,12/12/16,TOR,MIL,0,21,10,17,0.588,6,11,0.545,4,6,0.667,1,3,0.333,0,5,5,0,2,0,0,0,25,19.8
Gordon Hayward,26-234,F-G,11/12/16,UTA,MIA,1,35,10,20,0.5,9,16,0.563,1,4,0.25,4,5,0.8,1,8,9,4,0,0,1,1,25,19.1
Victor Oladipo,24-210,G,11/30/16,OKC,WAS,1,45,10,16,0.625,5,7,0.714,5,9,0.556,0,0,,0,6,6,6,1,0,2,1,25,22.4
Blake Griffin,27-240,F,11/11/16,LAC,OKC,1,36,10,20,0.5,10,19,0.526,0,1,0,5,7,0.714,2,4,6,3,2,0,3,1,25,17.5
DeMar DeRozan,27-106,G,11/21/16,TOR,LAC,1,36,11,21,0.524,11,20,0.55,0,1,0,3,4,0.75,1,3,4,7,1,0,1,3,25,19.6
Isaiah Thomas,27-262,G,10/26/16,BOS,BRK,1,33,7,14,0.5,5,7,0.714,2,7,0.286,9,9,1,0,6,6,8,2,0,3,3,25,23.2
Derrick Rose,28-082,G,12/25/16,NYK,BOS,1,38,10,19,0.526,10,19,0.526,0,0,,5,6,0.833,3,2,5,3,0,0,3,3,25,15.9
Marcus Morris,27-141,F,1/21/17,DET,WAS,1,38,7,17,0.412,4,11,0.364,3,6,0.5,8,9,0.889,6,5,11,3,1,0,1,3,25,22.1
Stephen Curry,28-351,G,2/28/17,GSW,WAS,1,34,9,20,0.45,7,11,0.636,2,9,0.222,5,6,0.833,4,3,7,4,2,0,5,3,25,16.5
Jeff Teague,28-173,G,11/30/16,IND,POR,1,34,7,13,0.538,6,11,0.545,1,2,0.5,10,12,0.833,0,5,5,8,0,1,2,2,25,22.9
John Wall,26-185,G,3/10/17,WAS,SAC,1,41,11,25,0.44,10,21,0.476,1,4,0.25,2,2,1,0,4,4,12,2,0,2,0,25,21.5
Evan Fournier,24-025,G-F,11/23/16,ORL,PHO,1,35,9,20,0.45,6,12,0.5,3,8,0.375,4,6,0.667,1,2,3,2,3,0,0,2,25,18.7
Greg Monroe,26-256,C-F,2/15/17,MIL,BRK,0,34,12,16,0.75,12,16,0.75,0,0,,1,2,0.5,2,6,8,3,2,0,3,4,25,20.9
Karl-Anthony Towns,21-126,C-F,3/21/17,MIN,SAS,1,39,8,17,0.471,7,15,0.467,1,2,0.5,8,9,0.889,6,9,15,1,1,2,2,3,25,22.7
Dirk Nowitzki,38-261,F,3/7/17,DAL,LAL,1,24,9,13,0.692,6,9,0.667,3,4,0.75,4,4,1,0,11,11,1,0,1,2,2,25,21.4
Ivica Zubac,19-360,C,3/13/17,LAL,DEN,1,30,12,15,0.8,12,15,0.8,0,0,,1,4,0.25,4,7,11,1,0,1,1,1,25,23
Joel Embiid,22-240,C-F,11/11/16,PHI,IND,1,26,6,18,0.333,5,15,0.333,1,3,0.333,12,14,0.857,3,4,7,2,0,2,5,3,25,13.9
Bradley Beal,23-202,G,1/16/17,WAS,POR,1,29,7,11,0.636,4,8,0.5,3,3,1,8,8,1,1,1,2,5,3,0,1,2,25,25.8
Hassan Whiteside,27-170,C,11/30/16,MIA,DEN,1,32,11,17,0.647,11,17,0.647,0,0,,3,5,0.6,4,12,16,1,1,4,1,3,25,25.4
Nikola Vucevic,26-122,C,2/23/17,ORL,POR,1,33,8,20,0.4,7,18,0.389,1,2,0.5,8,10,0.8,1,8,9,2,0,1,3,4,25,14
Blake Griffin,27-245,F,11/16/16,LAC,MEM,1,38,8,15,0.533,8,14,0.571,0,1,0,9,12,0.75,1,7,8,3,1,2,0,2,25,23
Kyle Lowry,30-240,G,11/20/16,TOR,SAC,1,36,7,17,0.412,5,10,0.5,2,7,0.286,9,10,0.9,1,7,8,6,2,0,7,5,25,15.5
Andrew Wiggins,21-246,F-G,10/26/16,MIN,MEM,1,34,7,14,0.5,6,13,0.462,1,1,1,10,14,0.714,4,3,7,0,0,1,2,1,25,18.4
Kent Bazemore,27-206,G-F,1/23/17,ATL,LAC,1,33,9,21,0.429,6,12,0.5,3,9,0.333,4,5,0.8,1,2,3,2,2,0,2,3,25,15
Jeff Teague,28-285,G,3/22/17,IND,BOS,1,35,10,15,0.667,7,9,0.778,3,6,0.5,2,2,1,0,2,2,7,1,0,2,4,25,21.4
Zach LaVine,21-276,G,12/11/16,MIN,GSW,1,42,8,19,0.421,3,10,0.3,5,9,0.556,4,4,1,0,3,3,4,0,0,1,5,25,15.6
Ryan Anderson,28-239,F,12/31/16,HOU,NYK,1,35,8,12,0.667,4,4,1,4,8,0.5,5,6,0.833,2,4,6,1,0,2,0,3,25,22.9
Jimmy Butler,27-107,G-F,12/30/16,CHI,IND,1,38,8,17,0.471,8,14,0.571,0,3,0,9,11,0.818,0,6,6,3,2,0,4,5,25,15.4
James Harden,27-078,G,11/12/16,HOU,SAS,1,39,7,18,0.389,5,9,0.556,2,9,0.222,9,11,0.818,5,6,11,13,0,0,7,1,25,21.4
Brook Lopez,29-009,C,4/10/17,BRK,BOS,1,34,10,21,0.476,9,15,0.6,1,6,0.167,4,4,1,3,4,7,2,0,1,1,2,25,17.9
Bradley Beal,23-151,G,11/26/16,WAS,SAS,1,38,11,23,0.478,8,14,0.571,3,9,0.333,0,0,,2,4,6,5,2,0,0,0,25,21.4
Carmelo Anthony,32-259,F,2/12/17,NYK,SAS,1,40,9,21,0.429,6,16,0.375,3,5,0.6,4,6,0.667,1,6,7,2,0,0,4,2,25,12.2
Harrison Barnes,24-275,F,3/1/17,DAL,ATL,1,38,9,19,0.474,6,15,0.4,3,4,0.75,4,4,1,0,4,4,4,2,0,3,1,25,17.9
Kemba Walker,26-195,G,11/19/16,CHO,NOP,1,37,10,25,0.4,8,16,0.5,2,9,0.222,3,3,1,1,6,7,5,1,0,1,1,25,17.1
George Hill,30-182,G,11/2/16,UTA,DAL,1,35,9,15,0.6,5,9,0.556,4,6,0.667,3,3,1,1,5,6,4,0,0,3,2,25,19.3
John Wall,26-130,G,1/14/17,WAS,PHI,1,30,9,17,0.529,6,13,0.462,3,4,0.75,4,5,0.8,2,5,7,7,2,0,3,1,25,22.7
Kawhi Leonard,25-271,F,3/27/17,SAS,CLE,1,30,11,21,0.524,11,14,0.786,0,7,0,3,3,1,0,6,6,6,3,1,2,2,25,21.6
Jimmy Butler,27-210,G-F,4/12/17,CHI,BRK,1,35,8,19,0.421,7,16,0.438,1,3,0.333,8,9,0.889,1,5,6,4,4,2,1,1,25,23.5
Kyrie Irving,24-277,G,12/25/16,CLE,GSW,1,44,11,27,0.407,9,22,0.409,2,5,0.4,1,1,1,3,3,6,10,7,0,2,0,25,25.5
Karl-Anthony Towns,21-026,C-F,12/11/16,MIN,GSW,1,39,9,15,0.6,8,12,0.667,1,3,0.333,6,8,0.75,7,11,18,2,0,0,1,3,25,24.7
Andrew Wiggins,21-309,F-G,12/28/16,MIN,DEN,1,36,11,20,0.55,9,16,0.563,2,4,0.5,1,4,0.25,1,4,5,1,2,0,0,0,25,18.8
C.J. McCollum,25-084,G,12/12/16,POR,LAC,1,33,9,17,0.529,7,13,0.538,2,4,0.5,5,5,1,0,5,5,3,0,0,4,6,25,13.9
Jordan Clarkson,24-196,G,12/20/16,LAL,CHO,0,31,9,13,0.692,2,4,0.5,7,9,0.778,0,0,,0,3,3,5,1,1,1,2,25,23.8
Harrison Barnes,24-163,F,11/9/16,DAL,GSW,1,34,8,20,0.4,7,17,0.412,1,3,0.333,8,8,1,2,6,8,1,0,0,0,1,25,17.7
Kevin Durant,28-147,F-G,2/23/17,GSW,LAC,1,34,8,15,0.533,4,9,0.444,4,6,0.667,5,6,0.833,1,14,15,7,1,1,1,3,25,26.6
Klay Thompson,27-028,G,3/8/17,GSW,BOS,1,34,11,23,0.478,9,15,0.6,2,8,0.25,1,2,0.5,1,5,6,1,1,2,2,2,25,15.4
Kevin Love,28-123,F,1/8/17,CLE,PHO,1,36,8,17,0.471,5,7,0.714,3,10,0.3,6,6,1,5,5,10,1,0,1,1,1,25,21.3
C.J. McCollum,25-113,G,1/10/17,POR,LAL,1,34,10,18,0.556,8,13,0.615,2,5,0.4,3,4,0.75,0,1,1,4,2,0,1,2,25,19.3
DeMarcus Cousins,26-146,C-F,1/6/17,SAC,LAC,1,36,9,19,0.474,6,11,0.545,3,8,0.375,4,6,0.667,2,9,11,7,3,2,4,3,25,22.7
Klay Thompson,26-311,G,12/15/16,GSW,NYK,1,32,10,17,0.588,6,7,0.857,4,10,0.4,1,1,1,2,3,5,4,1,0,2,2,25,20.4
Giannis Antetokounmpo,22-024,F-G,12/30/16,MIL,MIN,1,32,11,14,0.786,11,14,0.786,0,0,,3,4,0.75,2,4,6,5,1,1,3,3,25,22.8
Eric Gordon,28-024,G,1/18/17,HOU,MIL,0,32,9,20,0.45,2,3,0.667,7,17,0.412,0,0,,1,3,4,0,0,0,1,2,25,14.4
Goran Dragic,30-260,G,1/21/17,MIA,MIL,1,33,8,13,0.615,5,8,0.625,3,5,0.6,6,7,0.857,0,1,1,6,1,0,3,2,25,20.4
Russell Westbrook,28-122,G,3/14/17,OKC,BRK,1,35,6,18,0.333,4,11,0.364,2,7,0.286,11,13,0.846,1,11,12,19,2,1,5,3,25,27.8
James Harden,27-185,G,2/27/17,HOU,IND,1,39,5,17,0.294,4,8,0.5,1,9,0.111,14,17,0.824,1,6,7,12,2,0,2,2,25,24
Damian Lillard,26-262,G,4/3/17,POR,MIN,1,39,7,21,0.333,4,10,0.4,3,11,0.273,8,9,0.889,0,4,4,6,2,0,0,2,25,19.3
Devin Booker,20-078,G,1/16/17,PHO,UTA,1,46,10,22,0.455,9,17,0.529,1,5,0.2,4,4,1,0,0,0,1,0,0,3,3,25,10.1
Norman Powell,23-322,G,4/12/17,TOR,CLE,1,34,10,13,0.769,7,8,0.875,3,5,0.6,2,2,1,1,1,2,2,1,0,0,2,25,22.5
Derrick Rose,28-134,G,2/15/17,NYK,OKC,1,38,11,21,0.524,11,21,0.524,0,0,,3,3,1,1,3,4,7,2,0,3,2,25,19.4
Myles Turner,20-287,F-C,1/5/17,IND,BRK,1,32,9,15,0.6,7,13,0.538,2,2,1,5,5,1,3,12,15,0,1,5,0,1,25,27.9
Evan Fournier,24-128,G-F,3/6/17,ORL,NYK,1,34,9,17,0.529,5,8,0.625,4,9,0.444,3,4,0.75,0,2,2,3,0,0,2,2,25,16.2
Andrew Wiggins,21-246,F-G,10/26/16,MIN,MEM,1,34,7,14,0.5,6,13,0.462,1,1,1,10,14,0.714,4,3,7,0,0,1,2,1,25,18.4
Otto Porter,23-229,F,1/18/17,WAS,MEM,1,34,9,12,0.75,3,4,0.75,6,8,0.75,1,1,1,2,5,7,0,1,0,0,2,25,23.3
Isaiah Thomas,27-352,G,1/24/17,BOS,WAS,1,35,7,19,0.368,6,13,0.462,1,6,0.167,10,11,0.909,0,1,1,13,2,0,3,3,25,21.3
Paul George,26-219,F,12/7/16,IND,PHO,1,38,8,18,0.444,7,13,0.538,1,5,0.2,8,10,0.8,2,11,13,1,3,0,3,3,25,19
John Wall,26-182,G,3/7/17,WAS,PHO,1,37,9,20,0.45,9,17,0.529,0,3,0,7,12,0.583,1,3,4,14,3,2,3,1,25,25
T.J. Warren,23-208,F,4/1/17,PHO,POR,1,43,10,17,0.588,8,15,0.533,2,2,1,3,4,0.75,1,4,5,1,0,1,0,3,25,18.8
Jrue Holiday,26-243,G,2/10/17,NOP,MIN,1,38,10,14,0.714,9,12,0.75,1,2,0.5,4,4,1,2,4,6,12,5,0,9,3,25,25
Paul Millsap,32-000,F,2/10/17,ATL,SAC,1,38,7,13,0.538,5,7,0.714,2,6,0.333,9,11,0.818,2,4,6,3,2,0,2,2,25,21.8
Kevin Durant,28-137,F-G,2/13/17,GSW,DEN,1,27,10,16,0.625,8,11,0.727,2,5,0.4,3,3,1,1,3,4,5,1,1,3,1,25,21.2
Mike Conley,29-043,G,11/23/16,MEM,PHI,1,45,7,20,0.35,4,13,0.308,3,7,0.429,8,10,0.8,0,9,9,9,2,0,4,2,25,19.2
Nikola Jokic,21-315,C-F,12/30/16,DEN,PHI,1,22,9,13,0.692,9,13,0.692,0,0,,7,9,0.778,2,5,7,4,0,0,2,5,25,20.4
Devin Booker,20-128,G,3/7/17,PHO,WAS,1,38,8,18,0.444,4,11,0.364,4,7,0.571,5,6,0.833,1,3,4,6,0,0,6,2,25,14.2
Kristaps Porzingis,21-116,F-C,11/26/16,NYK,CHO,1,37,7,16,0.438,5,11,0.455,2,5,0.4,9,11,0.818,0,6,6,0,0,2,0,4,25,17.4
Kyrie Irving,24-328,G,2/14/17,CLE,MIN,1,37,10,27,0.37,8,17,0.471,2,10,0.2,3,3,1,0,1,1,7,1,1,0,4,25,15.4
LeBron James,31-311,F-G,11/5/16,CLE,PHI,1,36,9,23,0.391,8,18,0.444,1,5,0.2,6,7,0.857,1,7,8,14,2,1,5,1,25,22
Avery Bradley,26-018,G,12/14/16,BOS,SAS,1,35,10,16,0.625,7,10,0.7,3,6,0.5,2,2,1,1,9,10,6,3,0,3,2,25,24.6
James Harden,27-165,G,2/7/17,HOU,ORL,1,36,6,21,0.286,3,11,0.273,3,10,0.3,10,14,0.714,1,5,6,13,3,0,4,1,25,21
DeMarcus Cousins,26-207,C-F,3/8/17,NOP,TOR,1,39,8,23,0.348,5,15,0.333,3,8,0.375,6,7,0.857,2,8,10,3,1,2,5,5,25,13
Marc Gasol,31-335,C,12/29/16,MEM,OKC,1,33,9,20,0.45,9,17,0.529,0,3,0,7,9,0.778,0,8,8,2,1,5,2,4,25,18.5
Isaiah Thomas,28-043,G,3/22/17,BOS,IND,1,33,9,21,0.429,5,11,0.455,4,10,0.4,3,3,1,0,0,0,5,1,1,2,4,25,15.5
Gordon Hayward,26-357,F-G,3/15/17,UTA,DET,1,34,9,17,0.529,5,10,0.5,4,7,0.571,3,3,1,2,7,9,6,1,0,4,2,25,20.6
Kawhi Leonard,25-188,F,1/3/17,SAS,TOR,1,28,8,12,0.667,3,5,0.6,5,7,0.714,4,5,0.8,1,3,4,2,2,3,0,2,25,25.7
John Wall,26-090,G,12/5/16,WAS,BRK,1,36,10,19,0.526,9,14,0.643,1,5,0.2,4,4,1,0,1,1,13,3,0,4,0,25,24.1
Allen Crabbe,24-277,G-F,1/11/17,POR,CLE,0,31,9,11,0.818,6,6,1,3,5,0.6,3,4,0.75,0,4,4,1,1,0,0,1,24,22
Andre Drummond,23-213,C,3/11/17,DET,NYK,1,30,10,12,0.833,10,12,0.833,0,0,,4,10,0.4,5,10,15,0,3,1,2,3,24,24.2
Anthony Davis,23-339,F-C,2/13/17,NOP,PHO,1,40,8,16,0.5,8,15,0.533,0,1,0,8,8,1,1,9,10,2,0,4,3,4,24,19
Lou Williams,30-071,G,1/6/17,LAL,MIA,0,24,9,19,0.474,4,9,0.444,5,10,0.5,1,1,1,0,1,1,3,0,0,3,1,24,13.3
Nik Stauskas,23-148,G,3/4/17,PHI,DET,1,37,10,15,0.667,6,8,0.75,4,7,0.571,0,0,,0,5,5,2,2,0,3,4,24,17.8
Joel Embiid,22-303,C-F,1/13/17,PHI,CHO,1,28,6,12,0.5,6,7,0.857,0,5,0,12,14,0.857,0,8,8,1,2,3,5,5,24,17.4
Tyler Johnson,24-298,G,3/1/17,MIA,PHI,0,28,8,12,0.667,6,9,0.667,2,3,0.667,6,8,0.75,0,2,2,4,2,0,2,1,24,21
Frank Kaminsky,23-330,F-C,2/28/17,CHO,LAL,1,36,8,15,0.533,4,8,0.5,4,7,0.571,4,4,1,1,11,12,3,0,1,1,1,24,22.1
Karl-Anthony Towns,21-092,C-F,2/15/17,MIN,DEN,1,39,8,19,0.421,7,17,0.412,1,2,0.5,7,8,0.875,4,15,19,2,1,0,0,2,24,22.4
Evan Fournier,24-046,G-F,12/14/16,ORL,LAC,1,33,9,17,0.529,7,13,0.538,2,4,0.5,4,4,1,1,0,1,8,0,0,1,5,24,19
Zach LaVine,21-295,G,12/30/16,MIN,MIL,1,39,9,17,0.529,3,8,0.375,6,9,0.667,0,0,,0,2,2,4,0,0,2,3,24,15.9
Klay Thompson,26-303,G,12/7/16,GSW,LAC,1,35,8,18,0.444,5,12,0.417,3,6,0.5,5,5,1,2,2,4,3,0,0,1,1,24,17.3
Danilo Gallinari,28-202,F,2/26/17,DEN,MEM,1,35,6,16,0.375,4,9,0.444,2,7,0.286,10,11,0.909,0,4,4,1,2,0,1,2,24,16.9
Dejounte Murray,20-122,G,1/19/17,SAS,DEN,1,34,7,11,0.636,4,6,0.667,3,5,0.6,7,7,1,0,2,2,2,1,0,1,3,24,19.9
Anthony Davis,24-006,F-C,3/17/17,NOP,HOU,1,38,10,18,0.556,10,17,0.588,0,1,0,4,5,0.8,1,14,15,3,1,3,4,3,24,19.9
LeBron James,32-026,F-G,1/25/17,CLE,SAC,1,45,8,15,0.533,8,12,0.667,0,3,0,8,11,0.727,4,9,13,11,2,1,5,3,24,25.2
Seth Curry,26-192,G,3/3/17,DAL,MEM,1,37,8,15,0.533,6,8,0.75,2,7,0.286,6,6,1,0,5,5,2,2,0,2,2,24,18.8
Wilson Chandler,29-242,F,1/7/17,DEN,OKC,0,32,10,18,0.556,8,14,0.571,2,4,0.5,2,4,0.5,0,8,8,2,0,2,2,2,24,17
Evan Fournier,24-151,G-F,3/29/17,ORL,OKC,1,41,9,22,0.409,6,14,0.429,3,8,0.375,3,3,1,1,5,6,5,1,0,5,3,24,12.7
Giannis Antetokounmpo,22-046,F-G,1/21/17,MIL,MIA,1,38,8,19,0.421,6,14,0.429,2,5,0.4,6,8,0.75,4,6,10,3,2,0,2,2,24,19
Nicolas Batum,28-087,F-G,3/11/17,CHO,NOP,1,41,9,21,0.429,5,8,0.625,4,13,0.308,2,3,0.667,0,6,6,8,0,0,3,2,24,16.1
Brook Lopez,28-334,C,3/1/17,BRK,SAC,1,30,9,17,0.529,8,12,0.667,1,5,0.2,5,7,0.714,3,5,8,0,0,1,4,4,24,13.6
Klay Thompson,27-017,G,2/25/17,GSW,BRK,1,31,8,18,0.444,6,13,0.462,2,5,0.4,6,6,1,0,4,4,4,0,1,1,1,24,17.9
Harrison Barnes,24-207,F,12/23/16,DAL,LAC,1,38,11,19,0.579,11,17,0.647,0,2,0,2,3,0.667,2,4,6,1,1,1,3,1,24,16.3
Jon Leuer,27-265,F,2/3/17,DET,MIN,1,35,8,16,0.5,4,9,0.444,4,7,0.571,4,5,0.8,2,2,4,1,0,0,0,2,24,17.5
Will Barton,26-073,G,3/20/17,DEN,HOU,0,30,8,13,0.615,4,8,0.5,4,5,0.8,4,5,0.8,0,7,7,8,1,1,1,1,24,25.7
Nick Young,31-202,G-F,12/20/16,LAL,CHO,1,27,9,18,0.5,4,8,0.5,5,10,0.5,1,1,1,0,2,2,0,0,0,1,0,24,14.6
Terrence Jones,25-003,F,1/12/17,NOP,BRK,1,38,10,17,0.588,9,15,0.6,1,2,0.5,3,9,0.333,2,10,12,1,1,0,2,2,24,17
Nicolas Batum,27-340,F-G,11/18/16,CHO,ATL,1,33,8,17,0.471,4,9,0.444,4,8,0.5,4,4,1,1,9,10,4,2,0,3,0,24,20.5
Ersan Ilyasova,29-250,F,1/20/17,PHI,POR,1,29,9,14,0.643,4,8,0.5,5,6,0.833,1,2,0.5,2,4,6,2,2,1,5,4,24,17.5
Lou Williams,30-082,G,1/17/17,LAL,DEN,0,31,8,17,0.471,6,11,0.545,2,6,0.333,6,6,1,1,3,4,7,0,1,0,0,24,22.5
Nikola Mirotic,26-030,F,3/13/17,CHI,CHO,0,29,8,16,0.5,3,4,0.75,5,12,0.417,3,3,1,3,8,11,0,0,0,1,3,24,18.3
Kemba Walker,26-173,G,10/28/16,CHO,MIA,1,31,7,18,0.389,5,13,0.385,2,5,0.4,8,9,0.889,0,1,1,4,2,0,0,1,24,18.5
Chris Paul,31-185,G,11/7/16,LAC,DET,1,25,8,10,0.8,3,5,0.6,5,5,1,3,4,0.75,0,6,6,8,2,1,0,1,24,29.5
Isaiah Thomas,27-292,G,11/25/16,BOS,SAS,1,36,9,21,0.429,6,12,0.5,3,9,0.333,3,4,0.75,0,1,1,8,0,0,2,2,24,15.6
DeMarcus Cousins,26-116,C-F,12/7/16,SAC,DAL,1,33,10,16,0.625,8,14,0.571,2,2,1,2,3,0.667,2,11,13,7,0,3,2,3,24,24.9
LeBron James,32-071,F-G,3/11/17,CLE,ORL,1,38,8,14,0.571,6,9,0.667,2,5,0.4,6,10,0.6,0,12,12,12,0,1,4,3,24,23.3
Khris Middleton,25-204,F-G,3/4/17,MIL,TOR,1,30,9,14,0.643,8,10,0.8,1,4,0.25,5,6,0.833,0,3,3,0,1,0,2,4,24,15.7
Stephen Curry,29-017,G,3/31/17,GSW,HOU,1,35,8,18,0.444,4,9,0.444,4,9,0.444,4,5,0.8,3,4,7,5,2,0,2,4,24,19.4
C.J. McCollum,25-044,G,11/2/16,POR,PHO,1,39,8,18,0.444,5,12,0.417,3,6,0.5,5,5,1,0,4,4,4,0,1,2,4,24,15.7
James Harden,27-075,G,11/9/16,HOU,SAS,1,41,9,19,0.474,8,14,0.571,1,5,0.2,5,7,0.714,2,10,12,15,1,0,8,1,24,21
Nikola Jokic,21-311,C-F,12/26/16,DEN,LAC,1,32,11,16,0.688,9,13,0.692,2,3,0.667,0,1,0,2,8,10,4,3,0,2,4,24,22.8
Karl-Anthony Towns,21-109,C-F,3/4/17,MIN,SAS,1,46,9,16,0.563,9,14,0.643,0,2,0,6,8,0.75,6,8,14,1,1,1,2,4,24,21
Carmelo Anthony,32-156,F,11/1/16,NYK,DET,1,35,8,17,0.471,6,11,0.545,2,6,0.333,6,7,0.857,0,2,2,1,4,0,2,2,24,17.4
DeMarcus Cousins,26-150,C-F,1/10/17,SAC,DET,1,30,8,14,0.571,4,9,0.444,4,5,0.8,4,7,0.571,4,9,13,6,1,1,3,4,24,23
Carmelo Anthony,32-169,F,11/14/16,NYK,DAL,1,33,8,18,0.444,5,12,0.417,3,6,0.5,5,6,0.833,2,6,8,3,0,2,3,3,24,16.7
Marc Gasol,32-003,C,2/1/17,MEM,DEN,1,24,9,15,0.6,6,11,0.545,3,4,0.75,3,3,1,0,5,5,3,0,1,0,3,24,20.2
Eric Bledsoe,27-014,G,12/23/16,PHO,PHI,1,37,7,12,0.583,5,7,0.714,2,5,0.4,8,11,0.727,1,1,2,11,0,3,4,2,24,23.2
Klay Thompson,26-321,G,12/25/16,GSW,CLE,1,41,9,16,0.563,4,5,0.8,5,11,0.455,1,2,0.5,0,2,2,1,1,1,2,1,24,16.6
John Wall,26-139,G,1/23/17,WAS,CHO,1,38,9,20,0.45,9,19,0.474,0,1,0,6,7,0.857,0,4,4,7,1,0,5,2,24,14.5
Kristaps Porzingis,21-232,F-C,3/22/17,NYK,UTA,1,31,8,17,0.471,5,10,0.5,3,7,0.429,5,6,0.833,2,5,7,0,1,1,0,5,24,17.5
James Johnson,30-027,F,3/19/17,MIA,POR,0,31,9,13,0.692,7,10,0.7,2,3,0.667,4,5,0.8,1,6,7,5,2,2,0,2,24,26.7
Markieff Morris,27-071,F,11/12/16,WAS,CHI,1,44,9,19,0.474,9,18,0.5,0,1,0,6,6,1,4,11,15,2,0,3,3,1,24,20.5
Seth Curry,26-159,G,1/29/17,DAL,SAS,1,37,10,20,0.5,6,11,0.545,4,9,0.444,0,0,,1,9,10,5,1,0,2,2,24,19.1
Dennis Schroder,23-092,G,12/16/16,ATL,TOR,1,29,8,12,0.667,6,8,0.75,2,4,0.5,6,7,0.857,1,1,2,6,1,0,3,4,24,20
Willy Hernangomez,22-302,C,3/25/17,NYK,SAS,1,36,11,16,0.688,11,16,0.688,0,0,,2,3,0.667,5,8,13,1,1,1,1,5,24,22.1
Karl-Anthony Towns,20-363,C-F,11/12/16,MIN,LAC,1,33,10,18,0.556,9,15,0.6,1,3,0.333,3,4,0.75,4,6,10,2,2,2,3,5,24,19.4
Kemba Walker,26-253,G,1/16/17,CHO,BOS,1,38,8,21,0.381,5,14,0.357,3,7,0.429,5,5,1,2,2,4,2,1,0,3,2,24,13.1
Goran Dragic,30-297,G,2/27/17,MIA,DAL,1,37,10,21,0.476,8,16,0.5,2,5,0.4,2,3,0.667,3,2,5,6,3,0,4,3,24,17.6
Dwyane Wade,34-343,G,12/25/16,CHI,SAS,1,28,9,16,0.563,8,13,0.615,1,3,0.333,5,5,1,2,1,3,6,1,0,0,2,24,22.5
Paul Millsap,32-026,F,3/8/17,ATL,BRK,1,39,10,21,0.476,10,17,0.588,0,4,0,4,5,0.8,2,2,4,3,0,2,1,4,24,15.8
Nemanja Bjelica,28-188,F,11/13/16,MIN,LAL,1,41,9,15,0.6,4,7,0.571,5,8,0.625,1,1,1,2,6,8,3,3,0,1,3,24,23.2
Nikola Vucevic,26-016,C,11/9/16,ORL,MIN,1,30,11,19,0.579,10,18,0.556,1,1,1,1,2,0.5,6,8,14,6,0,1,0,3,24,25
Evan Turner,28-099,G,2/3/17,POR,DAL,1,32,10,17,0.588,9,13,0.692,1,4,0.25,3,3,1,0,4,4,3,1,0,3,0,24,17.4
Kevin Love,28-062,F,11/8/16,CLE,ATL,1,38,7,17,0.412,7,13,0.538,0,4,0,10,11,0.909,6,6,12,3,3,0,2,4,24,22
Will Barton,26-038,G,2/13/17,DEN,GSW,1,41,9,19,0.474,5,11,0.455,4,8,0.5,2,2,1,2,8,10,7,1,0,2,1,24,21.6
Kyle Lowry,30-252,G,12/2/16,TOR,LAL,1,31,8,12,0.667,2,3,0.667,6,9,0.667,2,2,1,0,4,4,7,1,0,4,1,24,21.5
Eric Bledsoe,27-017,G,12/26/16,PHO,HOU,1,27,8,20,0.4,7,12,0.583,1,8,0.125,7,9,0.778,0,6,6,4,3,0,5,3,24,13.8
Wilson Chandler,29-290,F,2/24/17,DEN,BRK,0,29,11,21,0.524,9,15,0.6,2,6,0.333,0,0,,2,1,3,1,0,0,1,2,24,14.3
T.J. Warren,23-204,F,3/28/17,PHO,ATL,1,40,11,20,0.55,11,19,0.579,0,1,0,2,2,1,4,4,8,3,2,2,6,5,24,15.9
DeMar DeRozan,27-144,G,12/29/16,TOR,PHO,1,35,8,18,0.444,8,15,0.533,0,3,0,8,10,0.8,0,3,3,2,0,0,2,2,24,13.3
J.J. Redick,32-154,G,11/25/16,LAC,DET,1,33,9,14,0.643,6,8,0.75,3,6,0.5,3,3,1,0,3,3,1,0,0,3,1,24,16
Jeremy Lin,28-203,G,3/14/17,BRK,OKC,1,26,8,15,0.533,6,11,0.545,2,4,0.5,6,6,1,0,2,2,5,1,1,3,3,24,18.3
Carmelo Anthony,32-274,F,2/27/17,NYK,TOR,1,39,9,26,0.346,7,17,0.412,2,9,0.222,4,4,1,1,3,4,2,1,0,3,1,24,10
Derrick Rose,28-059,G,12/2/16,NYK,MIN,1,34,9,15,0.6,9,14,0.643,0,1,0,6,10,0.6,1,4,5,5,1,0,1,1,24,20.5
Kawhi Leonard,25-145,F,11/21/16,SAS,DAL,1,34,8,19,0.421,7,18,0.389,1,1,1,7,8,0.875,2,7,9,4,1,0,1,2,24,19
Kemba Walker,26-307,G,3/11/17,CHO,NOP,1,40,9,24,0.375,5,9,0.556,4,15,0.267,2,2,1,0,8,8,12,0,0,2,1,24,19.2
Richaun Holmes,23-147,F-C,3/11/17,PHI,LAC,0,27,10,14,0.714,8,11,0.727,2,3,0.667,2,4,0.5,0,9,9,0,0,0,1,4,24,17.5
Harrison Barnes,24-273,F,2/27/17,DAL,MIA,1,36,9,18,0.5,9,17,0.529,0,1,0,6,6,1,1,3,4,1,0,0,0,0,24,17.3
Timothe Luwawu-Cabarrot,21-336,F,4/10/17,PHI,IND,1,37,8,12,0.667,4,7,0.571,4,5,0.8,4,4,1,1,4,5,3,1,0,2,4,24,20.2
Jimmy Butler,27-125,G-F,1/17/17,CHI,DAL,1,40,5,12,0.417,5,11,0.455,0,1,0,14,16,0.875,2,7,9,12,1,0,3,1,24,26.3
Damian Lillard,26-237,G,3/9/17,POR,PHI,1,41,6,21,0.286,6,15,0.4,0,6,0,12,12,1,0,4,4,4,0,2,3,0,24,14.1
Zach LaVine,21-278,G,12/13/16,MIN,CHI,1,43,10,18,0.556,9,14,0.643,1,4,0.25,3,4,0.75,1,5,6,6,0,1,2,3,24,18.9
James Johnson,29-285,F,12/1/16,MIA,UTA,0,24,11,15,0.733,9,11,0.818,2,4,0.5,0,0,,3,3,6,3,1,1,1,3,24,22.5
Giannis Antetokounmpo,22-090,F-G,3/6/17,MIL,PHI,1,35,7,13,0.538,6,11,0.545,1,2,0.5,9,12,0.75,1,7,8,5,2,3,0,1,24,26.5
Stephen Curry,28-357,G,3/6/17,GSW,ATL,1,35,8,20,0.4,2,5,0.4,6,15,0.4,2,3,0.667,1,3,4,9,0,0,2,4,24,17.1
Nicolas Batum,28-012,F-G,12/26/16,CHO,BRK,1,37,7,16,0.438,5,10,0.5,2,6,0.333,8,8,1,0,5,5,5,3,0,1,2,24,21.8
Paul Millsap,31-299,F,12/5/16,ATL,OKC,1,39,8,14,0.571,7,10,0.7,1,4,0.25,7,11,0.636,0,5,5,4,3,0,2,3,24,19.9
Eric Gordon,27-362,G,12/21/16,HOU,PHO,0,28,8,17,0.471,1,4,0.25,7,13,0.538,1,2,0.5,0,2,2,3,1,0,0,4,24,17
Stephen Curry,28-240,G,11/9/16,GSW,DAL,1,31,8,12,0.667,4,4,1,4,8,0.5,4,4,1,0,3,3,6,1,0,5,1,24,19.5
LeBron James,32-085,F-G,3/25/17,CLE,WAS,1,41,10,21,0.476,10,17,0.588,0,4,0,4,6,0.667,3,8,11,8,0,1,3,2,24,19.5
Marc Gasol,31-352,C,1/15/17,MEM,CHI,1,40,10,21,0.476,8,16,0.5,2,5,0.4,2,2,1,1,10,11,3,1,1,4,0,24,16.8
Stephen Curry,28-304,G,1/12/17,GSW,DET,1,30,9,17,0.529,6,8,0.75,3,9,0.333,3,3,1,0,2,2,7,5,0,8,0,24,18.2
Kyle Lowry,30-299,G,1/18/17,TOR,PHI,1,40,5,13,0.385,2,5,0.4,3,8,0.375,11,16,0.688,3,1,4,4,5,0,5,6,24,17.7
Kent Bazemore,27-198,G-F,1/15/17,ATL,MIL,1,28,8,13,0.615,4,6,0.667,4,7,0.571,4,5,0.8,2,1,3,1,2,0,2,3,24,18.9
C.J. McCollum,25-060,G,11/18/16,POR,NOP,1,36,7,18,0.389,3,10,0.3,4,8,0.5,6,6,1,1,3,4,5,1,0,3,5,24,15.3
DeMarcus Cousins,26-074,C-F,10/26/16,SAC,PHO,1,25,6,10,0.6,6,9,0.667,0,1,0,12,16,0.75,1,5,6,2,1,0,3,4,24,17.8
Markieff Morris,27-151,F,1/31/17,WAS,NYK,1,34,9,14,0.643,7,9,0.778,2,5,0.4,4,4,1,2,8,10,2,0,0,2,3,24,19.8
Marcus Morris,27-078,F,11/19/16,DET,BOS,1,33,10,16,0.625,6,9,0.667,4,7,0.571,0,0,,1,4,5,2,0,0,1,1,24,18.7
Dion Waiters,25-046,G,1/25/17,MIA,BRK,1,36,10,18,0.556,8,15,0.533,2,3,0.667,2,4,0.5,0,5,5,8,0,0,2,3,24,18.5
John Wall,26-095,G,12/10/16,WAS,MIL,1,39,8,20,0.4,7,16,0.438,1,4,0.25,7,8,0.875,0,4,4,11,2,1,4,3,24,19.2
Devin Booker,20-088,G,1/26/17,PHO,DEN,1,33,9,17,0.529,8,11,0.727,1,6,0.167,5,6,0.833,0,0,0,6,1,0,5,2,24,14.7
Frank Kaminsky,23-303,F-C,2/1/17,CHO,GSW,0,24,9,14,0.643,7,8,0.875,2,6,0.333,4,4,1,0,7,7,2,2,0,0,3,24,22.1
DeMar DeRozan,27-108,G,11/23/16,TOR,HOU,1,36,8,19,0.421,6,16,0.375,2,3,0.667,6,7,0.857,2,3,5,9,2,0,2,1,24,21.7
Jeff Teague,28-238,G,2/3/17,IND,BRK,1,34,6,10,0.6,4,8,0.5,2,2,1,10,13,0.769,1,2,3,7,3,0,3,3,24,23.2
Lou Williams,30-045,G,12/11/16,LAL,NYK,0,26,6,13,0.462,4,6,0.667,2,7,0.286,10,10,1,0,6,6,5,2,0,5,2,24,18.8
Jae Crowder,26-274,F,4/6/17,BOS,ATL,1,36,9,14,0.643,5,7,0.714,4,7,0.571,2,4,0.5,1,3,4,1,1,0,1,4,24,17.7
Damian Lillard,26-194,G,1/25/17,POR,LAL,1,35,8,20,0.4,7,15,0.467,1,5,0.2,7,7,1,0,4,4,2,1,0,1,1,24,15.4
Dennis Schroder,23-146,G,2/8/17,ATL,DEN,1,35,10,19,0.526,10,15,0.667,0,4,0,4,4,1,1,4,5,10,3,0,3,1,24,23.2
Jimmy Butler,27-043,G-F,10/27/16,CHI,BOS,1,37,6,17,0.353,2,11,0.182,4,6,0.667,8,12,0.667,3,4,7,3,2,0,0,2,24,19.5
Mike Conley,29-015,G,10/26/16,MEM,MIN,1,30,8,14,0.571,4,9,0.444,4,5,0.8,4,5,0.8,0,1,1,4,0,1,2,5,24,16.8
Kyle Lowry,30-255,G,12/5/16,TOR,CLE,1,40,7,14,0.5,3,5,0.6,4,9,0.444,6,7,0.857,1,2,3,9,1,0,2,2,24,22.4
Mike Conley,29-073,G,12/23/16,MEM,HOU,1,29,9,17,0.529,6,11,0.545,3,6,0.5,3,4,0.75,0,3,3,5,1,0,0,1,24,20.3
Clint Capela,22-290,F-C,3/4/17,HOU,MEM,1,29,8,14,0.571,8,14,0.571,0,0,,8,10,0.8,4,7,11,2,0,0,0,4,24,21.3
Kent Bazemore,27-212,G-F,1/29/17,ATL,NYK,1,50,9,15,0.6,5,10,0.5,4,5,0.8,2,2,1,2,8,10,0,0,0,1,2,24,19.1
Kemba Walker,26-183,G,11/7/16,CHO,IND,1,25,7,11,0.636,2,5,0.4,5,6,0.833,5,6,0.833,0,2,2,10,2,1,1,0,24,28
Thaddeus Young,28-172,F,12/10/16,IND,POR,1,40,9,13,0.692,3,5,0.6,6,8,0.75,0,0,,3,6,9,2,2,3,3,1,24,24.5
Nikola Vucevic,26-008,C,11/1/16,ORL,PHI,1,31,11,16,0.688,11,16,0.688,0,0,,2,3,0.667,5,9,14,4,1,1,1,4,24,24.9
Marc Gasol,31-326,C,12/20/16,MEM,BOS,1,37,8,22,0.364,5,18,0.278,3,4,0.75,5,5,1,1,6,7,6,1,0,2,4,24,15.9
Kevin Love,28-055,F,11/1/16,CLE,HOU,1,31,9,16,0.563,8,14,0.571,1,2,0.5,5,5,1,1,4,5,0,2,1,2,1,24,18.6
Wilson Chandler,29-206,F,12/2/16,DEN,HOU,0,29,10,19,0.526,7,12,0.583,3,7,0.429,1,3,0.333,2,3,5,2,1,0,2,1,24,16.2
Isaiah Thomas,27-265,G,10/29/16,BOS,CHO,1,35,9,20,0.45,7,13,0.538,2,7,0.286,4,7,0.571,0,1,1,7,0,0,2,2,24,14.8
Serge Ibaka,27-196,F-C,4/2/17,TOR,PHI,1,28,11,17,0.647,11,15,0.733,0,2,0,2,2,1,1,5,6,0,1,6,0,3,24,22.7
J.J. Redick,32-270,G,3/21/17,LAC,LAL,1,18,7,9,0.778,3,4,0.75,4,5,0.8,6,6,1,0,3,3,0,1,0,2,3,24,19.2
Evan Fournier,24-103,G-F,2/9/17,ORL,PHI,1,43,8,21,0.381,5,15,0.333,3,6,0.5,5,5,1,2,7,9,8,1,0,6,3,24,15.4
Marquese Chriss,19-262,F,3/21/17,PHO,MIA,1,38,7,9,0.778,5,7,0.714,2,2,1,8,10,0.8,1,6,7,0,2,0,6,5,24,16.2
Dirk Nowitzki,38-241,F,2/15/17,DAL,DET,1,30,9,19,0.474,5,13,0.385,4,6,0.667,2,2,1,0,10,10,3,1,1,1,2,24,19.3
Jae Crowder,26-254,F,3/17/17,BOS,BRK,1,35,7,11,0.636,3,4,0.75,4,7,0.571,6,7,0.857,0,12,12,1,1,0,1,1,24,22.6
Gordon Hayward,26-247,F-G,11/25/16,UTA,ATL,1,31,8,14,0.571,7,13,0.538,1,1,1,7,7,1,1,6,7,0,2,1,2,1,24,20.2
Blake Griffin,27-263,F,12/4/16,LAC,IND,1,34,10,21,0.476,10,21,0.476,0,0,,4,7,0.571,4,12,16,5,1,2,3,3,24,20.2
Austin Rivers,24-158,G,1/6/17,LAC,SAC,1,36,9,15,0.6,5,8,0.625,4,7,0.571,2,3,0.667,2,4,6,2,0,0,3,2,24,16.9
George Hill,30-208,G,11/28/16,UTA,MIN,1,34,7,15,0.467,7,12,0.583,0,3,0,10,11,0.909,1,7,8,4,0,0,2,3,24,18.3
Kyle Lowry,30-236,G,11/16/16,TOR,GSW,1,38,6,17,0.353,3,11,0.273,3,6,0.5,9,12,0.75,2,3,5,5,3,0,4,3,24,16.9
Paul George,26-261,F,1/18/17,IND,SAC,1,42,8,15,0.533,6,10,0.6,2,5,0.4,6,6,1,0,4,4,3,1,0,4,1,24,16.6
Tobias Harris,24-249,F,3/21/17,DET,BRK,1,36,10,15,0.667,10,12,0.833,0,3,0,4,5,0.8,2,3,5,1,2,3,0,1,24,23.8
Derrick Rose,28-077,G,12/20/16,NYK,IND,1,36,9,18,0.5,9,18,0.5,0,0,,6,7,0.857,0,4,4,6,0,2,4,0,24,17.4
Kristaps Porzingis,21-157,F-C,1/6/17,NYK,MIL,1,30,9,14,0.643,6,10,0.6,3,4,0.75,3,4,0.75,0,6,6,0,0,3,1,6,24,17.9
C.J. McCollum,25-067,G,11/25/16,POR,NOP,1,36,9,19,0.474,5,11,0.455,4,8,0.5,2,2,1,0,1,1,3,2,1,1,2,24,17.6
Derrick Rose,28-172,G,3/25/17,NYK,SAS,1,36,10,22,0.455,10,22,0.455,0,0,,4,4,1,3,2,5,5,0,0,1,0,24,17.8
Andrew Wiggins,22-040,F-G,4/4/17,MIN,GSW,1,30,9,20,0.45,8,16,0.5,1,4,0.25,5,7,0.714,1,3,4,2,3,0,4,2,24,14
C.J. McCollum,25-128,G,1/25/17,POR,LAL,1,33,9,16,0.563,7,13,0.538,2,3,0.667,4,4,1,0,4,4,4,0,0,0,3,24,19.2
Danilo Gallinari,28-119,F,12/5/16,DEN,PHI,1,38,5,12,0.417,2,5,0.4,3,7,0.429,11,12,0.917,1,3,4,3,2,1,2,1,24,21.2
Kyle Lowry,30-301,G,1/20/17,TOR,CHO,1,34,7,18,0.389,4,8,0.5,3,10,0.3,7,7,1,0,1,1,3,1,0,1,3,24,15.4
Kyrie Irving,24-257,G,12/5/16,CLE,TOR,1,37,9,18,0.5,7,12,0.583,2,6,0.333,4,4,1,1,1,2,7,0,0,6,4,24,13.3
Steven Adams,23-142,C,12/9/16,OKC,HOU,1,29,8,9,0.889,8,9,0.889,0,0,,8,9,0.889,2,8,10,1,1,0,4,2,24,21.2
Kemba Walker,26-283,G,2/15/17,CHO,TOR,1,43,8,15,0.533,2,5,0.4,6,10,0.6,2,2,1,0,4,4,9,2,0,3,2,24,22.4
Eric Gordon,28-021,G,1/15/17,HOU,BRK,0,28,9,14,0.643,5,6,0.833,4,8,0.5,2,3,0.667,1,2,3,3,0,0,1,2,24,19
Dennis Schroder,23-132,G,1/25/17,ATL,CHI,1,33,7,15,0.467,3,9,0.333,4,6,0.667,6,6,1,0,2,2,9,1,0,3,4,24,19.6
Lou Williams,30-022,G,11/18/16,LAL,SAS,0,27,9,13,0.692,7,9,0.778,2,4,0.5,4,4,1,0,3,3,3,2,0,2,3,24,20.3
Kyrie Irving,25-008,G,3/31/17,CLE,PHI,1,31,11,16,0.688,10,15,0.667,1,1,1,1,1,1,0,1,1,9,2,0,1,2,24,24
Evan Fournier,24-042,G-F,12/10/16,ORL,DEN,1,38,9,19,0.474,7,13,0.538,2,6,0.333,4,5,0.8,0,4,4,6,1,0,0,3,24,19.1
Bojan Bogdanovic,27-229,G-F,12/3/16,BRK,MIL,1,32,8,17,0.471,6,13,0.462,2,4,0.5,6,8,0.75,1,1,2,3,0,0,3,2,24,13.8
Kawhi Leonard,25-214,F,1/29/17,SAS,DAL,1,37,7,17,0.412,4,10,0.4,3,7,0.429,7,8,0.875,1,6,7,2,1,1,4,2,24,15.3
Russell Westbrook,28-065,G,1/16/17,OKC,LAC,1,29,7,19,0.368,5,12,0.417,2,7,0.286,8,9,0.889,1,4,5,4,2,0,4,2,24,15
C.J. McCollum,25-080,G,12/8/16,POR,MEM,1,35,7,13,0.538,3,9,0.333,4,4,1,6,6,1,0,0,0,1,1,0,1,1,24,18
Karl-Anthony Towns,21-080,C-F,2/3/17,MIN,DET,1,33,11,19,0.579,11,17,0.647,0,2,0,2,4,0.5,7,4,11,1,0,1,0,5,24,19.8
John Wall,26-151,G,2/4/17,WAS,NOP,1,38,8,19,0.421,6,12,0.5,2,7,0.286,6,8,0.75,1,2,3,13,5,1,4,1,24,24.8
Klay Thompson,26-273,G,11/7/16,GSW,NOP,1,38,11,20,0.55,9,13,0.692,2,7,0.286,0,0,,0,4,4,1,3,0,1,2,24,17.5
Goran Dragic,30-247,G,1/8/17,MIA,LAC,1,42,9,18,0.5,7,13,0.538,2,5,0.4,4,5,0.8,1,5,6,5,1,0,5,1,24,15.9
Dennis Schroder,23-192,G,3/26/17,ATL,BRK,1,35,10,24,0.417,8,20,0.4,2,4,0.5,2,3,0.667,0,2,2,8,2,0,3,4,24,14.4
Kawhi Leonard,25-190,F,1/5/17,SAS,DEN,1,36,9,19,0.474,6,13,0.462,3,6,0.5,3,4,0.75,1,5,6,5,0,2,1,2,24,19.2
Troy Daniels,25-158,G,12/20/16,MEM,BOS,0,35,8,13,0.615,4,6,0.667,4,7,0.571,4,4,1,0,2,2,0,2,0,2,3,24,17.5
Sean Kilpatrick,26-301,G,11/2/16,BRK,DET,0,28,8,12,0.667,4,8,0.5,4,4,1,4,4,1,0,10,10,3,2,0,3,2,24,22.1
Andrew Wiggins,21-334,F-G,1/22/17,MIN,DEN,1,39,10,20,0.5,9,17,0.529,1,3,0.333,3,4,0.75,0,4,4,4,1,1,2,5,24,15.3
Gordon Hayward,26-250,F-G,11/28/16,UTA,MIN,1,34,6,14,0.429,6,11,0.545,0,3,0,12,15,0.8,0,5,5,2,2,0,0,2,24,19.5
Terrence Ross,25-327,F-G,12/28/16,TOR,GSW,0,34,10,23,0.435,6,14,0.429,4,9,0.444,0,0,,3,4,7,1,2,0,0,4,24,16.3
LaMarcus Aldridge,31-130,F-C,11/26/16,SAS,WAS,1,34,9,17,0.529,8,14,0.571,1,3,0.333,5,6,0.833,2,5,7,0,1,0,1,2,24,17.4
Willy Hernangomez,22-317,C,4/9/17,NYK,TOR,1,31,9,15,0.6,8,14,0.571,1,1,1,5,6,0.833,3,8,11,5,3,0,2,3,24,24.5
Damian Lillard,26-150,G,12/12/16,POR,LAC,1,37,7,17,0.412,3,10,0.3,4,7,0.571,6,6,1,0,5,5,8,1,1,2,2,24,20.9
Kyle Lowry,30-291,G,1/10/17,TOR,BOS,1,42,7,12,0.583,2,6,0.333,5,6,0.833,5,8,0.625,1,3,4,9,2,1,4,3,24,22.6
Dion Waiters,25-088,G,3/8/17,MIA,CHO,1,27,8,16,0.5,3,6,0.5,5,10,0.5,3,4,0.75,1,2,3,5,1,0,2,3,24,18.2
Blake Griffin,27-254,F,11/25/16,LAC,DET,1,36,9,17,0.529,8,16,0.5,1,1,1,5,8,0.625,2,1,3,5,1,1,1,0,24,20.4
Zach Randolph,35-230,F,3/3/17,MEM,DAL,0,29,11,14,0.786,11,13,0.846,0,1,0,2,4,0.5,5,5,10,2,1,0,0,2,24,24.4
Karl-Anthony Towns,21-142,C-F,4/6/17,MIN,POR,1,39,8,16,0.5,7,13,0.538,1,3,0.333,7,7,1,6,10,16,4,1,1,3,4,24,23.1
Nicolas Batum,28-112,F-G,4/5/17,CHO,MIA,1,36,6,13,0.462,6,9,0.667,0,4,0,12,12,1,0,3,3,7,1,1,1,1,24,23.4
Enes Kanter,24-306,C,3/22/17,OKC,PHI,0,20,8,9,0.889,8,9,0.889,0,0,,8,9,0.889,4,7,11,0,1,1,0,1,24,26.7
Kyrie Irving,24-238,G,11/16/16,CLE,IND,1,32,10,20,0.5,9,15,0.6,1,5,0.2,3,4,0.75,1,1,2,7,1,0,2,3,24,17.3
Brook Lopez,28-295,C,1/21/17,BRK,CHO,1,31,10,21,0.476,7,14,0.5,3,7,0.429,1,1,1,0,5,5,4,0,2,2,3,24,15.8
Kyrie Irving,25-012,G,4/4/17,CLE,ORL,1,30,10,15,0.667,7,10,0.7,3,5,0.6,1,1,1,1,3,4,8,1,0,0,3,24,24.5
Eric Gordon,27-353,G,12/12/16,HOU,BRK,0,29,7,15,0.467,1,5,0.2,6,10,0.6,4,6,0.667,0,0,0,1,1,0,6,3,24,10
Harrison Barnes,24-245,F,1/30/17,DAL,CLE,1,37,9,16,0.563,9,14,0.643,0,2,0,6,7,0.857,4,7,11,3,1,0,3,2,24,20.2
Greg Monroe,26-272,C-F,3/3/17,MIL,LAC,0,35,11,15,0.733,11,15,0.733,0,0,,2,2,1,2,3,5,5,2,1,2,5,24,22.4
DeMar DeRozan,27-115,G,11/30/16,TOR,MEM,1,36,6,9,0.667,4,6,0.667,2,3,0.667,10,11,0.909,1,8,9,6,0,0,7,2,24,19.2
LeBron James,32-059,F-G,2/27/17,CLE,MIL,1,37,8,12,0.667,7,10,0.7,1,2,0.5,7,9,0.778,0,10,10,6,0,0,3,1,24,21.8
Lou Williams,30-041,G,12/7/16,LAL,HOU,0,25,7,12,0.583,5,8,0.625,2,4,0.5,8,8,1,1,0,1,0,3,1,6,1,24,16.4
Reggie Jackson,26-287,G,1/28/17,DET,MIA,1,31,10,17,0.588,8,15,0.533,2,2,1,2,2,1,0,7,7,3,0,0,4,1,24,15.9
DeMar DeRozan,27-138,G,12/23/16,TOR,UTA,1,37,10,24,0.417,10,23,0.435,0,1,0,4,6,0.667,1,5,6,1,4,0,2,3,24,14.1
Bradley Beal,23-262,G,3/17/17,WAS,CHI,1,32,10,18,0.556,7,14,0.5,3,4,0.75,1,1,1,1,3,4,0,0,0,3,4,24,12.4
Deron Williams,32-183,G,12/26/16,DAL,NOP,1,32,9,18,0.5,6,11,0.545,3,7,0.429,3,4,0.75,1,1,2,9,1,0,2,3,24,19.7
Evan Fournier,24-107,G-F,2/13/17,ORL,MIA,1,36,10,17,0.588,8,13,0.615,2,4,0.5,2,5,0.4,0,2,2,4,1,0,3,2,24,15.5
Paul George,26-277,F,2/3/17,IND,BRK,1,37,9,22,0.409,8,17,0.471,1,5,0.2,5,5,1,2,9,11,3,2,3,3,2,24,18.7
T.J. Warren,23-191,F,3/15/17,PHO,SAC,1,41,12,16,0.75,12,16,0.75,0,0,,0,0,,6,3,9,3,1,2,4,2,24,22.4
Kyle Lowry,30-279,G,12/29/16,TOR,PHO,1,38,7,15,0.467,4,6,0.667,3,9,0.333,7,9,0.778,0,5,5,5,2,1,4,4,24,17.6
Eric Gordon,27-353,G,12/12/16,HOU,BRK,0,29,7,15,0.467,1,5,0.2,6,10,0.6,4,6,0.667,0,0,0,1,1,0,6,3,24,10
Isaiah Thomas,27-334,G,1/6/17,BOS,PHI,1,35,6,14,0.429,4,10,0.4,2,4,0.5,10,11,0.909,1,3,4,3,0,0,7,4,24,11.3
Isaiah Whitehead,22-002,G,3/10/17,BRK,DAL,0,25,8,12,0.667,5,6,0.833,3,6,0.5,5,5,1,0,0,0,1,0,0,3,4,24,14.9
T.J. Warren,23-119,F,1/2/17,PHO,LAC,1,41,12,20,0.6,12,19,0.632,0,1,0,0,0,,5,3,8,2,1,1,2,3,24,19.1
Robert Covington,26-096,F,3/20/17,PHI,ORL,1,45,9,21,0.429,6,12,0.5,3,9,0.333,3,3,1,5,8,13,0,5,2,2,5,24,21.2
Kawhi Leonard,25-162,F,12/8/16,SAS,CHI,1,38,10,19,0.526,9,17,0.529,1,2,0.5,3,3,1,3,5,8,5,1,0,2,3,24,19.6
Tyler Johnson,24-323,G,3/26/17,MIA,BOS,0,31,9,15,0.6,9,13,0.692,0,2,0,6,6,1,1,3,4,2,3,0,2,3,24,19.9
Andre Drummond,23-182,C,2/8/17,DET,LAL,1,28,12,19,0.632,12,19,0.632,0,0,,0,3,0,5,12,17,0,3,4,3,1,24,23.8
Kyrie Irving,24-237,G,11/15/16,CLE,TOR,1,35,10,20,0.5,8,16,0.5,2,4,0.5,2,4,0.5,2,3,5,4,2,0,5,3,24,14.1
Trevor Ariza,31-269,F,3/26/17,HOU,OKC,1,37,9,11,0.818,3,3,1,6,8,0.75,0,0,,0,6,6,6,3,1,2,2,24,26.8
Stephen Curry,28-310,G,1/18/17,GSW,OKC,1,34,9,19,0.474,7,13,0.538,2,6,0.333,4,4,1,0,4,4,8,3,0,3,0,24,21.1
Victor Oladipo,24-277,G,2/5/17,OKC,POR,1,39,8,18,0.444,7,14,0.5,1,4,0.25,7,9,0.778,0,12,12,3,2,2,4,2,24,18.1
Kentavious Caldwell-Pope,23-302,G,12/16/16,DET,WAS,1,34,9,17,0.529,5,10,0.5,4,7,0.571,2,3,0.667,1,5,6,3,1,0,3,3,24,16.4
Dennis Schroder,23-074,G,11/28/16,ATL,GSW,1,34,10,20,0.5,9,16,0.563,1,4,0.25,3,4,0.75,0,1,1,6,2,1,5,2,24,15
Kristaps Porzingis,21-215,F-C,3/5/17,NYK,GSW,1,40,9,21,0.429,7,15,0.467,2,6,0.333,4,4,1,4,11,15,2,0,2,2,3,24,18.6
Pau Gasol,36-133,F-C,11/16/16,SAS,SAC,1,31,10,17,0.588,10,16,0.625,0,1,0,4,7,0.571,1,6,7,2,0,2,0,3,24,19
C.J. McCollum,25-077,G,12/5/16,POR,CHI,1,30,10,19,0.526,6,12,0.5,4,7,0.571,0,0,,1,1,2,5,0,0,2,2,24,16.4
Zach LaVine,21-303,G,1/7/17,MIN,UTA,1,38,10,21,0.476,7,12,0.583,3,9,0.333,1,1,1,3,6,9,4,1,0,2,2,24,18.2
Andrew Wiggins,21-313,F-G,1/1/17,MIN,POR,1,38,10,20,0.5,9,17,0.529,1,3,0.333,3,7,0.429,3,2,5,1,1,0,5,1,24,11.4
Kyle Lowry,30-248,G,11/28/16,TOR,PHI,1,32,7,9,0.778,1,3,0.333,6,6,1,4,5,0.8,0,4,4,8,1,0,3,0,24,24.9
Dwight Howard,31-056,C,2/2/17,ATL,HOU,1,37,11,13,0.846,11,13,0.846,0,0,,2,3,0.667,5,18,23,3,1,2,5,1,24,26.9
Giannis Antetokounmpo,21-331,F-G,11/1/16,MIL,NOP,1,34,10,19,0.526,9,13,0.692,1,6,0.167,3,4,0.75,3,6,9,7,1,2,2,5,24,21.5
Vince Carter,40-046,G-F,3/13/17,MEM,MIL,1,30,8,8,1,2,2,1,6,6,1,2,2,1,1,4,5,2,3,0,1,5,24,24.9
Dwyane Wade,34-320,G,12/2/16,CHI,CLE,1,37,11,23,0.478,10,19,0.526,1,4,0.25,1,2,0.5,3,2,5,4,2,0,4,2,24,14.6
Mike Conley,29-019,G,10/30/16,MEM,WAS,1,38,8,19,0.421,5,14,0.357,3,5,0.6,5,5,1,1,2,3,11,0,0,5,2,24,17.1
Jabari Parker,21-304,F,1/13/17,MIL,MIA,1,35,9,20,0.45,6,15,0.4,3,5,0.6,3,6,0.5,1,4,5,2,0,1,2,2,24,13.6
Danilo Gallinari,28-148,F,1/3/17,DEN,SAC,1,33,8,12,0.667,4,6,0.667,4,6,0.667,4,4,1,0,4,4,3,0,1,1,1,24,21.4
Chris Paul,31-178,G,10/31/16,LAC,PHO,1,30,8,15,0.533,6,11,0.545,2,4,0.5,6,7,0.857,0,5,5,8,2,0,2,4,24,21.8
Tim Hardaway,24-354,G,3/5/17,ATL,IND,0,35,9,16,0.563,5,9,0.556,4,7,0.571,2,2,1,1,3,4,2,1,0,1,2,24,18.6
Kristaps Porzingis,21-148,F-C,12/28/16,NYK,ATL,1,42,7,17,0.412,3,9,0.333,4,8,0.5,6,9,0.667,2,6,8,1,1,3,5,4,24,14.1
Tobias Harris,24-137,F,11/29/16,DET,CHO,1,36,9,12,0.75,6,7,0.857,3,5,0.6,3,3,1,0,7,7,2,1,2,2,1,24,22.7
Devin Booker,20-017,G,11/16/16,PHO,DEN,1,37,10,18,0.556,8,15,0.533,2,3,0.667,2,3,0.667,1,3,4,2,1,0,4,4,24,13.4
Kevin Durant,28-134,F-G,2/10/17,GSW,MEM,1,32,5,14,0.357,2,8,0.25,3,6,0.5,11,14,0.786,0,5,5,4,1,2,3,2,24,17.9
Goran Dragic,30-242,G,1/3/17,MIA,PHO,1,38,9,18,0.5,8,16,0.5,1,2,0.5,5,6,0.833,0,3,3,9,2,0,5,5,24,16.8
James Harden,27-214,G,3/28/17,HOU,GSW,1,38,5,20,0.25,4,11,0.364,1,9,0.111,13,13,1,3,8,11,13,1,0,6,1,24,20.2
John Wall,26-132,G,1/16/17,WAS,POR,1,28,10,17,0.588,8,14,0.571,2,3,0.667,2,2,1,1,3,4,7,2,0,4,0,24,20.6
Andre Iguodala,33-037,G-F,3/6/17,GSW,ATL,0,35,6,8,0.75,2,2,1,4,6,0.667,8,11,0.727,3,2,5,4,3,1,0,2,24,28
Kyle Lowry,30-318,G,2/6/17,TOR,LAC,1,38,6,14,0.429,1,6,0.167,5,8,0.625,7,7,1,0,4,4,8,0,0,2,3,24,20.2
Brook Lopez,28-349,C,3/16/17,BRK,NYK,1,30,9,17,0.529,8,12,0.667,1,5,0.2,5,5,1,1,5,6,3,0,1,3,4,24,16.1
DeMar DeRozan,27-206,G,3/1/17,TOR,WAS,1,34,7,20,0.35,7,20,0.35,0,0,,10,11,0.909,0,3,3,2,1,0,2,3,24,12.5
Stephen Curry,28-256,G,11/25/16,GSW,LAL,1,36,8,17,0.471,4,7,0.571,4,10,0.4,4,4,1,2,3,5,5,3,0,3,1,24,20.7
Isaiah Thomas,27-286,G,11/19/16,BOS,DET,1,36,7,22,0.318,5,14,0.357,2,8,0.25,8,9,0.889,1,3,4,8,0,1,0,1,24,18.5
Tyler Johnson,24-338,G,4/10/17,MIA,CLE,0,34,7,12,0.583,4,6,0.667,3,6,0.5,7,8,0.875,0,5,5,4,0,0,3,5,24,17.3
Gordon Hayward,26-309,F-G,1/26/17,UTA,LAL,1,32,7,14,0.5,6,8,0.75,1,6,0.167,9,10,0.9,0,3,3,2,1,0,3,0,24,16.9
Giannis Antetokounmpo,22-087,F-G,3/3/17,MIL,LAC,1,31,10,13,0.769,10,13,0.769,0,0,,4,5,0.8,0,5,5,8,2,2,1,4,24,26.4
Stephen Curry,28-302,G,1/10/17,GSW,MIA,1,36,8,21,0.381,4,10,0.4,4,11,0.364,4,5,0.8,1,7,8,9,1,1,3,0,24,19.9
DeAndre Jordan,28-177,C,1/14/17,LAC,LAL,1,35,12,13,0.923,12,13,0.923,0,0,,0,1,0,3,18,21,0,1,2,0,2,24,28.4
Enes Kanter,24-171,C,11/7/16,OKC,MIA,0,21,10,12,0.833,10,12,0.833,0,0,,4,4,1,4,6,10,1,0,1,2,2,24,22.8
Kawhi Leonard,25-138,F,11/14/16,SAS,MIA,1,35,7,19,0.368,4,14,0.286,3,5,0.6,7,9,0.778,1,11,12,4,0,0,4,2,24,14.7
Kristaps Porzingis,21-104,F-C,11/14/16,NYK,DAL,1,36,8,16,0.5,6,11,0.545,2,5,0.4,6,6,1,2,9,11,1,0,1,3,3,24,17.3
Eric Gordon,27-362,G,12/21/16,HOU,PHO,0,28,8,17,0.471,1,4,0.25,7,13,0.538,1,2,0.5,0,2,2,3,1,0,0,4,24,17
Jamal Murray,19-273,G,11/22/16,DEN,CHI,0,22,9,13,0.692,6,9,0.667,3,4,0.75,3,3,1,2,4,6,2,0,0,0,2,24,21.7
Jamal Crawford,36-281,G,12/26/16,LAC,DEN,1,36,11,23,0.478,9,18,0.5,2,5,0.4,0,0,,0,4,4,6,2,0,3,3,24,15.5
Stephen Curry,28-312,G,1/20/17,GSW,HOU,1,33,8,18,0.444,3,7,0.429,5,11,0.455,3,5,0.6,0,1,1,7,1,0,1,1,24,18.6
Bradley Beal,23-260,G,3/15/17,WAS,DAL,1,38,9,20,0.45,5,8,0.625,4,12,0.333,2,2,1,0,2,2,5,0,0,2,1,24,15.3
Terrence Ross,26-020,F-G,2/25/17,ORL,ATL,1,35,10,15,0.667,6,8,0.75,4,7,0.571,0,0,,0,4,4,2,2,1,0,2,24,22
Hassan Whiteside,27-303,C,4/12/17,MIA,WAS,1,31,10,17,0.588,10,17,0.588,0,0,,4,6,0.667,5,13,18,0,0,2,1,1,24,22.7
Wilson Chandler,29-318,F,3/24/17,DEN,IND,1,35,10,16,0.625,7,11,0.636,3,5,0.6,1,1,1,3,1,4,2,0,2,1,2,24,20.2
Gary Harris,22-178,G,3/11/17,DEN,SAC,1,36,10,15,0.667,8,10,0.8,2,5,0.4,2,2,1,1,2,3,2,2,1,1,0,24,21.9
DeMar DeRozan,27-124,G,12/9/16,TOR,BOS,1,37,9,25,0.36,9,24,0.375,0,1,0,6,6,1,0,5,5,2,0,0,4,1,24,8.6
Russell Westbrook,28-060,G,1/11/17,OKC,MEM,1,37,6,20,0.3,6,13,0.462,0,7,0,12,15,0.8,1,12,13,12,2,1,6,1,24,20.2
Thaddeus Young,28-155,F,11/23/16,IND,ATL,1,41,10,13,0.769,8,10,0.8,2,3,0.667,2,3,0.667,3,4,7,0,1,1,3,2,24,19.7
Rajon Rondo,31-027,G,3/21/17,CHI,TOR,1,40,9,16,0.563,5,9,0.556,4,7,0.571,2,2,1,1,4,5,8,4,0,4,4,24,22.3
Gary Harris,22-096,G,12/19/16,DEN,DAL,1,34,9,13,0.692,5,7,0.714,4,6,0.667,2,4,0.5,0,2,2,4,2,0,3,4,24,18.5
John Wall,26-212,G,4/6/17,WAS,NYK,1,32,9,15,0.6,5,10,0.5,4,5,0.8,2,6,0.333,0,1,1,8,1,1,2,3,24,19.9
Kemba Walker,26-216,G,12/10/16,CHO,CLE,1,30,9,14,0.643,6,9,0.667,3,5,0.6,3,4,0.75,0,1,1,5,1,0,2,1,24,19.8
James Harden,27-183,G,2/25/17,HOU,MIN,1,35,6,15,0.4,1,4,0.25,5,11,0.455,7,10,0.7,0,5,5,10,2,1,7,1,24,18.5
Richaun Holmes,23-156,F-C,3/20/17,PHI,ORL,1,42,11,19,0.579,10,15,0.667,1,4,0.25,1,1,1,5,9,14,5,1,1,1,6,24,23.1
Robert Covington,26-085,F,3/9/17,PHI,POR,1,40,10,21,0.476,6,13,0.462,4,8,0.5,0,0,,2,11,13,2,2,1,2,4,24,18.5
Zach LaVine,21-282,G,12/17/16,MIN,HOU,1,45,9,18,0.5,6,11,0.545,3,7,0.429,3,5,0.6,0,2,2,6,1,0,8,4,24,10.4
Tobias Harris,24-212,F,2/12/17,DET,TOR,0,31,9,13,0.692,7,9,0.778,2,4,0.5,4,4,1,0,6,6,2,2,1,0,3,24,23.2
Shabazz Muhammad,24-142,F-G,4/4/17,MIN,GSW,0,32,8,18,0.444,7,16,0.438,1,2,0.5,7,9,0.778,8,3,11,1,0,0,0,1,24,20.6
Damian Lillard,26-158,G,12/20/16,POR,SAC,1,39,6,20,0.3,5,11,0.455,1,9,0.111,11,12,0.917,0,4,4,15,0,0,0,1,24,23.3
Wilson Chandler,29-274,F,2/8/17,DEN,ATL,1,36,9,17,0.529,5,10,0.5,4,7,0.571,2,5,0.4,3,5,8,2,2,0,3,6,24,16.1
Brook Lopez,28-250,C,12/7/16,BRK,DEN,1,33,7,17,0.412,5,12,0.417,2,5,0.4,8,10,0.8,3,5,8,4,0,2,2,4,24,18.3
Russell Westbrook,28-124,G,3/16/17,OKC,TOR,1,28,8,17,0.471,4,9,0.444,4,8,0.5,4,4,1,0,10,10,16,1,0,2,2,24,27.7
Andrew Wiggins,22-015,F-G,3/10/17,MIN,GSW,1,37,9,21,0.429,8,20,0.4,1,1,1,5,7,0.714,2,2,4,0,2,0,4,3,24,10.9
Amir Johnson,29-185,F,11/2/16,BOS,CHI,1,30,9,11,0.818,5,7,0.714,4,4,1,1,2,0.5,1,5,6,3,3,2,0,2,23,26.4
Bradley Beal,23-219,G,2/2/17,WAS,LAL,1,34,9,17,0.529,4,8,0.5,5,9,0.556,0,0,,0,1,1,4,2,1,1,4,23,17.9
Devin Booker,20-108,G,2/15/17,PHO,LAL,1,30,9,14,0.643,5,7,0.714,4,7,0.571,1,2,0.5,1,3,4,1,0,1,3,3,23,15.2
Serge Ibaka,27-095,F-C,12/22/16,ORL,NYK,1,32,10,18,0.556,7,11,0.636,3,7,0.429,0,0,,3,7,10,1,0,1,3,2,23,16.2
Andrew Wiggins,21-294,F-G,12/13/16,MIN,CHI,1,39,8,17,0.471,6,13,0.462,2,4,0.5,5,6,0.833,3,6,9,3,1,1,1,3,23,19.4
LeBron James,31-314,F-G,11/8/16,CLE,ATL,1,37,8,17,0.471,6,12,0.5,2,5,0.4,5,5,1,2,7,9,5,3,0,1,3,23,22.1
Draymond Green,27-020,F,3/24/17,GSW,SAC,1,34,8,17,0.471,5,8,0.625,3,9,0.333,4,5,0.8,1,3,4,8,3,1,4,1,23,20.4
Andrew Wiggins,21-340,F-G,1/28/17,MIN,BRK,1,38,9,18,0.5,8,17,0.471,1,1,1,4,5,0.8,2,1,3,4,1,1,2,4,23,16.2
Kentavious Caldwell-Pope,23-318,G,1/1/17,DET,MIA,1,40,9,15,0.6,5,8,0.625,4,7,0.571,1,2,0.5,0,6,6,5,2,0,2,1,23,20.6
Allen Crabbe,24-332,G-F,3/7/17,POR,OKC,0,28,7,10,0.7,2,3,0.667,5,7,0.714,4,4,1,1,3,4,2,0,0,1,3,23,19.6
Blake Griffin,27-326,F,2/5/17,LAC,BOS,1,37,9,19,0.474,9,18,0.5,0,1,0,5,6,0.833,0,8,8,4,1,0,4,2,23,14.3
Gordon Hayward,26-348,F-G,3/6/17,UTA,NOP,1,36,10,20,0.5,8,15,0.533,2,5,0.4,1,2,0.5,0,7,7,2,1,0,3,2,23,13.3
Zach Randolph,35-227,F,2/28/17,MEM,PHO,0,27,10,15,0.667,9,12,0.75,1,3,0.333,2,2,1,3,5,8,2,1,0,2,3,23,19.3
Russell Westbrook,28-146,G,4/7/17,OKC,PHO,1,36,6,25,0.24,4,13,0.308,2,12,0.167,9,9,1,6,6,12,8,0,1,8,5,23,10.2
C.J. Miles,29-296,G-F,2/8/17,IND,CLE,1,35,7,11,0.636,1,2,0.5,6,9,0.667,3,3,1,0,4,4,0,0,1,1,3,23,17.8
DeMar DeRozan,27-161,G,1/15/17,TOR,NYK,1,28,8,17,0.471,8,17,0.471,0,0,,7,7,1,0,5,5,5,0,0,2,2,23,16.5
Frank Kaminsky,23-327,F-C,2/25/17,CHO,SAC,1,38,9,18,0.5,4,9,0.444,5,9,0.556,0,0,,2,11,13,3,2,0,0,4,23,21.2
Bradley Beal,23-253,G,3/8/17,WAS,DEN,1,34,9,15,0.6,4,8,0.5,5,7,0.714,0,0,,1,2,3,5,0,0,1,0,23,19.9
Ryan Anderson,28-185,F,11/7/16,HOU,WAS,1,34,9,15,0.6,4,7,0.571,5,8,0.625,0,0,,3,4,7,2,1,0,2,2,23,19
J.J. Barea,32-131,G,11/4/16,DAL,POR,1,30,7,17,0.412,2,9,0.222,5,8,0.625,4,4,1,0,0,0,6,0,0,3,1,23,14.7
Gordon Hayward,26-297,F-G,1/14/17,UTA,ORL,1,39,7,10,0.7,5,7,0.714,2,3,0.667,7,9,0.778,0,5,5,7,1,0,1,3,23,23.2
Tobias Harris,24-184,F,1/15/17,DET,LAL,1,38,8,18,0.444,6,11,0.545,2,7,0.286,5,5,1,2,5,7,3,0,1,0,1,23,18.9
Brook Lopez,28-350,C,3/17/17,BRK,BOS,1,31,8,18,0.444,6,13,0.462,2,5,0.4,5,6,0.833,1,4,5,4,0,2,2,4,23,15.7
Jimmy Butler,27-185,G-F,3/18/17,CHI,UTA,1,38,8,18,0.444,8,17,0.471,0,1,0,7,7,1,2,2,4,7,3,2,2,1,23,22.5
Stephen Curry,29-006,G,3/20/17,GSW,OKC,1,30,8,17,0.471,1,5,0.2,7,12,0.583,0,0,,0,4,4,6,0,0,5,3,23,13.5
Klay Thompson,26-339,G,1/12/17,GSW,DET,1,36,9,15,0.6,5,10,0.5,4,5,0.8,1,4,0.25,1,2,3,3,2,0,1,3,23,18.1
Carmelo Anthony,32-312,F,4/6/17,NYK,WAS,1,31,7,19,0.368,5,14,0.357,2,5,0.4,7,9,0.778,1,5,6,4,0,0,1,4,23,14.1
Goran Dragic,30-231,G,12/23/16,MIA,NOP,1,34,10,16,0.625,8,12,0.667,2,4,0.5,1,3,0.333,0,4,4,5,0,0,4,1,23,15.3
Goran Dragic,30-302,G,3/4/17,MIA,CLE,1,24,9,12,0.75,5,7,0.714,4,5,0.8,1,2,0.5,1,2,3,5,0,0,2,1,23,20.2
Maurice Harkless,23-169,F-G,10/27/16,POR,LAC,1,32,10,15,0.667,9,12,0.75,1,3,0.333,2,2,1,5,3,8,2,0,0,0,4,23,20.7
Rudy Gay,30-149,F,1/13/17,SAC,CLE,1,35,8,14,0.571,5,11,0.455,3,3,1,4,5,0.8,5,5,10,2,0,4,2,5,23,21.2
DeMar DeRozan,27-166,G,1/20/17,TOR,CHO,1,31,8,17,0.471,6,14,0.429,2,3,0.667,5,6,0.833,0,3,3,2,0,0,4,0,23,12.2
Hassan Whiteside,27-154,C,11/14/16,MIA,SAS,1,34,9,11,0.818,9,11,0.818,0,0,,5,9,0.556,5,11,16,1,2,2,4,3,23,23
T.J. Warren,23-214,F,4/7/17,PHO,OKC,1,33,10,15,0.667,10,14,0.714,0,1,0,3,3,1,4,12,16,0,0,1,0,3,23,22.4
Brook Lopez,28-308,C,2/3/17,BRK,IND,1,31,9,18,0.5,9,17,0.529,0,1,0,5,5,1,2,4,6,1,0,1,3,1,23,14.6
Gordon Hayward,26-348,F-G,3/6/17,UTA,NOP,1,36,10,20,0.5,8,15,0.533,2,5,0.4,1,2,0.5,0,7,7,2,1,0,3,2,23,13.3
Myles Turner,20-308,F-C,1/26/17,IND,MIN,1,36,10,14,0.714,9,12,0.75,1,2,0.5,2,2,1,2,4,6,0,1,2,3,2,23,18.4
Bojan Bogdanovic,27-240,G-F,12/14/16,BRK,LAL,1,29,6,13,0.462,3,6,0.5,3,7,0.429,8,10,0.8,1,3,4,1,1,0,2,3,23,15.6
Dennis Schroder,23-136,G,1/29/17,ATL,NYK,1,55,9,25,0.36,8,21,0.381,1,4,0.25,4,7,0.571,1,3,4,15,0,0,6,2,23,13.2
Klay Thompson,26-318,G,12/22/16,GSW,BRK,1,35,9,24,0.375,4,14,0.286,5,10,0.5,0,0,,0,5,5,2,4,0,2,0,23,14.7
Marquese Chriss,19-264,F,3/23/17,PHO,BRK,1,31,8,15,0.533,5,8,0.625,3,7,0.429,4,6,0.667,4,7,11,0,2,1,1,4,23,19.9
LaMarcus Aldridge,31-127,F-C,11/23/16,SAS,CHO,1,37,8,17,0.471,8,15,0.533,0,2,0,7,8,0.875,3,4,7,2,1,2,1,1,23,19.6
Hassan Whiteside,27-247,C,2/15/17,MIA,HOU,1,31,9,13,0.692,9,13,0.692,0,0,,5,8,0.625,3,11,14,1,0,5,1,4,23,23.3
Joel Embiid,22-296,C-F,1/6/17,PHI,BOS,1,26,6,12,0.5,5,9,0.556,1,3,0.333,10,10,1,0,8,8,3,0,2,4,6,23,16.5
Devin Booker,20-009,G,11/8/16,PHO,POR,1,31,8,18,0.444,6,12,0.5,2,6,0.333,5,5,1,0,0,0,0,1,0,2,3,23,11.4
Lou Williams,30-157,G,4/2/17,HOU,PHO,0,30,7,14,0.5,5,7,0.714,2,7,0.286,7,8,0.875,2,2,4,2,0,0,4,2,23,14.2
Giannis Antetokounmpo,22-022,F-G,12/28/16,MIL,DET,1,35,8,18,0.444,7,15,0.467,1,3,0.333,6,7,0.857,1,4,5,8,2,0,1,2,23,20.9
Bradley Beal,23-219,G,2/2/17,WAS,LAL,1,34,9,17,0.529,4,8,0.5,5,9,0.556,0,0,,0,1,1,4,2,1,1,4,23,17.9
Paul Millsap,31-338,F,1/13/17,ATL,BOS,1,40,8,15,0.533,7,12,0.583,1,3,0.333,6,7,0.857,3,2,5,6,1,1,3,1,23,20.5
Ersan Ilyasova,29-205,F,12/6/16,PHI,MEM,1,40,7,19,0.368,3,6,0.5,4,13,0.308,5,7,0.714,3,14,17,4,1,2,2,5,23,19.2
Kyrie Irving,24-320,G,2/6/17,CLE,WAS,1,44,8,24,0.333,6,17,0.353,2,7,0.286,5,5,1,0,1,1,5,1,0,3,3,23,10
C.J. McCollum,25-040,G,10/29/16,POR,DEN,1,41,10,24,0.417,8,19,0.421,2,5,0.4,1,1,1,3,7,10,3,3,3,2,4,23,18
Terrence Ross,26-052,F-G,3/29/17,ORL,OKC,1,45,9,17,0.529,4,6,0.667,5,11,0.455,0,0,,0,1,1,2,1,1,3,2,23,14.3
Eric Gordon,27-342,G,12/1/16,HOU,GSW,0,39,9,19,0.474,5,10,0.5,4,9,0.444,1,1,1,0,1,1,5,1,0,3,3,23,13.9
Hassan Whiteside,27-301,C,4/10/17,MIA,CLE,1,36,8,14,0.571,8,14,0.571,0,0,,7,12,0.583,4,14,18,1,1,1,2,4,23,20.2
Solomon Hill,25-334,F,2/15/17,NOP,MEM,1,37,8,11,0.727,4,5,0.8,4,6,0.667,3,4,0.75,0,5,5,1,2,0,0,2,23,21.5
Klay Thompson,27-053,G,4/2/17,GSW,WAS,1,33,9,20,0.45,5,10,0.5,4,10,0.4,1,1,1,0,1,1,3,1,1,2,2,23,13.9
Harrison Barnes,24-181,F,11/27/16,DAL,NOP,1,41,9,24,0.375,8,20,0.4,1,4,0.25,4,4,1,0,7,7,4,2,0,1,2,23,14.9
Victor Oladipo,24-281,G,2/9/17,OKC,CLE,1,36,9,17,0.529,7,11,0.636,2,6,0.333,3,4,0.75,0,7,7,3,2,0,0,2,23,19.7
C.J. Miles,29-203,G-F,11/7/16,IND,CHO,0,25,8,15,0.533,3,4,0.75,5,11,0.455,2,2,1,1,3,4,0,1,0,2,1,23,15.9
Julius Randle,22-115,F,3/24/17,LAL,MIN,1,34,8,14,0.571,6,10,0.6,2,4,0.5,5,6,0.833,3,9,12,3,1,2,4,4,23,19.7
Mike Conley,29-120,G,2/8/17,MEM,PHO,1,31,7,10,0.7,3,5,0.6,4,5,0.8,5,5,1,0,0,0,5,2,0,4,3,23,19.1
Ersan Ilyasova,29-207,F,12/8/16,PHI,NOP,1,32,9,16,0.563,7,10,0.7,2,6,0.333,3,4,0.75,2,6,8,4,1,0,1,2,23,20.2
Klay Thompson,26-292,G,11/26/16,GSW,MIN,1,38,9,17,0.529,5,8,0.625,4,9,0.444,1,2,0.5,1,5,6,2,1,0,2,1,23,16.5
Stephen Curry,28-359,G,3/8/17,GSW,BOS,1,35,8,16,0.5,6,7,0.857,2,9,0.222,5,5,1,3,2,5,6,0,1,4,4,23,17
Jusuf Nurkic,22-064,C,10/26/16,DEN,NOP,1,26,9,13,0.692,9,13,0.692,0,0,,5,6,0.833,2,7,9,3,0,1,1,3,23,21.2
James Harden,27-129,G,1/2/17,HOU,WAS,1,42,6,24,0.25,4,13,0.308,2,11,0.182,9,10,0.9,1,9,10,10,3,0,6,1,23,15.2
Will Barton,25-355,G,12/26/16,DEN,LAC,0,32,8,14,0.571,5,8,0.625,3,6,0.5,4,5,0.8,0,8,8,6,0,0,0,4,23,21
LaMarcus Aldridge,31-122,F-C,11/18/16,SAS,LAL,1,36,10,14,0.714,9,13,0.692,1,1,1,2,2,1,0,6,6,2,2,3,2,2,23,21.7
Kawhi Leonard,25-212,F,1/27/17,SAS,NOP,1,30,6,16,0.375,4,10,0.4,2,6,0.333,9,9,1,1,5,6,6,1,0,4,2,23,16.8
Langston Galloway,24-346,G,11/19/16,NOP,CHO,0,31,7,14,0.5,1,3,0.333,6,11,0.545,3,3,1,1,6,7,0,2,0,3,1,23,17.1
Klay Thompson,27-049,G,3/29/17,GSW,SAS,1,35,9,16,0.563,5,7,0.714,4,9,0.444,1,1,1,0,2,2,0,0,1,0,2,23,15.9
Dwyane Wade,35-055,G,3/13/17,CHI,CHO,1,32,8,15,0.533,8,13,0.615,0,2,0,7,8,0.875,0,1,1,5,2,1,1,3,23,19.6
Kyle Lowry,30-270,G,12/20/16,TOR,BRK,1,34,8,12,0.667,5,7,0.714,3,5,0.6,4,5,0.8,1,3,4,8,3,1,3,2,23,24.5
Jimmy Butler,27-180,G-F,3/13/17,CHI,CHO,1,38,8,15,0.533,6,10,0.6,2,5,0.4,5,6,0.833,1,5,6,11,2,2,2,1,23,26.2
Courtney Lee,31-114,G,1/25/17,NYK,DAL,1,38,9,13,0.692,7,8,0.875,2,5,0.4,3,3,1,2,4,6,1,0,1,1,2,23,19.7
Isaiah Thomas,27-269,G,11/2/16,BOS,CHI,1,36,8,18,0.444,4,11,0.364,4,7,0.571,3,4,0.75,1,1,2,10,3,1,3,3,23,20.7
Cody Zeller,24-044,F-C,11/18/16,CHO,ATL,1,31,9,10,0.9,9,10,0.9,0,0,,5,7,0.714,2,1,3,1,2,3,3,5,23,20.3
Deron Williams,32-178,G,12/21/16,DAL,POR,1,32,10,17,0.588,8,10,0.8,2,7,0.286,1,1,1,2,3,5,5,0,0,4,2,23,16.1
Maurice Harkless,23-203,F-G,11/30/16,POR,IND,1,29,9,14,0.643,6,8,0.75,3,6,0.5,2,2,1,2,0,2,0,2,0,0,3,23,19
George Hill,30-205,G,11/25/16,UTA,ATL,1,28,8,14,0.571,3,6,0.5,5,8,0.625,2,2,1,0,5,5,1,2,0,0,1,23,20.2
Seth Curry,26-090,G,11/21/16,DAL,SAS,1,36,9,16,0.563,4,6,0.667,5,10,0.5,0,1,0,0,2,2,4,1,0,4,3,23,14.2
Jamal Murray,19-274,G,11/23/16,DEN,UTA,0,35,8,19,0.421,3,11,0.273,5,8,0.625,2,2,1,2,2,4,3,0,1,4,2,23,12.9
LeBron James,31-349,F-G,12/13/16,CLE,MEM,1,36,9,17,0.529,9,13,0.692,0,4,0,5,8,0.625,1,5,6,8,3,0,6,1,23,17.9
Trevor Booker,29-127,F,4/1/17,BRK,ORL,0,24,11,12,0.917,10,10,1,1,2,0.5,0,0,,2,6,8,1,1,0,1,1,23,22.5
Victor Oladipo,24-256,G,1/15/17,OKC,SAC,1,40,7,14,0.5,6,7,0.857,1,7,0.143,8,8,1,0,1,1,2,2,1,2,3,23,17.2
Harrison Barnes,24-240,F,1/25/17,DAL,NYK,1,37,8,15,0.533,8,13,0.615,0,2,0,7,7,1,1,4,5,1,2,0,2,0,23,18.3
D'Angelo Russell,21-005,G,2/28/17,LAL,CHO,1,36,8,17,0.471,3,9,0.333,5,8,0.625,2,2,1,0,1,1,9,2,0,3,3,23,18.7
Gordon Hayward,26-350,F-G,3/8/17,UTA,HOU,1,37,8,14,0.571,5,8,0.625,3,6,0.5,4,4,1,0,7,7,4,0,1,0,2,23,21.2
Hassan Whiteside,27-188,C,12/18/16,MIA,BOS,1,38,9,13,0.692,9,13,0.692,0,0,,5,9,0.556,2,15,17,0,0,3,3,3,23,19.7
Dirk Nowitzki,38-283,F,3/29/17,DAL,NOP,1,31,7,14,0.5,5,12,0.417,2,2,1,7,7,1,1,6,7,2,0,1,0,3,23,19.4
Kemba Walker,26-335,G,4/8/17,CHO,BOS,1,36,7,19,0.368,5,9,0.556,2,10,0.2,7,7,1,0,1,1,8,1,0,0,1,23,19
Isaiah Thomas,27-276,G,11/9/16,BOS,WAS,1,35,6,18,0.333,5,12,0.417,1,6,0.167,10,10,1,3,3,6,10,0,0,3,4,23,18.2
Marreese Speights,29-165,C-F,1/16/17,LAC,OKC,0,27,8,15,0.533,5,8,0.625,3,7,0.429,4,4,1,2,8,10,3,1,0,2,4,23,19
Blake Griffin,28-002,F,3/18/17,LAC,CLE,1,31,10,17,0.588,9,15,0.6,1,2,0.5,2,4,0.5,1,7,8,4,0,0,0,1,23,19.5
J.J. Redick,32-160,G,12/1/16,LAC,CLE,1,25,9,13,0.692,5,7,0.714,4,6,0.667,1,2,0.5,0,2,2,1,0,0,2,1,23,16
Robert Covington,25-331,F,11/9/16,PHI,IND,1,33,8,16,0.5,3,7,0.429,5,9,0.556,2,2,1,3,3,6,1,2,0,0,1,23,20.3
Tyler Johnson,24-293,G,2/24/17,MIA,ATL,0,26,9,11,0.818,6,7,0.857,3,4,0.75,2,2,1,1,4,5,5,1,0,0,2,23,24.5
Paul George,26-339,F,4/6/17,IND,MIL,1,35,9,14,0.643,7,8,0.875,2,6,0.333,3,4,0.75,1,9,10,1,4,0,4,3,23,19.3
John Wall,26-155,G,2/8/17,WAS,BRK,1,46,7,24,0.292,6,20,0.3,1,4,0.25,8,10,0.8,1,5,6,12,1,2,3,2,23,17.4
Seth Curry,26-212,G,3/23/17,DAL,LAC,1,35,9,14,0.643,6,8,0.75,3,6,0.5,2,2,1,0,3,3,4,0,0,3,0,23,17.5
Nick Young,31-244,G-F,1/31/17,LAL,DEN,1,30,9,15,0.6,4,7,0.571,5,8,0.625,0,1,0,0,3,3,3,1,0,1,2,23,17.9
Marc Gasol,31-341,C,1/4/17,MEM,LAC,1,36,9,16,0.563,7,12,0.583,2,4,0.5,3,3,1,1,3,4,6,2,1,2,2,23,21.1
Doug McDermott,24-300,F,10/29/16,CHI,IND,0,27,9,14,0.643,4,8,0.5,5,6,0.833,0,0,,0,4,4,3,1,1,1,2,23,20
DeMar DeRozan,27-151,G,1/5/17,TOR,UTA,1,37,8,26,0.308,8,25,0.32,0,1,0,7,10,0.7,2,5,7,2,2,1,1,2,23,12
Kyrie Irving,25-002,G,3/25/17,CLE,WAS,1,34,8,23,0.348,7,16,0.438,1,7,0.143,6,7,0.857,1,1,2,4,1,2,2,3,23,12.7
Tyler Johnson,24-314,G,3/17/17,MIA,MIN,0,32,9,13,0.692,7,8,0.875,2,5,0.4,3,3,1,1,1,2,3,0,2,4,1,23,17.6
Sean Kilpatrick,26-355,G,12/26/16,BRK,CHO,1,32,9,15,0.6,5,8,0.625,4,7,0.571,1,2,0.5,0,5,5,4,0,0,2,3,23,16.8
Tim Hardaway,25-021,G,4/6/17,ATL,BOS,1,40,10,17,0.588,8,14,0.571,2,3,0.667,1,3,0.333,1,4,5,5,1,0,3,5,23,15.7
Hassan Whiteside,27-281,C,3/21/17,MIA,PHO,1,31,9,18,0.5,9,18,0.5,0,0,,5,6,0.833,4,10,14,1,3,2,2,4,23,20.9
Elfrid Payton,22-335,G,1/22/17,ORL,GSW,1,39,11,19,0.579,10,17,0.588,1,2,0.5,0,0,,0,4,4,10,1,0,2,4,23,19.7
Dion Waiters,25-067,G,2/15/17,MIA,HOU,1,37,8,17,0.471,4,8,0.5,4,9,0.444,3,4,0.75,1,9,10,7,0,0,1,3,23,20
Devin Booker,20-090,G,1/28/17,PHO,DEN,1,35,8,16,0.5,8,14,0.571,0,2,0,7,11,0.636,1,3,4,2,1,1,3,5,23,13.1
Sean Kilpatrick,26-322,G,11/23/16,BRK,BOS,0,32,8,17,0.471,7,13,0.538,1,4,0.25,6,8,0.75,0,2,2,3,0,3,3,1,23,14.9
Dwyane Wade,35-038,G,2/24/17,CHI,PHO,1,33,8,17,0.471,8,16,0.5,0,1,0,7,8,0.875,2,2,4,3,2,2,2,5,23,17.4
Harrison Barnes,24-299,F,3/25/17,DAL,TOR,1,37,8,17,0.471,8,15,0.533,0,2,0,7,7,1,1,6,7,2,3,0,0,0,23,21.2
Bojan Bogdanovic,27-277,G-F,1/20/17,BRK,NOP,1,27,6,13,0.462,4,8,0.5,2,5,0.4,9,9,1,1,5,6,2,1,1,2,1,23,19.2
DeAndre Jordan,28-251,C,3/29/17,LAC,WAS,1,38,8,9,0.889,8,9,0.889,0,0,,7,12,0.583,5,13,18,1,1,2,2,4,23,24.8
Zach LaVine,21-322,G,1/26/17,MIN,IND,1,42,7,17,0.412,4,8,0.5,3,9,0.333,6,7,0.857,0,3,3,5,1,1,2,3,23,16.4
Eric Bledsoe,27-043,G,1/21/17,PHO,NYK,1,39,6,14,0.429,5,10,0.5,1,4,0.25,10,10,1,1,4,5,7,0,1,0,0,23,23.1
Stephen Curry,28-353,G,3/2/17,GSW,CHI,1,35,10,27,0.37,8,16,0.5,2,11,0.182,1,1,1,1,5,6,5,5,0,4,4,23,13.2
Patty Mills,28-134,G,12/23/16,SAS,POR,0,28,7,9,0.778,2,2,1,5,7,0.714,4,5,0.8,0,3,3,5,2,0,3,2,23,21.7
Bradley Beal,23-253,G,3/8/17,WAS,DEN,1,34,9,15,0.6,4,8,0.5,5,7,0.714,0,0,,1,2,3,5,0,0,1,0,23,19.9
Jrue Holiday,26-182,G,12/11/16,NOP,PHO,1,40,7,18,0.389,5,10,0.5,2,8,0.25,7,9,0.778,2,1,3,3,2,0,2,5,23,14.2
Elfrid Payton,22-265,G,11/13/16,ORL,OKC,1,37,10,19,0.526,7,12,0.583,3,7,0.429,0,2,0,0,7,7,9,2,1,0,3,23,22.8
Carmelo Anthony,32-310,F,4/4/17,NYK,CHI,1,37,9,25,0.36,7,17,0.412,2,8,0.25,3,4,0.75,1,7,8,2,0,0,3,4,23,8.3
Michael Beasley,28-035,F,2/13/17,MIL,DET,1,32,10,13,0.769,10,12,0.833,0,1,0,3,3,1,0,3,3,4,3,1,0,1,23,24.9
Allen Crabbe,24-293,G-F,1/27/17,POR,MEM,0,29,8,12,0.667,2,4,0.5,6,8,0.75,1,1,1,0,2,2,0,0,0,0,4,23,16.8
Zach LaVine,21-284,G,12/19/16,MIN,PHO,1,36,7,16,0.438,3,8,0.375,4,8,0.5,5,5,1,2,2,4,3,1,1,2,2,23,17.6
Justise Winslow,20-271,F,12/22/16,MIA,LAL,1,42,10,16,0.625,10,15,0.667,0,1,0,3,6,0.5,3,10,13,3,4,0,3,1,23,22.4
Eric Bledsoe,27-063,G,2/10/17,PHO,CHI,1,33,9,19,0.474,8,16,0.5,1,3,0.333,4,5,0.8,0,3,3,8,0,1,4,0,23,16.1
Zach LaVine,21-267,G,12/2/16,MIN,NYK,1,40,9,18,0.5,7,11,0.636,2,7,0.286,3,3,1,0,2,2,3,1,0,2,3,23,14.5
Victor Oladipo,24-316,G,3/16/17,OKC,TOR,1,28,9,15,0.6,6,12,0.5,3,3,1,2,3,0.667,2,3,5,2,0,0,2,0,23,17.4
John Wall,26-173,G,2/26/17,WAS,UTA,1,37,9,18,0.5,7,14,0.5,2,4,0.5,3,5,0.6,0,3,3,11,4,0,9,2,23,16
Dario Saric,22-354,F,3/28/17,PHI,BRK,1,37,8,15,0.533,7,12,0.583,1,3,0.333,6,7,0.857,1,6,7,1,0,1,3,2,23,15.4
Robert Covington,26-047,F,1/30/17,PHI,SAC,1,36,8,16,0.5,4,5,0.8,4,11,0.364,3,3,1,1,9,10,2,4,0,2,3,23,20.6
Paul Millsap,31-303,F,12/9/16,ATL,MIL,1,39,8,15,0.533,7,11,0.636,1,4,0.25,6,8,0.75,3,11,14,6,1,3,1,1,23,26.2
Jamal Crawford,36-322,G,2/5/17,LAC,BOS,0,33,8,18,0.444,5,9,0.556,3,9,0.333,4,4,1,0,2,2,5,3,0,1,0,23,19.7
Nikola Jokic,22-047,C-F,4/7/17,DEN,NOP,1,29,9,13,0.692,7,11,0.636,2,2,1,3,4,0.75,3,9,12,5,2,0,7,1,23,20
Tim Hardaway,24-303,G,1/13/17,ATL,BOS,0,29,9,17,0.529,6,10,0.6,3,7,0.429,2,3,0.667,1,1,2,2,3,1,1,2,23,18.6
Kevin Love,28-150,F,2/4/17,CLE,NYK,1,35,7,16,0.438,3,9,0.333,4,7,0.571,5,6,0.833,5,11,16,1,1,0,5,1,23,17.3
Al-Farouq Aminu,26-164,F,3/4/17,POR,BRK,0,32,9,13,0.692,4,7,0.571,5,6,0.833,0,0,,1,5,6,1,0,0,2,1,23,18
Marc Gasol,32-028,C,2/26/17,MEM,DEN,1,38,9,17,0.529,6,11,0.545,3,6,0.5,2,2,1,1,4,5,6,0,1,4,0,23,17.5
Dirk Nowitzki,38-273,F,3/19/17,DAL,BRK,1,27,9,17,0.529,6,11,0.545,3,6,0.5,2,3,0.667,0,9,9,0,0,0,0,4,23,15.4
Markieff Morris,27-143,F,1/23/17,WAS,CHO,1,41,8,13,0.615,6,9,0.667,2,4,0.5,5,5,1,0,8,8,2,0,0,2,5,23,16.9
Karl-Anthony Towns,21-115,C-F,3/10/17,MIN,GSW,1,38,10,18,0.556,8,14,0.571,2,4,0.5,1,3,0.333,2,7,9,2,0,2,3,4,23,15.3
Jodie Meeks,29-134,G,1/2/17,ORL,NYK,1,32,7,9,0.778,1,2,0.5,6,7,0.857,3,3,1,0,2,2,2,0,1,3,1,23,18.8
Michael Kidd-Gilchrist,23-030,F,10/26/16,CHO,MIL,1,35,10,18,0.556,10,16,0.625,0,2,0,3,3,1,4,10,14,0,1,1,0,1,23,21.5
Brook Lopez,28-294,C,1/20/17,BRK,NOP,1,24,8,15,0.533,7,11,0.636,1,4,0.25,6,6,1,2,6,8,3,0,3,1,2,23,21.3
LeBron James,31-304,F-G,10/29/16,CLE,ORL,1,39,7,16,0.438,5,10,0.5,2,6,0.333,7,11,0.636,1,5,6,9,1,1,2,2,23,20.4
Harrison Barnes,24-285,F,3/11/17,DAL,PHO,1,36,5,16,0.313,5,15,0.333,0,1,0,13,14,0.929,3,4,7,1,0,0,1,1,23,16
Isaiah Thomas,27-315,G,12/18/16,BOS,MIA,1,28,9,16,0.563,6,10,0.6,3,6,0.5,2,2,1,1,1,2,4,1,0,2,1,23,17.8
Giannis Antetokounmpo,22-059,F-G,2/3/17,MIL,DEN,1,35,9,13,0.692,8,10,0.8,1,3,0.333,4,4,1,0,8,8,5,2,2,5,5,23,19.8
Tobias Harris,24-166,F,12/28/16,DET,MIL,0,31,9,15,0.6,7,10,0.7,2,5,0.4,3,3,1,1,11,12,2,0,0,2,0,23,19.5
Rudy Gay,30-095,F,11/20/16,SAC,TOR,1,36,9,13,0.692,8,12,0.667,1,1,1,4,4,1,0,9,9,4,1,3,4,3,23,20.9
Enes Kanter,24-225,C,12/31/16,OKC,LAC,0,25,6,13,0.462,6,13,0.462,0,0,,11,12,0.917,2,6,8,0,1,1,2,3,23,17.6
Dion Waiters,25-065,G,2/13/17,MIA,ORL,1,34,10,19,0.526,9,14,0.643,1,5,0.2,2,3,0.667,0,2,2,6,2,0,6,4,23,12.5
Trevor Ariza,31-199,F,1/15/17,HOU,BRK,1,33,7,11,0.636,1,1,1,6,10,0.6,3,3,1,2,6,8,2,2,0,0,1,23,24.3
Avery Bradley,26-033,G,12/29/16,BOS,CLE,1,30,10,21,0.476,7,11,0.636,3,10,0.3,0,0,,0,3,3,0,4,0,4,3,23,12
Jabari Parker,21-265,F,12/5/16,MIL,SAS,1,34,6,14,0.429,5,11,0.455,1,3,0.333,10,10,1,3,5,8,3,1,1,2,0,23,21
Karl-Anthony Towns,21-076,C-F,1/30/17,MIN,ORL,1,45,8,18,0.444,7,16,0.438,1,2,0.5,6,7,0.857,2,10,12,7,0,3,5,3,23,18.4
Dwight Howard,30-365,C,12/7/16,ATL,MIA,1,35,9,11,0.818,9,11,0.818,0,0,,5,6,0.833,7,10,17,4,1,2,1,2,23,29.8
Andrew Wiggins,21-306,F-G,12/25/16,MIN,OKC,1,36,10,20,0.5,10,18,0.556,0,2,0,3,8,0.375,1,2,3,2,2,0,1,0,23,14.7
Giannis Antetokounmpo,22-041,F-G,1/16/17,MIL,PHI,1,29,10,19,0.526,10,18,0.556,0,1,0,3,5,0.6,2,4,6,2,2,3,3,6,23,15.6
Kyrie Irving,24-337,G,2/23/17,CLE,NYK,1,30,9,16,0.563,8,12,0.667,1,4,0.25,4,5,0.8,1,2,3,6,1,1,2,1,23,19.8
Danilo Gallinari,28-140,F,12/26/16,DEN,LAC,1,37,5,12,0.417,3,7,0.429,2,5,0.4,11,12,0.917,2,9,11,1,3,0,2,0,23,22
Dennis Schroder,23-172,G,3/6/17,ATL,GSW,1,24,9,17,0.529,5,10,0.5,4,7,0.571,1,1,1,1,3,4,3,1,0,1,1,23,18
Goran Dragic,30-267,G,1/28/17,MIA,DET,1,33,8,14,0.571,6,12,0.5,2,2,1,5,7,0.714,0,2,2,4,1,0,2,4,23,16.4
Rudy Gay,30-144,F,1/8/17,SAC,GSW,1,35,9,17,0.529,7,11,0.636,2,6,0.333,3,4,0.75,0,1,1,3,2,2,4,3,23,14.9
Taj Gibson,31-161,F,12/2/16,CHI,CLE,1,40,10,13,0.769,10,13,0.769,0,0,,3,3,1,2,9,11,5,1,0,1,3,23,24.3
J.R. Smith,31-095,G-F,12/13/16,CLE,MEM,1,34,8,17,0.471,2,7,0.286,6,10,0.6,1,2,0.5,2,3,5,2,0,1,1,0,23,17.3
T.J. Warren,23-114,F,12/28/16,PHO,SAS,0,34,6,12,0.5,5,10,0.5,1,2,0.5,10,10,1,3,3,6,1,1,1,2,3,23,19.2
Kentavious Caldwell-Pope,23-288,G,12/2/16,DET,ATL,1,30,9,20,0.45,4,12,0.333,5,8,0.625,0,0,,3,5,8,0,1,0,0,1,23,16.8
Tobias Harris,24-110,F,11/2/16,DET,BRK,1,36,8,14,0.571,6,10,0.6,2,4,0.5,5,7,0.714,1,3,4,1,1,1,2,2,23,16.8
Joel Embiid,22-289,C-F,12/30/16,PHI,DEN,1,29,5,13,0.385,4,8,0.5,1,5,0.2,12,14,0.857,3,3,6,5,2,3,5,6,23,18.3
Avery Bradley,26-031,G,12/27/16,BOS,MEM,1,34,10,17,0.588,9,14,0.643,1,3,0.333,2,3,0.667,2,5,7,4,2,1,1,4,23,20.5
George Hill,30-177,G,10/28/16,UTA,LAL,1,35,7,14,0.5,5,7,0.714,2,7,0.286,7,9,0.778,0,3,3,3,0,1,1,4,23,16.3
Ian Clark,25-285,G,12/17/16,GSW,POR,0,21,9,11,0.818,6,7,0.857,3,4,0.75,2,2,1,0,2,2,4,1,0,0,1,23,22.9
John Wall,26-106,G,12/21/16,WAS,CHI,1,36,9,14,0.643,9,12,0.75,0,2,0,5,7,0.714,0,6,6,9,3,0,2,2,23,24.3
Emmanuel Mudiay,20-248,G,11/8/16,DEN,MEM,1,36,7,13,0.538,6,10,0.6,1,3,0.333,8,10,0.8,0,4,4,7,0,0,7,4,23,13.4
Eric Bledsoe,26-352,G,11/25/16,PHO,MIN,1,34,8,15,0.533,6,10,0.6,2,5,0.4,5,7,0.714,2,4,6,10,3,0,7,4,23,18.9
Julius Randle,22-091,F,2/28/17,LAL,CHO,1,34,10,14,0.714,10,13,0.769,0,1,0,3,3,1,4,15,19,6,3,2,1,2,23,31.3
Jimmy Butler,27-049,G-F,11/2/16,CHI,BOS,1,36,8,21,0.381,6,16,0.375,2,5,0.4,5,5,1,2,7,9,2,0,0,2,5,23,12.4
LeBron James,31-365,F-G,12/29/16,CLE,BOS,1,44,9,18,0.5,7,12,0.583,2,6,0.333,3,7,0.429,2,6,8,11,1,3,8,2,23,17.6
Marc Gasol,31-343,C,1/6/17,MEM,GSW,1,41,9,18,0.5,9,16,0.563,0,2,0,5,5,1,1,4,5,3,1,0,0,3,23,17.8
Jordan Clarkson,24-158,G,11/12/16,LAL,NOP,0,25,8,12,0.667,4,6,0.667,4,6,0.667,3,3,1,0,3,3,1,1,0,3,0,23,17.4
Evan Fournier,24-045,G-F,12/13/16,ORL,ATL,1,33,11,15,0.733,10,11,0.909,1,4,0.25,0,1,0,0,0,0,6,2,1,0,2,23,22.6
Kyrie Irving,24-261,G,12/9/16,CLE,MIA,1,33,9,15,0.6,7,11,0.636,2,4,0.5,3,5,0.6,0,1,1,3,0,0,2,0,23,15.7
Paul Millsap,31-364,F,2/8/17,ATL,DEN,1,38,9,15,0.6,7,10,0.7,2,5,0.4,3,3,1,1,5,6,5,0,1,0,2,23,21.7
Mike Conley,29-144,G,3/4/17,MEM,HOU,1,39,8,17,0.471,6,11,0.545,2,6,0.333,5,5,1,0,6,6,7,2,1,3,4,23,19.1
Jabari Parker,21-246,F,11/16/16,MIL,ATL,1,35,10,20,0.5,10,19,0.526,0,1,0,3,3,1,2,6,8,3,3,0,1,4,23,18.7
T.J. Warren,23-174,F,2/26/17,PHO,MIL,1,39,11,14,0.786,10,13,0.769,1,1,1,0,0,,0,5,5,1,1,0,1,3,23,18.6
Jrue Holiday,26-192,G,12/21/16,NOP,OKC,1,35,9,15,0.6,7,12,0.583,2,3,0.667,3,4,0.75,1,3,4,10,1,0,3,3,23,21.1
Klay Thompson,27-041,G,3/21/17,GSW,DAL,1,32,9,15,0.6,4,7,0.571,5,8,0.625,0,0,,0,3,3,3,3,0,2,1,23,19.7
Kawhi Leonard,25-142,F,11/18/16,SAS,LAL,1,39,7,15,0.467,5,8,0.625,2,7,0.286,7,8,0.875,1,11,12,7,2,0,3,0,23,22.8
Paul George,26-185,F,11/3/16,IND,MIL,1,37,9,20,0.45,5,12,0.417,4,8,0.5,1,3,0.333,1,4,5,1,1,3,6,3,23,10.3
Gary Harris,22-202,G,4/4/17,DEN,NOP,1,41,10,12,0.833,8,10,0.8,2,2,1,1,2,0.5,3,5,8,5,2,0,3,3,23,23.1
Wilson Chandler,29-269,F,2/3/17,DEN,MIL,1,41,5,14,0.357,5,9,0.556,0,5,0,13,17,0.765,3,5,8,3,2,4,2,4,23,20.5
Kawhi Leonard,25-156,F,12/2/16,SAS,WAS,1,34,9,18,0.5,7,14,0.5,2,4,0.5,3,3,1,1,4,5,2,2,0,1,1,23,17.9
Evan Fournier,24-161,G-F,4/8/17,ORL,IND,1,37,6,10,0.6,2,4,0.5,4,6,0.667,7,8,0.875,0,2,2,2,0,0,0,2,23,19.2
Gordon Hayward,26-350,F-G,3/8/17,UTA,HOU,1,37,8,14,0.571,5,8,0.625,3,6,0.5,4,4,1,0,7,7,4,0,1,0,2,23,21.2
Jeff Teague,28-192,G,12/19/16,IND,WAS,1,39,8,19,0.421,8,17,0.471,0,2,0,7,7,1,1,3,4,10,3,0,2,0,23,22.5
Bojan Bogdanovic,27-270,G-F,1/13/17,BRK,TOR,1,28,9,16,0.563,4,8,0.5,5,8,0.625,0,0,,0,4,4,2,0,0,4,2,23,13.2
Otto Porter,23-152,F,11/2/16,WAS,TOR,1,38,11,13,0.846,11,12,0.917,0,1,0,1,1,1,4,9,13,0,1,0,2,3,23,21.6
Jabari Parker,21-307,F,1/16/17,MIL,PHI,1,35,9,17,0.529,7,13,0.538,2,4,0.5,3,5,0.6,0,5,5,1,2,0,2,3,23,14.9
C.J. McCollum,25-171,G,3/9/17,POR,PHI,1,42,8,16,0.5,5,11,0.455,3,5,0.6,4,4,1,0,4,4,3,0,0,1,2,23,16.5
Andrew Wiggins,21-347,F-G,2/4/17,MIN,MEM,1,37,9,22,0.409,8,18,0.444,1,4,0.25,4,7,0.571,2,0,2,5,1,1,1,4,23,14
Marcus Morris,27-061,F,11/2/16,DET,BRK,1,32,8,16,0.5,5,11,0.455,3,5,0.6,4,5,0.8,1,3,4,2,3,0,0,3,23,19.4
Dwight Howard,30-351,C,11/23/16,ATL,IND,1,33,10,12,0.833,10,12,0.833,0,0,,3,5,0.6,9,12,21,1,0,0,3,2,23,24.6
Jimmy Butler,27-129,G-F,1/21/17,CHI,SAC,1,39,6,14,0.429,5,11,0.455,1,3,0.333,10,10,1,0,5,5,7,0,0,2,1,23,19.6
Tyler Johnson,24-242,G,1/4/17,MIA,SAC,0,30,7,11,0.636,5,7,0.714,2,4,0.5,7,9,0.778,3,3,6,2,1,2,2,1,23,21.7
Darren Collison,29-216,G,3/27/17,SAC,MEM,1,37,8,13,0.615,7,11,0.636,1,2,0.5,6,7,0.857,1,3,4,7,0,0,2,3,23,20
Avery Bradley,26-011,G,12/7/16,BOS,ORL,1,33,7,14,0.5,4,9,0.444,3,5,0.6,6,7,0.857,0,4,4,3,1,1,1,1,23,19.2
Wesley Matthews,30-116,G,2/7/17,DAL,POR,1,39,9,17,0.529,6,10,0.6,3,7,0.429,2,2,1,1,1,2,5,1,0,1,4,23,17.6
Enes Kanter,24-310,C,3/26/17,OKC,HOU,0,23,9,12,0.75,9,12,0.75,0,0,,5,5,1,3,1,4,2,1,0,1,3,23,20.8
Carmelo Anthony,32-228,F,1/12/17,NYK,CHI,1,34,10,19,0.526,8,13,0.615,2,6,0.333,1,2,0.5,1,8,9,6,0,1,1,3,23,19.1
Myles Turner,21-015,F-C,4/8/17,IND,ORL,1,30,10,13,0.769,9,12,0.75,1,1,1,2,3,0.667,2,8,10,1,0,2,2,2,23,20.6
Devin Booker,20-130,G,3/9/17,PHO,LAL,1,38,10,21,0.476,9,17,0.529,1,4,0.25,2,2,1,1,5,6,3,0,0,3,2,23,12.8
Isaiah Thomas,27-290,G,11/23/16,BOS,BRK,1,32,8,21,0.381,3,12,0.25,5,9,0.556,2,2,1,0,1,1,5,0,1,2,1,23,13.6
Kentavious Caldwell-Pope,24-029,G,3/19/17,DET,PHO,1,33,8,14,0.571,3,5,0.6,5,9,0.556,2,2,1,0,3,3,8,0,0,1,0,23,21.9
James Harden,27-091,G,11/25/16,HOU,SAC,1,40,6,18,0.333,3,7,0.429,3,11,0.273,8,8,1,1,8,9,10,0,0,5,2,23,17.1
Dario Saric,22-345,F,3/19/17,PHI,BOS,1,32,10,20,0.5,8,16,0.5,2,4,0.5,1,1,1,0,6,6,4,2,0,1,3,23,17.4
Anthony Davis,23-294,F-C,12/30/16,NOP,NYK,1,34,9,18,0.5,9,18,0.5,0,0,,5,6,0.833,1,17,18,2,2,0,5,3,23,16.6
Hassan Whiteside,27-176,C,12/6/16,MIA,NYK,1,38,10,20,0.5,10,20,0.5,0,0,,3,9,0.333,5,9,14,1,1,3,0,3,23,19.4
Mike Conley,29-109,G,1/28/17,MEM,UTA,1,28,9,14,0.643,6,7,0.857,3,7,0.429,2,2,1,0,3,3,3,2,0,0,2,23,21
LaMarcus Aldridge,31-247,F-C,3/23/17,SAS,MEM,1,36,10,16,0.625,9,14,0.643,1,2,0.5,2,2,1,0,7,7,1,0,3,0,3,23,19.5
George Hill,30-186,G,11/6/16,UTA,NYK,1,35,8,12,0.667,7,9,0.778,1,3,0.333,6,7,0.857,0,2,2,8,2,0,0,1,23,25.2
C.J. McCollum,25-087,G,12/15/16,POR,DEN,1,35,8,17,0.471,7,13,0.538,1,4,0.25,6,6,1,0,3,3,4,0,2,1,4,23,16.8
Paul Millsap,31-269,F,11/5/16,ATL,HOU,1,34,10,20,0.5,10,18,0.556,0,2,0,3,5,0.6,2,9,11,5,5,1,2,3,23,22.3
Brook Lopez,28-359,C,3/26/17,BRK,ATL,1,31,7,17,0.412,5,13,0.385,2,4,0.5,7,8,0.875,3,4,7,0,1,1,4,4,23,12.9
Dirk Nowitzki,38-265,F,3/11/17,DAL,PHO,1,31,10,14,0.714,9,12,0.75,1,2,0.5,2,3,0.667,1,10,11,2,0,0,1,2,23,20.1
Ryan Anderson,28-299,F,3/1/17,HOU,LAC,1,30,6,16,0.375,0,5,0,6,11,0.545,5,6,0.833,3,5,8,2,0,0,0,1,23,18.4
Gary Harris,22-162,G,2/23/17,DEN,SAC,1,35,9,19,0.474,4,8,0.5,5,11,0.455,0,0,,0,2,2,1,2,0,1,1,23,15.2
Kemba Walker,26-205,G,11/29/16,CHO,DET,1,31,9,16,0.563,5,9,0.556,4,7,0.571,1,2,0.5,1,1,2,4,2,1,3,1,23,18.1
Kevin Durant,28-121,F-G,1/28/17,GSW,LAC,1,29,9,11,0.818,6,7,0.857,3,4,0.75,2,2,1,1,3,4,7,1,1,0,1,23,26.7
Timothe Luwawu-Cabarrot,21-328,F,4/2/17,PHI,TOR,1,36,7,15,0.467,4,8,0.5,3,7,0.429,6,6,1,0,3,3,0,1,0,3,3,23,13
Rudy Gobert,24-255,C,3/8/17,UTA,HOU,1,36,7,8,0.875,7,8,0.875,0,0,,9,12,0.75,2,8,10,1,1,1,2,4,23,21.6
Paul Millsap,32-023,F,3/5/17,ATL,IND,1,37,8,16,0.5,8,14,0.571,0,2,0,7,12,0.583,3,7,10,2,2,0,4,1,23,16.2
Dion Waiters,24-343,G,11/17/16,MIA,MIL,1,35,10,22,0.455,10,17,0.588,0,5,0,3,5,0.6,0,7,7,4,0,0,0,3,23,14.5
Marc Gasol,32-066,C,4/5/17,MEM,OKC,1,33,8,16,0.5,5,11,0.455,3,5,0.6,4,4,1,0,5,5,5,2,4,4,3,23,19.6
Nikola Jokic,21-340,C-F,1/24/17,DEN,UTA,1,35,9,16,0.563,9,12,0.75,0,4,0,5,5,1,0,11,11,6,2,3,4,3,23,21.8
Bojan Bogdanovic,27-263,G-F,1/6/17,BRK,CLE,1,31,9,14,0.643,4,5,0.8,5,9,0.556,0,0,,0,2,2,4,1,0,2,5,23,17.2
Michael Carter-Williams,25-116,G,2/3/17,CHI,HOU,1,35,11,18,0.611,11,15,0.733,0,3,0,1,3,0.333,2,7,9,6,0,1,1,6,23,19
LeBron James,32-031,F-G,1/30/17,CLE,DAL,1,37,9,19,0.474,8,13,0.615,1,6,0.167,4,8,0.5,0,9,9,9,2,0,5,0,23,17.7
Jrue Holiday,26-229,G,1/27/17,NOP,SAS,1,38,10,17,0.588,7,11,0.636,3,6,0.5,0,1,0,0,4,4,11,2,2,5,1,23,21.6
Devin Booker,20-054,G,12/23/16,PHO,PHI,1,38,8,18,0.444,4,9,0.444,4,9,0.444,3,3,1,0,6,6,6,2,0,4,3,23,16.4
Andrew Wiggins,21-344,F-G,2/1/17,MIN,CLE,1,36,9,17,0.529,7,11,0.636,2,6,0.333,3,3,1,1,1,2,0,0,0,2,2,23,12.9
Hassan Whiteside,27-277,C,3/17/17,MIA,MIN,1,33,10,11,0.909,10,11,0.909,0,0,,3,3,1,3,11,14,1,0,3,2,3,23,24.3
Kevin Love,28-048,F,10/25/16,CLE,NYK,1,25,6,15,0.4,4,9,0.444,2,6,0.333,9,12,0.75,2,10,12,2,3,0,2,3,23,19.3
Kyrie Irving,24-225,G,11/3/16,CLE,BOS,1,34,9,18,0.5,6,10,0.6,3,8,0.375,2,3,0.667,0,4,4,6,0,0,3,3,23,14.8
Deron Williams,32-200,G,1/12/17,DAL,PHO,1,32,9,15,0.6,5,10,0.5,4,5,0.8,1,3,0.333,1,1,2,12,0,0,1,4,23,22.1
Otto Porter,23-230,F,1/19/17,WAS,NYK,1,30,7,13,0.538,1,3,0.333,6,10,0.6,3,3,1,1,4,5,2,1,0,0,3,23,19.8
Danilo Gallinari,28-240,F,4/5/17,DEN,HOU,1,38,8,16,0.5,5,8,0.625,3,8,0.375,4,4,1,0,5,5,3,0,0,2,1,23,16.2
LaMarcus Aldridge,31-168,F-C,1/3/17,SAS,TOR,1,30,11,16,0.688,10,15,0.667,1,1,1,0,0,,0,7,7,6,0,1,1,3,23,21
Blake Griffin,27-273,F,12/14/16,LAC,ORL,1,33,9,14,0.643,9,14,0.643,0,0,,5,7,0.714,1,6,7,3,0,0,4,4,23,15
Markieff Morris,27-164,F,2/13/17,WAS,OKC,1,32,8,14,0.571,5,11,0.455,3,3,1,4,5,0.8,1,5,6,1,2,0,4,2,23,16.1
Ersan Ilyasova,29-229,F,12/30/16,PHI,DEN,1,37,8,16,0.5,3,10,0.3,5,6,0.833,2,2,1,5,8,13,1,0,0,2,5,23,17.6
LaMarcus Aldridge,31-211,F-C,2/15/17,SAS,ORL,1,28,10,13,0.769,10,13,0.769,0,0,,3,4,0.75,1,2,3,3,2,1,2,1,23,21.2
Giannis Antetokounmpo,21-361,F-G,12/1/16,MIL,BRK,1,30,7,14,0.5,5,9,0.556,2,5,0.4,7,9,0.778,2,6,8,8,4,2,0,4,23,27.8
Nikola Jokic,21-253,C-F,10/29/16,DEN,POR,1,34,10,20,0.5,9,15,0.6,1,5,0.2,2,3,0.667,6,11,17,2,4,1,1,5,23,23.2
Karl-Anthony Towns,21-057,C-F,1/11/17,MIN,HOU,1,38,10,17,0.588,10,14,0.714,0,3,0,3,4,0.75,2,16,18,5,1,3,6,3,23,20.3
Chris Paul,31-304,G,3/6/17,LAC,BOS,1,30,8,14,0.571,7,11,0.636,1,3,0.333,6,8,0.75,1,4,5,4,3,0,5,1,23,17.9
Hassan Whiteside,27-192,C,12/22/16,MIA,LAL,1,37,9,12,0.75,9,12,0.75,0,0,,5,6,0.833,3,10,13,0,1,1,1,3,23,22.4
Markieff Morris,27-107,F,12/18/16,WAS,LAC,1,33,10,17,0.588,9,15,0.6,1,2,0.5,2,3,0.667,1,8,9,3,3,1,2,5,23,19.6
Tobias Harris,24-259,F,3/31/17,DET,MIL,0,35,10,14,0.714,8,10,0.8,2,4,0.5,1,1,1,3,4,7,3,1,0,1,2,23,21.8
Darren Collison,29-155,G,1/25/17,SAC,CLE,1,36,8,14,0.571,5,9,0.556,3,5,0.6,4,4,1,1,2,3,5,2,1,3,3,23,19.7
Devin Booker,20-147,G,3/26/17,PHO,CHO,1,35,7,17,0.412,5,12,0.417,2,5,0.4,7,7,1,1,3,4,5,0,1,4,3,23,14.5
Isaiah Thomas,27-279,G,11/12/16,BOS,IND,1,29,4,13,0.308,3,11,0.273,1,2,0.5,14,15,0.933,0,0,0,5,1,0,2,4,23,16
Myles Turner,20-283,F-C,1/1/17,IND,ORL,1,31,7,13,0.538,6,12,0.5,1,1,1,8,9,0.889,4,8,12,3,1,1,1,2,23,23.5
Dennis Schroder,23-112,G,1/5/17,ATL,NOP,1,33,8,18,0.444,6,13,0.462,2,5,0.4,5,6,0.833,3,3,6,4,1,0,4,1,23,15.6
Stephen Curry,28-228,G,10/28/16,GSW,NOP,1,34,8,19,0.421,4,9,0.444,4,10,0.4,3,4,0.75,1,0,1,8,1,0,4,3,23,14.6
Al Horford,30-203,C-F,12/23/16,BOS,OKC,1,33,8,17,0.471,5,11,0.455,3,6,0.5,4,4,1,1,5,6,4,2,1,2,4,23,18.4
Nikola Jokic,22-049,C-F,4/9/17,DEN,OKC,1,31,8,16,0.5,7,11,0.636,1,5,0.2,6,6,1,1,5,6,3,1,1,3,5,23,16
Jahlil Okafor,21-087,C-F,3/12/17,PHI,LAL,1,27,8,12,0.667,8,12,0.667,0,0,,7,8,0.875,1,3,4,2,1,1,4,3,23,16.9
Rudy Gay,30-081,F,11/6/16,SAC,TOR,1,35,9,19,0.474,7,14,0.5,2,5,0.4,3,4,0.75,2,3,5,1,1,0,2,3,23,13.7
Kyrie Irving,25-010,G,4/2/17,CLE,IND,1,46,5,20,0.25,3,15,0.2,2,5,0.4,11,11,1,2,3,5,7,1,1,3,4,23,15.3
Kemba Walker,26-306,G,3/10/17,CHO,ORL,1,24,9,13,0.692,4,5,0.8,5,8,0.625,0,0,,0,0,0,1,0,1,0,2,23,18.1
John Wall,26-072,G,11/17/16,WAS,NYK,1,31,7,15,0.467,4,9,0.444,3,6,0.5,6,6,1,0,2,2,11,1,0,2,3,23,21.4
Patty Mills,28-111,G,11/30/16,SAS,DAL,0,29,9,12,0.75,4,6,0.667,5,6,0.833,0,0,,0,3,3,4,1,0,2,1,23,20.5
Austin Rivers,24-207,G,2/24/17,LAC,SAS,0,27,8,14,0.571,6,8,0.75,2,6,0.333,5,6,0.833,0,0,0,3,0,0,0,4,23,16.5
John Wall,26-210,G,4/4/17,WAS,CHO,1,35,8,15,0.533,5,11,0.455,3,4,0.75,4,5,0.8,0,2,2,13,6,0,5,3,23,24.8
C.J. McCollum,25-079,G,12/7/16,POR,MIL,1,38,9,15,0.6,5,8,0.625,4,7,0.571,1,2,0.5,0,3,3,5,0,0,3,1,23,16.7
Kevin Durant,28-050,F-G,11/18/16,GSW,BOS,1,33,10,13,0.769,9,11,0.818,1,2,0.5,2,4,0.5,1,9,10,7,2,1,2,1,23,25.7
Nikola Vucevic,26-140,C,3/13/17,ORL,SAC,1,32,10,17,0.588,7,14,0.5,3,3,1,0,0,,3,6,9,4,2,2,2,2,23,22.4
Sean Kilpatrick,27-059,G,3/6/17,BRK,MEM,0,28,3,6,0.5,2,5,0.4,1,1,1,16,17,0.941,0,5,5,3,1,1,0,2,23,24.1
Frank Kaminsky,23-231,F-C,11/21/16,CHO,MEM,0,20,9,11,0.818,6,7,0.857,3,4,0.75,2,3,0.667,0,0,0,0,1,3,1,2,23,19.8
Jameer Nelson,35-047,G,3/28/17,DEN,POR,1,34,8,11,0.727,4,4,1,4,7,0.571,3,4,0.75,0,3,3,4,0,0,1,4,23,19.2
Gordon Hayward,26-286,F-G,1/3/17,UTA,BOS,1,34,7,14,0.5,4,7,0.571,3,7,0.429,6,7,0.857,0,2,2,2,1,0,3,2,23,14.8
Tyler Johnson,24-257,G,1/19/17,MIA,DAL,0,28,7,13,0.538,5,11,0.455,2,2,1,7,9,0.778,0,2,2,2,1,0,1,1,23,17.5
Ersan Ilyasova,29-307,F,3/18/17,ATL,POR,1,27,7,11,0.636,3,6,0.5,4,5,0.8,5,7,0.714,1,3,4,1,2,1,1,1,23,20.9
Thon Maker,20-034,F-C,3/31/17,MIL,DET,1,25,9,12,0.75,5,5,1,4,7,0.571,1,3,0.333,2,1,3,0,1,0,1,1,23,18.7
DeMar DeRozan,27-091,G,11/6/16,TOR,SAC,1,38,7,20,0.35,6,18,0.333,1,2,0.5,8,10,0.8,0,4,4,3,0,0,1,2,23,12.5
Jameer Nelson,35-004,G,2/13/17,DEN,GSW,1,34,9,14,0.643,4,7,0.571,5,7,0.714,0,0,,0,3,3,7,0,0,4,2,23,17.8
Marcus Morris,27-135,F,1/15/17,DET,LAL,1,43,9,18,0.5,5,10,0.5,4,8,0.5,1,2,0.5,2,7,9,1,0,1,1,1,23,17.1
D'Angelo Russell,20-253,G,11/2/16,LAL,ATL,1,31,9,19,0.474,8,16,0.5,1,3,0.333,4,4,1,1,3,4,8,2,3,4,1,23,20.2
C.J. Miles,29-299,G-F,2/11/17,IND,MIL,1,33,8,16,0.5,2,5,0.4,6,11,0.545,1,1,1,0,2,2,0,0,1,1,2,23,14.5
Seth Curry,26-077,G,11/8/16,DAL,LAL,0,31,9,15,0.6,5,8,0.625,4,7,0.571,1,2,0.5,1,3,4,4,3,0,1,2,23,21.3
Wilson Chandler,29-304,F,3/10/17,DEN,BOS,1,34,8,16,0.5,5,8,0.625,3,8,0.375,4,6,0.667,0,9,9,1,0,1,1,2,23,16.5
Karl-Anthony Towns,21-049,C-F,1/3/17,MIN,PHI,1,37,9,22,0.409,8,16,0.5,1,6,0.167,4,4,1,6,10,16,5,0,2,3,2,23,19.5
Jae Crowder,26-203,F,1/25/17,BOS,HOU,1,36,8,18,0.444,7,10,0.7,1,8,0.125,6,6,1,1,9,10,4,1,0,1,3,23,18.6
Jonas Valanciunas,24-198,C,11/20/16,TOR,SAC,1,37,9,18,0.5,9,18,0.5,0,0,,5,6,0.833,7,6,13,2,0,2,1,2,23,21.3
Ricky Rubio,26-145,G,3/15/17,MIN,BOS,1,32,8,14,0.571,5,9,0.556,3,5,0.6,4,4,1,2,1,3,7,1,0,1,4,23,21.4
Kyle O'Quinn,26-355,F-C,3/16/17,NYK,BRK,0,26,10,15,0.667,10,13,0.769,0,2,0,3,3,1,3,5,8,3,1,0,1,4,23,20.6
Russell Westbrook,28-117,G,3/9/17,OKC,SAS,1,35,7,21,0.333,6,15,0.4,1,6,0.167,8,9,0.889,3,10,13,13,2,0,3,2,23,23.1
Nicolas Batum,28-006,F-G,12/20/16,CHO,LAL,1,37,8,12,0.667,6,9,0.667,2,3,0.667,5,5,1,1,4,5,10,1,0,4,1,23,23.3
Brandon Jennings,27-134,G,2/4/17,NYK,CLE,1,42,8,13,0.615,2,5,0.4,6,8,0.75,1,2,0.5,0,5,5,10,2,0,1,4,23,24.6
Gordon Hayward,26-286,F-G,1/3/17,UTA,BOS,1,34,7,14,0.5,4,7,0.571,3,7,0.429,6,7,0.857,0,2,2,2,1,0,3,2,23,14.8
Deron Williams,32-176,G,12/19/16,DAL,DEN,1,31,9,18,0.5,6,15,0.4,3,3,1,2,3,0.667,0,1,1,8,1,0,3,3,23,16.3
Hassan Whiteside,27-240,C,2/8/17,MIA,MIL,1,34,10,12,0.833,10,12,0.833,0,0,,3,6,0.5,3,13,16,0,0,1,3,3,23,19.9
Kemba Walker,26-255,G,1/18/17,CHO,POR,1,32,8,14,0.571,4,6,0.667,4,8,0.5,3,5,0.6,0,2,2,5,3,0,1,1,23,21.3
Brandon Knight,24-364,G,11/30/16,PHO,ATL,0,31,6,18,0.333,3,15,0.2,3,3,1,8,9,0.889,1,4,5,2,1,0,3,0,23,13.7
Dante Exum,21-241,G,3/11/17,UTA,OKC,0,26,7,8,0.875,6,7,0.857,1,1,1,7,9,0.778,1,0,1,1,0,0,2,2,22,17
Rudy Gay,30-075,F,10/31/16,SAC,ATL,1,31,8,13,0.615,7,11,0.636,1,2,0.5,5,7,0.714,0,3,3,5,2,0,2,5,22,17.7
Marcus Smart,22-307,G,1/7/17,BOS,NOP,1,32,7,10,0.7,2,3,0.667,5,7,0.714,3,3,1,1,4,5,6,2,1,3,1,22,23.2
Kyle Korver,35-335,G-F,2/15/17,CLE,IND,0,25,8,12,0.667,2,4,0.5,6,8,0.75,0,0,,0,5,5,2,2,1,1,2,22,20.6
Terrence Ross,25-297,F-G,11/28/16,TOR,PHI,0,23,8,11,0.727,5,6,0.833,3,5,0.6,3,3,1,1,2,3,0,0,0,0,0,22,18.8
Marquese Chriss,19-283,F,4/11/17,PHO,SAC,1,40,8,19,0.421,6,13,0.462,2,6,0.333,4,8,0.5,1,6,7,0,1,2,4,4,22,9.6
Goran Dragic,30-197,G,11/19/16,MIA,WAS,1,37,7,14,0.5,5,10,0.5,2,4,0.5,6,8,0.75,0,3,3,6,1,0,4,3,22,15.1
Goran Dragic,30-283,G,2/13/17,MIA,ORL,1,36,6,15,0.4,6,14,0.429,0,1,0,10,10,1,1,2,3,1,1,1,2,3,22,14.4
Danilo Gallinari,28-204,F,2/28/17,DEN,CHI,1,32,7,10,0.7,4,6,0.667,3,4,0.75,5,6,0.833,1,2,3,0,1,0,0,2,22,18.9
Evan Fournier,24-000,G-F,10/29/16,ORL,CLE,1,38,9,16,0.563,7,10,0.7,2,6,0.333,2,2,1,0,2,2,6,0,0,3,5,22,14.2
Austin Rivers,24-189,G,2/6/17,LAC,TOR,1,38,7,14,0.5,3,6,0.5,4,8,0.5,4,7,0.571,1,1,2,0,0,1,1,3,22,13.3
Kemba Walker,26-268,G,1/31/17,CHO,POR,1,32,8,18,0.444,5,11,0.455,3,7,0.429,3,3,1,0,3,3,5,2,0,2,0,22,17
Joel Embiid,22-306,C-F,1/16/17,PHI,MIL,1,28,4,9,0.444,3,6,0.5,1,3,0.333,13,18,0.722,3,10,13,2,2,5,4,3,22,22.1
D'Angelo Russell,20-263,G,11/12/16,LAL,NOP,1,28,9,16,0.563,5,9,0.556,4,7,0.571,0,0,,0,2,2,6,0,1,3,3,22,15.7
Clint Capela,22-247,F-C,1/20/17,HOU,GSW,0,21,10,16,0.625,10,16,0.625,0,0,,2,2,1,6,6,12,1,1,1,2,3,22,20
Zach Randolph,35-106,F,10/30/16,MEM,WAS,0,25,10,16,0.625,10,15,0.667,0,1,0,2,3,0.667,1,7,8,1,3,0,4,3,22,15.7
Stephen Curry,28-294,G,1/2/17,GSW,DEN,1,35,8,18,0.444,5,9,0.556,3,9,0.333,3,3,1,0,3,3,5,0,0,3,2,22,13.2
Harrison Barnes,24-187,F,12/3/16,DAL,CHI,1,37,9,21,0.429,7,16,0.438,2,5,0.4,2,2,1,3,2,5,1,1,0,0,1,22,14.9
DeMar DeRozan,27-224,G,3/19/17,TOR,IND,1,29,9,19,0.474,8,17,0.471,1,2,0.5,3,4,0.75,0,3,3,4,0,0,4,1,22,11.2
Draymond Green,26-278,F,12/7/16,GSW,LAC,1,32,8,10,0.8,5,5,1,3,5,0.6,3,4,0.75,3,2,5,4,2,0,1,4,22,22.7
Elfrid Payton,23-014,G,3/8/17,ORL,CHI,1,36,8,12,0.667,8,11,0.727,0,1,0,6,7,0.857,6,8,14,14,2,2,2,0,22,34.2
Paul George,26-282,F,2/8/17,IND,CLE,1,38,9,19,0.474,7,14,0.5,2,5,0.4,2,3,0.667,1,7,8,6,2,1,3,2,22,17.8
Carmelo Anthony,32-171,F,11/16/16,NYK,DET,1,37,9,17,0.529,5,11,0.455,4,6,0.667,0,0,,1,4,5,3,1,0,2,0,22,16.7
DeAndre Jordan,28-237,C,3/15/17,LAC,MIL,1,37,9,12,0.75,9,12,0.75,0,0,,4,5,0.8,2,15,17,2,0,2,2,3,22,22.3
Kyle Lowry,30-326,G,2/14/17,TOR,CHI,1,38,8,17,0.471,4,6,0.667,4,11,0.364,2,2,1,0,3,3,4,1,0,5,5,22,11
Gordon Hayward,26-270,F-G,12/18/16,UTA,MEM,1,37,5,13,0.385,1,6,0.167,4,7,0.571,8,9,0.889,1,6,7,6,2,3,2,2,22,22.5
D'Angelo Russell,21-031,G,3/26/17,LAL,POR,1,33,8,19,0.421,7,15,0.467,1,4,0.25,5,5,1,0,1,1,2,0,0,2,3,22,10.4
J.J. Redick,32-247,G,2/26/17,LAC,CHO,1,38,9,16,0.563,6,9,0.667,3,7,0.429,1,2,0.5,0,2,2,2,1,0,2,2,22,14.2
Ersan Ilyasova,29-192,F,11/23/16,PHI,MEM,1,40,8,15,0.533,6,10,0.6,2,5,0.4,4,5,0.8,2,10,12,0,0,0,1,6,22,15.3
Damian Lillard,26-254,G,3/26/17,POR,LAL,1,30,7,20,0.35,3,10,0.3,4,10,0.4,4,7,0.571,1,6,7,5,3,0,1,3,22,16.4
Damian Lillard,26-254,G,3/26/17,POR,LAL,1,30,7,20,0.35,3,10,0.3,4,10,0.4,4,7,0.571,1,6,7,5,3,0,1,3,22,16.4
Eric Bledsoe,27-020,G,12/29/16,PHO,TOR,1,38,9,14,0.643,8,11,0.727,1,3,0.333,3,3,1,1,4,5,10,3,2,8,3,22,19.9
Mike Conley,29-081,G,12/31/16,MEM,SAC,1,29,8,11,0.727,5,7,0.714,3,4,0.75,3,5,0.6,3,5,8,3,0,1,2,0,22,21.1
Marcus Morris,27-060,F,11/1/16,DET,NYK,1,32,9,14,0.643,7,11,0.636,2,3,0.667,2,4,0.5,1,3,4,1,1,0,0,3,22,17.1
DeMarcus Cousins,26-163,C-F,1/23/17,SAC,DET,1,32,8,21,0.381,7,18,0.389,1,3,0.333,5,8,0.625,2,11,13,6,3,2,6,2,22,15.8
Gary Harris,22-154,G,2/15/17,DEN,MIN,1,38,8,17,0.471,5,11,0.455,3,6,0.5,3,4,0.75,1,2,3,2,2,0,2,2,22,14.8
Stephen Curry,28-272,G,12/11/16,GSW,MIN,1,32,6,13,0.462,4,8,0.5,2,5,0.4,8,8,1,1,3,4,9,1,0,0,3,22,23
Enes Kanter,24-229,C,1/4/17,OKC,CHO,0,20,8,13,0.615,7,11,0.636,1,2,0.5,5,6,0.833,2,6,8,0,0,0,1,3,22,16.7
Sean Kilpatrick,26-343,G,12/14/16,BRK,LAL,1,31,5,13,0.385,2,7,0.286,3,6,0.5,9,10,0.9,1,3,4,5,1,0,3,3,22,16.4
Marco Belinelli,30-239,G-F,11/19/16,CHO,NOP,0,33,7,13,0.538,0,4,0,7,9,0.778,1,2,0.5,0,10,10,4,0,0,4,2,22,16.3
Buddy Hield,23-105,G,4/1/17,SAC,MIN,1,34,9,15,0.6,5,9,0.556,4,6,0.667,0,0,,0,4,4,1,1,0,1,3,22,15.8
Giannis Antetokounmpo,22-113,F-G,3/29/17,MIL,BOS,1,33,8,17,0.471,6,13,0.462,2,4,0.5,4,7,0.571,4,5,9,3,3,3,2,1,22,21.2
James Harden,27-212,G,3/26/17,HOU,OKC,1,36,8,15,0.533,6,7,0.857,2,8,0.25,4,5,0.8,0,5,5,12,0,0,5,5,22,17.2
Dwyane Wade,34-310,G,11/22/16,CHI,DEN,1,35,9,21,0.429,7,17,0.412,2,4,0.5,2,2,1,1,2,3,2,1,1,0,3,22,14.1
Elfrid Payton,23-033,G,3/27/17,ORL,TOR,1,31,8,12,0.667,8,10,0.8,0,2,0,6,8,0.75,0,1,1,9,1,1,1,3,22,22.1
Dwyane Wade,34-363,G,1/14/17,CHI,NOP,1,32,9,24,0.375,8,20,0.4,1,4,0.25,3,5,0.6,1,4,5,5,2,0,1,5,22,12.4
Serge Ibaka,27-164,F-C,3/1/17,TOR,WAS,1,36,8,17,0.471,4,11,0.364,4,6,0.667,2,2,1,4,9,13,0,1,2,4,3,22,16
Reggie Jackson,26-264,G,1/5/17,DET,CHO,1,30,7,15,0.467,6,13,0.462,1,2,0.5,7,8,0.875,1,0,1,11,0,0,1,3,22,20.1
DeMar DeRozan,27-221,G,3/16/17,TOR,OKC,1,29,8,14,0.571,8,13,0.615,0,1,0,6,7,0.857,0,3,3,3,0,0,3,1,22,14.6
Mike Conley,29-163,G,3/23/17,MEM,SAS,1,36,7,18,0.389,6,10,0.6,1,8,0.125,7,7,1,0,2,2,6,0,0,3,2,22,13.2
Jon Leuer,27-230,F,12/30/16,DET,ATL,1,37,9,16,0.563,7,12,0.583,2,4,0.5,2,2,1,3,3,6,1,2,0,0,4,22,18.5
Myles Turner,20-239,F-C,11/18/16,IND,PHO,1,31,9,13,0.692,9,12,0.75,0,1,0,4,7,0.571,1,5,6,1,0,2,2,4,22,16
Mike Conley,29-092,G,1/11/17,MEM,OKC,1,36,8,20,0.4,5,13,0.385,3,7,0.429,3,5,0.6,2,2,4,6,3,0,2,2,22,16.8
Danilo Gallinari,28-205,F,3/1/17,DEN,MIL,1,34,6,11,0.545,4,6,0.667,2,5,0.4,8,8,1,1,4,5,1,1,1,2,1,22,18.6
Shabazz Muhammad,24-150,F-G,4/12/17,MIN,HOU,0,22,9,18,0.5,8,12,0.667,1,6,0.167,3,5,0.6,1,1,2,1,2,0,1,1,22,14.5
Markieff Morris,27-055,F,10/27/16,WAS,ATL,1,28,9,18,0.5,7,15,0.467,2,3,0.667,2,2,1,1,3,4,2,2,1,0,2,22,17.9
John Wall,26-199,G,3/24/17,WAS,BRK,1,24,9,16,0.563,9,14,0.643,0,2,0,4,4,1,1,3,4,9,1,0,3,2,22,19.5
Tobias Harris,24-103,F,10/26/16,DET,TOR,1,36,8,13,0.615,7,11,0.636,1,2,0.5,5,5,1,0,5,5,1,1,0,5,3,22,13.1
Shabazz Muhammad,24-087,F-G,2/8/17,MIN,TOR,0,26,8,13,0.615,6,8,0.75,2,5,0.4,4,6,0.667,0,2,2,2,0,0,0,2,22,16.5
Josh Richardson,23-103,G,12/27/16,MIA,OKC,1,37,9,16,0.563,7,10,0.7,2,6,0.333,2,2,1,0,5,5,3,1,0,0,4,22,17.4
Goran Dragic,30-331,G,4/2/17,MIA,DEN,1,34,8,15,0.533,7,11,0.636,1,4,0.25,5,6,0.833,1,1,2,6,0,0,3,4,22,14.9
Nicolas Batum,28-002,F-G,12/16/16,CHO,BOS,1,36,6,19,0.316,4,12,0.333,2,7,0.286,8,8,1,0,10,10,5,3,0,5,1,22,15.2
Eric Bledsoe,27-024,G,1/2/17,PHO,LAC,1,41,8,27,0.296,7,22,0.318,1,5,0.2,5,7,0.714,1,7,8,9,3,0,4,4,22,12
LaMarcus Aldridge,31-152,F-C,12/18/16,SAS,NOP,1,26,6,15,0.4,6,14,0.429,0,1,0,10,10,1,1,5,6,3,1,0,3,3,22,15
Will Barton,26-066,G,3/13/17,DEN,LAL,0,30,7,12,0.583,3,6,0.5,4,6,0.667,4,5,0.8,0,2,2,6,1,1,4,3,22,17.3
Ben McLemore,24-052,G,4/4/17,SAC,DAL,0,26,8,13,0.615,3,8,0.375,5,5,1,1,2,0.5,0,3,3,0,2,0,1,1,22,17.2
Ty Lawson,29-095,G,2/6/17,SAC,CHI,0,35,8,13,0.615,6,9,0.667,2,4,0.5,4,4,1,1,3,4,7,0,1,3,2,22,19.5
Rudy Gay,30-151,F,1/15/17,SAC,OKC,1,36,6,18,0.333,4,13,0.308,2,5,0.4,8,9,0.889,2,8,10,2,2,2,3,4,22,15.4
J.J. Redick,32-184,G,12/25/16,LAC,LAL,1,26,8,16,0.5,4,9,0.444,4,7,0.571,2,2,1,1,1,2,3,1,0,1,2,22,16.3
DeMarcus Cousins,26-125,C-F,12/16/16,SAC,MEM,1,35,7,20,0.35,7,17,0.412,0,3,0,8,8,1,0,9,9,1,0,1,2,6,22,10.5
Giannis Antetokounmpo,22-020,F-G,12/26/16,MIL,WAS,1,38,7,12,0.583,7,11,0.636,0,1,0,8,11,0.727,5,7,12,7,0,1,2,3,22,23.2
Jonas Valanciunas,24-275,C,2/5/17,TOR,BRK,1,26,9,17,0.529,9,17,0.529,0,0,,4,4,1,0,5,5,0,1,0,2,4,22,12.6
Ty Lawson,29-159,G,4/11/17,SAC,PHO,1,31,6,10,0.6,5,9,0.556,1,1,1,9,10,0.9,1,9,10,12,1,0,3,3,22,25.6
Ryan Anderson,28-235,F,12/27/16,HOU,DAL,1,28,7,12,0.583,3,5,0.6,4,7,0.571,4,4,1,1,2,3,0,1,1,1,3,22,17.2
Tyler Johnson,24-202,G,11/25/16,MIA,MEM,0,33,8,17,0.471,7,12,0.583,1,5,0.2,5,7,0.714,1,4,5,0,2,1,0,2,22,16.3
Isaiah Thomas,28-033,G,3/12/17,BOS,CHI,1,24,9,14,0.643,5,6,0.833,4,8,0.5,0,0,,0,1,1,2,3,0,2,0,22,18.5
Seth Curry,26-162,G,2/1/17,DAL,PHI,1,34,8,14,0.571,5,7,0.714,3,7,0.429,3,4,0.75,1,2,3,6,4,0,3,2,22,20.7
Myles Turner,20-305,F-C,1/23/17,IND,NYK,1,28,8,12,0.667,8,10,0.8,0,2,0,6,6,1,2,8,10,0,0,2,1,4,22,19.4
Nick Young,31-230,G-F,1/17/17,LAL,DEN,1,31,8,16,0.5,4,5,0.8,4,11,0.364,2,2,1,2,0,2,1,3,0,1,2,22,17.3
Clint Capela,22-329,F-C,4/12/17,HOU,MIN,1,30,11,12,0.917,11,12,0.917,0,0,,0,3,0,5,5,10,2,1,3,2,1,22,23.9
DeAndre Jordan,28-146,C,12/14/16,LAC,ORL,1,35,5,6,0.833,5,6,0.833,0,0,,12,18,0.667,3,9,12,2,1,3,0,2,22,25.9
Dwyane Wade,34-361,G,1/12/17,CHI,NYK,1,33,9,20,0.45,9,18,0.5,0,2,0,4,6,0.667,0,3,3,3,2,0,4,0,22,11.8
Will Barton,25-294,G,10/26/16,DEN,NOP,1,35,7,12,0.583,5,9,0.556,2,3,0.667,6,6,1,2,3,5,2,0,0,2,2,22,17.3
George Hill,30-181,G,11/1/16,UTA,SAS,1,33,9,13,0.692,6,8,0.75,3,5,0.6,1,1,1,0,2,2,7,1,0,0,2,22,22.2
Eric Bledsoe,27-041,G,1/19/17,PHO,CLE,1,38,7,20,0.35,5,15,0.333,2,5,0.4,6,7,0.857,2,4,6,9,4,0,4,3,22,18.1
Al Horford,30-235,C-F,1/24/17,BOS,WAS,1,33,9,12,0.75,7,9,0.778,2,3,0.667,2,2,1,0,2,2,4,0,1,1,3,22,19.1
Lou Williams,30-102,G,2/6/17,LAL,NYK,0,26,6,11,0.545,3,6,0.5,3,5,0.6,7,7,1,1,1,2,4,1,0,4,1,22,17.1
Stephen Curry,28-252,G,11/21/16,GSW,IND,1,30,6,11,0.545,4,5,0.8,2,6,0.333,8,8,1,2,4,6,6,1,0,1,1,22,23.1
Rudy Gay,30-109,F,12/4/16,SAC,NYK,1,35,7,18,0.389,5,12,0.417,2,6,0.333,6,6,1,2,7,9,4,3,0,3,3,22,17.3
Kyrie Irving,24-353,G,3/11/17,CLE,ORL,1,36,9,22,0.409,7,14,0.5,2,8,0.25,2,2,1,3,6,9,7,1,0,2,2,22,17.2
Avery Bradley,25-363,G,11/23/16,BOS,BRK,1,34,10,22,0.455,9,15,0.6,1,7,0.143,1,2,0.5,1,6,7,1,5,0,2,3,22,15.2
Kent Bazemore,27-152,G-F,11/30/16,ATL,PHO,1,40,8,17,0.471,4,9,0.444,4,8,0.5,2,2,1,1,4,5,3,3,1,3,2,22,17.2
Gary Harris,22-130,G,1/22/17,DEN,MIN,1,35,9,13,0.692,7,9,0.778,2,4,0.5,2,2,1,2,3,5,3,1,0,2,1,22,19.5
Markieff Morris,27-179,F,2/28/17,WAS,GSW,1,33,8,17,0.471,6,12,0.5,2,5,0.4,4,4,1,2,4,6,1,2,4,1,3,22,19.2
Rudy Gobert,24-163,C,12/6/16,UTA,PHO,1,38,6,8,0.75,6,8,0.75,0,0,,10,11,0.909,3,8,11,0,0,4,3,2,22,21.9
Kentavious Caldwell-Pope,23-279,G,11/23/16,DET,MIA,1,29,7,13,0.538,5,7,0.714,2,6,0.333,6,6,1,1,4,5,2,1,0,1,1,22,18.6
Tim Hardaway,24-297,G,1/7/17,ATL,DAL,0,31,7,13,0.538,2,5,0.4,5,8,0.625,3,4,0.75,0,2,2,3,0,0,2,2,22,15.2
Karl-Anthony Towns,21-010,C-F,11/25/16,MIN,PHO,1,35,8,19,0.421,6,13,0.462,2,6,0.333,4,5,0.8,3,7,10,4,1,1,4,2,22,15.4
Eric Gordon,28-098,G,4/2/17,HOU,PHO,1,37,9,24,0.375,7,16,0.438,2,8,0.25,2,3,0.667,3,3,6,5,1,3,0,2,22,17.2
Dennis Schroder,23-151,G,2/13/17,ATL,POR,1,42,9,22,0.409,8,18,0.444,1,4,0.25,3,4,0.75,0,4,4,4,0,0,2,3,22,10.6
Ben McLemore,24-046,G,3/29/17,SAC,UTA,0,28,9,12,0.75,8,8,1,1,4,0.25,3,4,0.75,0,4,4,1,0,0,2,4,22,15.1
Jamal Crawford,36-265,G,12/10/16,LAC,NOP,0,26,10,13,0.769,8,9,0.889,2,4,0.5,0,0,,0,0,0,2,1,0,2,1,22,16.9
Jamal Crawford,36-280,G,12/25/16,LAC,LAL,0,31,7,17,0.412,6,12,0.5,1,5,0.2,7,8,0.875,0,0,0,3,1,0,4,4,22,10
Jabari Parker,21-261,F,12/1/16,MIL,BRK,1,29,9,14,0.643,9,12,0.75,0,2,0,4,6,0.667,1,2,3,2,1,0,0,1,22,18.3
T.J. Warren,23-062,F,11/6/16,PHO,LAL,1,39,9,20,0.45,7,17,0.412,2,3,0.667,2,3,0.667,2,4,6,3,2,0,1,4,22,15.3
Jrue Holiday,26-170,G,11/29/16,NOP,LAL,1,29,8,15,0.533,4,8,0.5,4,7,0.571,2,3,0.667,0,2,2,5,1,0,2,1,22,17
Pau Gasol,36-190,F-C,1/12/17,SAS,LAL,1,26,9,9,1,9,9,1,0,0,,4,5,0.8,2,7,9,6,0,1,2,3,22,24.1
Victor Oladipo,24-311,G,3/11/17,OKC,UTA,1,38,8,15,0.533,5,9,0.556,3,6,0.5,3,4,0.75,1,1,2,4,1,1,1,2,22,18
Troy Daniels,25-167,G,12/29/16,MEM,OKC,0,18,8,12,0.667,2,4,0.5,6,8,0.75,0,0,,1,2,3,2,0,0,0,3,22,18.3
J.J. Redick,32-192,G,1/2/17,LAC,PHO,1,34,9,14,0.643,6,9,0.667,3,5,0.6,1,1,1,1,3,4,0,0,0,2,2,22,14.6
Kevin Durant,28-132,F-G,2/8/17,GSW,CHI,1,31,9,16,0.563,8,14,0.571,1,2,0.5,3,3,1,0,10,10,7,3,1,3,1,22,22.6
J.J. Redick,32-265,G,3/16/17,LAC,DEN,1,26,8,10,0.8,4,4,1,4,6,0.667,2,2,1,0,5,5,1,2,0,1,1,22,21
Jahlil Okafor,21-089,C-F,3/14/17,PHI,GSW,1,23,8,16,0.5,8,16,0.5,0,0,,6,7,0.857,2,4,6,1,1,4,3,2,22,16.9
Tyson Chandler,34-109,C,1/19/17,PHO,CLE,1,30,9,14,0.643,9,14,0.643,0,0,,4,6,0.667,8,8,16,1,0,1,1,0,22,23.4
Ben McLemore,23-365,G,2/10/17,SAC,ATL,1,42,8,17,0.471,2,7,0.286,6,10,0.6,0,0,,3,6,9,3,4,0,2,3,22,20.1
Kemba Walker,26-178,G,11/2/16,CHO,PHI,1,33,7,14,0.5,5,9,0.556,2,5,0.4,6,6,1,1,3,4,7,0,0,4,0,22,17.5
Jabari Parker,21-251,F,11/21/16,MIL,ORL,1,35,8,17,0.471,3,10,0.3,5,7,0.714,1,5,0.2,0,3,3,3,3,0,0,0,22,17.7
D'Angelo Russell,20-343,G,1/31/17,LAL,DEN,1,34,7,17,0.412,5,10,0.5,2,7,0.286,6,8,0.75,1,6,7,10,1,1,2,1,22,20.9
Gordon Hayward,26-245,F-G,11/23/16,UTA,DEN,1,36,7,15,0.467,5,11,0.455,2,4,0.5,6,6,1,0,5,5,7,1,1,2,2,22,19.6
Steven Adams,23-158,C,12/25/16,OKC,MIN,1,29,9,12,0.75,9,12,0.75,0,0,,4,4,1,1,5,6,1,2,0,2,3,22,18.9
Jordan Clarkson,24-232,G,1/25/17,LAL,POR,0,35,8,15,0.533,6,11,0.545,2,4,0.5,4,4,1,1,2,3,2,1,0,1,0,22,17.4
Kevin Love,28-094,F,12/10/16,CLE,CHO,1,36,7,12,0.583,7,8,0.875,0,4,0,8,10,0.8,1,5,6,1,3,0,2,4,22,17.9
Brook Lopez,28-259,C,12/16/16,BRK,ORL,1,32,9,19,0.474,9,16,0.563,0,3,0,4,5,0.8,1,5,6,1,1,5,4,6,22,12.9
Gordon Hayward,26-291,F-G,1/8/17,UTA,MEM,1,34,6,13,0.462,3,8,0.375,3,5,0.6,7,9,0.778,0,5,5,2,2,0,3,1,22,16
Jimmy Butler,27-077,G-F,11/30/16,CHI,LAL,1,40,4,18,0.222,3,12,0.25,1,6,0.167,13,15,0.867,1,3,4,2,3,0,4,3,22,11
James Johnson,29-314,F,12/30/16,MIA,BOS,0,24,8,13,0.615,4,6,0.667,4,7,0.571,2,3,0.667,0,3,3,6,2,2,5,3,22,18
Derrick Rose,28-163,G,3/16/17,NYK,BRK,1,33,7,17,0.412,7,17,0.412,0,0,,8,9,0.889,0,2,2,2,0,0,2,2,22,11.7
Paul George,26-316,F,3/14/17,IND,NYK,1,38,9,22,0.409,6,14,0.429,3,8,0.375,1,1,1,2,8,10,2,0,0,6,2,22,8.6
Hassan Whiteside,27-257,C,2/25/17,MIA,IND,1,37,6,12,0.5,6,12,0.5,0,0,,10,13,0.769,7,10,17,0,1,1,3,0,22,21.4
Kristaps Porzingis,21-145,F-C,12/25/16,NYK,BOS,1,37,9,16,0.563,7,12,0.583,2,4,0.5,2,2,1,2,10,12,1,2,4,5,4,22,17.7
Buddy Hield,23-097,G,3/24/17,SAC,GSW,1,33,7,14,0.5,3,5,0.6,4,9,0.444,4,4,1,2,6,8,7,2,0,3,3,22,20.9
Michael Beasley,28-046,F,2/24/17,MIL,UTA,1,32,10,17,0.588,10,16,0.625,0,1,0,2,2,1,0,6,6,0,0,0,1,3,22,13.7
Pau Gasol,36-256,F-C,3/19/17,SAS,SAC,0,20,7,11,0.636,5,9,0.556,2,2,1,6,9,0.667,3,6,9,0,2,0,1,1,22,20.4
J.J. Redick,32-201,G,1/11/17,LAC,ORL,1,36,7,16,0.438,4,7,0.571,3,9,0.333,5,7,0.714,0,6,6,5,0,1,0,2,22,18
Paul George,26-226,F,12/14/16,IND,MIA,1,38,8,22,0.364,4,11,0.364,4,11,0.364,2,2,1,1,6,7,3,0,0,2,2,22,11.6
Damian Lillard,26-235,G,3/7/17,POR,OKC,1,36,8,17,0.471,6,11,0.545,2,6,0.333,4,5,0.8,1,2,3,8,1,0,1,0,22,19.8
Jabari Parker,21-301,F,1/10/17,MIL,SAS,1,34,9,16,0.563,7,13,0.538,2,3,0.667,2,2,1,1,6,7,3,1,0,0,5,22,18
J.J. Redick,32-214,G,1/24/17,LAC,PHI,1,35,6,15,0.4,1,5,0.2,5,10,0.5,5,6,0.833,0,1,1,1,0,0,2,3,22,11.3
Tobias Harris,24-236,F,3/8/17,DET,IND,0,27,9,17,0.529,7,12,0.583,2,5,0.4,2,4,0.5,1,4,5,1,0,0,1,2,22,13.7
Michael Kidd-Gilchrist,23-168,F,3/13/17,CHO,CHI,1,35,9,12,0.75,9,12,0.75,0,0,,4,5,0.8,2,4,6,1,0,0,0,4,22,18.5
Quinn Cook,24-016,G,4/8/17,NOP,GSW,0,28,10,13,0.769,8,10,0.8,2,3,0.667,0,1,0,0,1,1,3,0,0,0,1,22,18.5
Jimmy Butler,27-066,G-F,11/19/16,CHI,LAC,1,38,5,18,0.278,4,13,0.308,1,5,0.2,11,12,0.917,3,3,6,1,1,0,2,1,22,13.3
Wesley Matthews,30-033,G,11/16/16,DAL,BOS,1,38,7,15,0.467,1,2,0.5,6,13,0.462,2,3,0.667,0,3,3,0,2,0,1,1,22,15.4
J.J. Barea,32-122,G,10/26/16,DAL,IND,0,39,7,17,0.412,5,10,0.5,2,7,0.286,6,6,1,0,2,2,6,0,1,3,1,22,15
Wayne Ellington,29-032,G,11/30/16,MIA,DEN,0,32,8,14,0.571,3,5,0.6,5,9,0.556,1,2,0.5,0,2,2,2,4,0,1,0,22,20
Jimmy Butler,27-169,G-F,3/2/17,CHI,GSW,1,35,6,14,0.429,6,13,0.462,0,1,0,10,10,1,0,5,5,6,4,1,2,1,22,22.6
Marc Gasol,31-340,C,1/3/17,MEM,LAL,1,35,8,15,0.533,8,13,0.615,0,2,0,6,6,1,0,6,6,7,1,0,1,1,22,21
Kyle Korver,35-288,G-F,12/30/16,ATL,DET,0,29,7,13,0.538,4,5,0.8,3,8,0.375,5,6,0.833,0,3,3,2,0,0,1,0,22,16.6
Giannis Antetokounmpo,22-064,F-G,2/8/17,MIL,MIA,1,36,9,15,0.6,7,12,0.583,2,3,0.667,2,2,1,2,6,8,1,2,1,4,1,22,17.3
Will Barton,25-334,G,12/5/16,DEN,PHI,1,36,9,17,0.529,8,14,0.571,1,3,0.333,3,7,0.429,1,7,8,3,2,2,4,3,22,15.2
John Wall,26-054,G,10/30/16,WAS,MEM,1,37,8,19,0.421,7,16,0.438,1,3,0.333,5,5,1,0,3,3,13,1,1,5,4,22,17
Kevin Durant,28-073,F-G,12/11/16,GSW,MIN,1,37,6,21,0.286,5,17,0.294,1,4,0.25,9,9,1,1,7,8,5,0,0,1,2,22,14.2
Paul George,26-331,F,3/29/17,IND,MEM,1,36,8,17,0.471,5,11,0.455,3,6,0.5,3,4,0.75,0,2,2,4,2,2,3,3,22,15.5
LeBron James,31-335,F-G,11/29/16,CLE,MIL,1,33,8,16,0.5,5,8,0.625,3,8,0.375,3,7,0.429,0,4,4,4,0,0,7,3,22,8.2
Tyson Chandler,34-114,C,1/24/17,PHO,MIN,1,35,9,9,1,9,9,1,0,0,,4,5,0.8,7,10,17,0,0,2,0,3,22,27
Austin Rivers,24-149,G,12/28/16,LAC,NOP,1,32,9,20,0.45,7,12,0.583,2,8,0.25,2,2,1,3,1,4,0,2,0,1,3,22,13.8
Dirk Nowitzki,38-129,F,10/26/16,DAL,IND,1,38,8,19,0.421,4,10,0.4,4,9,0.444,2,2,1,0,8,8,2,2,2,2,1,22,16.7
Zach Randolph,35-258,F,3/31/17,MEM,DAL,0,32,8,14,0.571,8,14,0.571,0,0,,6,6,1,2,10,12,3,1,0,2,3,22,19.7
Kawhi Leonard,25-265,F,3/21/17,SAS,MIN,1,31,7,13,0.538,7,8,0.875,0,5,0,8,10,0.8,0,3,3,4,3,1,3,2,22,18.5
Jordan Clarkson,24-154,G,11/8/16,LAL,DAL,0,28,9,12,0.75,7,9,0.778,2,3,0.667,2,2,1,0,0,0,2,3,0,3,0,22,18.6
Joel Embiid,22-250,C-F,11/21/16,PHI,MIA,1,23,7,13,0.538,6,11,0.545,1,2,0.5,7,9,0.778,0,5,5,0,1,3,1,2,22,17.7
Marc Gasol,31-290,C,11/14/16,MEM,UTA,1,33,9,17,0.529,7,11,0.636,2,6,0.333,2,4,0.5,0,5,5,0,1,0,6,2,22,8.6
Giannis Antetokounmpo,22-110,F-G,3/26/17,MIL,CHI,1,37,8,14,0.571,8,12,0.667,0,2,0,6,10,0.6,0,8,8,4,0,0,3,1,22,15.6
C.J. McCollum,25-180,G,3/18/17,POR,ATL,1,32,10,19,0.526,10,18,0.556,0,1,0,2,2,1,1,5,6,5,1,2,0,2,22,20
Nick Young,31-158,G-F,11/6/16,LAL,PHO,1,36,8,14,0.571,5,7,0.714,3,7,0.429,3,3,1,1,6,7,1,1,1,1,4,22,17.7
Otto Porter,23-208,F,12/28/16,WAS,IND,1,33,6,10,0.6,3,4,0.75,3,6,0.5,7,7,1,0,1,1,0,0,0,1,4,22,15.1
Damian Lillard,26-265,G,4/6/17,POR,MIN,1,37,7,21,0.333,6,12,0.5,1,9,0.111,7,7,1,0,9,9,8,1,0,4,2,22,14.6
Jrue Holiday,26-234,G,2/1/17,NOP,DET,1,35,10,17,0.588,10,14,0.714,0,3,0,2,3,0.667,1,2,3,11,2,1,4,1,22,21
Dennis Schroder,23-179,G,3/13/17,ATL,SAS,1,38,10,22,0.455,10,18,0.556,0,4,0,2,2,1,0,2,2,10,2,0,2,1,22,17.8
Marcus Morris,27-183,F,3/4/17,DET,PHI,1,34,8,15,0.533,6,9,0.667,2,6,0.333,4,4,1,1,2,3,2,2,3,0,1,22,21.1
Robert Covington,26-037,F,1/20/17,PHI,POR,1,34,8,17,0.471,3,5,0.6,5,12,0.417,1,1,1,1,5,6,0,1,1,2,3,22,14
Al Horford,30-227,C-F,1/16/17,BOS,CHO,1,34,8,14,0.571,7,9,0.778,1,5,0.2,5,5,1,2,4,6,4,0,0,2,1,22,18.4
Damian Lillard,26-265,G,4/6/17,POR,MIN,1,37,7,21,0.333,6,12,0.5,1,9,0.111,7,7,1,0,9,9,8,1,0,4,2,22,14.6
Nikola Jokic,21-328,C-F,1/12/17,DEN,IND,1,30,7,12,0.583,5,9,0.556,2,3,0.667,6,6,1,3,7,10,7,1,1,3,1,22,23.8
Karl-Anthony Towns,20-364,C-F,11/13/16,MIN,LAL,1,39,7,22,0.318,5,15,0.333,2,7,0.286,6,10,0.6,2,10,12,2,0,1,2,3,22,11.1
Elfrid Payton,22-302,G,12/20/16,ORL,MIA,0,36,8,13,0.615,8,12,0.667,0,1,0,6,7,0.857,0,2,2,6,1,1,1,2,22,20.4
Tobias Harris,24-122,F,11/14/16,DET,OKC,1,37,9,16,0.563,7,11,0.636,2,5,0.4,2,2,1,0,6,6,3,1,2,0,2,22,19.9
Ryan Anderson,28-222,F,12/14/16,HOU,SAC,1,26,8,12,0.667,4,5,0.8,4,7,0.571,2,3,0.667,2,4,6,1,0,0,0,0,22,19.7
Kevin Durant,28-082,F-G,12/20/16,GSW,UTA,1,25,8,14,0.571,8,13,0.615,0,1,0,6,6,1,1,4,5,1,0,0,1,4,22,15.4
Brook Lopez,28-231,C,11/18/16,BRK,OKC,1,28,8,16,0.5,4,9,0.444,4,7,0.571,2,2,1,2,2,4,2,1,2,1,3,22,17.6
Kemba Walker,26-318,G,3/22/17,CHO,ORL,1,33,8,21,0.381,7,14,0.5,1,7,0.143,5,6,0.833,0,3,3,7,0,0,1,1,22,14.5
Wilson Chandler,29-180,F,11/6/16,DEN,BOS,0,25,8,14,0.571,6,10,0.6,2,4,0.5,4,5,0.8,0,5,5,2,1,0,1,3,22,16.7
Joel Embiid,22-234,C-F,11/5/16,PHI,CLE,1,25,7,13,0.538,3,9,0.333,4,4,1,4,4,1,2,4,6,2,1,4,6,3,22,16.3
Goran Dragic,30-306,G,3/8/17,MIA,CHO,1,34,6,13,0.462,5,10,0.5,1,3,0.333,9,9,1,3,3,6,10,1,0,2,3,22,23.1
DeMar DeRozan,27-168,G,1/22/17,TOR,PHO,1,37,6,17,0.353,6,16,0.375,0,1,0,10,11,0.909,1,2,3,4,1,1,2,2,22,15.1
Kristaps Porzingis,21-137,F-C,12/17/16,NYK,DEN,1,38,7,19,0.368,6,13,0.462,1,6,0.167,7,7,1,1,6,7,3,2,0,0,4,22,16.5
Aaron Gordon,21-197,F,4/1/17,ORL,BRK,1,35,9,18,0.5,5,11,0.455,4,7,0.571,0,0,,4,11,15,5,2,0,1,3,22,22.4
Tim Hardaway,25-022,G,4/7/17,ATL,CLE,1,26,9,14,0.643,5,5,1,4,9,0.444,0,0,,0,2,2,5,1,0,0,0,22,20.9
Marco Belinelli,30-364,G-F,3/24/17,CHO,CLE,0,32,7,12,0.583,4,5,0.8,3,7,0.429,5,5,1,1,2,3,2,0,0,1,5,22,16.1
Ricky Rubio,26-141,G,3/11/17,MIN,MIL,1,28,9,14,0.643,7,11,0.636,2,3,0.667,2,3,0.667,0,0,0,8,0,0,1,5,22,18
Bradley Beal,23-174,G,12/19/16,WAS,IND,1,30,7,19,0.368,4,8,0.5,3,11,0.273,5,6,0.833,1,0,1,3,0,0,2,4,22,10.3
Jordan Crawford,28-147,G,3/19/17,NOP,MIN,0,21,9,13,0.692,5,6,0.833,4,7,0.571,0,0,,0,2,2,0,0,0,2,2,22,14.3
Shabazz Muhammad,24-047,F-G,12/30/16,MIN,MIL,0,18,8,13,0.615,4,8,0.5,4,5,0.8,2,2,1,0,1,1,0,0,0,2,1,22,14
James Harden,27-142,G,1/15/17,HOU,BRK,1,32,6,16,0.375,2,7,0.286,4,9,0.444,6,7,0.857,2,10,12,11,1,0,7,4,22,17.3
Kevin Durant,28-090,F-G,12/28/16,GSW,TOR,1,38,8,15,0.533,5,10,0.5,3,5,0.6,3,5,0.6,0,17,17,7,0,5,6,0,22,21.4
Tony Allen,35-002,G-F,1/13/17,MEM,HOU,1,25,9,10,0.9,9,9,1,0,1,0,4,8,0.5,0,4,4,3,1,0,3,6,22,15.9
Jamal Crawford,36-328,G,2/11/17,LAC,CHO,0,27,6,11,0.545,1,3,0.333,5,8,0.625,5,9,0.556,0,1,1,2,0,0,0,1,22,16.4
Kawhi Leonard,25-231,F,2/15/17,SAS,ORL,1,27,8,18,0.444,6,13,0.462,2,5,0.4,4,4,1,1,4,5,1,2,1,1,1,22,16.5
Zach LaVine,21-254,G,11/19/16,MIN,MEM,1,37,9,16,0.563,5,8,0.625,4,8,0.5,0,0,,0,1,1,3,2,0,2,2,22,16
George Hill,30-203,G,11/23/16,UTA,DEN,1,29,8,13,0.615,5,7,0.714,3,6,0.5,3,4,0.75,0,5,5,3,2,0,2,3,22,18.1
Paul George,26-224,F,12/12/16,IND,CHO,1,36,9,17,0.529,6,10,0.6,3,7,0.429,1,1,1,0,5,5,3,1,0,4,1,22,13.9
Giannis Antetokounmpo,21-365,F-G,12/5/16,MIL,SAS,1,29,6,12,0.5,5,11,0.455,1,1,1,9,10,0.9,2,9,11,2,2,1,2,5,22,19.8
Lou Williams,30-061,G,12/27/16,LAL,UTA,0,27,6,13,0.462,4,9,0.444,2,4,0.5,8,8,1,0,2,2,3,0,0,3,2,22,14.2
Jrue Holiday,26-194,G,12/23/16,NOP,MIA,1,27,9,17,0.529,8,15,0.533,1,2,0.5,3,5,0.6,0,2,2,6,2,0,1,3,22,17.5
Tyler Johnson,24-178,G,11/1/16,MIA,SAC,0,32,7,11,0.636,5,9,0.556,2,2,1,6,6,1,0,4,4,2,2,2,1,1,22,21.7
Andre Iguodala,33-013,G-F,2/10/17,GSW,MEM,0,28,6,7,0.857,4,4,1,2,3,0.667,8,11,0.727,0,2,2,4,1,2,0,0,22,24.1
John Wall,26-153,G,2/6/17,WAS,CLE,1,44,8,19,0.421,8,16,0.5,0,3,0,6,6,1,0,4,4,12,1,0,6,2,22,15.7
Steven Adams,23-173,C,1/9/17,OKC,CHI,1,36,11,14,0.786,11,14,0.786,0,0,,0,0,,1,4,5,2,0,1,1,0,22,19.6
Jrue Holiday,26-160,G,11/19/16,NOP,CHO,0,30,9,17,0.529,6,10,0.6,3,7,0.429,1,2,0.5,0,2,2,9,1,0,3,4,22,16.6
Andre Drummond,23-121,C,12/9/16,DET,MIN,1,28,10,13,0.769,10,13,0.769,0,0,,2,4,0.5,8,14,22,0,0,1,1,4,22,24
Giannis Antetokounmpo,22-010,F-G,12/16/16,MIL,CHI,1,35,8,13,0.615,6,10,0.6,2,3,0.667,4,6,0.667,3,4,7,11,3,1,0,2,22,29.2
DeMarcus Cousins,26-181,C-F,2/10/17,SAC,ATL,1,32,6,17,0.353,4,9,0.444,2,8,0.25,8,13,0.615,2,9,11,7,2,1,9,5,22,11.2
Jamal Murray,20-018,G,3/13/17,DEN,LAL,0,30,8,13,0.615,3,5,0.6,5,8,0.625,1,1,1,1,1,2,3,2,1,4,3,22,16.7
George Hill,30-278,G,2/6/17,UTA,ATL,1,35,8,15,0.533,5,7,0.714,3,8,0.375,3,4,0.75,1,3,4,8,1,1,1,2,22,21.4
Rodney Hood,24-013,G-F,11/2/16,UTA,DAL,1,35,9,16,0.563,7,12,0.583,2,4,0.5,2,2,1,1,6,7,3,1,0,3,4,22,15.4
Harrison Barnes,24-227,F,1/12/17,DAL,PHO,1,36,10,17,0.588,9,13,0.692,1,4,0.25,1,2,0.5,1,3,4,5,2,1,0,2,22,20.7
Klay Thompson,27-056,G,4/5/17,GSW,PHO,1,36,9,22,0.409,7,13,0.538,2,9,0.222,2,3,0.667,1,6,7,2,1,1,2,3,22,12.2
DeMar DeRozan,27-175,G,1/29/17,TOR,ORL,1,36,6,18,0.333,6,17,0.353,0,1,0,10,11,0.909,1,6,7,6,0,0,1,3,22,15.9
Harrison Barnes,24-289,F,3/15/17,DAL,WAS,1,40,10,16,0.625,9,14,0.643,1,2,0.5,1,2,0.5,0,9,9,2,0,0,3,1,22,15.1
D'Angelo Russell,21-012,G,3/7/17,LAL,DAL,1,33,8,17,0.471,6,11,0.545,2,6,0.333,4,4,1,0,1,1,4,4,0,0,2,22,19.6
Carmelo Anthony,32-289,F,3/14/17,NYK,IND,1,41,8,17,0.471,5,11,0.455,3,6,0.5,3,5,0.6,0,13,13,1,1,0,2,0,22,16.1
Dion Waiters,25-077,G,2/25/17,MIA,IND,1,31,8,15,0.533,5,9,0.556,3,6,0.5,3,3,1,0,2,2,3,2,0,6,1,22,13
Joel Embiid,22-256,C-F,11/27/16,PHI,CLE,1,25,8,18,0.444,5,14,0.357,3,4,0.75,3,5,0.6,4,5,9,4,0,3,3,2,22,17.2
Bradley Beal,23-181,G,12/26/16,WAS,MIL,1,37,5,14,0.357,2,6,0.333,3,8,0.375,9,10,0.9,1,3,4,5,2,0,3,2,22,17.1
Chris Paul,31-334,G,4/5/17,LAC,DAL,1,33,8,14,0.571,5,9,0.556,3,5,0.6,3,3,1,0,3,3,11,2,0,5,4,22,19.4
Nikola Jokic,22-029,C-F,3/20/17,DEN,HOU,1,40,7,14,0.5,7,11,0.636,0,3,0,8,8,1,1,12,13,8,0,1,5,3,22,19.4
Jamal Murray,19-286,G,12/5/16,DEN,PHI,0,24,8,12,0.667,5,5,1,3,7,0.429,3,3,1,0,3,3,2,0,0,1,0,22,18.1
DeMarcus Cousins,26-085,C-F,11/6/16,SAC,TOR,1,36,7,21,0.333,7,20,0.35,0,1,0,8,11,0.727,5,9,14,4,1,3,0,4,22,19.4
Anthony Davis,23-238,F-C,11/4/16,NOP,PHO,1,43,7,11,0.636,7,10,0.7,0,1,0,8,12,0.667,1,9,10,2,1,4,1,1,22,22.7
DeMarcus Cousins,26-174,C-F,2/3/17,SAC,PHO,1,34,6,16,0.375,3,9,0.333,3,7,0.429,7,9,0.778,1,10,11,12,1,2,5,5,22,19.9
Jordan Clarkson,24-294,G,3/28/17,LAL,WAS,1,39,10,19,0.526,8,14,0.571,2,5,0.4,0,0,,2,2,4,3,0,0,2,1,22,14.4
Kemba Walker,26-235,G,12/29/16,CHO,MIA,1,36,8,20,0.4,4,10,0.4,4,10,0.4,2,2,1,0,7,7,4,1,0,1,1,22,15.7
Sean Kilpatrick,26-326,G,11/27/16,BRK,SAC,1,30,8,13,0.615,5,8,0.625,3,5,0.6,3,3,1,1,4,5,3,2,0,3,1,22,18.7
Jeff Teague,28-222,G,1/18/17,IND,SAC,1,34,5,6,0.833,4,5,0.8,1,1,1,11,11,1,0,7,7,11,2,0,3,3,22,27.4
Paul Millsap,31-282,F,11/18/16,ATL,CHO,1,33,8,13,0.615,7,11,0.636,1,2,0.5,5,6,0.833,4,9,13,1,0,1,2,3,22,19.4
Jordan Clarkson,24-273,G,3/7/17,LAL,DAL,0,34,9,17,0.529,5,9,0.556,4,8,0.5,0,0,,1,0,1,2,0,0,2,2,22,13
Jon Leuer,27-291,F,3/1/17,DET,NOP,1,39,11,23,0.478,11,20,0.55,0,3,0,0,0,,4,3,7,1,3,1,1,4,22,15.8
Austin Rivers,24-114,G,11/23/16,LAC,DAL,0,26,7,11,0.636,1,4,0.25,6,7,0.857,2,3,0.667,0,1,1,1,1,0,0,0,22,18.7
Enes Kanter,24-243,C,1/18/17,OKC,GSW,0,30,11,18,0.611,11,18,0.611,0,0,,0,0,,5,4,9,1,1,0,3,4,22,15.6
Gordon Hayward,26-329,F-G,2/15/17,UTA,POR,1,34,8,18,0.444,6,12,0.5,2,6,0.333,4,6,0.667,1,5,6,7,0,0,0,2,22,18.1
Danilo Gallinari,28-208,F,3/4/17,DEN,CHO,1,33,5,15,0.333,3,7,0.429,2,8,0.25,10,10,1,2,3,5,0,1,0,0,3,22,15.6
Reggie Jackson,26-305,G,2/15/17,DET,DAL,1,28,8,12,0.667,5,8,0.625,3,4,0.75,3,4,0.75,0,0,0,4,2,0,3,2,22,17.4
Julius Randle,22-044,F,1/12/17,LAL,SAS,1,34,8,13,0.615,8,13,0.615,0,0,,6,7,0.857,0,6,6,5,1,0,0,3,22,20.8
Paul George,26-179,F,10/28/16,IND,BRK,1,36,8,22,0.364,6,14,0.429,2,8,0.25,4,4,1,1,8,9,2,2,0,1,2,22,14.5
Kevin Durant,28-039,F-G,11/7/16,GSW,NOP,1,37,8,17,0.471,7,13,0.538,1,4,0.25,5,6,0.833,1,2,3,5,1,1,4,0,22,15.4
DeMarcus Cousins,26-213,C-F,3/14/17,NOP,POR,1,30,9,22,0.409,9,17,0.529,0,5,0,4,10,0.4,1,8,9,3,3,2,0,2,22,16.6
Hollis Thompson,25-212,G-F,11/1/16,PHI,ORL,0,28,8,10,0.8,4,6,0.667,4,4,1,2,2,1,1,6,7,1,0,1,0,2,22,21.3
Brook Lopez,28-261,C,12/18/16,BRK,PHI,1,32,6,14,0.429,5,11,0.455,1,3,0.333,9,10,0.9,3,6,9,8,1,4,1,4,22,24.9
Clint Capela,22-260,F-C,2/2/17,HOU,ATL,1,31,9,11,0.818,9,11,0.818,0,0,,4,5,0.8,5,4,9,0,2,1,2,2,22,22.1
Serge Ibaka,27-083,F-C,12/10/16,ORL,DEN,1,36,9,17,0.529,7,14,0.5,2,3,0.667,2,2,1,1,3,4,0,1,4,0,4,22,17.5
Tristan Thompson,25-330,F-C,2/6/17,CLE,WAS,1,41,10,13,0.769,10,13,0.769,0,0,,2,4,0.5,6,6,12,2,0,0,0,1,22,23.1
Rudy Gay,30-102,F,11/27/16,SAC,BRK,1,32,8,15,0.533,5,10,0.5,3,5,0.6,3,4,0.75,4,4,8,8,1,1,2,1,22,23.2
Ricky Rubio,26-143,G,3/13/17,MIN,WAS,1,39,8,15,0.533,6,10,0.6,2,5,0.4,4,4,1,1,4,5,19,3,0,6,3,22,25.7
Blake Griffin,27-238,F,11/9/16,LAC,POR,1,26,7,14,0.5,7,13,0.538,0,1,0,8,10,0.8,4,9,13,5,2,1,0,0,22,25.9
Emmanuel Mudiay,20-300,G,12/30/16,DEN,PHI,1,29,7,11,0.636,4,6,0.667,3,5,0.6,5,8,0.625,1,3,4,5,1,0,0,4,22,20.4
D'Angelo Russell,20-317,G,1/5/17,LAL,POR,1,35,6,18,0.333,6,10,0.6,0,8,0,10,11,0.909,1,3,4,2,2,0,3,2,22,12.6
Myles Turner,20-263,F-C,12/12/16,IND,CHO,1,34,9,16,0.563,5,9,0.556,4,7,0.571,0,0,,0,7,7,0,1,4,0,3,22,19.1
Andrew Wiggins,21-263,F-G,11/12/16,MIN,LAC,1,37,8,24,0.333,7,20,0.35,1,4,0.25,5,5,1,1,3,4,3,1,0,3,1,22,9.7
Kawhi Leonard,25-262,F,3/18/17,SAS,MEM,1,36,6,15,0.4,4,9,0.444,2,6,0.333,8,9,0.889,1,6,7,3,0,1,4,2,22,14
Karl-Anthony Towns,21-041,C-F,12/26/16,MIN,ATL,1,31,8,8,1,5,5,1,3,3,1,3,3,1,3,8,11,4,0,3,1,5,22,26
C.J. McCollum,25-157,G,2/23/17,POR,ORL,1,37,7,17,0.412,6,14,0.429,1,3,0.333,7,7,1,0,1,1,6,2,1,5,3,22,13.9
Serge Ibaka,27-106,F-C,1/2/17,ORL,NYK,1,31,10,20,0.5,8,15,0.533,2,5,0.4,0,0,,2,4,6,0,0,0,1,4,22,12
Rudy Gay,30-070,F,10/26/16,SAC,PHO,1,33,9,15,0.6,8,12,0.667,1,3,0.333,3,4,0.75,0,3,3,2,0,4,0,1,22,19.4
Wayne Ellington,29-088,G,1/25/17,MIA,BRK,0,36,8,15,0.533,4,8,0.5,4,7,0.571,2,2,1,1,3,4,1,0,0,0,1,22,16.6
Devin Booker,20-092,G,1/30/17,PHO,MEM,1,39,6,20,0.3,6,17,0.353,0,3,0,10,12,0.833,2,4,6,2,1,0,3,1,22,11.2
Jrue Holiday,26-262,G,3/1/17,NOP,DET,1,30,10,18,0.556,8,13,0.615,2,5,0.4,0,0,,1,3,4,5,1,0,5,1,22,14.1
Bojan Bogdanovic,27-295,G-F,2/7/17,BRK,CHO,1,30,8,15,0.533,5,7,0.714,3,8,0.375,3,3,1,0,5,5,1,0,0,3,1,22,13.5
Jamal Crawford,36-290,G,1/4/17,LAC,MEM,0,27,6,12,0.5,3,6,0.5,3,6,0.5,7,7,1,0,1,1,4,0,1,3,2,22,16
Ersan Ilyasova,29-217,F,12/18/16,PHI,BRK,0,31,7,12,0.583,3,5,0.6,4,7,0.571,4,4,1,0,4,4,2,0,1,2,3,22,16.5
Kemba Walker,26-209,G,12/3/16,CHO,MIN,1,37,9,22,0.409,7,16,0.438,2,6,0.333,2,4,0.5,0,4,4,8,0,0,3,4,22,11.6
Tobias Harris,24-172,F,1/3/17,DET,IND,0,30,9,14,0.643,7,9,0.778,2,5,0.4,2,2,1,0,5,5,2,0,0,0,1,22,18.3
Tobias Harris,24-269,F,4/10/17,DET,WAS,0,31,8,17,0.471,5,11,0.455,3,6,0.5,3,3,1,0,5,5,2,2,0,0,0,22,18.2
Dwyane Wade,34-358,G,1/9/17,CHI,OKC,1,28,7,15,0.467,5,12,0.417,2,3,0.667,6,8,0.75,0,4,4,6,0,1,1,1,22,18.2
Jimmy Butler,27-163,G-F,2/24/17,CHI,PHO,1,43,8,21,0.381,7,17,0.412,1,4,0.25,5,6,0.833,2,1,3,9,4,0,3,2,22,18.3
Rashad Vaughn,20-074,G,10/29/16,MIL,BRK,0,27,8,17,0.471,2,5,0.4,6,12,0.5,0,0,,0,2,2,0,0,1,0,2,22,13.8
Bobby Portis,22-036,F,3/18/17,CHI,UTA,0,31,10,13,0.769,9,11,0.818,1,2,0.5,1,2,0.5,1,4,5,0,0,0,0,2,22,17.6
George Hill,30-283,G,2/11/17,UTA,BOS,1,36,7,16,0.438,5,10,0.5,2,6,0.333,6,7,0.857,2,1,3,4,3,0,1,3,22,18.5
Willie Reed,26-235,F-C,1/6/17,MIA,LAL,1,32,10,15,0.667,10,15,0.667,0,0,,2,5,0.4,7,5,12,2,0,3,0,3,22,23
Ian Clark,25-239,G,11/1/16,GSW,POR,0,25,8,8,1,5,5,1,3,3,1,3,3,1,0,2,2,1,3,0,1,2,22,22.1
Will Barton,25-349,G,12/20/16,DEN,LAC,0,32,9,15,0.6,7,10,0.7,2,5,0.4,2,3,0.667,1,4,5,2,2,0,1,2,22,18.2
Mirza Teletovic,31-048,F,11/5/16,MIL,SAC,0,21,7,9,0.778,0,0,,7,9,0.778,1,2,0.5,0,0,0,1,0,1,0,1,22,19.1
Emmanuel Mudiay,20-287,G,12/17/16,DEN,NYK,1,32,10,15,0.667,8,12,0.667,2,3,0.667,0,0,,0,7,7,5,1,0,1,2,22,20.3
Kristaps Porzingis,21-241,F-C,3/31/17,NYK,MIA,1,36,10,18,0.556,8,13,0.615,2,5,0.4,0,0,,2,5,7,3,0,1,4,3,22,13.9
George Hill,30-254,G,1/13/17,UTA,DET,1,27,8,13,0.615,3,7,0.429,5,6,0.833,1,3,0.333,1,3,4,1,0,0,1,1,22,16.2
Sean Kilpatrick,26-336,G,12/7/16,BRK,DEN,1,32,6,10,0.6,4,7,0.571,2,3,0.667,8,8,1,0,6,6,3,1,0,2,2,22,19.5
Ricky Rubio,26-101,G,1/30/17,MIN,ORL,1,36,7,16,0.438,1,7,0.143,6,9,0.667,2,4,0.5,1,7,8,8,0,2,1,6,22,19.2
Aaron Gordon,21-108,F,1/2/17,ORL,NYK,1,32,8,19,0.421,5,9,0.556,3,10,0.3,3,5,0.6,3,3,6,6,1,0,2,1,22,16.9
Paul George,26-303,F,3/1/17,IND,SAS,1,34,5,18,0.278,3,11,0.273,2,7,0.286,10,10,1,0,6,6,2,1,0,3,4,22,11
Malcolm Brogdon,24-028,G,1/8/17,MIL,WAS,1,36,9,15,0.6,7,11,0.636,2,4,0.5,2,2,1,0,1,1,5,3,1,4,2,22,17.8
Devin Booker,20-067,G,1/5/17,PHO,DAL,1,36,9,17,0.529,6,14,0.429,3,3,1,1,1,1,0,2,2,0,0,1,4,2,22,10.2
Eric Gordon,28-011,G,1/5/17,HOU,OKC,0,29,8,20,0.4,3,10,0.3,5,10,0.5,1,1,1,0,5,5,3,0,0,1,2,22,13
Paul Millsap,31-346,F,1/21/17,ATL,PHI,1,36,9,14,0.643,8,12,0.667,1,2,0.5,3,6,0.5,2,8,10,1,1,2,3,1,22,18.1
Bradley Beal,23-230,G,2/13/17,WAS,OKC,1,23,7,8,0.875,1,1,1,6,7,0.857,2,3,0.667,0,0,0,3,0,0,3,4,22,16.3
Anthony Davis,23-315,F-C,1/20/17,NOP,BRK,1,27,10,17,0.588,10,16,0.625,0,1,0,2,3,0.667,2,7,9,4,1,2,2,4,22,18.8
Frank Kaminsky,23-361,F-C,3/31/17,CHO,DEN,0,27,7,13,0.538,2,5,0.4,5,8,0.625,3,3,1,0,2,2,1,0,2,0,4,22,16.8
Carmelo Anthony,32-164,F,11/9/16,NYK,BRK,1,34,9,22,0.409,7,16,0.438,2,6,0.333,2,2,1,1,7,8,2,1,1,0,3,22,14.9
Harrison Barnes,24-177,F,11/23/16,DAL,LAC,1,30,10,19,0.526,8,15,0.533,2,4,0.5,0,0,,0,4,4,2,1,0,1,1,22,14.9
Andrew Wiggins,22-026,F-G,3/21/17,MIN,SAS,1,36,5,15,0.333,5,13,0.385,0,2,0,12,14,0.857,0,4,4,4,1,0,2,3,22,14.5
Giannis Antetokounmpo,22-105,F-G,3/21/17,MIL,POR,1,36,8,21,0.381,8,20,0.4,0,1,0,6,7,0.857,1,7,8,3,0,2,1,4,22,13.8
Evan Fournier,24-123,G-F,3/1/17,ORL,NYK,1,38,8,15,0.533,6,8,0.75,2,7,0.286,4,7,0.571,0,2,2,2,0,0,3,3,22,11.3
Luol Deng,31-239,F,12/11/16,LAL,NYK,1,32,8,13,0.615,3,5,0.6,5,8,0.625,1,1,1,0,5,5,2,2,0,1,1,22,19.6
Dwight Howard,31-111,C,3/29/17,ATL,PHI,1,36,8,17,0.471,8,17,0.471,0,0,,6,7,0.857,8,12,20,4,0,1,1,2,22,23.8
Karl-Anthony Towns,21-089,C-F,2/12/17,MIN,CHI,1,34,8,11,0.727,8,9,0.889,0,2,0,6,6,1,1,6,7,4,1,0,1,1,22,22.4
Mike Conley,29-167,G,3/27/17,MEM,SAC,1,40,8,23,0.348,7,16,0.438,1,7,0.143,5,6,0.833,1,2,3,9,0,0,2,1,22,13.9
Frank Kaminsky,23-281,F-C,1/10/17,CHO,HOU,0,27,8,14,0.571,4,5,0.8,4,9,0.444,2,2,1,0,3,3,1,0,0,1,1,22,15.6
Goran Dragic,30-329,G,3/31/17,MIA,NYK,1,35,8,17,0.471,6,12,0.5,2,5,0.4,4,6,0.667,0,3,3,5,0,0,3,4,22,12.3
Dwyane Wade,34-284,G,10/27/16,CHI,BOS,1,32,7,18,0.389,3,12,0.25,4,6,0.667,4,4,1,2,4,6,5,0,1,3,4,22,14.4
Mike Conley,29-156,G,3/16/17,MEM,ATL,1,33,8,20,0.4,7,15,0.467,1,5,0.2,5,6,0.833,2,2,4,12,1,0,1,1,22,20.8
Paul Millsap,32-058,F,4/9/17,ATL,CLE,1,36,5,11,0.455,4,8,0.5,1,3,0.333,11,11,1,1,8,9,2,1,0,4,4,22,16.2
Seth Curry,26-194,G,3/5/17,DAL,OKC,1,30,10,16,0.625,8,11,0.727,2,5,0.4,0,0,,0,1,1,1,1,0,1,1,22,15.4
Bradley Beal,23-192,G,1/6/17,WAS,MIN,1,34,7,12,0.583,2,5,0.4,5,7,0.714,3,3,1,0,3,3,3,0,0,1,0,22,18.4
Jimmy Butler,27-047,G-F,10/31/16,CHI,BRK,1,27,6,10,0.6,4,7,0.571,2,3,0.667,8,9,0.889,1,5,6,2,0,0,1,3,22,18.4
Willie Reed,26-232,F-C,1/3/17,MIA,PHO,1,32,11,16,0.688,11,16,0.688,0,0,,0,0,,8,10,18,2,1,2,1,2,22,25.8
Klay Thompson,26-350,G,1/23/17,GSW,MIA,1,37,8,18,0.444,5,10,0.5,3,8,0.375,3,4,0.75,0,5,5,1,2,1,2,4,22,13.5
Tony Parker,34-229,G,1/1/17,SAS,ATL,1,32,10,18,0.556,9,16,0.563,1,2,0.5,1,2,0.5,1,2,3,7,0,0,1,1,22,17.8
Jeff Teague,28-243,G,2/8/17,IND,CLE,1,35,7,14,0.5,4,9,0.444,3,5,0.6,5,6,0.833,0,5,5,14,2,0,4,1,22,23.5
Myles Turner,20-326,F-C,2/13/17,IND,SAS,1,36,6,13,0.462,5,12,0.417,1,1,1,9,12,0.75,2,4,6,1,1,0,0,4,22,16.8
Tobias Harris,24-144,F,12/6/16,DET,CHI,1,40,9,16,0.563,7,12,0.583,2,4,0.5,2,2,1,0,7,7,2,1,1,0,1,22,19.2
Nikola Mirotic,26-054,F,4/6/17,CHI,PHI,1,25,8,11,0.727,2,3,0.667,6,8,0.75,0,0,,1,7,8,2,0,1,2,2,22,19.6
Otto Porter,23-278,F,3/8/17,WAS,DEN,1,34,10,15,0.667,8,12,0.667,2,3,0.667,0,0,,1,2,3,1,4,0,0,4,22,19.9
Brandon Ingram,19-177,F,2/26/17,LAL,SAS,1,35,10,15,0.667,9,11,0.818,1,4,0.25,1,1,1,1,1,2,0,0,1,3,4,22,12.6
John Wall,26-197,G,3/22/17,WAS,ATL,1,34,6,21,0.286,5,15,0.333,1,6,0.167,9,12,0.75,0,2,2,10,4,2,4,3,22,16.3
Kevin Love,28-138,F,1/23/17,CLE,NOP,1,38,7,15,0.467,6,10,0.6,1,5,0.2,7,8,0.875,6,10,16,6,0,0,3,1,22,21.9
Paul George,26-221,F,12/9/16,IND,DAL,1,40,8,16,0.5,5,12,0.417,3,4,0.75,3,3,1,0,7,7,0,2,0,3,5,22,13.1
Nick Young,31-170,G-F,11/18/16,LAL,SAS,1,28,7,12,0.583,3,5,0.6,4,7,0.571,4,5,0.8,1,3,4,2,0,1,2,1,22,17.3
Elfrid Payton,23-043,G,4/6/17,ORL,BRK,1,33,8,14,0.571,7,12,0.583,1,2,0.5,5,6,0.833,1,4,5,11,1,1,3,2,22,22.5
Tim Hardaway,25-002,G,3/18/17,ATL,POR,0,29,6,16,0.375,4,10,0.4,2,6,0.333,8,9,0.889,1,1,2,2,1,0,3,0,22,13.2
Kyle O'Quinn,26-262,F-C,12/13/16,NYK,PHO,0,28,9,16,0.563,9,15,0.6,0,1,0,4,6,0.667,5,9,14,2,1,0,1,5,22,19.2
Darren Collison,29-171,G,2/10/17,SAC,ATL,1,44,8,16,0.5,6,11,0.545,2,5,0.4,4,5,0.8,0,3,3,4,2,0,1,5,22,16.3
Bradley Beal,23-243,G,2/26/17,WAS,UTA,1,34,9,16,0.563,6,9,0.667,3,7,0.429,1,2,0.5,1,2,3,4,0,0,0,4,22,16.5
Joe Johnson,35-282,G-F,4/7/17,UTA,MIN,0,33,8,10,0.8,4,5,0.8,4,5,0.8,2,2,1,0,3,3,1,1,1,4,1,22,17.1
James Johnson,30-046,F,4/7/17,MIA,TOR,1,38,8,17,0.471,7,12,0.583,1,5,0.2,5,8,0.625,2,8,10,3,3,2,4,1,22,18
Anthony Davis,23-266,F-C,12/2/16,NOP,LAC,1,32,8,17,0.471,8,17,0.471,0,0,,5,6,0.833,2,3,5,4,1,1,2,2,21,15.9
George Hill,30-298,G,2/26/17,UTA,WAS,1,37,7,13,0.538,2,5,0.4,5,8,0.625,2,4,0.5,0,3,3,6,1,1,5,1,21,15.3
DeMar DeRozan,27-118,G,12/3/16,TOR,ATL,1,31,8,16,0.5,8,15,0.533,0,1,0,5,6,0.833,0,3,3,4,1,0,2,1,21,14.9
Robert Covington,26-046,F,1/29/17,PHI,CHI,1,37,8,16,0.5,4,9,0.444,4,7,0.571,1,3,0.333,2,10,12,3,3,3,1,3,21,21.6
Paul George,26-263,F,1/20/17,IND,LAL,1,36,8,15,0.533,5,8,0.625,3,7,0.429,2,2,1,1,5,6,2,2,1,4,0,21,16
Devin Booker,20-161,G,4/9/17,PHO,DAL,1,23,8,15,0.533,7,11,0.636,1,4,0.25,4,5,0.8,0,2,2,3,0,0,2,1,21,13.6
Mike Conley,29-046,G,11/26/16,MEM,MIA,1,34,6,14,0.429,4,9,0.444,2,5,0.4,7,7,1,0,3,3,7,0,0,1,0,21,18.4
Ryan Anderson,28-308,F,3/10/17,HOU,CHI,1,27,7,15,0.467,1,3,0.333,6,12,0.5,1,1,1,2,1,3,0,1,0,0,0,21,16
Gary Harris,22-189,G,3/22/17,DEN,CLE,1,32,8,14,0.571,5,8,0.625,3,6,0.5,2,2,1,0,3,3,4,0,0,0,2,21,17.3
Paul Millsap,31-301,F,12/7/16,ATL,MIA,1,32,8,12,0.667,8,10,0.8,0,2,0,5,6,0.833,1,8,9,2,4,3,2,2,21,23.2
Ian Clark,25-261,G,11/23/16,GSW,LAL,0,18,7,8,0.875,2,3,0.667,5,5,1,2,4,0.5,0,1,1,1,0,0,1,0,21,17.4
Paul George,26-280,F,2/6/17,IND,OKC,1,33,7,20,0.35,5,11,0.455,2,9,0.222,5,6,0.833,4,4,8,4,2,0,5,3,21,12
Serge Ibaka,27-064,F-C,11/21/16,ORL,MIL,1,37,6,11,0.545,3,7,0.429,3,4,0.75,6,6,1,2,7,9,1,2,3,3,3,21,19.8
Kentavious Caldwell-Pope,23-327,G,1/10/17,DET,SAC,1,40,6,12,0.5,0,4,0,6,8,0.75,3,3,1,1,4,5,2,1,0,2,2,21,16.5
Tim Hardaway,24-276,G,12/17/16,ATL,CHO,1,33,7,17,0.412,3,8,0.375,4,9,0.444,3,6,0.5,0,4,4,4,0,1,0,1,21,15
Thaddeus Young,28-182,F,12/20/16,IND,NYK,1,37,9,17,0.529,7,12,0.583,2,5,0.4,1,2,0.5,2,5,7,1,2,0,1,2,21,16.1
Paul Millsap,32-003,F,2/13/17,ATL,POR,1,41,4,12,0.333,3,9,0.333,1,3,0.333,12,12,1,1,8,9,5,2,5,1,3,21,24.1
Jimmy Butler,27-175,G-F,3/8/17,CHI,ORL,1,38,7,21,0.333,4,13,0.308,3,8,0.375,4,5,0.8,1,3,4,9,1,1,5,0,21,13.3
Devin Booker,20-157,G,4/5/17,PHO,GSW,1,42,7,24,0.292,5,17,0.294,2,7,0.286,5,7,0.714,1,2,3,5,3,0,2,3,21,10.8
Marc Gasol,31-282,C,11/6/16,MEM,POR,1,28,7,14,0.5,6,12,0.5,1,2,0.5,6,8,0.75,0,3,3,2,1,0,2,2,21,13.7
Devin Booker,19-364,G,10/28/16,PHO,OKC,1,44,8,25,0.32,6,17,0.353,2,8,0.25,3,5,0.6,2,4,6,1,0,0,1,3,21,7
LaMarcus Aldridge,31-242,F-C,3/18/17,SAS,MEM,1,34,9,18,0.5,9,18,0.5,0,0,,3,3,1,1,8,9,4,0,1,2,1,21,16.2
Eric Gordon,27-313,G,11/2/16,HOU,NYK,1,29,6,11,0.545,2,4,0.5,4,7,0.571,5,6,0.833,0,3,3,1,1,0,2,3,21,14.7
Dwyane Wade,35-007,G,1/24/17,CHI,ORL,1,34,9,23,0.391,8,22,0.364,1,1,1,2,2,1,2,5,7,3,7,1,3,3,21,17
Avery Bradley,25-349,G,11/9/16,BOS,WAS,1,38,9,14,0.643,6,7,0.857,3,7,0.429,0,1,0,1,2,3,2,2,1,1,3,21,17.6
Elfrid Payton,23-049,G,4/12/17,ORL,DET,1,31,10,18,0.556,9,17,0.529,1,1,1,0,0,,0,5,5,13,0,0,1,3,21,20.8
Marcin Gortat,32-351,C-F,2/2/17,WAS,LAL,1,33,10,13,0.769,10,13,0.769,0,0,,1,1,1,6,8,14,3,2,0,1,3,21,24.4
Brook Lopez,28-269,C,12/26/16,BRK,CHO,1,33,8,13,0.615,7,10,0.7,1,3,0.333,4,4,1,2,3,5,5,0,3,2,1,21,20.6
Damian Lillard,26-174,G,1/5/17,POR,LAL,1,36,7,14,0.5,3,4,0.75,4,10,0.4,3,4,0.75,0,5,5,10,0,0,2,3,21,18.9
Dennis Schroder,23-097,G,12/21/16,ATL,MIN,1,37,10,21,0.476,9,14,0.643,1,7,0.143,0,0,,0,1,1,7,0,0,1,1,21,14.1
Tobias Harris,24-134,F,11/26/16,DET,OKC,1,39,8,18,0.444,7,14,0.5,1,4,0.25,4,5,0.8,0,4,4,1,3,0,1,3,21,13.9
T.J. Warren,23-151,F,2/3/17,PHO,SAC,1,36,7,13,0.538,6,10,0.6,1,3,0.333,6,6,1,2,3,5,1,1,0,1,2,21,16.9
Harrison Barnes,24-211,F,12/27/16,DAL,HOU,1,32,7,16,0.438,6,13,0.462,1,3,0.333,6,6,1,0,3,3,1,0,0,0,2,21,13.4
LaMarcus Aldridge,31-105,F-C,11/1/16,SAS,UTA,1,35,8,16,0.5,8,15,0.533,0,1,0,5,5,1,0,4,4,1,0,1,0,0,21,15.6
Kevin Love,28-193,F,3/19/17,CLE,LAL,1,26,6,15,0.4,3,8,0.375,3,7,0.429,6,7,0.857,4,11,15,0,0,0,1,2,21,16.8
Jordan Clarkson,24-283,G,3/17/17,LAL,MIL,1,38,8,20,0.4,4,9,0.444,4,11,0.364,1,1,1,1,4,5,2,1,1,3,2,21,11.4
Jabari Parker,21-231,F,11/1/16,MIL,NOP,1,29,7,14,0.5,7,13,0.538,0,1,0,7,7,1,1,1,2,0,0,0,1,1,21,13.6
T.J. Warren,23-202,F,3/26/17,PHO,CHO,1,39,9,16,0.563,9,16,0.563,0,0,,3,3,1,4,6,10,2,4,0,0,2,21,22.6
Rudy Gay,30-083,F,11/8/16,SAC,NOP,1,33,7,16,0.438,5,12,0.417,2,4,0.5,5,5,1,0,6,6,6,2,1,0,1,21,20.9
Tim Hardaway,24-225,G,10/27/16,ATL,WAS,0,23,8,13,0.615,5,8,0.625,3,5,0.6,2,2,1,1,1,2,1,0,0,0,0,21,16.8
Lou Williams,30-014,G,11/10/16,LAL,SAC,0,23,6,12,0.5,3,6,0.5,3,6,0.5,6,8,0.75,0,2,2,1,3,0,5,0,21,13.5
Jae Crowder,26-208,F,1/30/17,BOS,DET,1,36,6,12,0.5,2,6,0.333,4,6,0.667,5,8,0.625,1,7,8,0,1,0,1,1,21,16.2
Will Barton,26-001,G,1/7/17,DEN,OKC,1,28,6,11,0.545,3,6,0.5,3,5,0.6,6,6,1,2,5,7,1,1,0,2,3,21,17.1
Devin Booker,20-081,G,1/19/17,PHO,CLE,1,37,4,13,0.308,4,9,0.444,0,4,0,13,14,0.929,1,6,7,8,0,0,4,3,21,16
Rodney Stuckey,30-214,G,11/21/16,IND,GSW,0,24,7,12,0.583,7,9,0.778,0,3,0,7,8,0.875,0,2,2,2,0,0,0,4,21,15.4
Giannis Antetokounmpo,22-053,F-G,1/28/17,MIL,BOS,1,45,8,16,0.5,6,13,0.462,2,3,0.667,3,4,0.75,0,6,6,6,0,1,2,2,21,16.5
Buddy Hield,22-364,G,12/15/16,NOP,IND,1,33,8,17,0.471,3,9,0.333,5,8,0.625,0,0,,2,2,4,2,0,0,2,2,21,12.9
LaMarcus Aldridge,31-120,F-C,11/16/16,SAS,SAC,1,33,8,16,0.5,7,15,0.467,1,1,1,4,4,1,2,6,8,2,2,2,2,3,21,17.8
Evan Fournier,24-101,G-F,2/7/17,ORL,HOU,1,37,7,16,0.438,6,8,0.75,1,8,0.125,6,6,1,1,2,3,3,0,1,3,4,21,12.1
Klay Thompson,27-038,G,3/18/17,GSW,MIL,1,34,9,16,0.563,6,10,0.6,3,6,0.5,0,1,0,2,1,3,1,0,1,0,1,21,15.7
Lou Williams,30-031,G,11/27/16,LAL,ATL,0,27,5,13,0.385,3,7,0.429,2,6,0.333,9,9,1,0,4,4,3,0,0,1,2,21,15.4
Dwight Powell,25-263,F-C,4/9/17,DAL,PHO,0,32,8,14,0.571,4,6,0.667,4,8,0.5,1,3,0.333,0,5,5,2,2,1,2,2,21,16.4
Evan Fournier,24-054,G-F,12/22/16,ORL,NYK,1,36,9,17,0.529,8,12,0.667,1,5,0.2,2,2,1,1,4,5,4,0,1,2,2,21,15.3
Jordan Crawford,28-167,G,4/8/17,NOP,GSW,0,30,8,16,0.5,7,11,0.636,1,5,0.2,4,5,0.8,0,1,1,2,1,0,2,1,21,12.9
Jimmy Butler,27-092,G-F,12/15/16,CHI,MIL,1,38,6,16,0.375,5,13,0.385,1,3,0.333,8,10,0.8,0,3,3,3,2,0,2,1,21,14
Marcus Smart,23-000,G,3/6/17,BOS,LAC,0,32,6,12,0.5,5,7,0.714,1,5,0.2,8,9,0.889,0,3,3,3,1,0,1,4,21,16
Kristaps Porzingis,21-099,F-C,11/9/16,NYK,BRK,1,31,7,15,0.467,3,7,0.429,4,8,0.5,3,5,0.6,1,7,8,1,2,2,2,2,21,16.6
Paul Millsap,32-014,F,2/24/17,ATL,MIA,1,28,6,9,0.667,6,9,0.667,0,0,,9,14,0.643,0,4,4,1,1,0,2,2,21,15.2
John Wall,26-062,G,11/7/16,WAS,HOU,1,35,9,16,0.563,8,14,0.571,1,2,0.5,2,2,1,1,4,5,9,2,0,6,2,21,16.8
Lou Williams,30-016,G,11/12/16,LAL,NOP,0,25,9,15,0.6,7,10,0.7,2,5,0.4,1,1,1,0,3,3,4,2,0,0,1,21,19.4
Al Horford,30-214,C-F,1/3/17,BOS,UTA,1,31,9,16,0.563,6,10,0.6,3,6,0.5,0,0,,1,4,5,4,1,0,1,5,21,16.1
Kevin Love,28-091,F,12/7/16,CLE,NYK,1,27,6,16,0.375,2,4,0.5,4,12,0.333,5,5,1,1,2,3,2,2,0,2,0,21,14.9
Mike Conley,29-084,G,1/3/17,MEM,LAL,1,32,7,16,0.438,4,9,0.444,3,7,0.429,4,4,1,0,1,1,4,0,0,2,1,21,13.3
Robert Covington,26-104,F,3/28/17,PHI,BRK,1,38,9,15,0.6,8,9,0.889,1,6,0.167,2,2,1,3,10,13,1,2,2,1,4,21,20.7
Kyle Lowry,30-327,G,2/15/17,TOR,CHO,1,41,8,20,0.4,4,9,0.444,4,11,0.364,1,1,1,0,6,6,6,1,0,1,3,21,15
Al Horford,30-185,C-F,12/5/16,BOS,HOU,1,35,9,22,0.409,8,17,0.471,1,5,0.2,2,2,1,1,5,6,9,1,2,4,3,21,14.9
Kevin Durant,28-139,F-G,2/15/17,GSW,SAC,1,32,10,15,0.667,9,11,0.818,1,4,0.25,0,0,,0,7,7,7,1,4,1,1,21,23.9
Kemba Walker,26-234,G,12/28/16,CHO,ORL,1,25,8,12,0.667,6,6,1,2,6,0.333,3,3,1,0,3,3,5,0,0,1,1,21,18.8
Ricky Rubio,26-158,G,3/28/17,MIN,IND,1,38,4,12,0.333,4,11,0.364,0,1,0,13,13,1,2,3,5,11,0,0,5,4,21,17.6
Derrick Rose,28-039,G,11/12/16,NYK,TOR,1,38,10,20,0.5,10,17,0.588,0,3,0,1,2,0.5,2,2,4,4,0,0,4,0,21,11.4
Nikola Jokic,21-318,C-F,1/2/17,DEN,GSW,1,25,8,17,0.471,7,15,0.467,1,2,0.5,4,4,1,8,5,13,5,1,0,2,2,21,21.1
Devin Booker,20-034,G,12/3/16,PHO,GSW,1,33,8,17,0.471,7,12,0.583,1,5,0.2,4,5,0.8,1,0,1,5,0,0,2,4,21,12.5
Vince Carter,40-062,G-F,3/29/17,MEM,IND,1,33,5,8,0.625,1,2,0.5,4,6,0.667,7,7,1,1,7,8,0,1,0,1,1,21,19.8
Darren Collison,29-145,G,1/15/17,SAC,OKC,1,27,7,9,0.778,5,6,0.833,2,3,0.667,5,6,0.833,0,1,1,2,2,0,1,4,21,18.2
Nene Hilario,34-136,F-C,1/27/17,HOU,PHI,1,27,10,13,0.769,10,13,0.769,0,0,,1,1,1,2,4,6,2,0,1,3,5,21,15.6
Davis Bertans,24-056,F,1/7/17,SAS,CHO,0,18,5,6,0.833,1,1,1,4,5,0.8,7,8,0.875,0,1,1,2,1,0,0,2,21,20.3
Nikola Vucevic,26-108,C,2/9/17,ORL,PHI,1,31,10,13,0.769,10,13,0.769,0,0,,1,3,0.333,1,10,11,3,1,2,4,3,21,18.1
Bobby Portis,22-051,F,4/2/17,CHI,NOP,0,31,9,15,0.6,6,10,0.6,3,5,0.6,0,0,,1,10,11,0,0,0,0,4,21,16.2
Aaron Gordon,21-120,F,1/14/17,ORL,UTA,1,39,8,14,0.571,5,8,0.625,3,6,0.5,2,3,0.667,0,4,4,2,1,0,0,3,21,16.4
Harrison Barnes,24-200,F,12/16/16,DAL,UTA,1,37,10,22,0.455,9,19,0.474,1,3,0.333,0,0,,1,2,3,3,2,0,1,2,21,13.2
Hassan Whiteside,27-144,C,11/4/16,MIA,TOR,1,38,10,18,0.556,10,18,0.556,0,0,,1,3,0.333,5,11,16,3,2,1,3,5,21,18.2
Andrew Wiggins,21-346,F-G,2/3/17,MIN,DET,1,40,8,20,0.4,8,17,0.471,0,3,0,5,5,1,1,2,3,1,0,0,1,2,21,10.4
Andrew Wiggins,21-338,F-G,1/26/17,MIN,IND,1,39,7,17,0.412,6,13,0.462,1,4,0.25,6,7,0.857,1,4,5,2,1,0,3,3,21,11.6
Enes Kanter,24-238,C,1/13/17,OKC,MIN,0,30,8,10,0.8,7,9,0.778,1,1,1,4,5,0.8,6,2,8,2,0,0,3,4,21,18.4
Marco Belinelli,31-004,G-F,3/29/17,CHO,TOR,0,27,7,11,0.636,5,7,0.714,2,4,0.5,5,6,0.833,0,0,0,5,1,1,1,0,21,19.9
Paul Millsap,31-272,F,11/8/16,ATL,CLE,1,36,7,16,0.438,5,12,0.417,2,4,0.5,5,6,0.833,1,4,5,1,0,0,3,5,21,9.8
Danilo Gallinari,28-102,F,11/18/16,DEN,TOR,1,43,4,13,0.308,4,8,0.5,0,5,0,13,13,1,0,9,9,1,1,0,4,1,21,13.5
Kristaps Porzingis,21-102,F-C,11/12/16,NYK,TOR,1,30,9,16,0.563,7,8,0.875,2,8,0.25,1,1,1,1,3,4,2,0,0,2,5,21,12.4
Joe Ingles,29-067,F-G,12/8/16,UTA,GSW,0,35,7,13,0.538,2,4,0.5,5,9,0.556,2,3,0.667,0,5,5,3,4,1,2,4,21,19
Kevin Durant,28-070,F-G,12/8/16,GSW,UTA,1,36,7,15,0.467,6,12,0.5,1,3,0.333,6,8,0.75,0,11,11,4,1,2,3,2,21,17.2
Langston Galloway,24-341,G,11/14/16,NOP,BOS,0,32,8,14,0.571,5,9,0.556,3,5,0.6,2,2,1,0,1,1,3,2,0,2,3,21,15.6
Robin Lopez,28-303,C,1/29/17,CHI,PHI,1,31,9,13,0.692,9,13,0.692,0,0,,3,3,1,5,5,10,2,0,3,0,2,21,23.2
Leandro Barbosa,34-011,G,12/9/16,PHO,LAL,0,29,8,16,0.5,3,9,0.333,5,7,0.714,0,0,,0,2,2,4,2,0,0,0,21,18.4
Andrew Wiggins,22-020,F-G,3/15/17,MIN,BOS,1,39,9,23,0.391,7,19,0.368,2,4,0.5,1,4,0.25,1,3,4,4,0,0,1,3,21,9.5
Kemba Walker,26-189,G,11/13/16,CHO,CLE,1,32,8,20,0.4,4,12,0.333,4,8,0.5,1,1,1,0,2,2,4,1,0,0,1,21,14.2
Wesley Matthews,30-044,G,11/27/16,DAL,NOP,1,39,7,14,0.5,1,6,0.167,6,8,0.75,1,2,0.5,1,2,3,3,0,0,1,2,21,15.2
Clint Capela,22-193,F-C,11/27/16,HOU,POR,1,33,9,12,0.75,9,12,0.75,0,0,,3,4,0.75,3,6,9,0,0,2,0,3,21,19.9
Zach LaVine,21-291,G,12/26/16,MIN,ATL,1,31,7,16,0.438,1,7,0.143,6,9,0.667,1,1,1,0,1,1,3,1,0,4,1,21,11.6
Klay Thompson,27-019,G,2/27/17,GSW,PHI,1,36,7,17,0.412,4,8,0.5,3,9,0.333,4,4,1,1,2,3,2,2,0,2,1,21,14.2
Danilo Gallinari,28-228,F,3/24/17,DEN,IND,1,35,2,12,0.167,2,6,0.333,0,6,0,17,18,0.944,1,10,11,2,1,2,1,0,21,19.5
Bojan Bogdanovic,27-296,G-F,2/8/17,BRK,WAS,1,34,6,18,0.333,4,9,0.444,2,9,0.222,7,7,1,2,3,5,4,2,0,1,4,21,15.3
Otto Porter,23-167,F,11/17/16,WAS,NYK,1,39,8,14,0.571,4,9,0.444,4,5,0.8,1,1,1,1,7,8,1,2,1,2,2,21,17.8
Kenneth Faried,27-070,F,1/28/17,DEN,PHO,1,37,6,9,0.667,6,9,0.667,0,0,,9,11,0.818,3,11,14,2,2,2,0,3,21,25.3
Ersan Ilyasova,29-265,F,2/4/17,PHI,MIA,1,27,7,15,0.467,4,8,0.5,3,7,0.429,4,5,0.8,1,4,5,2,0,0,2,1,21,13.8
LeBron James,31-303,F-G,10/28/16,CLE,TOR,1,39,7,16,0.438,5,10,0.5,2,6,0.333,5,7,0.714,2,6,8,7,0,0,5,2,21,14.1
Gordon Hayward,27-016,F-G,4/8/17,UTA,POR,1,31,7,14,0.5,6,12,0.5,1,2,0.5,6,8,0.75,0,5,5,4,0,0,2,2,21,14.7
Norman Powell,23-209,G,12/20/16,TOR,BRK,0,27,7,13,0.538,6,11,0.545,1,2,0.5,6,7,0.857,0,3,3,1,5,0,1,3,21,18.7
Kevin Durant,28-109,F-G,1/16/17,GSW,CLE,1,29,9,16,0.563,6,9,0.667,3,7,0.429,0,0,,1,5,6,5,2,3,1,0,21,22.2
C.J. McCollum,25-055,G,11/13/16,POR,DEN,1,35,9,23,0.391,7,18,0.389,2,5,0.4,1,2,0.5,2,1,3,4,1,1,2,3,21,11.1
Sean Kilpatrick,26-334,G,12/5/16,BRK,WAS,1,33,8,12,0.667,6,8,0.75,2,4,0.5,3,3,1,1,5,6,4,1,0,2,1,21,19.4
Emmanuel Mudiay,20-238,G,10/29/16,DEN,POR,1,38,7,20,0.35,5,16,0.313,2,4,0.5,5,6,0.833,0,7,7,4,3,0,5,3,21,11.1
Kentavious Caldwell-Pope,23-360,G,2/12/17,DET,TOR,1,41,8,22,0.364,6,10,0.6,2,12,0.167,3,3,1,0,0,0,2,0,0,1,2,21,8.4
Marcus Morris,27-132,F,1/12/17,DET,GSW,1,34,9,17,0.529,8,11,0.727,1,6,0.167,2,2,1,1,4,5,3,1,0,2,1,21,15.3
Devin Booker,20-106,G,2/13/17,PHO,NOP,1,36,9,19,0.474,7,13,0.538,2,6,0.333,1,1,1,0,1,1,3,1,1,5,4,21,8.8
Jonas Valanciunas,24-276,C,2/6/17,TOR,LAC,1,32,9,13,0.692,9,13,0.692,0,0,,3,4,0.75,3,9,12,2,0,1,1,1,21,20.6
Paul George,26-310,F,3/8/17,IND,DET,1,29,7,12,0.583,4,7,0.571,3,5,0.6,4,4,1,0,8,8,2,0,0,1,2,21,17.4
Terrence Ross,25-354,F-G,1/24/17,TOR,SAS,0,30,6,10,0.6,3,3,1,3,7,0.429,6,8,0.75,0,1,1,0,1,2,3,3,21,14.1
Marc Gasol,31-280,C,11/4/16,MEM,LAC,1,37,7,18,0.389,6,14,0.429,1,4,0.25,6,6,1,1,9,10,4,1,2,2,2,21,17
Stephen Curry,29-012,G,3/26/17,GSW,MEM,1,36,8,18,0.444,3,6,0.5,5,12,0.417,0,0,,0,1,1,11,4,0,5,1,21,18.2
Andre Drummond,23-187,C,2/13/17,DET,MIL,1,34,8,16,0.5,8,16,0.5,0,0,,5,9,0.556,5,7,12,0,3,0,4,3,21,14.8
Russell Westbrook,28-058,G,1/9/17,OKC,CHI,1,33,9,18,0.5,8,11,0.727,1,7,0.143,2,3,0.667,0,9,9,14,1,0,4,2,21,20.3
Elfrid Payton,22-343,G,1/30/17,ORL,MIN,1,30,9,17,0.529,7,12,0.583,2,5,0.4,1,2,0.5,0,4,4,3,3,0,1,5,21,15.6
Bradley Beal,23-176,G,12/21/16,WAS,CHI,1,37,7,17,0.412,6,10,0.6,1,7,0.143,6,8,0.75,0,0,0,5,2,0,2,2,21,13.8
Harrison Barnes,24-284,F,3/10/17,DAL,BRK,1,37,7,15,0.467,5,12,0.417,2,3,0.667,5,5,1,1,6,7,0,0,0,3,1,21,12.4
Jrue Holiday,26-280,G,3/19/17,NOP,MIN,1,35,8,16,0.5,4,11,0.364,4,5,0.8,1,2,0.5,0,4,4,7,1,0,2,1,21,17.3
Jamal Crawford,36-319,G,2/2/17,LAC,GSW,0,34,7,11,0.636,2,3,0.667,5,8,0.625,2,3,0.667,0,2,2,4,0,1,4,2,21,15
Reggie Jackson,26-322,G,3/4/17,DET,PHI,1,25,9,14,0.643,6,10,0.6,3,4,0.75,0,0,,1,3,4,2,0,1,3,2,21,14.7
Michael Carter-Williams,25-119,G,2/6/17,CHI,SAC,1,31,8,12,0.667,7,10,0.7,1,2,0.5,4,4,1,0,6,6,4,2,1,0,1,21,22.7
Terrence Jones,24-347,F,12/21/16,NOP,OKC,0,34,9,17,0.529,9,16,0.563,0,1,0,3,5,0.6,0,2,2,1,1,1,1,0,21,13.9
Evan Fournier,24-135,G-F,3/13/17,ORL,SAC,1,30,8,18,0.444,4,7,0.571,4,11,0.364,1,1,1,3,2,5,0,1,0,3,3,21,11.1
Ish Smith,28-268,G,3/30/17,DET,BRK,1,32,9,18,0.5,6,14,0.429,3,4,0.75,0,0,,0,6,6,5,0,1,0,1,21,17.6
Dario Saric,22-325,F,2/27/17,PHI,GSW,1,35,6,15,0.4,6,9,0.667,0,6,0,9,10,0.9,3,4,7,7,1,0,2,4,21,18.1
Nicolas Batum,28-080,F-G,3/4/17,CHO,DEN,1,35,7,11,0.636,3,5,0.6,4,6,0.667,3,3,1,0,2,2,8,0,0,2,2,21,19.5
Tony Parker,34-320,G,4/2/17,SAS,UTA,1,30,7,15,0.467,7,15,0.467,0,0,,7,9,0.778,0,5,5,5,0,0,4,3,21,12.3
Karl-Anthony Towns,21-140,C-F,4/4/17,MIN,GSW,1,28,8,10,0.8,7,9,0.778,1,1,1,4,5,0.8,2,4,6,4,2,2,3,2,21,21.8
Paul Zipser,23-053,G-F,4/12/17,CHI,BRK,0,28,8,13,0.615,3,6,0.5,5,7,0.714,0,0,,0,6,6,2,0,0,0,3,21,17.1
Clint Capela,22-314,F-C,3/28/17,HOU,GSW,1,30,9,10,0.9,9,10,0.9,0,0,,3,4,0.75,3,4,7,0,0,1,2,4,21,17.6
Victor Oladipo,24-183,G,11/3/16,OKC,GSW,1,30,8,13,0.615,4,7,0.571,4,6,0.667,1,4,0.25,0,3,3,0,0,0,0,2,21,14
LeBron James,31-324,F-G,11/18/16,CLE,DET,1,28,9,14,0.643,8,11,0.727,1,3,0.333,2,3,0.667,0,3,3,3,0,1,2,1,21,15.7
Jeremy Lamb,24-316,G-F,4/11/17,CHO,ATL,0,33,7,18,0.389,6,11,0.545,1,7,0.143,6,6,1,2,3,5,2,2,0,3,1,21,13.5
Klay Thompson,26-360,G,2/2/17,GSW,LAC,1,33,9,19,0.474,6,13,0.462,3,6,0.5,0,0,,3,4,7,2,0,0,2,2,21,13.2
Blake Griffin,27-229,F,10/31/16,LAC,PHO,1,32,4,7,0.571,3,6,0.5,1,1,1,12,14,0.857,0,11,11,5,0,1,5,5,21,17.4
Darren Collison,29-092,G,11/23/16,SAC,OKC,1,31,7,12,0.583,4,7,0.571,3,5,0.6,4,4,1,0,0,0,6,0,0,4,0,21,15.6
Kawhi Leonard,25-154,F,11/30/16,SAS,DAL,1,31,5,16,0.313,3,11,0.273,2,5,0.4,9,12,0.75,1,6,7,2,2,0,2,1,21,14.1
Giannis Antetokounmpo,22-088,F-G,3/4/17,MIL,TOR,1,35,8,13,0.615,8,13,0.615,0,0,,5,6,0.833,2,8,10,4,0,1,1,2,21,20.2
Channing Frye,33-328,C-F,4/10/17,CLE,MIA,1,33,6,10,0.6,3,5,0.6,3,5,0.6,6,6,1,1,6,7,0,1,0,2,4,21,16.3
Channing Frye,33-182,C-F,11/15/16,CLE,TOR,0,20,7,10,0.7,2,2,1,5,8,0.625,2,2,1,1,2,3,1,0,1,0,2,21,18.7
Damian Lillard,26-213,G,2/13/17,POR,ATL,1,41,6,21,0.286,3,12,0.25,3,9,0.333,6,6,1,1,5,6,4,1,0,3,2,21,10.9
T.J. Warren,23-216,F,4/9/17,PHO,DAL,1,29,8,8,1,6,6,1,2,2,1,3,3,1,0,7,7,0,2,0,0,1,21,22.3
Norman Powell,23-282,G,3/3/17,TOR,WAS,0,25,7,12,0.583,5,8,0.625,2,4,0.5,5,5,1,1,5,6,1,1,0,0,4,21,17.7
DeMarcus Cousins,26-130,C-F,12/21/16,SAC,UTA,1,31,5,18,0.278,4,15,0.267,1,3,0.333,10,13,0.769,1,7,8,3,0,1,3,2,21,11
Khris Middleton,25-201,F-G,3/1/17,MIL,DEN,0,31,7,12,0.583,4,9,0.444,3,3,1,4,5,0.8,1,4,5,5,2,0,3,3,21,18.2
Markieff Morris,27-149,F,1/29/17,WAS,NOP,1,37,9,20,0.45,6,17,0.353,3,3,1,0,0,,3,5,8,1,0,0,0,3,21,13.7
Norman Powell,23-245,G,1/25/17,TOR,MEM,1,33,9,21,0.429,7,17,0.412,2,4,0.5,1,4,0.25,3,2,5,2,1,0,1,3,21,11.6
Harrison Barnes,24-297,F,3/23/17,DAL,LAC,1,38,9,18,0.5,8,16,0.5,1,2,0.5,2,2,1,0,2,2,0,2,0,2,2,21,11.8
Ersan Ilyasova,29-174,F,11/5/16,PHI,CLE,0,28,8,13,0.615,4,7,0.571,4,6,0.667,1,2,0.5,2,2,4,0,0,0,0,3,21,15.5
Nikola Vucevic,26-030,C,11/23/16,ORL,PHO,1,29,10,15,0.667,10,15,0.667,0,0,,1,2,0.5,3,11,14,2,1,1,0,2,21,21.8
LaMarcus Aldridge,31-227,F-C,3/3/17,SAS,NOP,1,40,10,19,0.526,10,19,0.526,0,0,,1,4,0.25,5,9,14,0,0,3,2,3,21,15.6
Frank Kaminsky,23-243,F-C,12/3/16,CHO,MIN,1,31,8,16,0.5,5,9,0.556,3,7,0.429,2,4,0.5,2,7,9,5,1,1,1,3,21,18.7
Andrew Wiggins,22-048,F-G,4/12/17,MIN,HOU,1,30,7,17,0.412,5,12,0.417,2,5,0.4,5,7,0.714,0,2,2,3,1,0,4,2,21,10
Klay Thompson,26-324,G,12/28/16,GSW,TOR,1,35,8,18,0.444,3,11,0.273,5,7,0.714,0,0,,1,5,6,2,1,2,2,3,21,14.4
Shabazz Muhammad,24-122,F-G,3/15/17,MIN,BOS,0,31,7,14,0.5,7,9,0.778,0,5,0,7,8,0.875,2,1,3,1,0,1,0,0,21,16.7
Anthony Morrow,31-060,G,11/26/16,OKC,DET,0,26,8,12,0.667,5,6,0.833,3,6,0.5,2,2,1,0,1,1,1,0,0,0,1,21,16.4
Brandon Jennings,27-130,G,1/31/17,NYK,WAS,1,38,5,16,0.313,3,10,0.3,2,6,0.333,9,11,0.818,2,3,5,2,4,0,4,2,21,13.9
Karl-Anthony Towns,21-000,C-F,11/15/16,MIN,CHO,1,37,9,23,0.391,6,13,0.462,3,10,0.3,0,0,,3,5,8,4,0,1,3,2,21,11.8
Andrew Wiggins,21-307,F-G,12/26/16,MIN,ATL,1,28,7,14,0.5,3,8,0.375,4,6,0.667,3,4,0.75,1,3,4,2,1,0,0,2,21,16.8
Aaron Gordon,21-202,F,4/6/17,ORL,BRK,1,33,9,15,0.6,9,12,0.75,0,3,0,3,4,0.75,2,4,6,2,3,0,1,4,21,18.1
LaMarcus Aldridge,31-189,F-C,1/24/17,SAS,TOR,1,32,6,14,0.429,6,14,0.429,0,0,,9,11,0.818,1,6,7,2,1,0,1,4,21,15.1
George Hill,30-239,G,12/29/16,UTA,PHI,1,29,8,10,0.8,6,8,0.75,2,2,1,3,6,0.5,1,7,8,6,3,1,2,1,21,24.3
Seth Curry,26-190,G,3/1/17,DAL,ATL,1,35,7,13,0.538,2,5,0.4,5,8,0.625,2,2,1,2,2,4,3,2,0,2,1,21,18.4
Anthony Davis,23-313,F-C,1/18/17,NOP,ORL,1,29,9,17,0.529,9,17,0.529,0,0,,3,4,0.75,2,11,13,4,0,1,2,1,21,18.1
Kristaps Porzingis,21-118,F-C,11/28/16,NYK,OKC,1,39,9,20,0.45,6,14,0.429,3,6,0.5,0,0,,1,4,5,2,2,5,2,2,21,16.6
Jeff Teague,28-287,G,3/24/17,IND,DEN,1,33,9,16,0.563,7,11,0.636,2,5,0.4,1,2,0.5,0,2,2,8,2,1,3,5,21,16.9
Norman Powell,23-235,G,1/15/17,TOR,NYK,0,24,7,12,0.583,6,9,0.667,1,3,0.333,6,6,1,1,0,1,0,1,0,2,2,21,14.3
Gorgui Dieng,26-363,C,1/15/17,MIN,DAL,1,31,10,12,0.833,10,11,0.909,0,1,0,1,3,0.333,5,3,8,0,1,0,0,1,21,20.8
Marcin Gortat,32-289,C-F,12/2/16,WAS,SAS,1,42,8,16,0.5,8,16,0.5,0,0,,5,6,0.833,6,12,18,2,2,2,2,6,21,20.8
Reggie Jackson,26-327,G,3/9/17,DET,CLE,1,31,8,16,0.5,7,13,0.538,1,3,0.333,4,4,1,1,1,2,5,1,0,3,3,21,14.3
Markieff Morris,27-218,F,4/8/17,WAS,MIA,1,30,9,13,0.692,6,9,0.667,3,4,0.75,0,0,,2,3,5,0,1,0,2,3,21,15.6
James Harden,27-105,G,12/9/16,HOU,OKC,1,37,6,23,0.261,4,12,0.333,2,11,0.182,7,8,0.875,1,8,9,12,2,0,8,5,21,10.4
Jeff Teague,28-209,G,1/5/17,IND,BRK,1,31,9,13,0.692,7,11,0.636,2,2,1,1,1,1,0,7,7,15,1,1,3,0,21,26.8
Julius Randle,22-103,F,3/12/17,LAL,PHI,1,34,8,18,0.444,8,15,0.533,0,3,0,5,6,0.833,2,10,12,3,0,2,3,5,21,14.1
Tim Frazier,26-021,G,11/22/16,NOP,ATL,1,35,7,12,0.583,4,8,0.5,3,4,0.75,4,4,1,0,5,5,14,3,0,1,1,21,28.3
Tim Hardaway,25-024,G,4/9/17,ATL,CLE,1,37,7,15,0.467,6,11,0.545,1,4,0.25,6,8,0.75,1,8,9,4,0,0,0,1,21,18
Lou Williams,30-099,G,2/3/17,LAL,BOS,0,23,5,14,0.357,2,5,0.4,3,9,0.333,8,10,0.8,0,4,4,4,0,0,1,0,21,15.4
Stephen Curry,28-315,G,1/23/17,GSW,MIA,1,37,7,19,0.368,4,10,0.4,3,9,0.333,4,5,0.8,0,9,9,8,0,1,4,2,21,14.3
Terrence Jones,25-030,F,2/8/17,NOP,UTA,1,35,9,16,0.563,9,15,0.6,0,1,0,3,3,1,2,6,8,1,1,0,2,0,21,16.3
Channing Frye,33-291,C-F,3/4/17,CLE,MIA,0,23,9,12,0.75,6,7,0.857,3,5,0.6,0,1,0,0,4,4,0,2,1,2,2,21,16.9
Damian Lillard,26-187,G,1/18/17,POR,CHO,1,35,7,18,0.389,5,12,0.417,2,6,0.333,5,5,1,1,6,7,6,1,1,3,0,21,16.6
Patty Mills,28-212,G,3/11/17,SAS,GSW,1,21,8,13,0.615,3,6,0.5,5,7,0.714,0,0,,1,1,2,4,1,0,1,1,21,18.5
C.J. McCollum,25-183,G,3/21/17,POR,MIL,1,36,9,17,0.529,8,13,0.615,1,4,0.25,2,2,1,0,2,2,2,0,0,3,2,21,10.9
Goran Dragic,30-218,G,12/10/16,MIA,CHI,1,35,10,19,0.526,10,17,0.588,0,2,0,1,1,1,1,4,5,11,0,0,5,2,21,15.5
Kevin Durant,28-095,F-G,1/2/17,GSW,DEN,1,34,10,19,0.526,9,15,0.6,1,4,0.25,0,0,,0,3,3,2,1,1,2,2,21,12.9
Goran Dragic,30-230,G,12/22/16,MIA,LAL,1,36,6,15,0.4,3,9,0.333,3,6,0.5,6,7,0.857,0,2,2,7,0,0,3,2,21,14.2
Paul George,26-278,F,2/4/17,IND,DET,1,32,9,14,0.643,6,8,0.75,3,6,0.5,0,1,0,0,3,3,4,1,0,1,2,21,17.3
Deron Williams,32-191,G,1/3/17,DAL,WAS,1,32,7,13,0.538,3,6,0.5,4,7,0.571,3,3,1,0,1,1,6,0,0,5,4,21,12.6
Ersan Ilyasova,29-251,F,1/21/17,PHI,ATL,1,30,8,15,0.533,5,9,0.556,3,6,0.5,2,3,0.667,2,1,3,4,0,1,1,2,21,16.7
Aaron Gordon,21-168,F,3/3/17,ORL,MIA,1,32,9,17,0.529,8,13,0.615,1,4,0.25,2,2,1,4,6,10,1,0,1,2,0,21,16.7
Carmelo Anthony,32-302,F,3/27/17,NYK,DET,1,35,8,15,0.533,5,10,0.5,3,5,0.6,2,2,1,0,3,3,5,3,0,4,2,21,16.3
Russell Westbrook,28-047,G,12/29/16,OKC,MEM,1,23,6,19,0.316,4,13,0.308,2,6,0.333,7,10,0.7,2,3,5,0,2,0,6,3,21,6
Lou Williams,30-106,G,2/10/17,LAL,MIL,0,19,5,9,0.556,2,4,0.5,3,5,0.6,8,9,0.889,0,1,1,2,1,0,4,1,21,14.6
Tim Hardaway,24-325,G,2/4/17,ATL,ORL,1,27,8,14,0.571,5,8,0.625,3,6,0.5,2,2,1,0,5,5,2,2,0,1,0,21,18.3
Paul Millsap,31-350,F,1/25/17,ATL,CHI,1,36,8,14,0.571,5,9,0.556,3,5,0.6,2,3,0.667,0,6,6,2,0,1,4,5,21,11.9
Kyrie Irving,24-269,G,12/17/16,CLE,LAL,1,38,8,17,0.471,6,11,0.545,2,6,0.333,3,3,1,1,5,6,12,3,0,2,0,21,23.9
Evan Fournier,24-015,G-F,11/13/16,ORL,OKC,1,37,7,10,0.7,4,6,0.667,3,4,0.75,4,4,1,0,2,2,5,0,0,3,2,21,17.1
Dennis Schroder,23-144,G,2/6/17,ATL,UTA,1,30,8,15,0.533,8,13,0.615,0,2,0,5,5,1,0,2,2,2,0,0,4,3,21,10.5
Zach Randolph,35-166,F,12/29/16,MEM,OKC,0,25,10,17,0.588,9,14,0.643,1,3,0.333,0,0,,2,6,8,2,0,0,1,2,21,15.9
Nik Stauskas,23-043,G,11/19/16,PHI,PHO,0,26,8,9,0.889,3,3,1,5,6,0.833,0,0,,0,2,2,0,0,1,2,2,21,16.4
Lou Williams,30-096,G,1/31/17,LAL,DEN,0,24,7,11,0.636,3,6,0.5,4,5,0.8,3,3,1,1,4,5,7,2,0,1,0,21,23.9
Isaiah Thomas,27-324,G,12/27/16,BOS,MEM,1,34,6,14,0.429,5,8,0.625,1,6,0.167,8,8,1,0,1,1,7,0,0,4,3,21,13.6
Nikola Jokic,22-044,C-F,4/4/17,DEN,NOP,1,34,10,18,0.556,10,16,0.625,0,2,0,1,2,0.5,4,8,12,4,0,0,1,2,21,18.2
Paul Millsap,31-343,F,1/18/17,ATL,DET,1,27,7,17,0.412,6,12,0.5,1,5,0.2,6,9,0.667,3,5,8,4,0,0,2,2,21,14.3
Danilo Gallinari,28-092,F,11/8/16,DEN,MEM,1,38,5,11,0.455,2,6,0.333,3,5,0.6,8,9,0.889,1,6,7,2,2,1,2,0,21,19.5
Kevin Love,28-140,F,1/25/17,CLE,SAC,1,39,7,16,0.438,3,7,0.429,4,9,0.444,3,6,0.5,4,12,16,5,1,0,4,3,21,17.1
Kentavious Caldwell-Pope,23-272,G,11/16/16,DET,NYK,1,37,9,22,0.409,6,13,0.462,3,9,0.333,0,0,,1,3,4,3,1,0,0,1,21,13.5
JaMychal Green,26-134,F,11/2/16,MEM,NOP,1,31,9,12,0.75,6,7,0.857,3,5,0.6,0,0,,2,4,6,2,1,0,1,4,21,18.6
Danilo Gallinari,28-124,F,12/10/16,DEN,ORL,1,33,5,8,0.625,3,5,0.6,2,3,0.667,9,10,0.9,0,6,6,3,0,0,1,3,21,18.7
Brook Lopez,28-233,C,11/20/16,BRK,POR,1,29,8,14,0.571,6,10,0.6,2,4,0.5,3,3,1,3,3,6,4,1,1,2,2,21,19.1
Trey Lyles,21-014,F,11/19/16,UTA,HOU,1,33,8,12,0.667,6,8,0.75,2,4,0.5,3,4,0.75,1,4,5,0,0,0,2,1,21,14.9
Brandon Knight,25-017,G,12/19/16,PHO,MIN,0,29,8,13,0.615,8,11,0.727,0,2,0,5,5,1,0,2,2,4,0,0,3,4,21,13.9
Isaiah Thomas,27-355,G,1/27/17,BOS,ORL,1,25,9,15,0.6,6,7,0.857,3,8,0.375,0,0,,0,3,3,8,2,0,2,4,21,19
Jabari Parker,21-283,F,12/23/16,MIL,WAS,1,32,9,15,0.6,8,12,0.667,1,3,0.333,2,2,1,4,4,8,3,2,2,1,1,21,22.2
Jeff Teague,28-188,G,12/15/16,IND,NOP,1,35,7,18,0.389,7,12,0.583,0,6,0,7,9,0.778,0,6,6,10,0,1,1,3,21,17.7
Goran Dragic,30-285,G,2/15/17,MIA,HOU,1,33,8,14,0.571,8,9,0.889,0,5,0,5,7,0.714,0,1,1,5,0,0,1,3,21,15.2
Tim Frazier,25-362,G,10/28/16,NOP,GSW,1,34,10,18,0.556,9,15,0.6,1,3,0.333,0,1,0,3,3,6,10,0,0,3,5,21,17
Jamal Crawford,36-257,G,12/2/16,LAC,NOP,0,29,9,15,0.6,7,11,0.636,2,4,0.5,1,1,1,0,1,1,1,0,1,1,1,21,14.4
Bojan Bogdanovic,27-191,G-F,10/26/16,BRK,BOS,1,23,9,17,0.529,6,9,0.667,3,8,0.375,0,0,,2,3,5,0,1,0,2,2,21,13.2
Klay Thompson,26-349,G,1/22/17,GSW,ORL,1,34,7,14,0.5,0,5,0,7,9,0.778,0,0,,0,5,5,1,0,1,3,1,21,13.5
Serge Ibaka,27-044,F-C,11/1/16,ORL,PHI,1,32,8,12,0.667,7,10,0.7,1,2,0.5,4,4,1,2,2,4,0,0,2,0,3,21,18
Dwyane Wade,34-344,G,12/26/16,CHI,IND,1,33,8,19,0.421,8,15,0.533,0,4,0,5,5,1,1,2,3,5,2,2,2,1,21,16.7
Lance Thomas,28-313,F,3/3/17,NYK,PHI,1,42,8,16,0.5,5,11,0.455,3,5,0.6,2,2,1,2,4,6,0,2,0,1,1,21,16.2
Robin Lopez,28-291,C,1/17/17,CHI,DAL,1,36,10,15,0.667,10,15,0.667,0,0,,1,1,1,5,0,5,0,0,1,3,2,21,14.9
Derrick Rose,28-088,G,12/31/16,NYK,HOU,1,41,8,23,0.348,7,20,0.35,1,3,0.333,4,5,0.8,2,3,5,7,2,0,0,0,21,16.9
Giannis Antetokounmpo,21-351,F-G,11/21/16,MIL,ORL,1,39,6,13,0.462,6,11,0.545,0,2,0,9,9,1,2,9,11,10,5,3,4,4,21,26.9
T.J. Warren,23-143,F,1/26/17,PHO,DEN,1,41,9,16,0.563,8,14,0.571,1,2,0.5,2,2,1,1,7,8,0,0,1,0,4,21,15.3
Channing Frye,33-273,C-F,2/14/17,CLE,MIN,1,33,7,15,0.467,3,4,0.75,4,11,0.364,3,3,1,2,8,10,1,0,2,0,1,21,18.8
Serge Ibaka,27-077,F-C,12/4/16,ORL,DET,1,34,9,11,0.818,7,7,1,2,4,0.5,1,2,0.5,1,6,7,4,3,4,1,0,21,26.6
Paul George,26-198,F,11/16/16,IND,CLE,1,37,8,18,0.444,5,9,0.556,3,9,0.333,2,2,1,0,11,11,5,2,1,3,1,21,17.7
Dennis Schroder,23-165,G,2/27/17,ATL,BOS,1,30,9,14,0.643,9,11,0.818,0,3,0,3,3,1,0,4,4,5,1,0,2,1,21,18.1
Kemba Walker,26-309,G,3/13/17,CHO,CHI,1,38,9,24,0.375,6,12,0.5,3,12,0.25,0,0,,0,4,4,10,0,0,2,3,21,12.8
DeAndre Jordan,28-131,C,11/29/16,LAC,BRK,1,45,9,13,0.692,9,12,0.75,0,1,0,3,4,0.75,5,18,23,1,0,1,3,3,21,21.2
Dirk Nowitzki,38-296,F,4/11/17,DAL,DEN,1,27,9,20,0.45,8,16,0.5,1,4,0.25,2,2,1,1,7,8,1,1,3,1,2,21,15.4
Marcus Morris,27-093,F,12/4/16,DET,ORL,1,35,7,12,0.583,2,3,0.667,5,9,0.556,2,2,1,0,5,5,1,2,0,0,1,21,19.2
Eric Bledsoe,26-326,G,10/30/16,PHO,GSW,1,36,7,11,0.636,6,8,0.75,1,3,0.333,6,9,0.667,0,5,5,6,1,0,0,2,21,20.8
Paul George,26-328,F,3/26/17,IND,PHI,1,35,7,17,0.412,6,10,0.6,1,7,0.143,6,8,0.75,0,8,8,3,0,0,3,1,21,12.2
Marcin Gortat,32-306,C-F,12/19/16,WAS,IND,1,43,10,15,0.667,10,15,0.667,0,0,,1,3,0.333,4,9,13,1,0,0,3,2,21,16.1
Harrison Barnes,24-222,F,1/7/17,DAL,ATL,1,30,9,15,0.6,7,11,0.636,2,4,0.5,1,2,0.5,2,2,4,0,2,0,0,3,21,16.5
Kent Bazemore,27-149,G-F,11/27/16,ATL,LAL,1,27,8,16,0.5,3,8,0.375,5,8,0.625,0,0,,0,1,1,4,1,0,0,1,21,16.7
Wilson Chandler,29-302,F,3/8/17,DEN,WAS,1,34,10,16,0.625,9,11,0.818,1,5,0.2,0,1,0,0,3,3,3,2,0,1,3,21,16.2
Goran Dragic,30-256,G,1/17/17,MIA,HOU,1,37,8,15,0.533,7,10,0.7,1,5,0.2,4,5,0.8,2,6,8,8,1,0,6,3,21,15.9
Yogi Ferrell,23-335,G,4/9/17,DAL,PHO,1,32,8,16,0.5,5,10,0.5,3,6,0.5,2,2,1,2,2,4,4,0,0,2,2,21,15
Pau Gasol,36-169,F-C,12/22/16,SAS,LAC,1,32,6,12,0.5,5,10,0.5,1,2,0.5,8,8,1,5,4,9,2,0,2,2,3,21,19.3
Wilson Chandler,29-247,F,1/12/17,DEN,IND,1,32,8,13,0.615,6,8,0.75,2,5,0.4,3,3,1,1,7,8,4,2,0,1,2,21,20.9
Carmelo Anthony,32-157,F,11/2/16,NYK,HOU,1,31,8,15,0.533,7,11,0.636,1,4,0.25,4,5,0.8,1,6,7,1,1,0,5,3,21,11.3
Dario Saric,22-239,F,12/3/16,PHI,BOS,0,27,7,12,0.583,4,6,0.667,3,6,0.5,4,4,1,3,8,11,2,1,0,3,0,21,19.3
Kristaps Porzingis,21-140,F-C,12/20/16,NYK,IND,1,33,7,15,0.467,3,8,0.375,4,7,0.571,3,4,0.75,0,8,8,1,0,3,3,2,21,14.3
Karl-Anthony Towns,21-106,C-F,3/1/17,MIN,UTA,1,35,9,16,0.563,7,13,0.538,2,3,0.667,1,1,1,3,12,15,3,0,1,4,2,21,17.1
Paul Millsap,31-280,F,11/16/16,ATL,MIL,1,38,8,11,0.727,7,8,0.875,1,3,0.333,4,4,1,0,8,8,3,2,1,2,3,21,20.5
Evan Fournier,24-013,G-F,11/11/16,ORL,UTA,1,38,7,16,0.438,5,12,0.417,2,4,0.5,5,6,0.833,1,3,4,4,3,0,3,4,21,15
Rudy Gobert,24-175,C,12/18/16,UTA,MEM,1,38,9,9,1,9,9,1,0,0,,3,7,0.429,2,10,12,0,1,3,3,5,21,19.2
Ty Lawson,29-149,G,4/1/17,SAC,MIN,0,25,5,8,0.625,5,7,0.714,0,1,0,11,14,0.786,0,2,2,11,1,0,1,3,21,23.3
Kawhi Leonard,25-174,F,12/20/16,SAS,HOU,1,36,5,14,0.357,5,11,0.455,0,3,0,11,13,0.846,0,5,5,4,5,0,7,1,21,14.3
Paul George,26-217,F,12/5/16,IND,GSW,1,31,4,12,0.333,4,10,0.4,0,2,0,13,13,1,1,9,10,3,1,0,2,2,21,17.9
Dario Saric,22-329,F,3/3/17,PHI,NYK,1,27,7,14,0.5,6,9,0.667,1,5,0.2,6,10,0.6,1,9,10,4,0,0,1,5,21,15.6
Damian Lillard,26-253,G,3/25/17,POR,MIN,1,29,8,13,0.615,5,7,0.714,3,6,0.5,2,3,0.667,0,6,6,8,2,0,3,0,21,21.1
Troy Daniels,25-259,G,3/31/17,MEM,DAL,0,34,7,13,0.538,0,1,0,7,12,0.583,0,0,,0,3,3,2,0,0,1,0,21,16
Paul Millsap,31-360,F,2/4/17,ATL,ORL,1,28,7,14,0.5,6,11,0.545,1,3,0.333,6,8,0.75,1,4,5,4,0,0,0,3,21,16.7
Eric Bledsoe,26-336,G,11/9/16,PHO,DET,1,35,8,15,0.533,7,13,0.538,1,2,0.5,4,4,1,1,10,11,8,0,0,5,2,21,17.2
Jameer Nelson,34-292,G,11/27/16,DEN,PHO,1,28,8,13,0.615,4,6,0.667,4,7,0.571,1,1,1,0,2,2,3,0,0,2,5,21,13.8
Goran Dragic,30-304,G,3/6/17,MIA,CLE,1,34,8,17,0.471,6,12,0.5,2,5,0.4,3,3,1,0,1,1,6,2,0,4,3,21,13.6
Dennis Schroder,23-130,G,1/23/17,ATL,LAC,1,34,7,18,0.389,6,14,0.429,1,4,0.25,6,6,1,2,4,6,7,0,0,2,3,21,15.5
Brandon Knight,25-024,G,12/26/16,PHO,HOU,0,24,6,12,0.5,4,7,0.571,2,5,0.4,7,8,0.875,0,5,5,1,0,0,1,2,21,15
Buddy Hield,23-095,G,3/22/17,SAC,MIL,1,36,8,16,0.5,6,10,0.6,2,6,0.333,3,5,0.6,1,3,4,2,1,0,1,0,21,15.2
Russell Westbrook,28-062,G,1/13/17,OKC,MIN,1,36,7,23,0.304,6,13,0.462,1,10,0.1,6,7,0.857,3,8,11,12,2,0,10,3,21,11
Kawhi Leonard,25-240,F,2/24/17,SAS,LAC,1,31,7,16,0.438,7,12,0.583,0,4,0,7,10,0.7,1,2,3,6,1,0,3,5,21,12.9
Rudy Gay,30-154,F,1/18/17,SAC,IND,1,28,8,13,0.615,5,9,0.556,3,4,0.75,2,2,1,3,1,4,0,2,1,3,3,21,16
Dario Saric,22-207,F,11/1/16,PHI,ORL,1,31,9,14,0.643,6,11,0.545,3,3,1,0,0,,1,2,3,1,1,0,3,2,21,14
Stephen Curry,28-234,G,11/3/16,GSW,OKC,1,30,6,14,0.429,4,8,0.5,2,6,0.333,7,8,0.875,0,1,1,7,2,1,1,1,21,19.7
Tony Parker,34-233,G,1/5/17,SAS,DEN,1,24,10,11,0.909,9,10,0.9,1,1,1,0,0,,0,3,3,9,0,0,1,1,21,23.1
Victor Oladipo,24-314,G,3/14/17,OKC,BRK,1,32,9,16,0.563,6,12,0.5,3,4,0.75,0,0,,2,1,3,0,4,0,2,3,21,15.9
Pau Gasol,36-128,F-C,11/11/16,SAS,DET,1,36,10,16,0.625,9,13,0.692,1,3,0.333,0,0,,4,5,9,6,1,2,1,2,21,22.9
Jordan McRae,25-282,G,1/4/17,CLE,CHI,1,33,7,15,0.467,6,10,0.6,1,5,0.2,6,7,0.857,1,2,3,2,0,2,2,4,21,13.4
Kristaps Porzingis,21-150,F-C,12/30/16,NYK,NOP,1,38,8,20,0.4,8,18,0.444,0,2,0,5,5,1,3,9,12,3,2,2,0,4,21,18.9
Devin Booker,20-037,G,12/6/16,PHO,UTA,1,26,9,13,0.692,8,10,0.8,1,3,0.333,2,3,0.667,0,2,2,1,1,0,4,1,21,13
D.J. Augustin,29-080,G,1/29/17,ORL,TOR,0,29,7,10,0.7,4,5,0.8,3,5,0.6,4,5,0.8,0,2,2,3,1,0,2,3,21,16.9
LeBron James,32-020,F-G,1/19/17,CLE,PHO,1,39,8,12,0.667,8,10,0.8,0,2,0,5,8,0.625,0,9,9,15,1,2,4,2,21,25.4
Nikola Jokic,22-019,C-F,3/10/17,DEN,BOS,1,27,8,10,0.8,7,8,0.875,1,2,0.5,4,6,0.667,3,7,10,7,4,1,7,4,21,21.6
Jae Crowder,26-196,F,1/18/17,BOS,NYK,1,37,7,13,0.538,5,8,0.625,2,5,0.4,5,6,0.833,0,5,5,1,0,0,0,3,21,15.3
Wilson Chandler,29-237,F,1/2/17,DEN,GSW,1,37,8,16,0.5,5,8,0.625,3,8,0.375,2,3,0.667,1,3,4,2,2,1,3,2,21,14.5
Jae Crowder,26-112,F,10/26/16,BOS,BRK,1,29,9,15,0.6,6,7,0.857,3,8,0.375,0,0,,0,5,5,2,2,1,2,2,21,16.9
Zach LaVine,21-233,G,10/29/16,MIN,SAC,1,37,7,14,0.5,4,7,0.571,3,7,0.429,4,4,1,0,5,5,2,0,0,1,3,21,14.7
Al Horford,30-210,C-F,12/30/16,BOS,MIA,1,31,8,12,0.667,5,6,0.833,3,6,0.5,2,2,1,0,6,6,4,1,0,2,1,21,19
Marcus Smart,22-346,G,2/15/17,BOS,PHI,1,34,7,11,0.636,4,4,1,3,7,0.429,4,7,0.571,0,5,5,5,8,1,6,1,21,22.2
C.J. McCollum,25-169,G,3/7/17,POR,OKC,1,37,8,20,0.4,7,17,0.412,1,3,0.333,4,4,1,0,1,1,0,0,0,1,2,21,8.7
Joel Embiid,22-301,C-F,1/11/17,PHI,NYK,1,27,7,20,0.35,6,17,0.353,1,3,0.333,6,7,0.857,5,9,14,1,1,1,1,3,21,15.8
D'Angelo Russell,20-358,G,2/15/17,LAL,PHO,1,28,7,20,0.35,5,14,0.357,2,6,0.333,5,5,1,0,4,4,4,1,1,2,1,21,13.1
Jrue Holiday,26-159,G,11/18/16,NOP,POR,0,23,8,14,0.571,7,12,0.583,1,2,0.5,4,7,0.571,0,2,2,7,1,1,1,2,21,18.6
Victor Oladipo,24-177,G,10/28/16,OKC,PHO,1,44,7,17,0.412,6,13,0.462,1,4,0.25,6,7,0.857,1,4,5,2,2,1,4,2,21,12.7
Andrew Harrison,22-033,G,11/30/16,MEM,TOR,1,35,7,12,0.583,3,7,0.429,4,5,0.8,3,4,0.75,0,2,2,4,3,0,2,4,21,17.8
Tony Snell,25-116,G-F,3/6/17,MIL,PHI,1,31,8,11,0.727,3,4,0.75,5,7,0.714,0,0,,1,6,7,2,2,0,2,2,21,19.6
Jae Crowder,26-181,F,1/3/17,BOS,UTA,1,35,6,8,0.75,1,2,0.5,5,6,0.833,4,4,1,0,3,3,1,1,0,0,2,21,19.6
Jusuf Nurkic,22-208,C,3/19/17,POR,MIA,1,29,9,15,0.6,9,15,0.6,0,0,,3,8,0.375,6,7,13,0,0,3,0,3,21,19.3
Wilson Chandler,29-179,F,11/5/16,DEN,DET,0,31,9,18,0.5,8,14,0.571,1,4,0.25,2,2,1,3,6,9,0,0,0,2,1,21,13.5
Jeff Teague,28-283,G,3/20/17,IND,UTA,1,37,6,15,0.4,3,11,0.273,3,4,0.75,6,6,1,1,4,5,5,1,1,0,1,21,19.6
John Wall,26-059,G,11/4/16,WAS,ATL,1,33,7,17,0.412,6,15,0.4,1,2,0.5,6,8,0.75,3,7,10,6,2,0,2,3,21,18.3
Nikola Vucevic,26-065,C,12/28/16,ORL,CHO,0,27,10,13,0.769,10,13,0.769,0,0,,1,2,0.5,0,5,5,4,3,1,2,3,21,20.3
Doug McDermott,25-074,F,3/18/17,OKC,SAC,0,21,8,9,0.889,4,4,1,4,5,0.8,1,2,0.5,0,5,5,0,0,0,0,2,21,18.2
Goran Dragic,30-295,G,2/25/17,MIA,IND,1,28,8,12,0.667,7,9,0.778,1,3,0.333,4,5,0.8,0,2,2,4,2,0,0,4,21,19.2
Giannis Antetokounmpo,21-328,F-G,10/29/16,MIL,BRK,1,35,10,18,0.556,10,17,0.588,0,1,0,1,1,1,1,9,10,3,2,2,4,2,21,16.5
Goran Dragic,30-224,G,12/16/16,MIA,LAC,1,39,7,16,0.438,7,13,0.538,0,3,0,7,7,1,1,5,6,11,2,0,1,2,21,22.7
Allen Crabbe,24-297,G-F,1/31/17,POR,CHO,0,29,5,10,0.5,2,4,0.5,3,6,0.5,8,8,1,0,5,5,0,0,1,0,0,21,18.2
Troy Williams,22-093,F,4/2/17,HOU,PHO,1,39,7,12,0.583,1,3,0.333,6,9,0.667,1,2,0.5,1,4,5,3,1,0,1,5,21,17
Lou Williams,30-111,G,2/15/17,LAL,PHO,0,24,7,13,0.538,4,9,0.444,3,4,0.75,4,5,0.8,1,1,2,3,3,0,2,3,21,17.2
Jeff Teague,28-148,G,11/5/16,IND,CHI,1,29,9,14,0.643,6,9,0.667,3,5,0.6,0,0,,0,1,1,6,1,0,2,2,21,17.5
Jabari Parker,21-318,F,1/27/17,MIL,TOR,1,37,8,17,0.471,8,14,0.571,0,3,0,5,6,0.833,2,11,13,2,0,0,3,2,21,14.2
Kentavious Caldwell-Pope,23-255,G,10/30/16,DET,MIL,1,34,7,13,0.538,5,8,0.625,2,5,0.4,5,5,1,4,2,6,2,2,0,0,1,21,21.1
Julius Randle,22-008,F,12/7/16,LAL,HOU,1,29,9,19,0.474,9,18,0.5,0,1,0,3,4,0.75,5,5,10,1,0,0,3,2,21,12.8
Jordan Clarkson,24-212,G,1/5/17,LAL,POR,0,32,8,14,0.571,4,7,0.571,4,7,0.571,1,2,0.5,1,2,3,1,2,0,0,2,21,17.2
Jordan Clarkson,24-221,G,1/14/17,LAL,LAC,0,28,8,14,0.571,5,10,0.5,3,4,0.75,2,2,1,1,3,4,3,0,0,2,3,21,14.9
Markieff Morris,27-167,F,2/16/17,WAS,IND,1,32,8,12,0.667,5,8,0.625,3,4,0.75,2,2,1,2,5,7,2,2,0,1,3,21,19.9
Eric Gordon,28-040,G,2/3/17,HOU,CHI,0,34,8,17,0.471,3,7,0.429,5,10,0.5,0,0,,0,1,1,4,0,1,3,1,21,12.7
Ricky Rubio,26-088,G,1/17/17,MIN,SAS,1,39,4,9,0.444,4,8,0.5,0,1,0,13,14,0.929,0,2,2,15,2,0,3,2,21,25.2
Nikola Mirotic,26-052,F,4/4/17,CHI,NYK,1,36,7,16,0.438,5,8,0.625,2,8,0.25,5,5,1,3,7,10,0,0,0,1,2,21,15
Chris Paul,31-220,G,12/12/16,LAC,POR,1,36,7,14,0.5,4,8,0.5,3,6,0.5,4,4,1,1,4,5,14,2,0,2,3,21,24.5
Lance Stephenson,26-058,G-F,11/2/16,NOP,MEM,0,45,9,15,0.6,8,12,0.667,1,3,0.333,2,2,1,0,3,3,6,1,1,4,4,21,15.3
Jeremy Lin,28-066,G,10/28/16,BRK,IND,1,34,6,12,0.5,4,8,0.5,2,4,0.5,7,8,0.875,0,9,9,9,0,1,2,1,21,21.9
Giannis Antetokounmpo,22-094,F-G,3/10/17,MIL,IND,1,39,7,13,0.538,6,10,0.6,1,3,0.333,6,6,1,0,8,8,5,5,1,6,3,21,19.1
Otto Porter,23-238,F,1/27/17,WAS,ATL,1,33,7,11,0.636,2,4,0.5,5,7,0.714,2,3,0.667,0,11,11,4,0,2,0,1,21,22.8
Marvin Williams,30-211,F,1/16/17,CHO,BOS,1,29,8,14,0.571,5,8,0.625,3,6,0.5,2,2,1,0,5,5,0,0,0,0,2,21,15.1
Jameer Nelson,34-290,G,11/25/16,DEN,OKC,1,41,8,16,0.5,5,9,0.556,3,7,0.429,2,2,1,0,4,4,13,0,0,2,3,21,20.1
Tobias Harris,24-164,F,12/26/16,DET,CLE,0,29,7,14,0.5,4,8,0.5,3,6,0.5,4,4,1,0,6,6,4,0,0,1,0,21,17.6
Victor Oladipo,24-287,G,2/15/17,OKC,NYK,1,37,9,17,0.529,6,11,0.545,3,6,0.5,0,0,,0,4,4,2,1,0,2,1,21,13.9
Myles Turner,20-271,F-C,12/20/16,IND,NYK,1,32,6,14,0.429,4,10,0.4,2,4,0.5,7,8,0.875,1,8,9,1,1,4,1,1,21,19.4
Terrence Jones,25-018,F,1/27/17,NOP,SAS,0,24,8,14,0.571,7,12,0.583,1,2,0.5,4,5,0.8,2,5,7,1,0,0,0,2,21,16.8
Nicolas Batum,28-082,F-G,3/6/17,CHO,IND,1,34,7,19,0.368,4,10,0.4,3,9,0.333,4,4,1,0,4,4,4,3,1,3,1,21,14.8
Dion Waiters,25-056,G,2/4/17,MIA,PHI,1,26,7,10,0.7,2,4,0.5,5,6,0.833,2,2,1,0,1,1,7,2,1,3,0,21,21.7
Eric Gordon,28-027,G,1/21/17,HOU,MEM,0,30,7,16,0.438,4,5,0.8,3,11,0.273,4,4,1,0,3,3,5,1,1,1,2,21,16.9
Tim Hardaway,24-259,G,11/30/16,ATL,PHO,0,26,9,17,0.529,7,10,0.7,2,7,0.286,1,2,0.5,0,1,1,3,1,0,1,4,21,13.1
Jrue Holiday,26-214,G,1/12/17,NOP,BRK,1,31,7,15,0.467,3,9,0.333,4,6,0.667,3,4,0.75,1,4,5,4,2,0,4,3,21,14.4
Kemba Walker,26-185,G,11/9/16,CHO,UTA,1,34,7,20,0.35,6,13,0.462,1,7,0.143,6,6,1,0,5,5,6,4,0,2,3,21,16.3
Kemba Walker,26-194,G,11/18/16,CHO,ATL,1,34,8,20,0.4,6,13,0.462,2,7,0.286,3,6,0.5,0,5,5,6,2,0,1,0,21,15.7
Chris Paul,31-301,G,3/3/17,LAC,MIL,1,29,7,11,0.636,2,5,0.4,5,6,0.833,2,2,1,0,4,4,5,1,0,4,5,21,15.8
Nikola Vucevic,26-053,C,12/16/16,ORL,BRK,0,31,9,19,0.474,9,17,0.529,0,2,0,3,5,0.6,4,6,10,4,2,3,1,2,21,20.2
Kemba Walker,26-204,G,11/28/16,CHO,MEM,1,34,7,14,0.5,2,6,0.333,5,8,0.625,2,2,1,0,3,3,3,0,0,5,0,21,12
Dwyane Wade,35-052,G,3/10/17,CHI,HOU,1,25,9,18,0.5,8,12,0.667,1,6,0.167,2,2,1,2,1,3,2,2,0,3,2,21,13.3
Khris Middleton,25-210,F-G,3/10/17,MIL,IND,1,37,7,14,0.5,4,9,0.444,3,5,0.6,4,6,0.667,0,3,3,2,2,0,7,2,21,9.7
Danilo Gallinari,28-137,F,12/23/16,DEN,ATL,1,33,5,10,0.5,3,6,0.5,2,4,0.5,9,10,0.9,2,9,11,2,0,1,3,3,21,17.6
Tobias Harris,24-138,F,11/30/16,DET,BOS,1,35,9,20,0.45,6,14,0.429,3,6,0.5,0,0,,1,5,6,4,0,0,0,0,21,15.6
Chris Paul,31-236,G,12/28/16,LAC,NOP,1,31,7,15,0.467,5,8,0.625,2,7,0.286,5,5,1,3,5,8,6,1,0,1,3,21,19.9
Sergio Rodriguez,30-194,G,12/23/16,PHI,PHO,1,26,8,12,0.667,4,4,1,4,8,0.5,1,1,1,1,1,2,7,0,0,3,2,21,17.9
Brook Lopez,28-222,C,11/9/16,BRK,NYK,1,24,8,12,0.667,7,7,1,1,5,0.2,4,6,0.667,1,3,4,1,0,3,1,3,21,17.2
Brandon Ingram,19-200,F,3/21/17,LAL,LAC,1,40,8,14,0.571,6,10,0.6,2,4,0.5,3,8,0.375,1,4,5,3,2,0,2,1,21,16
Kyrie Irving,24-358,G,3/16/17,CLE,UTA,1,30,8,19,0.421,7,17,0.412,1,2,0.5,4,5,0.8,1,3,4,4,0,0,1,2,21,13.1
P.J. Tucker,31-206,F,11/27/16,PHO,DEN,1,42,6,10,0.6,3,5,0.6,3,5,0.6,6,7,0.857,1,7,8,1,1,0,0,3,21,19.3
Jamal Crawford,36-262,G,12/7/16,LAC,GSW,0,35,7,17,0.412,4,11,0.364,3,6,0.5,4,4,1,2,0,2,4,1,0,0,2,21,16.3
Paul Millsap,32-028,F,3/10/17,ATL,TOR,1,36,7,13,0.538,6,10,0.6,1,3,0.333,6,6,1,1,5,6,4,1,1,4,2,21,16.6
Marvin Williams,30-280,F,3/26/17,CHO,PHO,1,35,6,8,0.75,1,2,0.5,5,6,0.833,4,4,1,1,6,7,2,1,0,1,2,21,20.9
Kawhi Leonard,25-159,F,12/5/16,SAS,MIL,1,31,9,22,0.409,8,17,0.471,1,5,0.2,2,2,1,2,7,9,0,0,2,2,1,21,11.7
Wesley Matthews,30-108,G,1/30/17,DAL,CLE,1,37,6,16,0.375,4,7,0.571,2,9,0.222,7,7,1,1,3,4,2,0,0,0,3,21,14
J.J. Barea,32-133,G,11/6/16,DAL,MIL,1,46,8,18,0.444,6,11,0.545,2,7,0.286,3,3,1,0,6,6,5,1,0,4,2,21,13.1
Karl-Anthony Towns,20-359,C-F,11/8/16,MIN,BRK,1,32,8,15,0.533,7,11,0.636,1,4,0.25,4,4,1,4,3,7,4,0,1,3,5,21,15.9
Goran Dragic,30-280,G,2/10/17,MIA,BRK,1,35,9,18,0.5,8,14,0.571,1,4,0.25,2,3,0.667,1,3,4,5,1,0,3,2,21,13.9
Goran Dragic,30-215,G,12/7/16,MIA,ATL,1,35,8,17,0.471,7,13,0.538,1,4,0.25,4,4,1,0,2,2,4,1,1,3,4,21,12.8
Jeremy Lamb,24-182,G-F,11/28/16,CHO,MEM,0,23,7,11,0.636,5,6,0.833,2,5,0.4,5,7,0.714,2,7,9,0,1,1,0,1,21,20.1
Jeff Teague,28-161,G,11/18/16,IND,PHO,1,34,6,10,0.6,6,8,0.75,0,2,0,9,12,0.75,0,4,4,7,1,1,6,2,21,16.2
John Wall,26-081,G,11/26/16,WAS,SAS,1,37,8,16,0.5,8,15,0.533,0,1,0,5,7,0.714,0,3,3,5,1,0,4,3,21,12.4
Karl-Anthony Towns,20-346,C-F,10/26/16,MIN,MEM,1,36,9,20,0.45,7,15,0.467,2,5,0.4,1,1,1,2,2,4,5,1,1,2,3,21,14.6
Evan Fournier,24-048,G-F,12/16/16,ORL,BRK,1,31,5,15,0.333,2,8,0.25,3,7,0.429,8,9,0.889,1,3,4,1,0,0,1,2,21,12.6
Kawhi Leonard,25-153,F,11/29/16,SAS,ORL,1,32,6,16,0.375,5,12,0.417,1,4,0.25,8,9,0.889,1,1,2,0,2,0,2,1,21,12.4
Isaiah Thomas,28-031,G,3/10/17,BOS,DEN,1,34,7,14,0.5,6,8,0.75,1,6,0.167,6,6,1,0,2,2,5,0,0,2,5,21,14.1
Justin Hamilton,26-222,C,11/9/16,BRK,NYK,0,23,8,13,0.615,3,6,0.5,5,7,0.714,0,0,,1,3,4,0,1,0,0,0,21,17.7
Kevin Durant,28-072,F-G,12/10/16,GSW,MEM,1,31,7,13,0.538,4,7,0.571,3,6,0.5,4,5,0.8,0,7,7,1,1,2,3,2,21,15.7
Alec Burks,25-234,G,3/11/17,UTA,OKC,0,24,5,11,0.455,2,6,0.333,3,5,0.6,8,9,0.889,1,6,7,2,0,0,0,3,21,17.6
Chris Paul,31-192,G,11/14/16,LAC,BRK,1,25,8,11,0.727,4,5,0.8,4,6,0.667,1,1,1,1,3,4,9,5,0,1,2,21,27.6
Blake Griffin,28-007,F,3/23/17,LAC,DAL,1,39,9,23,0.391,8,20,0.4,1,3,0.333,2,4,0.5,0,5,5,2,1,0,4,1,21,7.2
Kristaps Porzingis,21-088,F-C,10/29/16,NYK,MEM,1,36,7,11,0.636,6,7,0.857,1,4,0.25,6,8,0.75,0,5,5,2,0,1,0,5,21,16.9
Blake Griffin,27-352,F,3/3/17,LAC,MIL,1,38,6,9,0.667,6,8,0.75,0,1,0,9,13,0.692,0,9,9,8,0,0,5,2,21,18
Evan Fournier,24-157,G-F,4/4/17,ORL,CLE,1,29,5,12,0.417,1,4,0.25,4,8,0.5,7,8,0.875,0,0,0,1,2,0,1,4,21,14.3
Ryan Anderson,28-338,F,4/9/17,HOU,SAC,1,23,7,9,0.778,1,1,1,6,8,0.75,1,1,1,0,1,1,0,1,0,0,0,21,18.8
Kemba Walker,26-260,G,1/23/17,CHO,WAS,1,36,7,24,0.292,5,14,0.357,2,10,0.2,5,7,0.714,0,2,2,5,0,1,0,1,21,10.6
Kyrie Irving,24-293,G,1/10/17,CLE,UTA,1,39,5,18,0.278,3,10,0.3,2,8,0.25,8,8,1,2,2,4,4,1,0,3,3,20,11
Kevin Love,28-109,F,12/25/16,CLE,GSW,1,32,5,13,0.385,2,6,0.333,3,7,0.429,7,8,0.875,1,5,6,3,1,0,0,5,20,15.8
Steven Adams,23-204,C,2/9/17,OKC,CLE,1,39,9,14,0.643,9,14,0.643,0,0,,2,3,0.667,9,4,13,1,1,2,4,3,20,18.8
Ersan Ilyasova,29-236,F,1/6/17,PHI,BOS,1,32,8,21,0.381,4,7,0.571,4,14,0.286,0,0,,0,2,2,3,2,2,2,2,20,11.8
Clint Capela,22-185,F-C,11/19/16,HOU,UTA,1,31,10,19,0.526,10,19,0.526,0,0,,0,2,0,3,5,8,5,0,1,0,3,20,16.5
Dwight Howard,31-005,C,12/13/16,ATL,ORL,1,29,9,10,0.9,9,10,0.9,0,0,,2,3,0.667,9,7,16,1,0,1,5,0,20,21
Zach Randolph,35-225,F,2/26/17,MEM,DEN,0,26,9,18,0.5,9,16,0.563,0,2,0,2,2,1,4,7,11,2,0,0,1,0,20,16.3
Rodney Hood,24-070,G-F,12/29/16,UTA,PHI,1,32,7,11,0.636,3,5,0.6,4,6,0.667,2,2,1,0,1,1,2,1,0,4,2,20,13
Jimmy Butler,27-193,G-F,3/26/17,CHI,MIL,1,39,8,13,0.615,7,12,0.583,1,1,1,3,5,0.6,1,5,6,14,3,0,6,1,20,21.9
Jae Crowder,26-206,F,1/28/17,BOS,MIL,1,38,5,13,0.385,1,3,0.333,4,10,0.4,6,6,1,1,5,6,4,0,1,0,4,20,17
Markieff Morris,27-128,F,1/8/17,WAS,MIL,1,38,9,15,0.6,8,12,0.667,1,3,0.333,1,2,0.5,5,5,10,1,3,0,3,3,20,17.2
Bradley Beal,23-165,G,12/10/16,WAS,MIL,1,37,6,15,0.4,5,11,0.455,1,4,0.25,7,8,0.875,0,0,0,6,0,0,1,0,20,14.7
Derrick Rose,28-111,G,1/23/17,NYK,IND,1,40,7,16,0.438,7,15,0.467,0,1,0,6,6,1,0,3,3,6,0,0,4,1,20,12.3
Courtney Lee,31-179,G,3/31/17,NYK,MIA,1,35,6,15,0.4,4,11,0.364,2,4,0.5,6,6,1,0,4,4,1,3,0,3,0,20,13.8
Hassan Whiteside,27-275,C,3/15/17,MIA,NOP,1,35,9,11,0.818,9,11,0.818,0,0,,2,2,1,4,13,17,0,1,2,5,4,20,18.4
Gary Harris,22-145,G,2/6/17,DEN,DAL,1,37,5,12,0.417,1,7,0.143,4,5,0.8,6,6,1,2,3,5,1,2,0,3,1,20,15.2
J.J. Redick,32-150,G,11/21/16,LAC,TOR,1,29,4,7,0.571,1,3,0.333,3,4,0.75,9,9,1,0,2,2,0,1,0,2,2,20,15.5
Myles Turner,21-000,F-C,3/24/17,IND,DEN,1,36,9,16,0.563,9,15,0.6,0,1,0,2,2,1,2,2,4,0,2,4,0,3,20,18
Kyle Lowry,30-264,G,12/14/16,TOR,PHI,1,37,6,12,0.5,1,2,0.5,5,10,0.5,3,3,1,1,3,4,7,0,0,0,2,20,19.7
Klay Thompson,27-059,G,4/8/17,GSW,NOP,1,27,5,16,0.313,2,7,0.286,3,9,0.333,7,7,1,1,2,3,2,0,1,0,0,20,14.2
Langston Galloway,25-029,G,1/7/17,NOP,BOS,0,22,6,13,0.462,2,4,0.5,4,9,0.444,4,5,0.8,0,4,4,1,0,0,0,3,20,13.6
D'Angelo Russell,20-346,G,2/3/17,LAL,BOS,1,32,8,20,0.4,6,11,0.545,2,9,0.222,2,2,1,1,5,6,6,1,1,2,3,20,14.1
Kyle O'Quinn,26-251,F-C,12/2/16,NYK,MIN,1,31,9,11,0.818,9,11,0.818,0,0,,2,2,1,7,7,14,2,0,2,2,4,20,22.1
Jamal Crawford,36-325,G,2/8/17,LAC,NYK,0,30,7,12,0.583,4,8,0.5,3,4,0.75,3,3,1,2,1,3,2,1,0,2,0,20,16.5
Ryan Anderson,28-187,F,11/9/16,HOU,SAS,1,36,5,11,0.455,1,5,0.2,4,6,0.667,6,7,0.857,1,8,9,0,1,0,0,2,20,17.2
Karl-Anthony Towns,21-017,C-F,12/2/16,MIN,NYK,1,30,5,18,0.278,2,13,0.154,3,5,0.6,7,8,0.875,3,5,8,1,0,3,4,4,20,9.8
Troy Daniels,25-261,G,4/2/17,MEM,LAL,0,31,7,13,0.538,1,2,0.5,6,11,0.545,0,0,,0,2,2,3,1,0,1,2,20,15.6
Andre Drummond,23-146,C,1/3/17,DET,IND,1,35,9,16,0.563,9,16,0.563,0,0,,2,2,1,7,7,14,2,1,2,0,4,20,21.6
Marcus Morris,27-206,F,3/27/17,DET,NYK,1,33,6,13,0.462,2,8,0.25,4,5,0.8,4,5,0.8,0,1,1,2,0,0,3,6,20,9.2
Victor Oladipo,24-283,G,2/11/17,OKC,GSW,1,35,9,15,0.6,7,11,0.636,2,4,0.5,0,0,,1,3,4,4,1,0,3,4,20,13.9
Wesley Matthews,30-076,G,12/29/16,DAL,LAL,1,35,6,14,0.429,2,5,0.4,4,9,0.444,4,6,0.667,1,5,6,2,0,0,0,1,20,15
Marc Gasol,31-274,C,10/29/16,MEM,NYK,1,31,5,15,0.333,4,11,0.364,1,4,0.25,9,9,1,2,4,6,3,0,1,1,3,20,14.7
Kentavious Caldwell-Pope,24-053,G,4/12/17,DET,ORL,1,29,6,18,0.333,3,8,0.375,3,10,0.3,5,6,0.833,0,4,4,0,0,0,2,3,20,7.4
Jimmy Butler,27-057,G-F,11/10/16,CHI,MIA,1,38,5,11,0.455,4,9,0.444,1,2,0.5,9,10,0.9,1,3,4,5,3,0,2,1,20,19.6
J.J. Redick,32-136,G,11/7/16,LAC,DET,1,24,6,9,0.667,3,5,0.6,3,4,0.75,5,5,1,0,1,1,0,0,0,0,0,20,16.4
Klay Thompson,26-275,G,11/9/16,GSW,DAL,1,29,8,13,0.615,4,6,0.667,4,7,0.571,0,0,,0,2,2,4,0,0,3,5,20,12.5
Vince Carter,39-287,G-F,11/8/16,MEM,DEN,0,31,8,13,0.615,5,6,0.833,3,7,0.429,1,2,0.5,0,3,3,5,0,2,0,3,20,18.3
Kyrie Irving,25-007,G,3/30/17,CLE,CHI,1,38,7,20,0.35,3,13,0.231,4,7,0.571,2,2,1,2,0,2,3,1,0,2,5,20,9.3
Mike Conley,29-122,G,2/10/17,MEM,GSW,1,33,6,16,0.375,2,10,0.2,4,6,0.667,4,4,1,2,3,5,9,3,0,2,0,20,20.8
Tyler Ulis,21-059,G,3/5/17,PHO,BOS,0,33,8,12,0.667,7,11,0.636,1,1,1,3,3,1,0,2,2,5,1,0,0,2,20,19.1
Al Horford,30-285,C-F,3/15/17,BOS,MIN,1,30,9,12,0.75,8,10,0.8,1,2,0.5,1,1,1,2,7,9,8,0,1,1,0,20,24
Tim Frazier,26-039,G,12/10/16,NOP,LAC,1,35,6,13,0.462,5,11,0.455,1,2,0.5,7,8,0.875,0,1,1,11,0,0,3,5,20,15.9
Brook Lopez,28-257,C,12/14/16,BRK,LAL,1,33,8,19,0.421,7,12,0.583,1,7,0.143,3,5,0.6,3,4,7,2,0,1,3,2,20,10.7
Blake Griffin,27-241,F,11/12/16,LAC,MIN,1,37,7,17,0.412,7,17,0.412,0,0,,6,8,0.75,1,10,11,4,0,1,2,3,20,14.1
Giannis Antetokounmpo,22-067,F-G,2/11/17,MIL,IND,1,34,4,9,0.444,4,8,0.5,0,1,0,12,14,0.857,2,6,8,10,1,2,2,5,20,23.1
Derrick Rose,28-087,G,12/30/16,NYK,NOP,1,38,9,21,0.429,8,19,0.421,1,2,0.5,1,1,1,0,2,2,1,3,0,4,2,20,8.4
Kyrie Irving,24-220,G,10/29/16,CLE,ORL,1,37,7,18,0.389,5,12,0.417,2,6,0.333,4,4,1,0,4,4,2,0,2,1,2,20,12.4
Kyle Lowry,30-320,G,2/8/17,TOR,MIN,1,37,6,19,0.316,2,6,0.333,4,13,0.308,4,5,0.8,2,0,2,5,1,0,3,2,20,10.8
James Johnson,29-354,F,2/8/17,MIA,MIL,0,30,7,12,0.583,5,7,0.714,2,5,0.4,4,5,0.8,1,3,4,4,2,2,3,1,20,18.4
Kyle Korver,35-343,G-F,2/23/17,CLE,NYK,0,31,7,12,0.583,1,2,0.5,6,10,0.6,0,0,,0,2,2,3,1,0,0,1,20,17.7
Tim Hardaway,24-359,G,3/10/17,ATL,TOR,1,34,8,13,0.615,5,8,0.625,3,5,0.6,1,1,1,1,1,2,6,2,0,3,2,20,17.5
Hassan Whiteside,27-180,C,12/10/16,MIA,CHI,1,33,9,19,0.474,9,19,0.474,0,0,,2,4,0.5,3,5,8,1,2,3,2,5,20,13.9
Nikola Jokic,21-350,C-F,2/3/17,DEN,MIL,1,32,8,15,0.533,6,11,0.545,2,4,0.5,2,2,1,6,6,12,11,1,0,2,0,20,25.4
Trevor Ariza,31-258,F,3/15/17,HOU,LAL,1,28,7,9,0.778,3,3,1,4,6,0.667,2,3,0.667,1,2,3,2,4,0,1,1,20,21.4
Malcolm Brogdon,24-078,G,2/27/17,MIL,CLE,0,31,8,15,0.533,5,8,0.625,3,7,0.429,1,3,0.333,0,3,3,5,1,0,2,2,20,14.5
C.J. McCollum,25-185,G,3/23/17,POR,NYK,1,34,8,17,0.471,6,12,0.5,2,5,0.4,2,2,1,1,3,4,1,0,0,1,1,20,12.2
Derrick Favors,25-206,F-C,2/6/17,UTA,ATL,1,26,10,12,0.833,10,11,0.909,0,1,0,0,0,,3,7,10,1,3,2,1,2,20,23.1
Myles Turner,20-219,F-C,10/29/16,IND,CHI,1,22,8,12,0.667,8,12,0.667,0,0,,4,5,0.8,1,3,4,2,0,3,1,2,20,17.7
Rodney Hood,24-100,G-F,1/28/17,UTA,MEM,1,31,7,12,0.583,3,6,0.5,4,6,0.667,2,2,1,0,4,4,1,0,1,0,2,20,16.2
Marcus Morris,27-089,F,11/30/16,DET,BOS,1,38,8,13,0.615,6,8,0.75,2,5,0.4,2,2,1,1,3,4,3,1,3,3,3,20,16.7
Draymond Green,27-010,F,3/14/17,GSW,PHI,1,38,4,13,0.308,3,9,0.333,1,4,0.25,11,14,0.786,3,6,9,8,3,6,1,4,20,25.4
Jonas Valanciunas,24-270,C,1/31/17,TOR,NOP,1,32,9,17,0.529,9,17,0.529,0,0,,2,2,1,5,7,12,0,0,0,0,5,20,15.3
Jeff Teague,28-291,G,3/28/17,IND,MIN,1,41,6,12,0.5,6,8,0.75,0,4,0,8,9,0.889,0,3,3,10,0,0,1,3,20,19.3
LeBron James,32-017,F-G,1/16/17,CLE,GSW,1,35,6,18,0.333,5,14,0.357,1,4,0.25,7,10,0.7,2,6,8,2,1,0,6,1,20,7.8
James Johnson,29-321,F,1/6/17,MIA,LAL,0,34,7,11,0.636,3,4,0.75,4,7,0.571,2,4,0.5,1,4,5,1,2,2,3,3,20,16.1
Frank Kaminsky,23-225,F-C,11/15/16,CHO,MIN,0,27,8,14,0.571,5,7,0.714,3,7,0.429,1,1,1,0,4,4,5,1,1,2,1,20,17.4
Jordan Clarkson,24-240,G,2/2/17,LAL,WAS,0,29,9,13,0.692,7,7,1,2,6,0.333,0,0,,0,2,2,1,0,0,0,1,20,15.4
Evan Turner,28-070,G,1/5/17,POR,LAL,0,28,7,11,0.636,6,9,0.667,1,2,0.5,5,6,0.833,0,1,1,1,1,0,2,1,20,14.3
Dion Waiters,25-091,G,3/11/17,MIA,TOR,1,33,6,10,0.6,2,4,0.5,4,6,0.667,4,8,0.5,0,1,1,5,1,1,5,1,20,13.9
Austin Rivers,24-220,G,3/9/17,LAC,MEM,0,32,7,10,0.7,6,6,1,1,4,0.25,5,6,0.833,1,4,5,4,0,0,3,1,20,16.7
Elfrid Payton,22-329,G,1/16/17,ORL,DEN,1,29,9,17,0.529,9,17,0.529,0,0,,2,3,0.667,2,2,4,12,0,0,3,1,20,18.3
Jodie Meeks,29-114,G,12/13/16,ORL,ATL,0,26,7,10,0.7,3,4,0.75,4,6,0.667,2,4,0.5,0,4,4,2,2,0,2,1,20,17.2
Russell Westbrook,28-031,G,12/13/16,OKC,POR,1,27,7,19,0.368,5,14,0.357,2,5,0.4,4,4,1,2,4,6,6,0,0,4,1,20,11.9
Norman Powell,23-198,G,12/9/16,TOR,BOS,1,36,7,10,0.7,4,6,0.667,3,4,0.75,3,4,0.75,0,3,3,2,5,0,0,2,20,21.9
Aaron Gordon,21-077,F,12/2/16,ORL,PHI,1,25,9,14,0.643,7,10,0.7,2,4,0.5,0,0,,0,2,2,0,0,1,1,1,20,13.7
Dion Waiters,25-053,G,2/1/17,MIA,ATL,1,30,9,15,0.6,7,11,0.636,2,4,0.5,0,0,,2,5,7,3,2,2,3,2,20,17.7
Courtney Lee,31-154,G,3/6/17,NYK,ORL,1,41,6,16,0.375,6,13,0.462,0,3,0,8,8,1,0,3,3,2,1,0,1,4,20,11.9
Jonathon Simmons,27-041,G-F,10/25/16,SAS,GSW,0,28,8,14,0.571,5,9,0.556,3,5,0.6,1,3,0.333,1,3,4,3,0,1,2,2,20,14.2
Tony Parker,34-193,G,11/26/16,SAS,WAS,1,27,8,13,0.615,7,12,0.583,1,1,1,3,3,1,1,0,1,3,0,0,3,1,20,13.5
Evan Fournier,24-130,G-F,3/8/17,ORL,CHI,1,34,7,17,0.412,4,12,0.333,3,5,0.6,3,4,0.75,3,6,9,2,2,0,1,2,20,16
Tyler Ulis,21-094,G,4/9/17,PHO,DAL,1,33,7,13,0.538,5,10,0.5,2,3,0.667,4,4,1,0,2,2,10,0,1,3,0,20,19
Eric Gordon,27-330,G,11/19/16,HOU,UTA,0,37,7,16,0.438,3,8,0.375,4,8,0.5,2,2,1,2,5,7,6,2,0,1,3,20,18.5
Troy Daniels,25-152,G,12/14/16,MEM,CLE,0,22,7,13,0.538,3,5,0.6,4,8,0.5,2,2,1,1,1,2,1,0,0,2,4,20,11.8
Hassan Whiteside,27-264,C,3/4/17,MIA,CLE,1,28,9,14,0.643,9,14,0.643,0,0,,2,2,1,4,9,13,0,0,1,1,0,20,19
Enes Kanter,24-234,C,1/9/17,OKC,CHI,0,28,9,11,0.818,9,11,0.818,0,0,,2,3,0.667,4,7,11,3,1,0,1,1,20,22.1
Russell Westbrook,28-078,G,1/29/17,OKC,CLE,1,36,7,26,0.269,6,20,0.3,1,6,0.167,5,8,0.625,5,7,12,10,1,1,4,3,20,12.5
JaMychal Green,26-256,F,3/4/17,MEM,HOU,1,29,9,11,0.818,9,10,0.9,0,1,0,2,2,1,5,5,10,0,0,0,3,3,20,16.7
Evan Fournier,24-117,G-F,2/23/17,ORL,POR,1,38,7,17,0.412,6,13,0.462,1,4,0.25,5,8,0.625,2,3,5,2,1,0,2,3,20,11.2
Nick Young,31-160,G-F,11/8/16,LAL,DAL,1,29,7,12,0.583,4,6,0.667,3,6,0.5,3,3,1,0,2,2,0,0,0,0,3,20,13.8
Harrison Barnes,24-194,F,12/10/16,DAL,HOU,1,32,7,13,0.538,6,12,0.5,1,1,1,5,5,1,2,2,4,1,1,0,2,2,20,14.6
Rudy Gay,30-115,F,12/10/16,SAC,UTA,1,33,7,15,0.467,4,11,0.364,3,4,0.75,3,4,0.75,0,5,5,2,2,0,1,2,20,15
Giannis Antetokounmpo,22-112,F-G,3/28/17,MIL,CHO,1,39,8,13,0.615,7,12,0.583,1,1,1,3,4,0.75,0,8,8,2,0,1,1,2,20,16.4
Paul Millsap,31-317,F,12/23/16,ATL,DEN,1,38,5,15,0.333,3,10,0.3,2,5,0.4,8,10,0.8,1,7,8,3,1,1,1,4,20,14.7
Klay Thompson,26-294,G,11/28/16,GSW,ATL,1,37,8,18,0.444,5,12,0.417,3,6,0.5,1,1,1,2,2,4,2,1,1,2,3,20,12.5
Deron Williams,32-193,G,1/5/17,DAL,PHO,1,33,8,14,0.571,6,9,0.667,2,5,0.4,2,3,0.667,0,4,4,6,0,0,3,2,20,14.6
Tim Hardaway,24-306,G,1/16/17,ATL,NYK,1,35,9,16,0.563,7,9,0.778,2,7,0.286,0,0,,1,2,3,4,1,0,1,2,20,15.7
Steven Adams,23-125,C,11/22/16,OKC,LAL,1,31,9,13,0.692,9,13,0.692,0,0,,2,2,1,4,2,6,2,1,1,1,1,20,19.6
Rudy Gobert,24-282,C,4/4/17,UTA,POR,1,35,6,6,1,6,6,1,0,0,,8,10,0.8,1,10,11,2,1,3,0,4,20,24
Reggie Jackson,26-242,G,12/14/16,DET,DAL,1,30,8,16,0.5,7,12,0.583,1,4,0.25,3,4,0.75,0,2,2,6,0,0,3,5,20,11.4
Brandon Jennings,27-108,G,1/9/17,NYK,NOP,1,29,8,14,0.571,4,5,0.8,4,9,0.444,0,0,,1,4,5,4,2,0,2,0,20,18.1
Elfrid Payton,23-038,G,4/1/17,ORL,BRK,1,35,6,12,0.5,5,10,0.5,1,2,0.5,7,8,0.875,2,9,11,11,1,0,2,0,20,24.4
DeAndre Jordan,28-220,C,2/26/17,LAC,CHO,1,43,9,10,0.9,9,10,0.9,0,0,,2,4,0.5,9,10,19,1,3,2,3,2,20,26.4
Rudy Gobert,24-263,C,3/16/17,UTA,CLE,1,37,10,13,0.769,10,13,0.769,0,0,,0,1,0,5,14,19,1,2,2,2,3,20,23.1
Anthony Davis,23-297,F-C,1/2/17,NOP,CLE,1,40,10,27,0.37,10,26,0.385,0,1,0,0,2,0,6,10,16,2,1,3,3,2,20,12.2
Chris Paul,31-218,G,12/10/16,LAC,NOP,1,30,8,16,0.5,5,10,0.5,3,6,0.5,1,2,0.5,0,5,5,20,3,0,0,3,20,28.9
Tim Hardaway,25-016,G,4/1/17,ATL,CHI,1,37,6,16,0.375,3,10,0.3,3,6,0.5,5,5,1,1,4,5,5,0,0,2,2,20,13.8
Devin Booker,20-101,G,2/8/17,PHO,MEM,1,32,6,13,0.462,6,10,0.6,0,3,0,8,10,0.8,0,1,1,3,0,0,3,3,20,10.7
Caris LeVert,22-224,G-F,4/6/17,BRK,ORL,1,27,7,12,0.583,5,8,0.625,2,4,0.5,4,4,1,0,4,4,1,0,0,0,1,20,15.9
Nicolas Batum,28-000,F-G,12/14/16,CHO,WAS,1,37,7,14,0.5,4,6,0.667,3,8,0.375,3,3,1,0,5,5,8,2,1,3,3,20,18.6
Steven Adams,23-189,C,1/25/17,OKC,NOP,1,32,9,16,0.563,9,15,0.6,0,1,0,2,4,0.5,5,6,11,3,1,4,4,2,20,18
Harrison Barnes,24-175,F,11/21/16,DAL,SAS,1,42,9,18,0.5,9,16,0.563,0,2,0,2,4,0.5,4,5,9,1,0,1,3,3,20,11.7
Damian Lillard,26-179,G,1/10/17,POR,LAL,1,31,7,21,0.333,6,15,0.4,1,6,0.167,5,6,0.833,3,5,8,6,0,1,2,3,20,13
Archie Goodwin,22-238,G,4/12/17,BRK,CHI,0,29,7,11,0.636,7,9,0.778,0,2,0,6,10,0.6,4,3,7,4,1,1,5,3,20,15.5
Andrew Wiggins,22-013,F-G,3/8/17,MIN,LAC,1,36,5,17,0.294,5,14,0.357,0,3,0,10,10,1,1,1,2,3,1,0,1,1,20,12.8
Gordon Hayward,26-233,F-G,11/11/16,UTA,ORL,1,39,6,17,0.353,4,9,0.444,2,8,0.25,6,6,1,2,8,10,8,1,0,1,1,20,19.5
Garrett Temple,30-220,G,12/14/16,SAC,HOU,1,30,7,13,0.538,2,4,0.5,5,9,0.556,1,1,1,1,1,2,4,0,1,4,2,20,13.4
Josh Richardson,23-105,G,12/29/16,MIA,CHO,1,33,8,14,0.571,5,9,0.556,3,5,0.6,1,1,1,0,4,4,2,1,1,1,3,20,15.5
J.J. Redick,32-206,G,1/16/17,LAC,OKC,1,27,7,15,0.467,2,5,0.4,5,10,0.5,1,1,1,0,1,1,2,2,0,0,0,20,16
Jeff Teague,28-298,G,4/4/17,IND,TOR,1,36,5,13,0.385,3,8,0.375,2,5,0.4,8,8,1,0,2,2,6,0,0,1,1,20,16.3
Taurean Waller-Prince,23-015,F,4/6/17,ATL,BOS,1,41,7,13,0.538,5,10,0.5,2,3,0.667,4,4,1,2,5,7,4,0,0,3,3,20,15.2
Jimmy Butler,27-054,G-F,11/7/16,CHI,ORL,1,31,5,13,0.385,5,11,0.455,0,2,0,10,10,1,2,3,5,7,4,0,3,0,20,21.1
D'Angelo Russell,20-327,G,1/15/17,LAL,DET,1,26,9,17,0.529,9,13,0.692,0,4,0,2,2,1,1,6,7,3,1,0,5,3,20,11.1
Klay Thompson,27-051,G,3/31/17,GSW,HOU,1,36,8,20,0.4,4,11,0.364,4,9,0.444,0,0,,1,7,8,4,2,1,1,3,20,15.3
Maurice Harkless,23-181,F-G,11/8/16,POR,PHO,1,33,8,11,0.727,6,6,1,2,5,0.4,2,2,1,1,5,6,1,1,1,3,3,20,15.9
Jahlil Okafor,21-055,C-F,2/8/17,PHI,SAS,1,25,5,10,0.5,5,10,0.5,0,0,,10,11,0.909,4,4,8,0,0,2,0,1,20,19.6
Will Barton,26-075,G,3/22/17,DEN,CLE,0,33,8,14,0.571,5,8,0.625,3,6,0.5,1,1,1,0,4,4,2,2,0,0,2,20,17.2
Vince Carter,39-293,G-F,11/14/16,MEM,UTA,0,31,6,11,0.545,3,6,0.5,3,5,0.6,5,6,0.833,1,6,7,2,1,0,3,3,20,15
Tony Snell,25-046,G-F,12/26/16,MIL,WAS,1,29,7,14,0.5,1,3,0.333,6,11,0.545,0,0,,1,3,4,1,2,0,2,2,20,14.5
Blake Griffin,27-243,F,11/14/16,LAC,BRK,1,26,9,15,0.6,9,14,0.643,0,1,0,2,3,0.667,1,5,6,6,2,0,1,3,20,18.9
Ty Lawson,29-141,G,3/24/17,SAC,GSW,1,24,8,9,0.889,6,7,0.857,2,2,1,2,4,0.5,0,0,0,2,1,0,2,2,20,15.7
T.J. Warren,23-069,F,11/13/16,PHO,GSW,1,33,10,18,0.556,10,17,0.588,0,1,0,0,0,,1,2,3,2,4,0,0,2,20,17.3
Darren Collison,29-111,G,12/12/16,SAC,LAL,1,32,7,11,0.636,3,4,0.75,4,7,0.571,2,6,0.333,0,0,0,3,1,0,2,2,20,13.8
T.J. Warren,23-154,F,2/6/17,PHO,NOP,1,33,9,16,0.563,9,13,0.692,0,3,0,2,2,1,2,2,4,1,2,3,2,2,20,16.4
Nik Stauskas,23-164,G,3/20/17,PHI,ORL,0,39,6,17,0.353,3,8,0.375,3,9,0.333,5,6,0.833,1,4,5,2,2,1,5,2,20,10.3
JaMychal Green,26-263,F,3/11/17,MEM,ATL,1,26,8,12,0.667,7,11,0.636,1,1,1,3,3,1,7,4,11,0,0,1,1,4,20,19
Victor Oladipo,24-179,G,10/30/16,OKC,LAL,1,38,7,20,0.35,4,13,0.308,3,7,0.429,3,3,1,0,1,1,4,1,0,3,3,20,8.7
Justin Holiday,28-007,G,4/12/17,NYK,PHI,0,20,6,10,0.6,4,5,0.8,2,5,0.4,6,7,0.857,1,4,5,1,2,1,2,1,20,17.9
Nik Stauskas,23-166,G,3/22/17,PHI,OKC,0,30,7,12,0.583,2,4,0.5,5,8,0.625,1,1,1,0,0,0,1,0,0,1,1,20,13.7
John Wall,26-163,G,2/16/17,WAS,IND,1,37,8,20,0.4,8,18,0.444,0,2,0,4,4,1,0,2,2,12,1,2,5,2,20,14.8
Paul George,26-180,F,10/29/16,IND,CHI,1,24,8,12,0.667,4,7,0.571,4,5,0.8,0,0,,0,1,1,3,1,0,3,4,20,13.6
Gorgui Dieng,26-345,C,12/28/16,MIN,DEN,1,39,9,11,0.818,9,11,0.818,0,0,,2,2,1,2,6,8,1,1,1,1,5,20,18.5
Jeff Teague,28-230,G,1/26/17,IND,MIN,1,35,7,13,0.538,4,8,0.5,3,5,0.6,3,3,1,0,8,8,13,1,1,6,2,20,20.1
Jimmy Butler,27-098,G-F,12/21/16,CHI,WAS,1,39,6,20,0.3,6,16,0.375,0,4,0,8,9,0.889,5,6,11,5,0,0,4,4,20,11.2
Dwyane Wade,35-039,G,2/25/17,CHI,CLE,1,34,9,18,0.5,8,15,0.533,1,3,0.333,1,3,0.333,1,8,9,10,0,0,1,1,20,18.9
Bradley Beal,23-227,G,2/10/17,WAS,IND,1,35,6,15,0.4,3,5,0.6,3,10,0.3,5,8,0.625,1,2,3,4,1,0,2,1,20,13.4
Zach Randolph,35-188,F,1/20/17,MEM,SAC,0,24,7,14,0.5,5,11,0.455,2,3,0.667,4,5,0.8,2,8,10,2,0,0,1,2,20,16
Timofey Mozgov,30-122,C,11/15/16,LAL,BRK,1,29,7,11,0.636,7,11,0.636,0,0,,6,6,1,2,4,6,1,0,0,0,3,20,17.2
Jaylen Brown,20-095,F,1/27/17,BOS,ORL,1,30,6,13,0.462,4,8,0.5,2,5,0.4,6,8,0.75,1,7,8,2,0,0,1,5,20,13.7
Trevor Ariza,31-169,F,12/16/16,HOU,NOP,1,30,7,18,0.389,2,4,0.5,5,14,0.357,1,2,0.5,0,5,5,1,3,0,0,1,20,14.6
Bojan Bogdanovic,27-236,G-F,12/10/16,BRK,SAS,1,27,7,13,0.538,5,9,0.556,2,4,0.5,4,5,0.8,0,4,4,2,0,0,0,1,20,15.5
Joel Embiid,22-224,C-F,10/26/16,PHI,OKC,1,22,6,16,0.375,5,13,0.385,1,3,0.333,7,8,0.875,0,7,7,0,0,2,4,4,20,8.7
Joel Embiid,22-298,C-F,1/8/17,PHI,BRK,1,24,8,14,0.571,8,11,0.727,0,3,0,4,5,0.8,1,4,5,4,0,2,3,4,20,14.5
Gordon Hayward,26-229,F-G,11/7/16,UTA,PHI,1,30,9,17,0.529,9,15,0.6,0,2,0,2,2,1,1,6,7,5,1,0,3,2,20,14.9
Blake Griffin,27-275,F,12/16/16,LAC,MIA,1,38,9,15,0.6,9,15,0.6,0,0,,2,2,1,2,6,8,4,1,0,5,3,20,13.9
Rudy Gobert,24-165,C,12/8/16,UTA,GSW,1,35,8,8,1,8,8,1,0,0,,4,7,0.571,2,15,17,1,0,1,2,2,20,20.9
Jamal Murray,19-347,G,2/4/17,DEN,SAS,0,23,8,12,0.667,6,8,0.75,2,4,0.5,2,2,1,0,3,3,0,0,0,2,0,20,13.7
Frank Kaminsky,23-313,F-C,2/11/17,CHO,LAC,1,36,7,16,0.438,4,10,0.4,3,6,0.5,3,4,0.75,1,7,8,5,1,2,0,3,20,18.7
DeMar DeRozan,27-141,G,12/26/16,TOR,POR,1,37,8,22,0.364,8,21,0.381,0,1,0,4,7,0.571,5,5,10,7,3,0,3,1,20,16.1
James Harden,27-098,G,12/2/16,HOU,DEN,1,33,6,16,0.375,5,11,0.455,1,5,0.2,7,8,0.875,1,6,7,9,1,1,5,3,20,15.1
Dennis Schroder,23-114,G,1/7/17,ATL,DAL,1,29,7,15,0.467,4,10,0.4,3,5,0.6,3,4,0.75,0,3,3,3,1,0,2,4,20,12.3
Zach Randolph,35-263,F,4/5/17,MEM,OKC,0,26,8,15,0.533,7,14,0.5,1,1,1,3,5,0.6,1,8,9,1,1,0,2,2,20,13.9
D'Angelo Russell,20-246,G,10/26/16,LAL,HOU,1,29,7,16,0.438,3,6,0.5,4,10,0.4,2,3,0.667,0,1,1,3,1,0,3,2,20,10.8
James Johnson,29-316,F,1/1/17,MIA,DET,0,34,6,13,0.462,2,8,0.25,4,5,0.8,4,4,1,1,6,7,3,1,1,3,2,20,15.8
Andrew Wiggins,22-006,F-G,3/1/17,MIN,UTA,1,31,7,16,0.438,6,15,0.4,1,1,1,5,6,0.833,1,1,2,1,3,0,2,0,20,13.9
Patty Mills,28-165,G,1/23/17,SAS,BRK,0,20,7,13,0.538,3,7,0.429,4,6,0.667,2,3,0.667,1,2,3,2,0,0,1,0,20,15
Dion Waiters,24-327,G,11/1/16,MIA,SAC,1,42,7,14,0.5,6,11,0.545,1,3,0.333,5,7,0.714,0,4,4,4,1,2,3,1,20,15.2
Evan Fournier,23-363,G-F,10/26/16,ORL,MIA,1,39,7,19,0.368,5,13,0.385,2,6,0.333,4,7,0.571,1,3,4,4,2,0,1,3,20,12.5
Isaiah Thomas,28-017,G,2/24/17,BOS,TOR,1,35,6,17,0.353,3,7,0.429,3,10,0.3,5,6,0.833,1,2,3,5,0,0,3,3,20,10.7
Dwight Howard,31-018,C,12/26/16,ATL,MIN,1,21,9,9,1,9,9,1,0,0,,2,3,0.667,6,6,12,2,2,1,3,2,20,23.2
Blake Griffin,27-332,F,2/11/17,LAC,CHO,1,35,8,19,0.421,8,17,0.471,0,2,0,4,5,0.8,4,8,12,8,0,1,1,3,20,18.8
Reggie Jackson,26-262,G,1/3/17,DET,IND,1,32,8,18,0.444,5,14,0.357,3,4,0.75,1,1,1,4,3,7,12,2,0,3,2,20,20.9
Marcus Smart,22-248,G,11/9/16,BOS,WAS,0,36,7,18,0.389,3,9,0.333,4,9,0.444,2,5,0.4,0,3,3,1,1,0,2,3,20,8.4
Kenneth Faried,27-058,F,1/16/17,DEN,ORL,1,33,10,12,0.833,10,11,0.909,0,1,0,0,0,,1,4,5,2,1,1,0,2,20,19.8
Tyler Ulis,21-090,G,4/5/17,PHO,GSW,1,37,8,21,0.381,6,14,0.429,2,7,0.286,2,4,0.5,3,2,5,6,0,0,4,2,20,9.8
Darren Collison,29-173,G,2/12/17,SAC,NOP,1,41,7,16,0.438,5,12,0.417,2,4,0.5,4,5,0.8,0,6,6,8,3,0,4,3,20,16.4
Andre Drummond,23-112,C,11/30/16,DET,BOS,1,35,8,13,0.615,8,13,0.615,0,0,,4,7,0.571,8,9,17,2,2,1,2,4,20,21.7
Eric Bledsoe,26-340,G,11/13/16,PHO,GSW,1,28,6,13,0.462,5,9,0.556,1,4,0.25,7,7,1,1,2,3,5,0,0,0,2,20,17.3
Gerald Henderson,29-077,G,2/24/17,PHI,WAS,1,31,5,14,0.357,2,6,0.333,3,8,0.375,7,8,0.875,0,5,5,0,0,0,1,3,20,11.1
Darren Collison,29-080,G,11/11/16,SAC,POR,0,38,9,16,0.563,9,14,0.643,0,2,0,2,2,1,0,5,5,4,0,0,3,4,20,12.1
Derrick Rose,28-127,G,2/8/17,NYK,LAC,1,37,10,16,0.625,10,15,0.667,0,1,0,0,0,,2,5,7,8,1,0,3,1,20,18.9
Jordan Clarkson,24-171,G,11/25/16,LAL,GSW,1,38,6,16,0.375,2,7,0.286,4,9,0.444,4,5,0.8,0,2,2,0,5,0,3,1,20,13
Anthony Davis,23-292,F-C,12/28/16,NOP,LAC,1,37,8,16,0.5,8,14,0.571,0,2,0,4,8,0.5,1,4,5,1,4,1,0,4,20,16.1
Derrick Rose,28-107,G,1/19/17,NYK,WAS,1,32,7,16,0.438,7,16,0.438,0,0,,6,6,1,2,3,5,2,0,0,1,0,20,14.3
Serge Ibaka,27-138,F-C,2/3/17,ORL,TOR,1,35,8,12,0.667,6,9,0.667,2,3,0.667,2,2,1,1,11,12,1,0,3,1,2,20,19.8
Kemba Walker,26-241,G,1/4/17,CHO,OKC,1,33,5,13,0.385,4,9,0.444,1,4,0.25,9,9,1,2,2,4,9,2,0,3,1,20,19.8
Dennis Schroder,23-050,G,11/4/16,ATL,WAS,1,33,7,16,0.438,7,13,0.538,0,3,0,6,8,0.75,1,6,7,3,0,0,4,1,20,11
Jeff Green,30-100,F,12/6/16,ORL,WAS,0,25,6,9,0.667,5,7,0.714,1,2,0.5,7,8,0.875,0,3,3,0,1,0,1,2,20,15.8
Nikola Vucevic,26-092,C,1/24/17,ORL,CHI,1,33,8,16,0.5,8,15,0.533,0,1,0,4,5,0.8,2,6,8,2,2,0,3,1,20,14.8
Langston Galloway,25-004,G,12/13/16,NOP,GSW,0,28,6,14,0.429,1,2,0.5,5,12,0.417,3,3,1,1,5,6,0,2,0,2,2,20,14
Giannis Antetokounmpo,22-123,F-G,4/8/17,MIL,PHI,1,40,7,15,0.467,7,12,0.583,0,3,0,6,11,0.545,0,10,10,6,3,2,4,3,20,16.7
Glenn Robinson,22-322,G-F,11/25/16,IND,BRK,1,40,6,10,0.6,2,4,0.5,4,6,0.667,4,6,0.667,1,5,6,0,1,1,0,4,20,16.9
James Johnson,30-034,F,3/26/17,MIA,BOS,0,29,7,17,0.412,7,13,0.538,0,4,0,6,7,0.857,3,2,5,6,1,2,3,3,20,15.6
Andre Drummond,23-211,C,3/9/17,DET,CLE,1,36,10,14,0.714,10,14,0.714,0,0,,0,1,0,7,9,16,4,0,0,1,3,20,22
Devin Booker,20-084,G,1/22/17,PHO,TOR,1,37,6,14,0.429,1,6,0.167,5,8,0.625,3,4,0.75,0,4,4,2,2,0,2,5,20,12.8
Markieff Morris,27-220,F,4/10/17,WAS,DET,1,27,9,16,0.563,7,12,0.583,2,4,0.5,0,0,,1,7,8,1,0,0,5,2,20,10.1
Kenneth Faried,27-059,F,1/17/17,DEN,LAL,1,30,9,10,0.9,9,10,0.9,0,0,,2,4,0.5,1,6,7,2,1,0,1,1,20,19.3
Blake Griffin,27-318,F,1/28/17,LAC,GSW,1,23,9,14,0.643,9,13,0.692,0,1,0,2,3,0.667,2,2,4,2,1,0,2,4,20,14.2
Aron Baynes,29-341,C,11/14/16,DET,OKC,1,34,8,13,0.615,8,13,0.615,0,0,,4,4,1,1,7,8,1,0,0,1,1,20,16.2
Dwyane Wade,34-356,G,1/7/17,CHI,TOR,1,39,6,19,0.316,5,17,0.294,1,2,0.5,7,7,1,1,3,4,7,1,1,2,2,20,14.5
Dwight Howard,30-333,C,11/5/16,ATL,HOU,1,29,8,10,0.8,8,10,0.8,0,0,,4,10,0.4,7,8,15,3,1,2,3,3,20,21.4
Hassan Whiteside,27-137,C,10/28/16,MIA,CHO,1,27,8,11,0.727,8,11,0.727,0,0,,4,7,0.571,5,10,15,0,0,2,4,4,20,16.6
Dion Waiters,25-092,G,3/12/17,MIA,IND,1,36,8,18,0.444,5,11,0.455,3,7,0.429,1,3,0.333,0,8,8,6,0,0,1,2,20,14.6
DeAndre Jordan,28-230,C,3/8/17,LAC,MIN,1,30,9,11,0.818,9,11,0.818,0,0,,2,5,0.4,5,8,13,1,0,1,0,4,20,20.4
C.J. Miles,29-269,G-F,1/12/17,IND,DEN,0,20,7,13,0.538,1,6,0.167,6,7,0.857,0,0,,2,2,4,1,0,0,0,1,20,16
Jeff Teague,28-155,G,11/12/16,IND,BOS,1,35,4,15,0.267,3,11,0.273,1,4,0.25,11,12,0.917,1,2,3,4,0,0,2,6,20,10.4
Otto Porter,23-157,F,11/7/16,WAS,HOU,1,39,6,13,0.462,4,8,0.5,2,5,0.4,6,6,1,3,5,8,2,3,1,0,2,20,21.2
Andre Iguodala,33-057,G-F,3/26/17,GSW,MEM,0,32,7,8,0.875,5,6,0.833,2,2,1,4,5,0.8,0,7,7,4,2,1,0,0,20,24.4
Ryan Anderson,28-341,F,4/12/17,HOU,MIN,1,32,7,17,0.412,1,2,0.5,6,15,0.4,0,0,,1,1,2,4,0,0,0,2,20,13.9
Pau Gasol,36-116,F-C,10/30/16,SAS,MIA,1,31,9,18,0.5,8,16,0.5,1,2,0.5,1,2,0.5,3,8,11,3,0,2,0,2,20,17.8
Mike Dunleavy,36-122,F-G,1/15/17,ATL,MIL,0,23,6,10,0.6,2,5,0.4,4,5,0.8,4,5,0.8,1,2,3,2,0,0,1,4,20,15.1
Wesley Matthews,30-038,G,11/21/16,DAL,SAS,1,40,6,13,0.462,3,6,0.5,3,7,0.429,5,7,0.714,1,4,5,4,1,0,4,3,20,13
Goran Dragic,30-327,G,3/29/17,MIA,NYK,1,34,6,17,0.353,5,13,0.385,1,4,0.25,7,7,1,1,6,7,9,2,0,1,2,20,19.5
Khris Middleton,25-187,F-G,2/15/17,MIL,BRK,0,26,7,13,0.538,6,12,0.5,1,1,1,5,5,1,0,3,3,7,3,0,1,5,20,19.5
Darren Collison,29-136,G,1/6/17,SAC,LAC,1,35,7,13,0.538,4,7,0.571,3,6,0.5,3,3,1,1,4,5,2,0,0,0,2,20,16.2
Deron Williams,32-164,G,12/7/16,DAL,SAC,1,32,6,8,0.75,3,3,1,3,5,0.6,5,5,1,0,2,2,6,0,0,5,2,20,15.8
Eric Bledsoe,27-056,G,2/3/17,PHO,SAC,1,34,4,12,0.333,1,6,0.167,3,6,0.5,9,12,0.75,2,4,6,4,1,0,2,2,20,15.6
Shabazz Muhammad,24-070,F-G,1/22/17,MIN,DEN,0,33,9,14,0.643,7,9,0.778,2,5,0.4,0,0,,3,2,5,1,1,0,2,1,20,15.8
Kawhi Leonard,25-122,F,10/29/16,SAS,NOP,1,28,6,12,0.5,4,8,0.5,2,4,0.5,6,6,1,0,4,4,3,2,0,0,1,20,18.9
Bojan Bogdanovic,27-349,G-F,4/2/17,WAS,GSW,0,29,6,11,0.545,2,4,0.5,4,7,0.571,4,4,1,1,5,6,1,2,0,3,2,20,15.8
Rodney Hood,24-020,G-F,11/9/16,UTA,CHO,1,33,7,14,0.5,3,4,0.75,4,10,0.4,2,4,0.5,0,4,4,4,2,0,2,3,20,15
Jonas Valanciunas,24-216,C,12/8/16,TOR,MIN,1,29,9,15,0.6,9,15,0.6,0,0,,2,2,1,6,4,10,1,0,1,1,5,20,16.9
Doug McDermott,25-042,F,2/14/17,CHI,TOR,0,32,8,13,0.615,6,9,0.667,2,4,0.5,2,2,1,0,5,5,1,0,0,0,3,20,15.1
Brook Lopez,28-312,C,2/7/17,BRK,CHO,1,29,8,17,0.471,7,13,0.538,1,4,0.25,3,5,0.6,1,3,4,1,0,4,4,4,20,10
Marcus Morris,27-125,F,1/5/17,DET,CHO,1,36,5,15,0.333,2,9,0.222,3,6,0.5,7,8,0.875,3,8,11,3,0,1,0,3,20,17.2
Myles Turner,20-258,F-C,12/7/16,IND,PHO,1,28,7,11,0.636,4,7,0.571,3,4,0.75,3,4,0.75,2,2,4,0,1,2,3,3,20,14.9
Elfrid Payton,22-333,G,1/20/17,ORL,MIL,1,37,6,11,0.545,4,8,0.5,2,3,0.667,6,6,1,1,3,4,6,3,0,3,3,20,19.3
Taj Gibson,31-224,F,2/3/17,CHI,HOU,1,36,9,13,0.692,9,12,0.75,0,1,0,2,3,0.667,3,3,6,3,1,1,2,2,20,18.1
Rudy Gobert,24-274,C,3/27/17,UTA,NOP,1,40,8,11,0.727,8,11,0.727,0,0,,4,8,0.5,2,17,19,1,0,5,1,4,20,22
Nick Young,31-216,G-F,1/3/17,LAL,MEM,1,27,6,11,0.545,0,0,,6,11,0.545,2,4,0.5,0,0,0,2,0,0,0,4,20,13.7
Reggie Jackson,26-258,G,12/30/16,DET,ATL,1,32,7,17,0.412,5,10,0.5,2,7,0.286,4,4,1,2,2,4,8,1,0,4,5,20,13.5
Kawhi Leonard,25-140,F,11/16/16,SAS,SAC,1,32,7,14,0.5,3,5,0.6,4,9,0.444,2,2,1,2,4,6,1,4,1,1,1,20,19.6
Harrison Barnes,24-270,F,2/24/17,DAL,MIN,1,37,9,17,0.529,8,13,0.615,1,4,0.25,1,2,0.5,3,3,6,1,2,0,3,2,20,13.2
Brook Lopez,28-284,C,1/10/17,BRK,ATL,1,32,8,14,0.571,6,8,0.75,2,6,0.333,2,4,0.5,0,2,2,2,1,2,1,3,20,14.8
Frank Kaminsky,23-358,F-C,3/28/17,CHO,MIL,0,28,9,15,0.6,7,9,0.778,2,6,0.333,0,0,,1,3,4,3,0,0,0,1,20,16.4
Aaron Gordon,21-175,F,3/10/17,ORL,CHO,1,28,8,14,0.571,8,13,0.615,0,1,0,4,5,0.8,0,5,5,0,0,0,2,1,20,12.1
Dwyane Wade,34-333,G,12/15/16,CHI,MIL,1,33,8,13,0.615,8,10,0.8,0,3,0,4,6,0.667,0,3,3,6,1,1,4,2,20,15.3
Carmelo Anthony,32-189,F,12/4/16,NYK,SAC,1,36,8,20,0.4,5,12,0.417,3,8,0.375,1,2,0.5,0,4,4,1,0,0,0,3,20,9.5
Serge Ibaka,27-093,F-C,12/20/16,ORL,MIA,1,40,8,15,0.533,4,10,0.4,4,5,0.8,0,0,,3,6,9,2,1,1,1,5,20,16.7
Victor Oladipo,24-259,G,1/18/17,OKC,GSW,1,37,8,17,0.471,4,9,0.444,4,8,0.5,0,0,,1,2,3,2,4,1,2,2,20,15.9
Dario Saric,22-322,F,2/24/17,PHI,WAS,1,33,10,19,0.526,10,15,0.667,0,4,0,0,0,,1,10,11,4,1,0,2,1,20,15.8
Gordon Hayward,26-281,F-G,12/29/16,UTA,PHI,1,32,6,14,0.429,3,8,0.375,3,6,0.5,5,5,1,0,4,4,3,1,0,0,1,20,16.5
Frank Kaminsky,23-345,F-C,3/15/17,CHO,IND,0,31,7,15,0.467,6,7,0.857,1,8,0.125,5,7,0.714,0,4,4,1,1,0,2,1,20,12
Reggie Jackson,26-335,G,3/17/17,DET,TOR,1,28,6,14,0.429,6,13,0.462,0,1,0,8,10,0.8,0,0,0,6,0,0,2,2,20,13.2
John Henson,25-335,C-F,11/27/16,MIL,ORL,1,29,8,13,0.615,8,13,0.615,0,0,,4,6,0.667,2,5,7,1,1,3,0,0,20,20
E'Twaun Moore,27-256,G,11/10/16,NOP,MIL,1,32,8,18,0.444,6,13,0.462,2,5,0.4,2,2,1,0,2,2,3,1,0,1,3,20,12.1
Kevin Love,28-059,F,11/5/16,CLE,PHI,1,38,8,16,0.5,6,11,0.545,2,5,0.4,2,3,0.667,1,10,11,1,0,1,2,1,20,14.3
Jordan Clarkson,24-269,G,3/3/17,LAL,BOS,0,30,7,19,0.368,6,11,0.545,1,8,0.125,5,5,1,0,4,4,3,3,0,3,2,20,12
Zach LaVine,21-330,G,2/3/17,MIN,DET,1,32,9,13,0.692,9,11,0.818,0,2,0,2,3,0.667,1,3,4,4,0,0,2,1,20,16.1
Marc Gasol,31-275,C,10/30/16,MEM,WAS,1,29,6,14,0.429,2,8,0.25,4,6,0.667,4,6,0.667,1,9,10,1,1,1,0,1,20,17.2
Nick Young,31-204,G-F,12/22/16,LAL,MIA,1,36,7,14,0.5,2,3,0.667,5,11,0.455,1,1,1,0,0,0,1,2,0,0,2,20,14.9
Joe Ingles,29-043,F-G,11/14/16,UTA,MEM,1,33,7,11,0.636,3,4,0.75,4,7,0.571,2,2,1,0,4,4,2,1,0,0,4,20,17.1
Draymond Green,26-272,F,12/1/16,GSW,HOU,1,47,9,15,0.6,9,13,0.692,0,2,0,2,5,0.4,5,10,15,9,2,1,4,6,20,21
DeAndre Jordan,28-169,C,1/6/17,LAC,SAC,1,37,9,10,0.9,9,10,0.9,0,0,,2,3,0.667,1,8,9,2,1,1,0,2,20,21.6
Avery Bradley,26-007,G,12/3/16,BOS,PHI,1,32,9,16,0.563,8,10,0.8,1,6,0.167,1,2,0.5,2,7,9,2,1,0,1,1,20,16.5
Eric Bledsoe,27-081,G,2/28/17,PHO,MEM,1,31,7,17,0.412,5,12,0.417,2,5,0.4,4,6,0.667,0,4,4,8,2,1,1,0,20,18.6
Kyrie Irving,24-254,G,12/2/16,CLE,CHI,1,38,9,21,0.429,9,18,0.5,0,3,0,2,3,0.667,4,2,6,8,1,0,2,1,20,16.1
Willie Cauley-Stein,23-204,F-C,3/10/17,SAC,WAS,1,42,7,12,0.583,7,12,0.583,0,0,,6,8,0.75,2,11,13,3,1,0,2,1,20,19
Jon Leuer,27-270,F,2/8/17,DET,LAL,1,34,9,17,0.529,9,15,0.6,0,2,0,2,2,1,1,2,3,3,1,0,1,3,20,13.9
Dario Saric,22-313,F,2/15/17,PHI,BOS,0,33,9,18,0.5,8,10,0.8,1,8,0.125,1,1,1,1,10,11,0,1,1,3,3,20,12.2
Jeff Teague,28-138,G,10/26/16,IND,DAL,1,37,5,15,0.333,5,12,0.417,0,3,0,10,13,0.769,0,2,2,8,3,0,3,4,20,14.9
Marc Gasol,31-322,C,12/16/16,MEM,SAC,1,36,6,18,0.333,6,14,0.429,0,4,0,8,8,1,0,5,5,4,0,2,1,5,20,12.5
Brook Lopez,28-313,C,2/8/17,BRK,WAS,1,32,8,17,0.471,8,13,0.615,0,4,0,4,4,1,1,5,6,4,0,2,2,6,20,13.3
Rajon Rondo,31-019,G,3/13/17,CHI,CHO,1,36,8,15,0.533,5,9,0.556,3,6,0.5,1,1,1,3,3,6,6,1,0,3,3,20,16.7
Jrue Holiday,26-266,G,3/5/17,NOP,LAL,1,36,7,12,0.583,6,9,0.667,1,3,0.333,5,6,0.833,0,5,5,12,3,0,3,0,20,23.9
Isaiah Thomas,27-299,G,12/2/16,BOS,SAC,1,34,6,21,0.286,6,16,0.375,0,5,0,8,9,0.889,1,2,3,7,2,0,1,4,20,12.9
Jimmy Butler,27-132,G-F,1/24/17,CHI,ORL,1,39,7,14,0.5,7,11,0.636,0,3,0,6,7,0.857,2,6,8,4,3,0,0,0,20,21.6
Lou Williams,30-091,G,1/26/17,LAL,UTA,0,25,6,9,0.667,5,6,0.833,1,3,0.333,7,7,1,0,5,5,1,0,0,2,4,20,14.7
J.J. Barea,32-266,G,3/19/17,DAL,BRK,0,27,8,12,0.667,7,8,0.875,1,4,0.25,3,5,0.6,0,1,1,7,2,0,2,2,20,18.4
Karl-Anthony Towns,21-038,C-F,12/23/16,MIN,SAC,1,38,7,15,0.467,6,10,0.6,1,5,0.2,5,6,0.833,5,8,13,5,0,0,1,1,20,19.9
Austin Rivers,24-176,G,1/24/17,LAC,PHI,1,39,7,15,0.467,3,8,0.375,4,7,0.571,2,4,0.5,1,1,2,3,1,0,2,5,20,11.6
Jodie Meeks,29-228,G,4/6/17,ORL,BRK,1,31,7,12,0.583,3,5,0.6,4,7,0.571,2,2,1,0,2,2,0,0,0,2,2,20,12.2
Robert Covington,25-350,F,11/28/16,PHI,TOR,1,32,7,11,0.636,1,2,0.5,6,9,0.667,0,0,,2,3,5,2,2,0,3,4,20,16.2
Wilson Chandler,29-294,F,2/28/17,DEN,CHI,1,29,6,13,0.462,5,8,0.625,1,5,0.2,7,8,0.875,1,2,3,1,0,1,2,1,20,13.2
Shabazz Muhammad,24-059,F-G,1/11/17,MIN,HOU,0,30,7,11,0.636,5,8,0.625,2,3,0.667,4,4,1,1,6,7,1,0,0,0,1,20,17.9
Steven Adams,23-166,C,1/2/17,OKC,MIL,1,34,9,11,0.818,9,11,0.818,0,0,,2,2,1,3,5,8,2,1,3,0,3,20,22.8
Kevin Durant,28-067,F-G,12/5/16,GSW,IND,1,22,9,14,0.643,9,12,0.75,0,2,0,2,3,0.667,1,7,8,4,0,2,2,3,20,17.2
Will Barton,25-332,G,12/3/16,DEN,UTA,1,34,8,15,0.533,5,11,0.455,3,4,0.75,1,2,0.5,0,5,5,4,2,1,4,2,20,14.5
Ish Smith,28-276,G,4/7/17,DET,HOU,1,30,9,17,0.529,9,16,0.563,0,1,0,2,2,1,1,2,3,5,0,0,1,2,20,14.7
Dennis Schroder,23-148,G,2/10/17,ATL,SAC,1,33,6,12,0.5,4,8,0.5,2,4,0.5,6,7,0.857,0,2,2,5,1,0,6,1,20,12.3
Brook Lopez,28-310,C,2/5/17,BRK,TOR,1,30,6,17,0.353,5,13,0.385,1,4,0.25,7,8,0.875,2,4,6,3,1,2,4,4,20,11.6
Harrison Barnes,24-232,F,1/17/17,DAL,CHI,1,38,8,17,0.471,6,14,0.429,2,3,0.667,2,2,1,1,3,4,1,0,0,2,2,20,10.8
Yogi Ferrell,23-280,G,2/13/17,DAL,BOS,0,33,8,11,0.727,6,7,0.857,2,4,0.5,2,2,1,0,2,2,5,0,0,2,5,20,15.6
Carmelo Anthony,32-270,F,2/23/17,NYK,CLE,1,40,9,25,0.36,7,17,0.412,2,8,0.25,0,0,,1,4,5,5,0,0,5,3,20,5.3
Jamal Murray,19-276,G,11/25/16,DEN,OKC,0,34,5,16,0.313,3,9,0.333,2,7,0.286,8,10,0.8,1,6,7,0,2,1,2,3,20,12
Kristaps Porzingis,21-239,F-C,3/29/17,NYK,MIA,1,36,6,13,0.462,5,10,0.5,1,3,0.333,7,10,0.7,2,6,8,2,0,3,3,3,20,14.6
Andrew Wiggins,22-030,F-G,3/25/17,MIN,POR,1,32,8,19,0.421,8,18,0.444,0,1,0,4,7,0.571,0,0,0,2,1,0,1,1,20,9.7
Rondae Hollis-Jefferson,21-314,F,11/12/16,BRK,PHO,1,30,5,12,0.417,5,12,0.417,0,0,,10,11,0.909,0,13,13,4,1,1,3,2,20,17.8
Kevin Love,28-207,F,4/2/17,CLE,IND,1,37,8,12,0.667,5,6,0.833,3,6,0.5,1,2,0.5,3,9,12,1,0,0,4,2,20,15.1
Karl-Anthony Towns,20-360,C-F,11/9/16,MIN,ORL,1,41,7,16,0.438,6,13,0.462,1,3,0.333,5,5,1,4,7,11,1,2,1,0,3,20,18.7
Gerald Henderson,29-047,G,1/25/17,PHI,MIL,0,24,7,11,0.636,5,7,0.714,2,4,0.5,4,4,1,0,2,2,4,0,0,3,0,20,15.5
Nikola Mirotic,26-013,F,2/24/17,CHI,PHO,0,37,5,10,0.5,1,3,0.333,4,7,0.571,6,7,0.857,0,8,8,2,0,0,3,2,20,14.6
Dennis Schroder,23-186,G,3/20/17,ATL,CHO,1,31,8,17,0.471,5,10,0.5,3,7,0.429,1,1,1,2,1,3,6,0,2,3,2,20,14.8
Evan Fournier,24-149,G-F,3/27/17,ORL,TOR,1,30,7,12,0.583,5,7,0.714,2,5,0.4,4,5,0.8,0,1,1,1,2,0,0,2,20,16.2
Stephen Curry,28-308,G,1/16/17,GSW,CLE,1,31,7,20,0.35,2,8,0.25,5,12,0.417,1,2,0.5,0,2,2,11,4,0,3,2,20,16.9
Gordon Hayward,27-006,F-G,3/29/17,UTA,SAC,1,33,8,14,0.571,5,9,0.556,3,5,0.6,1,1,1,1,5,6,4,0,0,5,2,20,12.6
Enes Kanter,24-282,C,2/26/17,OKC,NOP,0,24,6,9,0.667,6,9,0.667,0,0,,8,10,0.8,3,6,9,3,1,0,2,4,20,18.7
Nikola Vucevic,26-138,C,3/11/17,ORL,CLE,1,28,9,19,0.474,9,18,0.5,0,1,0,2,4,0.5,6,9,15,0,0,1,2,5,20,13.1
Marquese Chriss,19-212,F,1/30/17,PHO,MEM,1,34,8,12,0.667,6,8,0.75,2,4,0.5,2,4,0.5,3,3,6,0,2,1,3,3,20,15.5
Kyrie Irving,24-308,G,1/25/17,CLE,SAC,1,42,9,19,0.474,8,15,0.533,1,4,0.25,1,2,0.5,0,1,1,6,2,2,3,3,20,13.6
Mike Conley,29-153,G,3/13/17,MEM,MIL,1,36,7,14,0.5,4,5,0.8,3,9,0.333,3,4,0.75,0,1,1,10,3,0,3,3,20,18.7
Sean Kilpatrick,27-057,G,3/4/17,BRK,POR,0,27,7,14,0.5,1,7,0.143,6,7,0.857,0,0,,1,1,2,5,0,0,0,0,20,17.5
George Hill,30-341,G,4/10/17,UTA,GSW,1,19,7,9,0.778,2,2,1,5,7,0.714,1,1,1,0,1,1,5,2,0,0,2,20,21.5
Otto Porter,23-250,F,2/8/17,WAS,BRK,1,39,6,13,0.462,3,5,0.6,3,8,0.375,5,6,0.833,5,5,10,1,1,0,1,4,20,17
Rodney Hood,24-158,G-F,3/27/17,UTA,NOP,1,30,7,16,0.438,3,9,0.333,4,7,0.571,2,4,0.5,1,5,6,3,0,0,1,2,20,13.3
Jimmy Butler,27-064,G-F,11/17/16,CHI,UTA,1,41,7,19,0.368,5,15,0.333,2,4,0.5,4,6,0.667,2,10,12,3,2,0,1,0,20,16.2
Chris Paul,31-253,G,1/14/17,LAC,LAL,1,31,7,15,0.467,5,9,0.556,2,6,0.333,4,4,1,2,3,5,13,2,0,4,2,20,20.9
Bradley Beal,23-200,G,1/14/17,WAS,PHI,1,27,8,15,0.533,6,12,0.5,2,3,0.667,2,2,1,0,4,4,1,1,0,1,1,20,14.2
Anthony Davis,23-300,F-C,1/5/17,NOP,ATL,1,37,7,20,0.35,7,20,0.35,0,0,,6,8,0.75,7,11,18,3,2,0,3,5,20,15.3
Gary Harris,22-183,G,3/16/17,DEN,LAC,1,41,6,9,0.667,3,4,0.75,3,5,0.6,5,5,1,0,2,2,5,0,0,1,3,20,18
DeMarre Carroll,30-172,F,1/15/17,TOR,NYK,1,27,7,13,0.538,6,7,0.857,1,6,0.167,5,5,1,1,1,2,0,2,1,0,1,20,17
Nikola Jokic,22-020,C-F,3/11/17,DEN,SAC,1,30,7,12,0.583,6,9,0.667,1,3,0.333,5,5,1,3,11,14,2,2,0,2,1,20,20.8
Dirk Nowitzki,38-269,F,3/15/17,DAL,WAS,1,32,7,15,0.467,4,8,0.5,3,7,0.429,3,5,0.6,0,4,4,2,0,1,2,0,20,12.8
Ish Smith,28-281,G,4/12/17,DET,ORL,1,35,8,20,0.4,7,14,0.5,1,6,0.167,3,4,0.75,1,3,4,10,0,0,1,1,20,16
Julius Randle,21-336,F,10/30/16,LAL,OKC,1,32,7,10,0.7,7,9,0.778,0,1,0,6,9,0.667,1,8,9,3,3,0,2,4,20,19.2
Al Horford,30-285,C-F,3/15/17,BOS,MIN,1,30,9,12,0.75,8,10,0.8,1,2,0.5,1,1,1,2,7,9,8,0,1,1,0,20,24
Buddy Hield,23-016,G,1/2/17,NOP,CLE,1,35,6,13,0.462,2,7,0.286,4,6,0.667,4,4,1,0,5,5,2,0,0,2,3,20,13
Kristaps Porzingis,21-211,F-C,3/1/17,NYK,ORL,1,33,6,15,0.4,4,8,0.5,2,7,0.286,6,8,0.75,3,6,9,2,1,0,1,3,20,15.2
Marco Belinelli,30-362,G-F,3/22/17,CHO,ORL,0,21,5,9,0.556,2,4,0.5,3,5,0.6,7,8,0.875,0,3,3,1,1,0,0,1,20,17.5
Julius Randle,21-341,F,11/4/16,LAL,GSW,1,30,10,18,0.556,10,17,0.588,0,1,0,0,0,,6,8,14,2,1,1,5,3,20,14.9
Jabari Parker,21-290,F,12/30/16,MIL,MIN,1,38,8,14,0.571,6,10,0.6,2,4,0.5,2,4,0.5,3,3,6,3,2,0,2,4,20,16.1
Stephen Curry,29-029,G,4/12/17,GSW,LAL,1,28,6,17,0.353,1,3,0.333,5,14,0.357,3,4,0.75,0,5,5,8,2,0,6,1,20,12.8
Elfrid Payton,22-357,G,2/13/17,ORL,MIA,0,31,7,15,0.467,7,15,0.467,0,0,,6,7,0.857,0,5,5,4,0,0,0,2,20,15.4
Andre Drummond,23-093,C,11/11/16,DET,SAS,1,33,8,10,0.8,7,9,0.778,1,1,1,3,3,1,6,11,17,0,1,1,6,2,20,18.6
Al-Farouq Aminu,26-194,F,4/3/17,POR,MIN,0,35,7,14,0.5,3,7,0.429,4,7,0.571,2,2,1,6,1,7,5,0,3,0,1,20,22.7
Gary Harris,22-209,G,4/11/17,DEN,DAL,1,35,6,10,0.6,2,3,0.667,4,7,0.571,4,6,0.667,2,6,8,8,1,0,3,1,20,21
Al Horford,30-171,C-F,11/21/16,BOS,MIN,1,36,9,20,0.45,7,13,0.538,2,7,0.286,0,0,,4,2,6,5,1,3,0,2,20,18.8
Dwight Howard,31-106,C,3/24/17,ATL,MIL,1,32,7,11,0.636,7,11,0.636,0,0,,6,8,0.75,2,10,12,1,0,0,3,2,20,15.6
DeAndre Jordan,28-162,C,12/30/16,LAC,HOU,1,30,9,11,0.818,9,11,0.818,0,0,,2,2,1,4,9,13,1,0,1,1,3,20,20.6
Matt Barnes,36-297,F,12/31/16,SAC,MEM,1,33,5,8,0.625,0,1,0,5,7,0.714,5,7,0.714,1,7,8,3,0,0,1,1,20,19.1
Mike Conley,29-116,G,2/4/17,MEM,MIN,1,36,5,16,0.313,5,11,0.455,0,5,0,10,12,0.833,0,2,2,8,0,0,3,2,20,12.4
Kyle Lowry,30-294,G,1/13/17,TOR,BRK,1,36,8,14,0.571,5,7,0.714,3,7,0.429,1,2,0.5,2,4,6,6,2,2,3,1,20,19.8
Derrick Rose,28-150,G,3/3/17,NYK,PHI,1,38,5,13,0.385,5,13,0.385,0,0,,10,13,0.769,1,3,4,5,2,0,3,0,20,15.8
Mike Conley,29-022,G,11/2/16,MEM,NOP,1,38,6,14,0.429,4,9,0.444,2,5,0.4,6,6,1,0,1,1,3,1,0,4,1,20,11.6
Dirk Nowitzki,38-235,F,2/9/17,DAL,UTA,1,37,8,17,0.471,8,15,0.533,0,2,0,4,5,0.8,1,6,7,2,2,0,2,4,20,13.2
Marquese Chriss,19-271,F,3/30/17,PHO,LAC,1,34,9,13,0.692,7,8,0.875,2,5,0.4,0,0,,1,5,6,2,1,0,4,5,20,13.1
Avery Bradley,26-114,G,3/20/17,BOS,WAS,1,34,8,16,0.5,4,8,0.5,4,8,0.5,0,0,,3,6,9,4,1,0,0,3,20,18.5
Gordon Hayward,26-296,F-G,1/13/17,UTA,DET,1,26,8,12,0.667,5,5,1,3,7,0.429,1,2,0.5,0,4,4,3,3,0,3,1,20,17.3
Kyle Korver,35-321,G-F,2/1/17,CLE,MIN,0,24,8,11,0.727,4,4,1,4,7,0.571,0,0,,0,1,1,2,0,1,0,2,20,17.1
Tony Parker,34-225,G,12/28/16,SAS,PHO,1,29,10,16,0.625,10,15,0.667,0,1,0,0,1,0,0,1,1,3,0,0,2,1,20,12.4
Jon Leuer,27-277,F,2/15/17,DET,DAL,1,34,5,7,0.714,5,7,0.714,0,0,,10,10,1,1,7,8,0,0,1,1,2,20,18.8
Nikola Mirotic,26-013,F,2/24/17,CHI,PHO,0,37,5,10,0.5,1,3,0.333,4,7,0.571,6,7,0.857,0,8,8,2,0,0,3,2,20,14.6
Channing Frye,33-180,C-F,11/13/16,CLE,CHO,0,25,7,15,0.467,1,3,0.333,6,12,0.5,0,0,,0,3,3,0,0,3,1,3,20,13.1
Austin Rivers,24-171,G,1/19/17,LAC,MIN,1,36,7,14,0.5,5,10,0.5,2,4,0.5,4,5,0.8,0,1,1,2,0,1,2,6,20,10.6
Serge Ibaka,27-136,F-C,2/1/17,ORL,IND,1,36,6,16,0.375,4,9,0.444,2,7,0.286,6,6,1,1,8,9,1,2,2,0,0,20,18.4
C.J. Miles,29-201,G-F,11/5/16,IND,CHI,0,22,8,14,0.571,4,7,0.571,4,7,0.571,0,0,,0,4,4,1,0,0,0,4,20,13.7
Victor Oladipo,24-342,G,4/11/17,OKC,MIN,1,34,8,16,0.5,7,11,0.636,1,5,0.2,3,3,1,3,6,9,6,0,0,8,2,20,11.3
Eric Bledsoe,26-329,G,11/2/16,PHO,POR,1,40,7,20,0.35,6,16,0.375,1,4,0.25,5,5,1,3,4,7,4,1,0,3,4,20,11.3
DeMarre Carroll,30-119,F,11/23/16,TOR,HOU,1,27,9,14,0.643,7,9,0.778,2,5,0.4,0,0,,2,1,3,2,4,3,2,1,20,20.6
Kyrie Irving,24-251,G,11/29/16,CLE,MIL,1,31,5,12,0.417,3,7,0.429,2,5,0.4,8,8,1,0,2,2,3,1,0,3,3,20,13.1
Markieff Morris,27-070,F,11/11/16,WAS,CLE,1,33,6,14,0.429,5,11,0.455,1,3,0.333,7,7,1,1,4,5,1,1,1,1,2,20,15.1
Kemba Walker,26-229,G,12/23/16,CHO,CHI,1,32,6,16,0.375,4,13,0.308,2,3,0.667,6,6,1,2,3,5,4,1,0,1,0,20,16.3
Dario Saric,22-306,F,2/8/17,PHI,SAS,0,21,8,11,0.727,4,6,0.667,4,5,0.8,0,0,,0,1,1,3,0,0,2,2,20,15.1
Thabo Sefolosha,32-191,G-F,11/9/16,ATL,CHI,0,29,8,9,0.889,6,6,1,2,3,0.667,2,2,1,1,4,5,1,3,1,4,0,20,19.2
Seth Curry,26-155,G,1/25/17,DAL,NYK,1,34,8,19,0.421,6,13,0.462,2,6,0.333,2,2,1,0,5,5,0,3,1,2,2,20,12.3
Wesley Matthews,30-120,G,2/11/17,DAL,ORL,1,25,7,10,0.7,1,2,0.5,6,8,0.75,0,0,,0,4,4,6,1,0,1,3,20,20
Jordan Clarkson,24-164,G,11/18/16,LAL,SAS,0,31,7,15,0.467,4,11,0.364,3,4,0.75,3,4,0.75,1,2,3,3,2,0,3,2,20,13.5
Dwight Howard,30-332,C,11/4/16,ATL,WAS,1,29,7,12,0.583,7,12,0.583,0,0,,6,12,0.5,5,7,12,1,2,0,4,5,20,14.3
Tyler Ennis,22-228,G,4/9/17,LAL,MIN,0,23,7,9,0.778,3,4,0.75,4,5,0.8,2,2,1,0,2,2,5,0,1,0,3,20,20.1
Lou Williams,30-008,G,11/4/16,LAL,GSW,0,26,7,14,0.5,5,8,0.625,2,6,0.333,4,5,0.8,0,2,2,4,3,1,2,0,20,17.7
Damian Lillard,26-155,G,12/17/16,POR,GSW,1,30,8,15,0.533,7,12,0.583,1,3,0.333,3,3,1,0,2,2,1,1,0,2,1,20,12.6
Marc Gasol,32-039,C,3/9/17,MEM,LAC,1,33,8,16,0.5,7,12,0.583,1,4,0.25,3,3,1,0,5,5,5,1,1,1,2,20,16.9
Rondae Hollis-Jefferson,22-072,F,3/16/17,BRK,NYK,1,25,7,12,0.583,7,11,0.636,0,1,0,6,6,1,5,5,10,0,1,1,1,4,20,18.5
Nicolas Batum,27-324,F-G,11/2/16,CHO,PHI,1,34,7,15,0.467,3,6,0.5,4,9,0.444,2,2,1,2,5,7,4,1,0,4,2,20,14.2
Terrence Ross,26-028,F-G,3/5/17,ORL,WAS,1,32,8,18,0.444,4,8,0.5,4,10,0.4,0,0,,0,4,4,1,2,2,2,5,20,11.9
Goran Dragic,30-269,G,1/30/17,MIA,BRK,1,33,6,13,0.462,5,11,0.455,1,2,0.5,7,11,0.636,1,2,3,8,3,0,1,4,20,19
Devin Booker,20-094,G,2/1/17,PHO,LAC,1,35,7,19,0.368,6,16,0.375,1,3,0.333,5,5,1,2,2,4,6,0,1,1,3,20,14.2
Bradley Beal,23-258,G,3/13/17,WAS,MIN,1,38,7,21,0.333,4,10,0.4,3,11,0.273,3,3,1,2,5,7,2,3,0,0,3,20,14.2
Otto Porter,23-222,F,1/11/17,WAS,BOS,1,37,9,12,0.75,7,10,0.7,2,2,1,0,0,,2,4,6,4,3,0,0,1,20,23.2
DeAndre Jordan,28-248,C,3/26/17,LAC,SAC,1,30,8,10,0.8,8,10,0.8,0,0,,4,7,0.571,1,10,11,0,1,1,0,1,20,20
Mike Dunleavy,36-204,F-G,4/7/17,ATL,CLE,0,20,6,9,0.667,2,4,0.5,4,5,0.8,4,4,1,0,1,1,1,1,0,0,2,20,17.3
Kevin Durant,28-065,F-G,12/3/16,GSW,PHO,1,32,5,7,0.714,4,6,0.667,1,1,1,9,9,1,0,4,4,8,0,3,1,1,20,24.6
Serge Ibaka,27-101,F-C,12/28/16,ORL,CHO,1,30,9,14,0.643,7,9,0.778,2,5,0.4,0,0,,2,5,7,3,0,3,1,1,20,19.5
Derrick Rose,28-061,G,12/4/16,NYK,SAC,1,34,9,14,0.643,9,14,0.643,0,0,,2,3,0.667,2,4,6,6,0,0,4,1,20,15.8
Dwyane Wade,34-348,G,12/30/16,CHI,IND,1,30,8,18,0.444,7,16,0.438,1,2,0.5,3,4,0.75,0,2,2,5,2,0,3,2,20,12.5
Gary Harris,22-205,G,4/7/17,DEN,NOP,1,37,7,14,0.5,4,7,0.571,3,7,0.429,3,3,1,0,6,6,9,1,0,1,1,20,20.7
Devin Booker,20-062,G,12/31/16,PHO,UTA,1,36,9,19,0.474,8,16,0.5,1,3,0.333,1,1,1,0,3,3,1,3,0,1,2,20,13.1
Jordan McRae,25-278,G,12/31/16,CLE,CHO,1,31,8,12,0.667,5,8,0.625,3,4,0.75,1,1,1,0,4,4,1,0,0,0,2,20,15.9
Andre Drummond,23-081,C,10/30/16,DET,MIL,1,37,8,16,0.5,8,16,0.5,0,0,,4,8,0.5,8,15,23,1,2,3,0,1,20,24.9
Eric Gordon,27-358,G,12/17/16,HOU,MIN,0,36,7,15,0.467,3,5,0.6,4,10,0.4,2,2,1,1,5,6,4,2,0,1,3,20,17.1
Brook Lopez,28-286,C,1/12/17,BRK,NOP,1,32,9,18,0.5,8,12,0.667,1,6,0.167,1,2,0.5,1,5,6,3,1,1,6,3,20,9.4
Ty Lawson,29-157,G,4/9/17,SAC,HOU,1,28,7,12,0.583,7,11,0.636,0,1,0,6,6,1,0,2,2,11,1,0,2,1,20,21.3
Victor Oladipo,24-309,G,3/9/17,OKC,SAS,1,28,8,15,0.533,5,11,0.455,3,4,0.75,1,1,1,0,4,4,3,1,0,1,2,20,15.2
Robert Covington,26-073,F,2/25/17,PHI,NYK,1,39,7,19,0.368,5,8,0.625,2,11,0.182,4,4,1,0,10,10,2,3,2,2,4,20,14.7
C.J. McCollum,25-143,G,2/9/17,POR,BOS,1,37,8,18,0.444,8,12,0.667,0,6,0,4,5,0.8,1,3,4,4,0,1,3,4,20,10.7
Kent Bazemore,27-127,G-F,11/5/16,ATL,HOU,1,32,7,12,0.583,4,8,0.5,3,4,0.75,3,3,1,0,4,4,4,3,0,2,2,20,18.6
Trevor Ariza,31-222,F,2/7/17,HOU,ORL,1,36,7,15,0.467,3,6,0.5,4,9,0.444,2,3,0.667,3,4,7,4,2,0,1,1,20,18.6
Myles Turner,20-270,F-C,12/19/16,IND,WAS,1,33,8,13,0.615,7,11,0.636,1,2,0.5,3,5,0.6,1,7,8,1,0,5,2,6,20,15.9
Evan Fournier,24-153,G-F,3/31/17,ORL,BOS,1,35,6,13,0.462,4,6,0.667,2,7,0.286,6,6,1,1,0,1,2,2,0,1,3,20,15.2
Enes Kanter,24-217,C,12/23/16,OKC,BOS,0,23,8,13,0.615,8,13,0.615,0,0,,4,6,0.667,4,2,6,2,0,0,1,3,20,15.9
Isaiah Thomas,27-302,G,12/5/16,BOS,HOU,1,33,7,19,0.368,4,12,0.333,3,7,0.429,3,3,1,0,2,2,3,2,0,2,2,20,11.4
Dwyane Wade,34-326,G,12/8/16,CHI,SAS,1,34,5,13,0.385,4,10,0.4,1,3,0.333,9,13,0.692,1,4,5,5,1,1,3,1,20,15
Shabazz Muhammad,24-126,F-G,3/19/17,MIN,NOP,0,24,8,13,0.615,7,10,0.7,1,3,0.333,3,5,0.6,2,4,6,1,1,0,1,0,20,16.6
Brook Lopez,28-238,C,11/25/16,BRK,IND,1,24,8,13,0.615,6,10,0.6,2,3,0.667,2,3,0.667,1,3,4,2,0,1,3,3,20,13.2
LeBron James,32-012,F-G,1/11/17,CLE,POR,1,31,5,12,0.417,3,7,0.429,2,5,0.4,8,9,0.889,1,10,11,4,1,1,5,1,20,16
Danilo Gallinari,28-214,F,3/10/17,DEN,BOS,1,34,6,12,0.5,3,7,0.429,3,5,0.6,5,5,1,2,3,5,1,2,0,2,2,20,16.2
Evan Fournier,24-154,G-F,4/1/17,ORL,BRK,1,37,8,16,0.5,6,12,0.5,2,4,0.5,2,4,0.5,0,1,1,1,2,0,2,3,20,11
Kenneth Faried,26-363,F,11/16/16,DEN,PHO,1,26,8,12,0.667,8,12,0.667,0,0,,4,5,0.8,6,9,15,0,4,1,4,5,20,20
Gary Harris,22-198,G,3/31/17,DEN,CHO,1,41,8,14,0.571,5,7,0.714,3,7,0.429,1,1,1,0,5,5,3,0,0,1,4,20,14.4
Kawhi Leonard,25-136,F,11/12/16,SAS,HOU,1,38,9,16,0.563,9,11,0.818,0,5,0,2,2,1,0,2,2,0,4,0,2,3,20,13.8
John Henson,25-341,C-F,12/3/16,MIL,BRK,1,27,7,11,0.636,7,11,0.636,0,0,,6,7,0.857,1,6,7,2,1,2,1,3,20,18.8
Kevin Durant,28-033,F-G,11/1/16,GSW,POR,1,31,9,15,0.6,9,12,0.75,0,3,0,2,3,0.667,1,4,5,2,4,1,2,3,20,17.5
Nicolas Batum,28-014,F-G,12/28/16,CHO,ORL,1,30,8,12,0.667,5,8,0.625,3,4,0.75,1,1,1,0,9,9,8,1,0,3,2,20,20.3
Wilson Chandler,29-207,F,12/3/16,DEN,UTA,0,41,7,14,0.5,4,8,0.5,3,6,0.5,3,3,1,0,5,5,3,2,0,0,4,20,17
Stephen Curry,28-250,G,11/19/16,GSW,MIL,1,35,7,21,0.333,6,10,0.6,1,11,0.091,5,5,1,0,5,5,5,1,0,3,4,20,9.5
Ricky Rubio,26-147,G,3/17/17,MIN,MIA,1,33,8,14,0.571,8,14,0.571,0,0,,4,4,1,0,0,0,6,2,1,3,5,20,15.3
Mike Conley,29-173,G,4/2/17,MEM,LAL,1,36,6,17,0.353,2,6,0.333,4,11,0.364,4,4,1,0,3,3,12,1,1,0,3,20,20.3
Nicolas Batum,28-009,F-G,12/23/16,CHO,CHI,1,40,7,15,0.467,6,10,0.6,1,5,0.2,5,6,0.833,2,9,11,10,1,1,2,0,20,22.7
Paul Millsap,31-311,F,12/17/16,ATL,CHO,1,34,8,17,0.471,6,14,0.429,2,3,0.667,2,2,1,0,5,5,5,1,0,1,1,20,15.9
Al Jefferson,32-014,C-F,1/18/17,IND,SAC,0,17,9,12,0.75,9,12,0.75,0,0,,2,2,1,2,1,3,1,0,0,0,3,20,16.4
Evan Fournier,24-097,G-F,2/3/17,ORL,TOR,1,36,5,12,0.417,3,8,0.375,2,4,0.5,8,10,0.8,3,7,10,4,0,0,2,2,20,17
Willie Reed,26-256,F-C,1/27/17,MIA,CHI,1,37,9,11,0.818,9,11,0.818,0,0,,2,2,1,2,3,5,1,1,0,0,3,20,18.7
Jordan Clarkson,24-193,G,12/17/16,LAL,CLE,0,31,7,12,0.583,3,5,0.6,4,7,0.571,2,2,1,2,3,5,1,0,0,2,3,20,14.2
Anthony Davis,23-360,F-C,3/6/17,NOP,UTA,1,37,7,17,0.412,6,14,0.429,1,3,0.333,5,6,0.833,5,7,12,1,2,0,5,2,20,13
Al Jefferson,32-016,C-F,1/20/17,IND,LAL,0,17,7,15,0.467,7,15,0.467,0,0,,6,6,1,1,5,6,1,2,0,0,1,20,16.8
Tobias Harris,24-232,F,3/4/17,DET,PHI,0,32,8,16,0.5,6,12,0.5,2,4,0.5,2,2,1,0,9,9,1,2,1,1,2,20,16.3
Jae Crowder,26-189,F,1/11/17,BOS,WAS,1,34,7,10,0.7,3,4,0.75,4,6,0.667,2,2,1,0,6,6,1,1,1,0,0,20,20
Bradley Beal,23-278,G,4/2/17,WAS,GSW,1,31,8,15,0.533,6,13,0.462,2,2,1,2,4,0.5,0,2,2,5,2,0,3,1,20,14.6
Bradley Beal,23-132,G,11/7/16,WAS,HOU,1,34,8,18,0.444,6,12,0.5,2,6,0.333,2,2,1,1,1,2,3,4,1,1,3,20,16.2
Jimmy Butler,27-112,G-F,1/4/17,CHI,CLE,1,38,7,20,0.35,4,12,0.333,3,8,0.375,3,4,0.75,3,3,6,8,1,0,0,2,20,17.2
Brook Lopez,28-287,C,1/13/17,BRK,TOR,1,29,6,17,0.353,6,14,0.429,0,3,0,8,10,0.8,0,3,3,5,1,1,1,2,20,14
Domantas Sabonis,20-234,F,12/23/16,OKC,BOS,1,25,8,11,0.727,4,5,0.8,4,6,0.667,0,0,,0,1,1,1,1,0,1,1,20,16.1
Bradley Beal,23-169,G,12/14/16,WAS,CHO,1,37,6,16,0.375,3,9,0.333,3,7,0.429,5,6,0.833,0,4,4,9,0,0,1,4,20,15.7
Justin Hamilton,26-357,C,3/24/17,BRK,WAS,0,23,7,11,0.636,5,8,0.625,2,3,0.667,4,6,0.667,0,6,6,2,0,0,0,0,20,17.5
Thaddeus Young,28-152,F,11/20/16,IND,OKC,1,38,9,18,0.5,7,13,0.538,2,5,0.4,0,3,0,4,7,11,1,2,0,1,0,20,16.4
Terrence Ross,25-273,F-G,11/4/16,TOR,MIA,0,21,8,15,0.533,5,8,0.625,3,7,0.429,1,1,1,0,4,4,0,1,0,0,3,20,13.7
Hassan Whiteside,27-150,C,11/10/16,MIA,CHI,1,37,8,18,0.444,8,18,0.444,0,0,,4,4,1,8,12,20,0,1,3,3,3,20,18.7
Jeff Teague,28-159,G,11/16/16,IND,CLE,1,35,7,12,0.583,5,8,0.625,2,4,0.5,4,4,1,0,4,4,8,1,1,2,3,20,19.7
Enes Kanter,24-219,C,12/25/16,OKC,MIN,0,29,8,10,0.8,8,9,0.889,0,1,0,4,7,0.571,0,4,4,4,1,0,3,2,20,16.2
Harrison Barnes,24-168,F,11/14/16,DAL,NYK,1,35,8,17,0.471,8,15,0.533,0,2,0,4,6,0.667,0,3,3,1,1,1,3,1,20,10.4
Enes Kanter,24-169,C,11/5/16,OKC,MIN,0,21,9,14,0.643,9,13,0.692,0,1,0,2,4,0.5,3,7,10,1,1,1,3,2,20,15.8
Paul Millsap,32-024,F,3/6/17,ATL,GSW,1,39,6,16,0.375,4,12,0.333,2,4,0.5,6,6,1,4,6,10,4,0,1,2,3,20,16.1
Jordan Crawford,28-166,G,4/7/17,NOP,DEN,0,30,10,16,0.625,10,13,0.769,0,3,0,0,1,0,0,1,1,3,1,0,2,0,20,13.8
Andre Drummond,23-101,C,11/19/16,DET,BOS,1,31,9,16,0.563,9,16,0.563,0,0,,2,6,0.333,3,14,17,0,0,0,1,2,20,15.3
Zach LaVine,21-324,G,1/28/17,MIN,BRK,1,37,6,11,0.545,3,5,0.6,3,6,0.5,5,7,0.714,0,6,6,2,2,1,1,1,20,18.4
Damian Lillard,26-177,G,1/8/17,POR,DET,1,43,7,16,0.438,4,7,0.571,3,9,0.333,3,4,0.75,0,9,9,5,0,0,5,0,20,12.4
Kentavious Caldwell-Pope,23-303,G,12/17/16,DET,IND,1,36,6,18,0.333,1,8,0.125,5,10,0.5,3,3,1,2,3,5,3,1,0,0,3,20,14
Avery Bradley,26-022,G,12/18/16,BOS,MIA,1,34,9,16,0.563,7,12,0.583,2,4,0.5,0,0,,1,4,5,0,1,0,2,3,20,12.1
Jimmy Butler,27-149,G-F,2/10/17,CHI,PHO,1,30,6,16,0.375,6,13,0.462,0,3,0,8,9,0.889,2,1,3,6,2,0,2,3,20,15.5
Tim Frazier,26-000,G,11/1/16,NOP,MIL,1,37,7,12,0.583,6,9,0.667,1,3,0.333,5,6,0.833,1,2,3,9,3,1,3,4,20,20.7
Russell Westbrook,27-357,G,11/3/16,OKC,GSW,1,29,4,15,0.267,2,11,0.182,2,4,0.5,10,14,0.714,1,5,6,10,1,2,6,3,20,13.9
Carmelo Anthony,32-153,F,10/29/16,NYK,MEM,1,36,5,15,0.333,4,10,0.4,1,5,0.2,9,12,0.75,0,6,6,5,0,0,3,2,20,11.8
Tim Hardaway,24-241,G,11/12/16,ATL,PHI,0,18,7,13,0.538,2,3,0.667,5,10,0.5,1,2,0.5,0,3,3,1,0,0,1,0,20,13.9
D'Angelo Russell,20-250,G,10/30/16,LAL,OKC,1,32,7,20,0.35,3,11,0.273,4,9,0.444,2,2,1,1,4,5,5,2,0,3,1,20,12.8
Danilo Gallinari,28-200,F,2/24/17,DEN,BRK,1,25,8,13,0.615,5,7,0.714,3,6,0.5,1,2,0.5,1,7,8,0,0,0,1,1,20,15.1
Jabari Parker,21-316,F,1/25/17,MIL,PHI,1,38,8,16,0.5,8,12,0.667,0,4,0,4,5,0.8,1,3,4,2,0,3,3,3,20,12.5
Mike Conley,29-099,G,1/18/17,MEM,WAS,1,31,5,13,0.385,3,8,0.375,2,5,0.4,8,9,0.889,1,2,3,6,0,0,5,2,20,12.2
Gorgui Dieng,26-308,C,11/21/16,MIN,BOS,1,40,10,16,0.625,10,16,0.625,0,0,,0,2,0,6,4,10,3,1,1,5,3,20,15
Thaddeus Young,28-293,F,4/10/17,IND,PHI,1,33,10,15,0.667,10,15,0.667,0,0,,0,0,,4,4,8,3,1,0,1,2,20,18.8
C.J. McCollum,25-100,G,12/28/16,POR,SAC,1,35,6,18,0.333,4,12,0.333,2,6,0.333,6,7,0.857,0,2,2,7,1,0,2,0,20,13.9
Kyrie Irving,24-245,G,11/23/16,CLE,POR,1,33,8,15,0.533,5,9,0.556,3,6,0.5,1,2,0.5,0,2,2,6,1,0,3,2,20,14.3
Arron Afflalo,31-080,G,1/3/17,SAC,DEN,0,30,8,11,0.727,6,7,0.857,2,4,0.5,1,1,1,0,2,2,2,1,0,2,1,19,15.1
Nicolas Batum,28-100,F-G,3/24/17,CHO,CLE,1,35,7,18,0.389,5,9,0.556,2,9,0.222,3,3,1,0,2,2,2,2,0,2,1,19,10.8
Jaylen Brown,20-010,F,11/3/16,BOS,CLE,1,35,8,16,0.5,5,10,0.5,3,6,0.5,0,1,0,3,2,5,2,3,1,1,4,19,15.8
Willie Cauley-Stein,23-237,F-C,4/12/17,SAC,LAC,1,35,9,18,0.5,9,18,0.5,0,0,,1,1,1,2,12,14,6,0,1,2,2,19,17.1
Joe Ingles,29-176,F-G,3/27/17,UTA,NOP,1,35,7,13,0.538,2,8,0.25,5,5,1,0,0,,1,3,4,4,2,0,3,2,19,15.3
Cheick Diallo,20-210,F,4/11/17,NOP,LAL,0,27,9,10,0.9,9,10,0.9,0,0,,1,2,0.5,3,8,11,0,0,2,2,2,19,18.3
Kentavious Caldwell-Pope,23-257,G,11/1/16,DET,NYK,1,34,7,11,0.636,3,5,0.6,4,6,0.667,1,1,1,0,3,3,3,1,0,1,0,19,17.1
T.J. Warren,23-107,F,12/21/16,PHO,HOU,0,29,9,17,0.529,8,14,0.571,1,3,0.333,0,0,,1,4,5,0,1,1,0,5,19,12.3
Kevin Love,28-052,F,10/29/16,CLE,ORL,1,33,6,17,0.353,6,12,0.5,0,5,0,7,7,1,3,2,5,0,0,1,4,6,19,6.5
Al Horford,30-311,C-F,4/10/17,BOS,BRK,1,33,8,17,0.471,7,14,0.5,1,3,0.333,2,4,0.5,1,7,8,4,1,1,1,3,19,14.6
Serge Ibaka,27-112,F-C,1/8/17,ORL,LAL,1,38,8,17,0.471,7,14,0.5,1,3,0.333,2,2,1,6,4,10,0,1,1,1,4,19,14.8
Gordon Hayward,26-342,F-G,2/28/17,UTA,OKC,1,33,7,17,0.412,4,11,0.364,3,6,0.5,2,2,1,1,1,2,5,3,0,0,1,19,17
Tony Snell,25-121,G-F,3/11/17,MIL,MIN,1,28,6,9,0.667,2,2,1,4,7,0.571,3,4,0.75,1,5,6,0,2,0,1,2,19,17.1
Nicolas Batum,28-030,F-G,1/13/17,CHO,PHI,1,32,7,14,0.5,6,11,0.545,1,3,0.333,4,4,1,1,4,5,2,1,0,1,2,19,14.5
Al Horford,30-189,C-F,12/9/16,BOS,TOR,1,32,5,14,0.357,2,6,0.333,3,8,0.375,6,9,0.667,1,6,7,6,0,1,4,2,19,12.6
C.J. Miles,29-317,G-F,3/1/17,IND,SAS,1,28,7,15,0.467,3,5,0.6,4,10,0.4,1,1,1,1,5,6,0,0,0,1,2,19,11.7
Gary Harris,22-195,G,3/28/17,DEN,POR,1,37,8,14,0.571,7,11,0.636,1,3,0.333,2,3,0.667,0,2,2,3,2,0,0,1,19,16.3
Bojan Bogdanovic,27-233,G-F,12/7/16,BRK,DEN,1,34,8,11,0.727,7,9,0.778,1,2,0.5,2,2,1,1,0,1,3,0,0,1,1,19,15.9
Evan Fournier,24-071,G-F,1/8/17,ORL,LAL,1,34,6,16,0.375,4,12,0.333,2,4,0.5,5,7,0.714,1,4,5,3,3,0,4,2,19,11.6
Marc Gasol,32-010,C,2/8/17,MEM,PHO,1,35,6,11,0.545,5,9,0.556,1,2,0.5,6,6,1,1,6,7,3,0,0,4,2,19,13.5
Robert Covington,26-077,F,3/1/17,PHI,MIA,1,26,5,11,0.455,2,4,0.5,3,7,0.429,6,8,0.75,0,5,5,0,1,1,1,2,19,13.9
Austin Rivers,24-147,G,12/26/16,LAC,DEN,1,42,8,17,0.471,6,11,0.545,2,6,0.333,1,1,1,0,3,3,5,1,0,5,0,19,10.7
Bradley Beal,23-161,G,12/6/16,WAS,ORL,1,37,7,18,0.389,4,12,0.333,3,6,0.5,2,4,0.5,1,2,3,4,0,0,3,3,19,8.3
Mason Plumlee,26-263,C-F,11/23/16,POR,CLE,1,23,9,10,0.9,9,10,0.9,0,0,,1,2,0.5,2,2,4,3,0,1,0,3,19,18.8
Mike Conley,29-070,G,12/20/16,MEM,BOS,1,36,6,16,0.375,3,8,0.375,3,8,0.375,4,6,0.667,1,4,5,8,2,0,4,3,19,13.7
Wesley Matthews,30-093,G,1/15/17,DAL,MIN,1,35,7,15,0.467,3,7,0.429,4,8,0.5,1,2,0.5,0,7,7,1,0,1,1,2,19,12.6
Eric Bledsoe,26-333,G,11/6/16,PHO,LAL,1,30,7,14,0.5,7,10,0.7,0,4,0,5,6,0.833,1,1,2,2,2,0,6,5,19,8
D.J. Augustin,29-001,G,11/11/16,ORL,UTA,0,24,6,10,0.6,3,4,0.75,3,6,0.5,4,5,0.8,0,0,0,3,0,0,3,1,19,12.7
George Hill,30-313,G,3/13/17,UTA,LAC,1,37,7,15,0.467,5,11,0.455,2,4,0.5,3,5,0.6,0,8,8,6,1,0,0,4,19,16.5
Hassan Whiteside,27-155,C,11/15/16,MIA,ATL,1,38,6,15,0.4,6,15,0.4,0,0,,7,8,0.875,10,15,25,2,2,1,4,3,19,20.9
Bradley Beal,23-269,G,3/24/17,WAS,BRK,1,25,7,13,0.538,6,11,0.545,1,2,0.5,4,4,1,0,1,1,3,1,0,0,1,19,15.7
Patty Mills,28-106,G,11/25/16,SAS,BOS,0,24,6,8,0.75,4,5,0.8,2,3,0.667,5,5,1,0,1,1,1,1,0,4,2,19,13
Wilson Chandler,29-276,F,2/10/17,DEN,NYK,1,37,9,14,0.643,8,12,0.667,1,2,0.5,0,0,,1,3,4,3,2,2,2,2,19,17.1
Tyler Johnson,24-336,G,4/8/17,MIA,WAS,0,37,6,15,0.4,3,10,0.3,3,5,0.6,4,7,0.571,0,4,4,2,1,0,1,2,19,11.5
Gary Harris,22-165,G,2/26/17,DEN,MEM,1,34,8,16,0.5,5,8,0.625,3,8,0.375,0,0,,2,1,3,3,1,1,1,3,19,14.3
Eric Gordon,28-060,G,2/23/17,HOU,NOP,0,30,5,16,0.313,1,2,0.5,4,14,0.286,5,5,1,0,1,1,1,2,0,1,3,19,10.6
Mason Plumlee,26-244,C-F,11/4/16,POR,DAL,1,34,7,9,0.778,7,9,0.778,0,0,,5,5,1,1,3,4,4,4,1,2,2,19,21.8
Reggie Jackson,26-269,G,1/10/17,DET,SAC,1,31,8,15,0.533,5,10,0.5,3,5,0.6,0,1,0,0,2,2,3,0,0,4,3,19,8.8
Josh Richardson,23-061,G,11/15/16,MIA,ATL,1,38,8,14,0.571,7,11,0.636,1,3,0.333,2,2,1,1,3,4,2,2,3,3,3,19,15.3
Gerald Henderson,28-348,G,11/21/16,PHI,MIA,1,32,6,8,0.75,3,5,0.6,3,3,1,4,4,1,0,3,3,2,0,0,1,3,19,15.9
Matt Barnes,36-334,F,2/6/17,SAC,CHI,0,33,7,10,0.7,4,6,0.667,3,4,0.75,2,2,1,1,8,9,5,0,0,3,3,19,17.2
LeBron James,31-331,F-G,11/25/16,CLE,DAL,1,29,6,13,0.462,4,8,0.5,2,5,0.4,5,5,1,0,5,5,11,1,0,4,1,19,18.1
Victor Oladipo,24-333,G,4/2/17,OKC,CHO,1,33,6,14,0.429,4,7,0.571,2,7,0.286,5,5,1,0,3,3,6,2,0,4,4,19,13.1
Kyle Lowry,30-229,G,11/9/16,TOR,OKC,1,43,6,20,0.3,1,9,0.111,5,11,0.455,2,2,1,2,7,9,13,0,1,5,4,19,14.1
Jamal Crawford,36-351,G,3/6/17,LAC,BOS,0,29,6,13,0.462,2,8,0.25,4,5,0.8,3,4,0.75,0,1,1,5,1,0,1,3,19,14.5
Brook Lopez,28-356,C,3/23/17,BRK,PHO,1,25,7,14,0.5,6,9,0.667,1,5,0.2,4,7,0.571,3,3,6,0,0,1,4,3,19,9.3
Mirza Teletovic,31-139,F,2/4/17,MIL,PHO,0,25,6,10,0.6,4,5,0.8,2,5,0.4,5,5,1,0,3,3,3,0,0,0,3,19,16.2
Rajon Rondo,31-006,G,2/28/17,CHI,DEN,0,24,8,15,0.533,7,12,0.583,1,3,0.333,2,2,1,1,3,4,5,3,0,1,2,19,18
Chris Paul,31-307,G,3/9/17,LAC,MEM,1,27,8,15,0.533,5,9,0.556,3,6,0.5,0,0,,1,3,4,7,0,0,2,1,19,15.8
Jabari Parker,21-293,F,1/2/17,MIL,OKC,1,41,7,17,0.412,5,13,0.385,2,4,0.5,3,4,0.75,2,4,6,2,0,1,4,2,19,9.4
Tobias Harris,24-201,F,2/1/17,DET,NOP,0,28,9,13,0.692,9,11,0.818,0,2,0,1,1,1,0,8,8,4,1,0,1,0,19,18.7
Wayne Ellington,29-039,G,12/7/16,MIA,ATL,1,41,7,15,0.467,3,6,0.5,4,9,0.444,1,1,1,0,3,3,2,0,0,0,0,19,13.6
Julius Randle,22-035,F,1/3/17,LAL,MEM,1,37,9,15,0.6,9,15,0.6,0,0,,1,4,0.25,2,12,14,11,1,0,2,3,19,21.4
Jrue Holiday,26-288,G,3/27/17,NOP,UTA,1,38,8,17,0.471,5,10,0.5,3,7,0.429,0,2,0,1,1,2,5,2,1,1,1,19,15.3
Jimmy Butler,27-204,G-F,4/6/17,CHI,PHI,1,37,5,12,0.417,5,11,0.455,0,1,0,9,9,1,0,10,10,10,2,0,6,0,19,18.6
Wayne Ellington,29-137,G,3/15/17,MIA,NOP,0,22,7,10,0.7,2,2,1,5,8,0.625,0,0,,0,2,2,1,1,0,0,2,19,16.3
C.J. McCollum,25-072,G,11/30/16,POR,IND,1,34,7,18,0.389,5,12,0.417,2,6,0.333,3,3,1,3,2,5,5,2,0,0,1,19,17
Elfrid Payton,22-326,G,1/13/17,ORL,POR,1,35,8,18,0.444,7,15,0.467,1,3,0.333,2,2,1,2,2,4,7,1,1,5,6,19,10.8
Jordan Crawford,28-134,G,3/6/17,NOP,UTA,0,20,8,15,0.533,5,8,0.625,3,7,0.429,0,0,,0,1,1,3,2,0,0,1,19,15.7
Kawhi Leonard,25-220,F,2/4/17,SAS,DEN,1,32,6,13,0.462,5,7,0.714,1,6,0.167,6,8,0.75,1,5,6,5,2,2,2,0,19,18.6
Justin Anderson,23-118,G,3/17/17,PHI,DAL,0,26,7,11,0.636,5,6,0.833,2,5,0.4,3,3,1,1,7,8,3,1,0,2,4,19,16.4
Andrew Wiggins,21-302,F-G,12/21/16,MIN,ATL,1,39,9,19,0.474,9,16,0.563,0,3,0,1,1,1,3,4,7,2,0,1,1,2,19,12.9
Jrue Holiday,26-278,G,3/17/17,NOP,HOU,1,28,9,17,0.529,9,12,0.75,0,5,0,1,2,0.5,0,4,4,6,1,3,1,2,19,17
Goran Dragic,30-262,G,1/23/17,MIA,GSW,1,36,5,14,0.357,4,9,0.444,1,5,0.2,8,13,0.615,2,2,4,5,1,0,4,1,19,11.3
Emmanuel Mudiay,20-267,G,11/27/16,DEN,PHO,1,37,5,13,0.385,4,10,0.4,1,3,0.333,8,10,0.8,1,3,4,6,0,0,2,4,19,13.3
Marvin Williams,30-200,F,1/5/17,CHO,DET,1,29,6,11,0.545,4,8,0.5,2,3,0.667,5,7,0.714,1,6,7,2,0,1,0,0,19,17.5
Joe Johnson,35-285,G-F,4/10/17,UTA,GSW,0,28,7,14,0.5,2,7,0.286,5,7,0.714,0,1,0,0,5,5,5,1,0,0,0,19,17.6
Monta Ellis,31-000,G,10/26/16,IND,DAL,1,44,7,11,0.636,6,9,0.667,1,2,0.5,4,4,1,0,7,7,7,3,0,3,3,19,19.9
Spencer Dinwiddie,24-002,G,4/8/17,BRK,CHI,0,26,6,9,0.667,5,6,0.833,1,3,0.333,6,6,1,1,2,3,4,2,0,1,0,19,20.2
Marvin Williams,30-143,F,11/9/16,CHO,UTA,1,30,7,11,0.636,2,4,0.5,5,7,0.714,0,0,,1,7,8,1,0,0,1,1,19,16.2
Jeff Teague,28-306,G,4/12/17,IND,ATL,1,32,6,9,0.667,5,7,0.714,1,2,0.5,6,8,0.75,0,0,0,7,0,0,1,1,19,17.8
John Wall,26-083,G,11/28/16,WAS,SAC,1,43,6,16,0.375,5,13,0.385,1,3,0.333,6,6,1,0,5,5,11,3,1,11,2,19,11.3
Rondae Hollis-Jefferson,22-080,F,3/24/17,BRK,WAS,1,22,9,13,0.692,9,13,0.692,0,0,,1,1,1,3,4,7,2,1,0,0,1,19,18.8
Devin Booker,20-060,G,12/29/16,PHO,TOR,1,38,6,19,0.316,5,15,0.333,1,4,0.25,6,7,0.857,0,5,5,5,1,0,1,3,19,11.5
DeMarcus Cousins,26-099,C-F,11/20/16,SAC,TOR,1,30,7,22,0.318,4,16,0.25,3,6,0.5,2,3,0.667,2,8,10,4,0,0,2,3,19,9.4
Danilo Gallinari,28-087,F,11/3/16,DEN,MIN,1,37,6,9,0.667,2,2,1,4,7,0.571,3,3,1,0,5,5,2,0,0,1,1,19,16.6
Bojan Bogdanovic,27-331,G-F,3/15/17,WAS,DAL,0,24,4,5,0.8,1,1,1,3,4,0.75,8,9,0.889,0,3,3,1,0,0,4,4,19,12.7
Ryan Anderson,28-264,F,1/25/17,HOU,BOS,1,36,5,8,0.625,2,4,0.5,3,4,0.75,6,7,0.857,3,2,5,1,1,0,2,3,19,16.2
Cody Zeller,24-164,F-C,3/18/17,CHO,WAS,1,33,8,10,0.8,8,10,0.8,0,0,,3,5,0.6,1,4,5,0,4,2,0,3,19,20.5
Rudy Gobert,24-209,C,1/21/17,UTA,IND,1,33,8,10,0.8,8,10,0.8,0,0,,3,5,0.6,5,6,11,0,0,1,2,1,19,18
LeBron James,31-359,F-G,12/23/16,CLE,BRK,1,27,7,16,0.438,7,13,0.538,0,3,0,5,6,0.833,1,4,5,6,3,0,1,0,19,18.3
Dennis Schroder,23-089,G,12/13/16,ATL,ORL,1,34,7,16,0.438,4,11,0.364,3,5,0.6,2,2,1,0,1,1,13,2,0,4,3,19,16.8
Carmelo Anthony,32-218,F,1/2/17,NYK,ORL,1,35,6,17,0.353,6,13,0.462,0,4,0,7,8,0.875,1,6,7,3,3,1,1,3,19,15.2
Terrence Jones,24-300,F,11/4/16,NOP,PHO,1,28,9,14,0.643,8,11,0.727,1,3,0.333,0,4,0,2,5,7,6,2,4,1,0,19,22.1
Jeff Green,30-108,F,12/14/16,ORL,LAC,0,27,7,11,0.636,3,6,0.5,4,5,0.8,1,1,1,0,3,3,2,2,0,2,4,19,14.8
Marvin Williams,30-181,F,12/17/16,CHO,ATL,1,30,7,10,0.7,3,4,0.75,4,6,0.667,1,2,0.5,1,5,6,2,1,0,1,1,19,17.6
Andrew Wiggins,21-327,F-G,1/15/17,MIN,DAL,1,38,8,15,0.533,7,12,0.583,1,3,0.333,2,2,1,1,7,8,4,1,0,2,1,19,15.9
Julius Randle,22-040,F,1/8/17,LAL,ORL,1,34,6,12,0.5,5,11,0.455,1,1,1,6,8,0.75,1,8,9,5,1,1,2,5,19,16.5
Ty Lawson,29-048,G,12/21/16,SAC,UTA,0,26,7,11,0.636,7,10,0.7,0,1,0,5,8,0.625,0,5,5,1,1,0,1,2,19,14.3
Kyrie Irving,25-013,G,4/5/17,CLE,BOS,1,32,7,18,0.389,6,12,0.5,1,6,0.167,4,5,0.8,0,1,1,5,2,1,0,4,19,13.7
Monta Ellis,31-153,G,3/28/17,IND,MIN,1,34,8,11,0.727,8,8,1,0,3,0,3,4,0.75,1,4,5,5,2,1,2,3,19,19
Josh Richardson,23-202,G,4/5/17,MIA,CHO,1,36,6,14,0.429,2,7,0.286,4,7,0.571,3,3,1,0,5,5,5,0,1,1,4,19,14.7
Giannis Antetokounmpo,22-038,F-G,1/13/17,MIL,MIA,1,36,8,12,0.667,8,12,0.667,0,0,,3,4,0.75,1,7,8,6,1,1,3,2,19,18.3
Marcin Gortat,32-324,C-F,1/6/17,WAS,MIN,1,33,9,9,1,9,9,1,0,0,,1,2,0.5,2,8,10,1,0,3,5,3,19,16.3
Norman Powell,23-292,G,3/13/17,TOR,DAL,1,31,6,8,0.75,4,4,1,2,4,0.5,5,5,1,0,5,5,3,0,0,0,2,19,18.6
Austin Rivers,24-090,G,10/30/16,LAC,UTA,0,29,8,11,0.727,6,7,0.857,2,4,0.5,1,2,0.5,0,2,2,1,0,0,3,2,19,11.6
Marc Gasol,32-015,C,2/13/17,MEM,BRK,1,37,6,17,0.353,6,13,0.462,0,4,0,7,7,1,1,9,10,8,1,1,2,1,19,17.8
Marquese Chriss,19-273,F,4/1/17,PHO,POR,1,34,7,10,0.7,6,8,0.75,1,2,0.5,4,4,1,2,11,13,1,1,2,4,1,19,18.2
Gordon Hayward,26-364,F-G,3/22/17,UTA,NYK,1,39,6,17,0.353,5,10,0.5,1,7,0.143,6,9,0.667,3,5,8,3,1,0,0,0,19,15
Austin Rivers,24-206,G,2/23/17,LAC,GSW,1,37,7,16,0.438,3,7,0.429,4,9,0.444,1,2,0.5,0,2,2,2,2,0,3,1,19,10.8
Enes Kanter,24-208,C,12/14/16,OKC,UTA,0,18,6,11,0.545,6,11,0.545,0,0,,7,8,0.875,1,1,2,1,1,1,0,2,19,15.9
Khris Middleton,25-229,F-G,3/29/17,MIL,BOS,1,34,8,14,0.571,5,11,0.455,3,3,1,0,1,0,1,5,6,5,2,1,4,4,19,14.8
Tyler Ulis,21-071,G,3/17/17,PHO,ORL,1,40,8,17,0.471,8,15,0.533,0,2,0,3,4,0.75,1,3,4,8,1,0,3,1,19,14.7
Tobias Harris,24-187,F,1/18/17,DET,ATL,1,27,7,12,0.583,3,6,0.5,4,6,0.667,1,2,0.5,0,5,5,0,1,0,1,5,19,12.5
Enes Kanter,24-236,C,1/11/17,OKC,MEM,0,30,8,18,0.444,8,16,0.5,0,2,0,3,3,1,3,9,12,3,2,0,4,3,19,13.3
Goran Dragic,30-252,G,1/13/17,MIA,MIL,1,34,6,13,0.462,5,8,0.625,1,5,0.2,6,6,1,0,3,3,3,0,2,2,5,19,12.7
John Wall,26-104,G,12/19/16,WAS,IND,1,38,6,14,0.429,6,9,0.667,0,5,0,7,8,0.875,1,4,5,10,2,0,4,3,19,16.9
Hassan Whiteside,27-286,C,3/26/17,MIA,BOS,1,30,8,14,0.571,8,14,0.571,0,0,,3,5,0.6,9,6,15,2,1,1,1,2,19,21
Al Horford,30-191,C-F,12/11/16,BOS,OKC,1,33,8,17,0.471,5,9,0.556,3,8,0.375,0,0,,1,3,4,6,0,1,1,1,19,15.4
Kentavious Caldwell-Pope,24-031,G,3/21/17,DET,BRK,1,35,7,17,0.412,4,9,0.444,3,8,0.375,2,2,1,0,4,4,3,0,0,1,1,19,11.8
DeMarcus Cousins,26-214,C-F,3/15/17,NOP,MIA,1,30,8,17,0.471,6,14,0.429,2,3,0.667,1,3,0.333,1,8,9,1,2,0,4,5,19,9.3
Tony Allen,34-329,G-F,12/5/16,MEM,NOP,1,42,9,14,0.643,9,13,0.692,0,1,0,1,2,0.5,4,9,13,0,2,1,2,2,19,17.8
Cheick Diallo,20-088,F,12/10/16,NOP,LAC,0,31,8,15,0.533,8,15,0.533,0,0,,3,6,0.5,3,7,10,1,2,0,1,3,19,15.2
DeAndre Jordan,28-179,C,1/16/17,LAC,OKC,1,30,7,8,0.875,7,8,0.875,0,0,,5,8,0.625,5,10,15,2,2,4,0,1,19,27.3
Robert Covington,25-345,F,11/23/16,PHI,MEM,1,46,6,10,0.6,2,3,0.667,4,7,0.571,3,5,0.6,1,9,10,2,3,3,6,5,19,15.5
Mason Plumlee,26-326,C-F,1/25/17,POR,LAL,1,34,8,15,0.533,8,15,0.533,0,0,,3,6,0.5,2,11,13,3,2,1,1,2,19,18.2
Bradley Beal,23-196,G,1/10/17,WAS,CHI,1,37,7,15,0.467,4,9,0.444,3,6,0.5,2,3,0.667,0,4,4,3,0,0,4,2,19,9.4
Jimmy Butler,27-102,G-F,12/25/16,CHI,SAS,1,36,8,19,0.421,7,16,0.438,1,3,0.333,2,2,1,1,4,5,3,1,0,0,3,19,12.7
Patrick Beverley,28-214,G,2/11/17,HOU,PHO,1,25,6,10,0.6,2,6,0.333,4,4,1,3,3,1,2,7,9,5,2,0,1,5,19,20.4
Markieff Morris,27-075,F,11/16/16,WAS,PHI,1,31,7,15,0.467,4,10,0.4,3,5,0.6,2,2,1,2,2,4,0,1,0,2,4,19,10.7
Marcus Smart,22-355,G,2/24/17,BOS,TOR,0,32,6,15,0.4,5,8,0.625,1,7,0.143,6,7,0.857,1,4,5,4,0,0,0,2,19,14.4
Josh Richardson,23-207,G,4/10/17,MIA,CLE,1,46,8,14,0.571,6,8,0.75,2,6,0.333,1,1,1,2,4,6,5,5,0,2,2,19,20.7
Kawhi Leonard,25-273,F,3/29/17,SAS,GSW,1,36,7,20,0.35,7,15,0.467,0,5,0,5,7,0.714,3,4,7,5,1,0,5,0,19,9.8
J.J. Redick,32-281,G,4/1/17,LAC,LAL,1,38,6,12,0.5,2,6,0.333,4,6,0.667,3,3,1,0,5,5,2,1,0,3,3,19,12.7
Kenneth Faried,27-076,F,2/3/17,DEN,MIL,1,25,6,8,0.75,6,8,0.75,0,0,,7,12,0.583,6,5,11,1,0,1,1,1,19,19.5
Jabari Parker,21-235,F,11/5/16,MIL,SAC,1,25,6,14,0.429,6,12,0.5,0,2,0,7,7,1,3,3,6,2,4,1,0,1,19,20.3
Nick Young,31-277,G-F,3/5/17,LAL,NOP,1,28,7,12,0.583,3,4,0.75,4,8,0.5,1,1,1,1,3,4,0,1,0,2,3,19,12.8
Eric Bledsoe,27-093,G,3/12/17,PHO,POR,1,31,7,19,0.368,4,15,0.267,3,4,0.75,2,4,0.5,1,2,3,6,2,0,2,1,19,12.8
Marcus Morris,27-157,F,2/6/17,DET,PHI,1,39,9,16,0.563,9,13,0.692,0,3,0,1,1,1,3,5,8,3,1,0,2,0,19,16.1
Evan Turner,28-024,G,11/20/16,POR,BRK,0,30,8,12,0.667,8,11,0.727,0,1,0,3,3,1,0,4,4,4,1,0,0,2,19,18
Seth Curry,26-204,G,3/15/17,DAL,WAS,1,34,6,10,0.6,3,3,1,3,7,0.429,4,6,0.667,0,0,0,1,2,0,1,5,19,13.3
Damian Lillard,26-146,G,12/8/16,POR,MEM,1,36,6,18,0.333,4,11,0.364,2,7,0.286,5,7,0.714,1,2,3,2,1,0,1,5,19,8.7
Caris LeVert,22-134,G-F,1/6/17,BRK,CLE,0,27,7,12,0.583,5,5,1,2,7,0.286,3,3,1,0,4,4,5,0,0,1,3,19,15.9
Draymond Green,27-024,F,3/28/17,GSW,HOU,1,33,9,15,0.6,8,9,0.889,1,6,0.167,0,0,,3,6,9,4,3,0,2,3,19,18.6
Harrison Barnes,24-303,F,3/29/17,DAL,NOP,1,34,6,15,0.4,4,13,0.308,2,2,1,5,5,1,3,5,8,3,0,0,1,3,19,14.4
Marvin Williams,30-256,F,3/2/17,CHO,PHO,1,29,5,9,0.556,2,6,0.333,3,3,1,6,8,0.75,1,3,4,0,1,1,1,2,19,15.4
Paul George,26-322,F,3/20/17,IND,UTA,1,36,6,20,0.3,4,13,0.308,2,7,0.286,5,5,1,0,8,8,5,2,2,3,4,19,12.1
Kyle Korver,35-274,G-F,12/16/16,ATL,TOR,0,23,6,10,0.6,0,0,,6,10,0.6,1,1,1,0,3,3,1,0,0,1,2,19,14.2
Kawhi Leonard,25-192,F,1/7/17,SAS,CHO,1,33,7,18,0.389,4,8,0.5,3,10,0.3,2,2,1,0,2,2,3,0,1,2,2,19,9.8
Brandon Knight,24-331,G,10/28/16,PHO,OKC,0,35,7,18,0.389,6,12,0.5,1,6,0.167,4,4,1,1,5,6,2,1,0,5,1,19,8.4
Tyler Ennis,22-224,G,4/5/17,LAL,SAS,1,39,8,14,0.571,5,10,0.5,3,4,0.75,0,0,,0,0,0,6,2,0,1,2,19,16.8
Steven Adams,23-228,C,3/5/17,OKC,DAL,1,25,8,10,0.8,8,10,0.8,0,0,,3,5,0.6,3,2,5,1,1,1,4,2,19,14.7
Danilo Gallinari,28-147,F,1/2/17,DEN,GSW,1,32,7,15,0.467,5,8,0.625,2,7,0.286,3,4,0.75,1,7,8,4,2,0,1,3,19,16.3
Devin Booker,20-014,G,11/13/16,PHO,GSW,1,32,6,18,0.333,5,13,0.385,1,5,0.2,6,6,1,1,3,4,3,2,1,1,1,19,13.8
Nicolas Batum,28-019,F-G,1/2/17,CHO,CHI,1,36,7,16,0.438,6,13,0.462,1,3,0.333,4,4,1,2,4,6,5,1,0,2,2,19,14.9
Taj Gibson,31-174,F,12/15/16,CHI,MIL,1,24,7,11,0.636,7,11,0.636,0,0,,5,6,0.833,2,2,4,1,0,1,0,3,19,15.9
Paul George,26-259,F,1/16/17,IND,NOP,1,34,6,17,0.353,4,11,0.364,2,6,0.333,5,5,1,0,5,5,6,2,0,3,3,19,13
Seth Curry,26-164,G,2/3/17,DAL,POR,1,29,7,12,0.583,6,9,0.667,1,3,0.333,4,4,1,0,3,3,2,0,0,0,5,19,13.7
Langston Galloway,24-365,G,12/8/16,NOP,PHI,0,28,8,16,0.5,5,10,0.5,3,6,0.5,0,1,0,1,3,4,2,1,0,1,2,19,12.8
LeBron James,31-307,F-G,11/1/16,CLE,HOU,1,36,6,12,0.5,5,9,0.556,1,3,0.333,6,10,0.6,3,10,13,8,0,0,4,4,19,16.5
Serge Ibaka,27-041,F-C,10/29/16,ORL,CLE,1,31,7,12,0.583,7,12,0.583,0,0,,5,7,0.714,3,4,7,1,1,0,1,4,19,15
DeMarre Carroll,30-196,F,2/8/17,TOR,MIN,1,34,7,9,0.778,2,4,0.5,5,5,1,0,0,,1,8,9,2,0,0,1,2,19,18.2
Enes Kanter,24-221,C,12/27/16,OKC,MIA,0,33,9,16,0.563,9,15,0.6,0,1,0,1,4,0.25,5,3,8,2,1,0,4,1,19,12.6
Monta Ellis,31-153,G,3/28/17,IND,MIN,1,34,8,11,0.727,8,8,1,0,3,0,3,4,0.75,1,4,5,5,2,1,2,3,19,19
Skal Labissiere,21-020,F,4/7/17,SAC,LAL,1,33,8,13,0.615,7,12,0.583,1,1,1,2,2,1,1,2,3,0,1,2,1,1,19,15.4
Rodney Hood,24-012,G-F,11/1/16,UTA,SAS,1,33,6,13,0.462,2,5,0.4,4,8,0.5,3,3,1,0,5,5,1,1,0,1,2,19,13.7
Kawhi Leonard,25-253,F,3/9/17,SAS,OKC,1,26,6,15,0.4,6,13,0.462,0,2,0,7,7,1,1,1,2,2,1,0,2,2,19,11.5
Thaddeus Young,28-285,F,4/2/17,IND,CLE,1,29,9,12,0.75,9,11,0.818,0,1,0,1,1,1,4,5,9,0,0,0,0,3,19,17.3
John Wall,26-180,G,3/5/17,WAS,ORL,1,37,6,17,0.353,5,14,0.357,1,3,0.333,6,7,0.857,0,6,6,10,0,1,4,1,19,14.2
Shelvin Mack,26-230,G,12/8/16,UTA,GSW,1,37,6,16,0.375,5,8,0.625,1,8,0.125,6,6,1,0,2,2,5,2,0,1,3,19,14.1
Otto Porter,23-175,F,11/25/16,WAS,ORL,1,34,8,15,0.533,5,7,0.714,3,8,0.375,0,0,,2,5,7,2,0,0,0,4,19,14.4
Harrison Barnes,24-203,F,12/19/16,DAL,DEN,1,34,9,15,0.6,8,12,0.667,1,3,0.333,0,0,,0,2,2,1,1,0,1,2,19,12.6
Damian Lillard,26-114,G,11/6/16,POR,MEM,1,33,3,11,0.273,1,3,0.333,2,8,0.25,11,11,1,1,6,7,7,1,0,3,3,19,16.7
Kemba Walker,26-211,G,12/5/16,CHO,DAL,1,35,8,15,0.533,8,13,0.615,0,2,0,3,4,0.75,0,3,3,4,1,1,2,1,19,14.3
Reggie Jackson,26-329,G,3/11/17,DET,NYK,1,30,7,14,0.5,3,8,0.375,4,6,0.667,1,1,1,0,3,3,8,1,1,2,3,19,17
Patrick McCaw,21-111,G,2/13/17,GSW,DEN,1,35,8,13,0.615,7,8,0.875,1,5,0.2,2,2,1,0,1,1,2,0,0,0,1,19,14.4
Kenneth Faried,27-021,F,12/10/16,DEN,ORL,0,24,9,10,0.9,9,10,0.9,0,0,,1,3,0.333,3,7,10,1,0,0,2,2,19,16.9
Spencer Dinwiddie,23-315,G,2/15/17,BRK,MIL,1,27,7,12,0.583,6,9,0.667,1,3,0.333,4,4,1,1,4,5,8,2,0,0,3,19,21.7
Rudy Gobert,24-280,C,4/2/17,UTA,SAS,1,41,9,15,0.6,9,15,0.6,0,0,,1,2,0.5,7,7,14,5,0,6,1,0,19,25.4
Rodney Hood,24-139,G-F,3/8/17,UTA,HOU,1,35,8,14,0.571,6,9,0.667,2,5,0.4,1,1,1,1,5,6,3,1,0,2,5,19,13.7
Thaddeus Young,28-129,F,10/28/16,IND,BRK,1,36,7,12,0.583,5,9,0.556,2,3,0.667,3,4,0.75,3,4,7,3,1,1,0,0,19,20.1
Reggie Jackson,26-280,G,1/21/17,DET,WAS,1,32,8,21,0.381,7,17,0.412,1,4,0.25,2,2,1,0,3,3,8,1,0,4,4,19,9.4
Joe Harris,25-102,G,12/18/16,BRK,PHI,0,28,7,13,0.538,2,4,0.5,5,9,0.556,0,0,,0,2,2,2,2,0,2,3,19,13.5
Sean Kilpatrick,26-303,G,11/4/16,BRK,CHO,0,33,5,15,0.333,3,8,0.375,2,7,0.286,7,10,0.7,0,4,4,4,2,0,2,2,19,12.5
Jamal Crawford,36-236,G,11/11/16,LAC,OKC,0,21,7,11,0.636,4,7,0.571,3,4,0.75,2,4,0.5,1,2,3,2,0,0,2,1,19,13.6
Joe Harris,25-066,G,11/12/16,BRK,PHO,0,24,6,10,0.6,1,2,0.5,5,8,0.625,2,2,1,2,0,2,1,0,0,3,4,19,11.9
Kawhi Leonard,25-150,F,11/26/16,SAS,WAS,1,36,5,14,0.357,4,8,0.5,1,6,0.167,8,10,0.8,0,1,1,5,3,0,3,1,19,13.8
Rudy Gobert,24-150,C,11/23/16,UTA,DEN,1,32,6,8,0.75,6,8,0.75,0,0,,7,12,0.583,2,11,13,0,0,2,2,2,19,17.1
Jordan Clarkson,24-224,G,1/17/17,LAL,DEN,0,36,7,16,0.438,5,11,0.455,2,5,0.4,3,3,1,0,0,0,3,2,0,1,5,19,11.7
Jonathon Simmons,27-107,G-F,12/30/16,SAS,POR,0,30,5,12,0.417,3,8,0.375,2,4,0.5,7,8,0.875,1,2,3,2,0,2,1,2,19,14.5
Steven Adams,23-150,C,12/17/16,OKC,PHO,1,29,8,13,0.615,8,13,0.615,0,0,,3,5,0.6,4,3,7,2,2,0,2,4,19,15.8
Jamal Crawford,36-309,G,1/23/17,LAC,ATL,0,27,9,20,0.45,8,18,0.444,1,2,0.5,0,1,0,0,2,2,4,0,0,1,2,19,9.8
James Harden,27-196,G,3/10/17,HOU,CHI,1,33,6,16,0.375,3,7,0.429,3,9,0.333,4,5,0.8,0,7,7,13,3,0,6,3,19,16.8
Kyle Lowry,30-231,G,11/11/16,TOR,CHO,1,36,7,16,0.438,5,8,0.625,2,8,0.25,3,3,1,1,7,8,6,2,1,0,5,19,18.3
Isaiah Thomas,28-054,G,4/2/17,BOS,NYK,1,24,6,11,0.545,2,2,1,4,9,0.444,3,3,1,0,2,2,6,1,0,1,0,19,18.5
Paul George,26-250,F,1/7/17,IND,NYK,1,28,7,16,0.438,6,12,0.5,1,4,0.25,4,4,1,0,3,3,4,2,0,4,3,19,11.1
Serge Ibaka,27-167,F-C,3/4/17,TOR,MIL,1,36,7,11,0.636,5,9,0.556,2,2,1,3,3,1,0,5,5,0,0,2,1,3,19,14.8
Jeremy Lamb,24-272,G-F,2/26/17,CHO,LAC,0,37,5,10,0.5,4,7,0.571,1,3,0.333,8,8,1,1,5,6,2,0,0,3,4,19,13
Pau Gasol,36-149,F-C,12/2/16,SAS,WAS,1,34,8,16,0.5,7,14,0.5,1,2,0.5,2,8,0.25,4,6,10,2,1,2,1,0,19,16
Khris Middleton,25-203,F-G,3/3/17,MIL,LAC,1,33,6,13,0.462,5,9,0.556,1,4,0.25,6,6,1,0,4,4,9,4,0,2,3,19,20.6
Eric Gordon,28-014,G,1/8/17,HOU,TOR,0,33,7,16,0.438,6,7,0.857,1,9,0.111,4,4,1,0,4,4,3,0,1,0,2,19,13.8
Lou Williams,30-005,G,11/1/16,LAL,IND,0,27,7,14,0.5,4,6,0.667,3,8,0.375,2,2,1,0,0,0,5,0,0,4,0,19,11.5
Bradley Beal,23-265,G,3/20/17,WAS,BOS,1,33,6,15,0.4,3,8,0.375,3,7,0.429,4,4,1,0,4,4,1,0,0,5,3,19,6.6
David Nwaba,24-077,G,4/1/17,LAL,LAC,0,35,6,9,0.667,6,7,0.857,0,2,0,7,10,0.7,3,3,6,1,2,0,1,4,19,17
LaMarcus Aldridge,31-239,F-C,3/15/17,SAS,POR,1,32,9,24,0.375,9,23,0.391,0,1,0,1,1,1,4,3,7,4,0,0,0,1,19,11.9
George Hill,30-280,G,2/8/17,UTA,NOP,1,25,6,11,0.545,4,5,0.8,2,6,0.333,5,8,0.625,0,1,1,3,1,0,0,3,19,14.7
Marcus Smart,22-344,G,2/13/17,BOS,DAL,1,35,6,11,0.545,3,4,0.75,3,7,0.429,4,4,1,0,3,3,3,2,1,3,3,19,15.2
Dennis Schroder,23-117,G,1/10/17,ATL,BRK,1,30,7,14,0.5,5,10,0.5,2,4,0.5,3,3,1,0,1,1,10,2,0,1,1,19,19.9
Tim Hardaway,25-013,G,3/29/17,ATL,PHI,1,37,7,14,0.5,5,8,0.625,2,6,0.333,3,4,0.75,1,2,3,1,0,0,1,1,19,12.2
Harrison Barnes,24-198,F,12/14/16,DAL,DET,1,37,9,18,0.5,8,13,0.615,1,5,0.2,0,0,,2,3,5,2,2,0,2,0,19,13.7
Mason Plumlee,26-285,C-F,12/15/16,POR,DEN,1,28,8,10,0.8,8,10,0.8,0,0,,3,7,0.429,3,4,7,4,2,0,0,2,19,20.9
Harrison Barnes,24-259,F,2/13/17,DAL,BOS,1,35,7,16,0.438,5,12,0.417,2,4,0.5,3,5,0.6,0,3,3,3,1,1,2,1,19,12.1
Darren Collison,29-106,G,12/7/16,SAC,DAL,1,30,5,10,0.5,3,6,0.5,2,4,0.5,7,8,0.875,1,2,3,3,0,0,5,1,19,11.6
Jordan Clarkson,24-285,G,3/19/17,LAL,CLE,1,41,8,18,0.444,6,11,0.545,2,7,0.286,1,1,1,2,1,3,6,0,0,2,3,19,12.3
Paul George,26-264,F,1/21/17,IND,UTA,1,29,8,16,0.5,5,11,0.455,3,5,0.6,0,0,,0,4,4,2,0,0,0,6,19,11.2
Marco Belinelli,30-245,G-F,11/25/16,CHO,NYK,0,33,7,11,0.636,2,5,0.4,5,6,0.833,0,0,,1,1,2,3,1,0,1,1,19,16.8
Dirk Nowitzki,38-214,F,1/19/17,DAL,MIA,1,29,7,16,0.438,5,10,0.5,2,6,0.333,3,5,0.6,0,4,4,1,2,0,1,2,19,11.9
Paul George,26-244,F,1/1/17,IND,ORL,1,31,5,13,0.385,2,8,0.25,3,5,0.6,6,7,0.857,1,4,5,3,0,0,1,3,19,13.3
Serge Ibaka,27-070,F-C,11/27/16,ORL,MIL,1,33,8,17,0.471,7,13,0.538,1,4,0.25,2,2,1,0,6,6,1,0,2,0,2,19,13.4
John Wall,26-193,G,3/18/17,WAS,CHO,1,35,5,16,0.313,4,12,0.333,1,4,0.25,8,11,0.727,1,3,4,8,1,2,3,1,19,14.8
Mike Conley,29-158,G,3/18/17,MEM,SAS,1,36,5,12,0.417,2,6,0.333,3,6,0.5,6,7,0.857,0,7,7,6,2,1,3,0,19,18.2
Hassan Whiteside,27-214,C,1/13/17,MIA,MIL,1,31,7,12,0.583,7,12,0.583,0,0,,5,6,0.833,2,7,9,2,1,0,2,1,19,16.5
Andre Drummond,23-087,C,11/5/16,DET,DEN,1,34,6,11,0.545,6,11,0.545,0,0,,7,11,0.636,3,16,19,1,1,3,4,2,19,18
Anthony Davis,23-280,F-C,12/16/16,NOP,HOU,1,23,9,17,0.529,9,16,0.563,0,1,0,1,3,0.333,1,4,5,3,0,0,1,0,19,12.9
Ersan Ilyasova,29-233,F,1/3/17,PHI,MIN,1,32,7,14,0.5,4,6,0.667,3,8,0.375,2,2,1,1,4,5,1,0,1,2,3,19,12.1
John Wall,26-137,G,1/21/17,WAS,DET,1,39,6,15,0.4,6,13,0.462,0,2,0,7,9,0.778,2,5,7,10,2,0,4,3,19,16.8
Richaun Holmes,23-167,F-C,3/31/17,PHI,CLE,1,36,7,9,0.778,5,7,0.714,2,2,1,3,5,0.6,1,7,8,2,2,0,4,2,19,16.1
Chris Paul,31-190,G,11/12/16,LAC,MIN,1,32,4,7,0.571,1,3,0.333,3,4,0.75,8,8,1,0,4,4,8,2,0,4,2,19,19.7
Pau Gasol,36-262,F-C,3/25/17,SAS,NYK,0,26,8,15,0.533,5,11,0.455,3,4,0.75,0,0,,5,5,10,3,0,2,0,3,19,19
Nick Young,31-207,G-F,12/25/16,LAL,LAC,1,30,6,9,0.667,1,2,0.5,5,7,0.714,2,2,1,0,2,2,2,1,0,1,3,19,15.9
Jeff Teague,28-180,G,12/7/16,IND,PHO,1,36,6,15,0.4,5,11,0.455,1,4,0.25,6,8,0.75,1,4,5,11,2,0,3,1,19,18.3
Gordon Hayward,27-008,F-G,3/31/17,UTA,WAS,1,40,7,16,0.438,6,10,0.6,1,6,0.167,4,6,0.667,0,7,7,4,2,1,1,1,19,16
Dwyane Wade,34-303,G,11/15/16,CHI,POR,1,31,8,18,0.444,8,18,0.444,0,0,,3,5,0.6,2,3,5,5,2,0,1,2,19,14.8
Jamal Murray,19-264,G,11/13/16,DEN,POR,1,28,6,12,0.5,1,3,0.333,5,9,0.556,2,3,0.667,0,5,5,1,0,0,6,2,19,8
Brandon Jennings,27-079,G,12/11/16,NYK,LAL,0,23,5,11,0.455,2,7,0.286,3,4,0.75,6,6,1,0,3,3,4,1,0,1,0,19,17
Goran Dragic,30-228,G,12/20/16,MIA,ORL,1,45,6,17,0.353,3,11,0.273,3,6,0.5,4,6,0.667,0,4,4,5,0,0,4,6,19,7
Jared Dudley,31-122,F-G,11/9/16,PHO,DET,0,30,6,9,0.667,2,3,0.667,4,6,0.667,3,4,0.75,0,5,5,1,1,2,2,2,19,16.5
Kelly Olynyk,25-206,C-F,11/11/16,BOS,NYK,1,30,6,11,0.545,3,6,0.5,3,5,0.6,4,4,1,2,5,7,3,2,0,3,3,19,16.5
Ty Lawson,29-081,G,1/23/17,SAC,DET,0,23,7,11,0.636,6,9,0.667,1,2,0.5,4,4,1,2,1,3,6,1,0,0,2,19,20.2
DeMarcus Cousins,26-160,C-F,1/20/17,SAC,MEM,1,28,5,11,0.455,3,8,0.375,2,3,0.667,7,10,0.7,1,9,10,2,0,1,4,4,19,12
DeAndre Jordan,28-142,C,12/10/16,LAC,NOP,1,23,9,11,0.818,9,11,0.818,0,0,,1,1,1,5,4,9,0,1,0,2,4,19,17
Kevin Love,28-069,F,11/15/16,CLE,TOR,1,35,5,16,0.313,4,9,0.444,1,7,0.143,8,9,0.889,4,9,13,1,0,3,3,1,19,14.3
Luol Deng,31-265,F,1/6/17,LAL,MIA,1,30,8,12,0.667,5,8,0.625,3,4,0.75,0,0,,3,11,14,2,0,0,3,3,19,16.4
Gorgui Dieng,27-083,C,4/11/17,MIN,OKC,1,39,9,11,0.818,9,11,0.818,0,0,,1,1,1,3,5,8,3,2,1,2,4,19,19.7
Zach Randolph,35-102,F,10/26/16,MEM,MIN,0,25,7,12,0.583,6,10,0.6,1,2,0.5,4,6,0.667,1,10,11,1,0,0,2,1,19,14.6
Tim Hardaway,24-319,G,1/29/17,ATL,NYK,1,58,5,20,0.25,5,11,0.455,0,9,0,9,12,0.75,0,5,5,8,1,0,1,4,19,11.3
Evan Fournier,24-142,G-F,3/20/17,ORL,PHI,1,37,6,13,0.462,5,8,0.625,1,5,0.2,6,10,0.6,1,3,4,3,2,0,4,2,19,11.6
Paul Millsap,31-348,F,1/23/17,ATL,LAC,1,38,5,16,0.313,3,9,0.333,2,7,0.286,7,8,0.875,2,6,8,7,2,2,0,2,19,20.1
Harrison Barnes,24-244,F,1/29/17,DAL,SAS,1,35,8,20,0.4,7,16,0.438,1,4,0.25,2,2,1,1,2,3,2,0,0,0,1,19,10.5
Nerlens Noel,22-289,C-F,1/24/17,PHI,LAC,1,29,8,10,0.8,8,10,0.8,0,0,,3,3,1,1,7,8,5,2,3,1,4,19,23
Sam Dekker,22-222,F,12/14/16,HOU,SAC,0,22,8,10,0.8,6,7,0.857,2,3,0.667,1,1,1,2,5,7,0,0,0,0,1,19,17.7
Tristan Thompson,25-322,F-C,1/29/17,CLE,OKC,1,34,7,15,0.467,7,15,0.467,0,0,,5,5,1,6,6,12,1,4,4,1,1,19,23.4
Wayne Ellington,29-134,G,3/12/17,MIA,IND,0,27,7,13,0.538,2,2,1,5,11,0.455,0,0,,0,1,1,2,0,0,0,0,19,14.4
C.J. Miles,29-199,G-F,11/3/16,IND,MIL,0,24,6,10,0.6,4,6,0.667,2,4,0.5,5,6,0.833,1,2,3,2,3,0,0,2,19,18.9
Andre Roberson,25-082,G-F,2/24/17,OKC,LAL,1,29,8,9,0.889,5,6,0.833,3,3,1,0,2,0,2,5,7,1,1,0,2,1,19,17.3
Dion Waiters,25-051,G,1/30/17,MIA,BRK,1,36,7,18,0.389,4,12,0.333,3,6,0.5,2,4,0.5,0,6,6,9,0,1,1,0,19,16.2
Yogi Ferrell,23-266,G,1/30/17,DAL,CLE,1,38,7,15,0.467,4,9,0.444,3,6,0.5,2,2,1,0,5,5,3,4,0,2,2,19,16.1
Mindaugas Kuzminskas,27-085,F,1/12/17,NYK,CHI,0,30,8,15,0.533,6,11,0.545,2,4,0.5,1,1,1,3,1,4,1,2,1,0,0,19,17.5
Harrison Barnes,24-149,F,10/26/16,DAL,IND,1,35,8,14,0.571,5,8,0.625,3,6,0.5,0,0,,3,6,9,0,0,0,2,3,19,13.1
Trevor Booker,28-353,F,11/12/16,BRK,PHO,1,26,7,10,0.7,6,9,0.667,1,1,1,4,4,1,4,4,8,4,0,1,0,2,19,21.5
Nicolas Batum,28-045,F-G,1/28/17,CHO,SAC,1,40,6,11,0.545,3,5,0.6,3,6,0.5,4,4,1,1,6,7,7,0,0,5,3,19,14.9
Bradley Beal,23-233,G,2/16/17,WAS,IND,1,36,7,14,0.5,3,7,0.429,4,7,0.571,1,2,0.5,1,2,3,4,1,0,2,3,19,13.5
Wilson Chandler,29-177,F,11/3/16,DEN,MIN,0,27,8,12,0.667,8,10,0.8,0,2,0,3,5,0.6,2,4,6,0,1,0,2,3,19,13.4
Kevin Durant,28-092,F-G,12/30/16,GSW,DAL,1,35,7,14,0.5,5,7,0.714,2,7,0.286,3,4,0.75,0,11,11,10,0,0,4,0,19,17.9
Jeremy Lin,28-215,G,3/26/17,BRK,ATL,1,28,7,15,0.467,6,10,0.6,1,5,0.2,4,4,1,0,4,4,8,2,1,4,4,19,15.2
Jrue Holiday,26-248,G,2/15/17,NOP,MEM,1,33,8,13,0.615,6,10,0.6,2,3,0.667,1,4,0.25,2,5,7,7,0,0,2,5,19,15.7
Jahlil Okafor,20-337,C-F,11/16/16,PHI,WAS,1,20,8,11,0.727,8,11,0.727,0,0,,3,4,0.75,0,5,5,2,0,0,2,6,19,12.6
Harrison Barnes,24-293,F,3/19/17,DAL,BRK,1,36,8,15,0.533,7,14,0.5,1,1,1,2,2,1,1,5,6,2,0,0,2,3,19,12.1
Giannis Antetokounmpo,22-052,F-G,1/27/17,MIL,TOR,1,33,7,15,0.467,7,15,0.467,0,0,,5,8,0.625,0,6,6,8,1,3,3,5,19,15.6
Dwight Howard,31-067,C,2/13/17,ATL,POR,1,38,5,7,0.714,5,6,0.833,0,1,0,9,16,0.563,4,12,16,1,2,3,2,2,19,21.7
Justin Anderson,23-104,G,3/3/17,PHI,NYK,0,24,8,12,0.667,5,6,0.833,3,6,0.5,0,0,,3,2,5,2,0,1,1,2,19,16.8
Bradley Beal,23-280,G,4/4/17,WAS,CHO,1,35,7,15,0.467,6,11,0.545,1,4,0.25,4,5,0.8,1,1,2,4,3,0,1,1,19,16.3
Markieff Morris,27-089,F,11/30/16,WAS,OKC,1,37,7,16,0.438,7,14,0.5,0,2,0,5,8,0.625,1,6,7,2,1,1,2,5,19,11
Nerlens Noel,22-307,C-F,2/11/17,PHI,MIA,1,32,9,12,0.75,9,11,0.818,0,1,0,1,3,0.333,3,0,3,1,4,1,1,4,19,18.3
Markieff Morris,27-144,F,1/24/17,WAS,BOS,1,34,6,14,0.429,5,10,0.5,1,4,0.25,6,7,0.857,2,9,11,4,0,2,2,2,19,16.7
Jusuf Nurkic,22-189,C,2/28/17,POR,DET,1,35,7,12,0.583,7,12,0.583,0,0,,5,7,0.714,3,4,7,5,0,1,4,5,19,14.1
Timothe Luwawu-Cabarrot,21-326,F,3/31/17,PHI,CLE,1,43,7,15,0.467,6,7,0.857,1,8,0.125,4,5,0.8,0,4,4,0,1,0,1,3,19,10.9
LaMarcus Aldridge,31-109,F-C,11/5/16,SAS,LAC,1,25,7,13,0.538,4,10,0.4,3,3,1,2,2,1,1,5,6,0,0,1,1,2,19,13.8
Tobias Harris,24-256,F,3/28/17,DET,MIA,0,30,7,14,0.5,3,6,0.5,4,8,0.5,1,2,0.5,1,5,6,2,2,0,2,2,19,14.4
Reggie Jackson,26-245,G,12/17/16,DET,IND,1,29,6,15,0.4,5,11,0.455,1,4,0.25,6,6,1,0,3,3,10,1,0,3,3,19,15.6
Tobias Harris,24-124,F,11/16/16,DET,NYK,1,39,6,13,0.462,5,9,0.556,1,4,0.25,6,6,1,2,8,10,1,1,0,1,2,19,16
Mirza Teletovic,31-146,F,2/11/17,MIL,IND,0,17,6,10,0.6,1,1,1,5,9,0.556,2,3,0.667,0,2,2,1,0,0,0,2,19,14.5
Jordan Clarkson,24-279,G,3/13/17,LAL,DEN,1,33,7,18,0.389,4,11,0.364,3,7,0.429,2,3,0.667,0,2,2,3,0,0,3,1,19,8.1
Kristaps Porzingis,21-183,F-C,2/1/17,NYK,BRK,1,26,7,15,0.467,6,11,0.545,1,4,0.25,4,7,0.571,4,8,12,1,0,2,2,5,19,13.4
Paul Millsap,31-284,F,11/20/16,ATL,NYK,1,38,8,17,0.471,6,13,0.462,2,4,0.5,1,3,0.333,1,6,7,5,2,2,0,3,19,17.7
Harrison Barnes,24-271,F,2/25/17,DAL,NOP,1,34,7,15,0.467,5,13,0.385,2,2,1,3,3,1,1,2,3,2,3,0,3,4,19,12.4
Isaiah Thomas,28-020,G,2/27/17,BOS,ATL,1,30,4,21,0.19,3,15,0.2,1,6,0.167,10,10,1,2,5,7,7,0,1,7,1,19,7
Damian Lillard,26-256,G,3/28/17,POR,DEN,1,38,7,19,0.368,3,8,0.375,4,11,0.364,1,4,0.25,2,4,6,7,3,0,3,1,19,14.4
Chris Paul,31-197,G,11/19/16,LAC,CHI,1,34,7,14,0.5,4,9,0.444,3,5,0.6,2,3,0.667,3,1,4,8,2,0,4,2,19,16.8
Derrick Favors,25-231,F-C,3/3/17,UTA,BRK,1,34,8,9,0.889,7,8,0.875,1,1,1,2,3,0.667,1,11,12,3,1,0,1,4,19,20
Marc Gasol,31-309,C,12/3/16,MEM,LAL,1,34,9,18,0.5,8,15,0.533,1,3,0.333,0,0,,0,3,3,8,3,1,0,2,19,19.4
Sean Kilpatrick,26-311,G,11/12/16,BRK,PHO,1,32,7,16,0.438,4,8,0.5,3,8,0.375,2,3,0.667,0,9,9,4,1,0,4,2,19,11.9
Kelly Olynyk,25-298,C-F,2/11/17,BOS,UTA,0,27,8,11,0.727,5,6,0.833,3,5,0.6,0,2,0,0,7,7,3,2,2,2,5,19,17.3
Dwyane Wade,35-042,G,2/28/17,CHI,DEN,1,28,8,14,0.571,6,12,0.5,2,2,1,1,1,1,1,3,4,6,0,0,3,0,19,15.2
Maurice Harkless,23-190,F-G,11/17/16,POR,HOU,1,31,8,12,0.667,5,8,0.625,3,4,0.75,0,0,,2,4,6,0,0,0,1,1,19,15
Tony Parker,34-293,G,3/6/17,SAS,HOU,1,28,7,14,0.5,4,8,0.5,3,6,0.5,2,2,1,0,5,5,3,0,0,3,2,19,11.8
Ryan Anderson,28-245,F,1/6/17,HOU,ORL,1,33,7,12,0.583,2,3,0.667,5,9,0.556,0,0,,0,4,4,0,2,0,0,0,19,16.6
Mike Conley,29-089,G,1/8/17,MEM,UTA,1,35,8,18,0.444,7,14,0.5,1,4,0.25,2,3,0.667,0,2,2,9,1,0,2,5,19,13.1
Marc Gasol,31-304,C,11/28/16,MEM,CHO,1,32,8,15,0.533,6,11,0.545,2,4,0.5,1,1,1,1,7,8,1,1,0,1,1,19,14.8
Nikola Jokic,22-042,C-F,4/2/17,DEN,MIA,1,35,9,16,0.563,9,14,0.643,0,2,0,1,1,1,1,9,10,7,2,0,1,2,19,19.9
Greg Monroe,26-216,C-F,1/6/17,MIL,NYK,0,28,6,11,0.545,6,11,0.545,0,0,,7,10,0.7,2,5,7,4,2,1,1,2,19,19.1
Dwyane Wade,34-339,G,12/21/16,CHI,WAS,1,32,7,20,0.35,7,19,0.368,0,1,0,5,6,0.833,0,3,3,3,1,1,1,3,19,9.9
Denzel Valentine,23-055,G,1/10/17,CHI,WAS,0,30,7,15,0.467,2,4,0.5,5,11,0.455,0,0,,0,2,2,2,2,0,1,1,19,13.9
Harrison Barnes,24-235,F,1/20/17,DAL,UTA,1,40,7,16,0.438,6,14,0.429,1,2,0.5,4,6,0.667,1,4,5,1,0,1,2,0,19,11.1
Aaron Brooks,31-347,G,12/26/16,IND,CHI,0,24,6,8,0.75,3,4,0.75,3,4,0.75,4,4,1,1,3,4,7,0,1,3,1,19,19.6
LaMarcus Aldridge,31-108,F-C,11/4/16,SAS,UTA,1,29,7,13,0.538,7,13,0.538,0,0,,5,6,0.833,1,5,6,0,2,1,2,3,19,14
J.J. Redick,32-194,G,1/4/17,LAC,MEM,1,37,5,13,0.385,3,5,0.6,2,8,0.25,7,8,0.875,0,3,3,2,0,0,1,1,19,12.4
Davis Bertans,24-146,F,4/7/17,SAS,DAL,1,39,7,13,0.538,2,4,0.5,5,9,0.556,0,0,,3,1,4,1,2,0,1,0,19,16.8
Ty Lawson,29-122,G,3/5/17,SAC,UTA,1,37,7,13,0.538,6,10,0.6,1,3,0.333,4,5,0.8,0,4,4,5,0,0,3,5,19,12
Ryan Anderson,28-220,F,12/12/16,HOU,BRK,1,31,6,11,0.545,3,4,0.75,3,7,0.429,4,5,0.8,2,4,6,2,0,0,0,3,19,16.1
DeMarcus Cousins,26-202,C-F,3/3/17,NOP,SAS,1,43,7,18,0.389,6,12,0.5,1,6,0.167,4,5,0.8,4,20,24,4,0,0,6,5,19,12.4
Klay Thompson,26-352,G,1/25/17,GSW,CHO,1,32,5,14,0.357,3,6,0.5,2,8,0.25,7,7,1,1,4,5,1,1,1,1,2,19,13.7
Marc Gasol,31-316,C,12/10/16,MEM,GSW,1,32,6,12,0.5,5,9,0.556,1,3,0.333,6,7,0.857,1,7,8,6,1,2,1,1,19,20.6
Jimmy Butler,27-128,G-F,1/20/17,CHI,ATL,1,29,6,8,0.75,4,6,0.667,2,2,1,5,5,1,0,0,0,3,1,0,4,0,19,14.9
Dwyane Wade,34-324,G,12/6/16,CHI,DET,1,34,5,13,0.385,5,11,0.455,0,2,0,9,10,0.9,0,3,3,8,1,0,2,3,19,15.8
Jeff Teague,28-211,G,1/7/17,IND,NYK,1,31,4,7,0.571,2,4,0.5,2,3,0.667,9,9,1,1,3,4,8,0,0,3,3,19,18.7
JaMychal Green,26-151,F,11/19/16,MEM,MIN,1,28,6,9,0.667,6,8,0.75,0,1,0,7,8,0.875,3,5,8,0,1,1,3,4,19,15.4
Kelly Olynyk,25-225,C-F,11/30/16,BOS,DET,0,26,7,9,0.778,4,5,0.8,3,4,0.75,2,2,1,1,2,3,2,0,0,1,4,19,15.6
J.J. Redick,32-196,G,1/6/17,LAC,SAC,1,32,6,13,0.462,1,4,0.25,5,9,0.556,2,3,0.667,0,4,4,1,0,0,1,2,19,12
Julius Randle,22-112,F,3/21/17,LAL,LAC,1,31,7,13,0.538,6,11,0.545,1,2,0.5,4,5,0.8,3,4,7,3,1,1,1,3,19,17.2
D.J. Augustin,29-057,G,1/6/17,ORL,HOU,0,29,5,9,0.556,1,2,0.5,4,7,0.571,5,5,1,0,1,1,2,1,0,2,2,19,14.6
Dwight Howard,30-355,C,11/27/16,ATL,LAL,1,33,9,13,0.692,9,13,0.692,0,0,,1,5,0.2,3,6,9,3,1,2,4,4,19,14.7
Tobias Harris,24-127,F,11/19/16,DET,BOS,1,42,7,16,0.438,6,12,0.5,1,4,0.25,4,4,1,0,2,2,1,1,0,0,3,19,11.7
Eric Gordon,27-306,G,10/26/16,HOU,LAL,1,34,7,15,0.467,5,7,0.714,2,8,0.25,3,4,0.75,0,5,5,0,1,0,1,1,19,12
Klay Thompson,26-276,G,11/10/16,GSW,DEN,1,32,7,14,0.5,4,10,0.4,3,4,0.75,2,2,1,0,2,2,3,1,0,3,1,19,12.3
Dion Waiters,24-347,G,11/21/16,MIA,PHI,1,33,6,15,0.4,4,9,0.444,2,6,0.333,5,6,0.833,0,3,3,5,0,1,0,3,19,14.4
Kemba Walker,26-325,G,3/29/17,CHO,TOR,1,35,7,25,0.28,4,15,0.267,3,10,0.3,2,2,1,4,0,4,2,0,0,1,0,19,7.5
Goran Dragic,30-243,G,1/4/17,MIA,SAC,1,30,5,12,0.417,5,10,0.5,0,2,0,9,9,1,0,1,1,7,2,0,2,1,19,17.4
Jordan Clarkson,24-275,G,3/9/17,LAL,PHO,0,35,7,18,0.389,6,12,0.5,1,6,0.167,4,5,0.8,0,2,2,3,2,0,1,2,19,11.7
Jeff Teague,28-190,G,12/17/16,IND,DET,1,31,6,10,0.6,5,8,0.625,1,2,0.5,6,8,0.75,0,9,9,8,2,0,4,2,19,19.1
Markieff Morris,27-130,F,1/10/17,WAS,CHI,1,22,8,12,0.667,5,9,0.556,3,3,1,0,0,,1,4,5,2,3,0,3,6,19,14.7
Ricky Rubio,26-154,G,3/24/17,MIN,LAL,1,43,5,13,0.385,4,8,0.5,1,5,0.2,8,8,1,0,3,3,15,3,1,2,1,19,24.6
Wilson Chandler,29-227,F,12/23/16,DEN,ATL,1,27,9,17,0.529,8,13,0.615,1,4,0.25,0,3,0,1,10,11,2,1,0,0,5,19,13.6
Robin Lopez,28-329,C,2/24/17,CHI,PHO,1,36,8,15,0.533,8,15,0.533,0,0,,3,3,1,1,5,6,0,0,1,0,2,19,13.8
Chris Paul,31-339,G,4/10/17,LAC,HOU,1,29,5,12,0.417,3,9,0.333,2,3,0.667,7,7,1,0,5,5,9,4,0,0,1,19,24
Victor Oladipo,24-254,G,1/13/17,OKC,MIN,1,33,8,18,0.444,7,14,0.5,1,4,0.25,2,2,1,2,3,5,0,1,0,1,0,19,11.9
Devin Booker,20-136,G,3/15/17,PHO,SAC,1,40,6,26,0.231,3,17,0.176,3,9,0.333,4,4,1,1,2,3,2,0,0,1,2,19,4.1
Ish Smith,28-148,G,11/30/16,DET,BOS,1,36,9,12,0.75,9,11,0.818,0,1,0,1,2,0.5,0,8,8,8,0,1,0,2,19,21.7
Darren Collison,29-215,G,3/26/17,SAC,LAC,1,28,8,11,0.727,8,11,0.727,0,0,,3,5,0.6,0,1,1,4,1,0,2,1,19,15.4
Stephen Curry,28-278,G,12/17/16,GSW,POR,1,27,6,11,0.545,1,3,0.333,5,8,0.625,2,2,1,0,3,3,6,0,0,3,3,19,14.6
Hassan Whiteside,27-259,C,2/27/17,MIA,DAL,1,38,9,16,0.563,9,16,0.563,0,0,,1,2,0.5,7,12,19,0,1,1,2,1,19,18.8
Manu Ginobili,39-223,G,3/8/17,SAS,SAC,0,25,7,15,0.467,4,8,0.5,3,7,0.429,2,2,1,0,4,4,5,3,0,3,1,19,15.6
Jonas Valanciunas,24-334,C,4/5/17,TOR,DET,1,27,9,11,0.818,9,11,0.818,0,0,,1,2,0.5,2,3,5,2,0,0,1,4,19,15.6
Chris Paul,31-337,G,4/8/17,LAC,SAS,1,31,9,16,0.563,8,13,0.615,1,3,0.333,0,0,,0,8,8,8,3,1,2,2,19,20.3
Dwight Howard,31-052,C,1/29/17,ATL,NYK,1,38,8,11,0.727,8,11,0.727,0,0,,3,7,0.429,4,8,12,1,0,1,2,6,19,15.1
Timofey Mozgov,30-162,C,12/25/16,LAL,LAC,1,25,8,11,0.727,8,11,0.727,0,0,,3,4,0.75,2,1,3,0,0,0,1,2,19,14
Jordan Clarkson,24-264,G,2/26/17,LAL,SAS,0,27,8,16,0.5,7,13,0.538,1,3,0.333,2,2,1,0,2,2,2,0,0,2,0,19,11
Zach LaVine,21-250,G,11/15/16,MIN,CHO,1,33,7,16,0.438,2,6,0.333,5,10,0.5,0,0,,0,2,2,2,0,0,0,2,19,11.8
LaMarcus Aldridge,31-136,F-C,12/2/16,SAS,WAS,1,37,8,14,0.571,8,14,0.571,0,0,,3,6,0.5,2,3,5,1,0,1,2,4,19,11.3
Robert Covington,26-016,F,12/30/16,PHI,DEN,1,28,6,12,0.5,3,6,0.5,3,6,0.5,4,5,0.8,2,4,6,1,1,1,0,4,19,16
Troy Daniels,25-138,G,11/30/16,MEM,TOR,0,21,6,12,0.5,2,4,0.5,4,8,0.5,3,3,1,1,0,1,1,1,0,1,0,19,14.4
John Wall,26-064,G,11/9/16,WAS,BOS,1,31,6,16,0.375,5,13,0.385,1,3,0.333,6,7,0.857,0,3,3,7,0,1,5,3,19,10.1
Al Horford,30-217,C-F,1/6/17,BOS,PHI,1,32,7,15,0.467,3,8,0.375,4,7,0.571,1,2,0.5,5,7,12,4,0,2,1,5,19,17.7
George Hill,30-174,G,10/25/16,UTA,POR,1,39,7,18,0.389,6,12,0.5,1,6,0.167,4,4,1,0,2,2,6,2,1,1,2,19,14.9
J.J. Redick,32-171,G,12/12/16,LAC,POR,1,28,5,11,0.455,4,7,0.571,1,4,0.25,8,8,1,0,0,0,0,1,1,0,1,19,14.6
Jimmy Butler,27-153,G-F,2/14/17,CHI,TOR,1,38,2,10,0.2,2,7,0.286,0,3,0,15,19,0.789,1,1,2,12,5,0,4,4,19,20
Deron Williams,32-269,G,3/22/17,CLE,DEN,0,20,8,10,0.8,6,6,1,2,4,0.5,1,1,1,1,3,4,2,0,1,0,1,19,18.5
Kelly Oubre,21-001,F,12/10/16,WAS,MIL,0,29,7,11,0.636,4,5,0.8,3,6,0.5,2,2,1,1,8,9,1,3,0,0,4,19,19.3
Dario Saric,22-330,F,3/4/17,PHI,DET,1,29,7,15,0.467,6,12,0.5,1,3,0.333,4,4,1,1,5,6,8,0,1,3,1,19,16.4
Karl-Anthony Towns,21-013,C-F,11/28/16,MIN,UTA,1,34,8,19,0.421,7,16,0.438,1,3,0.333,2,2,1,3,9,12,1,1,1,0,5,19,14.1
Troy Daniels,25-139,G,12/1/16,MEM,ORL,0,29,6,9,0.667,3,4,0.75,3,5,0.6,4,5,0.8,0,2,2,1,0,0,0,1,19,15.6
Justin Anderson,23-064,G,1/22/17,DAL,LAL,0,16,5,11,0.455,2,5,0.4,3,6,0.5,6,6,1,1,4,5,2,1,0,3,1,19,14.2
Andre Drummond,23-202,C,2/28/17,DET,POR,1,30,8,14,0.571,8,14,0.571,0,0,,3,8,0.375,8,7,15,1,1,0,1,4,19,17.2
James Johnson,29-306,F,12/22/16,MIA,LAL,0,26,8,11,0.727,5,6,0.833,3,5,0.6,0,2,0,0,8,8,6,0,1,3,2,19,17.2
Darren Collison,29-202,G,3/13/17,SAC,ORL,1,33,5,9,0.556,3,5,0.6,2,4,0.5,7,7,1,0,2,2,13,2,1,3,2,19,23.3
Dwight Howard,31-108,C,3/26/17,ATL,BRK,1,28,8,12,0.667,8,12,0.667,0,0,,3,12,0.25,8,8,16,0,1,1,5,4,19,13.3
Marco Belinelli,30-267,G-F,12/17/16,CHO,ATL,0,30,8,11,0.727,5,7,0.714,3,4,0.75,0,0,,0,3,3,1,0,0,1,1,19,14.7
Anthony Tolliver,31-285,F-C,3/13/17,SAC,ORL,0,28,6,9,0.667,1,2,0.5,5,7,0.714,2,2,1,0,6,6,1,1,0,1,3,19,16.4
Justin Anderson,23-107,G,3/6/17,PHI,MIL,0,23,9,16,0.563,9,10,0.9,0,6,0,1,2,0.5,3,3,6,3,0,0,1,2,19,14.3
Rudy Gay,30-112,F,12/7/16,SAC,DAL,1,31,8,14,0.571,7,11,0.636,1,3,0.333,2,2,1,1,2,3,4,3,0,2,1,19,17.1
George Hill,30-296,G,2/24/17,UTA,MIL,1,34,4,6,0.667,1,2,0.5,3,4,0.75,8,8,1,0,1,1,1,4,0,3,4,19,16.8
Damian Lillard,26-198,G,1/29/17,POR,GSW,1,36,6,14,0.429,4,9,0.444,2,5,0.4,5,5,1,0,2,2,8,1,0,3,1,19,15.4
Danilo Gallinari,28-235,F,3/31/17,DEN,CHO,1,34,5,11,0.455,1,5,0.2,4,6,0.667,5,5,1,1,4,5,4,0,0,2,1,19,15.6
Dion Waiters,25-048,G,1/27/17,MIA,CHI,1,34,6,18,0.333,3,13,0.231,3,5,0.6,4,5,0.8,0,5,5,1,1,0,1,2,19,9.8
Jeff Teague,28-225,G,1/21/17,IND,UTA,1,38,6,13,0.462,5,12,0.417,1,1,1,6,8,0.75,0,4,4,7,3,0,1,2,19,18.8
Anthony Davis,24-020,F-C,3/31/17,NOP,SAC,1,34,9,19,0.474,9,17,0.529,0,2,0,1,1,1,4,8,12,2,1,6,1,2,19,19.3
Anthony Davis,24-010,F-C,3/21/17,NOP,MEM,1,40,9,18,0.5,9,16,0.563,0,2,0,1,2,0.5,3,10,13,0,0,0,2,2,19,11.9
LaMarcus Aldridge,31-206,F-C,2/10/17,SAS,DET,1,32,8,18,0.444,8,18,0.444,0,0,,3,4,0.75,3,8,11,0,1,2,5,4,19,9.5
Dirk Nowitzki,38-220,F,1/25/17,DAL,NYK,1,25,8,12,0.667,8,10,0.8,0,2,0,3,3,1,2,2,4,2,0,3,0,2,19,18.5
Draymond Green,26-341,F,2/8/17,GSW,CHI,1,32,6,8,0.75,1,2,0.5,5,6,0.833,2,2,1,0,8,8,6,1,1,1,1,19,22.7
Wilson Chandler,29-327,F,4/2/17,DEN,MIA,0,31,8,13,0.615,7,10,0.7,1,3,0.333,2,2,1,2,7,9,2,0,1,0,1,19,18.3
Kyle Lowry,30-245,G,11/25/16,TOR,MIL,1,37,7,15,0.467,3,7,0.429,4,8,0.5,1,1,1,1,4,5,6,2,0,2,1,19,17
Chris Paul,31-247,G,1/8/17,LAC,MIA,1,29,7,11,0.636,6,8,0.75,1,3,0.333,4,5,0.8,1,5,6,18,2,0,1,4,19,27.9
Alex Abrines,23-207,G-F,2/24/17,OKC,LAL,1,29,7,13,0.538,2,2,1,5,11,0.455,0,0,,0,3,3,0,0,0,0,5,19,11.6
LaMarcus Aldridge,31-249,F-C,3/25/17,SAS,NYK,1,36,9,21,0.429,8,19,0.421,1,2,0.5,0,0,,4,6,10,2,1,0,1,1,19,13.5
Markieff Morris,27-141,F,1/21/17,WAS,DET,1,38,7,17,0.412,5,12,0.417,2,5,0.4,3,4,0.75,4,5,9,2,2,1,3,5,19,12.9
Clint Capela,22-294,F-C,3/8/17,HOU,UTA,1,32,9,13,0.692,9,13,0.692,0,0,,1,6,0.167,6,6,12,2,0,0,1,4,19,16.3
Carmelo Anthony,32-172,F,11/17/16,NYK,WAS,1,35,7,17,0.412,6,9,0.667,1,8,0.125,4,4,1,0,3,3,3,1,0,1,4,19,11.3
Myles Turner,20-251,F-C,11/30/16,IND,POR,1,31,7,12,0.583,7,12,0.583,0,0,,5,5,1,3,7,10,1,0,1,2,4,19,15.4
Maurice Harkless,23-198,F-G,11/25/16,POR,NOP,1,29,8,13,0.615,7,10,0.7,1,3,0.333,2,4,0.5,5,6,11,1,1,0,4,3,19,14.1
Josh Richardson,23-106,G,12/30/16,MIA,BOS,1,35,8,17,0.471,6,12,0.5,2,5,0.4,1,1,1,2,4,6,8,4,2,3,3,19,19.7
Jimmy Butler,27-096,G-F,12/19/16,CHI,DET,1,30,6,7,0.857,5,6,0.833,1,1,1,6,6,1,1,2,3,6,2,0,0,0,19,24
Brandon Jennings,27-072,G,12/4/16,NYK,SAC,0,26,5,7,0.714,3,3,1,2,4,0.5,7,7,1,0,1,1,3,0,0,4,0,19,14.5
C.J. McCollum,25-139,G,2/5/17,POR,OKC,1,31,7,15,0.467,5,9,0.556,2,6,0.333,3,3,1,0,8,8,1,0,0,3,2,19,10.6
Jamal Crawford,36-340,G,2/23/17,LAC,GSW,0,34,6,15,0.4,4,11,0.364,2,4,0.5,5,7,0.714,1,0,1,4,1,0,0,1,19,14.2
Tobias Harris,24-120,F,11/12/16,DET,DEN,1,36,8,15,0.533,7,13,0.538,1,2,0.5,2,2,1,1,3,4,3,2,1,2,1,19,15.7
DeAndre Jordan,28-102,C,10/31/16,LAC,PHO,1,31,8,10,0.8,8,10,0.8,0,0,,3,6,0.5,3,8,11,2,1,2,1,5,19,19.3
Caris LeVert,22-226,G-F,4/8/17,BRK,CHI,1,25,7,11,0.636,3,4,0.75,4,7,0.571,1,4,0.25,0,5,5,1,1,0,2,3,19,12.9
Mindaugas Kuzminskas,27-157,F,3/25/17,NYK,SAS,1,36,8,12,0.667,5,7,0.714,3,5,0.6,0,0,,1,0,1,2,0,0,0,2,19,15.1
Jon Leuer,27-214,F,12/14/16,DET,DAL,0,31,8,9,0.889,8,9,0.889,0,0,,3,3,1,1,4,5,2,1,1,1,0,19,19.9
Tyler Johnson,24-237,G,12/30/16,MIA,BOS,0,29,8,13,0.615,7,10,0.7,1,3,0.333,2,2,1,0,4,4,6,0,1,1,5,19,16.2
Norman Powell,23-171,G,11/12/16,TOR,NYK,1,29,4,10,0.4,1,4,0.25,3,6,0.5,8,8,1,0,5,5,2,1,0,0,3,19,16.3
Kyrie Irving,24-235,G,11/13/16,CLE,CHO,1,27,8,17,0.471,7,12,0.583,1,5,0.2,2,2,1,2,1,3,4,1,0,0,2,19,15
LaMarcus Aldridge,31-209,F-C,2/13/17,SAS,IND,1,36,7,22,0.318,7,22,0.318,0,0,,5,5,1,3,4,7,1,0,1,1,5,19,8.1
Paul George,26-234,F,12/22/16,IND,BOS,1,41,5,16,0.313,5,13,0.385,0,3,0,9,10,0.9,1,7,8,5,2,0,5,4,19,11.1
Wesley Matthews,30-074,G,12/27/16,DAL,HOU,1,29,7,13,0.538,4,6,0.667,3,7,0.429,2,2,1,0,1,1,1,1,0,0,2,19,13.9
Marcin Gortat,32-317,C-F,12/30/16,WAS,BRK,1,31,8,13,0.615,8,13,0.615,0,0,,3,4,0.75,2,11,13,1,1,1,3,2,19,16
Gorgui Dieng,27-069,C,3/28/17,MIN,IND,1,44,8,14,0.571,6,11,0.545,2,3,0.667,1,2,0.5,4,3,7,1,1,2,1,5,19,15.8
Hassan Whiteside,27-238,C,2/6/17,MIA,MIN,1,36,8,14,0.571,8,14,0.571,0,0,,3,4,0.75,2,11,13,2,1,1,2,2,19,17
Nikola Jokic,22-009,C-F,2/28/17,DEN,CHI,1,33,6,10,0.6,3,7,0.429,3,3,1,4,4,1,2,14,16,10,0,1,3,1,19,24.3
Rudy Gobert,24-202,C,1/14/17,UTA,ORL,1,36,7,9,0.778,7,9,0.778,0,0,,5,7,0.714,5,14,19,2,0,2,0,1,19,24.8
Damian Lillard,26-141,G,12/3/16,POR,MIA,1,35,6,19,0.316,4,13,0.308,2,6,0.333,5,6,0.833,0,4,4,6,1,0,2,3,19,10.9
J.R. Smith,31-207,G-F,4/4/17,CLE,ORL,1,31,7,11,0.636,2,3,0.667,5,8,0.625,0,0,,0,5,5,3,0,0,1,1,19,16.3
Marreese Speights,29-157,C-F,1/8/17,LAC,MIA,0,14,6,8,0.75,3,3,1,3,5,0.6,4,4,1,1,0,1,1,0,1,1,6,19,14.5
Jeff Teague,28-294,G,3/31/17,IND,TOR,1,34,4,9,0.444,2,6,0.333,2,3,0.667,9,10,0.9,0,4,4,5,1,0,1,3,19,17.4
Derrick Rose,28-148,G,3/1/17,NYK,ORL,1,33,8,14,0.571,8,13,0.615,0,1,0,3,5,0.6,2,6,8,4,1,0,3,1,19,15.2
D'Angelo Russell,20-318,G,1/6/17,LAL,MIA,1,26,7,17,0.412,6,13,0.462,1,4,0.25,4,6,0.667,3,3,6,5,3,0,0,0,19,18.6
C.J. Miles,29-248,G-F,12/22/16,IND,BOS,0,27,7,13,0.538,5,7,0.714,2,6,0.333,3,4,0.75,0,2,2,0,0,1,1,3,19,11.4
Dwyane Wade,35-017,G,2/3/17,CHI,HOU,1,36,8,22,0.364,6,18,0.333,2,4,0.5,1,1,1,0,9,9,6,0,0,4,2,19,8.9
John Wall,26-115,G,12/30/16,WAS,BRK,1,32,7,14,0.5,6,10,0.6,1,4,0.25,4,4,1,0,2,2,14,4,1,6,1,19,20.7
Monta Ellis,31-028,G,11/23/16,IND,ATL,1,34,8,16,0.5,6,12,0.5,2,4,0.5,1,2,0.5,0,3,3,3,1,0,3,2,19,10.8
Bobby Portis,22-006,F,2/16/17,CHI,BOS,0,26,8,13,0.615,7,9,0.778,1,4,0.25,2,2,1,1,7,8,0,0,1,2,0,19,14.6
Nikola Jokic,21-321,C-F,1/5/17,DEN,SAS,1,27,8,10,0.8,8,10,0.8,0,0,,3,4,0.75,5,6,11,5,1,0,3,2,19,20.8
Rondae Hollis-Jefferson,21-352,F,12/20/16,BRK,TOR,0,20,8,15,0.533,7,14,0.5,1,1,1,2,3,0.667,1,5,6,3,1,1,0,6,19,14.9
Boris Diaw,34-351,F-C,4/2/17,UTA,SAS,1,19,9,9,1,8,8,1,1,1,1,0,0,,2,1,3,2,0,0,3,2,19,15.6
Cory Joseph,25-213,G,3/21/17,TOR,CHI,1,43,6,11,0.545,5,7,0.714,1,4,0.25,6,7,0.857,1,0,1,2,0,0,2,2,19,12.6
Isaiah Whitehead,21-321,G,1/23/17,BRK,SAS,0,29,6,15,0.4,4,11,0.364,2,4,0.5,5,5,1,0,1,1,3,0,0,1,4,19,10.7
Glenn Robinson,23-038,G-F,2/15/17,IND,CLE,1,26,7,10,0.7,4,5,0.8,3,5,0.6,2,2,1,2,4,6,2,0,0,0,1,19,18.4
Kent Bazemore,27-271,G-F,3/29/17,ATL,PHI,0,20,6,10,0.6,2,5,0.4,4,5,0.8,3,5,0.6,1,3,4,4,2,1,0,2,19,19.9
Stephen Curry,28-350,G,2/27/17,GSW,PHI,1,35,7,23,0.304,7,12,0.583,0,11,0,5,5,1,2,2,4,6,2,0,4,2,19,9.1
Eric Bledsoe,27-022,G,12/31/16,PHO,UTA,1,30,7,20,0.35,5,14,0.357,2,6,0.333,3,3,1,1,7,8,8,0,0,1,3,19,14
Andrew Wiggins,21-283,F-G,12/2/16,MIN,NYK,1,36,6,14,0.429,6,12,0.5,0,2,0,7,8,0.875,1,2,3,4,1,0,1,3,19,14.1
Ricky Rubio,26-167,G,4/6/17,MIN,POR,1,39,8,19,0.421,7,16,0.438,1,3,0.333,2,2,1,0,7,7,5,1,1,2,0,19,14.2
Kawhi Leonard,25-218,F,2/2/17,SAS,PHI,1,25,8,17,0.471,8,15,0.533,0,2,0,3,5,0.6,4,4,8,5,2,2,4,1,19,16
Emmanuel Mudiay,20-252,G,11/12/16,DEN,DET,1,26,6,14,0.429,2,6,0.333,4,8,0.5,3,4,0.75,2,3,5,2,2,2,5,2,19,12.5
Terrence Ross,26-045,F-G,3/22/17,ORL,CHO,1,31,8,15,0.533,5,6,0.833,3,9,0.333,0,0,,1,1,2,1,2,0,2,1,19,13
Dario Saric,22-323,F,2/25/17,PHI,NYK,1,40,7,17,0.412,6,12,0.5,1,5,0.2,4,6,0.667,6,9,15,5,0,0,4,2,19,14.7
Garrett Temple,30-181,G,11/5/16,SAC,MIL,0,28,7,10,0.7,2,4,0.5,5,6,0.833,0,0,,0,3,3,4,3,0,1,1,19,20.1
Mike Conley,29-175,G,4/4/17,MEM,SAS,1,33,8,17,0.471,6,12,0.5,2,5,0.4,1,1,1,0,2,2,6,2,0,5,3,19,10.9
LeBron James,31-300,F-G,10/25/16,CLE,NYK,1,32,9,14,0.643,9,11,0.818,0,3,0,1,2,0.5,3,8,11,14,0,1,4,3,19,22.2
Dwight Howard,31-122,C,4/9/17,ATL,CLE,1,24,9,12,0.75,9,12,0.75,0,0,,1,3,0.333,1,4,5,2,0,1,2,2,19,14.6
Avery Bradley,26-013,G,12/9/16,BOS,TOR,1,34,7,11,0.636,2,4,0.5,5,7,0.714,0,0,,0,5,5,2,0,0,4,5,19,11
Damian Lillard,26-232,G,3/4/17,POR,BRK,1,36,7,16,0.438,5,10,0.5,2,6,0.333,3,4,0.75,0,5,5,11,0,1,4,2,19,15.3
Dwight Howard,31-124,C,4/11/17,ATL,CHO,1,25,7,9,0.778,7,9,0.778,0,0,,5,7,0.714,4,8,12,1,0,1,2,1,19,18.9
Serge Ibaka,27-068,F-C,11/25/16,ORL,WAS,1,31,8,13,0.615,6,9,0.667,2,4,0.5,1,1,1,2,6,8,2,1,4,2,3,19,18.3
Ish Smith,28-266,G,3/28/17,DET,MIA,1,31,7,13,0.538,7,12,0.583,0,1,0,5,6,0.833,1,3,4,6,0,0,2,1,19,15.7
Pat Connaughton,24-096,G,4/12/17,POR,NOP,0,36,7,13,0.538,2,3,0.667,5,10,0.5,0,0,,0,7,7,7,0,0,3,5,19,14.7
Domantas Sabonis,20-343,F,4/11/17,OKC,MIN,1,32,6,16,0.375,5,11,0.455,1,5,0.2,6,6,1,2,7,9,3,1,0,2,1,19,14.4
Serge Ibaka,27-096,F-C,12/23/16,ORL,LAL,1,30,8,15,0.533,7,11,0.636,1,4,0.25,2,3,0.667,3,8,11,2,2,5,1,3,19,20.5
Kristaps Porzingis,21-110,F-C,11/20/16,NYK,ATL,1,31,8,15,0.533,7,10,0.7,1,5,0.2,2,4,0.5,1,10,11,0,0,0,0,4,19,13
Tony Allen,34-334,G-F,12/10/16,MEM,GSW,1,38,7,12,0.583,6,11,0.545,1,1,1,4,4,1,0,4,4,1,1,1,3,1,19,13.6
Jae Crowder,26-205,F,1/27/17,BOS,ORL,1,27,7,11,0.636,2,4,0.5,5,7,0.714,0,0,,2,4,6,4,2,1,1,1,19,20.8
Jae Crowder,26-233,F,2/24/17,BOS,TOR,1,31,6,12,0.5,2,3,0.667,4,9,0.444,3,4,0.75,1,3,4,1,0,0,0,2,19,14.1
Andrew Wiggins,21-325,F-G,1/13/17,MIN,OKC,1,36,9,22,0.409,9,19,0.474,0,3,0,1,1,1,1,5,6,1,1,1,4,0,19,7.8
Derrick Favors,25-224,F-C,2/24/17,UTA,MIL,1,26,9,14,0.643,9,14,0.643,0,0,,1,1,1,2,5,7,2,0,2,2,1,19,16.1
Kawhi Leonard,25-267,F,3/23/17,SAS,MEM,1,38,7,15,0.467,6,10,0.6,1,5,0.2,4,7,0.571,3,4,7,4,1,0,2,2,19,14.4
Justin Hamilton,26-208,C,10/26/16,BRK,BOS,0,25,7,12,0.583,4,6,0.667,3,6,0.5,2,3,0.667,6,4,10,2,0,0,1,4,19,17.2
Rodney Hood,24-040,G-F,11/29/16,UTA,HOU,1,20,7,15,0.467,4,9,0.444,3,6,0.5,2,2,1,0,2,2,3,1,1,2,1,19,13.3
Jordan Crawford,28-139,G,3/11/17,NOP,CHO,0,27,7,12,0.583,2,5,0.4,5,7,0.714,0,0,,0,1,1,6,0,0,0,3,19,16.7
Norman Powell,23-247,G,1/27/17,TOR,MIL,1,31,7,15,0.467,5,12,0.417,2,3,0.667,3,3,1,1,5,6,1,0,0,2,1,19,11.8
Mason Plumlee,27-003,C-F,3/8/17,DEN,WAS,1,31,7,13,0.538,7,13,0.538,0,0,,5,7,0.714,6,4,10,5,1,0,4,2,19,17
Andrew Wiggins,21-281,F-G,11/30/16,MIN,NYK,1,40,8,20,0.4,5,16,0.313,3,4,0.75,0,1,0,2,5,7,4,1,0,1,2,19,12.7
Thaddeus Young,28-214,F,1/21/17,IND,UTA,1,38,8,11,0.727,6,9,0.667,2,2,1,1,2,0.5,2,7,9,3,1,1,5,3,19,15.2
T.J. Warren,23-109,F,12/23/16,PHO,PHI,0,32,7,16,0.438,5,11,0.455,2,5,0.4,3,6,0.5,3,2,5,2,1,0,1,1,19,13.1
Enes Kanter,24-223,C,12/29/16,OKC,MEM,0,24,7,11,0.636,7,10,0.7,0,1,0,5,7,0.714,0,5,5,0,0,0,2,1,19,12.4
Tobias Harris,24-208,F,2/8/17,DET,LAL,0,24,7,12,0.583,5,9,0.556,2,3,0.667,3,5,0.6,0,5,5,1,1,0,0,1,19,15.4
James Johnson,30-011,F,3/3/17,MIA,ORL,0,34,9,14,0.643,8,11,0.727,1,3,0.333,0,0,,3,1,4,6,2,2,1,1,19,21.4
Jamal Crawford,37-021,G,4/10/17,LAC,HOU,0,30,6,14,0.429,3,7,0.429,3,7,0.429,4,4,1,0,1,1,2,0,0,0,0,19,13.3
Jeff Teague,28-201,G,12/28/16,IND,WAS,1,38,6,12,0.5,5,9,0.556,1,3,0.333,6,7,0.857,1,1,2,11,1,0,1,4,19,19.7
Damian Lillard,26-123,G,11/15/16,POR,CHI,1,38,7,22,0.318,6,17,0.353,1,5,0.2,4,4,1,1,4,5,4,1,0,3,1,19,8.7
Tim Hardaway,24-355,G,3/6/17,ATL,GSW,0,33,7,15,0.467,6,9,0.667,1,6,0.167,4,6,0.667,2,2,4,5,2,0,5,3,19,11.8
Goran Dragic,30-315,G,3/17/17,MIA,MIN,1,33,7,16,0.438,6,12,0.5,1,4,0.25,4,5,0.8,1,4,5,10,3,0,3,2,19,18.3
Jared Dudley,31-269,F-G,4/5/17,PHO,GSW,0,33,8,14,0.571,5,8,0.625,3,6,0.5,0,0,,0,7,7,6,2,0,3,4,19,16.1
Robert Covington,26-059,F,2/11/17,PHI,MIA,1,31,6,12,0.5,1,6,0.167,5,6,0.833,2,2,1,0,7,7,0,4,2,2,4,19,16.9
Danilo Gallinari,28-097,F,11/13/16,DEN,POR,1,29,7,13,0.538,4,8,0.5,3,5,0.6,2,2,1,2,5,7,1,0,1,3,1,19,13.6
Chris Paul,31-187,G,11/9/16,LAC,POR,1,23,7,14,0.5,4,8,0.5,3,6,0.5,2,2,1,1,3,4,7,1,0,1,2,19,17.7
Nikola Jokic,21-337,C-F,1/21/17,DEN,LAC,1,21,8,11,0.727,6,8,0.75,2,3,0.667,1,1,1,3,7,10,3,0,0,3,3,19,16.6
Marc Gasol,31-284,C,11/8/16,MEM,DEN,1,30,9,14,0.643,9,13,0.692,0,1,0,1,3,0.333,0,2,2,6,0,1,1,1,19,16.1
Sean Kilpatrick,26-332,G,12/3/16,BRK,MIL,1,29,3,13,0.231,2,8,0.25,1,5,0.2,12,13,0.923,0,1,1,3,0,0,0,0,19,13.1
Kristaps Porzingis,21-222,F-C,3/12/17,NYK,BRK,1,34,7,16,0.438,5,10,0.5,2,6,0.333,3,4,0.75,2,8,10,4,0,5,4,6,19,13.9
Michael Beasley,27-308,F,11/12/16,MIL,MEM,0,19,6,8,0.75,5,7,0.714,1,1,1,6,7,0.857,1,3,4,1,1,0,1,1,19,17.3
Jamal Crawford,37-010,G,3/30/17,LAC,PHO,0,27,6,11,0.545,5,9,0.556,1,2,0.5,6,8,0.75,0,0,0,0,0,0,0,0,19,12.9
Stephen Curry,28-268,G,12/7/16,GSW,LAC,1,33,7,16,0.438,7,8,0.875,0,8,0,5,5,1,0,4,4,6,7,0,3,3,19,18.8
Chris Paul,31-230,G,12/22/16,LAC,SAS,1,23,6,11,0.545,4,9,0.444,2,2,1,5,6,0.833,0,6,6,6,2,0,2,2,19,18.5
Derrick Rose,28-028,G,11/1/16,NYK,DET,1,32,8,17,0.471,8,16,0.5,0,1,0,3,3,1,1,4,5,2,0,1,2,0,19,12.3
Avery Bradley,25-354,G,11/14/16,BOS,NOP,1,34,7,17,0.412,4,9,0.444,3,8,0.375,2,2,1,1,9,10,1,0,0,2,4,19,10.4
LeBron James,31-319,F-G,11/13/16,CLE,CHO,1,39,8,21,0.381,6,16,0.375,2,5,0.4,1,2,0.5,0,8,8,8,1,1,3,0,19,13.8
Dario Saric,22-309,F,2/11/17,PHI,MIA,0,26,7,15,0.467,6,10,0.6,1,5,0.2,4,4,1,2,4,6,4,2,1,1,2,19,17.6
Timothe Luwawu-Cabarrot,21-330,F,4/4/17,PHI,BRK,1,38,6,15,0.4,3,4,0.75,3,11,0.273,4,4,1,0,3,3,3,3,0,0,3,19,15.7
Zach LaVine,21-230,G,10/26/16,MIN,MEM,1,34,6,14,0.429,3,8,0.375,3,6,0.5,4,5,0.8,0,5,5,3,1,0,2,3,19,12.6
Eric Gordon,28-005,G,12/30/16,HOU,LAC,0,24,5,7,0.714,1,2,0.5,4,5,0.8,5,5,1,0,4,4,3,0,1,2,1,19,17.7
John Wall,26-143,G,1/27/17,WAS,ATL,1,30,7,17,0.412,6,15,0.4,1,2,0.5,4,6,0.667,1,5,6,9,0,0,4,0,19,13.6
Gerald Green,30-336,G-F,12/27/16,BOS,MEM,0,19,7,10,0.7,4,5,0.8,3,5,0.6,2,2,1,3,2,5,1,0,1,1,0,19,17.9
Trey Lyles,21-048,F,12/23/16,UTA,TOR,0,30,6,13,0.462,2,7,0.286,4,6,0.667,3,4,0.75,1,6,7,1,0,0,1,1,19,13.7
Harrison Barnes,24-220,F,1/5/17,DAL,PHO,1,39,8,13,0.615,8,13,0.615,0,0,,3,4,0.75,2,4,6,2,1,1,0,0,19,18.4
Derrick Rose,28-079,G,12/22/16,NYK,ORL,1,26,7,16,0.438,6,14,0.429,1,2,0.5,4,4,1,1,4,5,3,0,0,0,2,19,13.8
George Hill,30-287,G,2/15/17,UTA,POR,1,31,7,15,0.467,5,10,0.5,2,5,0.4,3,4,0.75,0,5,5,5,0,0,4,4,19,10.3
Stephen Curry,29-021,G,4/4/17,GSW,MIN,1,30,7,18,0.389,4,10,0.4,3,8,0.375,2,4,0.5,0,3,3,9,3,2,3,2,19,16.2
Jusuf Nurkic,22-219,C,3/30/17,POR,HOU,1,32,7,16,0.438,7,16,0.438,0,0,,5,7,0.714,5,6,11,0,1,3,4,3,19,13
DeAndre Jordan,28-233,C,3/11/17,LAC,PHI,1,36,6,7,0.857,6,7,0.857,0,0,,7,10,0.7,5,15,20,4,1,3,0,4,19,27.6
Avery Bradley,25-365,G,11/25/16,BOS,SAS,1,38,8,15,0.533,5,11,0.455,3,4,0.75,0,0,,1,7,8,3,0,0,1,2,19,14.8
Marcus Morris,27-155,F,2/4/17,DET,IND,1,34,5,11,0.455,2,8,0.25,3,3,1,6,6,1,1,5,6,4,1,1,1,1,19,18.6
Carmelo Anthony,32-149,F,10/25/16,NYK,CLE,1,30,8,18,0.444,7,14,0.5,1,4,0.25,2,2,1,1,4,5,3,1,0,4,5,19,8.6
George Hill,30-248,G,1/7/17,UTA,MIN,1,33,5,12,0.417,3,8,0.375,2,4,0.5,7,7,1,2,3,5,7,1,0,1,2,19,19
Kent Bazemore,27-140,G-F,11/18/16,ATL,CHO,1,30,8,15,0.533,7,10,0.7,1,5,0.2,2,2,1,1,1,2,2,3,2,4,5,19,12.5
Wayne Ellington,29-091,G,1/28/17,MIA,DET,0,34,7,10,0.7,2,3,0.667,5,7,0.714,0,0,,0,0,0,2,1,0,1,1,19,15.8
Nikola Vucevic,26-076,C,1/8/17,ORL,LAL,0,26,8,17,0.471,7,13,0.538,1,4,0.25,2,4,0.5,2,5,7,4,0,2,1,2,19,14.8
Eric Gordon,27-346,G,12/5/16,HOU,BOS,0,31,6,11,0.545,2,2,1,4,9,0.444,3,4,0.75,0,1,1,3,0,2,1,1,19,15.7
Darren Collison,29-164,G,2/3/17,SAC,PHO,1,38,8,16,0.5,5,12,0.417,3,4,0.75,0,0,,0,2,2,1,1,0,2,3,19,10.1
Hollis Thompson,25-220,G-F,11/9/16,PHI,IND,0,26,7,12,0.583,4,6,0.667,3,6,0.5,2,2,1,2,4,6,3,1,0,1,3,19,16.9
Seth Curry,26-218,G,3/29/17,DAL,NOP,1,34,7,13,0.538,5,7,0.714,2,6,0.333,2,2,1,0,2,2,3,1,0,0,2,18,14.6
Tyreke Evans,27-121,G-F,1/18/17,NOP,ORL,0,20,6,12,0.5,2,6,0.333,4,6,0.667,2,2,1,0,4,4,5,3,0,1,1,18,18.3
Nikola Vucevic,26-170,C,4/12/17,ORL,DET,1,27,8,15,0.533,6,13,0.462,2,2,1,0,0,,1,10,11,1,2,2,0,4,18,16.9
Jordan Clarkson,24-173,G,11/27/16,LAL,ATL,0,32,7,17,0.412,6,13,0.462,1,4,0.25,3,4,0.75,1,3,4,5,2,0,0,0,18,15.6
John Wall,26-111,G,12/26/16,WAS,MIL,1,42,8,19,0.421,7,15,0.467,1,4,0.25,1,2,0.5,2,1,3,16,2,2,7,2,18,16
Kyle Korver,35-302,G-F,1/13/17,CLE,SAC,0,25,7,10,0.7,3,4,0.75,4,6,0.667,0,0,,1,4,5,2,2,0,0,2,18,18.3
John Wall,26-118,G,1/2/17,WAS,HOU,1,37,8,18,0.444,8,16,0.5,0,2,0,2,3,0.667,1,4,5,12,2,0,5,2,18,14.7
Al Horford,30-196,C-F,12/16/16,BOS,CHO,1,35,6,11,0.545,6,11,0.545,0,0,,6,8,0.75,1,7,8,5,2,5,1,0,18,22.7
Kristaps Porzingis,21-178,F-C,1/27/17,NYK,CHO,1,35,8,11,0.727,6,7,0.857,2,4,0.5,0,0,,1,3,4,0,0,3,2,6,18,12.8
Bradley Beal,23-142,G,11/17/16,WAS,NYK,1,29,5,10,0.5,2,5,0.4,3,5,0.6,5,5,1,0,2,2,5,0,0,1,0,18,16.1
J.J. Barea,32-126,G,10/30/16,DAL,HOU,0,31,4,10,0.4,1,6,0.167,3,4,0.75,7,7,1,1,2,3,5,2,0,1,0,18,18.4
Seth Curry,26-196,G,3/7/17,DAL,LAL,1,31,7,12,0.583,3,5,0.6,4,7,0.571,0,1,0,0,2,2,5,1,0,2,3,18,13.9
David Lee,33-313,F,3/8/17,SAS,SAC,1,31,8,9,0.889,8,9,0.889,0,0,,2,5,0.4,2,8,10,0,0,2,2,1,18,16.5
Karl-Anthony Towns,21-070,C-F,1/24/17,MIN,PHO,1,39,7,12,0.583,7,12,0.583,0,0,,4,5,0.8,0,10,10,2,2,1,3,5,18,14.1
Marcus Smart,23-031,G,4/6/17,BOS,ATL,0,33,6,11,0.545,1,2,0.5,5,9,0.556,1,2,0.5,1,3,4,7,6,2,1,3,18,24
Devin Booker,20-050,G,12/19/16,PHO,MIN,1,29,6,15,0.4,5,10,0.5,1,5,0.2,5,6,0.833,1,1,2,3,0,1,2,2,18,10.5
Pau Gasol,36-266,F-C,3/29/17,SAS,GSW,0,26,5,11,0.455,4,9,0.444,1,2,0.5,7,8,0.875,3,5,8,5,1,1,0,0,18,20.7
Blake Griffin,27-228,F,10/30/16,LAC,UTA,1,30,7,14,0.5,7,13,0.538,0,1,0,4,6,0.667,3,7,10,1,1,0,2,2,18,13.3
Jrue Holiday,26-258,G,2/25/17,NOP,DAL,1,39,5,17,0.294,3,11,0.273,2,6,0.333,6,6,1,3,4,7,6,0,0,4,3,18,10.4
Harrison Barnes,24-196,F,12/12/16,DAL,DEN,1,32,6,11,0.545,6,11,0.545,0,0,,6,7,0.857,1,2,3,1,1,0,2,0,18,13.3
Derrick Favors,25-119,F-C,11/11/16,UTA,ORL,1,36,7,14,0.5,6,13,0.462,1,1,1,3,4,0.75,0,9,9,1,3,2,3,1,18,15
Wayne Ellington,29-064,G,1/1/17,MIA,DET,1,37,7,15,0.467,3,7,0.429,4,8,0.5,0,0,,0,4,4,3,0,0,0,0,18,13.6
C.J. Miles,29-284,G-F,1/27/17,IND,SAC,1,40,6,9,0.667,0,0,,6,9,0.667,0,0,,0,2,2,1,1,0,2,2,18,13.6
Kentavious Caldwell-Pope,24-008,G,2/26/17,DET,BOS,1,36,6,14,0.429,3,6,0.5,3,8,0.375,3,5,0.6,0,3,3,3,1,2,1,3,18,13
Taj Gibson,31-125,F,10/27/16,CHI,BOS,1,28,8,13,0.615,8,13,0.615,0,0,,2,2,1,2,8,10,1,0,0,2,2,18,13.8
Jimmy Butler,27-164,G-F,2/25/17,CHI,CLE,1,39,7,19,0.368,3,13,0.231,4,6,0.667,0,0,,1,9,10,10,1,0,1,1,18,17.5
Hassan Whiteside,27-135,C,10/26/16,MIA,ORL,1,31,9,16,0.563,9,16,0.563,0,0,,0,4,0,4,10,14,1,0,4,1,3,18,15.9
LaMarcus Aldridge,31-118,F-C,11/14/16,SAS,MIA,1,36,8,14,0.571,8,14,0.571,0,0,,2,2,1,1,2,3,2,1,0,2,1,18,12.7
Rodney Hood,24-131,G-F,2/28/17,UTA,OKC,1,31,6,13,0.462,3,7,0.429,3,6,0.5,3,3,1,0,6,6,0,0,0,2,2,18,10.3
Devin Booker,20-104,G,2/11/17,PHO,HOU,1,26,6,18,0.333,5,15,0.333,1,3,0.333,5,6,0.833,0,1,1,2,1,0,3,3,18,5.9
Michael Beasley,27-365,F,1/8/17,MIL,WAS,0,16,6,9,0.667,5,8,0.625,1,1,1,5,5,1,0,1,1,0,1,0,1,1,18,14
Klay Thompson,27-015,G,2/23/17,GSW,LAC,1,31,7,12,0.583,5,7,0.714,2,5,0.4,2,2,1,0,0,0,4,0,0,1,0,18,14.2
Metta World Peace,37-149,F,4/11/17,LAL,NOP,1,25,7,17,0.412,3,7,0.429,4,10,0.4,0,0,,1,3,4,1,3,0,1,1,18,12.8
Richaun Holmes,23-101,F-C,1/24/17,PHI,LAC,0,19,8,11,0.727,7,10,0.7,1,1,1,1,1,1,0,3,3,0,0,1,0,3,18,13.9
C.J. McCollum,25-134,G,1/31/17,POR,CHO,1,26,7,14,0.5,5,10,0.5,2,4,0.5,2,2,1,0,2,2,4,3,0,1,1,18,16
Karl-Anthony Towns,21-052,C-F,1/6/17,MIN,WAS,1,38,7,17,0.412,7,15,0.467,0,2,0,4,5,0.8,4,6,10,5,1,1,3,3,18,14.1
Dario Saric,22-346,F,3/20/17,PHI,ORL,1,26,6,14,0.429,4,9,0.444,2,5,0.4,4,4,1,0,5,5,0,1,1,1,6,18,10.4
Austin Rivers,24-185,G,2/2/17,LAC,GSW,1,36,7,15,0.467,7,12,0.583,0,3,0,4,6,0.667,1,3,4,6,0,1,2,4,18,12.4
Al Jefferson,31-310,C-F,11/9/16,IND,PHI,0,20,9,12,0.75,9,12,0.75,0,0,,0,0,,2,5,7,0,2,0,1,2,18,16.3
James Harden,27-201,G,3/15/17,HOU,LAL,1,31,6,12,0.5,5,6,0.833,1,6,0.167,5,7,0.714,3,9,12,13,2,0,9,2,18,17.3
Marquese Chriss,19-250,F,3/9/17,PHO,LAL,1,27,6,9,0.667,3,5,0.6,3,4,0.75,3,4,0.75,3,3,6,1,1,1,1,5,18,16.1
Shawn Long,24-065,C-F,4/4/17,PHI,BRK,0,17,8,11,0.727,8,11,0.727,0,0,,2,4,0.5,5,1,6,2,0,0,1,4,18,15.3
LaMarcus Aldridge,31-157,F-C,12/23/16,SAS,POR,1,37,7,18,0.389,7,18,0.389,0,0,,4,4,1,6,8,14,6,3,0,0,0,18,22
Hassan Whiteside,27-159,C,11/19/16,MIA,WAS,1,40,9,14,0.643,9,14,0.643,0,0,,0,3,0,9,9,18,1,0,3,0,4,18,20.8
Jonas Valanciunas,24-244,C,1/5/17,TOR,UTA,1,31,7,11,0.636,7,11,0.636,0,0,,4,4,1,8,5,13,0,0,0,0,3,18,19
J.J. Redick,32-292,G,4/12/17,LAC,SAC,1,29,6,13,0.462,3,6,0.5,3,7,0.429,3,3,1,0,2,2,4,0,1,0,1,18,15
Bojan Bogdanovic,27-210,G-F,11/14/16,BRK,LAC,1,25,8,11,0.727,7,8,0.875,1,3,0.333,1,1,1,0,2,2,0,1,0,3,1,18,11.7
Rodney Hood,24-015,G-F,11/4/16,UTA,SAS,1,24,7,12,0.583,5,8,0.625,2,4,0.5,2,4,0.5,1,4,5,2,1,0,1,4,18,13.3
Derrick Rose,28-144,G,2/25/17,NYK,PHI,1,36,8,17,0.471,8,16,0.5,0,1,0,2,2,1,0,5,5,3,0,0,1,1,18,11.5
Wilson Chandler,29-187,F,11/13/16,DEN,POR,0,27,7,12,0.583,7,10,0.7,0,2,0,4,5,0.8,0,7,7,1,1,0,0,4,18,14.2
Reggie Jackson,26-282,G,1/23/17,DET,SAC,1,35,6,12,0.5,3,7,0.429,3,5,0.6,3,4,0.75,1,2,3,11,0,0,4,5,18,14.6
C.J. McCollum,25-121,G,1/18/17,POR,CHO,1,32,7,18,0.389,5,12,0.417,2,6,0.333,2,2,1,0,2,2,1,4,1,4,3,18,9
Nicolas Batum,27-326,F-G,11/4/16,CHO,BRK,1,36,7,13,0.538,5,8,0.625,2,5,0.4,2,3,0.667,0,9,9,2,0,0,3,2,18,11.6
Norman Powell,23-251,G,1/31/17,TOR,NOP,1,40,8,15,0.533,8,13,0.615,0,2,0,2,2,1,0,4,4,3,2,2,3,2,18,13.6
Jamal Murray,19-340,G,1/28/17,DEN,PHO,0,23,7,10,0.7,6,8,0.75,1,2,0.5,3,3,1,0,1,1,1,0,1,2,2,18,12.7
Trevor Ariza,31-183,F,12/30/16,HOU,LAC,1,37,6,11,0.545,1,1,1,5,10,0.5,1,2,0.5,0,4,4,7,2,0,1,0,18,19.4
Lou Williams,30-034,G,11/30/16,LAL,CHI,0,28,4,12,0.333,3,9,0.333,1,3,0.333,9,11,0.818,0,5,5,5,1,1,2,0,18,15.1
Kevin Durant,28-125,F-G,2/1/17,GSW,CHO,1,33,7,17,0.412,6,10,0.6,1,7,0.143,3,3,1,2,6,8,8,1,0,1,0,18,17.7
Langston Galloway,25-040,G,1/18/17,NOP,ORL,0,31,5,8,0.625,1,1,1,4,7,0.571,4,5,0.8,1,2,3,3,0,0,0,2,18,16.6
Derrick Favors,25-193,F-C,1/24/17,UTA,DEN,1,25,8,11,0.727,8,11,0.727,0,0,,2,2,1,3,2,5,1,1,1,0,2,18,17.8
Ian Clark,26-014,G,3/21/17,GSW,DAL,0,29,8,16,0.5,8,12,0.667,0,4,0,2,2,1,0,4,4,0,1,0,3,4,18,7.6
Andre Drummond,23-091,C,11/9/16,DET,PHO,1,35,7,13,0.538,7,13,0.538,0,0,,4,6,0.667,4,10,14,4,1,1,2,5,18,17.2
Myles Turner,20-260,F-C,12/9/16,IND,DAL,1,31,4,9,0.444,4,8,0.5,0,1,0,10,10,1,2,4,6,2,0,1,2,2,18,15.2
Nikola Jokic,22-022,C-F,3/13/17,DEN,LAL,1,24,8,13,0.615,8,10,0.8,0,3,0,2,2,1,1,8,9,4,1,0,1,2,18,17.2
Rodney Hood,24-018,G-F,11/7/16,UTA,PHI,1,29,7,13,0.538,3,8,0.375,4,5,0.8,0,0,,0,2,2,1,1,1,1,1,18,13.3
Jrue Holiday,26-285,G,3/24/17,NOP,HOU,1,38,7,12,0.583,3,4,0.75,4,8,0.5,0,1,0,0,1,1,9,3,2,2,1,18,20.6
Jameer Nelson,34-342,G,1/16/17,DEN,ORL,0,32,7,10,0.7,5,5,1,2,5,0.4,2,2,1,1,3,4,4,1,0,1,2,18,17.4
Reggie Jackson,26-232,G,12/4/16,DET,ORL,1,23,7,12,0.583,5,9,0.556,2,3,0.667,2,2,1,0,1,1,4,0,0,3,1,18,12.1
Zach Randolph,35-262,F,4/4/17,MEM,SAS,0,35,7,21,0.333,7,18,0.389,0,3,0,4,6,0.667,4,12,16,2,2,0,0,1,18,14.7
Trey Burke,23-363,G,11/9/16,WAS,BOS,0,17,7,9,0.778,4,5,0.8,3,4,0.75,1,2,0.5,1,0,1,2,0,0,0,3,18,15
Nene Hilario,34-114,F-C,1/5/17,HOU,OKC,1,17,6,6,1,6,6,1,0,0,,6,10,0.6,0,3,3,1,1,0,0,4,18,15.6
Ersan Ilyasova,29-244,F,1/14/17,PHI,WAS,1,26,7,13,0.538,4,8,0.5,3,5,0.6,1,2,0.5,3,4,7,1,1,0,0,1,18,15.9
Marvin Williams,30-283,F,3/29/17,CHO,TOR,1,35,6,11,0.545,2,5,0.4,4,6,0.667,2,3,0.667,3,9,12,1,1,0,1,2,18,17
Kyle Lowry,30-222,G,11/2/16,TOR,WAS,1,36,7,13,0.538,4,7,0.571,3,6,0.5,1,2,0.5,0,1,1,2,4,0,3,2,18,13.2
John Wall,26-108,G,12/23/16,WAS,MIL,1,32,8,18,0.444,8,15,0.533,0,3,0,2,2,1,0,3,3,10,1,0,3,0,18,14.5
Willie Cauley-Stein,23-213,F-C,3/19/17,SAC,SAS,1,32,5,11,0.455,5,11,0.455,0,0,,8,10,0.8,0,4,4,5,0,1,2,2,18,14.1
Kyle O'Quinn,26-319,F-C,2/8/17,NYK,LAC,1,25,8,13,0.615,8,13,0.615,0,0,,2,2,1,2,4,6,2,3,2,1,3,18,18.3
Tony Parker,34-263,G,2/4/17,SAS,DEN,1,23,8,8,1,8,8,1,0,0,,2,2,1,0,0,0,4,3,0,3,2,18,17.6
Aaron Gordon,21-162,F,2/25/17,ORL,ATL,1,24,7,11,0.636,7,9,0.778,0,2,0,4,4,1,0,3,3,3,2,0,1,2,18,16.3
C.J. Miles,29-235,G-F,12/9/16,IND,DAL,0,28,6,9,0.667,0,0,,6,9,0.667,0,0,,0,4,4,1,2,0,0,2,18,17.2
Mason Plumlee,26-282,C-F,12/12/16,POR,LAC,1,34,8,15,0.533,8,15,0.533,0,0,,2,4,0.5,4,3,7,6,1,5,1,4,18,19.7
Marreese Speights,29-170,C-F,1/21/17,LAC,DEN,1,28,7,10,0.7,5,6,0.833,2,4,0.5,2,2,1,0,3,3,2,1,0,1,4,18,14.5
LaMarcus Aldridge,31-263,F-C,4/8/17,SAS,LAC,1,36,9,17,0.529,9,16,0.563,0,1,0,0,0,,0,2,2,0,1,1,2,3,18,8.8
Nikola Vucevic,26-038,C,12/1/16,ORL,MEM,0,30,6,15,0.4,5,12,0.417,1,3,0.333,5,5,1,2,9,11,0,0,3,1,1,18,14.7
Tyler Johnson,24-236,G,12/29/16,MIA,CHO,0,28,8,16,0.5,6,10,0.6,2,6,0.333,0,0,,1,6,7,5,2,1,1,1,18,17.3
Sean Kilpatrick,27-030,G,2/5/17,BRK,TOR,0,32,5,10,0.5,0,1,0,5,9,0.556,3,3,1,0,5,5,0,1,0,5,3,18,9.3
Al Jefferson,31-351,C-F,12/20/16,IND,NYK,0,16,8,11,0.727,8,11,0.727,0,0,,2,2,1,2,1,3,0,0,0,0,2,18,14.4
Wesley Matthews,30-122,G,2/13/17,DAL,BOS,1,35,5,12,0.417,4,7,0.571,1,5,0.2,7,10,0.7,0,7,7,3,0,0,0,3,18,13.4
J.J. Barea,32-135,G,11/8/16,DAL,LAL,1,34,7,15,0.467,5,9,0.556,2,6,0.333,2,2,1,1,6,7,8,0,0,4,1,18,14
Jeremy Lin,28-064,G,10/26/16,BRK,BOS,1,28,6,14,0.429,4,9,0.444,2,5,0.4,4,5,0.8,1,2,3,3,0,1,2,1,18,11.9
Darren Collison,29-165,G,2/4/17,SAC,GSW,1,33,8,13,0.615,8,10,0.8,0,3,0,2,2,1,0,2,2,3,0,0,2,2,18,12
Jrue Holiday,26-246,G,2/13/17,NOP,PHO,1,36,6,11,0.545,4,5,0.8,2,6,0.333,4,6,0.667,1,1,2,8,2,0,5,2,18,14.7
Nikola Vucevic,26-164,C,4/6/17,ORL,BRK,1,34,9,18,0.5,9,17,0.529,0,1,0,0,0,,0,12,12,5,1,0,0,2,18,16.3
Jeff Green,30-145,F,1/20/17,ORL,MIL,0,27,6,13,0.462,5,8,0.625,1,5,0.2,5,5,1,3,4,7,2,1,2,0,4,18,16.8
Zach Randolph,35-121,F,11/14/16,MEM,UTA,0,23,7,13,0.538,7,13,0.538,0,0,,4,4,1,5,5,10,0,0,0,2,4,18,13.1
Jrue Holiday,26-296,G,4/4/17,NOP,DEN,1,39,6,13,0.462,4,7,0.571,2,6,0.333,4,4,1,0,4,4,13,1,1,3,0,18,20.3
Kyle Lowry,30-315,G,2/3/17,TOR,ORL,1,42,5,20,0.25,3,9,0.333,2,11,0.182,6,6,1,1,4,5,7,0,1,2,5,18,9.5
Rodney Hood,24-017,G-F,11/6/16,UTA,NYK,1,38,7,13,0.538,5,9,0.556,2,4,0.5,2,3,0.667,0,6,6,5,1,0,0,2,18,16.8
Wayne Ellington,29-123,G,3/1/17,MIA,PHI,0,25,6,9,0.667,0,0,,6,9,0.667,0,0,,1,2,3,0,0,0,0,1,18,15
Marcin Gortat,32-269,C-F,11/12/16,WAS,CHI,1,35,9,12,0.75,9,12,0.75,0,0,,0,0,,3,11,14,2,0,1,2,4,18,17.1
Dwyane Wade,35-015,G,2/1/17,CHI,OKC,1,24,7,12,0.583,7,11,0.636,0,1,0,4,4,1,0,7,7,7,2,0,0,1,18,21
Zach LaVine,21-313,G,1/17/17,MIN,SAS,1,35,8,14,0.571,6,9,0.667,2,5,0.4,0,0,,0,4,4,2,0,0,1,3,18,11.8
Klay Thompson,26-291,G,11/25/16,GSW,LAL,1,33,7,17,0.412,6,11,0.545,1,6,0.167,3,4,0.75,0,7,7,0,0,0,1,1,18,9.2
J.R. Smith,31-205,G-F,4/2/17,CLE,IND,1,42,6,12,0.5,0,1,0,6,11,0.545,0,0,,1,4,5,2,2,0,0,1,18,16.9
Dario Saric,22-275,F,1/8/17,PHI,BRK,0,30,5,13,0.385,2,7,0.286,3,6,0.5,5,6,0.833,0,5,5,0,1,0,4,2,18,8.2
Karl-Anthony Towns,21-011,C-F,11/26/16,MIN,GSW,1,35,8,21,0.381,7,15,0.467,1,6,0.167,1,2,0.5,5,4,9,3,3,1,0,1,18,16.2
Cory Joseph,25-221,G,3/29/17,TOR,CHO,1,35,8,14,0.571,6,10,0.6,2,4,0.5,0,0,,3,4,7,5,2,2,1,2,18,19.8
Serge Ibaka,27-089,F-C,12/16/16,ORL,BRK,1,32,8,13,0.615,7,11,0.636,1,2,0.5,1,3,0.333,2,9,11,1,0,5,1,4,18,17
Robin Lopez,28-359,C,3/26/17,CHI,MIL,1,28,9,13,0.692,9,13,0.692,0,0,,0,0,,1,4,5,2,0,1,0,2,18,15.7
Mike Conley,29-034,G,11/14/16,MEM,UTA,1,31,7,14,0.5,5,9,0.556,2,5,0.4,2,2,1,0,3,3,7,1,0,0,0,18,17.8
Rajon Rondo,31-032,G,3/26/17,CHI,MIL,1,34,8,11,0.727,7,9,0.778,1,2,0.5,1,1,1,2,7,9,9,1,0,3,3,18,20.1
T.J. Warren,23-065,F,11/9/16,PHO,DET,1,38,7,17,0.412,7,15,0.467,0,2,0,4,4,1,2,1,3,1,0,1,2,3,18,8.8
Bradley Beal,23-263,G,3/18/17,WAS,CHO,1,31,6,14,0.429,4,7,0.571,2,7,0.286,4,6,0.667,0,3,3,2,1,1,1,4,18,11.2
Jamal Crawford,36-288,G,1/2/17,LAC,PHO,0,31,7,18,0.389,7,17,0.412,0,1,0,4,4,1,2,5,7,5,0,1,3,3,18,11.1
Kristaps Porzingis,21-230,F-C,3/20/17,NYK,LAC,1,32,9,16,0.563,9,12,0.75,0,4,0,0,0,,3,8,11,2,2,0,2,3,18,15.1
Markieff Morris,27-115,F,12/26/16,WAS,MIL,1,38,7,11,0.636,6,9,0.667,1,2,0.5,3,4,0.75,1,3,4,0,2,1,2,2,18,14.2
Taj Gibson,31-205,F,1/15/17,CHI,MEM,1,32,7,14,0.5,7,13,0.538,0,1,0,4,5,0.8,0,8,8,1,1,0,1,1,18,13.3
Myles Turner,20-298,F-C,1/16/17,IND,NOP,1,38,7,17,0.412,6,14,0.429,1,3,0.333,3,6,0.5,1,11,12,1,0,4,2,3,18,12
Shabazz Muhammad,24-108,F-G,3/1/17,MIN,UTA,0,24,7,12,0.583,7,10,0.7,0,2,0,4,4,1,2,1,3,1,0,0,1,3,18,12.6
Marc Gasol,32-036,C,3/6/17,MEM,BRK,1,34,4,11,0.364,2,7,0.286,2,4,0.5,8,10,0.8,1,5,6,4,0,2,2,3,18,14.3
D'Angelo Russell,21-003,G,2/26/17,LAL,SAS,1,29,8,16,0.5,6,11,0.545,2,5,0.4,0,0,,2,3,5,3,0,0,3,1,18,11
Avery Bradley,26-135,G,4/10/17,BOS,BRK,1,33,7,10,0.7,4,5,0.8,3,5,0.6,1,1,1,2,3,5,2,0,0,0,4,18,15.9
Giannis Antetokounmpo,22-095,F-G,3/11/17,MIL,MIN,1,40,6,15,0.4,6,14,0.429,0,1,0,6,7,0.857,0,4,4,7,0,2,2,5,18,13
Shabazz Muhammad,24-076,F-G,1/28/17,MIN,BRK,0,28,6,11,0.545,4,8,0.5,2,3,0.667,4,4,1,5,2,7,1,0,1,0,3,18,17
Frank Kaminsky,23-363,F-C,4/2/17,CHO,OKC,0,26,5,9,0.556,2,4,0.5,3,5,0.6,5,6,0.833,1,1,2,0,1,1,1,1,18,14.6
Danilo Gallinari,28-100,F,11/16/16,DEN,PHO,1,38,4,13,0.308,3,9,0.333,1,4,0.25,9,9,1,1,4,5,2,1,1,1,2,18,13.7
Danilo Gallinari,28-210,F,3/6/17,DEN,SAC,1,31,5,7,0.714,2,3,0.667,3,4,0.75,5,5,1,0,7,7,2,0,0,0,1,18,18.2
Eric Bledsoe,27-084,G,3/3/17,PHO,OKC,1,29,4,15,0.267,4,12,0.333,0,3,0,10,13,0.769,0,3,3,5,4,1,2,1,18,14.6
Danilo Gallinari,28-217,F,3/13/17,DEN,LAL,1,29,5,10,0.5,2,4,0.5,3,6,0.5,5,5,1,1,2,3,5,0,1,0,1,18,18.1
Robin Lopez,28-339,C,3/6/17,CHI,DET,1,34,8,17,0.471,8,17,0.471,0,0,,2,2,1,0,4,4,1,1,1,0,3,18,11.7
Darren Collison,29-096,G,11/27/16,SAC,BRK,1,30,6,10,0.6,4,8,0.5,2,2,1,4,6,0.667,0,2,2,2,1,0,3,1,18,12.2
Troy Williams,21-332,F,11/26/16,MEM,MIA,1,35,6,12,0.5,4,7,0.571,2,5,0.4,4,6,0.667,0,3,3,2,0,0,1,3,18,11.3
Hassan Whiteside,27-233,C,2/1/17,MIA,ATL,1,30,8,13,0.615,8,13,0.615,0,0,,2,3,0.667,4,14,18,0,1,2,2,1,18,18.7
Gerald Green,31-076,G-F,4/12/17,BOS,MIL,0,21,6,15,0.4,4,7,0.571,2,8,0.25,4,4,1,1,5,6,1,0,0,1,2,18,11
DeMarcus Cousins,26-177,C-F,2/6/17,SAC,CHI,1,38,5,16,0.313,2,7,0.286,3,9,0.333,5,6,0.833,2,12,14,5,1,1,2,5,18,14.6
Shawn Long,24-054,C-F,3/24/17,PHI,CHI,0,19,8,10,0.8,8,10,0.8,0,0,,2,3,0.667,3,4,7,1,2,0,1,4,18,17.2
Vince Carter,39-278,G-F,10/30/16,MEM,WAS,0,32,5,6,0.833,0,0,,5,6,0.833,3,4,0.75,0,2,2,1,1,1,0,2,18,17.6
Dennis Schroder,23-061,G,11/15/16,ATL,MIA,1,33,7,15,0.467,5,13,0.385,2,2,1,2,2,1,1,0,1,4,1,0,5,1,18,9.4
Mike Conley,29-115,G,2/3/17,MEM,OKC,1,34,7,16,0.438,6,11,0.545,1,5,0.2,3,5,0.6,0,1,1,2,3,0,2,0,18,11.5
Elfrid Payton,22-253,G,11/1/16,ORL,PHI,1,38,8,17,0.471,7,14,0.5,1,3,0.333,1,3,0.333,0,3,3,10,2,1,2,0,18,17.1
Kemba Walker,26-272,G,2/4/17,CHO,UTA,1,35,6,17,0.353,3,9,0.333,3,8,0.375,3,3,1,1,1,2,6,0,0,2,1,18,11.3
Avery Bradley,26-002,G,11/28/16,BOS,MIA,1,39,8,16,0.5,6,14,0.429,2,2,1,0,0,,0,6,6,2,0,0,0,4,18,11.6
Avery Bradley,26-015,G,12/11/16,BOS,OKC,1,35,8,18,0.444,6,14,0.429,2,4,0.5,0,1,0,1,3,4,2,3,0,4,2,18,9.4
Markieff Morris,27-155,F,2/4/17,WAS,NOP,1,38,6,16,0.375,4,10,0.4,2,6,0.333,4,4,1,0,4,4,0,1,0,2,5,18,7.4
Malcolm Brogdon,24-061,G,2/10/17,MIL,LAL,0,27,8,11,0.727,7,8,0.875,1,3,0.333,1,1,1,0,2,2,3,1,0,4,3,18,12
E'Twaun Moore,27-332,G,1/25/17,NOP,OKC,0,28,6,9,0.667,4,6,0.667,2,3,0.667,4,4,1,3,5,8,2,1,1,0,2,18,20
Brandon Ingram,19-194,F,3/15/17,LAL,HOU,1,39,8,14,0.571,6,11,0.545,2,3,0.667,0,0,,1,5,6,3,1,0,4,2,18,11.9
Otto Porter,23-203,F,12/23/16,WAS,MIL,1,25,7,9,0.778,3,4,0.75,4,5,0.8,0,0,,2,3,5,0,0,0,0,3,18,15.6
Kemba Walker,26-223,G,12/17/16,CHO,ATL,1,34,5,14,0.357,1,5,0.2,4,9,0.444,4,4,1,1,5,6,10,0,0,1,1,18,18
Tim Hardaway,25-000,G,3/16/17,ATL,MEM,0,30,6,14,0.429,4,5,0.8,2,9,0.222,4,5,0.8,0,4,4,3,1,0,1,0,18,13.5
Zach Randolph,35-245,F,3/18/17,MEM,SAS,0,26,7,12,0.583,6,11,0.545,1,1,1,3,5,0.6,2,5,7,2,0,0,1,1,18,14.5
Spencer Hawes,28-252,C-F,1/5/17,CHO,DET,0,28,6,13,0.462,3,8,0.375,3,5,0.6,3,3,1,0,4,4,3,0,1,0,3,18,14.1
Wesley Matthews,30-040,G,11/23/16,DAL,LAC,1,30,6,10,0.6,3,7,0.429,3,3,1,3,3,1,0,4,4,2,0,1,5,2,18,10.9
Bradley Beal,23-209,G,1/23/17,WAS,CHO,1,32,6,16,0.375,2,7,0.286,4,9,0.444,2,3,0.667,2,3,5,4,1,0,4,3,18,9.7
Tobias Harris,24-179,F,1/10/17,DET,SAC,1,40,7,16,0.438,5,10,0.5,2,6,0.333,2,2,1,0,3,3,2,1,2,1,2,18,12.5
DeMar DeRozan,27-191,G,2/14/17,TOR,CHI,1,38,5,19,0.263,5,18,0.278,0,1,0,8,9,0.889,1,4,5,3,1,0,3,5,18,6.3
Zach Randolph,35-236,F,3/9/17,MEM,LAC,0,25,8,15,0.533,7,14,0.5,1,1,1,1,2,0.5,5,6,11,0,1,1,3,1,18,13.9
Lou Williams,30-164,G,4/9/17,HOU,SAC,0,31,5,14,0.357,4,6,0.667,1,8,0.125,7,7,1,0,4,4,2,0,1,3,1,18,10.1
John Wall,26-076,G,11/21/16,WAS,PHO,1,38,6,24,0.25,5,19,0.263,1,5,0.2,5,5,1,2,2,4,15,4,3,2,3,18,19
Nikola Mirotic,25-298,F,12/5/16,CHI,POR,0,27,4,8,0.5,1,4,0.25,3,4,0.75,7,8,0.875,0,7,7,0,2,2,2,3,18,15.9
Kawhi Leonard,25-169,F,12/15/16,SAS,PHO,1,27,6,12,0.5,5,9,0.556,1,3,0.333,5,5,1,2,8,10,4,2,0,1,0,18,19.6
Myles Turner,20-324,F-C,2/11/17,IND,MIL,1,31,4,12,0.333,4,9,0.444,0,3,0,10,11,0.909,1,3,4,6,0,1,2,4,18,13.7
Robert Covington,26-056,F,2/8/17,PHI,SAS,1,38,6,14,0.429,4,7,0.571,2,7,0.286,4,4,1,1,5,6,1,2,0,0,4,18,13.9
George Hill,30-179,G,10/30/16,UTA,LAC,1,32,8,13,0.615,6,9,0.667,2,4,0.5,0,0,,1,1,2,3,2,0,2,3,18,14
Andrew Wiggins,22-047,F-G,4/11/17,MIN,OKC,1,37,7,22,0.318,6,18,0.333,1,4,0.25,3,6,0.5,1,2,3,4,2,1,2,2,18,8.2
John Wall,26-145,G,1/29/17,WAS,NOP,1,37,8,19,0.421,8,16,0.5,0,3,0,2,4,0.5,0,1,1,19,2,1,3,2,18,19.6
Lavoy Allen,28-000,F-C,2/4/17,IND,DET,1,32,8,15,0.533,8,15,0.533,0,0,,2,2,1,5,6,11,3,2,1,2,1,18,18.4
Myles Turner,20-311,F-C,1/29/17,IND,HOU,1,36,6,13,0.462,6,13,0.462,0,0,,6,9,0.667,3,7,10,0,3,4,1,1,18,18.7
Wayne Ellington,29-080,G,1/17/17,MIA,HOU,0,28,6,11,0.545,1,2,0.5,5,9,0.556,1,1,1,0,4,4,1,1,0,0,2,18,14.8
John Wall,26-103,G,12/18/16,WAS,LAC,1,36,7,16,0.438,7,14,0.5,0,2,0,4,8,0.5,2,3,5,11,1,1,5,2,18,13.9
Karl-Anthony Towns,21-061,C-F,1/15/17,MIN,DAL,1,38,8,17,0.471,7,13,0.538,1,4,0.25,1,2,0.5,2,7,9,3,1,1,3,2,18,12.4
Evan Turner,28-156,G,4/1/17,POR,PHO,0,26,6,11,0.545,4,8,0.5,2,3,0.667,4,5,0.8,0,1,1,2,2,1,1,0,18,15.7
Myles Turner,21-017,F-C,4/10/17,IND,PHI,1,28,6,8,0.75,6,8,0.75,0,0,,6,6,1,3,10,13,1,3,3,4,4,18,20.1
Myles Turner,21-019,F-C,4/12/17,IND,ATL,1,33,7,14,0.5,7,13,0.538,0,1,0,4,4,1,3,5,8,2,0,6,1,2,18,18.4
Iman Shumpert,26-261,G,3/14/17,CLE,DET,1,36,8,13,0.615,6,10,0.6,2,3,0.667,0,0,,0,5,5,0,0,0,0,1,18,13.2
Emmanuel Mudiay,20-289,G,12/19/16,DEN,DAL,1,33,7,12,0.583,3,7,0.429,4,5,0.8,0,0,,0,5,5,7,0,0,1,2,18,17
Carmelo Anthony,32-181,F,11/26/16,NYK,CHO,1,34,7,25,0.28,5,18,0.278,2,7,0.286,2,2,1,1,7,8,2,0,0,2,2,18,4.7
Joe Ingles,29-136,F-G,2/15/17,UTA,POR,1,32,7,9,0.778,3,3,1,4,6,0.667,0,0,,0,4,4,3,4,1,2,1,18,20.1
Nikola Jokic,21-319,C-F,1/3/17,DEN,SAC,1,28,7,11,0.636,6,9,0.667,1,2,0.5,3,3,1,1,5,6,5,1,1,1,3,18,18.3
Ty Lawson,29-092,G,2/3/17,SAC,PHO,0,28,7,10,0.7,7,9,0.778,0,1,0,4,4,1,2,3,5,3,2,0,2,2,18,17.4
Jodie Meeks,29-107,G,12/6/16,ORL,WAS,0,16,5,7,0.714,1,2,0.5,4,5,0.8,4,4,1,0,2,2,1,0,0,0,1,18,16
Blake Griffin,28-023,F,4/8/17,LAC,SAS,1,36,7,19,0.368,7,15,0.467,0,4,0,4,4,1,1,7,8,1,0,1,2,3,18,8.5
Jamal Murray,19-346,G,2/3/17,DEN,MIL,0,21,5,9,0.556,4,7,0.571,1,2,0.5,7,7,1,1,2,3,1,1,0,3,0,18,13.7
Buddy Hield,23-092,G,3/19/17,SAC,SAS,1,32,8,14,0.571,6,11,0.545,2,3,0.667,0,0,,0,5,5,5,1,0,0,0,18,17.4
Kyle Lowry,30-262,G,12/12/16,TOR,MIL,1,34,5,9,0.556,1,2,0.5,4,7,0.571,4,4,1,0,3,3,7,1,0,5,3,18,14.3
Maurice Harkless,23-297,F-G,3/4/17,POR,BRK,1,30,6,7,0.857,4,5,0.8,2,2,1,4,5,0.8,1,1,2,3,2,4,0,2,18,22.2
Julius Randle,22-030,F,12/29/16,LAL,DAL,1,28,5,10,0.5,5,9,0.556,0,1,0,8,10,0.8,1,3,4,3,0,0,4,3,18,10.7
Sean Kilpatrick,26-296,G,10/28/16,BRK,IND,0,25,7,11,0.636,3,7,0.429,4,4,1,0,0,,1,4,5,1,1,0,2,1,18,14.3
Trevor Ariza,31-150,F,11/27/16,HOU,POR,1,33,6,7,0.857,2,2,1,4,5,0.8,2,4,0.5,0,2,2,3,2,0,0,3,18,18.2
Kemba Walker,26-244,G,1/7/17,CHO,SAS,1,31,6,13,0.462,4,9,0.444,2,4,0.5,4,5,0.8,0,2,2,3,1,0,4,2,18,9.8
Jae Crowder,26-212,F,2/3/17,BOS,LAL,1,34,6,12,0.5,4,5,0.8,2,7,0.286,4,4,1,0,6,6,1,2,0,1,2,18,14.7
Lou Williams,30-006,G,11/2/16,LAL,ATL,0,23,6,11,0.545,4,6,0.667,2,5,0.4,4,4,1,0,3,3,4,2,0,1,2,18,16.6
Buddy Hield,22-321,G,11/2/16,NOP,MEM,0,31,6,15,0.4,2,6,0.333,4,9,0.444,2,2,1,0,4,4,1,2,1,2,4,18,10.9
LaMarcus Aldridge,31-139,F-C,12/5/16,SAS,MIL,1,36,7,14,0.5,6,13,0.462,1,1,1,3,4,0.75,3,6,9,5,1,1,0,3,18,18.5
Otto Porter,23-273,F,3/3/17,WAS,TOR,1,36,4,10,0.4,2,5,0.4,2,5,0.4,8,9,0.889,3,5,8,3,3,1,1,0,18,20.6
Marco Belinelli,30-304,G-F,1/23/17,CHO,WAS,0,29,5,12,0.417,3,4,0.75,2,8,0.25,6,7,0.857,0,3,3,2,1,0,0,1,18,14.1
Terrence Ross,26-047,F-G,3/24/17,ORL,DET,1,21,6,9,0.667,1,3,0.333,5,6,0.833,1,1,1,0,4,4,2,1,1,0,4,18,16.8
Jonathon Simmons,27-143,G-F,2/4/17,SAS,DEN,0,22,7,10,0.7,6,9,0.667,1,1,1,3,4,0.75,0,4,4,2,0,1,2,2,18,13.9
Austin Rivers,24-232,G,3/21/17,LAC,LAL,0,31,6,11,0.545,5,7,0.714,1,4,0.25,5,6,0.833,0,4,4,4,0,0,1,2,18,14.5
Draymond Green,26-282,F,12/11/16,GSW,MIN,1,35,6,9,0.667,1,1,1,5,8,0.625,1,2,0.5,0,5,5,4,1,1,2,4,18,16.1
Victor Oladipo,24-264,G,1/23/17,OKC,UTA,1,30,8,11,0.727,7,10,0.7,1,1,1,1,2,0.5,1,3,4,1,2,0,0,5,18,15.4
Carmelo Anthony,32-225,F,1/9/17,NYK,NOP,1,26,7,15,0.467,5,12,0.417,2,3,0.667,2,3,0.667,0,6,6,1,0,0,1,1,18,11
Evan Fournier,24-127,G-F,3/5/17,ORL,WAS,1,34,7,16,0.438,4,7,0.571,3,9,0.333,1,1,1,1,1,2,2,0,0,2,1,18,9.6
Kristaps Porzingis,21-213,F-C,3/3/17,NYK,PHI,1,31,6,12,0.5,6,10,0.6,0,2,0,6,6,1,0,8,8,1,1,0,0,5,18,14.1
DeAndre Jordan,28-114,C,11/12/16,LAC,MIN,1,34,4,6,0.667,4,6,0.667,0,0,,10,16,0.625,4,12,16,1,2,2,1,3,18,21.3
Eric Bledsoe,27-046,G,1/24/17,PHO,MIN,1,29,5,18,0.278,4,13,0.308,1,5,0.2,7,7,1,0,1,1,7,1,0,5,4,18,7
Dwight Howard,30-348,C,11/20/16,ATL,NYK,1,29,6,11,0.545,6,11,0.545,0,0,,6,12,0.5,8,10,18,0,0,3,1,3,18,18.8
Pau Gasol,36-238,F-C,3/1/17,SAS,IND,0,21,4,7,0.571,2,3,0.667,2,4,0.5,8,8,1,0,4,4,2,0,2,3,1,18,15.3
Otto Porter,23-185,F,12/5/16,WAS,BRK,1,36,7,9,0.778,3,4,0.75,4,5,0.8,0,0,,0,4,4,2,3,0,1,6,18,16.7
Jordan Clarkson,24-152,G,11/6/16,LAL,PHO,0,30,8,16,0.5,7,14,0.5,1,2,0.5,1,2,0.5,2,4,6,1,0,0,3,5,18,7.9
Danilo Gallinari,28-096,F,11/12/16,DEN,DET,1,36,5,10,0.5,3,6,0.5,2,4,0.5,6,8,0.75,0,4,4,1,0,0,1,1,18,12.7
Maurice Harkless,23-179,F-G,11/6/16,POR,MEM,1,34,8,15,0.533,6,10,0.6,2,5,0.4,0,0,,2,5,7,0,1,2,2,4,18,12.4
Evan Turner,28-094,G,1/29/17,POR,GSW,1,33,8,17,0.471,6,10,0.6,2,7,0.286,0,0,,0,4,4,6,1,0,2,3,18,12.5
Arron Afflalo,31-017,G,11/1/16,SAC,MIA,1,41,7,17,0.412,6,12,0.5,1,5,0.2,3,3,1,0,3,3,0,1,0,2,4,18,7.2
Aaron Gordon,21-112,F,1/6/17,ORL,HOU,1,36,7,14,0.5,5,8,0.625,2,6,0.333,2,3,0.667,3,3,6,7,1,0,2,2,18,16.7
Serge Ibaka,27-161,F-C,2/26/17,TOR,POR,1,34,8,15,0.533,6,10,0.6,2,5,0.4,0,0,,2,8,10,2,2,1,1,3,18,16.4
Zach Randolph,35-126,F,11/19/16,MEM,MIN,0,21,7,11,0.636,6,9,0.667,1,2,0.5,3,4,0.75,1,6,7,0,0,0,0,2,18,14.4
Lou Williams,30-050,G,12/16/16,LAL,PHI,0,23,5,12,0.417,4,6,0.667,1,6,0.167,7,8,0.875,0,0,0,3,4,0,1,0,18,16.3
Marquese Chriss,19-185,F,1/3/17,PHO,MIA,1,31,7,11,0.636,5,6,0.833,2,5,0.4,2,2,1,1,5,6,2,2,0,1,4,18,16.1
Dirk Nowitzki,38-239,F,2/13/17,DAL,BOS,1,29,7,17,0.412,6,12,0.5,1,5,0.2,3,3,1,0,5,5,3,2,0,1,0,18,13.5
Carmelo Anthony,32-243,F,1/27/17,NYK,CHO,1,35,8,26,0.308,7,19,0.368,1,7,0.143,1,3,0.333,0,11,11,0,0,1,0,0,18,6.2
Trevor Booker,29-051,F,1/15/17,BRK,HOU,1,26,8,15,0.533,7,11,0.636,1,4,0.25,1,2,0.5,1,4,5,2,3,0,3,0,18,13.6
Patty Mills,28-166,G,1/24/17,SAS,TOR,0,30,8,15,0.533,6,10,0.6,2,5,0.4,0,1,0,0,0,0,3,3,0,1,2,18,13.6
Brandon Ingram,19-198,F,3/19/17,LAL,CLE,1,40,8,15,0.533,8,13,0.615,0,2,0,2,2,1,0,6,6,1,0,0,1,3,18,11
Willie Cauley-Stein,23-207,F-C,3/13/17,SAC,ORL,1,36,9,16,0.563,9,16,0.563,0,0,,0,0,,0,8,8,1,0,0,1,0,18,12.5
Marc Gasol,32-001,C,1/30/17,MEM,PHO,1,29,6,12,0.5,4,8,0.5,2,4,0.5,4,4,1,1,5,6,3,1,2,4,3,18,13.5
Kelly Oubre,21-038,F,1/16/17,WAS,POR,0,28,5,8,0.625,2,4,0.5,3,4,0.75,5,5,1,3,1,4,2,0,1,2,3,18,15.7
Rudy Gay,30-103,F,11/28/16,SAC,WAS,1,38,7,16,0.438,6,12,0.5,1,4,0.25,3,3,1,2,3,5,2,2,1,6,5,18,8
Wilson Chandler,29-256,F,1/21/17,DEN,LAC,0,23,8,12,0.667,6,10,0.6,2,2,1,0,0,,2,5,7,1,0,0,2,1,18,14
Paul Millsap,32-019,F,3/1/17,ATL,DAL,1,38,6,12,0.5,6,11,0.545,0,1,0,6,8,0.75,1,7,8,10,0,1,6,3,18,14.5
Chris Paul,31-250,G,1/11/17,LAC,ORL,1,33,6,13,0.462,5,8,0.625,1,5,0.2,5,6,0.833,0,7,7,6,4,0,5,3,18,15
Alex Abrines,23-142,G-F,12/21/16,OKC,NOP,0,30,6,12,0.5,1,1,1,5,11,0.455,1,2,0.5,0,3,3,1,1,0,2,2,18,11.4
Dirk Nowitzki,38-259,F,3/5/17,DAL,OKC,1,30,8,17,0.471,7,13,0.538,1,4,0.25,1,1,1,0,13,13,3,0,0,1,4,18,12.7
Ricky Rubio,26-068,G,12/28/16,MIN,DEN,1,34,5,14,0.357,4,7,0.571,1,7,0.143,7,7,1,2,6,8,7,4,0,4,2,18,17.5
Dwyane Wade,35-024,G,2/10/17,CHI,PHO,1,28,7,16,0.438,6,13,0.462,1,3,0.333,3,3,1,1,5,6,3,0,2,1,0,18,14.3
Eric Gordon,28-044,G,2/7/17,HOU,ORL,0,30,5,10,0.5,1,2,0.5,4,8,0.5,4,5,0.8,0,3,3,2,0,1,2,1,18,13.2
Kyrie Irving,24-313,G,1/30/17,CLE,DAL,1,33,7,21,0.333,6,13,0.462,1,8,0.125,3,3,1,1,4,5,5,2,0,6,3,18,6.3
Jon Leuer,27-221,F,12/21/16,DET,MEM,0,30,6,13,0.462,5,9,0.556,1,4,0.25,5,5,1,0,5,5,1,0,1,1,2,18,12.4
John Wall,26-122,G,1/6/17,WAS,MIN,1,40,8,16,0.5,8,15,0.533,0,1,0,2,2,1,0,1,1,18,2,0,3,2,18,21.1
Serge Ibaka,27-173,F-C,3/10/17,TOR,ATL,1,30,6,12,0.5,4,7,0.571,2,5,0.4,4,4,1,2,1,3,2,0,1,4,6,18,9.4
Trevor Ariza,31-148,F,11/25/16,HOU,SAC,1,35,6,11,0.545,0,0,,6,11,0.545,0,0,,0,10,10,3,2,0,3,1,18,16.4
Joe Johnson,35-220,G-F,2/4/17,UTA,CHO,0,30,7,12,0.583,3,5,0.6,4,7,0.571,0,0,,2,4,6,4,0,0,2,0,18,15.8
Josh Richardson,23-063,G,11/17/16,MIA,MIL,1,32,7,19,0.368,3,8,0.375,4,11,0.364,0,0,,1,2,3,1,0,0,1,3,18,7.3
Nicolas Batum,28-071,F-G,2/23/17,CHO,DET,1,40,6,17,0.353,5,10,0.5,1,7,0.143,5,5,1,1,5,6,3,0,1,2,1,18,11.1
Jordan Clarkson,24-199,G,12/23/16,LAL,ORL,0,27,7,14,0.5,3,6,0.5,4,8,0.5,0,0,,1,4,5,2,0,0,5,1,18,8.9
Brandon Jennings,27-182,G,3/24/17,WAS,BRK,0,21,6,10,0.6,2,4,0.5,4,6,0.667,2,2,1,2,1,3,9,0,0,0,1,18,21
Damian Lillard,26-125,G,11/17/16,POR,HOU,1,34,7,17,0.412,6,12,0.5,1,5,0.2,3,5,0.6,1,4,5,5,0,1,3,1,18,10.8
Marc Gasol,31-271,C,10/26/16,MEM,MIN,1,32,7,17,0.412,6,14,0.429,1,3,0.333,3,4,0.75,1,2,3,2,0,4,4,2,18,9.2
Rodney Hood,24-082,G-F,1/10/17,UTA,CLE,1,35,7,15,0.467,3,5,0.6,4,10,0.4,0,0,,1,4,5,3,2,0,3,4,18,11.7
Tobias Harris,24-140,F,12/2/16,DET,ATL,1,32,8,13,0.615,6,10,0.6,2,3,0.667,0,0,,1,6,7,2,0,2,2,0,18,15.4
Patrick Beverley,28-195,G,1/23/17,HOU,MIL,1,33,7,10,0.7,3,3,1,4,7,0.571,0,0,,0,0,0,3,1,0,0,3,18,15.7
Ersan Ilyasova,29-317,F,3/28/17,ATL,PHO,1,33,6,15,0.4,4,8,0.5,2,7,0.286,4,6,0.667,3,9,12,1,1,0,2,4,18,12
Cody Zeller,24-070,F-C,12/14/16,CHO,WAS,1,30,6,7,0.857,6,7,0.857,0,0,,6,8,0.75,1,1,2,1,0,1,3,5,18,12.1
C.J. Watson,32-288,G,1/30/17,ORL,MIN,1,34,6,10,0.6,5,7,0.714,1,3,0.333,5,5,1,1,3,4,2,2,0,1,2,18,16.6
Marreese Speights,29-149,C-F,12/31/16,LAC,OKC,0,25,5,9,0.556,1,3,0.333,4,6,0.667,4,4,1,0,5,5,0,0,0,3,4,18,10.6
Karl-Anthony Towns,21-053,C-F,1/7/17,MIN,UTA,1,41,5,13,0.385,4,11,0.364,1,2,0.5,7,8,0.875,6,9,15,1,0,0,2,4,18,14.5
Serge Ibaka,27-072,F-C,11/29/16,ORL,SAS,1,34,7,11,0.636,5,7,0.714,2,4,0.5,2,2,1,1,6,7,2,2,1,0,2,18,18.9
Ben McLemore,24-014,G,2/25/17,SAC,CHO,1,33,7,15,0.467,4,8,0.5,3,7,0.429,1,1,1,0,2,2,0,1,0,1,4,18,9.3
Paul George,26-227,F,12/15/16,IND,NOP,1,36,6,13,0.462,4,10,0.4,2,3,0.667,4,4,1,1,3,4,4,2,0,5,5,18,10.7
Allen Crabbe,24-270,G-F,1/4/17,POR,GSW,1,36,4,11,0.364,2,7,0.286,2,4,0.5,8,8,1,0,3,3,5,0,0,1,2,18,14.5
Bradley Beal,23-160,G,12/5/16,WAS,BRK,1,36,7,18,0.389,4,10,0.4,3,8,0.375,1,4,0.25,1,3,4,4,3,0,1,3,18,12.2
Steven Adams,23-168,C,1/4/17,OKC,CHO,1,36,8,10,0.8,8,10,0.8,0,0,,2,2,1,4,8,12,3,1,1,2,5,18,19.2
Victor Oladipo,24-189,G,11/9/16,OKC,TOR,1,36,6,16,0.375,1,7,0.143,5,9,0.556,1,1,1,3,5,8,2,2,0,1,2,18,14.4
Kenneth Faried,27-132,F,3/31/17,DEN,CHO,1,32,9,17,0.529,9,17,0.529,0,0,,0,1,0,3,10,13,2,1,1,2,2,18,14.7
James Johnson,29-343,F,1/28/17,MIA,DET,0,32,7,13,0.538,7,12,0.583,0,1,0,4,4,1,0,8,8,5,2,1,0,1,18,19.9
Paul George,26-321,F,3/19/17,IND,TOR,1,31,7,14,0.5,6,10,0.6,1,4,0.25,3,5,0.6,1,3,4,2,1,0,3,5,18,9.2
James Harden,27-106,G,12/10/16,HOU,DAL,1,40,4,12,0.333,2,4,0.5,2,8,0.25,8,10,0.8,0,9,9,16,2,0,4,1,18,21.9
Sean Kilpatrick,26-357,G,12/28/16,BRK,CHI,1,34,6,14,0.429,2,5,0.4,4,9,0.444,2,2,1,0,3,3,6,1,0,2,2,18,13.9
Malcolm Brogdon,24-097,G,3/18/17,MIL,GSW,1,41,6,13,0.462,4,7,0.571,2,6,0.333,4,4,1,1,3,4,3,1,1,0,2,18,15.9
Danilo Gallinari,28-144,F,12/30/16,DEN,PHI,1,29,4,11,0.364,3,6,0.5,1,5,0.2,9,9,1,1,4,5,2,0,0,1,5,18,12.2
Victor Oladipo,24-191,G,11/11/16,OKC,LAC,1,38,6,19,0.316,2,11,0.182,4,8,0.5,2,3,0.667,1,1,2,1,0,0,3,3,18,4.2
Evan Fournier,24-023,G-F,11/21/16,ORL,MIL,1,37,6,13,0.462,4,8,0.5,2,5,0.4,4,4,1,0,5,5,2,0,0,5,1,18,8.8
Blake Griffin,28-025,F,4/10/17,LAC,HOU,1,27,6,11,0.545,6,11,0.545,0,0,,6,6,1,2,6,8,2,0,0,3,3,18,13.1
Maurice Harkless,23-200,F-G,11/27/16,POR,HOU,1,38,7,12,0.583,5,8,0.625,2,4,0.5,2,2,1,1,2,3,0,2,1,0,5,18,14.4
Draymond Green,26-235,F,10/25/16,GSW,SAS,1,33,7,14,0.5,5,9,0.556,2,5,0.4,2,2,1,5,7,12,6,5,1,2,2,18,23.7
Dario Saric,22-311,F,2/13/17,PHI,CHO,0,31,8,17,0.471,6,10,0.6,2,7,0.286,0,0,,2,9,11,3,0,1,3,1,18,12.8
Taj Gibson,31-194,F,1/4/17,CHI,CLE,1,34,9,10,0.9,9,10,0.9,0,0,,0,0,,2,5,7,2,1,0,3,1,18,16.5
Thabo Sefolosha,32-268,G-F,1/25/17,ATL,CHI,1,33,6,8,0.75,3,4,0.75,3,4,0.75,3,4,0.75,1,2,3,0,1,0,1,0,18,15.7
Ersan Ilyasova,29-248,F,1/18/17,PHI,TOR,1,24,7,14,0.5,4,8,0.5,3,6,0.5,1,2,0.5,1,3,4,2,0,0,0,1,18,13.2
Eric Gordon,27-308,G,10/28/16,HOU,DAL,1,33,4,9,0.444,1,3,0.333,3,6,0.5,7,8,0.875,0,4,4,6,0,0,2,2,18,15.5
Jordan Clarkson,24-281,G,3/15/17,LAL,HOU,1,39,7,19,0.368,6,13,0.462,1,6,0.167,3,4,0.75,0,2,2,3,2,0,3,1,18,8.4
Paul George,26-205,F,11/23/16,IND,ATL,1,38,6,22,0.273,4,11,0.364,2,11,0.182,4,4,1,1,5,6,3,3,0,3,2,18,8.5
Kevin Love,28-205,F,3/31/17,CLE,PHI,1,30,6,14,0.429,4,9,0.444,2,5,0.4,4,5,0.8,1,9,10,3,3,0,3,2,18,14.9
Jerryd Bayless,28-095,G,11/23/16,PHI,MEM,0,30,6,15,0.4,5,13,0.385,1,2,0.5,5,6,0.833,1,5,6,6,0,0,5,3,18,9.7
Buddy Hield,23-083,G,3/10/17,SAC,WAS,1,37,7,16,0.438,3,8,0.375,4,8,0.5,0,0,,2,2,4,1,0,0,2,4,18,8.7
Larry Nance Jr.,23-324,F,11/20/16,LAL,CHI,0,26,8,11,0.727,8,11,0.727,0,0,,2,2,1,2,4,6,3,1,1,0,0,18,19.9
Andre Drummond,23-221,C,3/19/17,DET,PHO,1,28,7,10,0.7,7,10,0.7,0,0,,4,11,0.364,4,14,18,2,0,2,3,3,18,16.6
Chris Paul,31-201,G,11/23/16,LAC,DAL,1,26,6,10,0.6,4,6,0.667,2,4,0.5,4,4,1,1,2,3,4,4,0,0,1,18,21.1
Brandon Jennings,27-128,G,1/29/17,NYK,ATL,1,53,5,15,0.333,1,7,0.143,4,8,0.5,4,6,0.667,0,3,3,11,1,0,1,5,18,15.3
Eric Gordon,28-085,G,3/20/17,HOU,DEN,0,32,5,9,0.556,1,2,0.5,4,7,0.571,4,4,1,0,1,1,3,0,1,3,2,18,13
C.J. McCollum,25-164,G,3/2/17,POR,OKC,1,34,5,14,0.357,3,10,0.3,2,4,0.5,6,6,1,0,6,6,4,0,0,2,2,18,12
Victor Oladipo,24-243,G,1/2/17,OKC,MIL,1,35,7,12,0.583,3,5,0.6,4,7,0.571,0,0,,1,4,5,4,1,0,2,4,18,14.5
Ersan Ilyasova,29-202,F,12/3/16,PHI,BOS,1,30,6,14,0.429,3,7,0.429,3,7,0.429,3,3,1,0,6,6,2,0,0,1,2,18,12
Patrick Beverley,28-162,G,12/21/16,HOU,PHO,1,33,7,11,0.636,5,8,0.625,2,3,0.667,2,2,1,2,7,9,9,0,1,2,3,18,20.4
Will Barton,26-040,G,2/15/17,DEN,MIN,0,38,7,15,0.467,7,11,0.636,0,4,0,4,5,0.8,2,7,9,2,0,1,0,1,18,15.1
Kemba Walker,26-332,G,4/5/17,CHO,MIA,1,34,6,17,0.353,3,9,0.333,3,8,0.375,3,5,0.6,0,2,2,5,0,0,3,3,18,7.6
Allen Crabbe,24-199,G-F,10/25/16,POR,UTA,0,29,6,10,0.6,2,5,0.4,4,5,0.8,2,2,1,0,3,3,3,0,0,2,2,18,13.6
Kent Bazemore,27-248,G-F,3/6/17,ATL,GSW,1,29,6,15,0.4,4,10,0.4,2,5,0.4,4,6,0.667,0,1,1,0,0,1,3,5,18,5.1
Timothe Luwawu-Cabarrot,21-307,F,3/12/17,PHI,LAL,1,27,7,11,0.636,5,7,0.714,2,4,0.5,2,2,1,0,3,3,3,0,0,1,4,18,13.5
J.J. Redick,32-141,G,11/12/16,LAC,MIN,1,29,7,13,0.538,5,6,0.833,2,7,0.286,2,2,1,0,1,1,3,1,0,2,0,18,13.1
Kristaps Porzingis,21-091,F-C,11/1/16,NYK,DET,1,30,7,18,0.389,5,11,0.455,2,7,0.286,2,2,1,2,4,6,1,0,1,0,2,18,11.4
Joe Johnson,35-155,G-F,12/1/16,UTA,MIA,1,33,6,9,0.667,2,3,0.667,4,6,0.667,2,2,1,0,3,3,4,1,0,2,3,18,15.6
Jeremy Lin,28-199,G,3/10/17,BRK,DAL,1,27,4,9,0.444,3,6,0.5,1,3,0.333,9,10,0.9,1,4,5,3,2,0,2,3,18,15.7
Rudy Gay,30-142,F,1/6/17,SAC,LAC,1,33,7,17,0.412,6,11,0.545,1,6,0.167,3,3,1,1,6,7,1,0,0,0,0,18,12.1
D'Angelo Russell,21-026,G,3/21/17,LAL,LAC,1,36,7,15,0.467,4,8,0.5,3,7,0.429,1,2,0.5,0,2,2,5,3,0,1,3,18,14.8
Wesley Matthews,30-097,G,1/19/17,DAL,MIA,1,37,7,14,0.5,3,5,0.6,4,9,0.444,0,0,,0,5,5,1,0,1,0,1,18,13.5
Jae Crowder,26-268,F,3/31/17,BOS,ORL,1,34,6,11,0.545,4,5,0.8,2,6,0.333,4,6,0.667,0,5,5,0,2,0,0,1,18,15
Jusuf Nurkic,22-072,C,11/3/16,DEN,MIN,1,27,7,13,0.538,7,13,0.538,0,0,,4,7,0.571,2,3,5,1,2,1,1,4,18,13.6
Austin Rivers,24-194,G,2/11/17,LAC,CHO,1,38,7,12,0.583,3,6,0.5,4,6,0.667,0,2,0,0,3,3,5,0,0,5,3,18,9.8
Nikola Jokic,21-338,C-F,1/22/17,DEN,MIN,1,27,8,15,0.533,8,12,0.667,0,3,0,2,2,1,5,4,9,4,2,2,4,5,18,15.6
Emmanuel Mudiay,20-317,G,1/16/17,DEN,ORL,1,37,6,12,0.5,4,8,0.5,2,4,0.5,4,4,1,0,2,2,13,2,1,4,4,18,18.8
Sean Kilpatrick,27-006,G,1/12/17,BRK,NOP,0,27,6,12,0.5,3,6,0.5,3,6,0.5,3,3,1,0,7,7,1,1,0,4,2,18,11
Jamal Murray,19-271,G,11/20/16,DEN,UTA,0,23,6,8,0.75,3,4,0.75,3,4,0.75,3,4,0.75,1,1,2,4,0,1,0,2,18,18.1
Brandon Ingram,19-211,F,4/1/17,LAL,LAC,1,24,7,14,0.5,6,13,0.462,1,1,1,3,6,0.5,2,3,5,3,1,1,1,5,18,12.9
Blake Griffin,27-364,F,3/15/17,LAC,MIL,1,37,6,12,0.5,5,8,0.625,1,4,0.25,5,8,0.625,2,5,7,4,0,0,1,0,18,15.5
Brandon Knight,24-334,G,10/31/16,PHO,LAC,1,31,6,13,0.462,4,9,0.444,2,4,0.5,4,4,1,0,0,0,0,0,0,2,2,18,8.5
Marcus Morris,27-088,F,11/29/16,DET,CHO,1,36,8,18,0.444,6,12,0.5,2,6,0.333,0,0,,0,4,4,0,1,0,1,3,18,8.6
David Lee,33-306,F,3/1/17,SAS,IND,0,21,8,8,1,8,8,1,0,0,,2,2,1,2,3,5,0,0,1,0,1,18,18.2
LaMarcus Aldridge,31-228,F-C,3/4/17,SAS,MIN,1,44,8,24,0.333,8,24,0.333,0,0,,2,3,0.667,4,6,10,2,1,2,2,2,18,9.6
Kosta Koufos,27-314,C,1/3/17,SAC,DEN,1,29,8,9,0.889,8,9,0.889,0,0,,2,3,0.667,1,4,5,1,2,0,1,3,18,16.9
Dennis Schroder,23-171,G,3/5/17,ATL,IND,1,36,7,16,0.438,5,11,0.455,2,5,0.4,2,2,1,0,1,1,7,3,0,1,5,18,14.8
Tyler Johnson,24-248,G,1/10/17,MIA,GSW,0,30,6,11,0.545,3,3,1,3,8,0.375,3,4,0.75,1,6,7,3,0,0,0,3,18,15.7
LaMarcus Aldridge,31-267,F-C,4/12/17,SAS,UTA,1,34,9,14,0.643,9,13,0.692,0,1,0,0,0,,2,3,5,0,3,1,1,1,18,16.4
C.J. McCollum,25-199,G,4/6/17,POR,MIN,1,35,8,19,0.421,6,15,0.4,2,4,0.5,0,0,,1,1,2,5,1,0,2,2,18,10.6
Nicolas Batum,27-333,F-G,11/11/16,CHO,TOR,1,39,7,15,0.467,4,9,0.444,3,6,0.5,1,2,0.5,4,6,10,6,0,1,6,4,18,11.8
Kevin Durant,28-042,F-G,11/10/16,GSW,DEN,1,30,8,16,0.5,8,13,0.615,0,3,0,2,2,1,2,7,9,5,1,2,1,2,18,17.6
Zach Randolph,35-123,F,11/16/16,MEM,LAC,0,26,7,13,0.538,7,13,0.538,0,0,,4,4,1,2,5,7,1,0,0,1,0,18,14.3
Paul Millsap,31-287,F,11/23/16,ATL,IND,1,36,8,18,0.444,8,14,0.571,0,4,0,2,2,1,4,7,11,5,4,3,3,2,18,19.3
Jeff Green,30-069,F,11/5/16,ORL,WAS,0,27,5,12,0.417,3,7,0.429,2,5,0.4,6,7,0.857,1,4,5,3,0,1,1,1,18,14.5
Rudy Gobert,24-188,C,12/31/16,UTA,PHO,1,37,7,8,0.875,7,8,0.875,0,0,,4,5,0.8,2,11,13,0,0,3,2,1,18,19.2
Ryan Anderson,28-295,F,2/25/17,HOU,MIN,1,24,5,15,0.333,1,2,0.5,4,13,0.308,4,5,0.8,1,1,2,3,0,0,1,1,18,10.8
Jeremy Lin,28-195,G,3/6/17,BRK,MEM,1,24,5,10,0.5,2,3,0.667,3,7,0.429,5,6,0.833,0,4,4,1,0,0,2,5,18,10.5
James Johnson,30-037,F,3/29/17,MIA,NYK,0,27,6,11,0.545,4,9,0.444,2,2,1,4,6,0.667,1,6,7,4,3,2,3,4,18,17
Otto Porter,23-255,F,2/13/17,WAS,OKC,1,34,6,11,0.545,4,7,0.571,2,4,0.5,4,4,1,1,11,12,0,0,2,0,4,18,16.5
Danilo Gallinari,28-157,F,1/12/17,DEN,IND,1,30,7,11,0.636,3,5,0.6,4,6,0.667,0,0,,0,2,2,3,0,0,1,1,18,14.4
Victor Oladipo,24-206,G,11/26/16,OKC,DET,1,33,6,10,0.6,3,5,0.6,3,5,0.6,3,6,0.5,1,5,6,2,1,0,0,2,18,16
Jonas Valanciunas,24-273,C,2/3/17,TOR,ORL,1,35,7,17,0.412,7,17,0.412,0,0,,4,6,0.667,2,9,11,1,1,1,0,1,18,14.2
Jrue Holiday,26-207,G,1/5/17,NOP,ATL,1,35,5,13,0.385,1,7,0.143,4,6,0.667,4,4,1,0,2,2,5,1,0,4,2,18,11.2
Otto Porter,23-281,F,3/11/17,WAS,POR,1,40,8,14,0.571,6,9,0.667,2,5,0.4,0,1,0,2,8,10,4,2,0,0,5,18,17.6
Tony Parker,34-267,G,2/8/17,SAS,PHI,1,30,7,12,0.583,6,11,0.545,1,1,1,3,3,1,0,1,1,5,0,0,0,2,18,15.4
Gordon Hayward,26-283,F-G,12/31/16,UTA,PHO,1,35,7,13,0.538,7,11,0.636,0,2,0,4,5,0.8,1,8,9,4,2,0,0,1,18,18.8
Raymond Felton,32-220,G,2/1/17,LAC,PHO,1,30,7,14,0.5,5,11,0.455,2,3,0.667,2,2,1,1,4,5,1,1,0,2,4,18,11
Timothe Luwawu-Cabarrot,21-332,F,4/6/17,PHI,CHI,1,34,6,15,0.4,5,8,0.625,1,7,0.143,5,5,1,1,2,3,3,2,0,1,4,18,12.7
Leandro Barbosa,34-013,G,12/11/16,PHO,NOP,0,33,8,14,0.571,6,9,0.667,2,5,0.4,0,0,,0,3,3,0,0,0,3,4,18,7.7
JaMychal Green,26-193,F,12/31/16,MEM,SAC,1,38,7,9,0.778,3,4,0.75,4,5,0.8,0,0,,3,4,7,4,1,0,0,3,18,20.4
Jae Crowder,26-158,F,12/11/16,BOS,OKC,1,27,7,9,0.778,4,5,0.8,3,4,0.75,1,1,1,0,2,2,3,1,1,3,6,18,13.5
Jeremy Lamb,24-180,G-F,11/26/16,CHO,NYK,1,36,8,15,0.533,7,12,0.583,1,3,0.333,1,2,0.5,2,15,17,2,1,0,1,0,18,17.6
Tony Parker,34-227,G,12/30/16,SAS,POR,1,22,7,15,0.467,6,14,0.429,1,1,1,3,5,0.6,0,2,2,5,0,0,0,0,18,13.6
Brook Lopez,28-341,C,3/8/17,BRK,ATL,1,29,7,18,0.389,5,13,0.385,2,5,0.4,2,2,1,2,4,6,3,1,5,5,3,18,11.2
Trevor Booker,29-082,F,2/15/17,BRK,MIL,0,28,7,8,0.875,7,7,1,0,1,0,4,4,1,0,5,5,3,1,0,3,2,18,16
LaMarcus Aldridge,31-243,F-C,3/19/17,SAS,SAC,1,22,8,13,0.615,6,11,0.545,2,2,1,0,0,,5,3,8,0,1,1,0,0,18,18.2
Isaiah Thomas,28-024,G,3/3/17,BOS,LAL,1,26,6,13,0.462,5,8,0.625,1,5,0.2,5,5,1,0,2,2,8,0,0,2,1,18,15.1
Tristan Thompson,25-325,F-C,2/1/17,CLE,MIN,1,39,7,11,0.636,7,11,0.636,0,0,,4,5,0.8,8,6,14,1,1,2,1,2,18,21.4
Devin Booker,19-362,G,10/26/16,PHO,SAC,1,25,8,12,0.667,8,9,0.889,0,3,0,2,5,0.4,0,2,2,3,0,0,4,5,18,8.3
Ersan Ilyasova,29-290,F,3/1/17,ATL,DAL,0,26,6,7,0.857,2,3,0.667,4,4,1,2,2,1,0,1,1,0,2,0,0,5,18,15.8
Dirk Nowitzki,38-207,F,1/12/17,DAL,PHO,1,30,7,15,0.467,4,10,0.4,3,5,0.6,1,1,1,0,6,6,1,0,1,0,2,18,12.7
Kenneth Faried,26-360,F,11/13/16,DEN,POR,1,28,5,10,0.5,5,10,0.5,0,0,,8,9,0.889,8,6,14,1,1,3,1,2,18,22
Seth Curry,26-199,G,3/10/17,DAL,BRK,1,32,6,11,0.545,3,7,0.429,3,4,0.75,3,3,1,1,4,5,4,0,0,2,0,18,15.4
Ian Clark,25-343,G,2/13/17,GSW,DEN,0,27,8,15,0.533,6,12,0.5,2,3,0.667,0,0,,0,1,1,1,2,0,2,1,18,11.3
Marco Belinelli,30-350,G-F,3/10/17,CHO,ORL,0,22,6,10,0.6,6,8,0.75,0,2,0,6,6,1,0,0,0,3,0,0,1,2,18,13.7
Mason Plumlee,26-302,C-F,1/1/17,POR,MIN,1,29,6,9,0.667,6,9,0.667,0,0,,6,10,0.6,2,6,8,3,1,0,2,2,18,16
Mason Plumlee,26-283,C-F,12/13/16,POR,OKC,1,29,7,9,0.778,7,9,0.778,0,0,,4,6,0.667,1,6,7,2,1,2,4,3,18,14.8
Brandon Bass,31-245,F,12/31/16,LAC,OKC,0,24,7,9,0.778,7,8,0.875,0,1,0,4,4,1,2,4,6,0,0,1,1,4,18,15.2
Jordan Clarkson,24-168,G,11/22/16,LAL,OKC,0,26,7,14,0.5,7,10,0.7,0,4,0,4,4,1,0,3,3,4,4,0,1,1,18,17.3
Rudy Gobert,24-204,C,1/16/17,UTA,PHO,1,36,8,12,0.667,8,12,0.667,0,0,,2,5,0.4,6,11,17,1,1,4,2,1,18,21.2
Tim Hardaway,24-268,G,12/9/16,ATL,MIL,1,31,6,17,0.353,3,8,0.375,3,9,0.333,3,5,0.6,2,2,4,4,1,0,3,0,18,10.5
Allen Crabbe,24-351,G-F,3/26/17,POR,LAL,0,29,7,12,0.583,3,4,0.75,4,8,0.5,0,0,,1,5,6,1,1,2,0,3,18,16.5
Chris Paul,31-212,G,12/4/16,LAC,IND,1,35,5,9,0.556,3,4,0.75,2,5,0.4,6,7,0.857,0,2,2,11,1,0,5,3,18,16.4
Jahlil Okafor,20-333,C-F,11/12/16,PHI,ATL,1,24,7,13,0.538,7,13,0.538,0,0,,4,8,0.5,3,3,6,2,0,1,2,4,18,11.6
Derrick Rose,28-131,G,2/12/17,NYK,SAS,1,30,6,11,0.545,6,11,0.545,0,0,,6,8,0.75,0,4,4,2,0,1,3,0,18,12.2
Carmelo Anthony,32-231,F,1/15/17,NYK,TOR,1,26,7,14,0.5,4,9,0.444,3,5,0.6,1,2,0.5,0,1,1,1,0,1,1,1,18,10.9
J.J. Redick,32-143,G,11/14/16,LAC,BRK,1,23,6,13,0.462,4,10,0.4,2,3,0.667,4,4,1,0,2,2,4,2,0,1,2,18,14.9
T.J. Warren,23-060,F,11/4/16,PHO,NOP,1,40,4,17,0.235,3,15,0.2,1,2,0.5,9,11,0.818,3,3,6,1,4,0,0,0,18,14.6
LeBron James,32-055,F-G,2/23/17,CLE,NYK,1,37,7,11,0.636,7,9,0.778,0,2,0,4,6,0.667,0,13,13,15,0,3,6,1,18,22.4
Avery Bradley,26-116,G,3/22/17,BOS,IND,1,39,7,13,0.538,5,10,0.5,2,3,0.667,2,2,1,2,6,8,2,1,0,2,4,18,13.7
Anthony Davis,23-232,F-C,10/29/16,NOP,SAS,1,32,6,15,0.4,6,15,0.4,0,0,,6,8,0.75,0,5,5,0,0,3,1,1,18,11.3
Goran Dragic,30-337,G,4/8/17,MIA,WAS,1,37,6,16,0.375,6,14,0.429,0,2,0,6,8,0.75,0,4,4,7,2,0,3,2,18,12.7
Harrison Barnes,24-287,F,3/13/17,DAL,TOR,1,36,7,16,0.438,6,14,0.429,1,2,0.5,3,3,1,1,1,2,1,0,2,0,3,18,11.5
Jrue Holiday,26-290,G,3/29/17,NOP,DAL,1,39,7,12,0.583,5,8,0.625,2,4,0.5,2,3,0.667,0,5,5,7,0,2,1,1,18,18.4
Seth Curry,26-147,G,1/17/17,DAL,CHI,1,30,7,10,0.7,4,5,0.8,3,5,0.6,1,2,0.5,0,2,2,2,2,0,1,1,18,16
Nikola Jokic,21-355,C-F,2/8/17,DEN,ATL,1,34,8,17,0.471,6,14,0.429,2,3,0.667,0,0,,9,6,15,3,0,0,0,4,18,17.9
Ben McLemore,23-358,G,2/3/17,SAC,PHO,1,35,6,12,0.5,3,6,0.5,3,6,0.5,3,4,0.75,0,0,0,3,0,0,0,4,18,12.1
Alex Poythress,23-218,F,4/12/17,PHI,NYK,1,32,9,14,0.643,9,11,0.818,0,3,0,0,0,,3,3,6,1,1,1,0,3,18,16
C.J. McCollum,25-130,G,1/27/17,POR,MEM,1,31,7,11,0.636,7,7,1,0,4,0,4,4,1,2,2,4,2,0,0,5,4,18,9.9
Maurice Harkless,23-291,F-G,2/26/17,POR,TOR,1,36,7,9,0.778,5,6,0.833,2,3,0.667,2,4,0.5,2,3,5,0,2,1,1,4,18,16.1
Anthony Davis,23-326,F-C,1/31/17,NOP,TOR,1,41,4,18,0.222,4,17,0.235,0,1,0,10,12,0.833,3,14,17,3,1,3,0,2,18,16.9
Joe Ingles,29-162,F-G,3/13/17,UTA,LAC,0,26,6,9,0.667,3,5,0.6,3,4,0.75,3,3,1,1,3,4,2,0,0,0,4,18,15.5
Eric Gordon,27-343,G,12/2/16,HOU,DEN,0,24,6,13,0.462,2,5,0.4,4,8,0.5,2,4,0.5,1,1,2,4,1,0,0,0,18,15.3
Kawhi Leonard,25-285,F,4/10/17,SAS,POR,1,20,8,11,0.727,7,9,0.778,1,2,0.5,1,1,1,0,0,0,0,1,1,2,0,18,13.2
Tobias Harris,24-190,F,1/21/17,DET,WAS,1,40,8,16,0.5,6,8,0.75,2,8,0.25,0,1,0,1,8,9,5,0,0,3,1,18,12.8
Trey Lyles,21-009,F,11/14/16,UTA,MEM,0,32,6,12,0.5,5,6,0.833,1,6,0.167,5,6,0.833,1,4,5,2,2,0,1,2,18,15.1
Gerald Henderson,29-028,G,1/6/17,PHI,BOS,0,29,6,9,0.667,4,6,0.667,2,3,0.667,4,4,1,0,4,4,1,0,1,1,2,18,14.9
Chris Paul,31-314,G,3/16/17,LAC,DEN,1,30,8,12,0.667,6,9,0.667,2,3,0.667,0,0,,0,1,1,14,1,0,2,5,18,19.9
Frank Kaminsky,23-352,F-C,3/22/17,CHO,ORL,0,33,6,13,0.462,2,6,0.333,4,7,0.571,2,2,1,2,3,5,1,0,1,2,3,18,11.8
Marc Gasol,32-046,C,3/16/17,MEM,ATL,1,36,7,16,0.438,5,11,0.455,2,5,0.4,2,2,1,1,9,10,10,0,0,2,4,18,16.4
Jabari Parker,21-259,F,11/29/16,MIL,CLE,1,31,7,17,0.412,6,14,0.429,1,3,0.333,3,3,1,1,3,4,1,2,0,0,1,18,12.8
Nicolas Batum,28-048,F-G,1/31/17,CHO,POR,1,34,6,12,0.5,2,6,0.333,4,6,0.667,2,4,0.5,0,8,8,6,0,0,4,0,18,13.8
Ryan Anderson,28-210,F,12/2/16,HOU,DEN,1,25,4,7,0.571,0,1,0,4,6,0.667,6,6,1,2,4,6,2,1,0,0,3,18,18.5
Victor Oladipo,24-203,G,11/23/16,OKC,SAC,1,36,7,15,0.467,4,7,0.571,3,8,0.375,1,2,0.5,0,6,6,2,1,2,2,3,18,12.3
Julius Randle,22-030,F,12/29/16,LAL,DAL,1,28,5,10,0.5,5,9,0.556,0,1,0,8,10,0.8,1,3,4,3,0,0,4,3,18,10.7
Zach Randolph,35-150,F,12/13/16,MEM,CLE,1,31,9,15,0.6,9,14,0.643,0,1,0,0,0,,1,4,5,2,2,1,1,1,18,15.7
Eric Gordon,28-069,G,3/4/17,HOU,MEM,0,35,6,9,0.667,0,0,,6,9,0.667,0,0,,0,2,2,1,2,1,2,0,18,16.1
Wilson Chandler,29-289,F,2/23/17,DEN,SAC,0,29,7,13,0.538,4,6,0.667,3,7,0.429,1,2,0.5,2,8,10,1,0,0,2,3,18,12.6
Stephen Curry,28-333,G,2/10/17,GSW,MEM,1,35,6,13,0.462,4,7,0.571,2,6,0.333,4,5,0.8,0,4,4,5,0,0,3,3,18,11.4
Monta Ellis,31-108,G,2/11/17,IND,MIL,0,32,7,10,0.7,6,7,0.857,1,3,0.333,3,4,0.75,0,4,4,1,0,2,5,4,18,10.1
Patty Mills,28-079,G,10/29/16,SAS,NOP,1,24,6,9,0.667,2,2,1,4,7,0.571,2,2,1,1,0,1,5,0,0,1,0,18,17.3
Channing Frye,33-247,C-F,1/19/17,CLE,PHO,0,30,6,11,0.545,2,3,0.667,4,8,0.5,2,2,1,2,8,10,2,1,0,0,5,18,16.9
Jeremy Lin,28-193,G,3/4/17,BRK,POR,1,22,6,14,0.429,2,7,0.286,4,7,0.571,2,2,1,0,3,3,2,1,1,1,2,18,12.8
Kristaps Porzingis,21-221,F-C,3/11/17,NYK,DET,1,36,7,16,0.438,4,9,0.444,3,7,0.429,1,3,0.333,2,4,6,4,0,6,0,4,18,16.8
Tyler Johnson,24-279,G,2/10/17,MIA,BRK,0,36,6,16,0.375,6,13,0.462,0,3,0,6,6,1,3,3,6,2,3,0,4,2,18,11.8
Aaron Brooks,32-074,G,3/29/17,IND,MEM,0,28,6,15,0.4,2,10,0.2,4,5,0.8,2,2,1,1,1,2,1,1,0,2,4,18,9
Robert Covington,26-093,F,3/17/17,PHI,DAL,1,26,4,8,0.5,1,2,0.5,3,6,0.5,7,8,0.875,0,9,9,3,0,1,1,2,18,17.3
Tyler Johnson,24-207,G,11/30/16,MIA,DEN,0,28,7,13,0.538,7,13,0.538,0,0,,4,6,0.667,1,1,2,7,1,0,1,1,18,16.4
Kentavious Caldwell-Pope,23-347,G,1/30/17,DET,BOS,1,36,5,16,0.313,3,9,0.333,2,7,0.286,6,8,0.75,0,3,3,3,2,0,1,3,18,10.8
Andre Drummond,23-105,C,11/23/16,DET,MIA,1,26,9,12,0.75,9,12,0.75,0,0,,0,1,0,3,12,15,1,4,4,0,2,18,25.2
Julius Randle,22-124,F,4/2/17,LAL,MEM,1,36,6,12,0.5,5,8,0.625,1,4,0.25,5,6,0.833,3,8,11,0,1,1,1,0,18,16.8
Danilo Gallinari,28-166,F,1/21/17,DEN,LAC,1,32,5,8,0.625,3,5,0.6,2,3,0.667,6,6,1,0,4,4,2,0,0,0,1,18,16.6
Larry Nance Jr.,24-033,F,2/3/17,LAL,BOS,0,32,7,13,0.538,7,13,0.538,0,0,,4,6,0.667,5,6,11,4,3,0,1,5,18,19
Giannis Antetokounmpo,21-357,F-G,11/27/16,MIL,ORL,1,31,7,11,0.636,6,10,0.6,1,1,1,3,4,0.75,1,8,9,4,1,3,6,4,18,14.1
Jordan Clarkson,24-148,G,11/2/16,LAL,ATL,0,23,8,13,0.615,7,10,0.7,1,3,0.333,1,2,0.5,0,2,2,3,1,1,3,4,18,11.5
Victor Oladipo,24-322,G,3/22/17,OKC,PHI,1,31,7,13,0.538,6,10,0.6,1,3,0.333,3,3,1,0,2,2,1,1,0,4,2,18,9.2
Will Barton,26-015,G,1/21/17,DEN,LAC,1,29,8,13,0.615,6,9,0.667,2,4,0.5,0,0,,1,2,3,3,1,0,0,1,18,16.1
Anthony Davis,23-341,F-C,2/15/17,NOP,MEM,1,39,9,20,0.45,9,19,0.474,0,1,0,0,0,,0,7,7,2,1,2,3,2,18,9.7
Tobias Harris,24-105,F,10/28/16,DET,ORL,1,27,8,16,0.5,6,11,0.545,2,5,0.4,0,0,,0,4,4,2,2,1,2,2,18,12.5
Dwight Howard,30-328,C,10/31/16,ATL,SAC,1,30,5,9,0.556,5,9,0.556,0,0,,8,20,0.4,7,4,11,1,0,4,2,5,18,14.5
Robin Lopez,29-009,C,4/10/17,CHI,ORL,1,29,9,14,0.643,9,14,0.643,0,0,,0,0,,3,5,8,1,0,1,2,1,18,14.4
Marcus Smart,22-340,G,2/9/17,BOS,POR,1,38,8,13,0.615,8,11,0.727,0,2,0,2,3,0.667,1,5,6,5,5,0,0,2,18,21.6
Kyrie Irving,24-278,G,12/26/16,CLE,DET,1,29,8,20,0.4,6,14,0.429,2,6,0.333,0,1,0,1,4,5,8,0,0,3,3,18,10.1
LeBron James,32-041,F-G,2/9/17,CLE,OKC,1,41,8,19,0.421,7,15,0.467,1,4,0.25,1,3,0.333,1,4,5,7,2,2,3,1,18,13.9
Zach Randolph,35-198,F,1/30/17,MEM,PHO,0,23,8,13,0.615,6,10,0.6,2,3,0.667,0,0,,0,6,6,0,1,0,2,1,18,12.5
Gerald Henderson,28-328,G,11/1/16,PHI,ORL,1,31,7,13,0.538,7,13,0.538,0,0,,4,5,0.8,1,3,4,1,1,0,1,1,18,13.2
Dwyane Wade,34-305,G,11/17/16,CHI,UTA,1,33,7,17,0.412,7,15,0.467,0,2,0,4,4,1,1,1,2,1,0,1,1,2,18,9.5
Kentavious Caldwell-Pope,23-285,G,11/29/16,DET,CHO,1,32,6,14,0.429,2,6,0.333,4,8,0.5,2,2,1,2,5,7,7,1,1,1,2,18,18.3
Sean Kilpatrick,27-021,G,1/27/17,BRK,CLE,0,34,7,17,0.412,4,12,0.333,3,5,0.6,1,2,0.5,0,2,2,3,2,0,2,2,18,10.4
Pau Gasol,36-179,F-C,1/1/17,SAS,ATL,1,38,6,10,0.6,5,9,0.556,1,1,1,5,6,0.833,1,8,9,2,1,1,3,3,18,15
Harrison Barnes,24-277,F,3/3/17,DAL,MEM,1,37,6,15,0.4,5,11,0.455,1,4,0.25,5,5,1,1,2,3,1,1,0,0,1,18,12.5
Kentavious Caldwell-Pope,23-312,G,12/26/16,DET,CLE,1,39,7,11,0.636,3,5,0.6,4,6,0.667,0,0,,0,3,3,3,3,1,1,2,18,18
Greg Monroe,26-214,C-F,1/4/17,MIL,NYK,0,31,7,10,0.7,7,10,0.7,0,0,,4,10,0.4,3,6,9,4,3,1,3,1,18,18.4
Derrick Rose,28-053,G,11/26/16,NYK,CHO,1,34,6,20,0.3,5,17,0.294,1,3,0.333,5,6,0.833,5,3,8,8,2,2,1,3,18,17.2
Sergio Rodriguez,30-197,G,12/26/16,PHI,SAC,1,25,7,9,0.778,3,4,0.75,4,5,0.8,0,0,,0,3,3,5,3,0,2,1,18,19.5
Khris Middleton,25-208,F-G,3/8/17,MIL,NYK,1,28,7,9,0.778,3,3,1,4,6,0.667,0,0,,0,3,3,4,1,1,0,2,18,19.1
Trevor Booker,28-364,F,11/23/16,BRK,BOS,1,33,8,13,0.615,7,11,0.636,1,2,0.5,1,2,0.5,5,7,12,3,4,0,3,3,18,19.2
Marc Gasol,31-306,C,11/30/16,MEM,TOR,1,35,7,14,0.5,5,10,0.5,2,4,0.5,2,2,1,3,5,8,3,0,0,0,2,18,15.9
Kevin Love,28-051,F,10/28/16,CLE,TOR,1,36,6,15,0.4,4,10,0.4,2,5,0.4,4,4,1,2,8,10,2,1,2,0,2,18,16.7
Wesley Matthews,30-090,G,1/12/17,DAL,PHO,1,38,7,14,0.5,3,6,0.5,4,8,0.5,0,0,,0,0,0,5,1,1,1,1,18,14.8
Mike Conley,29-113,G,2/1/17,MEM,DEN,1,27,7,14,0.5,5,7,0.714,2,7,0.286,2,2,1,1,3,4,5,1,0,1,1,18,15.7
Joel Embiid,22-230,C-F,11/1/16,PHI,ORL,1,25,6,12,0.5,6,11,0.545,0,1,0,6,9,0.667,3,7,10,3,0,4,4,2,18,15.1
Quincy Acy,26-148,F,3/3/17,BRK,UTA,0,18,5,7,0.714,3,4,0.75,2,3,0.667,6,8,0.75,0,2,2,0,1,0,0,2,18,15.1
LeBron James,32-095,F-G,4/4/17,CLE,ORL,1,37,7,14,0.5,7,11,0.636,0,3,0,4,6,0.667,1,10,11,11,2,1,6,2,18,17.5
DeAndre Jordan,28-167,C,1/4/17,LAC,MEM,1,37,7,10,0.7,7,10,0.7,0,0,,4,11,0.364,4,16,20,0,0,2,2,3,18,16.8
T.J. Warren,23-060,F,11/4/16,PHO,NOP,1,40,4,17,0.235,3,15,0.2,1,2,0.5,9,11,0.818,3,3,6,1,4,0,0,0,18,14.6
DeAndre Jordan,28-265,C,4/12/17,LAC,SAC,1,36,8,10,0.8,8,10,0.8,0,0,,2,4,0.5,7,10,17,2,0,4,0,3,18,24.3
Danny Green,29-191,G-F,12/30/16,SAS,POR,1,31,6,9,0.667,0,1,0,6,8,0.75,0,0,,0,2,2,1,0,1,3,3,18,11.9
Paul Millsap,31-340,F,1/15/17,ATL,MIL,1,36,7,12,0.583,4,7,0.571,3,5,0.6,1,1,1,2,6,8,5,0,2,4,4,18,14.9
Kyrie Irving,25-015,G,4/7/17,CLE,ATL,1,33,8,13,0.615,8,12,0.667,0,1,0,2,2,1,0,1,1,6,0,0,1,0,18,15.6
Victor Oladipo,24-245,G,1/4/17,OKC,CHO,1,36,7,20,0.35,4,12,0.333,3,8,0.375,1,2,0.5,2,1,3,5,1,0,3,5,18,7.6
Tyreke Evans,27-184,G-F,3/22/17,SAC,MIL,0,21,8,14,0.571,6,11,0.545,2,3,0.667,0,1,0,1,2,3,2,0,0,2,2,18,10.9
Al Horford,30-169,C-F,11/19/16,BOS,DET,1,34,7,12,0.583,5,9,0.556,2,3,0.667,2,2,1,2,9,11,5,2,3,1,2,18,22.3
C.J. McCollum,25-149,G,2/15/17,POR,UTA,1,25,8,19,0.421,6,14,0.429,2,5,0.4,0,0,,1,1,2,0,0,0,4,4,18,3.3
Gary Harris,22-092,G,12/15/16,DEN,POR,1,32,7,11,0.636,4,7,0.571,3,4,0.75,1,1,1,0,4,4,6,2,1,0,4,18,19.6
Otto Porter,23-280,F,3/10/17,WAS,SAC,1,39,7,11,0.636,5,8,0.625,2,3,0.667,2,2,1,1,5,6,2,2,1,0,1,18,19
Kristaps Porzingis,21-233,F-C,3/23/17,NYK,POR,1,38,8,21,0.381,8,16,0.5,0,5,0,2,3,0.667,3,6,9,1,1,3,2,2,18,11
Pau Gasol,36-162,F-C,12/15/16,SAS,PHO,1,24,8,12,0.667,8,11,0.727,0,1,0,2,2,1,2,7,9,3,0,0,2,1,18,16
Luol Deng,31-231,F,12/3/16,LAL,MEM,1,36,8,15,0.533,6,8,0.75,2,7,0.286,0,1,0,2,3,5,0,4,1,2,2,18,14.5
Isaiah Thomas,27-285,G,11/18/16,BOS,GSW,1,28,4,12,0.333,3,6,0.5,1,6,0.167,9,9,1,0,2,2,4,0,0,1,1,18,13.2
Rodney Stuckey,30-218,G,11/25/16,IND,BRK,0,25,7,10,0.7,5,7,0.714,2,3,0.667,2,4,0.5,0,4,4,3,2,0,3,2,18,14.5
Carmelo Anthony,32-278,F,3/3/17,NYK,PHI,1,36,5,18,0.278,3,13,0.231,2,5,0.4,6,6,1,1,5,6,2,2,2,2,3,18,11.2
LeBron James,32-082,F-G,3/22/17,CLE,DEN,1,34,8,12,0.667,8,10,0.8,0,2,0,2,4,0.5,2,4,6,5,0,0,4,1,18,13.7
Ben McLemore,24-057,G,4/9/17,SAC,HOU,0,24,6,15,0.4,3,8,0.375,3,7,0.429,3,4,0.75,0,3,3,0,0,0,0,2,18,9.6
Lou Williams,30-134,G,3/10/17,HOU,CHI,0,27,4,11,0.364,2,4,0.5,2,7,0.286,8,8,1,0,3,3,1,2,1,4,1,18,11.8
Dennis Schroder,23-203,G,4/6/17,ATL,BOS,1,33,7,14,0.5,4,9,0.444,3,5,0.6,1,1,1,0,4,4,5,0,0,2,4,18,12.1
Julius Randle,21-343,F,11/6/16,LAL,PHO,1,28,6,9,0.667,6,9,0.667,0,0,,6,6,1,0,5,5,4,1,0,1,4,18,16.8
Terrence Ross,25-284,F-G,11/15/16,TOR,CLE,0,25,7,12,0.583,3,5,0.6,4,7,0.571,0,0,,0,3,3,0,2,0,0,0,18,15.3
Enes Kanter,24-286,C,3/2/17,OKC,POR,0,28,6,13,0.462,6,13,0.462,0,0,,6,7,0.857,2,8,10,0,1,0,2,3,18,12.5
Carmelo Anthony,32-183,F,11/28/16,NYK,OKC,1,34,4,19,0.211,4,18,0.222,0,1,0,10,11,0.909,1,7,8,2,1,1,1,1,18,10.4
D.J. Augustin,29-009,G,11/19/16,ORL,DAL,0,30,6,11,0.545,4,6,0.667,2,5,0.4,4,4,1,0,2,2,6,0,0,3,1,18,14.1
Clint Capela,22-326,F-C,4/9/17,HOU,SAC,1,24,8,8,1,8,8,1,0,0,,2,2,1,0,6,6,0,0,1,1,2,18,16.3
Kyle Korver,36-024,G-F,4/10/17,CLE,MIA,0,30,6,12,0.5,2,4,0.5,4,8,0.5,2,2,1,0,8,8,1,0,1,1,2,18,14
Kyle Lowry,30-238,G,11/18/16,TOR,DEN,1,38,6,15,0.4,3,8,0.375,3,7,0.429,3,4,0.75,0,5,5,13,0,0,4,1,18,15.7
Wilson Chandler,29-316,F,3/22/17,DEN,CLE,1,41,8,14,0.571,7,10,0.7,1,4,0.25,1,1,1,0,5,5,3,1,0,2,1,18,13.6
Jordan Clarkson,24-296,G,3/30/17,LAL,MIN,1,40,6,13,0.462,2,5,0.4,4,8,0.5,2,2,1,0,3,3,7,0,0,4,1,18,12.7
Dennis Schroder,23-111,G,1/4/17,ATL,ORL,1,30,7,13,0.538,7,12,0.583,0,1,0,4,6,0.667,0,6,6,7,1,0,3,1,18,15.2
Goran Dragic,30-211,G,12/3/16,MIA,POR,1,35,8,19,0.421,8,18,0.444,0,1,0,2,2,1,1,8,9,8,2,0,5,3,18,12.4
Serge Ibaka,27-188,F-C,3/25/17,TOR,DAL,1,32,8,16,0.5,6,14,0.429,2,2,1,0,0,,2,6,8,1,0,0,0,4,18,12.3
Sean Kilpatrick,27-028,G,2/3/17,BRK,IND,0,26,6,11,0.545,4,7,0.571,2,4,0.5,4,4,1,0,5,5,4,0,0,2,3,18,13.8
Jonas Valanciunas,24-249,C,1/10/17,TOR,BOS,1,28,6,18,0.333,6,18,0.333,0,0,,6,6,1,11,12,23,0,0,2,3,4,18,15.9
Jae Crowder,26-224,F,2/15/17,BOS,PHI,1,35,5,13,0.385,4,8,0.5,1,5,0.2,7,9,0.778,2,3,5,2,1,0,1,1,18,13.4
Derrick Rose,28-049,G,11/22/16,NYK,POR,1,28,8,15,0.533,8,15,0.533,0,0,,2,2,1,2,2,4,5,2,1,1,4,18,16.3
Dwight Howard,30-337,C,11/9/16,ATL,CHI,1,34,6,9,0.667,6,9,0.667,0,0,,6,9,0.667,6,4,10,0,3,2,2,3,18,19.5
Manu Ginobili,39-191,G,2/4/17,SAS,DEN,0,10,5,6,0.833,1,1,1,4,5,0.8,4,4,1,0,1,1,0,1,0,2,1,18,14.7
Klay Thompson,26-335,G,1/8/17,GSW,SAC,1,36,8,19,0.421,7,12,0.583,1,7,0.143,1,2,0.5,1,5,6,2,0,0,5,3,18,4.9
Russell Westbrook,28-130,G,3/22/17,OKC,PHI,1,28,6,6,1,6,6,1,0,0,,6,6,1,0,11,11,14,0,2,5,1,18,25.3
Marc Gasol,31-288,C,11/12/16,MEM,MIL,1,34,6,13,0.462,5,9,0.556,1,4,0.25,5,6,0.833,1,4,5,6,0,2,2,6,18,14
Arron Afflalo,31-179,G,4/12/17,SAC,LAC,1,34,8,11,0.727,8,11,0.727,0,0,,2,2,1,0,2,2,6,0,0,0,0,18,18.3
Karl-Anthony Towns,21-045,C-F,12/30/16,MIN,MIL,1,38,7,12,0.583,7,10,0.7,0,2,0,4,6,0.667,5,11,16,3,0,2,4,4,18,16.3
Nicolas Batum,27-347,F-G,11/25/16,CHO,NYK,1,45,7,17,0.412,6,10,0.6,1,7,0.143,3,6,0.5,0,9,9,9,0,1,2,0,18,15.4
Matthew Dellavedova,26-086,G,12/3/16,MIL,BRK,1,27,6,10,0.6,6,8,0.75,0,2,0,6,6,1,1,1,2,6,0,0,1,2,18,16.8
Dirk Nowitzki,38-251,F,2/25/17,DAL,NOP,1,28,8,12,0.667,6,10,0.6,2,2,1,0,0,,0,9,9,0,1,1,0,2,18,16.4
Terrence Jones,24-336,F,12/10/16,NOP,LAC,1,26,7,9,0.778,5,6,0.833,2,3,0.667,2,4,0.5,1,4,5,0,0,0,3,4,18,11
Solomon Hill,25-228,F,11/1/16,NOP,MIL,1,36,5,9,0.556,2,5,0.4,3,4,0.75,5,8,0.625,1,5,6,4,2,0,0,3,18,18.3
Kemba Walker,26-207,G,12/1/16,CHO,DAL,1,33,7,19,0.368,4,9,0.444,3,10,0.3,1,2,0.5,0,3,3,5,1,0,3,4,18,7.9
Derrick Rose,28-167,G,3/20/17,NYK,LAC,1,28,6,11,0.545,6,11,0.545,0,0,,6,6,1,1,3,4,5,0,0,1,1,18,16.4
Thaddeus Young,28-260,F,3/8/17,IND,DET,1,34,9,14,0.643,9,14,0.643,0,0,,0,2,0,3,5,8,0,1,0,0,3,18,14.4
Bojan Bogdanovic,27-231,G-F,12/5/16,BRK,WAS,1,29,5,14,0.357,3,7,0.429,2,7,0.286,6,8,0.75,0,3,3,2,0,0,1,3,18,9.5
Danilo Gallinari,28-142,F,12/28/16,DEN,MIN,1,35,6,9,0.667,4,5,0.8,2,4,0.5,4,4,1,0,5,5,2,0,0,3,3,18,12.8
Allen Crabbe,24-334,G-F,3/9/17,POR,PHI,0,24,8,12,0.667,6,7,0.857,2,5,0.4,0,0,,0,4,4,0,1,0,0,2,18,14.2
Robert Covington,26-063,F,2/15/17,PHI,BOS,1,29,7,12,0.583,3,6,0.5,4,6,0.667,0,0,,3,6,9,2,3,1,0,2,18,20.6
Markieff Morris,27-063,F,11/4/16,WAS,ATL,1,33,5,13,0.385,4,10,0.4,1,3,0.333,7,9,0.778,0,9,9,1,3,1,2,5,18,13.2
Norman Powell,23-254,G,2/3/17,TOR,ORL,1,38,7,12,0.583,5,10,0.5,2,2,1,2,2,1,2,0,2,1,1,0,2,2,18,12.7
Patty Mills,28-080,G,10/30/16,SAS,MIA,0,25,6,10,0.6,2,4,0.5,4,6,0.667,2,2,1,0,0,0,0,0,0,1,1,18,12
Sheldon McClellan,24-112,G,4/12/17,WAS,MIA,0,35,6,11,0.545,5,7,0.714,1,4,0.25,5,6,0.833,0,4,4,0,0,0,2,1,18,11.1
Paul George,26-312,F,3/10/17,IND,MIL,1,42,5,14,0.357,5,9,0.556,0,5,0,8,8,1,1,10,11,6,2,0,3,4,18,15.5
Nikola Vucevic,26-102,C,2/3/17,ORL,TOR,1,30,9,16,0.563,9,16,0.563,0,0,,0,2,0,2,3,5,3,1,1,4,2,18,10.9
E'Twaun Moore,28-015,G,3/15/17,NOP,MIA,0,35,8,12,0.667,7,9,0.778,1,3,0.333,1,2,0.5,0,1,1,1,0,0,0,1,18,13
Tobias Harris,24-181,F,1/12/17,DET,GSW,1,34,8,15,0.533,7,11,0.636,1,4,0.25,1,2,0.5,0,4,4,0,3,0,1,2,18,12.7
Shabazz Muhammad,24-128,F-G,3/21/17,MIN,SAS,0,24,8,15,0.533,6,12,0.5,2,3,0.667,0,0,,3,1,4,0,1,0,1,0,18,13.1
Buddy Hield,22-331,G,11/12/16,NOP,LAL,0,26,8,13,0.615,7,9,0.778,1,4,0.25,1,1,1,0,3,3,1,0,0,1,3,18,11.5
Jae Crowder,26-191,F,1/13/17,BOS,ATL,1,33,7,12,0.583,3,4,0.75,4,8,0.5,0,0,,1,8,9,0,0,0,1,1,18,14.1
Spencer Dinwiddie,23-347,G,3/19/17,BRK,DAL,0,30,5,9,0.556,3,3,1,2,6,0.333,6,7,0.857,1,1,2,7,1,0,1,5,18,17.2
Goran Dragic,30-336,G,4/7/17,MIA,TOR,1,36,6,14,0.429,6,12,0.5,0,2,0,6,8,0.75,1,0,1,1,1,0,4,3,18,7
C.J. Watson,32-292,G,2/3/17,ORL,TOR,0,32,5,6,0.833,4,4,1,1,2,0.5,7,7,1,1,2,3,4,2,1,0,2,18,21.8
Nikola Vucevic,26-144,C,3/17/17,ORL,PHO,1,32,8,20,0.4,8,18,0.444,0,2,0,2,2,1,6,11,17,2,3,0,2,2,18,16.3
E'Twaun Moore,27-244,G,10/29/16,NOP,SAS,1,25,8,13,0.615,8,11,0.727,0,2,0,2,3,0.667,0,0,0,0,1,1,0,0,18,13.4
James Johnson,29-261,F,11/7/16,MIA,OKC,0,25,5,12,0.417,4,9,0.444,1,3,0.333,7,7,1,2,4,6,1,1,2,3,4,18,12.7
Jerian Grant,24-037,G,11/15/16,CHI,POR,1,30,6,13,0.462,4,8,0.5,2,5,0.4,4,4,1,0,3,3,2,5,0,0,2,18,17.8
Jordan Clarkson,24-176,G,11/30/16,LAL,CHI,0,34,9,18,0.5,9,17,0.529,0,1,0,0,0,,0,4,4,3,1,0,3,2,18,9.5
Pau Gasol,36-246,F-C,3/9/17,SAS,OKC,0,24,8,14,0.571,6,12,0.5,2,2,1,0,0,,3,4,7,1,0,0,0,1,18,15
Ryan Anderson,28-250,F,1/11/17,HOU,MIN,1,38,6,16,0.375,1,2,0.5,5,14,0.357,1,1,1,2,5,7,4,1,0,0,5,18,13.9
C.J. McCollum,25-181,G,3/19/17,POR,MIA,1,37,7,16,0.438,5,11,0.455,2,5,0.4,2,2,1,0,4,4,5,1,0,3,1,18,11.9
Marc Gasol,31-365,C,1/28/17,MEM,UTA,1,37,7,12,0.583,3,7,0.429,4,5,0.8,0,0,,0,4,4,5,0,1,2,4,18,14.2
Dennis Schroder,23-188,G,3/22/17,ATL,WAS,1,34,5,16,0.313,5,13,0.385,0,3,0,8,8,1,0,2,2,6,0,1,10,4,18,2.7
Darren Collison,29-194,G,3/5/17,SAC,UTA,1,41,8,14,0.571,7,12,0.583,1,2,0.5,1,2,0.5,0,3,3,5,1,0,1,1,18,15
Jabari Parker,21-326,F,2/4/17,MIL,PHO,1,31,7,10,0.7,7,9,0.778,0,1,0,4,6,0.667,2,7,9,2,0,1,2,1,18,16.2
D'Angelo Russell,20-315,G,1/3/17,LAL,MEM,1,33,6,12,0.5,0,3,0,6,9,0.667,0,0,,0,4,4,6,1,0,2,0,18,16.4
Jae Crowder,26-142,F,11/25/16,BOS,SAS,1,28,7,12,0.583,3,3,1,4,9,0.444,0,0,,0,3,3,5,1,0,1,4,18,15.2
Nikola Vucevic,26-069,C,1/1/17,ORL,IND,0,30,9,18,0.5,9,16,0.563,0,2,0,0,0,,1,10,11,1,1,2,1,4,18,13.2
Wayne Ellington,29-128,G,3/6/17,MIA,CLE,0,32,6,12,0.5,1,2,0.5,5,10,0.5,1,1,1,1,3,4,4,0,0,0,1,18,16
Jusuf Nurkic,22-191,C,3/2/17,POR,OKC,1,38,7,10,0.7,7,10,0.7,0,0,,4,5,0.8,3,9,12,6,2,5,4,3,18,22.7
Paul Millsap,31-315,F,12/21/16,ATL,MIN,1,39,7,18,0.389,7,13,0.538,0,5,0,4,6,0.667,3,7,10,7,2,0,0,2,18,17.7
Myles Turner,20-338,F-C,2/25/17,IND,MIA,1,32,8,19,0.421,8,18,0.444,0,1,0,2,2,1,3,4,7,1,3,1,0,5,18,13.6
Will Barton,26-013,G,1/19/17,DEN,SAS,1,36,5,12,0.417,4,7,0.571,1,5,0.2,7,7,1,0,3,3,7,0,2,3,3,18,14.6
Derrick Rose,28-033,G,11/6/16,NYK,UTA,1,36,7,14,0.5,7,14,0.5,0,0,,4,4,1,2,2,4,8,1,0,4,3,18,14.4
Reggie Jackson,26-249,G,12/21/16,DET,MEM,1,26,6,12,0.5,4,8,0.5,2,4,0.5,4,4,1,0,1,1,7,0,0,2,4,18,13.6
Ivica Zubac,19-364,C,3/17/17,LAL,MIL,1,29,9,15,0.6,9,15,0.6,0,0,,0,0,,2,6,8,1,0,0,0,2,18,14.2
Rodney Hood,24-082,G-F,1/10/17,UTA,CLE,1,35,7,15,0.467,3,5,0.6,4,10,0.4,0,0,,1,4,5,3,2,0,3,4,18,11.7
Arron Afflalo,31-146,G,3/10/17,SAC,WAS,1,34,6,10,0.6,4,7,0.571,2,3,0.667,4,5,0.8,0,3,3,1,0,0,0,2,18,13.8
Giannis Antetokounmpo,22-097,F-G,3/13/17,MIL,MEM,1,28,6,14,0.429,5,10,0.5,1,4,0.25,5,7,0.714,0,5,5,4,1,0,2,3,18,11.9
DeMarre Carroll,30-170,F,1/13/17,TOR,BRK,1,29,7,16,0.438,4,6,0.667,3,10,0.3,1,1,1,1,10,11,0,0,0,0,2,18,12.5
Brook Lopez,28-217,C,11/4/16,BRK,CHO,1,29,7,17,0.412,5,11,0.455,2,6,0.333,2,3,0.667,1,2,3,2,0,0,3,1,18,7.8
Justise Winslow,20-218,F,10/30/16,MIA,SAS,1,39,7,15,0.467,7,12,0.583,0,3,0,4,5,0.8,2,3,5,2,2,1,2,5,18,12.3
Avery Bradley,25-356,G,11/16/16,BOS,DAL,1,34,8,19,0.421,6,13,0.462,2,6,0.333,0,1,0,2,11,13,1,0,0,3,1,18,9.5
Greg Monroe,26-279,C-F,3/10/17,MIL,IND,0,27,6,7,0.857,6,7,0.857,0,0,,6,7,0.857,1,6,7,2,1,1,3,3,18,16.5
Elfrid Payton,22-261,G,11/9/16,ORL,MIN,1,27,8,14,0.571,7,11,0.636,1,3,0.333,1,1,1,0,3,3,7,1,0,1,1,18,16.8
Deron Williams,32-173,G,12/16/16,DAL,UTA,1,35,6,11,0.545,5,7,0.714,1,4,0.25,5,5,1,0,0,0,7,2,0,1,1,18,18.2
Damian Lillard,26-128,G,11/20/16,POR,BRK,1,28,8,14,0.571,8,9,0.889,0,5,0,2,4,0.5,0,4,4,5,1,1,2,1,18,14.6
Eric Gordon,27-351,G,12/10/16,HOU,DAL,0,26,6,14,0.429,0,5,0,6,9,0.667,0,0,,1,0,1,3,0,0,2,2,18,10.6
Alex Len,23-139,C,11/2/16,PHO,POR,0,21,6,10,0.6,6,9,0.667,0,1,0,6,6,1,4,2,6,1,0,3,0,2,18,18.8
Klay Thompson,26-269,G,11/3/16,GSW,OKC,1,33,7,14,0.5,3,6,0.5,4,8,0.5,0,0,,1,0,1,3,2,1,2,3,18,13.3
Nicolas Batum,28-102,F-G,3/26/17,CHO,PHO,1,30,6,15,0.4,3,7,0.429,3,8,0.375,3,4,0.75,0,6,6,10,1,0,3,1,18,15.9
Joel Embiid,22-310,C-F,1/20/17,PHI,POR,1,22,7,14,0.5,7,14,0.5,0,0,,4,9,0.444,3,7,10,5,0,4,5,2,18,13.7
J.J. Redick,32-158,G,11/29/16,LAC,BRK,1,38,7,18,0.389,4,8,0.5,3,10,0.3,1,1,1,0,2,2,2,0,0,1,4,18,7.6
Avery Bradley,26-109,G,3/15/17,BOS,MIN,1,32,7,12,0.583,3,6,0.5,4,6,0.667,0,0,,0,3,3,4,0,0,0,2,18,15.3
Markieff Morris,27-064,F,11/5/16,WAS,ORL,1,38,5,16,0.313,4,12,0.333,1,4,0.25,7,9,0.778,1,6,7,3,0,2,2,1,18,11.6
Channing Frye,33-260,C-F,2/1/17,CLE,MIN,1,22,7,13,0.538,4,4,1,3,9,0.333,1,2,0.5,0,4,4,1,1,2,0,0,18,15.6
T.J. Warren,23-068,F,11/12/16,PHO,BRK,1,34,9,17,0.529,9,14,0.643,0,3,0,0,0,,3,0,3,2,3,1,1,3,18,14.7
Derrick Rose,28-090,G,1/2/17,NYK,ORL,1,28,8,15,0.533,8,14,0.571,0,1,0,2,2,1,2,1,3,4,0,0,3,0,18,12.2
Zach LaVine,21-286,G,12/21/16,MIN,ATL,1,38,5,12,0.417,1,4,0.25,4,8,0.5,4,4,1,1,3,4,2,1,1,1,1,18,14.9
George Hill,30-318,G,3/18/17,UTA,CHI,1,37,6,11,0.545,4,6,0.667,2,5,0.4,4,4,1,1,6,7,4,2,1,3,1,18,17.3
Ty Lawson,29-015,G,11/18/16,SAC,LAC,1,36,7,11,0.636,5,8,0.625,2,3,0.667,2,2,1,1,6,7,8,1,0,2,1,18,19.8
Derrick Rose,28-104,G,1/16/17,NYK,ATL,1,32,8,16,0.5,8,16,0.5,0,0,,2,4,0.5,1,3,4,9,1,1,6,4,18,11.2
Austin Rivers,24-131,G,12/10/16,LAC,NOP,1,28,6,9,0.667,2,3,0.667,4,6,0.667,2,2,1,1,1,2,4,1,0,1,1,18,17.5
Wilson Chandler,29-329,F,4/4/17,DEN,NOP,0,25,6,11,0.545,4,6,0.667,2,5,0.4,4,5,0.8,2,5,7,2,0,0,1,5,18,13.6
DeMar DeRozan,27-230,G,3/25/17,TOR,DAL,1,37,8,17,0.471,7,15,0.467,1,2,0.5,1,2,0.5,0,3,3,6,1,1,3,3,18,11.5
Langston Galloway,24-329,G,11/2/16,NOP,MEM,0,32,6,13,0.462,2,6,0.333,4,7,0.571,2,3,0.667,0,2,2,2,2,1,0,4,18,14
Clint Capela,22-296,F-C,3/10/17,HOU,CHI,1,24,7,9,0.778,7,9,0.778,0,0,,3,4,0.75,3,4,7,1,0,0,1,0,17,16.1
DeMarre Carroll,30-146,F,12/20/16,TOR,BRK,1,22,7,11,0.636,4,5,0.8,3,6,0.5,0,0,,1,2,3,0,2,0,2,2,17,12.6
Chris Paul,31-324,G,3/26/17,LAC,SAC,1,31,4,9,0.444,1,4,0.25,3,5,0.6,6,6,1,1,3,4,9,1,1,1,1,17,20.5
Paul George,26-290,F,2/16/17,IND,WAS,1,37,6,19,0.316,5,12,0.417,1,7,0.143,4,4,1,0,7,7,3,2,0,3,1,17,8.9
Kyle Lowry,30-253,G,12/3/16,TOR,ATL,1,31,6,9,0.667,3,4,0.75,3,5,0.6,2,2,1,1,7,8,8,0,1,1,4,17,19.6
Jeff Green,30-126,F,1/1/17,ORL,IND,0,23,7,12,0.583,4,6,0.667,3,6,0.5,0,0,,1,1,2,2,0,0,1,2,17,12
Robin Lopez,28-311,C,2/6/17,CHI,SAC,1,32,7,12,0.583,7,12,0.583,0,0,,3,4,0.75,4,2,6,2,1,0,3,2,17,13
Lance Thomas,28-316,F,3/6/17,NYK,ORL,1,27,5,13,0.385,2,8,0.25,3,5,0.6,4,4,1,1,3,4,1,2,0,1,3,17,12
Kentavious Caldwell-Pope,23-270,G,11/14/16,DET,OKC,1,34,7,17,0.412,6,13,0.462,1,4,0.25,2,3,0.667,1,2,3,4,1,0,3,2,17,8.8
Serge Ibaka,27-180,F-C,3/17/17,TOR,DET,1,34,6,14,0.429,3,6,0.5,3,8,0.375,2,2,1,1,8,9,1,0,0,3,3,17,9.2
George Hill,30-257,G,1/16/17,UTA,PHO,1,33,7,18,0.389,6,10,0.6,1,8,0.125,2,2,1,2,6,8,3,0,1,3,1,17,9.8
Dwyane Wade,35-000,G,1/17/17,CHI,DAL,1,35,8,21,0.381,8,20,0.4,0,1,0,1,3,0.333,1,4,5,2,0,1,4,3,17,3.5
Patrick Patterson,27-264,F,12/3/16,TOR,ATL,0,21,6,8,0.75,2,3,0.667,4,5,0.8,1,1,1,0,4,4,2,1,0,1,3,17,15.2
Sam Dekker,22-210,F,12/2/16,HOU,DEN,0,28,6,10,0.6,5,6,0.833,1,4,0.25,4,4,1,1,2,3,0,1,1,0,0,17,15.4
Nicolas Batum,28-035,F-G,1/18/17,CHO,POR,1,34,6,15,0.4,5,10,0.5,1,5,0.2,4,4,1,0,7,7,7,0,1,5,0,17,11.6
Chris Paul,31-189,G,11/11/16,LAC,OKC,1,36,5,14,0.357,3,8,0.375,2,6,0.333,5,5,1,0,6,6,10,1,0,0,2,17,18.2
Brandon Ingram,19-091,F,12/2/16,LAL,TOR,1,35,8,16,0.5,7,11,0.636,1,5,0.2,0,0,,1,5,6,2,0,0,1,3,17,10.4
Will Barton,26-033,G,2/8/17,DEN,ATL,0,38,6,19,0.316,6,10,0.6,0,9,0,5,7,0.714,3,4,7,7,3,2,1,0,17,16.9
Tobias Harris,24-170,F,1/1/17,DET,MIA,0,35,5,13,0.385,4,9,0.444,1,4,0.25,6,7,0.857,1,6,7,0,2,2,1,2,17,13.6
D'Angelo Russell,21-008,G,3/3/17,LAL,BOS,1,30,7,12,0.583,5,7,0.714,2,5,0.4,1,2,0.5,1,2,3,4,1,1,3,1,17,13.4
Malcolm Brogdon,24-083,G,3/4/17,MIL,TOR,1,42,6,13,0.462,6,9,0.667,0,4,0,5,6,0.833,1,4,5,3,0,0,1,1,17,12.5
Kent Bazemore,27-169,G-F,12/17/16,ATL,CHO,0,30,7,13,0.538,6,9,0.667,1,4,0.25,2,2,1,2,2,4,5,0,1,2,2,17,14.1
Jusuf Nurkic,22-109,C,12/10/16,DEN,ORL,1,21,8,11,0.727,8,11,0.727,0,0,,1,2,0.5,1,7,8,0,0,1,4,1,17,11.2
Dwight Howard,30-358,C,11/30/16,ATL,PHO,1,33,8,10,0.8,8,10,0.8,0,0,,1,1,1,3,11,14,1,0,0,6,3,17,12.1
Jamal Crawford,36-239,G,11/14/16,LAC,BRK,0,22,5,10,0.5,2,5,0.4,3,5,0.6,4,4,1,0,0,0,5,1,0,1,0,17,15.5
Jae Crowder,26-238,F,3/1/17,BOS,CLE,1,33,5,10,0.5,2,5,0.4,3,5,0.6,4,4,1,0,10,10,2,1,0,0,3,17,16.2
Goran Dragic,30-249,G,1/10/17,MIA,GSW,1,38,7,16,0.438,5,11,0.455,2,5,0.4,1,1,1,0,2,2,4,1,0,3,2,17,9.2
Carmelo Anthony,32-177,F,11/22/16,NYK,POR,1,36,7,22,0.318,4,13,0.308,3,9,0.333,0,0,,2,4,6,0,1,1,1,3,17,6.5
Jahlil Okafor,20-365,C-F,12/14/16,PHI,TOR,1,30,6,9,0.667,6,9,0.667,0,0,,5,6,0.833,3,1,4,3,0,2,0,0,17,18.6
Gary Harris,22-105,G,12/28/16,DEN,MIN,1,29,7,12,0.583,5,7,0.714,2,5,0.4,1,1,1,1,3,4,1,0,0,2,0,17,11.7
JaVale McGee,28-331,C,12/15/16,GSW,NYK,1,16,8,10,0.8,8,10,0.8,0,0,,1,3,0.333,2,0,2,1,0,1,1,0,17,14.2
Myles Turner,21-002,F-C,3/26/17,IND,PHI,1,34,7,9,0.778,7,9,0.778,0,0,,3,4,0.75,4,12,16,1,1,2,1,2,17,20.8
Aaron Gordon,21-185,F,3/20/17,ORL,PHI,1,32,4,7,0.571,4,7,0.571,0,0,,9,11,0.818,0,3,3,4,0,1,2,6,17,12.9
Serge Ibaka,27-134,F-C,1/30/17,ORL,MIN,1,38,7,16,0.438,4,9,0.444,3,7,0.429,0,0,,4,6,10,2,1,2,2,4,17,13.4
Lou Williams,30-104,G,2/8/17,LAL,DET,0,21,4,10,0.4,4,5,0.8,0,5,0,9,9,1,0,1,1,2,2,0,2,2,17,12.5
J.J. Redick,32-175,G,12/16/16,LAC,MIA,1,29,5,16,0.313,3,7,0.429,2,9,0.222,5,6,0.833,0,1,1,1,0,0,0,0,17,8.4
Al Horford,30-173,C-F,11/23/16,BOS,BRK,1,30,7,12,0.583,4,8,0.5,3,4,0.75,0,0,,1,4,5,8,1,2,2,2,17,18.5
Dennis Schroder,23-142,G,2/4/17,ATL,ORL,1,26,6,11,0.545,4,6,0.667,2,5,0.4,3,4,0.75,0,4,4,10,2,0,2,1,17,19.1
Trevor Ariza,31-167,F,12/14/16,HOU,SAC,1,29,6,9,0.667,1,2,0.5,5,7,0.714,0,0,,0,3,3,1,3,0,0,1,17,17.3
Terrence Jones,24-319,F,11/23/16,NOP,MIN,0,24,7,10,0.7,7,9,0.778,0,1,0,3,4,0.75,1,6,7,1,1,1,1,1,17,15.9
Jae Crowder,26-154,F,12/7/16,BOS,ORL,1,30,6,10,0.6,5,7,0.714,1,3,0.333,4,5,0.8,1,9,10,2,0,0,1,3,17,14.6
Marcus Smart,22-321,G,1/21/17,BOS,POR,1,41,5,15,0.333,4,8,0.5,1,7,0.143,6,6,1,2,4,6,6,2,0,4,4,17,11.7
C.J. McCollum,25-075,G,12/3/16,POR,MIA,1,33,7,18,0.389,6,13,0.462,1,5,0.2,2,3,0.667,2,2,4,4,0,2,1,2,17,11.2
Jeff Teague,28-241,G,2/6/17,IND,OKC,1,34,6,16,0.375,4,12,0.333,2,4,0.5,3,4,0.75,0,4,4,3,1,1,2,1,17,10.4
Dennis Schroder,23-169,G,3/3/17,ATL,CLE,1,32,7,15,0.467,6,10,0.6,1,5,0.2,2,2,1,1,1,2,7,1,0,5,4,17,9.6
Kyrie Irving,24-299,G,1/16/17,CLE,GSW,1,29,6,19,0.316,5,14,0.357,1,5,0.2,4,5,0.8,0,2,2,2,1,1,6,3,17,2.2
Victor Oladipo,24-267,G,1/26/17,OKC,DAL,1,36,7,14,0.5,6,10,0.6,1,4,0.25,2,2,1,0,3,3,3,3,0,2,2,17,13.2
Brandon Knight,24-352,G,11/18/16,PHO,IND,0,22,6,14,0.429,3,9,0.333,3,5,0.6,2,2,1,0,0,0,5,1,0,2,4,17,10.5
Jeff Teague,28-296,G,4/2/17,IND,CLE,1,44,5,13,0.385,1,4,0.25,4,9,0.444,3,3,1,1,3,4,11,1,0,3,2,17,16.4
Mike Conley,29-127,G,2/15/17,MEM,NOP,1,33,5,16,0.313,2,6,0.333,3,10,0.3,4,6,0.667,0,2,2,4,0,1,4,1,17,6.7
Ramon Sessions,30-285,G,1/21/17,CHO,BRK,0,19,3,8,0.375,0,4,0,3,4,0.75,8,8,1,0,2,2,2,0,0,1,0,17,13.6
Malcolm Brogdon,24-080,G,3/1/17,MIL,DEN,1,34,7,16,0.438,5,13,0.385,2,3,0.667,1,1,1,1,1,2,3,3,0,1,1,17,13.3
Karl-Anthony Towns,21-036,C-F,12/21/16,MIN,ATL,1,37,7,16,0.438,7,13,0.538,0,3,0,3,4,0.75,4,14,18,5,0,1,6,3,17,12.2
Dirk Nowitzki,38-210,F,1/15/17,DAL,MIN,1,28,7,14,0.5,4,10,0.4,3,4,0.75,0,0,,0,6,6,2,0,3,1,1,17,13.9
Jordan Clarkson,24-306,G,4/9/17,LAL,MIN,1,31,7,13,0.538,6,9,0.667,1,4,0.25,2,2,1,0,4,4,3,0,0,2,2,17,11.2
Maurice Harkless,23-220,F-G,12/17/16,POR,GSW,1,30,7,15,0.467,4,8,0.5,3,7,0.429,0,0,,0,2,2,0,2,2,1,3,17,11.1
Jameer Nelson,34-354,G,1/28/17,DEN,PHO,1,33,4,9,0.444,2,3,0.667,2,6,0.333,7,8,0.875,0,3,3,6,1,0,2,5,17,14
Chris Paul,31-294,G,2/24/17,LAC,SAS,1,33,6,14,0.429,4,11,0.364,2,3,0.667,3,4,0.75,0,6,6,5,2,0,4,4,17,10.9
Jae Crowder,26-145,F,11/28/16,BOS,MIA,1,32,6,11,0.545,4,7,0.571,2,4,0.5,3,3,1,0,4,4,3,2,0,0,3,17,15.8
Garrett Temple,30-213,G,12/7/16,SAC,DAL,0,27,5,6,0.833,1,2,0.5,4,4,1,3,4,0.75,0,3,3,3,0,0,1,5,17,14.4
Paul Millsap,31-307,F,12/13/16,ATL,ORL,1,34,6,12,0.5,4,7,0.571,2,5,0.4,3,3,1,1,8,9,5,2,1,3,4,17,15.7
Ivica Zubac,20-003,C,3/21/17,LAL,LAC,1,36,8,14,0.571,8,14,0.571,0,0,,1,2,0.5,1,6,7,3,1,1,1,5,17,13.3
Enes Kanter,24-313,C,3/29/17,OKC,ORL,0,20,6,11,0.545,6,11,0.545,0,0,,5,6,0.833,0,10,10,0,0,0,2,1,17,11.9
Jeremy Lin,28-115,G,12/16/16,BRK,ORL,0,20,7,13,0.538,6,11,0.545,1,2,0.5,2,2,1,0,3,3,3,0,0,1,1,17,12.3
Shabazz Muhammad,24-115,F-G,3/8/17,MIN,LAC,1,26,7,13,0.538,7,12,0.583,0,1,0,3,4,0.75,3,3,6,0,1,0,3,1,17,10.9
Gorgui Dieng,26-288,C,11/1/16,MIN,MEM,1,34,8,9,0.889,8,9,0.889,0,0,,1,2,0.5,1,5,6,2,3,2,2,3,17,18.3
Devin Booker,20-124,G,3/3/17,PHO,OKC,1,33,5,13,0.385,3,6,0.5,2,7,0.286,5,6,0.833,0,7,7,3,0,1,6,2,17,7.6
Bobby Portis,22-042,F,3/24/17,CHI,PHI,0,22,8,11,0.727,7,10,0.7,1,1,1,0,0,,4,7,11,1,0,2,1,4,17,16.9
C.J. McCollum,25-057,G,11/15/16,POR,CHI,1,33,7,17,0.412,4,11,0.364,3,6,0.5,0,0,,1,3,4,3,1,0,3,3,17,8.4
Klay Thompson,26-319,G,12/23/16,GSW,DET,1,37,6,14,0.429,3,6,0.5,3,8,0.375,2,2,1,0,3,3,2,1,0,3,0,17,9.9
Dwyane Wade,34-318,G,11/30/16,CHI,LAL,1,30,7,15,0.467,7,14,0.5,0,1,0,3,4,0.75,1,3,4,6,2,0,5,3,17,10.5
Richaun Holmes,23-175,F-C,4/8/17,PHI,MIL,1,36,6,11,0.545,3,7,0.429,3,4,0.75,2,2,1,2,8,10,0,0,1,4,3,17,11
DeMarre Carroll,30-126,F,11/30/16,TOR,MEM,1,29,6,11,0.545,3,4,0.75,3,7,0.429,2,4,0.5,0,0,0,1,0,0,0,4,17,10
Julius Randle,21-352,F,11/15/16,LAL,BRK,1,31,5,8,0.625,5,8,0.625,0,0,,7,10,0.7,1,13,14,10,0,0,3,1,17,20.4
Victor Oladipo,24-187,G,11/7/16,OKC,MIA,1,33,6,9,0.667,5,7,0.714,1,2,0.5,4,4,1,0,2,2,2,0,0,1,1,17,13.7
Courtney Lee,31-124,G,2/4/17,NYK,CLE,1,30,7,11,0.636,4,6,0.667,3,5,0.6,0,2,0,2,2,4,0,0,1,2,1,17,11.6
Bojan Bogdanovic,27-326,G-F,3/10/17,WAS,SAC,0,30,7,16,0.438,7,11,0.636,0,5,0,3,4,0.75,2,0,2,1,1,0,1,4,17,8.7
Michael Beasley,27-325,F,11/29/16,MIL,CLE,0,26,7,10,0.7,6,9,0.667,1,1,1,2,2,1,1,1,2,2,2,0,2,3,17,14
Davis Bertans,24-076,F,1/27/17,SAS,NOP,0,20,6,9,0.667,1,2,0.5,5,7,0.714,0,0,,0,1,1,0,1,1,0,2,17,14.3
Reggie Jackson,26-251,G,12/23/16,DET,GSW,1,30,7,17,0.412,7,13,0.538,0,4,0,3,4,0.75,0,3,3,6,1,0,5,2,17,7.8
James Johnson,29-273,F,11/19/16,MIA,WAS,0,27,7,8,0.875,5,5,1,2,3,0.667,1,3,0.333,2,1,3,1,1,2,2,0,17,16.2
Jeff Teague,28-273,G,3/10/17,IND,MIL,1,35,7,12,0.583,6,10,0.6,1,2,0.5,2,2,1,0,4,4,4,3,0,7,4,17,9.8
Kemba Walker,26-220,G,12/14/16,CHO,WAS,1,36,7,15,0.467,4,7,0.571,3,8,0.375,0,0,,1,5,6,9,0,0,3,3,17,13.6
Goran Dragic,30-264,G,1/25/17,MIA,BRK,1,39,6,16,0.375,5,13,0.385,1,3,0.333,4,5,0.8,3,6,9,9,2,0,3,1,17,16.6
Evan Turner,28-027,G,11/23/16,POR,CLE,0,33,7,13,0.538,5,9,0.556,2,4,0.5,1,1,1,0,1,1,3,1,1,2,2,17,12
Enes Kanter,24-250,C,1/25/17,OKC,NOP,0,21,6,13,0.462,6,13,0.462,0,0,,5,5,1,3,8,11,2,0,0,1,1,17,14.8
Malcolm Delaney,27-308,G,1/13/17,ATL,BOS,0,27,6,12,0.5,3,8,0.375,3,4,0.75,2,2,1,0,4,4,6,0,0,1,2,17,14.6
Chris Paul,31-341,G,4/12/17,LAC,SAC,1,35,6,12,0.5,3,7,0.429,3,5,0.6,2,2,1,1,4,5,9,2,0,1,1,17,19.8
Pau Gasol,36-233,F-C,2/24/17,SAS,LAC,0,27,5,7,0.714,2,4,0.5,3,3,1,4,4,1,5,7,12,2,0,1,2,3,17,18.6
Emmanuel Mudiay,21-028,G,4/2/17,DEN,MIA,0,32,4,9,0.444,4,9,0.444,0,0,,9,10,0.9,0,4,4,9,0,1,2,2,17,17.3
Evan Fournier,24-003,G-F,11/1/16,ORL,PHI,1,37,6,17,0.353,3,11,0.273,3,6,0.5,2,2,1,0,5,5,5,1,0,2,2,17,10.7
Isaiah Canaan,25-183,G,11/20/16,CHI,LAL,0,31,6,10,0.6,3,4,0.75,3,6,0.5,2,2,1,0,2,2,0,2,0,3,0,17,12
Marquese Chriss,19-243,F,3/2/17,PHO,CHO,1,22,6,9,0.667,3,5,0.6,3,4,0.75,2,2,1,0,1,1,1,0,0,1,3,17,11.9
Nikola Mirotic,25-265,F,11/2/16,CHI,BOS,0,35,3,6,0.5,0,0,,3,6,0.5,8,11,0.727,0,6,6,1,0,1,2,1,17,13.6
Kemba Walker,26-201,G,11/25/16,CHO,NYK,1,32,7,16,0.438,7,11,0.636,0,5,0,3,5,0.6,1,4,5,3,4,0,3,3,17,11.6
Nikola Jokic,21-293,C-F,12/8/16,DEN,WAS,0,28,6,10,0.6,6,10,0.6,0,0,,5,7,0.714,7,4,11,1,0,1,4,1,17,14.7
Allen Crabbe,24-355,G-F,3/30/17,POR,HOU,0,32,7,11,0.636,4,6,0.667,3,5,0.6,0,0,,0,2,2,2,4,0,0,3,17,16.9
Kyle Lowry,30-217,G,10/28/16,TOR,CLE,1,39,5,16,0.313,4,11,0.364,1,5,0.2,6,7,0.857,0,2,2,4,0,0,6,4,17,3.2
Brandon Knight,25-034,G,1/5/17,PHO,DAL,0,26,6,11,0.545,5,10,0.5,1,1,1,4,4,1,2,0,2,2,1,0,0,3,17,14.3
Thaddeus Young,28-192,F,12/30/16,IND,CHI,1,36,7,11,0.636,7,11,0.636,0,0,,3,4,0.75,2,4,6,2,0,0,1,3,17,13.5
Ersan Ilyasova,29-255,F,1/25/17,PHI,MIL,1,27,6,14,0.429,3,9,0.333,3,5,0.6,2,4,0.5,1,8,9,2,1,0,2,0,17,12.3
C.J. McCollum,25-160,G,2/26/17,POR,TOR,1,35,6,19,0.316,5,16,0.313,1,3,0.333,4,6,0.667,1,2,3,1,0,0,0,4,17,5.7
C.J. Miles,29-312,G-F,2/24/17,IND,MEM,1,22,6,10,0.6,1,1,1,5,9,0.556,0,0,,0,4,4,1,2,2,1,2,17,15.9
Maurice Harkless,23-186,F-G,11/13/16,POR,DEN,1,33,6,11,0.545,4,7,0.571,2,4,0.5,3,4,0.75,1,5,6,0,0,2,0,2,17,14.1
Marreese Speights,29-128,C-F,12/10/16,LAC,NOP,0,25,7,12,0.583,4,6,0.667,3,6,0.5,0,0,,2,10,12,4,0,0,1,4,17,16
Montrezl Harrell,22-330,F-C,12/21/16,HOU,PHO,1,28,8,11,0.727,8,11,0.727,0,0,,1,2,0.5,0,3,3,3,0,3,3,2,17,13.4
Luol Deng,31-292,F,2/2/17,LAL,WAS,1,32,6,11,0.545,3,4,0.75,3,7,0.429,2,2,1,3,3,6,0,0,1,1,1,17,14
Giannis Antetokounmpo,22-050,F-G,1/25/17,MIL,PHI,1,39,7,19,0.368,7,12,0.583,0,7,0,3,3,1,6,6,12,5,4,0,2,0,17,18
Tyler Johnson,24-200,G,11/23/16,MIA,DET,0,32,5,13,0.385,5,10,0.5,0,3,0,7,9,0.778,0,2,2,7,1,1,1,0,17,15.3
Andrew Wiggins,22-033,F-G,3/28/17,MIN,IND,1,39,6,17,0.353,4,13,0.308,2,4,0.5,3,4,0.75,2,3,5,1,0,1,4,2,17,6
J.J. Barea,32-280,G,4/2/17,DAL,MIL,0,23,7,11,0.636,4,7,0.571,3,4,0.75,0,0,,0,2,2,6,0,0,5,1,17,11.5
Alex Len,23-160,C,11/23/16,PHO,ORL,1,35,6,10,0.6,6,10,0.6,0,0,,5,6,0.833,4,8,12,0,0,2,3,2,17,14.8
Darren Collison,29-158,G,1/28/17,SAC,CHO,1,35,7,11,0.636,5,5,1,2,6,0.333,1,1,1,0,0,0,2,0,1,2,4,17,10.6
Jrue Holiday,26-294,G,4/2/17,NOP,CHI,1,39,5,12,0.417,3,8,0.375,2,4,0.5,5,5,1,0,1,1,6,0,1,1,2,17,14
Yogi Ferrell,23-305,G,3/10/17,DAL,BRK,1,34,5,12,0.417,2,7,0.286,3,5,0.6,4,4,1,1,1,2,2,1,0,1,3,17,11.8
Nikola Vucevic,26-084,C,1/16/17,ORL,DEN,1,28,8,13,0.615,8,12,0.667,0,1,0,1,1,1,1,3,4,2,1,1,1,3,17,13.6
Dario Saric,22-242,F,12/6/16,PHI,MEM,0,25,6,12,0.5,3,6,0.5,3,6,0.5,2,3,0.667,2,5,7,0,1,0,2,4,17,10.9
Myles Turner,20-285,F-C,1/3/17,IND,DET,1,36,7,12,0.583,5,10,0.5,2,2,1,1,2,0.5,2,5,7,1,2,2,1,3,17,15.8
Thaddeus Young,28-166,F,12/4/16,IND,LAC,1,30,7,13,0.538,7,13,0.538,0,0,,3,4,0.75,2,5,7,2,0,1,0,4,17,13.7
Brandon Knight,25-055,G,1/26/17,PHO,DEN,0,29,8,11,0.727,7,9,0.778,1,2,0.5,0,0,,0,1,1,4,0,1,2,0,17,14.3
Greg Monroe,26-277,C-F,3/8/17,MIL,NYK,0,29,6,14,0.429,6,14,0.429,0,0,,5,7,0.714,2,6,8,3,0,1,1,4,17,12.2
Ryan Anderson,28-285,F,2/15/17,HOU,MIA,1,31,6,16,0.375,1,6,0.167,5,10,0.5,0,0,,4,2,6,1,0,0,0,3,17,11.1
Aaron Gordon,21-182,F,3/17/17,ORL,PHO,1,34,7,12,0.583,6,9,0.667,1,3,0.333,2,2,1,0,4,4,0,1,4,2,2,17,13.6
Enes Kanter,24-319,C,4/4/17,OKC,MIL,0,15,6,8,0.75,6,8,0.75,0,0,,5,5,1,2,3,5,0,3,0,2,3,17,15.9
Danilo Gallinari,28-134,F,12/20/16,DEN,LAC,1,32,6,11,0.545,2,3,0.667,4,8,0.5,1,2,0.5,1,4,5,2,0,0,1,1,17,13.2
Maurice Harkless,23-323,F-G,3/30/17,POR,HOU,1,32,8,13,0.615,7,11,0.636,1,2,0.5,0,0,,4,2,6,0,2,3,0,0,17,18.6
Jameer Nelson,34-295,G,11/30/16,DEN,MIA,1,38,5,14,0.357,2,9,0.222,3,5,0.6,4,6,0.667,1,4,5,8,0,0,0,4,17,14.3
Dirk Nowitzki,38-287,F,4/2/17,DAL,MIL,1,26,7,11,0.636,4,5,0.8,3,6,0.5,0,0,,0,5,5,1,0,1,0,1,17,14.6
LaMarcus Aldridge,31-233,F-C,3/9/17,SAS,OKC,1,32,8,14,0.571,8,13,0.615,0,1,0,1,2,0.5,4,2,6,1,0,0,1,3,17,11.9
Myles Turner,20-233,F-C,11/12/16,IND,BOS,1,30,6,8,0.75,6,7,0.857,0,1,0,5,5,1,2,6,8,1,4,3,4,2,17,19
Eric Bledsoe,27-036,G,1/14/17,PHO,SAS,1,38,5,17,0.294,4,14,0.286,1,3,0.333,6,8,0.75,2,4,6,10,1,0,3,2,17,13.1
Thaddeus Young,28-209,F,1/16/17,IND,NOP,1,37,8,9,0.889,8,9,0.889,0,0,,1,1,1,0,3,3,2,6,0,0,2,17,21.4
Nikola Jokic,22-037,C-F,3/28/17,DEN,POR,1,36,7,14,0.5,6,8,0.75,1,6,0.167,2,2,1,3,5,8,8,0,2,3,4,17,16
Kyle Korver,35-228,G-F,10/31/16,ATL,SAC,1,32,6,11,0.545,1,3,0.333,5,8,0.625,0,0,,0,0,0,0,1,0,2,1,17,10.3
Tyler Johnson,24-318,G,3/21/17,MIA,PHO,0,29,7,17,0.412,5,14,0.357,2,3,0.667,1,2,0.5,1,5,6,4,5,0,2,3,17,14.3
Pau Gasol,36-268,F-C,3/31/17,SAS,OKC,0,28,5,10,0.5,3,8,0.375,2,2,1,5,6,0.833,1,3,4,4,0,2,1,3,17,15.2
Kemba Walker,26-275,G,2/7/17,CHO,BRK,1,35,4,20,0.2,3,16,0.188,1,4,0.25,8,9,0.889,1,2,3,5,0,0,1,2,17,7.2
Rudy Gobert,24-288,C,4/10/17,UTA,GSW,1,33,7,12,0.583,7,12,0.583,0,0,,3,5,0.6,6,12,18,0,0,2,1,4,17,17.2
Harrison Barnes,24-279,F,3/5/17,DAL,OKC,1,34,5,14,0.357,5,11,0.455,0,3,0,7,8,0.875,3,2,5,3,0,0,0,1,17,13.2
Alexis Ajinca,28-337,C,4/8/17,NOP,GSW,1,29,8,14,0.571,8,14,0.571,0,0,,1,1,1,1,5,6,1,0,0,0,5,17,11.3
Rudy Gay,30-071,F,10/27/16,SAC,SAS,1,32,3,10,0.3,2,7,0.286,1,3,0.333,10,12,0.833,0,7,7,2,2,0,1,4,17,13.3
Kawhi Leonard,25-135,F,11/11/16,SAS,DET,1,37,5,18,0.278,1,13,0.077,4,5,0.8,3,3,1,0,4,4,1,4,0,2,1,17,9.9
George Hill,30-265,G,1/24/17,UTA,DEN,1,35,6,18,0.333,5,12,0.417,1,6,0.167,4,4,1,0,3,3,5,1,0,1,2,17,10.4
Tyler Johnson,24-280,G,2/11/17,MIA,PHI,0,32,6,13,0.462,5,9,0.556,1,4,0.25,4,4,1,0,3,3,5,1,0,1,5,17,12.7
Stanley Johnson,20-283,F,3/8/17,DET,IND,0,28,7,12,0.583,4,6,0.667,3,6,0.5,0,0,,2,3,5,2,1,1,1,2,17,15
Nemanja Bjelica,28-207,F,12/2/16,MIN,NYK,0,21,7,13,0.538,4,6,0.667,3,7,0.429,0,0,,2,5,7,3,0,0,1,1,17,14.3
Josh Richardson,23-195,G,3/29/17,MIA,NYK,1,35,7,12,0.583,4,5,0.8,3,7,0.429,0,0,,0,1,1,1,5,1,3,0,17,15.1
Marcus Morris,27-056,F,10/28/16,DET,ORL,1,29,7,14,0.5,5,9,0.556,2,5,0.4,1,1,1,1,7,8,3,0,0,2,0,17,12.9
Andrew Wiggins,22-009,F-G,3/4/17,MIN,SAS,1,44,6,24,0.25,6,22,0.273,0,2,0,5,6,0.833,0,4,4,2,0,0,3,5,17,-0.2
Jeremy Lamb,24-210,G-F,12/26/16,CHO,BRK,0,22,7,14,0.5,5,8,0.625,2,6,0.333,1,3,0.333,1,3,4,1,0,1,0,3,17,11
Rudy Gobert,24-178,C,12/21/16,UTA,SAC,1,35,6,9,0.667,6,9,0.667,0,0,,5,7,0.714,2,12,14,1,1,3,0,4,17,19.5
Enes Kanter,24-159,C,10/26/16,OKC,PHI,0,24,7,14,0.5,7,14,0.5,0,0,,3,4,0.75,5,7,12,0,1,1,0,3,17,15.7
Myles Turner,20-329,F-C,2/16/17,IND,WAS,1,37,6,13,0.462,6,12,0.5,0,1,0,5,7,0.714,3,6,9,1,2,1,2,3,17,13.6
Jordan Clarkson,24-302,G,4/5/17,LAL,SAS,1,28,7,17,0.412,6,12,0.5,1,5,0.2,2,2,1,1,5,6,2,0,0,5,2,17,5.7
Dwight Howard,31-081,C,2/27/17,ATL,BOS,1,27,6,11,0.545,6,11,0.545,0,0,,5,9,0.556,6,6,12,1,0,2,2,1,17,15.8
Clint Capela,22-254,F-C,1/27/17,HOU,PHI,0,21,7,11,0.636,7,11,0.636,0,0,,3,3,1,2,4,6,0,2,1,4,3,17,12.2
Matthew Dellavedova,26-090,G,12/7/16,MIL,POR,1,24,7,11,0.636,4,6,0.667,3,5,0.6,0,0,,1,3,4,1,0,0,2,2,17,11.6
Nikola Vucevic,26-002,C,10/26/16,ORL,MIA,1,36,7,14,0.5,7,14,0.5,0,0,,3,4,0.75,5,9,14,3,2,0,1,3,17,17.7
Dennis Schroder,23-083,G,12/7/16,ATL,MIA,1,31,8,15,0.533,7,13,0.538,1,2,0.5,0,0,,1,3,4,7,1,1,3,2,17,14.1
Michael Beasley,28-019,F,1/28/17,MIL,BOS,0,22,7,10,0.7,6,9,0.667,1,1,1,2,2,1,0,8,8,1,0,0,2,2,17,13.1
Buddy Hield,23-055,G,2/10/17,NOP,MIN,1,22,7,10,0.7,5,6,0.833,2,4,0.5,1,1,1,0,4,4,1,0,0,1,3,17,12.5
Nick Young,31-179,G-F,11/27/16,LAL,ATL,1,23,6,12,0.5,2,7,0.286,4,5,0.8,1,1,1,1,0,1,0,1,0,0,2,17,11.9
Michael Kidd-Gilchrist,23-117,F,1/21/17,CHO,BRK,1,35,7,11,0.636,7,11,0.636,0,0,,3,4,0.75,6,8,14,1,0,2,2,3,17,17.2
Tim Frazier,26-018,G,11/19/16,NOP,CHO,1,36,6,12,0.5,5,7,0.714,1,5,0.2,4,4,1,0,5,5,8,1,0,0,3,17,17.9
Taurean Waller-Prince,22-354,F,3/11/17,ATL,MEM,0,31,5,6,0.833,2,2,1,3,4,0.75,4,4,1,0,3,3,2,2,2,2,0,17,18.5
Blake Griffin,27-350,F,3/1/17,LAC,HOU,1,35,7,17,0.412,6,13,0.462,1,4,0.25,2,5,0.4,3,1,4,5,0,0,3,4,17,8
Dario Saric,22-292,F,1/25/17,PHI,MIL,0,21,7,14,0.5,6,10,0.6,1,4,0.25,2,2,1,2,1,3,0,0,0,0,2,17,10.9
Norman Powell,23-280,G,3/1/17,TOR,WAS,0,16,5,12,0.417,4,8,0.5,1,4,0.25,6,8,0.75,0,2,2,2,0,0,0,3,17,10.6
Hassan Whiteside,27-182,C,12/12/16,MIA,WAS,1,34,7,14,0.5,7,14,0.5,0,0,,3,6,0.5,3,13,16,0,1,2,0,0,17,17.2
Dwight Powell,25-136,F-C,12/3/16,DAL,CHI,0,28,7,11,0.636,7,11,0.636,0,0,,3,4,0.75,3,4,7,1,0,0,1,3,17,13.5
Kemba Walker,26-171,G,10/26/16,CHO,MIL,1,35,5,15,0.333,2,8,0.25,3,7,0.429,4,6,0.667,0,1,1,8,2,0,2,2,17,12.8
Kent Bazemore,27-187,G-F,1/4/17,ATL,ORL,1,27,6,9,0.667,3,6,0.5,3,3,1,2,2,1,0,0,0,4,2,0,0,2,17,17.1
Nikola Jokic,21-285,C-F,11/30/16,DEN,MIA,0,24,7,11,0.636,7,11,0.636,0,0,,3,4,0.75,3,11,14,3,1,0,1,3,17,18
J.J. Redick,32-177,G,12/18/16,LAC,WAS,1,25,7,14,0.5,5,8,0.625,2,6,0.333,1,2,0.5,0,1,1,0,0,0,0,2,17,9.1
Brook Lopez,28-240,C,11/27/16,BRK,SAC,1,30,5,15,0.333,2,7,0.286,3,8,0.375,4,4,1,1,6,7,2,0,0,2,2,17,9.6
Carmelo Anthony,32-276,F,3/1/17,NYK,ORL,1,39,4,16,0.25,2,9,0.222,2,7,0.286,7,8,0.875,0,8,8,2,2,0,2,2,17,10
Malcolm Brogdon,24-062,G,2/11/17,MIL,IND,0,36,5,14,0.357,3,8,0.375,2,6,0.333,5,6,0.833,0,3,3,3,0,0,0,2,17,11
Trevor Ariza,31-163,F,12/10/16,HOU,DAL,1,33,6,11,0.545,2,3,0.667,4,8,0.5,1,2,0.5,0,7,7,1,0,0,2,0,17,12.1
Jusuf Nurkic,22-193,C,3/4/17,POR,BRK,1,30,6,11,0.545,6,11,0.545,0,0,,5,8,0.625,1,5,6,5,1,0,3,3,17,13
George Hill,30-327,G,3/27/17,UTA,NOP,1,33,7,14,0.5,4,8,0.5,3,6,0.5,0,0,,0,2,2,5,1,0,3,3,17,10.9
Eric Gordon,28-037,G,1/31/17,HOU,SAC,0,28,7,15,0.467,4,5,0.8,3,10,0.3,0,0,,2,3,5,1,0,0,1,1,17,10.9
Terrence Ross,26-000,F-G,2/5/17,TOR,BRK,0,26,7,11,0.636,4,7,0.571,3,4,0.75,0,0,,1,2,3,2,0,1,1,0,17,14.5
Danilo Gallinari,28-114,F,11/30/16,DEN,MIA,1,36,6,16,0.375,5,11,0.455,1,5,0.2,4,6,0.667,0,4,4,4,0,1,2,3,17,8.9
Julius Randle,22-012,F,12/11/16,LAL,NYK,1,34,7,12,0.583,7,12,0.583,0,0,,3,4,0.75,2,8,10,4,0,0,1,4,17,15
J.J. Barea,32-141,G,11/14/16,DAL,NYK,1,33,8,16,0.5,7,11,0.636,1,5,0.2,0,0,,0,1,1,4,0,0,0,0,17,12.1
Dario Saric,22-283,F,1/16/17,PHI,MIL,0,24,6,11,0.545,4,6,0.667,2,5,0.4,3,3,1,2,7,9,4,1,0,3,1,17,15.6
Jordan Clarkson,24-181,G,12/5/16,LAL,UTA,0,38,7,13,0.538,6,11,0.545,1,2,0.5,2,2,1,1,4,5,0,0,0,3,1,17,9.2
Al Horford,30-273,C-F,3/3/17,BOS,LAL,1,32,8,12,0.667,7,10,0.7,1,2,0.5,0,0,,0,4,4,3,0,0,0,1,17,14.7
Jae Crowder,26-202,F,1/24/17,BOS,WAS,1,34,6,8,0.75,3,3,1,3,5,0.6,2,2,1,1,5,6,3,1,0,2,3,17,15.9
Langston Galloway,25-113,G,4/1/17,SAC,MIN,0,15,6,7,0.857,3,3,1,3,4,0.75,2,2,1,1,2,3,0,0,0,0,0,17,15.8
Will Barton,25-346,G,12/17/16,DEN,NYK,0,32,6,10,0.6,4,7,0.571,2,3,0.667,3,5,0.6,0,8,8,2,2,1,2,1,17,15.7
Shelvin Mack,26-206,G,11/14/16,UTA,MEM,0,28,7,9,0.778,5,6,0.833,2,3,0.667,1,2,0.5,2,1,3,4,0,0,1,2,17,15.8
Jeff Teague,28-193,G,12/20/16,IND,NYK,1,37,5,13,0.385,5,10,0.5,0,3,0,7,9,0.778,1,6,7,12,1,1,1,1,17,20.3
Jamal Murray,20-013,G,3/8/17,DEN,WAS,0,24,7,15,0.467,4,10,0.4,3,5,0.6,0,0,,0,3,3,5,0,0,1,3,17,11.5
Pau Gasol,36-183,F-C,1/5/17,SAS,DEN,1,35,7,8,0.875,6,7,0.857,1,1,1,2,3,0.667,1,8,9,4,0,2,1,3,17,18.9
Kent Bazemore,27-134,G-F,11/12/16,ATL,PHI,1,28,8,13,0.615,7,10,0.7,1,3,0.333,0,0,,1,4,5,1,3,2,3,0,17,15.1
Stephen Curry,28-271,G,12/10/16,GSW,MEM,1,31,4,14,0.286,1,3,0.333,3,11,0.273,6,6,1,2,6,8,3,0,0,4,3,17,8.9
Wesley Matthews,30-107,G,1/29/17,DAL,SAS,1,31,6,10,0.6,4,5,0.8,2,5,0.4,3,4,0.75,0,7,7,3,2,0,1,2,17,16.4
Nick Young,31-174,G-F,11/22/16,LAL,OKC,1,29,6,12,0.5,2,5,0.4,4,7,0.571,1,2,0.5,1,1,2,1,0,2,3,3,17,9.5
D'Angelo Russell,20-255,G,11/4/16,LAL,GSW,1,22,5,11,0.455,2,4,0.5,3,7,0.429,4,4,1,0,2,2,4,1,0,1,2,17,13.9
Ty Lawson,29-064,G,1/6/17,SAC,LAC,1,37,6,12,0.5,6,9,0.667,0,3,0,5,6,0.833,0,4,4,6,1,0,2,1,17,14.6
Mike Conley,29-085,G,1/4/17,MEM,LAC,1,36,5,16,0.313,4,11,0.364,1,5,0.2,6,7,0.857,3,4,7,12,0,0,3,5,17,14.1
Jae Crowder,26-174,F,12/27/16,BOS,MEM,1,32,6,9,0.667,3,4,0.75,3,5,0.6,2,2,1,0,7,7,0,0,1,2,2,17,13.1
Mike Conley,29-076,G,12/26/16,MEM,ORL,1,27,6,8,0.75,6,7,0.857,0,1,0,5,5,1,0,2,2,4,0,0,3,1,17,13.8
Terrence Ross,26-054,F-G,3/31/17,ORL,BOS,1,38,5,13,0.385,1,4,0.25,4,9,0.444,3,3,1,0,3,3,1,2,1,4,4,17,8.6
Karl-Anthony Towns,21-120,C-F,3/15/17,MIN,BOS,1,40,7,14,0.5,6,9,0.667,1,5,0.2,2,2,1,4,10,14,4,0,0,2,3,17,15.4
Terrence Jones,24-318,F,11/22/16,NOP,ATL,0,28,7,13,0.538,7,11,0.636,0,2,0,3,4,0.75,0,6,6,1,1,1,0,2,17,13.7
Hassan Whiteside,27-279,C,3/19/17,MIA,POR,1,31,8,15,0.533,8,15,0.533,0,0,,1,2,0.5,5,5,10,2,0,3,1,5,17,14.8
Joffrey Lauvergne,25-173,C-F,3/22/17,CHI,DET,1,28,7,13,0.538,6,10,0.6,1,3,0.333,2,4,0.5,1,6,7,3,1,0,1,2,17,13.7
Willy Hernangomez,22-204,C,12/17/16,NYK,DEN,0,28,5,8,0.625,5,8,0.625,0,0,,7,8,0.875,2,8,10,2,0,2,1,4,17,17
Paul Millsap,31-332,F,1/7/17,ATL,DAL,1,39,3,10,0.3,3,8,0.375,0,2,0,11,13,0.846,0,9,9,6,2,0,2,1,17,16.9
Klay Thompson,26-333,G,1/6/17,GSW,MEM,1,42,7,17,0.412,5,11,0.455,2,6,0.333,1,3,0.333,3,3,6,2,0,0,0,1,17,11.1
Kelly Oubre,21-030,F,1/8/17,WAS,MIL,0,25,7,14,0.5,4,7,0.571,3,7,0.429,0,0,,3,2,5,1,1,0,1,4,17,11.8
Nicolas Batum,28-055,F-G,2/7/17,CHO,BRK,1,38,7,18,0.389,5,12,0.417,2,6,0.333,1,2,0.5,1,7,8,4,4,2,2,1,17,15.4
Dion Waiters,25-038,G,1/17/17,MIA,HOU,1,28,7,15,0.467,6,11,0.545,1,4,0.25,2,3,0.667,2,3,5,3,1,0,2,3,17,11.1
Kyle Lowry,31-015,G,4/9/17,TOR,NYK,1,38,5,10,0.5,1,1,1,4,9,0.444,3,3,1,0,7,7,11,3,1,4,0,17,21.5
Nene Hilario,34-194,F-C,3/26/17,HOU,OKC,0,26,7,9,0.778,7,8,0.875,0,1,0,3,4,0.75,0,4,4,3,2,1,1,1,17,17.7
J.J. Redick,32-223,G,2/2/17,LAC,GSW,1,37,6,14,0.429,2,4,0.5,4,10,0.4,1,1,1,0,2,2,3,2,1,2,1,17,12.6
Darren Collison,29-195,G,3/6/17,SAC,DEN,1,26,6,11,0.545,5,10,0.5,1,1,1,4,4,1,0,1,1,5,0,0,1,1,17,14.1
Marc Gasol,32-012,C,2/10/17,MEM,GSW,1,36,4,14,0.286,3,9,0.333,1,5,0.2,8,10,0.8,1,5,6,7,1,1,4,5,17,10.8
D'Angelo Russell,20-293,G,12/12/16,LAL,SAC,1,20,6,10,0.6,3,6,0.5,3,4,0.75,2,2,1,1,1,2,4,0,0,3,0,17,13.2
Kevin Love,28-121,F,1/6/17,CLE,BRK,1,36,5,16,0.313,1,7,0.143,4,9,0.444,3,3,1,3,10,13,2,0,0,4,2,17,9.5
Greg Monroe,26-233,C-F,1/23/17,MIL,HOU,0,27,7,13,0.538,7,12,0.583,0,1,0,3,4,0.75,2,8,10,1,3,0,2,3,17,14.6
Andre Drummond,23-200,C,2/26/17,DET,BOS,1,36,8,13,0.615,8,13,0.615,0,0,,1,11,0.091,2,13,15,0,2,0,3,2,17,10.6
Derrick Rose,28-169,G,3/22/17,NYK,UTA,1,32,7,12,0.583,7,12,0.583,0,0,,3,3,1,0,1,1,6,0,0,3,0,17,12.9
Pau Gasol,36-161,F-C,12/14/16,SAS,BOS,1,35,7,12,0.583,6,10,0.6,1,2,0.5,2,2,1,1,12,13,6,2,1,0,0,17,22.6
Jonas Valanciunas,24-282,C,2/12/17,TOR,DET,1,34,7,14,0.5,7,14,0.5,0,0,,3,4,0.75,2,7,9,0,0,0,1,3,17,10.9
Dario Saric,22-241,F,12/5/16,PHI,DEN,0,25,6,12,0.5,3,6,0.5,3,6,0.5,2,3,0.667,1,7,8,0,1,0,2,2,17,11.6
Kyle Lowry,30-243,G,11/23/16,TOR,HOU,1,36,6,15,0.4,4,8,0.5,2,7,0.286,3,4,0.75,1,0,1,9,1,0,3,3,17,12.3
Harrison Barnes,24-158,F,11/4/16,DAL,POR,1,35,8,17,0.471,7,13,0.538,1,4,0.25,0,0,,2,8,10,0,0,0,2,3,17,8.9
Arron Afflalo,31-141,G,3/5/17,SAC,UTA,1,40,6,12,0.5,5,10,0.5,1,2,0.5,4,4,1,1,3,4,3,0,0,0,2,17,13.9
Chris Paul,31-302,G,3/4/17,LAC,CHI,1,33,7,14,0.5,5,10,0.5,2,4,0.5,1,2,0.5,0,2,2,4,2,1,1,2,17,13.9
Zach Randolph,35-195,F,1/27/17,MEM,POR,0,31,8,11,0.727,8,10,0.8,0,1,0,1,2,0.5,4,9,13,3,1,0,1,1,17,19.3
Gary Harris,22-107,G,12/30/16,DEN,PHI,1,34,5,12,0.417,3,6,0.5,2,6,0.333,5,6,0.833,1,3,4,4,1,0,3,2,17,11.8
Eric Gordon,28-106,G,4/10/17,HOU,LAC,1,24,5,13,0.385,3,6,0.5,2,7,0.286,5,5,1,0,5,5,0,0,1,0,3,17,10.9
Myles Turner,20-248,F-C,11/27/16,IND,LAC,1,25,8,16,0.5,7,13,0.538,1,3,0.333,0,0,,3,9,12,3,0,1,1,3,17,14.4
Derrick Williams,25-198,F,12/9/16,MIA,CLE,0,31,6,11,0.545,6,9,0.667,0,2,0,5,7,0.714,1,1,2,1,2,0,0,2,17,13.8
Klay Thompson,26-316,G,12/20/16,GSW,UTA,1,31,8,13,0.615,7,10,0.7,1,3,0.333,0,0,,0,5,5,1,1,0,1,0,17,13.3
Jake Layman,22-239,F,11/1/16,POR,GSW,0,8,6,8,0.75,1,1,1,5,7,0.714,0,0,,0,1,1,1,1,0,0,0,17,15.8
Marquese Chriss,19-256,F,3/15/17,PHO,SAC,1,32,6,14,0.429,4,6,0.667,2,8,0.25,3,7,0.429,2,5,7,2,2,5,3,5,17,12.8
Paul Millsap,32-017,F,2/27/17,ATL,BOS,1,32,7,18,0.389,7,15,0.467,0,3,0,3,3,1,0,10,10,4,2,0,3,3,17,10.8
Trevor Ariza,31-192,F,1/8/17,HOU,TOR,1,42,5,10,0.5,0,0,,5,10,0.5,2,2,1,0,7,7,3,2,0,1,3,17,16
Wilson Chandler,29-322,F,3/28/17,DEN,POR,1,36,7,13,0.538,6,10,0.6,1,3,0.333,2,3,0.667,1,8,9,1,0,1,2,4,17,11.2
Norman Powell,23-266,G,2/15/17,TOR,CHO,1,28,5,12,0.417,2,5,0.4,3,7,0.429,4,6,0.667,0,3,3,0,3,0,2,1,17,11.3
Myles Turner,20-355,F-C,3/14/17,IND,NYK,1,31,8,17,0.471,8,17,0.471,0,0,,1,2,0.5,6,5,11,1,1,3,1,3,17,15.2
T.J. Warren,23-172,F,2/24/17,PHO,CHI,1,38,8,14,0.571,8,12,0.667,0,2,0,1,2,0.5,3,5,8,2,2,0,1,3,17,14.8
JaMychal Green,26-191,F,12/29/16,MEM,OKC,1,34,6,7,0.857,4,5,0.8,2,2,1,3,5,0.6,2,2,4,2,1,1,1,4,17,16.2
Hassan Whiteside,27-288,C,3/28/17,MIA,DET,1,30,7,13,0.538,7,13,0.538,0,0,,3,4,0.75,4,5,9,1,0,1,1,3,17,13.8
Austin Rivers,24-231,G,3/20/17,LAC,NYK,0,23,6,10,0.6,5,6,0.833,1,4,0.25,4,5,0.8,0,1,1,2,0,0,3,4,17,9.1
Dennis Schroder,23-167,G,3/1/17,ATL,DAL,1,33,7,13,0.538,6,11,0.545,1,2,0.5,2,2,1,0,2,2,6,1,1,7,2,17,9.4
Marcus Morris,27-071,F,11/12/16,DET,DEN,1,34,8,15,0.533,7,9,0.778,1,6,0.167,0,0,,0,1,1,3,2,0,0,1,17,13.7
Chris Paul,31-224,G,12/16/16,LAC,MIA,1,34,6,15,0.4,5,11,0.455,1,4,0.25,4,6,0.667,0,5,5,6,0,0,1,3,17,11.6
Zach Randolph,35-254,F,3/27/17,MEM,SAC,1,32,5,18,0.278,5,16,0.313,0,2,0,7,8,0.875,7,8,15,2,0,1,1,1,17,14
Wilson Chandler,29-204,F,11/30/16,DEN,MIA,0,29,8,17,0.471,7,13,0.538,1,4,0.25,0,0,,2,5,7,0,1,0,3,2,17,8.4
Zach Randolph,35-209,F,2/10/17,MEM,GSW,0,25,5,9,0.556,5,8,0.625,0,1,0,7,9,0.778,6,7,13,1,0,0,2,1,17,16.5
Shelvin Mack,26-245,G,12/23/16,UTA,TOR,1,34,7,13,0.538,5,7,0.714,2,6,0.333,1,2,0.5,1,3,4,5,1,0,3,1,17,13
Doug McDermott,25-001,F,1/4/17,CHI,CLE,0,32,6,9,0.667,3,5,0.6,3,4,0.75,2,2,1,1,5,6,1,1,0,0,1,17,16.6
Kristaps Porzingis,21-192,F-C,2/10/17,NYK,DEN,1,33,7,14,0.5,5,10,0.5,2,4,0.5,1,2,0.5,2,2,4,2,1,1,1,3,17,12.5
Willie Cauley-Stein,23-165,F-C,1/30/17,SAC,PHI,0,20,8,10,0.8,8,10,0.8,0,0,,1,2,0.5,1,2,3,1,1,1,3,1,17,13.1
Bradley Beal,23-207,G,1/21/17,WAS,DET,1,38,4,16,0.25,4,9,0.444,0,7,0,9,11,0.818,1,4,5,4,2,1,0,1,17,13.6
Carmelo Anthony,32-318,F,4/12/17,NYK,PHI,1,23,7,15,0.467,7,14,0.5,0,1,0,3,3,1,1,1,2,1,0,1,1,2,17,9.9
Wilson Chandler,29-257,F,1/22/17,DEN,MIN,0,34,6,11,0.545,5,9,0.556,1,2,0.5,4,5,0.8,2,4,6,0,1,1,3,2,17,11.8
Doug McDermott,25-004,F,1/7/17,CHI,TOR,0,38,6,17,0.353,4,10,0.4,2,7,0.286,3,3,1,2,8,10,1,1,0,2,1,17,10.6
Jerian Grant,24-183,G,4/10/17,CHI,ORL,1,28,7,12,0.583,5,7,0.714,2,5,0.4,1,1,1,0,1,1,11,2,0,0,1,17,21
Eric Gordon,28-012,G,1/6/17,HOU,ORL,0,32,7,20,0.35,4,4,1,3,16,0.188,0,0,,0,3,3,4,1,0,0,3,17,9.3
Otto Porter,23-199,F,12/19/16,WAS,IND,1,38,5,13,0.385,3,7,0.429,2,6,0.333,5,5,1,2,7,9,0,1,3,1,2,17,14.7
Wilson Chandler,29-219,F,12/15/16,DEN,POR,1,35,6,16,0.375,4,9,0.444,2,7,0.286,3,5,0.6,1,7,8,3,2,0,2,3,17,11.1
Avery Bradley,25-358,G,11/18/16,BOS,GSW,1,35,7,15,0.467,5,11,0.455,2,4,0.5,1,2,0.5,1,9,10,2,2,1,3,2,17,12.6
Dennis Schroder,23-046,G,10/31/16,ATL,SAC,1,32,5,14,0.357,3,9,0.333,2,5,0.4,5,6,0.833,1,2,3,5,0,0,1,0,17,12.6
Amir Johnson,29-236,F,12/23/16,BOS,OKC,1,26,6,10,0.6,5,8,0.625,1,2,0.5,4,5,0.8,3,3,6,5,2,0,0,3,17,19.3
LeBron James,32-087,F-G,3/27/17,CLE,SAS,1,30,7,17,0.412,7,14,0.5,0,3,0,3,6,0.5,3,5,8,8,0,0,2,3,17,12.7
Courtney Lee,31-032,G,11/4/16,NYK,CHI,1,41,8,10,0.8,7,9,0.778,1,1,1,0,0,,0,2,2,4,0,0,0,3,17,15.4
Wilson Chandler,29-232,F,12/28/16,DEN,MIN,1,37,6,17,0.353,3,8,0.375,3,9,0.333,2,2,1,2,5,7,2,1,1,1,2,17,11.7
Nick Young,31-211,G-F,12/29/16,LAL,DAL,1,30,6,8,0.75,1,2,0.5,5,6,0.833,0,0,,0,2,2,1,1,0,0,0,17,16.1
Goran Dragic,30-317,G,3/19/17,MIA,POR,1,38,6,21,0.286,5,15,0.333,1,6,0.167,4,6,0.667,2,2,4,3,3,0,2,3,17,7.8
Giannis Antetokounmpo,21-335,F-G,11/5/16,MIL,SAC,1,25,5,9,0.556,5,8,0.625,0,1,0,7,8,0.875,3,5,8,8,4,1,4,3,17,21
Patrick Beverley,28-178,G,1/6/17,HOU,ORL,1,31,7,9,0.778,4,5,0.8,3,4,0.75,0,0,,4,5,9,3,3,0,3,1,17,19.5
Trevor Ariza,31-273,F,3/30/17,HOU,POR,1,37,7,11,0.636,4,5,0.8,3,6,0.5,0,0,,1,4,5,2,6,0,2,2,17,18.6
Andrew Wiggins,21-252,F-G,11/1/16,MIN,MEM,1,29,6,11,0.545,4,9,0.444,2,2,1,3,5,0.6,1,2,3,4,0,1,3,3,17,11.5
LaMarcus Aldridge,31-154,F-C,12/20/16,SAS,HOU,1,36,6,15,0.4,6,15,0.4,0,0,,5,6,0.833,5,5,10,5,0,1,0,2,17,16.9
Serge Ibaka,27-148,F-C,2/13/17,ORL,MIA,1,28,7,9,0.778,6,8,0.75,1,1,1,2,2,1,5,3,8,0,1,1,0,3,17,18.4
Trevor Booker,29-038,F,1/2/17,BRK,UTA,1,34,6,14,0.429,5,10,0.5,1,4,0.25,4,4,1,4,11,15,2,0,1,1,3,17,15.6
Cody Zeller,24-066,F-C,12/10/16,CHO,CLE,1,23,7,8,0.875,7,8,0.875,0,0,,3,4,0.75,3,6,9,2,2,0,5,5,17,14.1
Jordan Clarkson,24-309,G,4/12/17,LAL,GSW,1,32,8,16,0.5,7,10,0.7,1,6,0.167,0,3,0,0,3,3,2,1,0,1,2,17,9.3
Serge Ibaka,27-105,F-C,1/1/17,ORL,IND,1,32,8,17,0.471,8,12,0.667,0,5,0,1,2,0.5,2,4,6,1,1,2,0,2,17,12.8
Jamal Murray,19-334,G,1/22/17,DEN,MIN,0,20,7,13,0.538,7,11,0.636,0,2,0,3,4,0.75,1,4,5,3,1,0,0,2,17,14.5
Buddy Hield,23-111,G,4/7/17,SAC,LAL,1,30,7,14,0.5,4,9,0.444,3,5,0.6,0,0,,0,1,1,2,1,0,4,2,17,7.9
Aaron Gordon,21-171,F,3/6/17,ORL,NYK,1,30,8,15,0.533,7,9,0.778,1,6,0.167,0,1,0,1,4,5,4,0,1,1,4,17,12.1
LaMarcus Aldridge,31-253,F-C,3/29/17,SAS,GSW,1,35,7,14,0.5,6,12,0.5,1,2,0.5,2,2,1,2,5,7,0,0,5,1,1,17,15
T.J. Warren,23-176,F,2/28/17,PHO,MEM,1,34,8,13,0.615,8,10,0.8,0,3,0,1,2,0.5,2,4,6,1,1,0,0,4,17,13.4
Malcolm Brogdon,24-012,G,12/23/16,MIL,WAS,0,29,7,7,1,4,4,1,3,3,1,0,0,,0,3,3,7,2,0,3,4,17,18.1
Carmelo Anthony,32-223,F,1/7/17,NYK,IND,1,27,6,14,0.429,5,10,0.5,1,4,0.25,4,5,0.8,0,2,2,5,0,0,0,3,17,12.1
Nick Young,31-247,G-F,2/3/17,LAL,BOS,1,33,6,14,0.429,1,4,0.25,5,10,0.5,0,0,,1,2,3,3,2,1,1,4,17,13.1
Kevin Love,28-110,F,12/26/16,CLE,DET,1,26,6,14,0.429,3,8,0.375,3,6,0.5,2,2,1,4,10,14,1,2,1,5,2,17,13
Jonas Valanciunas,24-222,C,12/14/16,TOR,PHI,1,34,6,11,0.545,6,11,0.545,0,0,,5,5,1,4,6,10,1,2,1,3,4,17,15.1
Enes Kanter,24-198,C,12/4/16,OKC,NOP,0,30,7,13,0.538,7,13,0.538,0,0,,3,6,0.5,4,6,10,1,1,2,2,2,17,14.4
Julius Randle,22-037,F,1/5/17,LAL,POR,1,37,4,13,0.308,4,12,0.333,0,1,0,9,11,0.818,2,7,9,5,1,0,2,5,17,12.7
Bojan Bogdanovic,27-340,G-F,3/24/17,WAS,BRK,0,26,6,12,0.5,6,9,0.667,0,3,0,5,5,1,0,7,7,2,1,1,2,0,17,14.2
D'Angelo Russell,20-261,G,11/10/16,LAL,SAC,1,23,7,12,0.583,6,8,0.75,1,4,0.25,2,3,0.667,0,0,0,1,0,0,5,2,17,5.9
Jimmy Butler,27-208,G-F,4/10/17,CHI,ORL,1,31,5,11,0.455,5,10,0.5,0,1,0,7,7,1,2,3,5,3,3,0,2,2,17,15.9
Victor Oladipo,24-246,G,1/5/17,OKC,HOU,1,41,6,16,0.375,2,7,0.286,4,9,0.444,1,2,0.5,2,5,7,2,1,0,1,3,17,10.9
Monta Ellis,31-006,G,11/1/16,IND,LAL,1,38,6,14,0.429,4,9,0.444,2,5,0.4,3,4,0.75,0,2,2,3,0,2,2,2,17,10.5
Justin Anderson,23-138,G,4/6/17,PHI,CHI,1,33,6,11,0.545,4,6,0.667,2,5,0.4,3,4,0.75,0,3,3,0,1,0,1,2,17,11.4
Tobias Harris,24-242,F,3/14/17,DET,CLE,1,26,6,11,0.545,5,7,0.714,1,4,0.25,4,5,0.8,1,1,2,2,1,0,0,2,17,13.9
Deron Williams,32-169,G,12/12/16,DAL,DEN,1,32,7,16,0.438,6,10,0.6,1,6,0.167,2,2,1,0,2,2,8,2,0,1,2,17,15
DeAndre Jordan,28-261,C,4/8/17,LAC,SAS,1,36,8,10,0.8,8,10,0.8,0,0,,1,4,0.25,5,12,17,2,1,0,0,2,17,20.7
Tyler Ulis,21-073,G,3/19/17,PHO,DET,1,43,7,24,0.292,7,19,0.368,0,5,0,3,4,0.75,0,3,3,11,3,0,2,3,17,11
Eric Gordon,27-364,G,12/23/16,HOU,MEM,0,32,6,19,0.316,2,3,0.667,4,16,0.25,1,1,1,0,2,2,4,1,1,1,1,17,9.8
Victor Oladipo,24-270,G,1/29/17,OKC,CLE,1,38,6,18,0.333,5,14,0.357,1,4,0.25,4,5,0.8,1,6,7,4,0,0,1,3,17,9.5
Rondae Hollis-Jefferson,22-097,F,4/10/17,BRK,BOS,1,37,4,15,0.267,3,13,0.231,1,2,0.5,8,8,1,1,10,11,3,4,2,3,2,17,15.5
J.J. Redick,32-213,G,1/23/17,LAC,ATL,1,35,6,13,0.462,3,9,0.333,3,4,0.75,2,2,1,1,2,3,3,1,0,2,1,17,12.3
Zach LaVine,21-268,G,12/3/16,MIN,CHO,1,44,7,20,0.35,4,11,0.364,3,9,0.333,0,0,,1,1,2,3,2,1,0,1,17,11.2
Blake Griffin,28-010,F,3/26/17,LAC,SAC,1,32,6,11,0.545,4,7,0.571,2,4,0.5,3,4,0.75,0,6,6,4,1,0,3,1,17,13.5
Wilson Chandler,29-194,F,11/20/16,DEN,UTA,0,24,7,11,0.636,5,7,0.714,2,4,0.5,1,2,0.5,0,4,4,1,1,0,3,1,17,11.2
Jeremy Lamb,24-313,G-F,4/8/17,CHO,BOS,0,25,6,8,0.75,5,6,0.833,1,2,0.5,4,4,1,0,5,5,1,0,2,0,1,17,17
Justin Holiday,27-285,G,1/15/17,NYK,TOR,0,26,5,8,0.625,2,3,0.667,3,5,0.6,4,5,0.8,0,2,2,1,1,0,1,0,17,14.3
Eric Gordon,27-350,G,12/9/16,HOU,OKC,0,33,5,10,0.5,2,4,0.5,3,6,0.5,4,4,1,1,0,1,3,1,0,1,1,17,14.4
Paul Millsap,31-330,F,1/5/17,ATL,NOP,1,33,6,19,0.316,5,15,0.333,1,4,0.25,4,4,1,0,10,10,4,2,1,2,1,17,12.2
Carmelo Anthony,32-291,F,3/16/17,NYK,BRK,1,37,6,18,0.333,6,12,0.5,0,6,0,5,5,1,0,6,6,5,1,1,1,5,17,10.8
Kris Dunn,23-007,G,3/25/17,MIN,POR,0,29,8,13,0.615,7,11,0.636,1,2,0.5,0,0,,1,3,4,1,2,0,0,4,17,13.8
Lou Williams,30-152,G,3/28/17,HOU,GSW,0,32,5,14,0.357,5,9,0.556,0,5,0,7,8,0.875,0,3,3,1,1,0,2,1,17,9
Harrison Barnes,24-184,F,11/30/16,DAL,SAS,1,40,8,15,0.533,7,13,0.538,1,2,0.5,0,0,,1,1,2,1,1,1,2,0,17,11.1
Tony Allen,34-351,G-F,12/27/16,MEM,BOS,1,35,6,9,0.667,6,9,0.667,0,0,,5,7,0.714,4,3,7,1,4,0,1,4,17,18.1
Kristaps Porzingis,21-129,F-C,12/9/16,NYK,SAC,1,35,6,19,0.316,5,14,0.357,1,5,0.2,4,4,1,2,9,11,2,0,0,2,3,17,8.4
Terrence Ross,25-333,F-G,1/3/17,TOR,SAS,0,25,7,11,0.636,5,7,0.714,2,4,0.5,1,2,0.5,0,5,5,0,1,0,1,0,17,13.2
Trevor Ariza,31-137,F,11/14/16,HOU,PHI,1,35,6,14,0.429,1,3,0.333,5,11,0.455,0,0,,1,7,8,2,3,1,0,1,17,17.1
Shelvin Mack,26-258,G,1/5/17,UTA,TOR,1,31,7,9,0.778,6,8,0.75,1,1,1,2,2,1,1,3,4,2,1,0,4,3,17,12.3
Avery Bradley,26-106,G,3/12/17,BOS,CHI,1,26,7,16,0.438,4,13,0.308,3,3,1,0,0,,3,3,6,1,3,1,2,1,17,13.6
Brandon Jennings,27-055,G,11/17/16,NYK,WAS,0,24,7,10,0.7,4,5,0.8,3,5,0.6,0,0,,3,2,5,11,1,0,2,3,17,21
Tyus Jones,20-337,G,4/12/17,MIN,HOU,0,28,6,9,0.667,3,5,0.6,3,4,0.75,2,2,1,1,3,4,7,2,1,1,1,17,20.9
Carmelo Anthony,32-251,F,2/4/17,NYK,CLE,1,35,6,20,0.3,5,14,0.357,1,6,0.167,4,5,0.8,2,4,6,2,2,1,2,4,17,8.1
Nene Hilario,34-132,F-C,1/23/17,HOU,MIL,0,22,6,9,0.667,6,9,0.667,0,0,,5,8,0.625,3,5,8,1,2,2,2,1,17,17.2
Tobias Harris,24-131,F,11/23/16,DET,MIA,1,33,6,14,0.429,6,12,0.5,0,2,0,5,6,0.833,1,5,6,3,0,0,2,1,17,11.1
Alan Williams,24-029,F-C,2/26/17,PHO,MIL,0,34,7,13,0.538,7,13,0.538,0,0,,3,3,1,7,8,15,3,3,1,2,3,17,20.6
Taurean Waller-Prince,23-004,F,3/26/17,ATL,BRK,1,38,5,13,0.385,3,9,0.333,2,4,0.5,5,6,0.833,2,5,7,1,3,1,1,2,17,15
Danilo Gallinari,28-176,F,1/31/17,DEN,LAL,1,36,5,12,0.417,5,9,0.556,0,3,0,7,7,1,0,2,2,3,1,0,2,2,17,11.5
Aaron Gordon,21-204,F,4/8/17,ORL,IND,1,37,7,13,0.538,6,10,0.6,1,3,0.333,2,2,1,2,2,4,3,2,1,1,3,17,15.3
Kevin Love,28-067,F,11/13/16,CLE,CHO,1,26,6,10,0.6,4,7,0.571,2,3,0.667,3,4,0.75,4,7,11,4,1,0,1,3,17,18.5
Gordon Hayward,26-306,F-G,1/23/17,UTA,OKC,1,36,6,17,0.353,4,11,0.364,2,6,0.333,3,3,1,0,6,6,1,1,0,0,1,17,10.6
Malik Beasley,20-137,G,4/12/17,DEN,OKC,1,40,8,17,0.471,7,13,0.538,1,4,0.25,0,0,,1,2,3,3,1,0,2,2,17,9.9
Kevin Love,28-199,F,3/25/17,CLE,WAS,1,33,5,11,0.455,2,5,0.4,3,6,0.5,4,4,1,2,5,7,0,1,1,2,3,17,12.7
Monta Ellis,31-149,G,3/24/17,IND,DEN,0,31,7,10,0.7,4,7,0.571,3,3,1,0,0,,1,3,4,1,2,0,0,2,17,16.3
Willy Hernangomez,22-236,C,1/18/17,NYK,BOS,0,20,8,13,0.615,8,13,0.615,0,0,,1,1,1,4,7,11,1,0,0,1,2,17,14.9
Lou Williams,30-017,G,11/13/16,LAL,MIN,0,18,5,10,0.5,3,6,0.5,2,4,0.5,5,5,1,0,5,5,4,0,0,3,1,17,12.9
Will Barton,25-331,G,12/2/16,DEN,HOU,1,33,7,16,0.438,6,12,0.5,1,4,0.25,2,5,0.4,2,5,7,5,1,0,2,2,17,12
James Harden,27-147,G,1/20/17,HOU,GSW,1,35,6,13,0.462,6,8,0.75,0,5,0,5,5,1,0,6,6,11,1,0,7,3,17,12.6
Jrue Holiday,26-168,G,11/27/16,NOP,DAL,0,31,7,13,0.538,4,9,0.444,3,4,0.75,0,0,,1,3,4,6,0,0,4,3,17,11.3
Richaun Holmes,23-177,F-C,4/10/17,PHI,IND,1,34,6,14,0.429,6,11,0.545,0,3,0,5,6,0.833,3,3,6,2,1,0,0,3,17,13.4
Marcin Gortat,32-347,C-F,1/29/17,WAS,NOP,1,31,7,11,0.636,7,11,0.636,0,0,,3,3,1,3,8,11,2,1,0,2,3,17,15.8
Enes Kanter,24-322,C,4/7/17,OKC,PHO,0,20,5,14,0.357,5,13,0.385,0,1,0,7,7,1,3,1,4,0,0,0,0,3,17,10.4
Brandon Knight,25-019,G,12/21/16,PHO,HOU,0,26,5,10,0.5,3,8,0.375,2,2,1,5,6,0.833,1,4,5,2,2,1,2,3,17,14.4
Eric Bledsoe,26-331,G,11/4/16,PHO,NOP,1,36,7,13,0.538,5,7,0.714,2,6,0.333,1,3,0.333,2,5,7,4,0,0,3,5,17,10.6
Derrick Favors,25-183,F-C,1/14/17,UTA,ORL,1,32,7,12,0.583,7,12,0.583,0,0,,3,3,1,1,5,6,1,0,0,3,1,17,10.9
Markieff Morris,27-138,F,1/18/17,WAS,MEM,1,34,6,16,0.375,6,11,0.545,0,5,0,5,5,1,3,9,12,2,1,1,1,5,17,13.1
Gorgui Dieng,26-365,C,1/17/17,MIN,SAS,1,29,6,12,0.5,6,12,0.5,0,0,,5,6,0.833,1,5,6,2,1,4,1,2,17,16.2
Buddy Hield,23-084,G,3/11/17,SAC,DEN,1,30,6,8,0.75,3,3,1,3,5,0.6,2,2,1,2,4,6,3,1,0,2,0,17,17.5
Giannis Antetokounmpo,22-045,F-G,1/20/17,MIL,ORL,1,36,6,17,0.353,5,13,0.385,1,4,0.25,4,4,1,2,12,14,5,1,0,4,6,17,10.6
Mike Conley,29-108,G,1/27/17,MEM,POR,1,36,5,16,0.313,2,8,0.25,3,8,0.375,4,5,0.8,1,2,3,10,1,0,4,0,17,12.7
Tony Parker,34-283,G,2/24/17,SAS,LAC,1,31,5,12,0.417,4,10,0.4,1,2,0.5,6,6,1,0,2,2,3,2,0,2,0,17,13.3
Al Horford,30-232,C-F,1/21/17,BOS,POR,1,38,6,13,0.462,4,11,0.364,2,2,1,3,5,0.6,2,7,9,5,0,0,1,6,17,13.1
Joe Harris,25-087,G,12/3/16,BRK,MIL,0,30,7,12,0.583,4,5,0.8,3,7,0.429,0,0,,0,5,5,2,1,0,1,3,17,13.1
Jason Smith,31-015,F-C,3/17/17,WAS,CHI,1,38,6,15,0.4,3,9,0.333,3,6,0.5,2,3,0.667,3,4,7,2,2,2,1,2,17,14.8
Lou Williams,30-001,G,10/28/16,LAL,UTA,0,27,6,12,0.5,3,8,0.375,3,4,0.75,2,2,1,0,0,0,6,1,0,1,2,17,14.4
Derrick Rose,28-021,G,10/25/16,NYK,CLE,1,30,7,17,0.412,6,15,0.4,1,2,0.5,2,2,1,2,1,3,1,0,1,4,1,17,6.6
Marc Gasol,32-034,C,3/4/17,MEM,HOU,1,36,7,16,0.438,7,13,0.538,0,3,0,3,5,0.6,0,4,4,7,2,4,3,1,17,15.3
Nikola Jokic,21-360,C-F,2/13/17,DEN,GSW,1,36,7,13,0.538,7,13,0.538,0,0,,3,4,0.75,6,15,21,12,2,0,6,3,17,22.2
Andre Drummond,23-175,C,2/1/17,DET,NOP,1,26,8,13,0.615,8,13,0.615,0,0,,1,2,0.5,1,5,6,0,3,0,2,3,17,12.7
Jonas Valanciunas,24-325,C,3/27/17,TOR,ORL,1,27,7,9,0.778,7,9,0.778,0,0,,3,4,0.75,1,8,9,0,0,1,0,2,17,16.1
Gordon Hayward,26-266,F-G,12/14/16,UTA,OKC,1,32,7,14,0.5,7,10,0.7,0,4,0,3,5,0.6,0,2,2,2,0,2,2,2,17,9.8
Wesley Matthews,30-073,G,12/26/16,DAL,NOP,1,36,4,11,0.364,1,4,0.25,3,7,0.429,6,7,0.857,0,2,2,2,2,0,4,2,17,9.7
Ersan Ilyasova,29-204,F,12/5/16,PHI,DEN,1,36,7,15,0.467,5,10,0.5,2,5,0.4,1,2,0.5,3,5,8,2,2,0,1,2,17,14.1
Mason Plumlee,26-236,C-F,10/27/16,POR,LAC,1,31,7,9,0.778,7,9,0.778,0,0,,3,6,0.5,2,6,8,4,0,3,2,4,17,16.8
DeAndre Jordan,28-123,C,11/21/16,LAC,TOR,1,34,4,6,0.667,4,6,0.667,0,0,,9,14,0.643,3,12,15,0,0,1,1,4,17,16.2
Sean Kilpatrick,26-341,G,12/12/16,BRK,HOU,1,32,6,8,0.75,4,6,0.667,2,2,1,3,4,0.75,0,3,3,2,0,0,7,5,17,6.7
Joffrey Lauvergne,25-136,C-F,2/13/17,OKC,WAS,0,29,6,7,0.857,5,6,0.833,1,1,1,4,4,1,3,3,6,4,0,0,2,3,17,17.1
Jeff Green,30-104,F,12/10/16,ORL,DEN,0,25,6,10,0.6,4,6,0.667,2,4,0.5,3,4,0.75,0,4,4,1,0,0,1,1,17,12.5
Allen Crabbe,24-240,G-F,12/5/16,POR,CHI,0,33,7,15,0.467,6,11,0.545,1,4,0.25,2,2,1,2,3,5,1,2,0,0,3,17,13.1
Brandon Ingram,19-126,F,1/6/17,LAL,MIA,0,28,6,9,0.667,6,8,0.75,0,1,0,5,5,1,1,5,6,4,0,0,0,0,17,18.1
Ivica Zubac,19-319,C,1/31/17,LAL,DEN,0,21,8,9,0.889,8,9,0.889,0,0,,1,1,1,3,3,6,1,0,0,1,4,17,15
Zach LaVine,21-243,G,11/8/16,MIN,BRK,1,40,5,16,0.313,4,11,0.364,1,5,0.2,6,6,1,0,2,2,1,0,0,1,0,17,8.1
Giannis Antetokounmpo,21-329,F-G,10/30/16,MIL,DET,1,35,5,16,0.313,4,13,0.308,1,3,0.333,6,6,1,0,8,8,8,0,3,2,0,17,15.9
Bojan Bogdanovic,27-282,G-F,1/25/17,BRK,MIA,1,26,5,11,0.455,4,8,0.5,1,3,0.333,6,6,1,0,5,5,2,2,0,3,2,17,12.4
Glenn Robinson,22-324,G-F,11/27/16,IND,LAC,1,39,7,9,0.778,6,8,0.75,1,1,1,2,2,1,0,6,6,1,0,0,1,2,17,14.2
Deyonta Davis,19-335,F-C,11/1/16,MEM,MIN,0,26,7,8,0.875,7,8,0.875,0,0,,3,5,0.6,1,5,6,0,0,2,1,2,17,15.2
Taj Gibson,31-180,F,12/21/16,CHI,WAS,1,33,8,12,0.667,8,12,0.667,0,0,,1,3,0.333,4,7,11,2,0,2,2,3,17,15.5
Damian Lillard,26-151,G,12/13/16,POR,OKC,1,30,7,13,0.538,6,8,0.75,1,5,0.2,2,2,1,2,0,2,9,1,0,3,1,17,16
Kemba Walker,26-197,G,11/21/16,CHO,MEM,1,31,6,15,0.4,5,8,0.625,1,7,0.143,4,6,0.667,0,2,2,2,1,1,0,0,17,11.8
DeMarre Carroll,30-116,F,11/20/16,TOR,SAC,1,33,6,12,0.5,3,6,0.5,3,6,0.5,2,2,1,1,3,4,0,2,0,0,3,17,13.4
James Johnson,29-345,F,1/30/17,MIA,BRK,0,33,6,11,0.545,4,8,0.5,2,3,0.667,3,4,0.75,1,3,4,5,2,3,3,1,17,17.1
Manu Ginobili,39-143,G,12/18/16,SAS,NOP,0,18,6,9,0.667,3,4,0.75,3,5,0.6,2,2,1,0,1,1,1,1,1,0,1,17,15.4
C.J. McCollum,25-196,G,4/3/17,POR,MIN,1,35,5,14,0.357,5,11,0.455,0,3,0,7,8,0.875,1,4,5,4,1,1,2,1,17,12.8
James Harden,27-217,G,3/31/17,HOU,GSW,1,35,4,17,0.235,2,8,0.25,2,9,0.222,7,7,1,4,8,12,8,0,1,6,3,17,11
Jeremy Lin,28-190,G,3/1/17,BRK,SAC,1,20,5,10,0.5,3,7,0.429,2,3,0.667,5,6,0.833,0,2,2,5,0,0,2,1,17,13.3
Gordon Hayward,26-299,F-G,1/16/17,UTA,PHO,1,32,4,13,0.308,3,10,0.3,1,3,0.333,8,9,0.889,0,4,4,5,0,0,1,1,17,12.4
Danilo Gallinari,28-082,F,10/29/16,DEN,POR,1,42,4,16,0.25,4,11,0.364,0,5,0,9,10,0.9,1,4,5,2,0,0,2,0,17,8.3
Julius Randle,22-071,F,2/8/17,LAL,DET,1,30,7,13,0.538,7,13,0.538,0,0,,3,4,0.75,1,5,6,1,0,0,3,3,17,9
Devin Booker,20-046,G,12/15/16,PHO,SAS,1,36,6,19,0.316,4,13,0.308,2,6,0.333,3,4,0.75,1,3,4,5,2,0,4,4,17,7.2
Frank Kaminsky,23-325,F-C,2/23/17,CHO,DET,1,39,6,18,0.333,3,10,0.3,3,8,0.375,2,3,0.667,0,1,1,2,1,1,1,3,17,7.6
Kentavious Caldwell-Pope,24-041,G,3/31/17,DET,MIL,1,38,7,19,0.368,5,8,0.625,2,11,0.182,1,1,1,2,6,8,2,2,0,1,1,17,11.7
Nick Young,31-250,G-F,2/6/17,LAL,NYK,1,22,5,15,0.333,2,5,0.4,3,10,0.3,4,4,1,1,4,5,0,1,0,0,2,17,10.6
Rajon Rondo,31-021,G,3/15/17,CHI,MEM,1,35,7,16,0.438,4,12,0.333,3,4,0.75,0,0,,3,3,6,8,2,0,0,4,17,17.6
Josh Richardson,23-199,G,4/2/17,MIA,DEN,1,38,6,11,0.545,2,5,0.4,4,6,0.667,1,2,0.5,1,2,3,1,1,3,1,4,17,13.8
Marco Belinelli,30-319,G-F,2/7/17,CHO,BRK,0,26,4,9,0.444,3,6,0.5,1,3,0.333,8,9,0.889,0,3,3,0,0,1,0,1,17,13.1
Enes Kanter,24-298,C,3/14/17,OKC,BRK,0,19,6,10,0.6,6,9,0.667,0,1,0,5,6,0.833,2,3,5,2,1,0,1,3,17,14.5
Dennis Schroder,23-106,G,12/30/16,ATL,DET,1,31,6,14,0.429,4,10,0.4,2,4,0.5,3,4,0.75,0,1,1,7,2,0,4,3,17,11.2
Marcus Morris,27-084,F,11/25/16,DET,LAC,1,22,8,13,0.615,7,11,0.636,1,2,0.5,0,0,,0,3,3,0,0,0,2,4,17,8.4
Marcus Morris,27-054,F,10/26/16,DET,TOR,1,32,7,17,0.412,5,9,0.556,2,8,0.25,1,1,1,4,5,9,3,1,0,2,2,17,12.5
Clint Capela,22-191,F-C,11/25/16,HOU,SAC,1,30,7,14,0.5,7,14,0.5,0,0,,3,4,0.75,3,7,10,0,0,2,1,2,17,13.4
Dorian Finney-Smith,23-228,F,12/18/16,DAL,SAC,1,29,5,9,0.556,2,3,0.667,3,6,0.5,4,4,1,0,2,2,3,1,0,3,2,17,12.6
Hassan Whiteside,27-291,C,3/31/17,MIA,NYK,1,34,6,9,0.667,6,9,0.667,0,0,,5,7,0.714,5,11,16,0,0,2,3,4,17,15.9
Marc Gasol,31-345,C,1/8/17,MEM,UTA,1,34,7,18,0.389,7,15,0.467,0,3,0,3,4,0.75,1,3,4,1,3,0,2,4,17,8.5
Aaron Gordon,21-042,F,10/28/16,ORL,DET,1,29,6,12,0.5,5,10,0.5,1,2,0.5,4,6,0.667,3,4,7,0,2,0,1,3,17,13.3
Ian Clark,26-032,G,4/8/17,GSW,NOP,0,28,8,13,0.615,7,9,0.778,1,4,0.25,0,0,,1,2,3,4,0,0,1,2,17,13.4
D.J. Augustin,29-036,G,12/16/16,ORL,BRK,1,27,6,14,0.429,4,7,0.571,2,7,0.286,3,3,1,0,5,5,4,1,0,3,1,17,11.5
Chris Paul,31-210,G,12/2/16,LAC,NOP,1,34,6,11,0.545,5,7,0.714,1,4,0.25,4,4,1,1,7,8,13,1,0,2,2,17,21.8
Jeremy Lin,28-125,G,12/26/16,BRK,CHO,1,22,6,11,0.545,4,7,0.571,2,4,0.5,3,4,0.75,0,0,0,4,2,0,3,2,17,12.3
Giannis Antetokounmpo,21-340,F-G,11/10/16,MIL,NOP,1,35,7,16,0.438,7,16,0.438,0,0,,3,4,0.75,4,6,10,1,1,2,3,5,17,10.9
Dennis Schroder,23-051,G,11/5/16,ATL,HOU,1,32,6,14,0.429,4,9,0.444,2,5,0.4,3,4,0.75,0,3,3,10,1,0,4,1,17,13.7
Jonathon Simmons,27-200,G-F,4/2/17,SAS,UTA,0,34,7,14,0.5,6,11,0.545,1,3,0.333,2,2,1,0,1,1,2,1,0,1,5,17,9.7
Zach LaVine,21-293,G,12/28/16,MIN,DEN,1,40,7,17,0.412,5,9,0.556,2,8,0.25,1,2,0.5,0,1,1,5,1,0,0,0,17,12.3
Zach Randolph,35-256,F,3/29/17,MEM,IND,0,25,8,15,0.533,8,13,0.615,0,2,0,1,1,1,1,5,6,3,1,0,3,2,17,11.2
Sergio Rodriguez,30-176,G,12/5/16,PHI,DEN,1,33,7,14,0.5,4,8,0.5,3,6,0.5,0,0,,1,3,4,7,3,0,3,3,17,15.3
Jusuf Nurkic,22-196,C,3/7/17,POR,OKC,1,25,5,12,0.417,5,11,0.455,0,1,0,7,8,0.875,2,7,9,4,1,0,4,5,17,11.5
Brook Lopez,28-318,C,2/13/17,BRK,MEM,1,32,7,18,0.389,6,13,0.462,1,5,0.2,2,2,1,1,2,3,5,1,0,2,4,17,9.4
Vince Carter,39-291,G-F,11/12/16,MEM,MIL,0,34,7,11,0.636,6,6,1,1,5,0.2,2,2,1,0,1,1,2,1,0,0,3,17,13.6
Spencer Dinwiddie,23-313,G,2/13/17,BRK,MEM,1,29,5,8,0.625,1,3,0.333,4,5,0.8,3,3,1,0,3,3,1,0,0,0,1,17,14.6
Reggie Bullock,26-027,G-F,4/12/17,DET,ORL,0,29,6,9,0.667,1,3,0.333,5,6,0.833,0,0,,0,2,2,3,2,0,0,0,17,17.8
T.J. McConnell,24-280,G,12/30/16,PHI,DEN,1,36,6,12,0.5,3,9,0.333,3,3,1,2,2,1,0,2,2,8,0,0,2,3,17,14
Jeff Teague,28-231,G,1/27/17,IND,SAC,1,43,5,11,0.455,4,8,0.5,1,3,0.333,6,6,1,1,7,8,8,1,0,1,3,17,18.5
Ricky Rubio,26-114,G,2/12/17,MIN,CHI,1,33,5,10,0.5,4,7,0.571,1,3,0.333,6,6,1,0,6,6,11,2,0,4,0,17,19.5
Jason Smith,31-033,F-C,4/4/17,WAS,CHO,0,24,6,11,0.545,1,2,0.5,5,9,0.556,0,0,,0,5,5,2,0,1,1,2,17,13.5
Markieff Morris,27-136,F,1/16/17,WAS,POR,1,33,6,9,0.667,5,7,0.714,1,2,0.5,4,4,1,0,13,13,5,2,2,0,3,17,22.7
Rodney Hood,24-023,G-F,11/12/16,UTA,MIA,1,34,6,13,0.462,5,9,0.556,1,4,0.25,4,4,1,0,4,4,1,0,1,1,4,17,10.3
Timothe Luwawu-Cabarrot,21-323,F,3/28/17,PHI,BRK,1,33,5,12,0.417,1,2,0.5,4,10,0.4,3,4,0.75,2,7,9,3,1,1,3,4,17,12.9
DeAndre Jordan,28-217,C,2/23/17,LAC,GSW,1,31,6,12,0.5,6,12,0.5,0,0,,5,8,0.625,5,6,11,3,1,0,1,3,17,16
Otto Porter,23-217,F,1/6/17,WAS,MIN,1,34,7,12,0.583,4,6,0.667,3,6,0.5,0,0,,1,5,6,2,1,2,2,2,17,14.6
Wayne Ellington,29-102,G,2/8/17,MIA,MIL,1,28,6,11,0.545,1,3,0.333,5,8,0.625,0,0,,0,2,2,1,0,0,1,1,17,11.6
Russell Westbrook,28-104,G,2/24/17,OKC,LAL,1,35,4,18,0.222,3,13,0.231,1,5,0.2,8,9,0.889,2,16,18,17,3,0,6,1,17,20.3
Austin Rivers,24-227,G,3/16/17,LAC,DEN,1,33,7,12,0.583,4,6,0.667,3,6,0.5,0,1,0,0,1,1,1,0,0,1,4,17,9.4
Kelly Olynyk,25-323,C-F,3/8/17,BOS,GSW,0,26,7,9,0.778,6,7,0.857,1,2,0.5,2,2,1,0,5,5,5,3,0,1,0,17,20.5
Goran Dragic,30-294,G,2/24/17,MIA,ATL,1,29,5,16,0.313,3,10,0.3,2,6,0.333,5,5,1,1,5,6,3,0,2,2,2,17,10.7
Brook Lopez,28-336,C,3/3/17,BRK,UTA,1,29,5,13,0.385,4,9,0.444,1,4,0.25,6,7,0.857,0,5,5,1,0,2,1,3,17,10.9
J.R. Smith,31-063,G-F,11/11/16,CLE,WAS,1,35,5,11,0.455,0,2,0,5,9,0.556,2,2,1,0,4,4,0,1,0,0,4,17,11.9
Kevin Love,28-126,F,1/11/17,CLE,POR,1,28,5,15,0.333,2,6,0.333,3,9,0.333,4,4,1,0,8,8,1,0,0,1,0,17,10.6
Victor Oladipo,24-320,G,3/20/17,OKC,GSW,1,33,6,14,0.429,4,11,0.364,2,3,0.667,3,4,0.75,1,5,6,5,2,0,1,2,17,15.1
Greg Monroe,26-308,C-F,4/8/17,MIL,PHI,0,22,8,14,0.571,8,14,0.571,0,0,,1,2,0.5,2,3,5,3,2,1,3,3,17,12.9
Rudy Gay,30-131,F,12/26/16,SAC,PHI,1,36,7,16,0.438,6,12,0.5,1,4,0.25,2,2,1,2,7,9,2,0,1,4,1,17,9.8
Rudy Gay,30-098,F,11/23/16,SAC,OKC,1,34,6,15,0.4,3,9,0.333,3,6,0.5,2,2,1,2,7,9,4,0,0,2,3,17,12
Brandan Wright,29-131,F-C,2/13/17,MEM,BRK,0,21,7,9,0.778,7,9,0.778,0,0,,3,3,1,1,3,4,1,1,0,1,1,17,15.4
Reggie Jackson,26-316,G,2/26/17,DET,BOS,1,34,6,12,0.5,3,7,0.429,3,5,0.6,2,2,1,1,3,4,6,1,0,3,2,17,14
Michael Beasley,28-048,F,2/26/17,MIL,PHO,0,23,8,10,0.8,8,10,0.8,0,0,,1,1,1,1,2,3,0,1,1,4,3,17,11
Derrick Rose,28-159,G,3/12/17,NYK,BRK,1,37,5,15,0.333,5,15,0.333,0,0,,7,8,0.875,3,2,5,2,2,0,0,2,17,13.4
Terrence Jones,24-346,F,12/20/16,NOP,PHI,0,30,6,14,0.429,6,14,0.429,0,0,,5,8,0.625,4,6,10,3,0,0,2,2,17,12.3
Kyle Korver,35-248,G-F,11/20/16,ATL,NYK,1,37,7,12,0.583,5,8,0.625,2,4,0.5,1,1,1,0,4,4,1,2,0,0,1,17,14.9
Taj Gibson,31-263,F,3/14/17,OKC,BRK,1,24,8,17,0.471,8,17,0.471,0,0,,1,3,0.333,3,4,7,0,1,1,1,4,17,9.9
Harrison Barnes,24-185,F,12/1/16,DAL,CHO,1,38,8,20,0.4,7,18,0.389,1,2,0.5,0,0,,1,8,9,1,2,0,1,1,17,10.6
Tyler Johnson,24-301,G,3/4/17,MIA,CLE,0,26,6,11,0.545,3,5,0.6,3,6,0.5,2,2,1,2,4,6,2,3,0,0,4,17,17.1
Rudy Gobert,24-167,C,12/10/16,UTA,SAC,1,36,5,6,0.833,5,6,0.833,0,0,,7,8,0.875,4,10,14,0,0,6,2,4,17,20.8
DeMarcus Cousins,26-148,C-F,1/8/17,SAC,GSW,1,29,4,11,0.364,3,8,0.375,1,3,0.333,8,9,0.889,0,10,10,5,1,2,7,4,17,10.8
Karl-Anthony Towns,21-023,C-F,12/8/16,MIN,TOR,1,35,8,16,0.5,7,12,0.583,1,4,0.25,0,0,,5,6,11,1,0,1,3,4,17,11.1
Gary Harris,22-139,G,1/31/17,DEN,LAL,1,32,6,11,0.545,3,7,0.429,3,4,0.75,2,2,1,1,3,4,4,4,0,4,3,17,14.9
James Johnson,30-025,F,3/17/17,MIA,MIN,0,27,8,12,0.667,7,10,0.7,1,2,0.5,0,0,,0,2,2,6,2,1,2,1,17,16.9
Langston Galloway,25-017,G,12/26/16,NOP,DAL,0,26,6,8,0.75,1,3,0.333,5,5,1,0,0,,0,2,2,2,0,0,2,1,17,13.4
Goran Dragic,30-182,G,11/4/16,MIA,TOR,1,36,6,14,0.429,3,9,0.333,3,5,0.6,2,2,1,1,4,5,5,1,0,4,2,17,11.2
Shaun Livingston,31-203,G,4/2/17,GSW,WAS,0,21,8,10,0.8,8,10,0.8,0,0,,1,1,1,2,5,7,0,0,1,0,3,17,15.6
Emmanuel Mudiay,20-265,G,11/25/16,DEN,OKC,1,30,5,10,0.5,2,4,0.5,3,6,0.5,4,6,0.667,1,2,3,5,1,0,1,0,17,16
Jon Leuer,27-209,F,12/9/16,DET,MIN,0,28,5,10,0.5,5,6,0.833,0,4,0,7,8,0.875,1,4,5,1,1,0,0,1,17,14.8
Nikola Jokic,22-025,C-F,3/16/17,DEN,LAC,1,30,7,12,0.583,7,11,0.636,0,1,0,3,3,1,3,11,14,10,0,0,2,2,17,21
Patrick Beverley,28-212,G,2/9/17,HOU,CHO,1,32,7,15,0.467,4,7,0.571,3,8,0.375,0,0,,0,2,2,3,3,0,2,0,17,13
Nick Young,31-154,G-F,11/2/16,LAL,ATL,1,26,6,11,0.545,3,4,0.75,3,7,0.429,2,2,1,0,1,1,2,0,0,1,1,17,12
Clint Capela,22-265,F-C,2/7/17,HOU,ORL,1,28,7,9,0.778,7,9,0.778,0,0,,3,8,0.375,2,7,9,0,1,1,0,1,17,16.3
Blake Griffin,27-336,F,2/15/17,LAC,ATL,1,29,6,15,0.4,5,12,0.417,1,3,0.333,4,4,1,1,4,5,9,1,2,4,2,17,14.7
Zach LaVine,21-265,G,11/30/16,MIN,NYK,1,42,5,13,0.385,4,8,0.5,1,5,0.2,6,6,1,1,1,2,1,1,0,3,1,17,9.2
Nikola Vucevic,26-034,C,11/27/16,ORL,MIL,0,30,7,15,0.467,6,12,0.5,1,3,0.333,2,2,1,3,13,16,3,0,1,0,4,17,16.5
Klay Thompson,26-309,G,12/13/16,GSW,NOP,1,37,6,16,0.375,4,8,0.5,2,8,0.25,3,4,0.75,1,2,3,3,0,2,2,2,17,9.8
Maurice Harkless,23-278,F-G,2/13/17,POR,ATL,1,32,7,15,0.467,4,11,0.364,3,4,0.75,0,1,0,6,3,9,2,1,2,2,4,17,14.2
Jabari Parker,21-323,F,2/1/17,MIL,UTA,1,32,6,12,0.5,6,10,0.6,0,2,0,5,6,0.833,1,6,7,0,1,1,3,3,17,10.6
Bojan Bogdanovic,27-284,G-F,1/27/17,BRK,CLE,1,30,7,13,0.538,6,7,0.857,1,6,0.167,2,2,1,0,2,2,3,1,0,1,2,17,12.6
Pau Gasol,36-241,F-C,3/4/17,SAS,MIN,0,30,7,10,0.7,5,6,0.833,2,4,0.5,1,3,0.333,3,5,8,3,0,1,1,2,17,16.6
Russell Westbrook,28-093,G,2/13/17,OKC,WAS,1,24,5,19,0.263,5,15,0.333,0,4,0,7,7,1,2,2,4,4,2,0,2,0,17,10.5
Tim Hardaway,24-315,G,1/25/17,ATL,CHI,0,33,6,11,0.545,2,5,0.4,4,6,0.667,1,1,1,0,2,2,5,0,0,2,3,17,12.6
DeMar DeRozan,27-238,G,4/2/17,TOR,PHI,1,31,6,11,0.545,6,11,0.545,0,0,,5,5,1,1,0,1,9,0,0,3,1,17,15.3
Maurice Harkless,23-206,F-G,12/3/16,POR,MIA,1,33,6,12,0.5,5,9,0.556,1,3,0.333,4,4,1,2,5,7,1,1,1,1,2,17,14.5
Jeff Teague,28-233,G,1/29/17,IND,HOU,1,36,5,10,0.5,5,8,0.625,0,2,0,7,7,1,0,3,3,15,2,1,3,2,17,22.3
Sam Dekker,22-259,F,1/20/17,HOU,GSW,0,28,6,14,0.429,5,7,0.714,1,7,0.143,4,5,0.8,4,3,7,2,0,1,0,1,17,14.6
Russell Westbrook,28-014,G,11/26/16,OKC,DET,1,37,8,22,0.364,8,17,0.471,0,5,0,1,2,0.5,3,10,13,15,1,1,5,2,17,15.9
Brandon Ingram,19-128,F,1/8/17,LAL,ORL,0,27,6,9,0.667,4,5,0.8,2,4,0.5,3,4,0.75,0,3,3,2,0,1,3,2,17,11.9
Joe Johnson,35-269,G-F,3/25/17,UTA,LAC,0,26,6,13,0.462,3,6,0.5,3,7,0.429,2,2,1,0,3,3,2,0,0,0,3,17,11.4
E'Twaun Moore,27-247,G,11/1/16,NOP,MIL,1,36,7,13,0.538,4,7,0.571,3,6,0.5,0,0,,0,0,0,3,0,0,1,2,17,11
Avery Bradley,26-131,G,4/6/17,BOS,ATL,1,35,6,19,0.316,5,11,0.455,1,8,0.125,4,5,0.8,1,3,4,1,2,0,1,4,17,7.4
Maurice Harkless,23-327,F-G,4/3/17,POR,MIN,1,36,7,10,0.7,4,5,0.8,3,5,0.6,0,0,,2,5,7,1,1,1,0,4,17,16.5
Courtney Lee,31-118,G,1/29/17,NYK,ATL,1,52,6,16,0.375,3,8,0.375,3,8,0.375,2,2,1,2,7,9,2,2,1,1,5,17,12.8
Paul Millsap,31-341,F,1/16/17,ATL,NYK,1,39,5,18,0.278,4,13,0.308,1,5,0.2,6,10,0.6,1,6,7,6,3,3,3,4,17,12
Terrence Ross,25-359,F-G,1/29/17,TOR,ORL,0,28,6,10,0.6,2,3,0.667,4,7,0.571,1,1,1,0,1,1,1,3,0,1,5,17,13.4
Dario Saric,22-297,F,1/30/17,PHI,SAC,0,27,8,11,0.727,7,8,0.875,1,3,0.333,0,0,,2,3,5,6,0,0,1,1,17,17.6
Jason Smith,31-005,F-C,3/7/17,WAS,PHO,0,23,6,7,0.857,4,5,0.8,2,2,1,3,4,0.75,1,5,6,1,1,0,2,4,17,14.4
Eric Bledsoe,27-077,G,2/24/17,PHO,CHI,1,40,5,14,0.357,3,7,0.429,2,7,0.286,5,5,1,1,6,7,9,1,1,5,2,17,13.9
Marquese Chriss,19-237,F,2/24/17,PHO,CHI,1,33,7,10,0.7,5,7,0.714,2,3,0.667,1,3,0.333,1,6,7,2,2,2,3,2,17,15.5
Kemba Walker,26-250,G,1/13/17,CHO,PHI,1,42,7,23,0.304,5,14,0.357,2,9,0.222,1,1,1,1,2,3,3,2,0,4,3,17,3.9
Jon Leuer,27-186,F,11/16/16,DET,NYK,0,27,7,11,0.636,5,7,0.714,2,4,0.5,1,1,1,2,7,9,3,1,0,2,2,17,15.9
Emmanuel Mudiay,20-282,G,12/12/16,DEN,DAL,1,31,6,12,0.5,3,7,0.429,3,5,0.6,2,4,0.5,0,2,2,4,0,1,4,1,17,9.9
Joe Johnson,35-188,G-F,1/3/17,UTA,BOS,0,21,7,11,0.636,4,7,0.571,3,4,0.75,0,0,,0,3,3,2,1,2,0,2,17,16
Stephen Curry,29-007,G,3/21/17,GSW,DAL,1,30,7,14,0.5,4,5,0.8,3,9,0.333,0,0,,1,4,5,9,2,0,0,1,17,19.8
Reggie Williams,30-088,F,12/11/16,NOP,PHO,0,20,5,8,0.625,1,3,0.333,4,5,0.8,3,3,1,1,2,3,1,0,0,0,0,17,15.4
Robin Lopez,28-313,C,2/8/17,CHI,GSW,1,29,8,18,0.444,8,18,0.444,0,0,,1,2,0.5,7,3,10,4,1,0,1,1,17,15.4
Buddy Hield,23-011,G,12/28/16,NOP,LAC,1,23,7,11,0.636,4,6,0.667,3,5,0.6,0,0,,1,5,6,0,1,0,1,1,17,13.9
D'Angelo Russell,20-303,G,12/22/16,LAL,MIA,1,32,7,16,0.438,4,8,0.5,3,8,0.375,0,0,,0,4,4,7,1,0,6,4,17,8.1
Gordon Hayward,26-322,F-G,2/8/17,UTA,NOP,1,26,7,16,0.438,6,12,0.5,1,4,0.25,2,2,1,1,4,5,3,1,0,0,0,17,13.6
Jameer Nelson,34-281,G,11/16/16,DEN,PHO,1,34,8,12,0.667,7,9,0.778,1,3,0.333,0,0,,0,1,1,2,0,0,2,5,17,9.5
Brook Lopez,28-280,C,1/6/17,BRK,CLE,1,33,5,10,0.5,4,8,0.5,1,2,0.5,6,7,0.857,0,1,1,1,0,0,5,2,17,6.8
Jeff Teague,28-207,G,1/3/17,IND,DET,1,33,5,8,0.625,4,7,0.571,1,1,1,6,7,0.857,0,3,3,8,1,0,5,1,17,15.1
Jared Dudley,31-143,F-G,11/30/16,PHO,ATL,0,32,6,9,0.667,3,4,0.75,3,5,0.6,2,3,0.667,1,1,2,1,2,0,3,2,17,12.6
Brandon Jennings,27-106,G,1/7/17,NYK,IND,0,23,6,11,0.545,3,6,0.5,3,5,0.6,2,5,0.4,1,2,3,4,0,0,2,1,17,12.2
Ty Lawson,29-071,G,1/13/17,SAC,CLE,0,26,7,10,0.7,7,9,0.778,0,1,0,3,4,0.75,0,4,4,4,0,0,3,2,17,12.6
Harrison Barnes,24-213,F,12/29/16,DAL,LAL,1,36,6,17,0.353,5,13,0.385,1,4,0.25,4,4,1,2,7,9,4,1,0,2,1,17,12.4
Al Horford,30-198,C-F,12/18/16,BOS,MIA,1,31,7,16,0.438,7,11,0.636,0,5,0,3,3,1,2,5,7,8,2,1,1,1,17,18.4
Garrett Temple,30-222,G,12/16/16,SAC,MEM,1,37,4,10,0.4,1,5,0.2,3,5,0.6,6,6,1,2,4,6,4,2,0,2,1,17,16.6
Ryan Anderson,28-293,F,2/23/17,HOU,NOP,1,24,5,9,0.556,2,3,0.667,3,6,0.5,4,4,1,2,2,4,0,0,0,1,1,17,13.3
Nikola Mirotic,25-275,F,11/12/16,CHI,WAS,0,23,6,7,0.857,3,3,1,3,4,0.75,2,2,1,1,10,11,1,2,2,0,3,17,21.1
Eric Bledsoe,27-025,G,1/3/17,PHO,MIA,1,35,4,14,0.286,2,10,0.2,2,4,0.5,7,8,0.875,0,4,4,7,2,1,4,1,17,12.8
Dirk Nowitzki,38-267,F,3/13/17,DAL,TOR,1,29,7,16,0.438,4,11,0.364,3,5,0.6,0,0,,0,7,7,2,1,1,0,3,17,12.6
Kevin Seraphin,27-124,F,4/10/17,IND,PHI,0,19,8,10,0.8,8,10,0.8,0,0,,1,2,0.5,2,4,6,0,1,0,1,5,17,13.4
Gary Harris,22-203,G,4/5/17,DEN,HOU,1,30,8,14,0.571,7,10,0.7,1,4,0.25,0,1,0,1,2,3,1,1,0,0,3,17,11.8
Andre Drummond,23-171,C,1/28/17,DET,MIA,1,35,8,15,0.533,8,14,0.571,0,1,0,1,3,0.333,8,13,21,1,3,2,1,3,17,21.3
Al Horford,30-200,C-F,12/20/16,BOS,MEM,1,40,8,19,0.421,7,11,0.636,1,8,0.125,0,1,0,3,11,14,3,0,1,2,3,17,11.5
Dion Waiters,25-049,G,1/28/17,MIA,DET,1,34,7,19,0.368,6,10,0.6,1,9,0.111,2,4,0.5,1,2,3,7,0,0,4,2,17,7.1
Jared Dudley,31-125,F-G,11/12/16,PHO,BRK,0,28,6,12,0.5,2,4,0.5,4,8,0.5,1,2,0.5,2,4,6,2,0,0,1,3,17,12.4
Thabo Sefolosha,32-225,G-F,12/13/16,ATL,ORL,1,30,6,11,0.545,5,8,0.625,1,3,0.333,4,4,1,1,4,5,3,2,1,1,1,17,17
Anthony Tolliver,31-223,F-C,1/10/17,SAC,DET,1,36,4,11,0.364,1,4,0.25,3,7,0.429,6,6,1,3,1,4,3,0,0,0,1,17,15
Kenneth Faried,27-123,F,3/22/17,DEN,CLE,0,19,8,15,0.533,8,15,0.533,0,0,,1,1,1,4,5,9,1,2,0,0,2,17,15.9
John Wall,26-087,G,12/2/16,WAS,SAS,1,37,8,16,0.5,7,15,0.467,1,1,1,0,0,,0,2,2,15,3,0,3,1,17,19.7
Patty Mills,28-209,G,3/8/17,SAS,SAC,0,27,6,9,0.667,2,3,0.667,4,6,0.667,1,1,1,0,1,1,10,0,0,0,1,17,20
Patrick Beverley,28-255,G,3/24/17,HOU,NOP,1,31,6,11,0.545,2,4,0.5,4,7,0.571,1,2,0.5,1,5,6,2,1,0,4,2,17,11.1
Terrence Ross,26-050,F-G,3/27/17,ORL,TOR,1,29,8,14,0.571,8,12,0.667,0,2,0,1,1,1,0,2,2,0,4,0,1,4,17,12.4
Ricky Rubio,26-140,G,3/10/17,MIN,GSW,1,36,3,10,0.3,3,9,0.333,0,1,0,11,11,1,1,3,4,13,1,0,2,3,17,19.7
Malcolm Brogdon,24-030,G,1/10/17,MIL,SAS,1,25,5,11,0.455,2,6,0.333,3,5,0.6,4,5,0.8,2,4,6,6,0,1,1,3,17,16.2
Gary Harris,22-185,G,3/18/17,DEN,HOU,1,39,6,14,0.429,5,10,0.5,1,4,0.25,4,5,0.8,3,3,6,2,2,0,1,2,17,13.8
Eric Bledsoe,26-324,G,10/28/16,PHO,OKC,1,38,6,16,0.375,6,9,0.667,0,7,0,5,9,0.556,0,5,5,6,3,0,1,5,17,12.3
Cory Joseph,25-095,G,11/23/16,TOR,HOU,0,25,6,11,0.545,3,8,0.375,3,3,1,2,2,1,1,1,2,1,1,1,0,0,17,15.1
Rodney Stuckey,30-312,G,2/27/17,IND,HOU,0,22,6,15,0.4,4,9,0.444,2,6,0.333,3,3,1,1,5,6,3,2,0,2,1,17,12.8
Montrezl Harrell,22-281,F-C,11/2/16,HOU,NYK,0,27,8,11,0.727,8,11,0.727,0,0,,1,2,0.5,5,5,10,0,1,3,4,2,17,15.4
Paul Millsap,31-262,F,10/29/16,ATL,PHI,1,27,6,14,0.429,6,12,0.5,0,2,0,5,6,0.833,0,4,4,4,1,0,2,3,17,11
Richaun Holmes,23-153,F-C,3/17/17,PHI,DAL,1,20,8,11,0.727,8,10,0.8,0,1,0,1,2,0.5,2,5,7,2,2,0,2,0,17,16.4
Jon Leuer,27-216,F,12/16/16,DET,WAS,0,31,8,12,0.667,7,9,0.778,1,3,0.333,0,0,,1,6,7,5,1,0,1,2,17,17
Darren Collison,29-109,G,12/10/16,SAC,UTA,1,32,7,14,0.5,4,9,0.444,3,5,0.6,0,0,,1,0,1,2,1,0,2,1,17,10.7
D'Angelo Russell,20-320,G,1/8/17,LAL,ORL,1,31,7,10,0.7,5,5,1,2,5,0.4,1,2,0.5,0,8,8,7,3,1,2,3,17,20.2
Aaron Gordon,21-178,F,3/13/17,ORL,SAC,1,29,6,15,0.4,4,12,0.333,2,3,0.667,3,3,1,0,3,3,2,2,0,1,3,17,11
Gerald Henderson,28-336,G,11/9/16,PHI,IND,1,30,8,14,0.571,7,11,0.636,1,3,0.333,0,0,,1,3,4,2,0,0,3,5,17,8.4
Yogi Ferrell,23-298,G,3/3/17,DAL,MEM,1,29,6,12,0.5,6,10,0.6,0,2,0,5,5,1,0,2,2,5,1,0,1,3,17,13.9
D'Angelo Russell,20-345,G,2/2/17,LAL,WAS,1,31,5,15,0.333,1,5,0.2,4,10,0.4,3,6,0.5,1,6,7,11,1,1,7,3,17,11
George Hill,30-315,G,3/15/17,UTA,DET,1,31,6,12,0.5,5,8,0.625,1,4,0.25,4,5,0.8,0,4,4,2,0,0,2,0,17,11.2
Anthony Tolliver,31-205,F-C,12/23/16,SAC,MIN,0,31,6,9,0.667,1,2,0.5,5,7,0.714,0,0,,0,3,3,0,0,0,0,3,17,12.8
Caris LeVert,22-148,G-F,1/20/17,BRK,NOP,0,25,6,6,1,3,3,1,3,3,1,2,2,1,1,4,5,6,1,1,3,3,17,18.8
Wayne Ellington,29-033,G,12/1/16,MIA,UTA,0,34,6,9,0.667,3,4,0.75,3,5,0.6,2,2,1,0,0,0,0,1,0,0,0,17,14.1
Patty Mills,28-102,G,11/21/16,SAS,DAL,0,30,6,11,0.545,4,6,0.667,2,5,0.4,3,4,0.75,1,2,3,1,2,0,2,1,17,12.9
Greg Monroe,26-252,C-F,2/11/17,MIL,IND,0,26,6,8,0.75,6,8,0.75,0,0,,5,6,0.833,1,7,8,4,2,2,2,3,17,19.2
Aaron Gordon,21-126,F,1/20/17,ORL,MIL,1,32,7,16,0.438,7,12,0.583,0,4,0,3,6,0.5,2,6,8,3,2,0,0,2,17,13.9
Wilson Chandler,29-223,F,12/19/16,DEN,DAL,1,38,7,13,0.538,7,12,0.583,0,1,0,3,3,1,2,6,8,4,0,0,1,1,17,15.3
Dennis Schroder,23-078,G,12/2/16,ATL,DET,1,25,7,13,0.538,6,11,0.545,1,2,0.5,2,3,0.667,0,2,2,11,0,0,1,0,17,17.6
Avery Bradley,25-335,G,10/26/16,BOS,BRK,1,34,7,15,0.467,4,11,0.364,3,4,0.75,0,0,,4,5,9,6,1,0,3,4,17,14.2
Nikola Vucevic,26-032,C,11/25/16,ORL,WAS,1,35,8,16,0.5,7,14,0.5,1,2,0.5,0,0,,5,12,17,2,3,3,4,0,17,18.6
P.J. Tucker,31-209,F,11/30/16,PHO,ATL,1,30,6,9,0.667,4,6,0.667,2,3,0.667,3,3,1,1,2,3,2,0,0,2,1,17,13.4
Nene Hilario,34-201,F-C,4/2/17,HOU,PHO,0,23,7,11,0.636,7,11,0.636,0,0,,3,6,0.5,0,5,5,0,2,0,2,2,17,11.6
Kelly Olynyk,25-284,C-F,1/28/17,BOS,MIL,0,36,7,12,0.583,6,7,0.857,1,5,0.2,2,3,0.667,1,6,7,3,1,0,1,4,17,14
Dirk Nowitzki,38-187,F,12/23/16,DAL,LAC,1,15,7,12,0.583,5,9,0.556,2,3,0.667,1,1,1,2,2,4,0,0,0,1,2,17,11.6
Marvin Williams,30-222,F,1/27/17,CHO,NYK,1,31,6,14,0.429,1,5,0.2,5,9,0.556,0,0,,0,3,3,0,1,0,1,3,17,9.3
Mindaugas Kuzminskas,27-091,F,1/18/17,NYK,BOS,1,29,6,12,0.5,4,9,0.444,2,3,0.667,3,3,1,2,4,6,2,0,0,1,1,17,13.6
Frank Kaminsky,23-275,F-C,1/4/17,CHO,OKC,0,24,6,11,0.545,4,6,0.667,2,5,0.4,3,4,0.75,2,4,6,2,2,1,2,2,17,15.2
Meyers Leonard,24-329,C-F,1/21/17,POR,BOS,0,25,6,7,0.857,2,3,0.667,4,4,1,1,1,1,1,3,4,0,1,0,3,2,17,13.3
Marco Belinelli,30-323,G-F,2/11/17,CHO,LAC,0,27,7,14,0.5,5,6,0.833,2,8,0.25,1,1,1,1,3,4,1,1,0,1,3,17,11.1
Ben McLemore,23-363,G,2/8/17,SAC,BOS,0,30,7,12,0.583,4,7,0.571,3,5,0.6,0,0,,0,2,2,1,0,0,1,2,17,10.9
Dewayne Dedmon,27-182,C,2/10/17,SAS,DET,1,32,8,10,0.8,8,10,0.8,0,0,,1,1,1,5,12,17,0,1,2,3,3,17,18.5
Jameer Nelson,34-350,G,1/24/17,DEN,UTA,1,31,6,8,0.75,3,4,0.75,3,4,0.75,2,2,1,0,1,1,7,0,0,0,2,17,18.2
Robert Covington,26-061,F,2/13/17,PHI,CHO,1,30,6,16,0.375,3,6,0.5,3,10,0.3,2,3,0.667,2,3,5,1,3,1,5,3,17,8.3
Justin Anderson,23-068,G,1/26/17,DAL,OKC,0,24,5,11,0.455,2,5,0.4,3,6,0.5,4,4,1,1,4,5,1,0,0,0,2,17,13.1
Buddy Hield,23-086,G,3/13/17,SAC,ORL,1,31,6,13,0.462,4,7,0.571,2,6,0.333,3,4,0.75,0,6,6,2,2,0,2,1,17,12.7
T.J. Warren,23-185,F,3/9/17,PHO,LAL,1,39,8,17,0.471,8,16,0.5,0,1,0,1,1,1,4,9,13,3,0,3,2,2,17,15.2
Russell Westbrook,28-049,G,12/31/16,OKC,LAC,1,29,6,11,0.545,6,9,0.667,0,2,0,5,6,0.833,0,12,12,14,2,0,1,0,17,25.7
Devin Harris,33-311,G,1/3/17,DAL,WAS,0,17,6,11,0.545,2,4,0.5,4,7,0.571,1,1,1,0,4,4,1,1,0,0,2,17,13.8
Bobby Portis,22-020,F,3/2/17,CHI,GSW,1,31,6,12,0.5,4,8,0.5,2,4,0.5,3,4,0.75,2,11,13,0,0,1,1,1,17,14.6
Kelly Olynyk,25-303,C-F,2/16/17,BOS,CHI,0,32,6,10,0.6,3,4,0.75,3,6,0.5,2,3,0.667,0,7,7,4,0,0,0,2,17,16.1
Cory Joseph,25-118,G,12/16/16,TOR,ATL,0,27,7,12,0.583,6,11,0.545,1,1,1,2,2,1,2,2,4,4,0,0,0,2,17,15.4
Tobias Harris,24-266,F,4/7/17,DET,HOU,0,22,5,12,0.417,2,8,0.25,3,4,0.75,4,4,1,2,4,6,2,1,0,0,1,17,15.2
Mike Conley,29-094,G,1/13/17,MEM,HOU,1,39,7,14,0.5,5,8,0.625,2,6,0.333,1,1,1,0,6,6,9,2,1,5,2,17,15
E'Twaun Moore,27-338,G,1/31/17,NOP,TOR,0,30,6,14,0.429,1,7,0.143,5,7,0.714,0,0,,2,4,6,2,1,0,1,1,17,13.2
Brook Lopez,28-329,C,2/24/17,BRK,DEN,1,27,7,11,0.636,6,7,0.857,1,4,0.25,2,4,0.5,1,0,1,3,0,1,2,2,17,12
Ersan Ilyasova,29-225,F,12/26/16,PHI,SAC,0,33,7,12,0.583,5,7,0.714,2,5,0.4,1,2,0.5,0,4,4,2,2,0,0,5,17,13.6
Derrick Rose,28-100,G,1/12/17,NYK,CHI,1,34,7,15,0.467,7,15,0.467,0,0,,3,3,1,0,4,4,3,0,0,2,0,17,10.6
Marc Gasol,31-320,C,12/14/16,MEM,CLE,1,29,6,9,0.667,3,6,0.5,3,3,1,2,2,1,1,10,11,3,1,0,1,1,17,18.5
Iman Shumpert,26-207,G,1/19/17,CLE,PHO,1,30,6,8,0.75,1,2,0.5,5,6,0.833,0,0,,1,1,2,1,1,1,0,5,17,15.2
Dennis Schroder,23-081,G,12/5/16,ATL,OKC,1,34,6,15,0.4,5,13,0.385,1,2,0.5,4,4,1,1,5,6,8,2,0,2,1,17,16.3
Lou Williams,30-121,G,2/25/17,HOU,MIN,0,26,4,11,0.364,2,4,0.5,2,7,0.286,7,9,0.778,0,0,0,4,3,0,2,2,17,13.1
Karl-Anthony Towns,21-004,C-F,11/19/16,MIN,MEM,1,28,6,10,0.6,3,7,0.429,3,3,1,2,4,0.5,0,3,3,0,0,1,2,5,17,9.2
Tim Hardaway,24-362,G,3/13/17,ATL,SAS,0,29,6,14,0.429,3,7,0.429,3,7,0.429,2,2,1,0,2,2,4,2,1,1,1,17,14.3
DeMar DeRozan,27-216,G,3/11/17,TOR,MIA,1,28,5,16,0.313,5,14,0.357,0,2,0,7,7,1,1,3,4,2,1,0,2,0,17,9.8
Serge Ibaka,27-046,F-C,11/3/16,ORL,SAC,1,33,6,13,0.462,5,7,0.714,1,6,0.167,4,4,1,1,2,3,0,0,1,0,2,17,11.5
Wilson Chandler,29-334,F,4/9/17,DEN,OKC,1,42,6,11,0.545,1,1,1,5,10,0.5,0,0,,0,10,10,2,0,1,1,2,17,15
Sean Kilpatrick,27-017,G,1/23/17,BRK,SAS,0,31,7,16,0.438,6,10,0.6,1,6,0.167,2,2,1,0,10,10,1,0,0,3,2,17,8.5
Emmanuel Mudiay,20-293,G,12/23/16,DEN,ATL,1,28,3,8,0.375,2,5,0.4,1,3,0.333,10,10,1,0,3,3,5,0,0,2,1,17,14.6
Goran Dragic,30-195,G,11/17/16,MIA,MIL,1,35,5,14,0.357,4,11,0.364,1,3,0.333,5,6,0.833,2,4,6,4,1,0,2,2,16,11.4
Greg Monroe,26-205,C-F,12/26/16,MIL,WAS,0,22,7,10,0.7,7,10,0.7,0,0,,2,4,0.5,1,4,5,1,1,0,2,0,16,12.6
Jahlil Okafor,21-048,C-F,2/1/17,PHI,DAL,1,24,7,16,0.438,7,16,0.438,0,0,,2,5,0.4,0,1,1,1,0,0,1,3,16,5.2
Jon Leuer,27-314,F,3/24/17,DET,ORL,0,28,7,11,0.636,7,9,0.778,0,2,0,2,2,1,2,6,8,2,1,0,1,0,16,15.7
James Johnson,30-049,F,4/10/17,MIA,CLE,1,36,7,17,0.412,6,10,0.6,1,7,0.143,1,1,1,0,2,2,9,0,0,3,6,16,8.4
Bojan Bogdanovic,27-287,G-F,1/30/17,BRK,MIA,1,31,6,13,0.462,5,9,0.556,1,4,0.25,3,3,1,0,6,6,1,0,0,3,2,16,8
Boris Diaw,34-283,F-C,1/24/17,UTA,DEN,0,24,7,12,0.583,5,7,0.714,2,5,0.4,0,0,,0,1,1,3,0,0,0,2,16,12
Jameer Nelson,35-035,G,3/16/17,DEN,LAC,1,34,4,8,0.5,1,4,0.25,3,4,0.75,5,5,1,0,1,1,5,2,0,3,0,16,14.8
Avery Bradley,26-104,G,3/10/17,BOS,DEN,1,29,6,14,0.429,2,6,0.333,4,8,0.5,0,0,,0,2,2,2,3,0,3,3,16,9.4
Kevin Love,28-085,F,12/1/16,CLE,LAC,1,25,7,11,0.636,5,6,0.833,2,5,0.4,0,0,,0,4,4,0,0,0,3,3,16,8.1
Enes Kanter,24-184,C,11/20/16,OKC,IND,0,25,5,9,0.556,4,7,0.571,1,2,0.5,5,6,0.833,0,4,4,3,1,3,2,3,16,14.5
James Ennis,26-124,F,11/2/16,MEM,NOP,1,38,5,8,0.625,3,4,0.75,2,4,0.5,4,4,1,2,8,10,0,2,0,2,1,16,15.8
Ian Mahinmi,30-139,C,3/24/17,WAS,BRK,0,24,5,6,0.833,5,6,0.833,0,0,,6,7,0.857,3,4,7,0,4,1,0,2,16,20.6
Lou Williams,30-048,G,12/14/16,LAL,BRK,0,24,5,12,0.417,5,8,0.625,0,4,0,6,6,1,1,1,2,2,2,0,3,4,16,9.4
Jameer Nelson,35-006,G,2/15/17,DEN,MIN,1,35,7,15,0.467,6,10,0.6,1,5,0.2,1,1,1,2,6,8,11,0,0,4,4,16,13.6
Jabari Parker,21-312,F,1/21/17,MIL,MIA,0,32,7,18,0.389,7,14,0.5,0,4,0,2,3,0.667,2,5,7,4,1,1,2,1,16,10.8
Willy Hernangomez,22-253,C,2/4/17,NYK,CLE,0,36,7,10,0.7,7,9,0.778,0,1,0,2,6,0.333,3,2,5,5,0,2,2,1,16,15.4
Goran Dragic,30-278,G,2/8/17,MIA,MIL,1,34,7,13,0.538,7,11,0.636,0,2,0,2,3,0.667,2,2,4,7,2,0,5,3,16,12
Thomas Robinson,26-004,F,3/21/17,LAL,LAC,0,10,7,8,0.875,7,8,0.875,0,0,,2,2,1,2,4,6,1,0,0,0,2,16,15.7
Serge Ibaka,27-144,F-C,2/9/17,ORL,PHI,1,35,6,14,0.429,4,10,0.4,2,4,0.5,2,2,1,2,1,3,1,0,4,1,5,16,10.8
Cody Zeller,24-100,F-C,1/13/17,CHO,PHI,1,36,6,14,0.429,6,14,0.429,0,0,,4,4,1,6,4,10,1,3,1,3,5,16,13.4
Clint Capela,22-250,F-C,1/23/17,HOU,MIL,1,22,7,12,0.583,7,12,0.583,0,0,,2,3,0.667,1,2,3,1,0,0,0,3,16,10.8
Kentavious Caldwell-Pope,24-010,G,2/28/17,DET,POR,1,47,5,12,0.417,4,8,0.5,1,4,0.25,5,5,1,0,3,3,3,3,0,1,2,16,13.8
Elfrid Payton,22-279,G,11/27/16,ORL,MIL,0,29,6,9,0.667,5,6,0.833,1,3,0.333,3,4,0.75,0,3,3,3,1,0,3,3,16,11.5
Marcus Thornton,29-157,G,11/9/16,WAS,BOS,0,34,5,13,0.385,3,8,0.375,2,5,0.4,4,4,1,2,2,4,4,3,0,1,3,16,14.5
Myles Turner,20-277,F-C,12/26/16,IND,CHI,1,28,7,15,0.467,6,12,0.5,1,3,0.333,1,2,0.5,0,8,8,0,0,2,0,4,16,10.1
Doug McDermott,25-056,F,2/28/17,OKC,UTA,0,25,6,11,0.545,2,5,0.4,4,6,0.667,0,0,,0,5,5,1,0,0,0,0,16,12.9
Gerald Green,31-016,G-F,2/11/17,BOS,UTA,0,23,7,8,0.875,5,5,1,2,3,0.667,0,0,,0,0,0,0,0,0,1,3,16,11
Marcus Morris,27-177,F,2/26/17,DET,BOS,1,38,5,15,0.333,3,8,0.375,2,7,0.286,4,5,0.8,5,5,10,4,1,0,5,3,16,9.7
C.J. Miles,29-289,G-F,2/1/17,IND,ORL,1,21,6,7,0.857,2,2,1,4,5,0.8,0,0,,0,4,4,0,0,0,0,3,16,13.5
Jeff Teague,28-185,G,12/12/16,IND,CHO,1,35,5,8,0.625,2,5,0.4,3,3,1,3,5,0.6,1,4,5,11,1,0,4,3,16,17
Cory Joseph,25-146,G,1/13/17,TOR,BRK,0,22,7,7,1,6,6,1,1,1,1,1,1,1,1,3,4,7,2,0,1,1,16,21
Robert Covington,26-079,F,3/3/17,PHI,NYK,1,36,3,9,0.333,1,4,0.25,2,5,0.4,8,9,0.889,1,3,4,3,1,5,4,4,16,13.1
Enes Kanter,24-163,C,10/30/16,OKC,LAL,0,22,8,11,0.727,8,10,0.8,0,1,0,0,0,,1,5,6,0,0,0,2,2,16,10.9
LaMarcus Aldridge,31-186,F-C,1/21/17,SAS,CLE,1,42,7,14,0.5,7,14,0.5,0,0,,2,4,0.5,4,8,12,6,0,2,1,2,16,17.2
Jahlil Okafor,21-084,C-F,3/9/17,PHI,POR,1,29,7,14,0.5,7,14,0.5,0,0,,2,2,1,3,5,8,1,1,0,1,4,16,11.7
Jaylen Brown,20-130,F,3/3/17,BOS,LAL,0,23,7,13,0.538,7,11,0.636,0,2,0,2,3,0.667,2,6,8,0,0,0,2,0,16,10.5
Malcolm Brogdon,24-108,G,3/29/17,MIL,BOS,1,29,7,12,0.583,7,11,0.636,0,1,0,2,2,1,0,4,4,9,1,1,0,4,16,18
Rudy Gobert,24-144,C,11/17/16,UTA,CHI,1,41,7,9,0.778,7,9,0.778,0,0,,2,2,1,5,8,13,1,0,3,2,0,16,19.2
Gary Harris,22-149,G,2/10/17,DEN,NYK,1,34,6,10,0.6,3,4,0.75,3,6,0.5,1,1,1,2,5,7,2,1,0,2,0,16,14.7
Derrick Rose,28-146,G,2/27/17,NYK,TOR,1,40,5,12,0.417,5,11,0.455,0,1,0,6,6,1,0,6,6,4,2,0,3,3,16,12
Mason Plumlee,27-037,C-F,4/11/17,DEN,DAL,1,34,8,14,0.571,8,14,0.571,0,0,,0,0,,3,6,9,0,1,1,4,3,16,9.8
Dwight Howard,31-046,C,1/23/17,ATL,LAC,1,35,6,7,0.857,6,7,0.857,0,0,,4,5,0.8,1,11,12,3,2,0,2,3,16,18
Montrezl Harrell,22-355,F-C,1/15/17,HOU,BRK,1,34,6,9,0.667,6,9,0.667,0,0,,4,6,0.667,2,6,8,1,1,2,1,0,16,16.6
Nicolas Batum,28-061,F-G,2/13/17,CHO,PHI,1,38,5,12,0.417,2,6,0.333,3,6,0.5,3,3,1,0,1,1,4,2,0,1,0,16,13.7
Thomas Robinson,26-015,F,4/1/17,LAL,LAC,0,22,7,15,0.467,7,14,0.5,0,1,0,2,5,0.4,5,4,9,3,1,0,1,1,16,13.5
Kyle O'Quinn,26-321,F-C,2/10/17,NYK,DEN,0,22,8,9,0.889,8,8,1,0,1,0,0,0,,2,4,6,3,0,4,2,2,16,17.6
Taj Gibson,31-178,F,12/19/16,CHI,DET,1,19,8,8,1,8,8,1,0,0,,0,0,,0,4,4,0,1,1,1,0,16,15.5
Rondae Hollis-Jefferson,21-362,F,12/30/16,BRK,WAS,0,29,6,13,0.462,6,13,0.462,0,0,,4,6,0.667,1,4,5,1,1,0,2,0,16,10.1
E'Twaun Moore,27-250,G,11/4/16,NOP,PHO,1,36,5,15,0.333,4,12,0.333,1,3,0.333,5,6,0.833,0,1,1,5,2,1,1,4,16,11
Trevor Booker,28-361,F,11/20/16,BRK,POR,1,26,7,9,0.778,5,7,0.714,2,2,1,0,0,,3,1,4,1,2,0,1,2,16,15.8
Danilo Gallinari,28-116,F,12/2/16,DEN,HOU,1,35,6,11,0.545,4,8,0.5,2,3,0.667,2,2,1,2,3,5,1,0,0,1,1,16,12.3
Courtney Lee,31-116,G,1/27/17,NYK,CHO,1,35,7,12,0.583,5,7,0.714,2,5,0.4,0,0,,0,3,3,4,3,1,1,1,16,16.4
Rudy Gobert,24-155,C,11/28/16,UTA,MIN,1,34,5,10,0.5,5,10,0.5,0,0,,6,8,0.75,8,9,17,1,0,3,2,4,16,17.7
Monta Ellis,31-121,G,2/24/17,IND,MEM,0,24,7,10,0.7,5,7,0.714,2,3,0.667,0,0,,0,1,1,3,0,0,2,2,16,11.4
Clint Capela,22-161,F-C,10/26/16,HOU,LAL,1,26,8,11,0.727,8,11,0.727,0,0,,0,1,0,3,6,9,0,0,1,1,2,16,13.9
Seth Curry,26-170,G,2/9/17,DAL,UTA,1,43,6,12,0.5,5,8,0.625,1,4,0.25,3,3,1,1,4,5,4,0,0,4,0,16,10.7
Nikola Vucevic,26-079,C,1/11/17,ORL,LAC,1,32,8,16,0.5,8,14,0.571,0,2,0,0,0,,1,11,12,4,1,2,3,2,16,13.4
Marcin Gortat,32-342,C-F,1/24/17,WAS,BOS,1,33,7,8,0.875,7,8,0.875,0,0,,2,2,1,2,6,8,0,1,0,2,1,16,15
Andrew Wiggins,21-277,F-G,11/26/16,MIN,GSW,1,39,6,15,0.4,5,9,0.556,1,6,0.167,3,4,0.75,0,3,3,3,1,0,3,1,16,8.1
Ish Smith,28-279,G,4/10/17,DET,WAS,1,32,7,14,0.5,7,13,0.538,0,1,0,2,2,1,1,1,2,9,0,1,2,2,16,14.2
Dario Saric,22-359,F,4/2/17,PHI,TOR,1,24,5,13,0.385,4,9,0.444,1,4,0.25,5,6,0.833,1,2,3,1,1,0,3,2,16,7.7
George Hill,30-320,G,3/20/17,UTA,IND,1,38,7,17,0.412,7,11,0.636,0,6,0,2,2,1,2,4,6,6,0,0,2,1,16,11.3
John Wall,26-195,G,3/20/17,WAS,BOS,1,34,4,10,0.4,4,7,0.571,0,3,0,8,9,0.889,0,4,4,8,3,0,5,1,16,14.6
Nene Hilario,34-169,F-C,3/1/17,HOU,LAC,0,22,6,7,0.857,6,7,0.857,0,0,,4,5,0.8,4,5,9,0,1,0,1,2,16,16.6
Mason Plumlee,27-038,C-F,4/12/17,DEN,OKC,1,33,6,10,0.6,6,10,0.6,0,0,,4,6,0.667,1,4,5,0,0,1,3,5,16,8.2
Tyler Johnson,24-308,G,3/11/17,MIA,TOR,0,27,6,12,0.5,6,11,0.545,0,1,0,4,4,1,0,3,3,3,0,0,1,2,16,11.2
Tyreke Evans,27-102,G-F,12/30/16,NOP,NYK,0,18,5,11,0.455,3,6,0.5,2,5,0.4,4,4,1,0,5,5,4,0,0,1,0,16,13.6
Gordon Hayward,27-010,F-G,4/2/17,UTA,SAS,1,36,6,19,0.316,5,14,0.357,1,5,0.2,3,5,0.6,1,2,3,4,1,0,2,3,16,6.2
Al Jefferson,31-326,C-F,11/25/16,IND,BRK,0,19,8,14,0.571,8,14,0.571,0,0,,0,0,,1,2,3,1,0,0,1,3,16,9.2
Doug McDermott,25-040,F,2/12/17,CHI,MIN,1,29,6,15,0.4,2,8,0.25,4,7,0.571,0,0,,0,1,1,2,0,0,2,1,16,7.2
Ty Lawson,29-047,G,12/20/16,SAC,POR,0,29,6,8,0.75,6,7,0.857,0,1,0,4,4,1,0,3,3,8,1,0,0,1,16,19.9
Nicolas Batum,27-361,F-G,12/9/16,CHO,ORL,1,29,6,11,0.545,2,7,0.286,4,4,1,0,0,,1,8,9,7,0,0,2,1,16,16.3
E'Twaun Moore,27-321,G,1/14/17,NOP,CHI,0,27,6,9,0.667,2,4,0.5,4,5,0.8,0,0,,0,1,1,2,0,1,1,2,16,12.7
Jeff Green,30-096,F,12/2/16,ORL,PHI,0,23,6,13,0.462,4,9,0.444,2,4,0.5,2,2,1,1,5,6,3,0,0,2,2,16,10.8
Nikola Mirotic,25-263,F,10/31/16,CHI,BRK,0,25,6,14,0.429,2,4,0.5,4,10,0.4,0,0,,1,9,10,3,0,3,3,1,16,12.8
James Ennis,26-120,F,10/29/16,MEM,NYK,1,27,5,7,0.714,3,4,0.75,2,3,0.667,4,5,0.8,1,3,4,1,0,0,1,3,16,12.8
Jimmy Butler,27-123,G-F,1/15/17,CHI,MEM,1,38,6,14,0.429,5,9,0.556,1,5,0.2,3,7,0.429,0,8,8,6,3,0,2,2,16,13.8
Zaza Pachulia,33-017,C,2/27/17,GSW,PHI,1,15,5,5,1,5,5,1,0,0,,6,7,0.857,1,4,5,2,1,1,0,0,16,19.1
Buddy Hield,23-116,G,4/12/17,SAC,LAC,1,37,7,15,0.467,5,11,0.455,2,4,0.5,0,1,0,2,4,6,4,0,0,2,3,16,10.1
Dwyane Wade,34-346,G,12/28/16,CHI,BRK,1,22,5,13,0.385,5,12,0.417,0,1,0,6,7,0.857,2,2,4,1,0,1,3,1,16,8.5
Trevor Booker,29-041,F,1/5/17,BRK,IND,1,20,7,11,0.636,5,9,0.556,2,2,1,0,0,,2,4,6,0,0,0,2,0,16,11.7
Sergio Rodriguez,30-179,G,12/8/16,PHI,NOP,1,30,6,13,0.462,2,5,0.4,4,8,0.5,0,0,,0,2,2,8,1,0,1,2,16,14.7
Serge Ibaka,27-190,F-C,3/27/17,TOR,ORL,1,32,5,10,0.5,3,8,0.375,2,2,1,4,5,0.8,2,5,7,1,1,0,1,5,16,12.2
Jae Crowder,26-199,F,1/21/17,BOS,POR,1,40,5,12,0.417,2,5,0.4,3,7,0.429,3,3,1,0,4,4,2,1,0,1,3,16,11
Anthony Tolliver,31-213,F-C,12/31/16,SAC,MEM,0,28,4,5,0.8,0,0,,4,5,0.8,4,4,1,2,4,6,2,0,0,1,2,16,16.3
Marquese Chriss,19-260,F,3/19/17,PHO,DET,1,26,5,13,0.385,4,10,0.4,1,3,0.333,5,6,0.833,1,6,7,0,1,0,1,4,16,9.4
Joe Harris,25-049,G,10/26/16,BRK,BOS,0,25,6,15,0.4,2,6,0.333,4,9,0.444,0,0,,0,4,4,3,2,2,3,3,16,10.4
Gordon Hayward,26-290,F-G,1/7/17,UTA,MIN,1,32,4,13,0.308,3,9,0.333,1,4,0.25,7,7,1,0,2,2,3,1,0,3,2,16,8.4
Lou Williams,30-033,G,11/29/16,LAL,NOP,0,22,5,14,0.357,3,7,0.429,2,7,0.286,4,5,0.8,1,2,3,4,1,0,2,0,16,10.9
C.J. McCollum,25-095,G,12/23/16,POR,SAS,1,30,5,16,0.313,2,8,0.25,3,8,0.375,3,4,0.75,3,3,6,3,2,0,3,2,16,9.7
LaMarcus Aldridge,31-100,F-C,10/27/16,SAS,SAC,1,32,5,13,0.385,5,12,0.417,0,1,0,6,8,0.75,2,3,5,1,0,0,1,4,16,8.5
Justin Hamilton,26-282,C,1/8/17,BRK,PHI,0,23,6,11,0.545,4,7,0.571,2,4,0.5,2,3,0.667,1,4,5,0,0,2,0,2,16,12.8
Tobias Harris,24-107,F,10/30/16,DET,MIL,1,31,7,12,0.583,5,9,0.556,2,3,0.667,0,0,,1,4,5,2,2,0,1,2,16,13.9
Frank Kaminsky,23-328,F-C,2/26/17,CHO,LAC,1,28,5,13,0.385,4,8,0.5,1,5,0.2,5,5,1,0,5,5,4,0,0,2,6,16,8.8
Devin Booker,20-042,G,12/11/16,PHO,NOP,1,38,6,15,0.4,4,7,0.571,2,8,0.25,2,3,0.667,0,5,5,5,1,0,4,1,16,9.1
Kristaps Porzingis,21-084,F-C,10/25/16,NYK,CLE,1,33,5,13,0.385,2,8,0.25,3,5,0.6,3,6,0.5,4,3,7,0,1,2,2,5,16,9.8
Serge Ibaka,27-110,F-C,1/6/17,ORL,HOU,1,33,8,17,0.471,8,16,0.5,0,1,0,0,2,0,5,7,12,1,0,0,1,3,16,10.6
Jae Crowder,26-149,F,12/2/16,BOS,SAC,1,37,6,12,0.5,3,7,0.429,3,5,0.6,1,1,1,0,3,3,3,1,0,2,4,16,10.4
Brandon Knight,25-068,G,2/8/17,PHO,MEM,0,26,5,11,0.455,3,7,0.429,2,4,0.5,4,4,1,1,1,2,2,2,0,3,4,16,10.1
Eric Bledsoe,27-061,G,2/8/17,PHO,MEM,1,25,3,15,0.2,2,11,0.182,1,4,0.25,9,9,1,0,0,0,3,1,0,2,3,16,6.6
Jabari Parker,21-242,F,11/12/16,MIL,MEM,1,34,5,16,0.313,5,12,0.417,0,4,0,6,8,0.75,1,3,4,2,0,0,2,2,16,6.2
Jeff Green,30-154,F,1/29/17,ORL,TOR,0,27,6,8,0.75,4,5,0.8,2,3,0.667,2,4,0.5,1,2,3,2,2,0,1,2,16,14.9
Ian Mahinmi,30-132,C,3/17/17,WAS,CHI,0,20,8,11,0.727,8,11,0.727,0,0,,0,0,,2,1,3,1,0,2,1,3,16,13.1
Brandon Knight,24-336,G,11/2/16,PHO,POR,0,32,6,17,0.353,5,13,0.385,1,4,0.25,3,3,1,1,3,4,3,0,0,1,3,16,8
Avery Bradley,26-111,G,3/17/17,BOS,BRK,1,34,6,13,0.462,6,11,0.545,0,2,0,4,5,0.8,1,4,5,1,1,0,3,2,16,8.7
Tyler Johnson,24-255,G,1/17/17,MIA,HOU,0,34,6,17,0.353,5,13,0.385,1,4,0.25,3,5,0.6,1,1,2,3,3,0,0,1,16,11.4
Meyers Leonard,24-300,C-F,12/23/16,POR,SAS,0,28,6,11,0.545,2,4,0.5,4,7,0.571,0,0,,1,4,5,0,0,1,1,2,16,11.5
Kristaps Porzingis,21-158,F-C,1/7/17,NYK,IND,1,34,5,11,0.455,1,5,0.2,4,6,0.667,2,2,1,1,3,4,3,1,4,5,4,16,11.2
Sergio Rodriguez,30-185,G,12/14/16,PHI,TOR,1,29,7,15,0.467,5,9,0.556,2,6,0.333,0,0,,0,1,1,5,0,0,1,3,16,9.9
Harrison Barnes,24-261,F,2/15/17,DAL,DET,1,37,7,16,0.438,7,12,0.583,0,4,0,2,2,1,1,4,5,1,0,0,0,2,16,9.4
Courtney Lee,31-171,G,3/23/17,NYK,POR,1,41,6,12,0.5,6,9,0.667,0,3,0,4,4,1,0,1,1,4,1,0,2,2,16,11.3
T.J. McConnell,24-360,G,3/20/17,PHI,ORL,1,34,6,15,0.4,6,13,0.462,0,2,0,4,4,1,0,1,1,10,3,0,3,0,16,15.2
DeAndre Jordan,28-120,C,11/18/16,LAC,SAC,1,37,8,10,0.8,8,10,0.8,0,0,,0,0,,1,11,12,0,1,1,2,5,16,13.9
Paul George,26-232,F,12/20/16,IND,NYK,1,36,6,16,0.375,6,13,0.462,0,3,0,4,4,1,1,4,5,3,2,0,3,2,16,9.4
Taj Gibson,31-136,F,11/7/16,CHI,ORL,1,28,7,13,0.538,7,13,0.538,0,0,,2,2,1,2,9,11,3,0,0,0,2,16,15.1
LeBron James,31-337,F-G,12/1/16,CLE,LAC,1,34,5,14,0.357,5,12,0.417,0,2,0,6,11,0.545,1,4,5,5,2,0,5,2,16,7.8
Jusuf Nurkic,22-212,C,3/23/17,POR,NYK,1,27,6,9,0.667,6,9,0.667,0,0,,4,7,0.571,3,7,10,3,0,0,2,5,16,13.2
Nikola Mirotic,26-058,F,4/10/17,CHI,ORL,1,27,6,12,0.5,3,6,0.5,3,6,0.5,1,1,1,1,4,5,2,2,1,0,3,16,14.8
Nicolas Batum,27-337,F-G,11/15/16,CHO,MIN,1,36,5,9,0.556,1,4,0.25,4,5,0.8,2,3,0.667,0,5,5,7,3,1,0,4,16,19.8
Avery Bradley,26-009,G,12/5/16,BOS,HOU,1,35,8,16,0.5,8,14,0.571,0,2,0,0,0,,2,8,10,1,1,0,1,5,16,10.5
Tony Parker,34-185,G,11/18/16,SAS,LAL,1,27,6,10,0.6,5,9,0.556,1,1,1,3,3,1,1,1,2,7,0,0,0,2,16,16.5
Bojan Bogdanovic,27-316,G-F,2/28/17,WAS,GSW,0,24,5,12,0.417,2,6,0.333,3,6,0.5,3,3,1,2,0,2,0,1,0,1,1,16,10.6
Derrick Rose,28-029,G,11/2/16,NYK,HOU,1,30,8,18,0.444,8,18,0.444,0,0,,0,0,,1,3,4,4,2,0,2,2,16,10.2
C.J. McCollum,25-064,G,11/22/16,POR,NYK,1,36,6,17,0.353,5,14,0.357,1,3,0.333,3,3,1,1,4,5,5,0,0,1,2,16,10.1
Wesley Matthews,30-070,G,12/23/16,DAL,LAC,1,40,6,16,0.375,5,8,0.625,1,8,0.125,3,6,0.5,0,6,6,2,3,1,0,3,16,11.7
Nerlens Noel,22-290,C-F,1/25/17,PHI,MIL,1,28,5,9,0.556,5,9,0.556,0,0,,6,6,1,3,10,13,0,1,1,1,4,16,15.9
Marvin Williams,30-205,F,1/10/17,CHO,HOU,1,25,6,10,0.6,3,5,0.6,3,5,0.6,1,2,0.5,1,7,8,0,1,0,0,3,16,13.6
Jordan Clarkson,24-233,G,1/26/17,LAL,UTA,0,36,8,18,0.444,8,16,0.5,0,2,0,0,0,,0,5,5,4,1,0,3,3,16,7.7
Rondae Hollis-Jefferson,22-029,F,2/1/17,BRK,NYK,1,30,6,11,0.545,6,10,0.6,0,1,0,4,4,1,3,5,8,3,0,1,4,5,16,11.1
Tim Hardaway,25-010,G,3/26/17,ATL,BRK,1,39,5,16,0.313,4,10,0.4,1,6,0.167,5,6,0.833,1,3,4,3,2,0,4,3,16,6.9
Jon Leuer,27-219,F,12/19/16,DET,CHI,0,21,7,9,0.778,7,8,0.875,0,1,0,2,2,1,2,3,5,1,0,0,1,0,16,14.5
Rudy Gobert,24-173,C,12/16/16,UTA,DAL,1,35,4,7,0.571,4,7,0.571,0,0,,8,10,0.8,3,7,10,1,1,1,2,3,16,15.3
Solomon Hill,25-358,F,3/11/17,NOP,CHO,1,43,7,11,0.636,5,6,0.833,2,5,0.4,0,0,,1,2,3,0,1,0,0,2,16,12.6
Courtney Lee,31-026,G,10/29/16,NYK,MEM,1,34,6,11,0.545,4,7,0.571,2,4,0.5,2,2,1,0,3,3,1,1,0,0,1,16,12.9
Kent Bazemore,27-204,G-F,1/21/17,ATL,PHI,1,24,7,12,0.583,5,8,0.625,2,4,0.5,0,0,,0,2,2,2,1,0,2,3,16,10.2
Bradley Beal,23-273,G,3/28/17,WAS,LAL,1,35,7,16,0.438,6,11,0.545,1,5,0.2,1,1,1,0,1,1,3,0,1,4,2,16,5.9
J.J. Redick,32-262,G,3/13/17,LAC,UTA,1,33,5,11,0.455,4,7,0.571,1,4,0.25,5,6,0.833,0,1,1,1,0,0,0,2,16,10.1
Myles Turner,20-361,F-C,3/20/17,IND,UTA,1,35,6,11,0.545,6,11,0.545,0,0,,4,4,1,2,4,6,1,0,4,1,4,16,14.2
Jae Crowder,26-172,F,12/25/16,BOS,NYK,1,34,5,9,0.556,2,3,0.667,3,6,0.5,3,4,0.75,1,5,6,1,0,0,0,3,16,13
Marcus Morris,27-068,F,11/9/16,DET,PHO,1,40,5,13,0.385,4,9,0.444,1,4,0.25,5,5,1,0,3,3,2,2,0,1,3,16,11
Anthony Davis,23-322,F-C,1/27/17,NOP,SAS,1,33,6,11,0.545,6,10,0.6,0,1,0,4,5,0.8,5,17,22,2,1,1,7,2,16,14.2
Jeff Teague,28-146,G,11/3/16,IND,MIL,1,30,4,11,0.364,3,8,0.375,1,3,0.333,7,8,0.875,1,3,4,6,3,0,4,1,16,13.9
JaVale McGee,29-023,C,2/11/17,GSW,OKC,1,20,7,8,0.875,7,8,0.875,0,0,,2,5,0.4,3,0,3,0,0,0,0,3,16,12.9
Draymond Green,26-296,F,12/25/16,GSW,CLE,1,32,7,9,0.778,7,7,1,0,2,0,2,2,1,0,4,4,4,1,0,6,5,16,9.5
Tobias Harris,24-197,F,1/28/17,DET,MIA,0,28,7,11,0.636,7,11,0.636,0,0,,2,2,1,0,2,2,0,0,0,2,1,16,9.3
Rajon Rondo,30-262,G,11/10/16,CHI,MIA,1,37,6,14,0.429,5,13,0.385,1,1,1,3,4,0.75,1,11,12,6,2,0,1,0,16,17.4
Eric Gordon,27-328,G,11/17/16,HOU,POR,0,24,6,15,0.4,4,8,0.5,2,7,0.286,2,3,0.667,3,2,5,3,0,0,2,3,16,9.1
Marvin Williams,30-254,F,2/28/17,CHO,LAL,1,34,6,11,0.545,2,4,0.5,4,7,0.571,0,0,,3,4,7,2,0,2,1,2,16,15
Eric Gordon,27-325,G,11/14/16,HOU,PHI,1,27,6,12,0.5,2,5,0.4,4,7,0.571,0,0,,0,1,1,1,0,0,1,3,16,8.8
Aaron Gordon,21-176,F,3/11/17,ORL,CLE,1,31,6,12,0.5,6,11,0.545,0,1,0,4,4,1,2,3,5,3,0,0,0,1,16,14
Yogi Ferrell,23-302,G,3/7/17,DAL,LAL,1,32,6,9,0.667,4,5,0.8,2,4,0.5,2,2,1,1,1,2,7,0,0,2,2,16,15.2
Dion Waiters,24-345,G,11/19/16,MIA,WAS,1,29,7,16,0.438,6,12,0.5,1,4,0.25,1,2,0.5,1,3,4,8,0,1,2,4,16,11.5
Gorgui Dieng,27-038,C,2/25/17,MIN,HOU,1,36,7,10,0.7,7,9,0.778,0,1,0,2,4,0.5,4,9,13,2,4,1,3,3,16,18.4
Draymond Green,26-245,F,11/4/16,GSW,LAL,1,34,6,10,0.6,6,7,0.857,0,3,0,4,6,0.667,2,7,9,4,4,0,1,1,16,19.5
Elfrid Payton,23-012,G,3/6/17,ORL,NYK,1,35,7,13,0.538,7,12,0.583,0,1,0,2,2,1,3,8,11,10,1,0,2,4,16,18.6
Steven Adams,23-171,C,1/7/17,OKC,DEN,1,31,7,10,0.7,7,10,0.7,0,0,,2,3,0.667,0,5,5,2,1,4,2,3,16,14.9
LeBron James,32-014,F-G,1/13/17,CLE,SAC,1,42,6,12,0.5,5,8,0.625,1,4,0.25,3,3,1,0,2,2,15,1,1,5,2,16,17
Elfrid Payton,22-308,G,12/26/16,ORL,MEM,0,25,6,10,0.6,5,8,0.625,1,2,0.5,3,5,0.6,0,4,4,7,1,0,1,3,16,15.5
Mason Plumlee,27-021,C-F,3/26/17,DEN,NOP,0,19,8,10,0.8,8,10,0.8,0,0,,0,1,0,1,4,5,1,0,1,2,0,16,13.1
Greg Monroe,26-310,C-F,4/10/17,MIL,CHO,0,26,7,14,0.5,7,14,0.5,0,0,,2,4,0.5,2,6,8,3,1,0,0,2,16,13.7
Greg Monroe,26-298,C-F,3/29/17,MIL,BOS,0,27,6,9,0.667,6,9,0.667,0,0,,4,4,1,1,7,8,3,1,0,4,1,16,13.6
Derrick Rose,28-103,G,1/15/17,NYK,TOR,1,29,6,12,0.5,6,12,0.5,0,0,,4,5,0.8,0,2,2,3,0,1,2,0,16,11
Brandon Ingram,19-082,F,11/23/16,LAL,GSW,1,34,6,12,0.5,4,8,0.5,2,4,0.5,2,2,1,0,3,3,1,0,0,3,0,16,8.6
Pau Gasol,36-135,F-C,11/18/16,SAS,LAL,1,28,6,13,0.462,6,13,0.462,0,0,,4,4,1,0,5,5,2,0,2,2,3,16,10.4
Steven Adams,23-129,C,11/26/16,OKC,DET,1,29,7,9,0.778,7,9,0.778,0,0,,2,5,0.4,3,6,9,0,1,0,2,1,16,13.8
Brandon Jennings,27-136,G,2/6/17,NYK,LAL,0,28,5,9,0.556,4,6,0.667,1,3,0.333,5,7,0.714,0,3,3,5,1,0,2,3,16,13.1
Cody Zeller,24-172,F-C,3/26/17,CHO,PHO,1,32,6,9,0.667,6,9,0.667,0,0,,4,5,0.8,2,5,7,2,4,0,1,4,16,17.4
Willy Hernangomez,22-250,C,2/1/17,NYK,BRK,0,25,7,12,0.583,7,12,0.583,0,0,,2,4,0.5,7,9,16,2,2,1,1,2,16,19.5
Austin Rivers,24-168,G,1/16/17,LAC,OKC,1,35,5,13,0.385,3,6,0.5,2,7,0.286,4,4,1,0,2,2,6,1,0,3,2,16,10.9
Carmelo Anthony,32-283,F,3/8/17,NYK,MIL,1,40,6,13,0.462,4,9,0.444,2,4,0.5,2,3,0.667,2,2,4,3,1,0,2,5,16,10
Robin Lopez,29-007,C,4/8/17,CHI,BRK,1,27,7,11,0.636,7,11,0.636,0,0,,2,2,1,2,6,8,0,0,1,2,4,16,11.4
Danilo Gallinari,28-090,F,11/6/16,DEN,BOS,1,41,7,13,0.538,5,9,0.556,2,4,0.5,0,0,,1,2,3,3,0,1,1,1,16,12.4
Troy Daniels,25-164,G,12/26/16,MEM,ORL,0,20,5,12,0.417,1,4,0.25,4,8,0.5,2,3,0.667,1,3,4,1,1,0,0,0,16,12.5
Zach Randolph,35-115,F,11/8/16,MEM,DEN,0,23,8,13,0.615,8,13,0.615,0,0,,0,1,0,4,4,8,0,0,0,1,2,16,11.9
Mike Conley,29-151,G,3/11/17,MEM,ATL,1,32,5,12,0.417,4,5,0.8,1,7,0.143,5,5,1,0,1,1,5,5,0,3,2,16,14.6
Alex Len,23-146,C,11/9/16,PHO,DET,1,37,7,10,0.7,7,10,0.7,0,0,,2,6,0.333,1,13,14,0,3,1,0,3,16,17.3
Tony Snell,25-095,G-F,2/13/17,MIL,DET,1,30,5,11,0.455,1,3,0.333,4,8,0.5,2,2,1,0,2,2,1,0,0,1,1,16,10.2
Richaun Holmes,23-171,F-C,4/4/17,PHI,BRK,1,24,7,11,0.636,5,8,0.625,2,3,0.667,0,0,,1,5,6,4,1,3,2,2,16,16.4
Nikola Jokic,22-027,C-F,3/18/17,DEN,HOU,1,22,7,14,0.5,6,12,0.5,1,2,0.5,1,1,1,2,3,5,4,0,1,3,5,16,9.8
Marc Gasol,32-048,C,3/18/17,MEM,SAS,1,39,6,14,0.429,5,11,0.455,1,3,0.333,3,3,1,0,5,5,7,0,0,2,2,16,12.2
Frank Kaminsky,23-332,F-C,3/2/17,CHO,PHO,1,32,7,14,0.5,5,8,0.625,2,6,0.333,0,0,,0,1,1,0,2,0,2,3,16,8.1
Jonas Valanciunas,24-261,C,1/22/17,TOR,PHO,1,31,6,10,0.6,6,10,0.6,0,0,,4,5,0.8,4,8,12,2,1,3,1,3,16,18.5
Gary Harris,22-152,G,2/13/17,DEN,GSW,1,32,6,12,0.5,2,5,0.4,4,7,0.571,0,2,0,1,1,2,1,1,0,3,0,16,8.9
Will Barton,26-048,G,2/23/17,DEN,SAC,0,32,7,15,0.467,5,10,0.5,2,5,0.4,0,0,,1,1,2,5,0,1,3,1,16,10.1
Kevin Durant,28-193,F-G,4/10/17,GSW,UTA,1,33,6,12,0.5,6,7,0.857,0,5,0,4,4,1,0,10,10,6,1,1,1,1,16,17.5
Patty Mills,28-119,G,12/8/16,SAS,CHI,0,24,6,12,0.5,2,6,0.333,4,6,0.667,0,0,,0,2,2,1,2,0,1,1,16,11.9
Joel Embiid,22-264,C-F,12/5/16,PHI,DEN,1,26,5,15,0.333,4,12,0.333,1,3,0.333,5,6,0.833,1,3,4,1,0,5,3,3,16,8.7
Malcolm Brogdon,24-040,G,1/20/17,MIL,ORL,1,35,6,11,0.545,2,5,0.4,4,6,0.667,0,0,,0,2,2,5,1,0,1,3,16,13.6
Serge Ibaka,27-059,F-C,11/16/16,ORL,NOP,1,30,7,13,0.538,5,9,0.556,2,4,0.5,0,0,,2,6,8,1,0,0,3,3,16,9.4
Evan Fournier,24-034,G-F,12/2/16,ORL,PHI,1,30,4,11,0.364,3,9,0.333,1,2,0.5,7,8,0.875,0,4,4,3,2,0,1,1,16,13.4
Ty Lawson,29-085,G,1/27/17,SAC,IND,0,23,3,7,0.429,1,4,0.25,2,3,0.667,8,8,1,1,1,2,6,1,0,2,1,16,16.1
C.J. McCollum,25-123,G,1/20/17,POR,PHI,1,35,5,18,0.278,3,10,0.3,2,8,0.25,4,4,1,0,4,4,4,2,0,4,1,16,7
Myles Turner,20-342,F-C,3/1/17,IND,SAS,1,32,7,11,0.636,7,10,0.7,0,1,0,2,2,1,2,4,6,1,3,0,1,3,16,15.2
Avery Bradley,25-336,G,10/27/16,BOS,CHI,1,41,6,12,0.5,5,9,0.556,1,3,0.333,3,4,0.75,1,5,6,5,0,1,2,2,16,13.2
Klay Thompson,26-355,G,1/28/17,GSW,LAC,1,27,7,11,0.636,5,8,0.625,2,3,0.667,0,1,0,0,1,1,1,1,0,2,1,16,10.3
Giannis Antetokounmpo,21-363,F-G,12/3/16,MIL,BRK,1,35,5,9,0.556,4,6,0.667,1,3,0.333,5,8,0.625,1,9,10,6,2,5,3,4,16,19
Marco Belinelli,30-255,G-F,12/5/16,CHO,DAL,0,30,5,9,0.556,3,5,0.6,2,4,0.5,4,5,0.8,0,6,6,2,0,0,3,1,16,11.1
Allen Crabbe,24-343,G-F,3/18/17,POR,ATL,0,29,5,10,0.5,1,2,0.5,4,8,0.5,2,2,1,0,3,3,0,2,0,1,3,16,11.7
Jonas Valanciunas,24-329,C,3/31/17,TOR,IND,1,28,5,9,0.556,5,9,0.556,0,0,,6,9,0.667,4,13,17,1,1,2,2,2,16,17.5
Zach Randolph,35-181,F,1/13/17,MEM,HOU,0,23,7,16,0.438,6,14,0.429,1,2,0.5,1,2,0.5,3,9,12,2,2,0,2,3,16,12.2
Sean Kilpatrick,26-324,G,11/25/16,BRK,IND,1,27,5,10,0.5,3,5,0.6,2,5,0.4,4,6,0.667,0,2,2,7,0,0,1,2,16,13.9
T.J. Warren,23-187,F,3/11/17,PHO,DAL,1,33,6,12,0.5,6,11,0.545,0,1,0,4,5,0.8,3,6,9,1,0,1,0,5,16,12.9
Jeff Teague,28-289,G,3/26/17,IND,PHI,1,26,6,12,0.5,3,8,0.375,3,4,0.75,1,1,1,0,2,2,4,2,0,2,0,16,13.4
Avery Bradley,26-027,G,12/23/16,BOS,OKC,1,36,6,16,0.375,5,11,0.455,1,5,0.2,3,6,0.5,2,4,6,1,0,0,1,3,16,7.1
Jae Crowder,26-242,F,3/5/17,BOS,PHO,1,33,6,10,0.6,4,5,0.8,2,5,0.4,2,3,0.667,0,10,10,1,0,0,1,1,16,13.3
Trevor Ariza,31-195,F,1/11/17,HOU,MIN,1,40,6,13,0.462,3,6,0.5,3,7,0.429,1,3,0.333,2,1,3,0,0,0,1,3,16,8
Myles Turner,20-321,F-C,2/8/17,IND,CLE,1,40,4,10,0.4,4,8,0.5,0,2,0,8,8,1,1,6,7,0,0,0,1,2,16,11.3
Thaddeus Young,28-271,F,3/19/17,IND,TOR,1,26,7,9,0.778,6,8,0.75,1,1,1,1,3,0.333,2,2,4,1,1,0,1,1,16,14
Dwyane Wade,34-295,G,11/7/16,CHI,ORL,1,25,7,12,0.583,7,10,0.7,0,2,0,2,2,1,1,2,3,4,2,2,1,3,16,15.7
Paul Millsap,31-273,F,11/9/16,ATL,CHI,1,34,5,13,0.385,3,10,0.3,2,3,0.667,4,4,1,0,11,11,6,1,2,6,4,16,11.2
Tyler Ulis,21-084,G,3/30/17,PHO,LAC,1,40,8,15,0.533,8,13,0.615,0,2,0,0,0,,0,3,3,13,1,0,2,2,16,16.9
Kemba Walker,26-258,G,1/21/17,CHO,BRK,1,33,6,17,0.353,4,11,0.364,2,6,0.333,2,3,0.667,0,4,4,6,0,0,4,1,16,7.1
Brandan Wright,29-179,F-C,4/2/17,MEM,LAL,1,32,7,10,0.7,7,10,0.7,0,0,,2,3,0.667,1,2,3,2,0,1,3,3,16,10.6
Goran Dragic,30-274,G,2/4/17,MIA,PHI,1,28,6,11,0.545,4,9,0.444,2,2,1,2,3,0.667,0,4,4,8,0,0,1,3,16,14.9
Marco Belinelli,31-010,G-F,4/4/17,CHO,WAS,0,25,6,10,0.6,4,6,0.667,2,4,0.5,2,2,1,0,3,3,2,1,0,2,1,16,12.3
Dennis Schroder,23-199,G,4/2/17,ATL,BRK,1,41,7,20,0.35,5,15,0.333,2,5,0.4,0,0,,1,4,5,8,2,1,5,0,16,10
Carmelo Anthony,32-295,F,3/20/17,NYK,LAC,1,25,6,14,0.429,5,9,0.556,1,5,0.2,3,3,1,2,2,4,1,0,0,0,3,16,10.1
Al Horford,30-309,C-F,4/8/17,BOS,CHO,1,34,7,15,0.467,5,10,0.5,2,5,0.4,0,0,,1,3,4,7,1,1,0,1,16,16.1
Nikola Jokic,22-031,C-F,3/22/17,DEN,CLE,1,29,8,10,0.8,8,10,0.8,0,0,,0,0,,2,8,10,7,0,0,3,2,16,17.1
Goran Dragic,30-173,G,10/26/16,MIA,ORL,1,29,7,15,0.467,7,14,0.5,0,1,0,2,2,1,3,3,6,6,0,0,3,4,16,10.9
Solomon Hill,25-315,F,1/27/17,NOP,SAS,1,34,5,10,0.5,0,3,0,5,7,0.714,1,2,0.5,3,3,6,2,1,0,1,2,16,14.2
Robert Covington,26-009,F,12/23/16,PHI,PHO,1,33,6,11,0.545,5,5,1,1,6,0.167,3,3,1,1,1,2,4,1,1,4,6,16,9.8
Marcin Gortat,33-048,C-F,4/6/17,WAS,NYK,1,30,7,7,1,7,7,1,0,0,,2,3,0.667,0,3,3,1,0,0,0,2,16,14.3
Thaddeus Young,28-148,F,11/16/16,IND,CLE,1,37,7,14,0.5,6,13,0.462,1,1,1,1,2,0.5,1,5,6,1,1,0,1,2,16,10.7
Jabari Parker,21-236,F,11/6/16,MIL,DAL,1,39,8,16,0.5,8,15,0.533,0,1,0,0,0,,1,6,7,1,1,0,4,5,16,6.2
Dion Waiters,24-336,G,11/10/16,MIA,CHI,1,36,6,15,0.4,4,9,0.444,2,6,0.333,2,4,0.5,2,2,4,6,1,0,2,3,16,11.1
Gerald Henderson,29-080,G,2/27/17,PHI,GSW,1,25,4,11,0.364,1,7,0.143,3,4,0.75,5,5,1,1,2,3,2,1,0,0,0,16,13.6
Jordan Clarkson,24-222,G,1/15/17,LAL,DET,0,24,7,12,0.583,7,10,0.7,0,2,0,2,2,1,0,2,2,2,0,0,2,3,16,9.2
Bobby Portis,22-002,F,2/12/17,CHI,MIN,0,31,6,11,0.545,5,7,0.714,1,4,0.25,3,3,1,2,4,6,0,0,0,0,2,16,12.5
Wesley Matthews,30-054,G,12/7/16,DAL,SAC,1,33,6,10,0.6,2,4,0.5,4,6,0.667,0,0,,0,4,4,1,1,1,1,1,16,13.6
Kelly Olynyk,25-283,C-F,1/27/17,BOS,ORL,0,17,7,7,1,5,5,1,2,2,1,0,0,,0,5,5,1,0,0,2,1,16,13.7
Jusuf Nurkic,22-204,C,3/15/17,POR,SAS,1,35,7,18,0.389,7,18,0.389,0,0,,2,5,0.4,3,6,9,3,4,1,5,3,16,9.5
Victor Oladipo,24-252,G,1/11/17,OKC,MEM,1,32,5,10,0.5,1,3,0.333,4,7,0.571,2,3,0.667,0,3,3,2,0,0,1,1,16,11.5
Trevor Ariza,31-194,F,1/10/17,HOU,CHO,1,40,5,10,0.5,2,4,0.5,3,6,0.5,3,5,0.6,0,5,5,3,1,0,0,1,16,14.4
Nerlens Noel,22-311,C-F,2/15/17,PHI,BOS,1,31,7,10,0.7,7,10,0.7,0,0,,2,2,1,3,4,7,3,3,0,4,5,16,14.2
Serge Ibaka,27-075,F-C,12/2/16,ORL,PHI,1,25,6,12,0.5,5,7,0.714,1,5,0.2,3,4,0.75,1,3,4,1,1,1,0,3,16,12.4
Wayne Ellington,29-105,G,2/11/17,MIA,PHI,1,36,4,14,0.286,1,4,0.25,3,10,0.3,5,5,1,3,2,5,2,1,0,4,1,16,8.5
Marcin Gortat,32-355,C-F,2/6/17,WAS,CLE,1,38,6,13,0.462,6,13,0.462,0,0,,4,4,1,5,3,8,3,0,3,1,5,16,14.9
Luke Babbitt,27-207,F,1/13/17,MIA,MIL,1,32,6,9,0.667,2,2,1,4,7,0.571,0,0,,0,4,4,2,0,2,0,3,16,14.9
Rudy Gobert,24-156,C,11/29/16,UTA,HOU,1,33,5,7,0.714,5,7,0.714,0,0,,6,8,0.75,4,10,14,0,0,3,2,2,16,17.4
Chris Paul,31-299,G,3/1/17,LAC,HOU,1,36,5,13,0.385,2,6,0.333,3,7,0.429,3,3,1,1,1,2,11,2,0,1,3,16,17.4
John Henson,26-037,C-F,2/3/17,MIL,DEN,1,31,7,12,0.583,7,12,0.583,0,0,,2,2,1,0,5,5,0,1,4,0,6,16,13.3
Alan Williams,24-067,F-C,4/5/17,PHO,GSW,0,25,5,9,0.556,5,9,0.556,0,0,,6,8,0.75,7,10,17,0,4,0,0,4,16,21.2
Emmanuel Mudiay,20-240,G,10/31/16,DEN,TOR,1,33,6,17,0.353,5,13,0.385,1,4,0.25,3,4,0.75,1,5,6,4,0,1,2,1,16,9.4
Rodney Hood,24-034,G-F,11/23/16,UTA,DEN,1,29,7,15,0.467,5,8,0.625,2,7,0.286,0,0,,0,6,6,1,0,0,2,3,16,7.6
Alan Williams,24-027,F-C,2/24/17,PHO,CHI,0,15,8,9,0.889,8,9,0.889,0,0,,0,2,0,1,2,3,1,0,0,0,5,16,12.1
Joe Johnson,35-252,G-F,3/8/17,UTA,HOU,1,32,5,10,0.5,3,5,0.6,2,5,0.4,4,4,1,0,2,2,2,0,0,2,0,16,11
Steven Adams,23-195,C,1/31/17,OKC,SAS,1,34,7,13,0.538,7,13,0.538,0,0,,2,4,0.5,5,7,12,2,1,1,2,4,16,14
Jrue Holiday,26-186,G,12/15/16,NOP,IND,1,36,7,12,0.583,7,11,0.636,0,1,0,2,3,0.667,2,5,7,14,0,0,2,4,16,19.1
James Johnson,29-311,F,12/27/16,MIA,OKC,0,25,6,13,0.462,5,8,0.625,1,5,0.2,3,6,0.5,2,3,5,2,2,0,3,5,16,8.8
Raymond Felton,32-224,G,2/5/17,LAC,BOS,0,25,6,10,0.6,3,5,0.6,3,5,0.6,1,2,0.5,1,4,5,4,0,0,1,3,16,13.5
Nicolas Batum,28-042,F-G,1/25/17,CHO,GSW,1,38,6,12,0.5,4,8,0.5,2,4,0.5,2,2,1,1,5,6,8,0,0,3,1,16,14.4
Jeff Teague,28-282,G,3/19/17,IND,TOR,1,27,4,11,0.364,3,9,0.333,1,2,0.5,7,7,1,0,2,2,7,1,0,1,2,16,14.6
Nikola Vucevic,26-041,C,12/4/16,ORL,DET,0,28,8,14,0.571,8,13,0.615,0,1,0,0,0,,0,8,8,2,0,2,1,0,16,13.6
Rudy Gobert,24-285,C,4/7/17,UTA,MIN,1,27,7,9,0.778,7,9,0.778,0,0,,2,3,0.667,0,5,5,1,1,2,2,5,16,12.7
Jon Leuer,27-202,F,12/2/16,DET,ATL,0,31,5,6,0.833,1,1,1,4,5,0.8,2,3,0.667,3,6,9,2,1,0,5,1,16,14.3
Kelly Olynyk,25-207,C-F,11/12/16,BOS,IND,1,28,6,13,0.462,4,7,0.571,2,6,0.333,2,4,0.5,2,4,6,4,0,1,3,5,16,9.6
Buddy Hield,23-068,G,2/23/17,SAC,DEN,0,26,6,10,0.6,5,7,0.714,1,3,0.333,3,3,1,0,6,6,1,1,0,1,0,16,13.9
Ricky Rubio,26-155,G,3/25/17,MIN,POR,1,25,6,12,0.5,5,11,0.455,1,1,1,3,3,1,2,2,4,4,1,0,2,3,16,12.6
Jimmy Butler,27-171,G-F,3/4/17,CHI,LAC,1,36,4,7,0.571,3,6,0.5,1,1,1,7,8,0.875,2,2,4,6,3,0,2,1,16,19.1
John Wall,26-214,G,4/8/17,WAS,MIA,1,36,5,18,0.278,4,15,0.267,1,3,0.333,5,7,0.714,0,6,6,8,2,2,8,2,16,6.6
Isaiah Whitehead,21-325,G,1/27/17,BRK,CLE,0,24,4,9,0.444,2,7,0.286,2,2,1,6,6,1,0,3,3,3,0,0,0,0,16,14.3
Deron Williams,32-171,G,12/14/16,DAL,DET,1,36,3,13,0.231,2,9,0.222,1,4,0.25,9,9,1,1,2,3,5,1,0,2,3,16,10.7
Pau Gasol,36-175,F-C,12/28/16,SAS,PHO,1,29,6,12,0.5,6,10,0.6,0,2,0,4,5,0.8,2,8,10,1,2,1,2,1,16,14.4
DeAndre Jordan,28-125,C,11/23/16,LAC,DAL,1,26,5,8,0.625,5,8,0.625,0,0,,6,9,0.667,0,8,8,2,1,1,1,2,16,14.9
Trevor Booker,29-035,F,12/30/16,BRK,WAS,1,20,6,11,0.545,3,7,0.429,3,4,0.75,1,2,0.5,2,5,7,3,0,0,2,1,16,12.9
James Johnson,30-036,F,3/28/17,MIA,DET,0,33,5,11,0.455,4,9,0.444,1,2,0.5,5,6,0.833,1,5,6,2,0,0,4,0,16,9.5
Jimmy Butler,27-177,G-F,3/10/17,CHI,HOU,1,31,6,12,0.5,6,10,0.6,0,2,0,4,4,1,3,2,5,4,1,0,1,1,16,15.1
Steven Adams,23-198,C,2/3/17,OKC,MEM,1,44,7,13,0.538,7,13,0.538,0,0,,2,6,0.333,10,2,12,2,1,2,3,4,16,14.9
Randy Foye,33-125,G,1/27/17,BRK,CLE,1,30,6,12,0.5,2,4,0.5,4,8,0.5,0,0,,0,8,8,5,0,0,2,1,16,13.5
Tony Parker,34-257,G,1/29/17,SAS,DAL,1,23,8,12,0.667,8,12,0.667,0,0,,0,1,0,0,0,0,4,0,0,1,2,16,11.4
Elfrid Payton,22-247,G,10/26/16,ORL,MIA,1,38,4,12,0.333,4,10,0.4,0,2,0,8,8,1,2,2,4,5,0,2,4,1,16,11.7
Jrue Holiday,26-245,G,2/12/17,NOP,SAC,1,40,6,14,0.429,5,10,0.5,1,4,0.25,3,3,1,2,4,6,11,5,0,4,2,16,19.1
Luol Deng,31-240,F,12/12/16,LAL,SAC,1,26,7,11,0.636,5,8,0.625,2,3,0.667,0,1,0,1,3,4,4,2,0,1,0,16,16.1
Norman Powell,23-244,G,1/24/17,TOR,SAS,1,39,8,16,0.5,8,12,0.667,0,4,0,0,0,,0,4,4,2,2,1,0,3,16,12.1
Aaron Brooks,31-321,G,11/30/16,IND,POR,0,21,6,10,0.6,3,5,0.6,3,5,0.6,1,1,1,0,3,3,0,0,0,3,1,16,8.9
Jae Crowder,26-257,F,3/20/17,BOS,WAS,1,38,5,12,0.417,2,4,0.5,3,8,0.375,3,4,0.75,3,5,8,1,3,1,1,2,16,15.4
Tyler Ulis,21-080,G,3/26/17,PHO,CHO,1,41,7,17,0.412,6,14,0.429,1,3,0.333,1,2,0.5,0,4,4,9,1,0,1,2,16,13.2
Pau Gasol,36-138,F-C,11/21/16,SAS,DAL,1,28,7,13,0.538,6,12,0.5,1,1,1,1,2,0.5,0,8,8,2,0,0,3,1,16,9.7
Chris Paul,31-228,G,12/20/16,LAC,DEN,1,26,7,14,0.5,5,9,0.556,2,5,0.4,0,0,,0,8,8,15,1,0,3,1,16,19.5
Kent Bazemore,27-199,G-F,1/16/17,ATL,NYK,1,32,5,13,0.385,3,5,0.6,2,8,0.25,4,4,1,1,5,6,5,1,0,1,1,16,14.2
Allen Crabbe,24-216,G-F,11/11/16,POR,SAC,0,37,6,10,0.6,4,5,0.8,2,5,0.4,2,3,0.667,1,6,7,4,1,0,0,1,16,16.9
Jahlil Okafor,20-353,C-F,12/2/16,PHI,ORL,0,28,8,10,0.8,8,10,0.8,0,0,,0,1,0,6,7,13,0,0,2,3,1,16,16.1
Sergio Rodriguez,30-287,G,3/26/17,PHI,IND,0,24,6,9,0.667,2,3,0.667,4,6,0.667,0,0,,0,1,1,2,2,0,2,2,16,13
Jimmy Butler,27-189,G-F,3/22/17,CHI,DET,1,34,6,6,1,6,6,1,0,0,,4,4,1,2,3,5,12,2,0,0,1,16,26.5
C.J. Miles,29-210,G-F,11/14/16,IND,ORL,0,23,5,12,0.417,1,4,0.25,4,8,0.5,2,2,1,0,4,4,1,2,2,0,0,16,14.9
Gary Harris,22-094,G,12/17/16,DEN,NYK,1,30,6,9,0.667,6,8,0.75,0,1,0,4,6,0.667,0,3,3,2,1,0,0,2,16,13.8
Mike Conley,29-045,G,11/25/16,MEM,MIA,0,23,5,15,0.333,4,11,0.364,1,4,0.25,5,5,1,2,2,4,3,1,1,3,1,16,9.9
DeAndre Jordan,28-111,C,11/9/16,LAC,POR,1,24,6,9,0.667,6,9,0.667,0,0,,4,8,0.5,3,6,9,1,0,3,1,2,16,15.4
Kevin Durant,28-069,F-G,12/7/16,GSW,LAC,1,32,5,17,0.294,4,12,0.333,1,5,0.2,5,6,0.833,0,8,8,7,1,0,0,3,16,12.8
Ryan Anderson,28-310,F,3/12/17,HOU,CLE,1,30,5,11,0.455,1,4,0.25,4,7,0.571,2,2,1,2,4,6,2,0,0,0,2,16,13.5
Ish Smith,28-115,G,10/28/16,DET,ORL,1,26,8,13,0.615,8,13,0.615,0,0,,0,0,,0,2,2,8,1,0,2,1,16,14.9
Timofey Mozgov,30-129,C,11/22/16,LAL,OKC,1,31,6,10,0.6,6,10,0.6,0,0,,4,4,1,2,1,3,2,0,2,0,3,16,14.7
Tony Parker,34-211,G,12/14/16,SAS,BOS,1,26,8,15,0.533,8,14,0.571,0,1,0,0,0,,0,2,2,7,0,0,2,4,16,10.6
Tony Parker,34-306,G,3/19/17,SAS,SAC,1,20,8,10,0.8,8,10,0.8,0,0,,0,1,0,0,3,3,7,0,0,1,1,16,16.2
Otto Porter,23-298,F,3/28/17,WAS,LAL,1,30,7,9,0.778,6,6,1,1,3,0.333,1,1,1,1,3,4,1,0,0,0,2,16,14
Ersan Ilyasova,29-241,F,1/11/17,PHI,NYK,1,30,5,16,0.313,4,8,0.5,1,8,0.125,5,6,0.833,2,2,4,5,0,0,3,1,16,8.5
Enes Kanter,24-177,C,11/13/16,OKC,ORL,0,24,7,13,0.538,7,11,0.636,0,2,0,2,2,1,4,4,8,0,1,1,1,2,16,13.6
C.J. McCollum,25-038,G,10/27/16,POR,LAC,1,38,5,12,0.417,4,11,0.364,1,1,1,5,6,0.833,0,4,4,2,3,0,3,2,16,11
Lou Williams,30-054,G,12/20/16,LAL,CHO,0,28,5,12,0.417,4,8,0.5,1,4,0.25,5,6,0.833,1,1,2,8,2,1,2,1,16,16.1
Alan Williams,24-040,F-C,3/9/17,PHO,LAL,0,22,5,9,0.556,5,9,0.556,0,0,,6,6,1,5,5,10,0,1,2,0,4,16,17.5
Leandro Barbosa,34-094,G,3/2/17,PHO,CHO,0,23,7,11,0.636,6,7,0.857,1,4,0.25,1,1,1,0,4,4,1,2,0,4,6,16,8.6
Michael Kidd-Gilchrist,23-188,F,4/2/17,CHO,OKC,1,36,5,8,0.625,5,8,0.625,0,0,,6,6,1,0,6,6,1,3,0,2,3,16,14.7
Chris Paul,31-222,G,12/14/16,LAC,ORL,1,32,5,9,0.556,4,7,0.571,1,2,0.5,5,6,0.833,1,2,3,10,1,0,4,3,16,15.4
Nik Stauskas,23-115,G,1/30/17,PHI,SAC,1,28,6,10,0.6,2,4,0.5,4,6,0.667,0,0,,0,0,0,1,1,1,1,4,16,11.2
Kevin Love,28-157,F,2/11/17,CLE,DEN,1,34,5,11,0.455,2,6,0.333,3,5,0.6,3,4,0.75,3,6,9,5,0,0,2,0,16,15.3
Justin Anderson,22-356,G,11/9/16,DAL,GSW,1,41,6,19,0.316,6,14,0.429,0,5,0,4,7,0.571,3,5,8,7,0,0,0,4,16,10.8
Rodney Hood,24-046,G-F,12/5/16,UTA,LAL,1,31,5,17,0.294,3,9,0.333,2,8,0.25,4,4,1,1,4,5,5,0,0,1,0,16,10.5
Jordan Clarkson,24-266,G,2/28/17,LAL,CHO,0,34,7,14,0.5,6,10,0.6,1,4,0.25,1,1,1,0,3,3,3,1,0,3,5,16,8
Andre Drummond,23-180,C,2/6/17,DET,PHI,1,26,8,14,0.571,8,13,0.615,0,1,0,0,0,,3,14,17,1,3,1,1,2,16,18.3
Ivica Zubac,19-314,C,1/26/17,LAL,UTA,0,26,6,11,0.545,6,11,0.545,0,0,,4,4,1,2,8,10,1,0,0,0,1,16,14.8
Gary Harris,22-120,G,1/12/17,DEN,IND,1,34,6,11,0.545,5,10,0.5,1,1,1,3,3,1,0,5,5,6,1,0,1,2,16,15.6
JaMychal Green,26-165,F,12/3/16,MEM,LAL,1,34,7,13,0.538,7,10,0.7,0,3,0,2,2,1,7,6,13,1,0,3,0,3,16,18
Bojan Bogdanovic,27-267,G-F,1/10/17,BRK,ATL,1,26,5,10,0.5,2,5,0.4,3,5,0.6,3,3,1,0,6,6,4,1,0,4,2,16,11.8
Damian Lillard,26-263,G,4/4/17,POR,UTA,1,34,5,20,0.25,3,13,0.231,2,7,0.286,4,5,0.8,0,2,2,3,0,0,0,2,16,5.5
Darren Collison,29-130,G,12/31/16,SAC,MEM,1,39,8,16,0.5,8,14,0.571,0,2,0,0,0,,1,3,4,2,0,0,0,1,16,10.6
Mike Muscala,25-138,F-C,11/16/16,ATL,MIL,1,33,6,11,0.545,5,8,0.625,1,3,0.333,3,4,0.75,1,4,5,3,0,1,3,2,16,11.2
Allen Crabbe,24-238,G-F,12/3/16,POR,MIA,0,28,5,11,0.455,1,5,0.2,4,6,0.667,2,2,1,0,3,3,0,0,1,0,1,16,11.5
Montrezl Harrell,22-332,F-C,12/23/16,HOU,MEM,1,28,7,11,0.636,7,11,0.636,0,0,,2,2,1,2,6,8,1,0,0,0,4,16,13.4
E'Twaun Moore,27-302,G,12/26/16,NOP,DAL,0,23,7,10,0.7,5,7,0.714,2,3,0.667,0,0,,0,1,1,1,2,0,0,2,16,14
Al Horford,30-290,C-F,3/20/17,BOS,WAS,1,36,6,11,0.545,6,10,0.6,0,1,0,4,7,0.571,2,7,9,5,1,2,1,0,16,17.9
Bradley Beal,23-284,G,4/8/17,WAS,MIA,1,38,6,15,0.4,5,10,0.5,1,5,0.2,3,3,1,2,3,5,5,2,1,5,4,16,9.8
DeMar DeRozan,27-117,G,12/2/16,TOR,LAL,1,29,6,18,0.333,6,17,0.353,0,1,0,4,4,1,1,3,4,6,2,0,1,0,16,12.6
Marvin Williams,30-251,F,2/25/17,CHO,SAC,1,36,6,12,0.5,3,4,0.75,3,8,0.375,1,1,1,1,5,6,0,2,1,3,3,16,10.7
Terry Rozier,22-265,G,12/7/16,BOS,ORL,0,26,6,13,0.462,5,9,0.556,1,4,0.25,3,4,0.75,1,4,5,2,1,0,0,1,16,12.8
Kentavious Caldwell-Pope,23-320,G,1/3/17,DET,IND,1,39,5,13,0.385,4,8,0.5,1,5,0.2,5,5,1,1,2,3,5,1,0,0,4,16,13.1
Aaron Gordon,21-189,F,3/24/17,ORL,DET,1,30,8,11,0.727,8,9,0.889,0,2,0,0,0,,0,4,4,2,0,1,0,1,16,14.4
Spencer Hawes,28-310,C-F,3/4/17,MIL,TOR,0,17,6,7,0.857,4,4,1,2,3,0.667,2,3,0.667,1,7,8,1,0,1,0,1,16,16.9
Joe Ingles,29-130,F-G,2/9/17,UTA,DAL,1,41,6,12,0.5,2,5,0.4,4,7,0.571,0,0,,1,4,5,5,1,0,2,1,16,14
Josh Richardson,23-056,G,11/10/16,MIA,CHI,0,28,6,13,0.462,2,6,0.333,4,7,0.571,0,0,,0,1,1,0,0,1,0,3,16,9.1
Nicolas Batum,28-015,F-G,12/29/16,CHO,MIA,1,36,7,17,0.412,7,12,0.583,0,5,0,2,3,0.667,3,10,13,8,3,1,3,0,16,17.9
D'Angelo Russell,21-010,G,3/5/17,LAL,NOP,1,33,7,20,0.35,5,9,0.556,2,11,0.182,0,1,0,0,4,4,7,2,1,6,4,16,5.6
Danny Green,29-154,G-F,11/23/16,SAS,CHO,1,30,6,12,0.5,2,5,0.4,4,7,0.571,0,0,,1,2,3,2,0,1,1,1,16,12
Willie Cauley-Stein,23-234,F-C,4/9/17,SAC,HOU,1,25,6,12,0.5,6,12,0.5,0,0,,4,4,1,2,8,10,0,0,1,0,2,16,13.7
Jahlil Okafor,21-084,C-F,3/9/17,PHI,POR,1,29,7,14,0.5,7,14,0.5,0,0,,2,2,1,3,5,8,1,1,0,1,4,16,11.7
Devin Booker,20-057,G,12/26/16,PHO,HOU,1,28,6,18,0.333,5,13,0.385,1,5,0.2,3,3,1,1,1,2,4,1,0,1,6,16,7.2
J.J. Redick,32-140,G,11/11/16,LAC,OKC,1,28,6,12,0.5,2,5,0.4,4,7,0.571,0,0,,0,3,3,1,1,0,1,2,16,10.8
Dario Saric,22-223,F,11/17/16,PHI,MIN,0,27,6,11,0.545,4,7,0.571,2,4,0.5,2,3,0.667,3,1,4,1,2,0,1,3,16,13.2
Marvin Williams,30-147,F,11/13/16,CHO,CLE,1,26,6,14,0.429,3,5,0.6,3,9,0.333,1,1,1,1,5,6,2,0,0,0,2,16,11.4
Jimmy Butler,27-052,G-F,11/5/16,CHI,IND,1,32,5,7,0.714,4,6,0.667,1,1,1,5,6,0.833,0,4,4,2,0,0,6,3,16,8.1
Courtney Lee,31-186,G,4/7/17,NYK,MEM,1,28,7,13,0.538,5,9,0.556,2,4,0.5,0,0,,1,2,3,3,1,0,0,0,16,14.1
Mike Conley,29-161,G,3/21/17,MEM,NOP,1,31,6,14,0.429,4,8,0.5,2,6,0.333,2,2,1,0,6,6,3,0,0,2,2,16,9.7
Courtney Lee,31-186,G,4/7/17,NYK,MEM,1,28,7,13,0.538,5,9,0.556,2,4,0.5,0,0,,1,2,3,3,1,0,0,0,16,14.1
Ersan Ilyasova,29-228,F,12/29/16,PHI,UTA,1,24,7,13,0.538,5,9,0.556,2,4,0.5,0,0,,4,8,12,1,0,0,0,1,16,15.2
Rudy Gobert,24-252,C,3/5/17,UTA,SAC,1,41,8,11,0.727,8,11,0.727,0,0,,0,2,0,5,18,23,3,1,3,0,3,16,23.6
Gorgui Dieng,26-323,C,12/6/16,MIN,SAS,1,33,7,9,0.778,7,9,0.778,0,0,,2,5,0.4,3,5,8,1,1,0,2,3,16,13.4
Paul Millsap,31-358,F,2/2/17,ATL,HOU,1,29,4,8,0.5,3,4,0.75,1,4,0.25,7,8,0.875,0,4,4,3,2,0,4,4,16,11.3
Courtney Lee,31-116,G,1/27/17,NYK,CHO,1,35,7,12,0.583,5,7,0.714,2,5,0.4,0,0,,0,3,3,4,3,1,1,1,16,16.4
Gordon Hayward,26-288,F-G,1/5/17,UTA,TOR,1,34,6,12,0.5,4,8,0.5,2,4,0.5,2,2,1,2,2,4,2,0,0,4,3,16,8.2
Ish Smith,28-269,G,3/31/17,DET,MIL,1,32,7,20,0.35,5,14,0.357,2,6,0.333,0,0,,0,4,4,5,0,0,2,5,16,5.5
Draymond Green,26-250,F,11/9/16,GSW,DAL,1,35,6,11,0.545,2,5,0.4,4,6,0.667,0,1,0,1,9,10,4,0,1,1,3,16,15
Gary Harris,22-150,G,2/11/17,DEN,CLE,1,29,6,11,0.545,3,6,0.5,3,5,0.6,1,2,0.5,0,3,3,0,1,1,1,0,16,11.9
Robin Lopez,28-223,C,11/10/16,CHI,MIA,1,38,8,20,0.4,8,20,0.4,0,0,,0,0,,7,2,9,0,0,1,1,3,16,9.2
Steven Adams,23-144,C,12/11/16,OKC,BOS,1,32,7,8,0.875,7,8,0.875,0,0,,2,5,0.4,4,4,8,2,1,1,0,0,16,19.1
Rudy Gobert,24-278,C,3/31/17,UTA,WAS,1,38,6,9,0.667,6,9,0.667,0,0,,4,10,0.4,2,8,10,1,0,3,0,3,16,15.1
Jonas Valanciunas,24-278,C,2/8/17,TOR,MIN,1,26,7,7,1,7,7,1,0,0,,2,2,1,1,4,5,1,0,0,0,2,16,15.7
C.J. McCollum,25-043,G,11/1/16,POR,GSW,1,26,6,12,0.5,4,7,0.571,2,5,0.4,2,2,1,1,3,4,2,1,0,4,2,16,9.2
Nick Young,31-162,G-F,11/10/16,LAL,SAC,1,30,6,11,0.545,2,2,1,4,9,0.444,0,0,,0,3,3,1,1,0,1,4,16,10.7
Darren Collison,29-087,G,11/18/16,SAC,LAC,0,33,7,11,0.636,6,9,0.667,1,2,0.5,1,2,0.5,1,1,2,2,0,0,2,3,16,9.9
Dennis Schroder,23-058,G,11/12/16,ATL,PHI,1,28,7,10,0.7,5,8,0.625,2,2,1,0,3,0,0,5,5,8,1,1,5,0,16,14.4
Shelvin Mack,26-353,G,4/10/17,UTA,GSW,0,31,7,15,0.467,6,10,0.6,1,5,0.2,1,3,0.333,0,2,2,5,1,0,2,3,16,9.4
Justin Holiday,28-001,G,4/6/17,NYK,WAS,0,33,7,12,0.583,5,8,0.625,2,4,0.5,0,0,,0,5,5,1,0,0,1,1,16,11.2
Marreese Speights,29-107,C-F,11/19/16,LAC,CHI,0,19,5,7,0.714,2,3,0.667,3,4,0.75,3,4,0.75,4,0,4,1,0,1,1,4,16,14.3
Jamal Crawford,36-230,G,11/5/16,LAC,SAS,0,26,6,10,0.6,3,5,0.6,3,5,0.6,1,1,1,0,3,3,2,0,1,2,1,16,12
Klay Thompson,27-020,G,2/28/17,GSW,WAS,1,38,5,20,0.25,2,7,0.286,3,13,0.231,3,4,0.75,0,3,3,2,2,0,1,3,16,5.7
Tobias Harris,24-210,F,2/10/17,DET,SAS,0,33,7,12,0.583,7,11,0.636,0,1,0,2,2,1,0,5,5,1,1,0,0,1,16,13.2
Marco Belinelli,30-264,G-F,12/14/16,CHO,WAS,0,22,6,10,0.6,2,4,0.5,4,6,0.667,0,0,,0,1,1,1,0,0,2,1,16,10
Bobby Brown,32-197,G,4/9/17,HOU,SAC,0,25,5,9,0.556,1,2,0.5,4,7,0.571,2,2,1,0,1,1,2,0,0,1,2,16,11.6
Monta Ellis,31-069,G,1/3/17,IND,DET,0,20,6,6,1,6,6,1,0,0,,4,5,0.8,0,1,1,3,0,0,1,1,16,14.8
Hassan Whiteside,27-293,C,4/2/17,MIA,DEN,1,33,6,12,0.5,6,12,0.5,0,0,,4,6,0.667,2,9,11,2,0,3,1,3,16,14.6
Carmelo Anthony,32-297,F,3/22/17,NYK,UTA,1,36,5,13,0.385,4,9,0.444,1,4,0.25,5,5,1,1,2,3,3,1,0,1,3,16,11.1
Shabazz Muhammad,24-080,F-G,2/1/17,MIN,CLE,0,31,7,16,0.438,5,13,0.385,2,3,0.667,0,0,,3,3,6,2,1,0,0,1,16,12.6
Spencer Hawes,28-257,C-F,1/10/17,CHO,HOU,0,25,7,10,0.7,5,6,0.833,2,4,0.5,0,0,,0,5,5,4,0,0,1,6,16,12.7
Nene Hilario,34-067,F-C,11/19/16,HOU,UTA,0,17,6,9,0.667,5,8,0.625,1,1,1,3,3,1,1,5,6,0,1,0,1,2,16,13.5
Zach LaVine,21-290,G,12/25/16,MIN,OKC,1,31,5,11,0.455,2,6,0.333,3,5,0.6,3,3,1,0,1,1,2,1,0,3,2,16,9.2
Jordan Clarkson,24-210,G,1/3/17,LAL,MEM,0,18,6,9,0.667,3,3,1,3,6,0.5,1,3,0.333,3,4,7,3,0,0,1,3,16,14.5
Klay Thompson,26-347,G,1/20/17,GSW,HOU,1,34,7,19,0.368,5,9,0.556,2,10,0.2,0,0,,0,1,1,1,1,0,2,1,16,5.1
Richard Jefferson,36-264,F,3/12/17,CLE,HOU,1,31,6,6,1,2,2,1,4,4,1,0,0,,0,3,3,1,0,0,0,3,16,14.6
Andre Drummond,23-107,C,11/25/16,DET,LAC,1,26,8,11,0.727,8,11,0.727,0,0,,0,2,0,4,6,10,1,3,0,2,4,16,15.4
Nikola Jokic,21-313,C-F,12/28/16,DEN,MIN,1,34,6,12,0.5,6,10,0.6,0,2,0,4,5,0.8,2,6,8,11,0,1,2,3,16,18
Brandon Jennings,27-075,G,12/7/16,NYK,CLE,1,31,6,14,0.429,5,11,0.455,1,3,0.333,3,3,1,0,4,4,3,0,0,3,2,16,8.1
Jaylen Brown,20-160,F,4/2/17,BOS,NYK,1,27,5,6,0.833,3,3,1,2,3,0.667,4,4,1,1,1,2,1,0,0,1,4,16,12.9
Kyle Lowry,30-268,G,12/18/16,TOR,ORL,1,35,3,9,0.333,1,2,0.5,2,7,0.286,8,8,1,0,3,3,10,1,0,4,1,16,15.4
Terrence Jones,24-342,F,12/16/16,NOP,HOU,0,29,7,14,0.5,7,12,0.583,0,2,0,2,6,0.333,3,5,8,1,0,1,1,2,16,10.6
Kyle Lowry,30-232,G,11/12/16,TOR,NYK,1,41,7,15,0.467,7,10,0.7,0,5,0,2,2,1,3,3,6,6,0,0,2,3,16,12.3
Anthony Tolliver,31-221,F-C,1/8/17,SAC,GSW,1,32,5,9,0.556,2,5,0.4,3,4,0.75,3,4,0.75,0,5,5,0,3,0,0,1,16,15.4
Jeff Teague,28-220,G,1/16/17,IND,NOP,1,37,7,10,0.7,6,7,0.857,1,3,0.333,1,1,1,1,7,8,10,0,0,7,2,16,13.8
Buddy Hield,22-353,G,12/4/16,NOP,OKC,0,15,6,12,0.5,2,5,0.4,4,7,0.571,0,0,,1,3,4,1,0,0,1,0,16,11.3
Dante Cunningham,29-313,F,3/1/17,NOP,DET,1,33,5,8,0.625,1,1,1,4,7,0.571,2,2,1,1,4,5,1,1,0,0,1,16,15.6
Thaddeus Young,28-200,F,1/7/17,IND,NYK,1,29,6,8,0.75,4,6,0.667,2,2,1,2,4,0.5,1,8,9,2,6,0,2,2,16,19.7
Andrew Wiggins,21-290,F-G,12/9/16,MIN,DET,1,27,6,16,0.375,5,13,0.385,1,3,0.333,3,4,0.75,0,2,2,0,0,0,1,0,16,6.4
LaMarcus Aldridge,31-116,F-C,11/12/16,SAS,HOU,1,35,5,13,0.385,5,12,0.417,0,1,0,6,6,1,0,10,10,2,0,3,4,4,16,9.8
Avery Bradley,26-024,G,12/20/16,BOS,MEM,1,38,5,8,0.625,4,5,0.8,1,3,0.333,5,6,0.833,0,3,3,3,1,1,1,5,16,13.7
Deron Williams,32-166,G,12/9/16,DAL,IND,1,33,5,13,0.385,2,7,0.286,3,6,0.5,3,3,1,0,1,1,6,1,0,1,4,16,11.8
Jeremy Lin,28-224,G,4/4/17,BRK,PHI,1,23,6,10,0.6,4,8,0.5,2,2,1,2,3,0.667,0,5,5,7,2,0,5,3,16,13.2
Robert Covington,25-363,F,12/11/16,PHI,DET,1,34,6,9,0.667,4,5,0.8,2,4,0.5,2,2,1,0,7,7,2,2,1,3,4,16,13.7
Rodney Stuckey,30-227,G,12/4/16,IND,LAC,0,21,7,10,0.7,7,9,0.778,0,1,0,2,2,1,0,3,3,3,0,0,2,3,16,11.6
Cory Joseph,25-102,G,11/30/16,TOR,MEM,0,28,4,8,0.5,3,5,0.6,1,3,0.333,7,8,0.875,2,6,8,3,0,0,1,3,16,14.7
Meyers Leonard,24-305,C-F,12/28/16,POR,SAC,0,25,5,13,0.385,2,7,0.286,3,6,0.5,3,3,1,0,5,5,1,0,1,0,2,16,11
Kristaps Porzingis,21-188,F-C,2/6/17,NYK,LAL,1,33,5,14,0.357,4,9,0.444,1,5,0.2,5,7,0.714,1,8,9,0,0,2,2,2,16,9.1
Julius Randle,22-052,F,1/20/17,LAL,IND,1,35,7,13,0.538,7,13,0.538,0,0,,2,3,0.667,1,4,5,4,1,1,2,5,16,11.7
Joffrey Lauvergne,25-126,C-F,2/3/17,OKC,MEM,0,29,6,7,0.857,3,3,1,3,4,0.75,1,2,0.5,1,7,8,2,0,0,3,3,16,13.1
Austin Rivers,24-144,G,12/23/16,LAC,DAL,0,29,6,13,0.462,2,7,0.286,4,6,0.667,0,0,,0,0,0,3,2,0,3,3,16,9.2
Jordan Clarkson,24-169,G,11/23/16,LAL,GSW,0,29,7,16,0.438,7,14,0.5,0,2,0,2,3,0.667,1,2,3,2,1,0,1,2,16,9.1
Eric Bledsoe,26-322,G,10/26/16,PHO,SAC,1,29,5,11,0.455,3,6,0.5,2,5,0.4,4,4,1,0,6,6,5,1,0,4,3,16,11.4
Dario Saric,22-337,F,3/11/17,PHI,LAC,1,35,6,17,0.353,4,12,0.333,2,5,0.4,2,2,1,2,3,5,2,0,1,4,3,16,5.7
Zach Randolph,35-193,F,1/25/17,MEM,TOR,1,38,7,10,0.7,6,8,0.75,1,2,0.5,1,4,0.25,1,7,8,3,0,0,1,1,16,14.1
Ish Smith,28-143,G,11/25/16,DET,LAC,1,34,6,13,0.462,4,11,0.364,2,2,1,2,2,1,0,2,2,7,1,0,0,1,16,15.4
Tyreke Evans,27-173,G-F,3/11/17,SAC,DEN,0,24,6,15,0.4,4,10,0.4,2,5,0.4,2,4,0.5,0,3,3,2,1,1,1,0,16,10.1
Lou Williams,30-027,G,11/23/16,LAL,GSW,0,22,6,11,0.545,5,9,0.556,1,2,0.5,3,5,0.6,0,0,0,2,1,0,2,1,16,9.9
Thaddeus Young,28-281,F,3/29/17,IND,MEM,1,33,8,12,0.667,8,12,0.667,0,0,,0,0,,6,8,14,3,1,0,0,1,16,20.1
Nemanja Bjelica,28-279,F,2/12/17,MIN,CHI,0,19,6,12,0.5,3,6,0.5,3,6,0.5,1,1,1,1,5,6,3,2,1,1,2,16,15.2
Dario Saric,22-291,F,1/24/17,PHI,LAC,0,26,4,10,0.4,4,8,0.5,0,2,0,8,9,0.889,1,7,8,2,1,1,0,2,16,15.3
Tony Allen,34-338,G-F,12/14/16,MEM,CLE,1,33,7,17,0.412,7,16,0.438,0,1,0,2,5,0.4,5,3,8,1,3,1,2,4,16,10.9
Channing Frye,33-325,C-F,4/7/17,CLE,ATL,1,26,6,10,0.6,4,4,1,2,6,0.333,2,2,1,0,5,5,0,0,2,0,1,16,13.9
Dwight Howard,31-020,C,12/28/16,ATL,NYK,1,39,6,9,0.667,6,9,0.667,0,0,,4,6,0.667,7,15,22,3,1,1,1,5,16,21.5
Nicolas Batum,28-084,F-G,3/8/17,CHO,MIA,1,31,5,14,0.357,5,11,0.455,0,3,0,6,6,1,1,6,7,2,4,0,1,3,16,13.9
LaMarcus Aldridge,31-133,F-C,11/29/16,SAS,ORL,1,31,7,12,0.583,6,11,0.545,1,1,1,1,2,0.5,1,5,6,3,0,1,1,1,16,13.6
Will Barton,25-339,G,12/10/16,DEN,ORL,1,24,5,8,0.625,5,8,0.625,0,0,,6,8,0.75,1,3,4,2,0,0,1,4,16,12
T.J. Warren,23-158,F,2/10/17,PHO,CHI,1,37,8,17,0.471,8,16,0.5,0,1,0,0,0,,1,4,5,0,0,2,0,4,16,9
Jason Smith,30-325,F-C,1/21/17,WAS,DET,0,19,6,9,0.667,4,6,0.667,2,3,0.667,2,2,1,1,3,4,0,0,1,0,2,16,13.6
Derrick Rose,28-052,G,11/25/16,NYK,CHO,1,38,6,13,0.462,6,12,0.5,0,1,0,4,5,0.8,2,1,3,5,1,1,3,1,16,12.4
Zach Randolph,35-164,F,12/27/16,MEM,BOS,0,29,6,13,0.462,6,12,0.5,0,1,0,4,4,1,5,5,10,2,1,0,3,1,16,13.3
Marreese Speights,29-111,C-F,11/23/16,LAC,DAL,0,22,5,8,0.625,4,6,0.667,1,2,0.5,5,6,0.833,3,9,12,2,1,1,0,4,16,18.3
Nemanja Bjelica,28-308,F,3/13/17,MIN,WAS,0,29,6,7,0.857,5,5,1,1,2,0.5,3,4,0.75,2,7,9,2,1,0,0,4,16,17.4
Austin Rivers,24-212,G,3/1/17,LAC,HOU,0,26,6,12,0.5,2,5,0.4,4,7,0.571,0,0,,0,5,5,4,2,0,2,5,16,12.3
Trevor Ariza,31-155,F,12/2/16,HOU,DEN,1,31,6,12,0.5,2,4,0.5,4,8,0.5,0,0,,2,5,7,3,5,0,0,1,16,19.6
Kristaps Porzingis,21-194,F-C,2/12/17,NYK,SAS,1,37,4,10,0.4,1,5,0.2,3,5,0.6,5,5,1,0,7,7,2,1,4,2,3,16,14.7
Khris Middleton,25-215,F-G,3/15/17,MIL,LAC,1,32,4,8,0.5,3,6,0.5,1,2,0.5,7,7,1,0,7,7,2,2,0,4,2,16,12.7
Myles Turner,20-300,F-C,1/18/17,IND,SAC,1,34,7,9,0.778,6,7,0.857,1,2,0.5,1,2,0.5,1,4,5,0,0,1,1,4,16,12.1
Rudy Gobert,24-267,C,3/20/17,UTA,IND,1,37,7,12,0.583,7,12,0.583,0,0,,2,6,0.333,5,9,14,3,0,8,1,3,16,20.5
Jimmy Butler,27-045,G-F,10/29/16,CHI,IND,1,26,6,9,0.667,6,7,0.857,0,2,0,4,4,1,2,3,5,3,1,0,0,2,16,16.7
Serge Ibaka,27-182,F-C,3/19/17,TOR,IND,1,24,7,11,0.636,5,8,0.625,2,3,0.667,0,0,,0,5,5,0,0,2,1,3,16,11.8
Jeff Teague,28-260,G,2/25/17,IND,MIA,1,32,5,16,0.313,5,13,0.385,0,3,0,6,7,0.857,0,3,3,6,1,0,1,3,16,10.3
J.J. Redick,32-222,G,2/1/17,LAC,PHO,1,31,5,13,0.385,3,6,0.5,2,7,0.286,4,4,1,0,2,2,3,1,1,1,1,16,11.9
Iman Shumpert,26-217,G,1/29/17,CLE,OKC,1,34,5,11,0.455,0,3,0,5,8,0.625,1,2,0.5,2,1,3,1,1,0,1,4,16,10.7
Dwight Howard,31-038,C,1/15/17,ATL,MIL,1,32,6,8,0.75,6,8,0.75,0,0,,4,6,0.667,7,7,14,2,1,1,2,2,16,19.3
Serge Ibaka,27-099,F-C,12/26/16,ORL,MEM,1,24,6,11,0.545,4,5,0.8,2,6,0.333,2,2,1,1,5,6,3,0,0,1,3,16,12.8
Goran Dragic,30-245,G,1/6/17,MIA,LAL,1,22,7,13,0.538,5,10,0.5,2,3,0.667,0,0,,0,3,3,3,0,0,0,2,16,11.9
Kent Bazemore,27-258,G-F,3/16/17,ATL,MEM,1,31,4,8,0.5,4,6,0.667,0,2,0,8,10,0.8,0,0,0,1,1,1,1,1,16,12.2
Matthew Dellavedova,26-137,G,1/23/17,MIL,HOU,1,31,5,6,0.833,3,3,1,2,3,0.667,4,5,0.8,0,3,3,7,0,0,3,3,16,15
Norman Powell,23-306,G,3/27/17,TOR,ORL,0,24,6,11,0.545,2,5,0.4,4,6,0.667,0,0,,0,1,1,2,0,1,2,2,16,10.3
Kentavious Caldwell-Pope,23-281,G,11/25/16,DET,LAC,1,35,5,11,0.455,1,5,0.2,4,6,0.667,2,2,1,0,1,1,10,1,0,2,2,16,15.8
Glenn Robinson,22-317,G-F,11/20/16,IND,OKC,1,45,6,14,0.429,4,9,0.444,2,5,0.4,2,2,1,2,9,11,2,0,0,2,4,16,10.5
Wilson Chandler,29-330,F,4/5/17,DEN,HOU,0,34,6,18,0.333,5,13,0.385,1,5,0.2,3,5,0.6,2,3,5,0,0,0,2,6,16,2.9
Marcin Gortat,32-274,C-F,11/17/16,WAS,NYK,1,31,7,12,0.583,7,12,0.583,0,0,,2,4,0.5,2,6,8,1,0,1,1,4,16,11.6
James Harden,27-119,G,12/23/16,HOU,MEM,1,36,6,13,0.462,4,7,0.571,2,6,0.333,2,3,0.667,1,6,7,17,1,0,9,5,16,13.3
Nikola Mirotic,25-328,F,1/4/17,CHI,CLE,0,26,6,12,0.5,3,5,0.6,3,7,0.429,1,1,1,0,4,4,1,1,1,0,2,16,12.8
Jeremy Lamb,24-253,G-F,2/7/17,CHO,BRK,0,19,6,11,0.545,5,9,0.556,1,2,0.5,3,3,1,1,5,6,0,1,1,1,1,16,13.2
Courtney Lee,31-147,G,2/27/17,NYK,TOR,1,41,6,10,0.6,3,6,0.5,3,4,0.75,1,2,0.5,0,3,3,3,5,2,2,1,16,18
C.J. Miles,29-322,G-F,3/6/17,IND,CHO,1,33,6,11,0.545,2,4,0.5,4,7,0.571,0,0,,1,3,4,4,0,0,0,1,16,14.7
Stephen Curry,28-249,G,11/18/16,GSW,BOS,1,36,7,20,0.35,5,10,0.5,2,10,0.2,0,0,,0,3,3,8,4,1,2,4,16,12.4
Will Barton,26-020,G,1/26/17,DEN,PHO,0,25,6,7,0.857,5,6,0.833,1,1,1,3,3,1,1,1,2,4,0,0,2,2,16,14.5
Enes Kanter,24-295,C,3/11/17,OKC,UTA,0,18,8,12,0.667,8,12,0.667,0,0,,0,0,,2,4,6,1,0,2,2,3,16,12.3
Kelly Oubre,21-106,F,3/25/17,WAS,CLE,0,26,7,8,0.875,7,7,1,0,1,0,2,3,0.667,4,3,7,0,1,0,0,4,16,15.9
Marvin Williams,30-272,F,3/18/17,CHO,WAS,1,33,5,7,0.714,3,4,0.75,2,3,0.667,4,4,1,1,7,8,3,2,0,0,3,16,18.8
Chris Paul,31-209,G,12/1/16,LAC,CLE,1,25,5,11,0.455,2,4,0.5,3,7,0.429,3,3,1,2,4,6,9,1,0,0,4,16,18.6
Bojan Bogdanovic,27-278,G-F,1/21/17,BRK,CHO,1,28,4,12,0.333,0,4,0,4,8,0.5,4,4,1,0,3,3,3,0,0,2,0,16,10.2
Wesley Matthews,30-068,G,12/21/16,DAL,POR,1,41,6,16,0.375,5,9,0.556,1,7,0.143,3,5,0.6,0,4,4,3,3,0,1,3,16,10.5
Patty Mills,28-121,G,12/10/16,SAS,BRK,0,16,6,11,0.545,2,4,0.5,4,7,0.571,0,0,,0,0,0,4,3,0,1,1,16,15.1
Trevor Ariza,31-173,F,12/20/16,HOU,SAS,1,35,6,14,0.429,3,5,0.6,3,9,0.333,1,2,0.5,0,6,6,2,4,1,4,5,16,10.1
Nikola Vucevic,26-151,C,3/24/17,ORL,DET,1,26,8,14,0.571,8,13,0.615,0,1,0,0,0,,2,6,8,6,1,1,2,1,16,16.1
Reggie Jackson,26-237,G,12/9/16,DET,MIN,1,29,5,15,0.333,3,12,0.25,2,3,0.667,4,4,1,0,1,1,4,0,0,0,4,16,9
Buddy Hield,22-353,G,12/4/16,NOP,OKC,0,15,6,12,0.5,2,5,0.4,4,7,0.571,0,0,,1,3,4,1,0,0,1,0,16,11.3
Marcin Gortat,32-301,C-F,12/14/16,WAS,CHO,1,36,8,11,0.727,8,11,0.727,0,0,,0,0,,5,9,14,1,3,1,1,3,16,19.9
Willie Reed,26-331,F-C,4/12/17,MIA,WAS,0,15,8,9,0.889,8,9,0.889,0,0,,0,0,,3,3,6,0,0,0,1,3,16,13.7
Kevin Seraphin,27-065,F,2/10/17,IND,WAS,0,25,8,10,0.8,8,10,0.8,0,0,,0,0,,3,4,7,1,0,2,1,3,16,15.4
Ryan Anderson,28-180,F,11/2/16,HOU,NYK,1,29,6,15,0.4,2,6,0.333,4,9,0.444,0,0,,5,4,9,0,0,0,3,1,16,9.2
Buddy Hield,23-074,G,3/1/17,SAC,BRK,0,26,6,11,0.545,2,5,0.4,4,6,0.667,0,0,,1,0,1,0,2,0,3,2,16,9.6
Derrick Favors,25-117,F-C,11/9/16,UTA,CHO,1,35,8,12,0.667,8,11,0.727,0,1,0,0,0,,2,8,10,0,0,2,0,3,16,14.8
Al Horford,30-222,C-F,1/11/17,BOS,WAS,1,33,7,12,0.583,5,6,0.833,2,6,0.333,0,0,,1,8,9,3,2,2,2,2,16,16.2
Danilo Gallinari,28-089,F,11/5/16,DEN,DET,1,29,5,14,0.357,3,7,0.429,2,7,0.286,4,5,0.8,1,2,3,2,0,0,0,1,16,10.1
Tyler Johnson,24-284,G,2/15/17,MIA,HOU,0,33,6,11,0.545,4,5,0.8,2,6,0.333,2,3,0.667,4,3,7,4,0,0,2,2,16,14
T.J. Warren,23-178,F,3/2/17,PHO,CHO,1,27,8,11,0.727,8,10,0.8,0,1,0,0,0,,3,5,8,1,0,2,1,0,16,16.2
J.J. Redick,32-169,G,12/10/16,LAC,NOP,1,34,6,14,0.429,4,7,0.571,2,7,0.286,2,2,1,0,1,1,0,0,0,1,0,16,7.9
Dennis Schroder,23-071,G,11/25/16,ATL,UTA,1,28,6,19,0.316,4,12,0.333,2,7,0.286,2,2,1,0,2,2,2,3,0,2,2,16,7.3
David Lee,33-343,F,4/7/17,SAS,DAL,0,31,6,16,0.375,6,16,0.375,0,0,,4,4,1,6,7,13,5,0,0,1,1,16,15.6
Danilo Gallinari,28-084,F,10/31/16,DEN,TOR,1,37,3,11,0.273,1,6,0.167,2,5,0.4,8,8,1,1,1,2,1,0,0,0,0,16,11.2
Michael Kidd-Gilchrist,23-074,F,12/9/16,CHO,ORL,1,21,6,9,0.667,6,9,0.667,0,0,,4,4,1,3,4,7,1,0,0,0,1,16,15.7
LaMarcus Aldridge,31-194,F-C,1/29/17,SAS,DAL,1,34,5,14,0.357,5,14,0.357,0,0,,6,9,0.667,2,5,7,4,0,0,2,1,16,10.3
Eric Bledsoe,27-012,G,12/21/16,PHO,HOU,1,31,6,13,0.462,5,8,0.625,1,5,0.2,3,4,0.75,2,0,2,6,0,0,1,2,16,12.7
Tyson Chandler,34-112,C,1/22/17,PHO,TOR,1,35,7,10,0.7,7,10,0.7,0,0,,2,2,1,3,6,9,2,1,0,2,3,16,14.9
Evan Turner,28-165,G,4/10/17,POR,SAS,1,29,7,17,0.412,6,14,0.429,1,3,0.333,1,1,1,1,2,3,7,1,0,3,2,16,10.3
Iman Shumpert,26-167,G,12/10/16,CLE,CHO,0,32,5,8,0.625,1,2,0.5,4,6,0.667,2,2,1,0,5,5,2,1,0,1,2,16,14.5
Jae Crowder,26-280,F,4/12/17,BOS,MIL,1,30,6,12,0.5,3,5,0.6,3,7,0.429,1,2,0.5,0,5,5,2,3,0,1,1,16,14.1
Clint Capela,22-283,F-C,2/25/17,HOU,MIN,1,22,7,9,0.778,7,9,0.778,0,0,,2,2,1,4,5,9,2,1,1,2,2,16,17.1
Jrue Holiday,26-166,G,11/25/16,NOP,POR,0,29,6,13,0.462,4,9,0.444,2,4,0.5,2,4,0.5,0,4,4,5,0,1,5,4,16,7.3
Paul Millsap,31-329,F,1/4/17,ATL,ORL,1,30,6,12,0.5,4,8,0.5,2,4,0.5,2,5,0.4,0,6,6,4,4,0,5,2,16,11.6
Malik Beasley,20-136,G,4/11/17,DEN,DAL,0,32,6,12,0.5,4,5,0.8,2,7,0.286,2,2,1,2,3,5,2,2,0,0,2,16,14.9
Monta Ellis,31-140,G,3/15/17,IND,CHO,0,27,7,13,0.538,5,8,0.625,2,5,0.4,0,0,,0,1,1,2,1,2,0,3,16,12.6
Clint Capela,22-304,F-C,3/18/17,HOU,DEN,1,24,7,13,0.538,7,13,0.538,0,0,,2,2,1,5,3,8,0,1,1,0,4,16,14.2
Greg Monroe,26-223,C-F,1/13/17,MIL,MIA,0,25,5,13,0.385,5,13,0.385,0,0,,6,6,1,5,6,11,0,0,0,1,1,16,12.8
Jamal Murray,19-354,G,2/11/17,DEN,CLE,0,17,5,11,0.455,2,4,0.5,3,7,0.429,3,3,1,0,0,0,1,1,0,0,3,16,10.8
Brook Lopez,28-266,C,12/23/16,BRK,CLE,1,22,7,11,0.636,5,8,0.625,2,3,0.667,0,0,,1,2,3,1,0,2,3,2,16,10.7
Klay Thompson,26-313,G,12/17/16,GSW,POR,1,25,7,15,0.467,6,11,0.545,1,4,0.25,1,1,1,0,0,0,2,0,1,0,0,16,10.4
Kentavious Caldwell-Pope,23-363,G,2/15/17,DET,DAL,1,37,7,15,0.467,5,8,0.625,2,7,0.286,0,0,,1,4,5,1,0,0,0,2,16,10.1
Jonas Valanciunas,24-226,C,12/18/16,TOR,ORL,1,26,8,15,0.533,8,15,0.533,0,0,,0,0,,6,7,13,0,0,1,0,1,16,15.3
Darrell Arthur,28-305,F,1/24/17,DEN,UTA,0,22,5,7,0.714,2,4,0.5,3,3,1,3,3,1,2,6,8,1,1,0,0,2,16,17.2
Patrick Beverley,28-187,G,1/15/17,HOU,BRK,1,27,6,11,0.545,2,4,0.5,4,7,0.571,0,0,,0,7,7,6,2,0,0,2,16,18.2
Nicolas Batum,28-038,F-G,1/21/17,CHO,BRK,1,35,6,16,0.375,3,10,0.3,3,6,0.5,1,1,1,0,9,9,6,4,0,2,2,16,15.3
Kevin Durant,28-191,F-G,4/8/17,GSW,NOP,1,31,6,15,0.4,6,11,0.545,0,4,0,4,4,1,1,9,10,6,0,0,1,3,16,13.3
Matthew Dellavedova,26-184,G,3/11/17,MIL,MIN,1,28,5,12,0.417,1,5,0.2,4,7,0.571,2,2,1,0,1,1,2,0,0,1,2,16,9.5
Myles Turner,20-226,F-C,11/5/16,IND,CHI,1,28,5,13,0.385,5,12,0.417,0,1,0,6,8,0.75,1,4,5,1,2,4,1,0,16,14.5
Jamal Murray,20-040,G,4/4/17,DEN,NOP,1,33,7,15,0.467,5,8,0.625,2,7,0.286,0,0,,0,5,5,5,1,0,3,1,16,10.9
Paul Millsap,32-029,F,3/11/17,ATL,MEM,1,33,5,12,0.417,4,9,0.444,1,3,0.333,5,7,0.714,2,9,11,6,1,1,1,2,16,17
Zach Randolph,35-202,F,2/3/17,MEM,OKC,0,29,6,14,0.429,6,13,0.462,0,1,0,4,4,1,3,7,10,3,1,0,1,4,16,13.3
Courtney Lee,31-181,G,4/2/17,NYK,BOS,1,30,5,10,0.5,4,7,0.571,1,3,0.333,5,5,1,1,2,3,5,1,0,1,0,16,15.8
Jeff Teague,28-178,G,12/5/16,IND,GSW,1,26,4,10,0.4,4,10,0.4,0,0,,8,10,0.8,1,2,3,6,1,0,4,4,16,10.7
Greg Monroe,26-295,C-F,3/26/17,MIL,CHI,0,26,7,13,0.538,7,13,0.538,0,0,,2,2,1,3,1,4,2,0,0,1,2,16,11.7
Mike Conley,29-101,G,1/20/17,MEM,SAC,1,34,6,13,0.462,4,8,0.5,2,5,0.4,2,2,1,1,7,8,8,2,0,3,2,16,15.9
Wilson Chandler,29-196,F,11/22/16,DEN,CHI,0,33,7,23,0.304,6,19,0.316,1,4,0.25,1,1,1,4,5,9,3,1,1,1,0,16,9.8
Kelly Olynyk,25-250,C-F,12/25/16,BOS,NYK,0,23,7,9,0.778,5,6,0.833,2,3,0.667,0,0,,0,2,2,2,0,0,1,3,16,12.3
Eric Bledsoe,26-350,G,11/23/16,PHO,ORL,1,32,5,15,0.333,4,11,0.364,1,4,0.25,5,8,0.625,0,9,9,5,1,1,3,1,16,10.8
Marvin Williams,30-230,F,2/4/17,CHO,UTA,1,38,5,10,0.5,2,4,0.5,3,6,0.5,3,4,0.75,0,12,12,1,3,1,1,2,16,16.8
Austin Rivers,24-173,G,1/21/17,LAC,DEN,1,26,7,12,0.583,5,8,0.625,2,4,0.5,0,0,,1,1,2,5,0,0,0,3,16,13.7
Andre Drummond,23-077,C,10/26/16,DET,TOR,1,24,7,11,0.636,7,11,0.636,0,0,,2,6,0.333,1,5,6,0,1,0,4,5,16,6.7
Cody Zeller,24-073,F-C,12/17/16,CHO,ATL,1,36,8,14,0.571,8,14,0.571,0,0,,0,0,,2,9,11,1,1,0,2,5,16,11.2
Serge Ibaka,27-128,F-C,1/24/17,ORL,CHI,1,35,6,13,0.462,3,8,0.375,3,5,0.6,1,1,1,1,7,8,0,3,2,1,3,16,14.3
Tony Parker,34-179,G,11/12/16,SAS,HOU,1,27,6,9,0.667,6,9,0.667,0,0,,4,5,0.8,0,1,1,3,0,0,1,0,16,13.1
Patty Mills,28-085,G,11/4/16,SAS,UTA,1,30,6,11,0.545,2,4,0.5,4,7,0.571,0,0,,0,3,3,3,0,0,1,3,16,11.5
Aaron Gordon,21-192,F,3/27/17,ORL,TOR,1,36,7,13,0.538,7,11,0.636,0,2,0,2,4,0.5,1,0,1,0,2,0,0,3,16,10.4
Derrick Rose,28-161,G,3/14/17,NYK,IND,1,32,7,12,0.583,7,11,0.636,0,1,0,2,2,1,0,2,2,4,0,0,0,0,16,13.8
Nene Hilario,34-204,F-C,4/5/17,HOU,DEN,0,24,7,8,0.875,7,8,0.875,0,0,,2,4,0.5,0,4,4,2,1,0,1,1,16,14.6
Jimmy Butler,27-103,G-F,12/26/16,CHI,IND,1,40,3,12,0.25,2,9,0.222,1,3,0.333,9,12,0.75,0,5,5,5,2,0,2,1,16,12.2
Blake Griffin,27-353,F,3/4/17,LAC,CHI,1,34,5,15,0.333,5,12,0.417,0,3,0,6,6,1,1,5,6,7,0,0,3,1,16,11.2
Tony Snell,25-015,G-F,11/25/16,MIL,TOR,1,33,6,12,0.5,2,2,1,4,10,0.4,0,0,,0,3,3,0,0,0,0,2,16,10.1
Julius Randle,22-018,F,12/17/16,LAL,CLE,1,28,8,15,0.533,8,15,0.533,0,0,,0,1,0,1,3,4,7,0,0,5,1,16,9.4
Marcus Smart,22-310,G,1/10/17,BOS,TOR,1,38,6,11,0.545,5,9,0.556,1,2,0.5,3,3,1,1,3,4,5,4,1,3,4,16,15.9
Nick Young,31-289,G-F,3/17/17,LAL,MIL,1,29,6,11,0.545,2,3,0.667,4,8,0.5,0,0,,0,3,3,2,0,0,0,2,16,12.2
Anthony Davis,23-311,F-C,1/16/17,NOP,IND,1,23,6,11,0.545,6,11,0.545,0,0,,4,5,0.8,0,3,3,3,0,0,0,1,16,12.9
Otto Porter,23-288,F,3/18/17,WAS,CHO,1,33,4,11,0.364,0,2,0,4,9,0.444,4,4,1,2,1,3,1,3,0,1,4,16,12.7
Kemba Walker,26-316,G,3/20/17,CHO,ATL,1,29,6,16,0.375,2,8,0.25,4,8,0.5,0,0,,0,4,4,4,1,0,0,0,16,12.2
Dennis Schroder,23-108,G,1/1/17,ATL,SAS,1,33,7,17,0.412,7,15,0.467,0,2,0,2,3,0.667,1,0,1,10,0,1,3,1,16,11.5
Andre Drummond,23-140,C,12/28/16,DET,MIL,1,26,7,13,0.538,7,13,0.538,0,0,,2,6,0.333,4,5,9,0,1,0,1,2,16,11.6
Frank Kaminsky,23-291,F-C,1/20/17,CHO,TOR,0,27,5,10,0.5,3,5,0.6,2,5,0.4,4,4,1,2,6,8,1,3,1,1,0,16,17.6
Brandon Ingram,19-184,F,3/5/17,LAL,NOP,1,39,7,13,0.538,5,10,0.5,2,3,0.667,0,2,0,0,6,6,2,0,1,4,1,16,8.4
Mike Conley,29-026,G,11/6/16,MEM,POR,1,31,5,11,0.455,4,6,0.667,1,5,0.2,5,5,1,0,4,4,7,2,2,2,1,16,17.4
Goran Dragic,30-208,G,11/30/16,MIA,DEN,1,34,6,17,0.353,6,14,0.429,0,3,0,4,6,0.667,0,3,3,7,1,0,0,5,16,10.5
J.R. Smith,31-050,G-F,10/29/16,CLE,ORL,1,28,5,11,0.455,1,1,1,4,10,0.4,2,2,1,3,2,5,1,1,1,0,4,16,13.8
Jusuf Nurkic,22-089,C,11/20/16,DEN,UTA,1,26,8,12,0.667,8,12,0.667,0,0,,0,6,0,5,6,11,2,1,0,2,2,16,13.3
Hassan Whiteside,27-283,C,3/23/17,MIA,TOR,1,30,6,10,0.6,6,10,0.6,0,0,,4,5,0.8,6,8,14,2,0,2,3,4,16,15.8
Shawn Long,24-061,C-F,3/31/17,PHI,CLE,0,22,7,10,0.7,5,7,0.714,2,3,0.667,0,0,,3,1,4,0,1,1,2,1,16,13.5
Mason Plumlee,26-270,C-F,11/30/16,POR,IND,1,27,8,14,0.571,8,13,0.615,0,1,0,0,0,,3,6,9,6,0,1,1,4,16,15.6
Marcus Morris,27-198,F,3/19/17,DET,PHO,1,36,6,9,0.667,4,6,0.667,2,3,0.667,2,3,0.667,1,4,5,3,0,0,2,2,16,12.9
Joe Harris,25-091,G,12/7/16,BRK,DEN,0,24,6,8,0.75,4,5,0.8,2,3,0.667,2,2,1,1,1,2,0,2,0,0,3,16,14.6
Devin Booker,20-126,G,3/5/17,PHO,BOS,1,27,5,10,0.5,4,7,0.571,1,3,0.333,5,6,0.833,0,5,5,0,1,0,1,5,16,10.1
Tim Hardaway,24-357,G,3/8/17,ATL,BRK,0,29,5,11,0.455,4,9,0.444,1,2,0.5,5,5,1,1,5,6,0,2,0,2,1,16,12.1
Trevor Ariza,31-140,F,11/17/16,HOU,POR,1,29,5,8,0.625,1,2,0.5,4,6,0.667,2,2,1,2,5,7,0,1,0,0,0,16,16.3
Marcin Gortat,33-054,C-F,4/12/17,WAS,MIA,1,25,8,9,0.889,8,9,0.889,0,0,,0,1,0,2,3,5,1,0,0,1,1,16,14.1
Victor Oladipo,24-307,G,3/7/17,OKC,POR,1,25,5,9,0.556,1,4,0.25,4,5,0.8,2,2,1,0,5,5,0,0,0,1,3,16,11
Kemba Walker,26-314,G,3/18/17,CHO,WAS,1,34,5,18,0.278,1,9,0.111,4,9,0.444,2,3,0.667,0,2,2,6,0,0,2,1,16,7.4
Reggie Jackson,26-274,G,1/15/17,DET,LAL,1,28,6,16,0.375,5,14,0.357,1,2,0.5,3,3,1,2,1,3,5,0,0,2,3,16,9.2
Alexis Ajinca,28-226,C,12/18/16,NOP,SAS,1,27,8,12,0.667,8,11,0.727,0,1,0,0,0,,1,7,8,1,0,1,0,2,16,14.2
Norman Powell,23-191,G,12/2/16,TOR,LAL,1,32,7,14,0.5,5,8,0.625,2,6,0.333,0,2,0,1,6,7,2,0,0,0,2,16,11.3
Goran Dragic,30-319,G,3/21/17,MIA,PHO,1,28,6,15,0.4,4,10,0.4,2,5,0.4,2,3,0.667,1,3,4,2,2,0,3,3,16,8.3
Karl-Anthony Towns,21-028,C-F,12/13/16,MIN,CHI,1,39,6,21,0.286,5,13,0.385,1,8,0.125,3,4,0.75,1,10,11,2,1,3,4,1,16,7.1
Al Horford,30-253,C-F,2/11/17,BOS,UTA,1,34,6,9,0.667,4,5,0.8,2,4,0.5,2,3,0.667,0,9,9,3,0,1,4,2,16,12.4
James Johnson,29-347,F,2/1/17,MIA,ATL,0,23,7,13,0.538,5,7,0.714,2,6,0.333,0,1,0,0,2,2,3,1,3,1,1,16,13.7
Damian Lillard,26-161,G,12/23/16,POR,SAS,1,37,7,19,0.368,6,14,0.429,1,5,0.2,1,2,0.5,0,5,5,10,1,0,2,3,16,11.4
Will Barton,25-299,G,10/31/16,DEN,TOR,1,30,5,7,0.714,3,5,0.6,2,2,1,4,5,0.8,0,4,4,3,0,1,0,0,16,16.7
Joakim Noah,31-253,C,11/4/16,NYK,CHI,1,35,7,11,0.636,7,10,0.7,0,1,0,2,2,1,3,6,9,4,3,0,0,4,16,19.2
Andre Drummond,23-148,C,1/5/17,DET,CHO,1,25,7,15,0.467,7,15,0.467,0,0,,2,3,0.667,2,6,8,0,0,1,0,5,16,9.8
Amir Johnson,29-346,F,4/12/17,BOS,MIL,1,19,6,7,0.857,4,5,0.8,2,2,1,2,3,0.667,2,3,5,1,1,1,0,4,16,16.2
Tyler Johnson,24-273,G,2/4/17,MIA,PHI,0,34,5,9,0.556,5,9,0.556,0,0,,6,8,0.75,0,6,6,6,1,1,2,4,16,15
Jared Dudley,31-131,F-G,11/18/16,PHO,IND,0,32,6,10,0.6,4,6,0.667,2,4,0.5,2,2,1,2,3,5,6,0,0,1,0,16,16.9
Seth Curry,26-135,G,1/5/17,DAL,PHO,0,26,6,9,0.667,5,6,0.833,1,3,0.333,3,4,0.75,0,1,1,0,0,0,1,4,16,9.4
Terrence Ross,25-287,F-G,11/18/16,TOR,DEN,0,30,6,11,0.545,2,6,0.333,4,5,0.8,0,1,0,0,2,2,2,0,0,1,2,16,10.5
Draymond Green,26-337,F,2/4/17,GSW,SAC,1,43,6,15,0.4,3,7,0.429,3,8,0.375,1,4,0.25,1,7,8,6,2,2,6,1,16,10.7
Serge Ibaka,27-184,F-C,3/21/17,TOR,CHI,1,26,7,13,0.538,5,10,0.5,2,3,0.667,0,0,,2,4,6,1,0,0,1,3,16,10.8
Jeremy Lin,28-197,G,3/8/17,BRK,ATL,1,25,6,13,0.462,3,7,0.429,3,6,0.5,1,2,0.5,0,3,3,8,1,0,4,4,16,10.8
Jusuf Nurkic,22-133,C,1/3/17,DEN,SAC,0,18,6,8,0.75,6,8,0.75,0,0,,4,4,1,1,5,6,4,1,1,2,1,16,17.1
Blake Griffin,27-357,F,3/8/17,LAC,MIN,1,36,5,11,0.455,3,7,0.429,2,4,0.5,4,4,1,0,4,4,2,0,0,6,4,16,5.3
Eric Gordon,27-312,G,11/1/16,HOU,CLE,1,33,6,13,0.462,2,4,0.5,4,9,0.444,0,0,,0,2,2,3,2,0,2,5,16,10
Marco Belinelli,30-313,G-F,2/1/17,CHO,GSW,0,30,6,11,0.545,5,6,0.833,1,5,0.2,3,3,1,1,1,2,7,1,0,1,2,16,15.8
Aaron Gordon,21-141,F,2/4/17,ORL,ATL,1,26,5,10,0.5,4,8,0.5,1,2,0.5,5,6,0.833,1,2,3,3,2,0,0,2,16,15.2
Al-Farouq Aminu,26-109,F,1/8/17,POR,DET,1,37,7,10,0.7,6,7,0.857,1,3,0.333,1,1,1,1,7,8,2,0,0,1,1,16,14.6
Kristaps Porzingis,21-115,F-C,11/25/16,NYK,CHO,1,34,6,16,0.375,2,8,0.25,4,8,0.5,0,0,,2,6,8,2,1,3,3,4,16,10.3
Ryan Anderson,28-281,F,2/11/17,HOU,PHO,1,33,4,9,0.444,1,3,0.333,3,6,0.5,5,8,0.625,2,2,4,1,1,1,3,1,16,11.1
Seth Curry,26-125,G,12/26/16,DAL,NOP,0,31,5,9,0.556,3,3,1,2,6,0.333,4,5,0.8,0,1,1,7,0,0,1,3,16,14.3
Robert Covington,26-095,F,3/19/17,PHI,BOS,1,36,7,15,0.467,5,8,0.625,2,7,0.286,0,0,,1,6,7,0,2,1,4,2,16,8.7
Gorgui Dieng,26-330,C,12/13/16,MIN,CHI,1,37,7,12,0.583,6,10,0.6,1,2,0.5,1,2,0.5,2,5,7,2,0,2,1,3,16,13.5
Jeff Teague,28-268,G,3/5/17,IND,ATL,1,32,5,10,0.5,4,6,0.667,1,4,0.25,5,5,1,0,4,4,6,1,1,2,0,16,16.1
Nik Stauskas,23-124,G,2/8/17,PHI,SAS,0,32,5,10,0.5,1,3,0.333,4,7,0.571,2,2,1,0,7,7,7,0,0,0,0,16,18
Kent Bazemore,27-208,G-F,1/25/17,ATL,CHI,1,33,7,14,0.5,5,10,0.5,2,4,0.5,0,0,,1,5,6,7,1,3,1,3,16,17
Shabazz Muhammad,24-072,F-G,1/24/17,MIN,PHO,0,27,6,9,0.667,4,6,0.667,2,3,0.667,2,3,0.667,0,3,3,1,0,0,0,0,16,13.3
Enes Kanter,24-289,C,3/5/17,OKC,DAL,0,19,7,14,0.5,7,13,0.538,0,1,0,2,5,0.4,6,4,10,2,1,0,3,2,16,11.8
D'Angelo Russell,21-045,G,4/9/17,LAL,MIN,1,34,6,19,0.316,4,11,0.364,2,8,0.25,2,2,1,1,3,4,4,3,0,5,2,16,6.7
Kyle Lowry,30-296,G,1/15/17,TOR,NYK,1,28,6,10,0.6,4,5,0.8,2,5,0.4,2,3,0.667,0,4,4,9,1,1,1,1,16,18.8
Roy Hibbert,30-038,C,1/18/17,CHO,POR,0,22,7,8,0.875,7,8,0.875,0,0,,2,2,1,2,4,6,0,0,2,0,1,16,16.8
George Hill,30-269,G,1/28/17,UTA,MEM,1,33,7,13,0.538,6,8,0.75,1,5,0.2,1,1,1,0,3,3,5,0,0,3,4,16,9.5
Danny Green,29-280,G-F,3/29/17,SAS,GSW,1,30,5,9,0.556,1,3,0.333,4,6,0.667,2,2,1,4,2,6,3,2,0,2,2,16,16.4
Dwight Howard,31-048,C,1/25/17,ATL,CHI,1,34,6,10,0.6,6,10,0.6,0,0,,4,5,0.8,2,10,12,2,1,1,1,0,16,17.5
DeMarcus Cousins,26-171,C-F,1/31/17,SAC,HOU,1,25,5,16,0.313,4,12,0.333,1,4,0.25,5,7,0.714,1,6,7,5,0,0,2,2,16,9.2
Manu Ginobili,39-170,G,1/14/17,SAS,PHO,0,25,3,7,0.429,1,3,0.333,2,4,0.5,8,8,1,0,2,2,3,0,0,3,2,16,11.2
Iman Shumpert,26-213,G,1/25/17,CLE,SAC,1,28,6,9,0.667,2,2,1,4,7,0.571,0,0,,0,3,3,2,2,0,0,2,16,15.6
Seth Curry,26-133,G,1/3/17,DAL,WAS,0,22,5,8,0.625,1,3,0.333,4,5,0.8,2,2,1,0,1,1,2,1,0,1,2,16,13.3
Ricky Rubio,26-105,G,2/3/17,MIN,DET,1,34,4,10,0.4,2,6,0.333,2,4,0.5,6,7,0.857,0,2,2,7,2,0,6,1,16,11.3
Tony Snell,25-151,G-F,4/10/17,MIL,CHO,1,26,6,9,0.667,2,4,0.5,4,5,0.8,0,0,,0,0,0,2,2,0,2,0,16,13.5
Myles Turner,20-246,F-C,11/25/16,IND,BRK,1,23,6,11,0.545,6,10,0.6,0,1,0,4,4,1,2,6,8,1,1,4,2,3,16,15.2
Ersan Ilyasova,29-185,F,11/16/16,PHI,WAS,1,26,5,10,0.5,1,2,0.5,4,8,0.5,2,2,1,1,3,4,0,0,0,1,6,16,9.2
Kristaps Porzingis,21-107,F-C,11/17/16,NYK,WAS,1,37,7,16,0.438,5,11,0.455,2,5,0.4,0,0,,2,5,7,2,4,0,2,4,16,12.3
Marcus Morris,27-174,F,2/23/17,DET,CHO,1,38,6,17,0.353,3,13,0.231,3,4,0.75,1,1,1,1,7,8,0,1,0,1,3,16,8.1
Deron Williams,32-208,G,1/20/17,DAL,UTA,1,35,6,14,0.429,5,11,0.455,1,3,0.333,3,5,0.6,1,3,4,8,0,0,3,2,16,11.2
Iman Shumpert,26-201,G,1/13/17,CLE,SAC,1,26,6,9,0.667,2,3,0.667,4,6,0.667,0,0,,0,0,0,0,2,0,0,0,16,14.1
Brook Lopez,29-003,C,4/4/17,BRK,PHI,1,23,4,5,0.8,2,3,0.667,2,2,1,6,6,1,0,4,4,1,0,3,1,1,16,16.7
Rondae Hollis-Jefferson,22-053,F,2/25/17,BRK,GSW,1,21,6,13,0.462,6,11,0.545,0,2,0,4,4,1,4,6,10,1,1,0,1,2,16,13.8
JaVale McGee,29-079,C,4/8/17,GSW,NOP,0,16,8,10,0.8,8,10,0.8,0,0,,0,1,0,4,3,7,0,0,1,1,1,16,14.8
Wesley Matthews,30-052,G,12/5/16,DAL,CHO,1,35,5,13,0.385,1,4,0.25,4,9,0.444,2,2,1,0,5,5,3,0,0,0,2,16,11.7
Jeremy Lamb,24-302,G-F,3/28/17,CHO,MIL,0,26,6,11,0.545,5,8,0.625,1,3,0.333,3,4,0.75,0,3,3,2,1,0,0,3,16,12.4
Mason Plumlee,26-305,C-F,1/4/17,POR,GSW,1,33,6,12,0.5,6,11,0.545,0,1,0,4,5,0.8,3,7,10,4,3,1,0,2,16,19.5
Steven Adams,23-098,C,10/26/16,OKC,PHI,1,36,7,16,0.438,7,16,0.438,0,0,,2,2,1,2,3,5,1,3,0,2,4,16,10
Caris LeVert,22-201,G-F,3/14/17,BRK,OKC,1,23,4,6,0.667,3,4,0.75,1,2,0.5,7,8,0.875,1,6,7,2,2,1,2,2,16,16.8
C.J. Miles,29-197,G-F,11/1/16,IND,LAL,0,23,6,9,0.667,4,6,0.667,2,3,0.667,2,2,1,1,1,2,0,1,1,1,1,16,13.4
LeBron James,32-074,F-G,3/14/17,CLE,DET,1,28,6,12,0.5,6,10,0.6,0,2,0,4,5,0.8,0,11,11,12,0,0,2,0,16,19.3
Al Jefferson,31-328,C-F,11/27/16,IND,LAC,0,21,8,17,0.471,8,17,0.471,0,0,,0,0,,3,5,8,2,0,0,0,3,16,11.1
Rudy Gay,30-078,F,11/3/16,SAC,ORL,1,32,6,13,0.462,4,10,0.4,2,3,0.667,2,5,0.4,0,2,2,2,1,0,3,3,16,6.9
Nicolas Batum,28-096,F-G,3/20/17,CHO,ATL,1,31,5,8,0.625,4,6,0.667,1,2,0.5,5,7,0.714,0,1,1,6,1,0,1,0,16,16.1
Dennis Schroder,23-177,G,3/11/17,ATL,MEM,1,29,7,15,0.467,6,11,0.545,1,4,0.25,1,2,0.5,1,6,7,8,3,0,6,3,16,11.8
Paul George,26-216,F,12/4/16,IND,LAC,1,34,6,13,0.462,3,7,0.429,3,6,0.5,1,1,1,0,7,7,5,3,0,2,5,16,13.9
Taurean Waller-Prince,22-359,F,3/16/17,ATL,MEM,0,29,6,10,0.6,4,6,0.667,2,4,0.5,2,2,1,1,5,6,1,0,4,3,2,16,13.3
Marquese Chriss,19-133,F,11/12/16,PHO,BRK,1,18,7,15,0.467,5,11,0.455,2,4,0.5,0,0,,2,3,5,0,1,0,2,2,16,8.8
K.J. McDaniels,24-042,G-F,3/23/17,BRK,PHO,0,24,6,9,0.667,5,6,0.833,1,3,0.333,3,3,1,2,6,8,1,2,1,1,3,16,16.5
Matt Barnes,36-327,F,1/30/17,SAC,PHI,0,22,6,12,0.5,2,5,0.4,4,7,0.571,0,0,,2,1,3,2,1,0,1,4,16,11.5
Nikola Vucevic,26-114,C,2/15/17,ORL,SAS,1,28,7,16,0.438,7,16,0.438,0,0,,2,2,1,1,9,10,0,0,1,3,2,16,7.9
Ish Smith,28-253,G,3/15/17,DET,UTA,0,28,6,9,0.667,6,9,0.667,0,0,,4,6,0.667,0,3,3,3,0,0,2,1,16,11.9
John Wall,26-206,G,3/31/17,WAS,UTA,1,38,6,22,0.273,5,19,0.263,1,3,0.333,3,4,0.75,1,3,4,5,1,0,2,1,16,6.3
Ryan Anderson,28-262,F,1/23/17,HOU,MIL,1,29,6,11,0.545,3,4,0.75,3,7,0.429,1,1,1,1,0,1,1,1,0,1,4,16,10.5
Giannis Antetokounmpo,22-099,F-G,3/15/17,MIL,LAC,1,28,5,10,0.5,5,10,0.5,0,0,,6,9,0.667,0,5,5,5,0,1,2,4,16,11.9
Paul Millsap,32-031,F,3/13/17,ATL,SAS,1,40,6,13,0.462,6,11,0.545,0,2,0,4,6,0.667,1,2,3,5,1,1,4,5,16,9
Jameer Nelson,35-001,G,2/10/17,DEN,NYK,1,36,6,10,0.6,2,4,0.5,4,6,0.667,0,0,,0,4,4,12,0,0,2,2,16,18.2
J.J. Redick,32-264,G,3/15/17,LAC,MIL,1,31,4,9,0.444,2,4,0.5,2,5,0.4,6,9,0.667,0,1,1,4,0,0,1,0,16,12.2
Zach Randolph,35-214,F,2/15/17,MEM,NOP,0,25,5,11,0.455,5,10,0.5,0,1,0,6,6,1,5,4,9,0,1,0,2,5,16,12
Bobby Portis,21-269,F,11/5/16,CHI,IND,0,18,7,9,0.778,6,8,0.75,1,1,1,1,3,0.333,2,3,5,1,0,0,0,1,16,14.3
Courtney Lee,31-171,G,3/23/17,NYK,POR,1,41,6,12,0.5,6,9,0.667,0,3,0,4,4,1,0,1,1,4,1,0,2,2,16,11.3
Beno Udrih,34-269,G,3/31/17,DET,MIL,0,21,7,10,0.7,7,8,0.875,0,2,0,2,2,1,0,1,1,8,2,0,1,1,16,18.3
Nick Young,31-151,G-F,10/30/16,LAL,OKC,1,30,4,11,0.364,1,1,1,3,10,0.3,5,5,1,0,3,3,1,2,0,2,5,16,9.5
Victor Oladipo,24-331,G,3/31/17,OKC,SAS,1,33,7,17,0.412,5,10,0.5,2,7,0.286,0,0,,0,2,2,3,1,0,3,3,16,6.4
Raymond Felton,32-190,G,1/2/17,LAC,PHO,1,37,5,13,0.385,5,11,0.455,0,2,0,6,8,0.75,0,4,4,5,1,2,4,3,16,10
Karl-Anthony Towns,21-130,C-F,3/25/17,MIN,POR,1,31,6,11,0.545,6,9,0.667,0,2,0,4,5,0.8,1,4,5,0,0,0,2,1,16,9.8
Blake Griffin,27-256,F,11/27/16,LAC,IND,1,34,6,15,0.4,6,14,0.429,0,1,0,4,4,1,3,6,9,3,0,0,3,1,16,10.5
Richard Jefferson,36-266,F,3/14/17,CLE,DET,1,26,5,9,0.556,1,2,0.5,4,7,0.571,2,3,0.667,0,2,2,1,2,0,1,2,16,12.8
Marc Gasol,32-068,C,4/7/17,MEM,NYK,1,34,4,13,0.308,2,9,0.222,2,4,0.5,6,6,1,0,10,10,3,0,3,2,3,16,12.5
Rudy Gobert,24-276,C,3/29/17,UTA,SAC,1,34,5,8,0.625,5,8,0.625,0,0,,6,8,0.75,4,11,15,0,0,0,0,1,16,17.3
Ish Smith,28-274,G,4/5/17,DET,TOR,1,30,7,13,0.538,7,13,0.538,0,0,,2,2,1,1,3,4,6,0,1,1,3,16,14
Zach Randolph,35-160,F,12/23/16,MEM,HOU,0,20,8,11,0.727,8,11,0.727,0,0,,0,0,,1,4,5,4,1,0,2,1,16,14.8
Tristan Thompson,25-285,F-C,12/23/16,CLE,BRK,1,26,7,8,0.875,7,8,0.875,0,0,,2,2,1,6,5,11,1,1,1,2,1,16,18.9
Gerald Henderson,29-005,G,12/14/16,PHI,TOR,1,25,6,7,0.857,4,4,1,2,3,0.667,2,2,1,0,0,0,2,1,0,2,1,16,13.5
Derrick Favors,25-115,F-C,11/7/16,UTA,PHI,1,29,6,11,0.545,6,11,0.545,0,0,,4,8,0.5,3,11,14,1,1,3,1,3,16,16.1
Alan Williams,24-033,F-C,3/2/17,PHO,CHO,0,24,7,9,0.778,7,9,0.778,0,0,,2,4,0.5,1,11,12,0,1,1,1,3,16,15.2
Dwight Howard,31-092,C,3/10/17,ATL,TOR,1,34,6,9,0.667,6,9,0.667,0,0,,4,10,0.4,3,7,10,1,1,2,4,4,16,11.4
Kelly Olynyk,25-302,C-F,2/15/17,BOS,PHI,0,26,6,8,0.75,4,6,0.667,2,2,1,2,3,0.667,1,6,7,3,1,0,3,2,16,14.2
John Wall,26-124,G,1/8/17,WAS,MIL,1,37,7,15,0.467,7,12,0.583,0,3,0,2,2,1,0,3,3,7,1,0,5,1,16,9.7
LaMarcus Aldridge,31-222,F-C,2/26/17,SAS,LAL,1,23,8,14,0.571,8,14,0.571,0,0,,0,0,,5,4,9,1,0,0,0,0,16,14.8
Tobias Harris,24-264,F,4/5/17,DET,TOR,0,34,7,16,0.438,5,9,0.556,2,7,0.286,0,0,,0,2,2,1,0,1,0,2,16,8.8
Marcus Smart,22-310,G,1/10/17,BOS,TOR,1,38,6,11,0.545,5,9,0.556,1,2,0.5,3,3,1,1,3,4,5,4,1,3,4,16,15.9
Tony Allen,34-340,G-F,12/16/16,MEM,SAC,1,34,6,13,0.462,6,13,0.462,0,0,,4,6,0.667,6,3,9,1,2,1,2,2,16,14.2
Jeremy Lamb,24-151,G-F,10/28/16,CHO,MIA,0,22,7,12,0.583,7,10,0.7,0,2,0,2,2,1,2,6,8,1,0,1,0,4,16,13.4
Justin Hamilton,26-279,C,1/5/17,BRK,IND,0,22,6,9,0.667,2,4,0.5,4,5,0.8,0,0,,2,6,8,0,1,1,0,0,16,17
Greg Monroe,26-152,C-F,11/3/16,MIL,IND,0,26,6,11,0.545,6,11,0.545,0,0,,4,5,0.8,6,10,16,7,0,1,1,2,16,21.3
Hassan Whiteside,27-222,C,1/21/17,MIA,MIL,1,30,7,8,0.875,7,8,0.875,0,0,,2,4,0.5,2,13,15,0,0,2,1,3,16,16.9
Justin Holiday,27-223,G,11/14/16,NYK,DAL,0,25,6,7,0.857,4,4,1,2,3,0.667,2,2,1,0,4,4,2,1,1,1,3,16,15.6
LaMarcus Aldridge,31-188,F-C,1/23/17,SAS,BRK,1,27,8,19,0.421,8,18,0.444,0,1,0,0,0,,4,5,9,5,2,2,1,2,16,15.3
Will Barton,25-297,G,10/29/16,DEN,POR,1,41,4,13,0.308,4,11,0.364,0,2,0,8,8,1,1,5,6,3,0,1,1,3,16,11.3
Steven Adams,23-241,C,3/18/17,OKC,SAC,1,35,6,7,0.857,6,7,0.857,0,0,,4,6,0.667,4,9,13,3,2,1,2,3,16,19.8
Salah Mejri,30-231,C,2/1/17,DAL,PHI,0,21,7,9,0.778,7,9,0.778,0,0,,2,4,0.5,8,9,17,0,1,1,1,2,16,19.9
Garrett Temple,30-218,G,12/12/16,SAC,LAL,0,31,7,8,0.875,5,6,0.833,2,2,1,0,0,,0,1,1,2,1,0,1,3,16,13.7
Dirk Nowitzki,38-275,F,3/21/17,DAL,GSW,1,28,6,13,0.462,5,9,0.556,1,4,0.25,3,3,1,1,8,9,1,0,0,0,0,16,13.1
Mike Muscala,25-173,F-C,12/21/16,ATL,MIN,0,30,6,9,0.667,3,6,0.5,3,3,1,1,1,1,2,2,4,0,1,0,2,4,16,11.5
Jeff Green,30-107,F,12/13/16,ORL,ATL,0,31,6,14,0.429,5,10,0.5,1,4,0.25,3,3,1,1,3,4,1,0,0,3,1,16,7.5
Paul Millsap,31-268,F,11/4/16,ATL,WAS,1,33,5,14,0.357,4,11,0.364,1,3,0.333,5,10,0.5,1,6,7,2,4,0,3,3,16,9.9
Markieff Morris,27-094,F,12/5/16,WAS,BRK,1,33,5,9,0.556,5,8,0.625,0,1,0,6,6,1,1,4,5,1,4,0,2,4,16,14.7
Tyler Johnson,24-181,G,11/4/16,MIA,TOR,0,30,5,10,0.5,1,2,0.5,4,8,0.5,2,2,1,0,4,4,2,3,2,1,4,16,15.4
Ish Smith,28-259,G,3/21/17,DET,BRK,0,28,8,15,0.533,8,13,0.615,0,2,0,0,0,,1,6,7,4,3,1,0,1,16,17.3
DeMarcus Cousins,26-119,C-F,12/10/16,SAC,UTA,1,34,7,22,0.318,6,16,0.375,1,6,0.167,1,3,0.333,3,7,10,4,1,1,3,3,16,7.1
Marc Gasol,31-329,C,12/23/16,MEM,HOU,1,34,5,14,0.357,5,13,0.385,0,1,0,6,6,1,1,4,5,4,1,2,3,3,16,11.1
JaMychal Green,26-162,F,11/30/16,MEM,TOR,1,34,5,11,0.455,5,9,0.556,0,2,0,6,7,0.857,3,2,5,1,5,1,1,1,16,17.6
Andrew Wiggins,21-319,F-G,1/7/17,MIN,UTA,1,38,6,19,0.316,5,16,0.313,1,3,0.333,3,7,0.429,4,1,5,4,0,1,5,4,16,3.5
Evan Fournier,24-018,G-F,11/16/16,ORL,NOP,1,34,5,13,0.385,3,8,0.375,2,5,0.4,4,6,0.667,0,1,1,3,1,0,1,2,16,9.7
Nikola Vucevic,26-124,C,2/25/17,ORL,ATL,1,29,6,14,0.429,6,13,0.462,0,1,0,4,4,1,3,11,14,1,2,2,2,3,16,14.9
Jeremy Lin,28-117,G,12/18/16,BRK,PHI,0,22,5,10,0.5,3,3,1,2,7,0.286,4,5,0.8,0,2,2,4,2,0,3,1,16,12.6
Seth Curry,26-160,G,1/30/17,DAL,CLE,1,38,7,17,0.412,5,11,0.455,2,6,0.333,0,0,,1,4,5,4,0,0,0,1,16,11.2
Arron Afflalo,31-168,G,4/1/17,SAC,MIN,0,26,5,9,0.556,1,4,0.25,4,5,0.8,2,3,0.667,0,2,2,2,0,0,2,2,16,10.5
Gorgui Dieng,27-006,C,1/24/17,MIN,PHO,1,34,8,11,0.727,8,11,0.727,0,0,,0,0,,4,5,9,2,1,3,2,4,16,16.7
Rondae Hollis-Jefferson,22-095,F,4/8/17,BRK,CHI,1,30,5,8,0.625,5,7,0.714,0,1,0,6,7,0.857,2,10,12,3,3,1,1,2,16,20.4
Kosta Koufos,27-296,C,12/16/16,SAC,MEM,1,30,7,11,0.636,7,11,0.636,0,0,,2,6,0.333,7,6,13,2,0,3,1,5,16,16.7
J.J. Redick,32-267,G,3/18/17,LAC,CLE,1,19,6,11,0.545,4,7,0.571,2,4,0.5,2,2,1,0,1,1,1,1,0,1,4,16,10.1
Courtney Lee,31-181,G,4/2/17,NYK,BOS,1,30,5,10,0.5,4,7,0.571,1,3,0.333,5,5,1,1,2,3,5,1,0,1,0,16,15.8
Marco Belinelli,30-253,G-F,12/3/16,CHO,MIN,0,23,6,10,0.6,3,3,1,3,7,0.429,0,0,,0,0,0,0,0,0,1,0,15,9.4
Garrett Temple,30-241,G,1/4/17,SAC,MIA,0,31,7,11,0.636,7,7,1,0,4,0,1,1,1,0,0,0,2,3,0,1,3,15,12.3
C.J. Watson,32-287,G,1/29/17,ORL,TOR,1,34,5,8,0.625,5,7,0.714,0,1,0,5,5,1,0,1,1,1,1,0,1,4,15,10.8
Kevin Love,28-212,F,4/7/17,CLE,ATL,1,35,6,17,0.353,3,7,0.429,3,10,0.3,0,0,,0,15,15,3,0,0,2,4,15,8.5
Serge Ibaka,27-062,F-C,11/19/16,ORL,DAL,1,31,6,12,0.5,4,9,0.444,2,3,0.667,1,2,0.5,3,6,9,1,1,3,4,3,15,11.1
Buddy Hield,23-045,G,1/31/17,NOP,TOR,1,33,6,9,0.667,3,4,0.75,3,5,0.6,0,0,,0,6,6,0,0,1,1,2,15,11.8
Bismack Biyombo,24-141,C-F,1/16/17,ORL,DEN,0,20,7,9,0.778,7,9,0.778,0,0,,1,4,0.25,3,6,9,0,0,0,1,1,15,12.8
Terrence Jones,25-026,F,2/4/17,NOP,WAS,1,30,5,10,0.5,4,7,0.571,1,3,0.333,4,9,0.444,1,3,4,0,0,2,1,0,15,10
Marco Belinelli,30-260,G-F,12/10/16,CHO,CLE,0,29,6,11,0.545,3,7,0.429,3,4,0.75,0,0,,1,0,1,1,0,0,1,4,15,8.5
Nikola Mirotic,25-259,F,10/27/16,CHI,BOS,0,29,6,11,0.545,5,5,1,1,6,0.167,2,2,1,2,7,9,1,0,0,3,3,15,9.7
Nik Stauskas,23-114,G,1/29/17,PHI,CHI,1,33,6,14,0.429,3,8,0.375,3,6,0.5,0,0,,0,1,1,3,1,1,1,1,15,10.3
Kristaps Porzingis,21-124,F-C,12/4/16,NYK,SAC,1,35,6,18,0.333,5,12,0.417,1,6,0.167,2,2,1,3,11,14,2,0,5,3,4,15,10.5
Nick Young,31-272,G-F,2/28/17,LAL,CHO,1,30,5,11,0.455,0,1,0,5,10,0.5,0,0,,0,0,0,0,0,0,0,3,15,8.1
Khris Middleton,25-241,F-G,4/10/17,MIL,CHO,1,36,5,9,0.556,1,4,0.25,4,5,0.8,1,1,1,1,6,7,6,0,0,4,1,15,13
Hassan Whiteside,27-166,C,11/26/16,MIA,MEM,1,34,7,11,0.636,7,11,0.636,0,0,,1,4,0.25,4,8,12,0,1,2,1,4,15,13.9
Andre Iguodala,33-016,G-F,2/13/17,GSW,DEN,0,18,6,9,0.667,5,5,1,1,4,0.25,2,2,1,0,1,1,2,2,0,0,0,15,14.8
Marreese Speights,29-125,C-F,12/7/16,LAC,GSW,0,16,6,11,0.545,5,8,0.625,1,3,0.333,2,2,1,2,7,9,0,0,0,0,3,15,12
Danilo Gallinari,28-161,F,1/16/17,DEN,ORL,1,40,5,11,0.455,3,5,0.6,2,6,0.333,3,4,0.75,0,6,6,2,1,0,3,0,15,10.1
James Ennis,26-117,F,10/26/16,MEM,MIN,1,28,5,8,0.625,3,4,0.75,2,4,0.5,3,4,0.75,1,5,6,0,1,0,0,3,15,13
Trevor Ariza,31-158,F,12/5/16,HOU,BOS,1,33,6,15,0.4,3,5,0.6,3,10,0.3,0,0,,1,7,8,1,0,2,0,2,15,11
Kevin Love,28-128,F,1/13/17,CLE,SAC,1,31,6,16,0.375,5,10,0.5,1,6,0.167,2,2,1,5,12,17,1,0,0,2,1,15,11.6
Goran Dragic,30-309,G,3/11/17,MIA,TOR,1,17,5,9,0.556,4,7,0.571,1,2,0.5,4,5,0.8,0,2,2,2,2,0,0,1,15,13.9
Arron Afflalo,31-024,G,11/8/16,SAC,NOP,1,29,5,6,0.833,3,3,1,2,3,0.667,3,3,1,0,2,2,2,0,0,0,2,15,14
Carmelo Anthony,32-280,F,3/5/17,NYK,GSW,1,35,6,12,0.5,5,8,0.625,1,4,0.25,2,2,1,2,4,6,2,0,2,2,1,15,12
Jrue Holiday,26-272,G,3/11/17,NOP,CHO,1,42,6,14,0.429,5,9,0.556,1,5,0.2,2,2,1,0,4,4,13,3,1,2,1,15,19.2
Matt Barnes,36-254,F,11/18/16,SAC,LAC,0,30,5,10,0.5,1,4,0.25,4,6,0.667,1,2,0.5,2,5,7,1,1,2,2,4,15,12
Gerald Green,30-347,G-F,1/7/17,BOS,NOP,0,16,3,7,0.429,1,4,0.25,2,3,0.667,7,7,1,0,3,3,0,0,0,0,3,15,11
Paul Millsap,31-279,F,11/15/16,ATL,MIA,1,35,7,17,0.412,7,15,0.467,0,2,0,1,2,0.5,1,5,6,4,2,0,1,2,15,10.7
Jae Crowder,26-140,F,11/23/16,BOS,BRK,1,22,6,11,0.545,3,4,0.75,3,7,0.429,0,1,0,1,4,5,1,0,0,0,2,15,11.1
Dennis Schroder,23-153,G,2/15/17,ATL,LAC,1,29,5,15,0.333,3,9,0.333,2,6,0.333,3,4,0.75,1,3,4,7,0,0,1,0,15,11.6
Joe Harris,25-127,G,1/12/17,BRK,NOP,1,27,6,10,0.6,4,4,1,2,6,0.333,1,2,0.5,0,2,2,2,0,0,0,1,15,11.6
C.J. McCollum,25-085,G,12/13/16,POR,OKC,1,30,6,13,0.462,5,10,0.5,1,3,0.333,2,3,0.667,1,3,4,4,1,1,3,1,15,10.6
Brandon Ingram,19-137,F,1/17/17,LAL,DEN,1,37,6,14,0.429,4,8,0.5,2,6,0.333,1,2,0.5,1,4,5,4,3,0,0,2,15,14.1
Sean Kilpatrick,26-297,G,10/29/16,BRK,MIL,0,24,5,9,0.556,4,7,0.571,1,2,0.5,4,5,0.8,0,0,0,1,1,0,1,3,15,9.8
Jameer Nelson,35-037,G,3/18/17,DEN,HOU,1,39,6,14,0.429,4,7,0.571,2,7,0.286,1,2,0.5,2,5,7,11,1,0,2,3,15,15.6
Eric Bledsoe,26-364,G,12/7/16,PHO,IND,1,29,5,13,0.385,5,8,0.625,0,5,0,5,5,1,0,3,3,4,3,1,4,5,15,9.3
Richaun Holmes,23-135,F-C,2/27/17,PHI,GSW,0,28,6,11,0.545,5,8,0.625,1,3,0.333,2,2,1,3,2,5,2,1,3,0,2,15,16.1
Wesley Matthews,30-164,G,3/27/17,DAL,OKC,1,37,5,13,0.385,3,4,0.75,2,9,0.222,3,3,1,0,4,4,4,1,0,2,2,15,10.1
Arron Afflalo,31-104,G,1/27/17,SAC,IND,1,34,6,9,0.667,3,4,0.75,3,5,0.6,0,0,,0,1,1,0,0,0,1,5,15,8.4
Cody Zeller,24-051,F-C,11/25/16,CHO,NYK,1,23,7,10,0.7,7,10,0.7,0,0,,1,4,0.25,2,4,6,2,0,0,1,3,15,11.4
John Wall,26-093,G,12/8/16,WAS,DEN,1,38,5,14,0.357,5,10,0.5,0,4,0,5,6,0.833,1,6,7,5,3,1,5,2,15,10.7
James Harden,27-110,G,12/14/16,HOU,SAC,1,30,4,7,0.571,1,1,1,3,6,0.5,4,4,1,0,11,11,14,1,0,5,0,15,20.8
Nicolas Batum,28-086,F-G,3/10/17,CHO,ORL,1,28,7,14,0.5,7,11,0.636,0,3,0,1,2,0.5,1,2,3,10,1,0,2,0,15,14.9
Ty Lawson,29-066,G,1/8/17,SAC,GSW,0,22,4,8,0.5,4,7,0.571,0,1,0,7,8,0.875,0,2,2,3,0,0,1,1,15,11.9
Steven Adams,23-190,C,1/26/17,OKC,DAL,1,37,5,7,0.714,5,7,0.714,0,0,,5,6,0.833,3,4,7,0,0,0,1,3,15,12.8
Elfrid Payton,22-249,G,10/28/16,ORL,DET,1,28,6,13,0.462,5,9,0.556,1,4,0.25,2,2,1,1,4,5,6,2,0,3,0,15,13.4
Nik Stauskas,23-185,G,4/10/17,PHI,IND,0,26,4,8,0.5,2,4,0.5,2,4,0.5,5,5,1,0,0,0,2,0,0,1,1,15,11
Serge Ibaka,27-159,F-C,2/24/17,TOR,BOS,1,36,7,12,0.583,6,9,0.667,1,3,0.333,0,0,,1,6,7,0,1,1,2,5,15,9.6
Robert Covington,26-075,F,2/27/17,PHI,GSW,1,35,6,12,0.5,4,5,0.8,2,7,0.286,1,2,0.5,1,7,8,2,4,0,3,3,15,12.6
Zach Randolph,35-113,F,11/6/16,MEM,POR,0,20,6,11,0.545,5,10,0.5,1,1,1,2,2,1,1,6,7,2,0,0,1,1,15,12.2
C.J. Miles,29-240,G-F,12/14/16,IND,MIA,0,22,5,10,0.5,2,4,0.5,3,6,0.5,2,2,1,0,2,2,0,0,0,1,1,15,9.2
Trevor Ariza,31-240,F,2/25/17,HOU,MIN,1,32,3,8,0.375,0,0,,3,8,0.375,6,6,1,2,1,3,3,1,0,1,1,15,14
Denzel Valentine,23-100,G,2/24/17,CHI,PHO,0,34,5,9,0.556,0,1,0,5,8,0.625,0,0,,0,5,5,5,3,0,2,1,15,16.3
Tarik Black,25-128,C-F,3/30/17,LAL,MIN,0,23,7,8,0.875,7,8,0.875,0,0,,1,1,1,5,4,9,0,0,2,0,1,15,17.9
Jabari Parker,21-295,F,1/4/17,MIL,NYK,1,37,4,10,0.4,3,7,0.429,1,3,0.333,6,8,0.75,0,4,4,3,1,0,1,2,15,11.3
Ty Lawson,29-062,G,1/4/17,SAC,MIA,0,29,7,11,0.636,6,10,0.6,1,1,1,0,0,,0,0,0,6,1,0,4,3,15,10.1
Jae Crowder,26-165,F,12/18/16,BOS,MIA,1,34,4,10,0.4,1,4,0.25,3,6,0.5,4,6,0.667,2,4,6,1,4,0,0,1,15,15.7
Yogi Ferrell,23-324,G,3/29/17,DAL,NOP,0,24,5,10,0.5,1,4,0.25,4,6,0.667,1,2,0.5,1,2,3,1,1,1,1,2,15,11.5
Marc Gasol,32-008,C,2/6/17,MEM,SAS,1,34,4,12,0.333,4,10,0.4,0,2,0,7,8,0.875,2,6,8,1,0,1,3,3,15,8.2
Trevor Booker,29-012,F,12/7/16,BRK,DEN,1,37,6,12,0.5,6,11,0.545,0,1,0,3,6,0.5,1,11,12,5,1,0,5,1,15,10.9
DeMarcus Cousins,26-205,C-F,3/6/17,NOP,UTA,1,38,5,15,0.333,4,11,0.364,1,4,0.25,4,4,1,0,8,8,3,1,0,4,2,15,7.2
Alan Williams,23-295,F-C,11/18/16,PHO,IND,0,26,6,7,0.857,6,7,0.857,0,0,,3,4,0.75,8,7,15,1,2,1,1,5,15,20.2
Marreese Speights,29-186,C-F,2/6/17,LAC,TOR,0,20,5,10,0.5,2,3,0.667,3,7,0.429,2,2,1,1,1,2,2,2,0,0,3,15,13.2
Chris Paul,31-321,G,3/23/17,LAC,DAL,1,35,6,13,0.462,5,8,0.625,1,5,0.2,2,2,1,2,4,6,6,3,0,4,3,15,12.9
Al Horford,30-292,C-F,3/22/17,BOS,IND,1,31,5,10,0.5,4,7,0.571,1,3,0.333,4,5,0.8,3,5,8,8,1,0,2,1,15,17.4
Victor Oladipo,24-272,G,1/31/17,OKC,SAS,1,32,5,12,0.417,4,9,0.444,1,3,0.333,4,4,1,1,3,4,1,4,1,1,0,15,14.6
Langston Galloway,25-116,G,4/4/17,SAC,DAL,1,37,5,10,0.5,3,6,0.5,2,4,0.5,3,4,0.75,1,6,7,1,0,0,4,0,15,8.8
Nick Young,31-164,G-F,11/12/16,LAL,NOP,1,20,5,9,0.556,0,1,0,5,8,0.625,0,0,,1,0,1,2,0,0,0,2,15,12
Steven Adams,23-219,C,2/24/17,OKC,LAL,1,31,7,13,0.538,7,13,0.538,0,0,,1,2,0.5,3,7,10,4,3,2,0,0,15,19.7
Rudy Gobert,24-228,C,2/9/17,UTA,DAL,1,36,5,9,0.556,5,9,0.556,0,0,,5,6,0.833,3,12,15,3,0,2,5,6,15,12.1
LaMarcus Aldridge,31-259,F-C,4/4/17,SAS,MEM,1,41,6,12,0.5,5,10,0.5,1,2,0.5,2,4,0.5,1,5,6,0,1,3,1,3,15,11.3
P.J. Tucker,31-261,F,1/21/17,PHO,NYK,0,36,6,10,0.6,4,5,0.8,2,5,0.4,1,2,0.5,1,2,3,2,3,0,3,2,15,11.9
DeMarcus Cousins,26-084,C-F,11/5/16,SAC,MIL,1,28,5,12,0.417,5,10,0.5,0,2,0,5,6,0.833,0,4,4,0,1,2,2,3,15,8.6
Brandon Knight,25-004,G,12/6/16,PHO,UTA,0,27,6,18,0.333,6,16,0.375,0,2,0,3,5,0.6,4,3,7,5,0,0,1,1,15,9.8
Kelly Oubre,21-005,F,12/14/16,WAS,CHO,1,40,7,12,0.583,6,8,0.75,1,4,0.25,0,1,0,0,4,4,1,2,0,1,2,15,11.1
T.J. Warren,23-195,F,3/19/17,PHO,DET,1,45,6,16,0.375,5,14,0.357,1,2,0.5,2,3,0.667,2,4,6,1,3,2,0,3,15,12.3
J.J. Redick,32-258,G,3/9/17,LAC,MEM,1,18,3,5,0.6,2,3,0.667,1,2,0.5,8,8,1,0,2,2,0,0,0,2,3,15,10.1
Ryan Anderson,28-229,F,12/21/16,HOU,PHO,1,28,5,10,0.5,2,3,0.667,3,7,0.429,2,2,1,1,4,5,0,0,1,1,2,15,10.8
Bojan Bogdanovic,27-314,G-F,2/26/17,WAS,UTA,0,33,5,10,0.5,2,4,0.5,3,6,0.5,2,2,1,0,1,1,1,1,1,2,3,15,9.5
Joffrey Lauvergne,25-184,C-F,4/2/17,CHI,NOP,0,22,5,7,0.714,2,3,0.667,3,4,0.75,2,2,1,2,3,5,2,0,0,2,3,15,12.6
Will Barton,26-053,G,2/28/17,DEN,CHI,0,29,7,15,0.467,6,10,0.6,1,5,0.2,0,0,,0,8,8,3,3,0,5,1,15,9.4
Paul George,26-301,F,2/27/17,IND,HOU,1,30,5,16,0.313,2,7,0.286,3,9,0.333,2,2,1,1,6,7,5,3,1,2,5,15,11.5
Tobias Harris,24-229,F,3/1/17,DET,NOP,0,27,6,10,0.6,5,8,0.625,1,2,0.5,2,5,0.4,0,6,6,2,1,0,0,1,15,13
Myles Turner,20-241,F-C,11/20/16,IND,OKC,1,38,2,8,0.25,2,7,0.286,0,1,0,11,12,0.917,2,7,9,0,1,2,1,4,15,13.1
Myles Turner,20-281,F-C,12/30/16,IND,CHI,1,29,5,10,0.5,5,10,0.5,0,0,,5,6,0.833,1,2,3,0,0,4,0,5,15,11.7
Ivica Zubac,19-329,C,2/10/17,LAL,MIL,0,21,7,11,0.636,7,11,0.636,0,0,,1,1,1,1,5,6,2,0,1,2,3,15,11.2
Danilo Gallinari,28-199,F,2/23/17,DEN,SAC,1,30,5,9,0.556,5,6,0.833,0,3,0,5,5,1,1,5,6,4,1,0,2,2,15,13.9
Tyreke Evans,27-147,G-F,2/13/17,NOP,PHO,0,25,6,11,0.545,6,8,0.75,0,3,0,3,5,0.6,0,4,4,4,1,0,3,3,15,9.7
George Hill,30-322,G,3/22/17,UTA,NYK,1,35,7,18,0.389,6,14,0.429,1,4,0.25,0,0,,0,7,7,4,1,0,4,1,15,6.7
Danilo Gallinari,28-079,F,10/26/16,DEN,NOP,1,38,5,11,0.455,2,5,0.4,3,6,0.5,2,4,0.5,0,3,3,2,3,1,1,2,15,12.7
Marreese Speights,29-148,C-F,12/30/16,LAC,HOU,0,20,6,11,0.545,4,8,0.5,2,3,0.667,1,1,1,2,5,7,0,0,2,1,3,15,11.8
Wesley Matthews,30-144,G,3/7/17,DAL,LAL,1,25,5,9,0.556,0,2,0,5,7,0.714,0,0,,0,2,2,2,0,0,0,2,15,11.9
Kemba Walker,26-215,G,12/9/16,CHO,ORL,1,25,7,13,0.538,6,10,0.6,1,3,0.333,0,0,,0,0,0,5,1,0,3,0,15,10.2
D.J. Augustin,29-064,G,1/13/17,ORL,POR,0,17,4,7,0.571,3,5,0.6,1,2,0.5,6,6,1,0,1,1,2,0,0,0,0,15,13.4
Luol Deng,31-245,F,12/17/16,LAL,CLE,1,34,6,11,0.545,3,4,0.75,3,7,0.429,0,0,,2,6,8,3,1,0,1,0,15,15
Deron Williams,32-162,G,12/5/16,DAL,CHO,1,37,6,18,0.333,4,10,0.4,2,8,0.25,1,1,1,0,1,1,13,0,0,2,2,15,11.4
Jared Dudley,31-266,F-G,4/2/17,PHO,HOU,0,34,4,14,0.286,1,3,0.333,3,11,0.273,4,4,1,2,7,9,1,2,0,1,1,15,11.6
Shabazz Muhammad,24-124,F-G,3/17/17,MIN,MIA,0,28,7,10,0.7,7,7,1,0,3,0,1,1,1,0,1,1,2,0,0,1,3,15,10.3
Tyler Ulis,21-082,G,3/28/17,PHO,ATL,1,40,6,16,0.375,5,11,0.455,1,5,0.2,2,2,1,2,4,6,10,1,0,1,2,15,15
Tyreke Evans,27-138,G-F,2/4/17,NOP,WAS,0,27,6,16,0.375,4,13,0.308,2,3,0.667,1,2,0.5,1,5,6,2,1,0,4,2,15,5.6
Pat Connaughton,24-094,G,4/10/17,POR,SAS,1,35,6,10,0.6,3,6,0.5,3,4,0.75,0,0,,0,4,4,3,1,0,1,1,15,13.3
Robert Covington,26-038,F,1/21/17,PHI,ATL,1,31,5,12,0.417,2,6,0.333,3,6,0.5,2,2,1,2,8,10,2,1,1,2,2,15,12.7
Matt Barnes,36-343,F,2/15/17,SAC,GSW,0,32,5,12,0.417,4,7,0.571,1,5,0.2,4,4,1,3,11,14,3,1,0,1,2,15,15.3
Elfrid Payton,23-028,G,3/22/17,ORL,CHO,1,34,6,9,0.667,5,8,0.625,1,1,1,2,2,1,3,2,5,5,0,0,3,4,15,12.7
George Hill,30-305,G,3/5/17,UTA,SAC,1,40,4,14,0.286,2,8,0.25,2,6,0.333,5,8,0.625,1,4,5,8,1,0,1,3,15,11.9
John Wall,26-208,G,4/2/17,WAS,GSW,1,27,4,11,0.364,4,10,0.4,0,1,0,7,8,0.875,0,4,4,11,1,0,3,0,15,15.4
Al Jefferson,31-338,C-F,12/7/16,IND,PHO,0,19,5,7,0.714,5,7,0.714,0,0,,5,8,0.625,3,3,6,0,2,0,0,3,15,14.7
Nerlens Noel,22-327,C-F,3/3/17,DAL,MEM,1,35,6,10,0.6,6,10,0.6,0,0,,3,6,0.5,4,13,17,2,1,2,0,3,15,18.5
Sam Dekker,22-264,F,1/25/17,HOU,BOS,0,29,7,14,0.5,6,9,0.667,1,5,0.2,0,0,,0,4,4,0,1,1,0,2,15,10.1
C.J. Miles,29-347,G-F,3/31/17,IND,TOR,0,27,5,14,0.357,2,8,0.25,3,6,0.5,2,2,1,1,2,3,0,1,0,0,2,15,8.7
Kent Bazemore,27-253,G-F,3/11/17,ATL,MEM,1,26,6,10,0.6,3,3,1,3,7,0.429,0,0,,1,1,2,0,0,0,1,0,15,10.4
Jonas Valanciunas,24-296,C,2/26/17,TOR,POR,1,22,7,8,0.875,7,8,0.875,0,0,,1,2,0.5,2,5,7,1,0,0,1,2,15,13.6
Myles Turner,20-279,F-C,12/28/16,IND,WAS,1,34,6,9,0.667,6,8,0.75,0,1,0,3,3,1,0,8,8,0,0,3,4,4,15,10
Clint Capela,22-301,F-C,3/15/17,HOU,LAL,1,21,5,7,0.714,5,7,0.714,0,0,,5,8,0.625,3,7,10,2,0,0,2,2,15,13.7
Shawn Long,24-056,C-F,3/26/17,PHI,IND,0,23,7,13,0.538,7,12,0.583,0,1,0,1,3,0.333,5,5,10,1,1,0,1,3,15,12.4
Rodney Hood,24-008,G-F,10/28/16,UTA,LAL,1,32,5,14,0.357,3,6,0.5,2,8,0.25,3,5,0.6,0,6,6,1,1,0,1,4,15,7.3
Ian Mahinmi,30-122,C,3/7/17,WAS,PHO,0,26,5,8,0.625,5,8,0.625,0,0,,5,8,0.625,2,7,9,1,7,1,1,2,15,20.3
LaMarcus Aldridge,31-204,F-C,2/8/17,SAS,PHI,1,36,5,10,0.5,5,9,0.556,0,1,0,5,6,0.833,2,8,10,0,0,2,2,2,15,12
Jamal Crawford,36-221,G,10/27/16,LAC,POR,0,26,3,12,0.25,2,6,0.333,1,6,0.167,8,8,1,0,3,3,1,4,0,1,2,15,11.6
Zach Randolph,35-111,F,11/4/16,MEM,LAC,0,28,6,11,0.545,6,10,0.6,0,1,0,3,5,0.6,1,8,9,2,0,0,4,2,15,8.6
Kelly Olynyk,25-300,C-F,2/13/17,BOS,DAL,0,29,6,10,0.6,5,7,0.714,1,3,0.333,2,2,1,2,5,7,2,0,0,2,4,15,11.1
Channing Frye,33-296,C-F,3/9/17,CLE,DET,0,22,5,7,0.714,0,0,,5,7,0.714,0,0,,0,9,9,0,1,0,0,2,15,15
Troy Williams,22-101,F,4/10/17,HOU,LAC,0,24,5,10,0.5,4,6,0.667,1,4,0.25,4,4,1,2,3,5,1,0,1,3,3,15,9.5
Frank Kaminsky,23-271,F-C,12/31/16,CHO,CLE,0,30,5,9,0.556,4,5,0.8,1,4,0.25,4,4,1,1,4,5,0,0,0,0,2,15,11.8
Gary Harris,22-167,G,2/28/17,DEN,CHI,1,36,7,12,0.583,6,7,0.857,1,5,0.2,0,0,,2,2,4,4,2,0,0,1,15,15.8
Richaun Holmes,23-179,F-C,4/12/17,PHI,NYK,1,33,7,11,0.636,7,9,0.778,0,2,0,1,1,1,2,5,7,0,1,1,0,2,15,13.9
Jordan Clarkson,24-308,G,4/11/17,LAL,NOP,1,25,5,8,0.625,2,3,0.667,3,5,0.6,2,2,1,0,3,3,3,1,0,2,1,15,13
Courtney Lee,31-160,G,3/12/17,NYK,BRK,1,39,5,10,0.5,3,6,0.5,2,4,0.5,3,4,0.75,1,1,2,1,1,0,0,3,15,11.1
Otto Porter,23-182,F,12/2/16,WAS,SAS,1,37,6,10,0.6,5,7,0.714,1,3,0.333,2,2,1,0,12,12,2,4,0,3,1,15,16
Marcus Morris,27-064,F,11/5/16,DET,DEN,1,28,5,10,0.5,4,8,0.5,1,2,0.5,4,4,1,3,3,6,0,1,0,0,4,15,12.4
Carmelo Anthony,32-248,F,2/1/17,NYK,BRK,1,27,6,22,0.273,5,16,0.313,1,6,0.167,2,3,0.667,2,1,3,0,1,0,3,1,15,0.9
Julius Randle,21-345,F,11/8/16,LAL,DAL,1,31,6,12,0.5,6,12,0.5,0,0,,3,4,0.75,5,5,10,1,1,0,6,4,15,7.7
Seth Curry,26-167,G,2/6/17,DAL,DEN,1,34,6,15,0.4,3,8,0.375,3,7,0.429,0,0,,0,2,2,1,0,0,1,4,15,5.6
Luis Scola,36-224,F,12/10/16,BRK,SAS,0,16,5,9,0.556,4,8,0.5,1,1,1,4,5,0.8,4,7,11,1,0,0,2,3,15,12.7
David West,36-212,F,3/29/17,GSW,SAS,0,22,7,11,0.636,6,9,0.667,1,2,0.5,0,0,,2,2,4,5,0,2,1,0,15,16
Willy Hernangomez,22-249,C,1/31/17,NYK,WAS,1,32,5,12,0.417,5,12,0.417,0,0,,5,5,1,6,8,14,4,0,0,1,4,15,15.4
Isaiah Canaan,25-163,G,10/31/16,CHI,BRK,0,22,5,7,0.714,2,3,0.667,3,4,0.75,2,2,1,1,2,3,6,1,0,0,2,15,17.8
Giannis Antetokounmpo,22-001,F-G,12/7/16,MIL,POR,1,40,4,11,0.364,4,8,0.5,0,3,0,7,10,0.7,2,10,12,11,2,4,3,3,15,20.4
Nikola Mirotic,26-041,F,3/24/17,CHI,PHI,1,27,5,11,0.455,1,5,0.2,4,6,0.667,1,2,0.5,3,1,4,2,0,0,2,2,15,9.9
Rodney McGruder,25-192,G,2/6/17,MIA,MIN,1,39,6,8,0.75,3,4,0.75,3,4,0.75,0,0,,4,1,5,4,1,0,0,1,15,18.3
Nikola Mirotic,26-034,F,3/17/17,CHI,WAS,0,32,6,16,0.375,4,8,0.5,2,8,0.25,1,2,0.5,1,7,8,3,1,3,0,2,15,13
Tony Allen,35-061,G-F,3/13/17,MEM,MIL,1,30,6,10,0.6,4,8,0.5,2,2,1,1,3,0.333,1,3,4,1,0,0,2,2,15,9.1
Gary Harris,22-111,G,1/3/17,DEN,SAC,1,32,6,11,0.545,3,7,0.429,3,4,0.75,0,0,,1,0,1,3,1,0,0,0,15,13.5
Taj Gibson,31-204,F,1/14/17,CHI,NOP,1,32,7,14,0.5,7,12,0.583,0,2,0,1,4,0.25,4,11,15,1,0,2,3,2,15,11.2
Pau Gasol,36-152,F-C,12/5/16,SAS,MIL,1,27,6,9,0.667,4,7,0.571,2,2,1,1,1,1,2,7,9,1,0,1,2,1,15,13.6
C.J. Miles,29-254,G-F,12/28/16,IND,WAS,0,25,4,12,0.333,0,4,0,4,8,0.5,3,3,1,0,3,3,1,0,0,1,3,15,7.6
T.J. Warren,23-125,F,1/8/17,PHO,CLE,1,27,7,9,0.778,6,7,0.857,1,2,0.5,0,0,,1,2,3,2,3,0,1,2,15,15.4
Dwight Howard,31-030,C,1/7/17,ATL,DAL,1,31,4,10,0.4,4,10,0.4,0,0,,7,9,0.778,3,17,20,0,1,0,1,1,15,15.6
Goran Dragic,30-301,G,3/3/17,MIA,ORL,1,34,3,14,0.214,3,11,0.273,0,3,0,9,11,0.818,2,2,4,5,2,0,1,3,15,10.9
Joe Harris,25-083,G,11/29/16,BRK,LAC,0,39,5,9,0.556,3,5,0.6,2,4,0.5,3,5,0.6,1,0,1,1,3,0,2,3,15,11.1
Steven Adams,23-160,C,12/27/16,OKC,MIA,1,23,7,10,0.7,7,10,0.7,0,0,,1,1,1,6,2,8,1,0,2,4,5,15,11.7
Ty Lawson,29-050,G,12/23/16,SAC,MIN,0,28,5,11,0.455,3,8,0.375,2,3,0.667,3,4,0.75,0,3,3,4,2,0,1,1,15,13.2
Nick Young,31-172,G-F,11/20/16,LAL,CHI,1,30,5,13,0.385,2,5,0.4,3,8,0.375,2,2,1,1,5,6,2,0,0,1,2,15,9.7
T.J. Warren,23-133,F,1/16/17,PHO,UTA,1,31,5,7,0.714,4,6,0.667,1,1,1,4,4,1,0,1,1,1,1,0,0,3,15,12.9
Draymond Green,26-304,F,1/2/17,GSW,DEN,1,36,5,8,0.625,4,6,0.667,1,2,0.5,4,6,0.667,3,7,10,13,0,0,5,3,15,17.7
Alan Williams,24-038,F-C,3/7/17,PHO,WAS,0,24,5,9,0.556,5,9,0.556,0,0,,5,9,0.556,3,7,10,0,0,0,0,6,15,10.9
Bradley Beal,23-127,G,11/2/16,WAS,TOR,1,39,5,13,0.385,3,9,0.333,2,4,0.5,3,6,0.5,0,1,1,2,0,2,1,2,15,8
Allen Crabbe,24-220,G-F,11/15/16,POR,CHI,0,33,6,12,0.5,3,5,0.6,3,7,0.429,0,0,,1,3,4,1,1,1,0,1,15,12.6
Jeff Green,30-190,F,3/6/17,ORL,NYK,0,20,5,10,0.5,4,6,0.667,1,4,0.25,4,4,1,0,1,1,0,0,1,2,3,15,7.8
John Henson,26-038,C-F,2/4/17,MIL,PHO,1,25,6,8,0.75,6,8,0.75,0,0,,3,5,0.6,2,5,7,1,1,1,3,4,15,11.7
Terry Rozier,22-310,G,1/21/17,BOS,POR,0,22,6,13,0.462,3,7,0.429,3,6,0.5,0,0,,0,3,3,3,0,0,1,4,15,8.7
Sean Kilpatrick,27-083,G,3/30/17,BRK,DET,0,23,6,12,0.5,5,8,0.625,1,4,0.25,2,3,0.667,0,2,2,1,0,0,0,1,15,9.5
E'Twaun Moore,27-271,G,11/25/16,NOP,POR,1,23,6,11,0.545,3,8,0.375,3,3,1,0,2,0,0,1,1,4,0,0,1,4,15,9.4
Cory Joseph,25-202,G,3/10/17,TOR,ATL,1,35,6,11,0.545,5,8,0.625,1,3,0.333,2,2,1,2,0,2,8,4,0,1,3,15,18.5
Willy Hernangomez,22-304,C,3/27/17,NYK,DET,1,27,6,9,0.667,6,9,0.667,0,0,,3,4,0.75,2,3,5,2,1,0,0,2,15,14.6
Emmanuel Mudiay,20-256,G,11/16/16,DEN,PHO,1,38,7,17,0.412,7,15,0.467,0,2,0,1,1,1,2,3,5,6,2,0,0,1,15,14
Michael Beasley,28-093,F,4/12/17,MIL,BOS,1,35,7,17,0.412,7,14,0.5,0,3,0,1,1,1,1,4,5,2,3,2,1,2,15,11.8
Tristan Thompson,25-235,F-C,11/3/16,CLE,BOS,1,31,6,7,0.857,6,7,0.857,0,0,,3,4,0.75,4,10,14,1,1,3,0,1,15,21.3
Tyler Johnson,24-172,G,10/26/16,MIA,ORL,0,28,7,11,0.636,7,10,0.7,0,1,0,1,1,1,1,5,6,3,2,0,1,2,15,14.6
Harrison Barnes,24-247,F,2/1/17,DAL,PHI,1,32,6,13,0.462,5,10,0.5,1,3,0.333,2,2,1,2,5,7,1,2,0,1,2,15,12.1
Zach Randolph,35-183,F,1/15/17,MEM,CHI,0,33,7,19,0.368,6,18,0.333,1,1,1,0,0,,8,8,16,2,0,0,1,3,15,11.7
Sheldon McClellan,23-327,G,11/12/16,WAS,CHI,1,35,5,9,0.556,4,8,0.5,1,1,1,4,5,0.8,1,1,2,1,0,0,0,2,15,11.2
Dion Waiters,24-351,G,11/25/16,MIA,MEM,1,35,6,15,0.4,5,11,0.455,1,4,0.25,2,2,1,1,3,4,4,3,0,2,1,15,11.9
Ish Smith,28-265,G,3/27/17,DET,NYK,1,35,6,14,0.429,4,11,0.364,2,3,0.667,1,2,0.5,0,6,6,5,1,0,1,1,15,12.1
LaMarcus Aldridge,31-220,F-C,2/24/17,SAS,LAC,1,34,5,15,0.333,4,14,0.286,1,1,1,4,4,1,2,9,11,1,1,1,2,5,15,9
Klay Thompson,26-297,G,12/1/16,GSW,HOU,1,47,4,20,0.2,1,7,0.143,3,13,0.231,4,6,0.667,0,6,6,3,0,0,2,1,15,3.3
Al Horford,30-294,C-F,3/24/17,BOS,PHO,1,30,7,10,0.7,7,9,0.778,0,1,0,1,2,0.5,3,7,10,6,2,0,2,2,15,18
Marreese Speights,29-084,C-F,10/27/16,LAC,POR,0,16,4,8,0.5,2,5,0.4,2,3,0.667,5,7,0.714,2,0,2,0,0,0,0,3,15,10.4
John Wall,26-085,G,11/30/16,WAS,OKC,1,44,6,20,0.3,4,13,0.308,2,7,0.286,1,2,0.5,3,3,6,15,1,1,3,1,15,14.8
Cory Joseph,25-131,G,12/29/16,TOR,PHO,0,25,6,10,0.6,4,8,0.5,2,2,1,1,2,0.5,1,5,6,1,0,0,3,3,15,8.7
Patrick Beverley,28-171,G,12/30/16,HOU,LAC,1,33,5,9,0.556,3,5,0.6,2,4,0.5,3,3,1,2,5,7,3,1,0,0,4,15,15.1
Montrezl Harrell,23-014,F-C,2/9/17,HOU,CHO,0,22,7,10,0.7,7,10,0.7,0,0,,1,1,1,2,2,4,1,1,0,2,3,15,11.3
Kyle Korver,35-352,G-F,3/4/17,CLE,MIA,1,27,5,12,0.417,0,3,0,5,9,0.556,0,0,,0,1,1,2,0,0,0,2,15,9.5
Andrew Wiggins,21-304,F-G,12/23/16,MIN,SAC,1,40,6,19,0.316,6,13,0.462,0,6,0,3,4,0.75,0,0,0,1,0,1,2,1,15,2.7
Nikola Jokic,21-362,C-F,2/15/17,DEN,MIN,1,34,6,19,0.316,4,14,0.286,2,5,0.4,1,2,0.5,4,10,14,4,1,3,2,5,15,11.4
Larry Nance Jr.,24-094,F,4/5/17,LAL,SAS,1,21,6,9,0.667,5,8,0.625,1,1,1,2,2,1,2,7,9,0,1,2,0,0,15,17
Ish Smith,28-211,G,2/1/17,DET,NOP,0,27,6,7,0.857,5,5,1,1,2,0.5,2,4,0.5,0,3,3,7,0,0,2,0,15,15.5
Andre Drummond,23-158,C,1/15/17,DET,LAL,1,32,6,17,0.353,5,16,0.313,1,1,1,2,5,0.4,3,14,17,2,3,1,2,4,15,12.1
Brandon Knight,24-359,G,11/25/16,PHO,MIN,1,28,5,12,0.417,4,7,0.571,1,5,0.2,4,4,1,1,3,4,1,1,0,0,2,15,11.1
Jonas Valanciunas,24-201,C,11/23/16,TOR,HOU,1,31,6,10,0.6,6,10,0.6,0,0,,3,4,0.75,5,11,16,2,0,1,5,2,15,13.1
Ricky Rubio,26-165,G,4/4/17,MIN,GSW,1,30,6,17,0.353,6,11,0.545,0,6,0,3,3,1,2,3,5,5,1,0,2,3,15,9.1
Mirza Teletovic,31-200,F,4/6/17,MIL,IND,0,27,5,8,0.625,0,0,,5,8,0.625,0,0,,0,3,3,0,1,1,1,1,15,12.6
Goran Dragic,30-217,G,12/9/16,MIA,CLE,1,34,4,10,0.4,2,6,0.333,2,4,0.5,5,6,0.833,1,2,3,4,0,1,4,2,15,9.2
Michael Beasley,28-032,F,2/10/17,MIL,LAL,0,23,6,9,0.667,5,6,0.833,1,3,0.333,2,3,0.667,1,4,5,2,0,1,3,3,15,10.5
Matthew Dellavedova,26-176,G,3/3/17,MIL,LAC,0,36,6,9,0.667,5,6,0.833,1,3,0.333,2,2,1,1,0,1,8,0,0,3,5,15,12.4
Luc Mbah a Moute,30-213,F,4/10/17,LAC,HOU,1,24,6,8,0.75,5,7,0.714,1,1,1,2,2,1,1,1,2,3,2,0,0,2,15,16.1
Devin Booker,20-123,G,3/2/17,PHO,CHO,1,30,5,12,0.417,4,8,0.5,1,4,0.25,4,5,0.8,0,6,6,9,0,0,5,3,15,10.1
Jamal Crawford,37-001,G,3/21/17,LAC,LAL,0,30,6,10,0.6,3,4,0.75,3,6,0.5,0,0,,0,2,2,3,1,0,1,2,15,12.3
Monta Ellis,31-017,G,11/12/16,IND,BOS,1,34,5,10,0.5,4,7,0.571,1,3,0.333,4,7,0.571,0,4,4,4,1,1,3,4,15,9.9
Derrick Rose,28-092,G,1/4/17,NYK,MIL,1,33,7,18,0.389,6,16,0.375,1,2,0.5,0,0,,0,3,3,4,1,0,5,0,15,4.9
P.J. Tucker,31-232,F,12/23/16,PHO,PHI,1,35,5,7,0.714,2,3,0.667,3,4,0.75,2,2,1,1,5,6,0,4,1,0,2,15,18.2
C.J. Miles,29-336,G-F,3/20/17,IND,UTA,1,23,4,6,0.667,1,3,0.333,3,3,1,4,4,1,1,1,2,0,3,0,0,2,15,15.6
LaMarcus Aldridge,31-172,F-C,1/7/17,SAS,CHO,1,34,5,9,0.556,5,8,0.625,0,1,0,5,6,0.833,5,6,11,3,0,1,0,2,15,17.6
Will Barton,26-035,G,2/10/17,DEN,NYK,0,34,6,15,0.4,5,11,0.455,1,4,0.25,2,4,0.5,6,4,10,4,0,2,2,2,15,12.9
Timofey Mozgov,30-176,C,1/8/17,LAL,ORL,1,30,7,7,1,7,7,1,0,0,,1,1,1,2,7,9,2,1,0,0,4,15,17.2
Jonas Valanciunas,24-199,C,11/21/16,TOR,LAC,1,29,5,8,0.625,5,8,0.625,0,0,,5,5,1,2,6,8,1,0,1,0,4,15,14.4
Andre Drummond,23-098,C,11/16/16,DET,NYK,1,29,7,13,0.538,7,13,0.538,0,0,,1,2,0.5,1,8,9,1,0,1,3,4,15,8.2
Tobias Harris,24-237,F,3/9/17,DET,CLE,1,41,5,18,0.278,5,15,0.333,0,3,0,5,6,0.833,3,6,9,2,0,1,0,1,15,9.6
Nicolas Batum,28-044,F-G,1/27/17,CHO,NYK,1,36,5,12,0.417,2,6,0.333,3,6,0.5,2,2,1,2,9,11,9,1,0,5,2,15,14.2
Davis Bertans,24-013,F,11/25/16,SAS,BOS,0,23,6,8,0.75,3,3,1,3,5,0.6,0,0,,0,2,2,0,1,0,0,0,15,13.4
James Johnson,30-005,F,2/25/17,MIA,IND,0,29,6,14,0.429,4,9,0.444,2,5,0.4,1,3,0.333,1,6,7,8,2,2,5,4,15,11.7
Jeff Teague,28-304,G,4/10/17,IND,PHI,1,33,4,8,0.5,4,6,0.667,0,2,0,7,8,0.875,0,2,2,6,1,0,3,3,15,12.2
Trevor Ariza,31-279,F,4/5/17,HOU,DEN,1,38,6,12,0.5,3,6,0.5,3,6,0.5,0,0,,1,9,10,1,1,0,2,3,15,10.9
Garrett Temple,30-315,G,3/19/17,SAC,SAS,1,26,6,9,0.667,3,6,0.5,3,3,1,0,1,0,0,1,1,4,0,0,2,1,15,11.4
Jason Smith,30-343,F-C,2/8/17,WAS,BRK,0,23,5,9,0.556,4,7,0.571,1,2,0.5,4,7,0.571,3,5,8,0,1,0,0,2,15,13.3
Joffrey Lauvergne,25-056,C-F,11/25/16,OKC,DEN,0,18,6,8,0.75,3,4,0.75,3,4,0.75,0,0,,1,3,4,0,1,1,0,2,15,14.3
Thabo Sefolosha,32-231,G-F,12/19/16,ATL,OKC,1,34,6,10,0.6,5,7,0.714,1,3,0.333,2,2,1,0,6,6,1,1,0,1,2,15,12.1
Tyson Chandler,34-118,C,1/28/17,PHO,DEN,1,40,6,8,0.75,6,8,0.75,0,0,,3,4,0.75,2,10,12,0,2,0,1,3,15,15.6
John Wall,26-160,G,2/13/17,WAS,OKC,1,30,4,10,0.4,3,8,0.375,1,2,0.5,6,7,0.857,0,5,5,14,1,2,5,1,15,17.5
Dwight Howard,31-110,C,3/28/17,ATL,PHO,1,36,6,8,0.75,6,8,0.75,0,0,,3,5,0.6,2,9,11,4,1,4,3,4,15,17.1
Tristan Thompson,26-017,F-C,3/30/17,CLE,CHI,1,36,7,10,0.7,7,10,0.7,0,0,,1,3,0.333,2,7,9,0,1,0,2,3,15,11.3
George Hill,30-300,G,2/28/17,UTA,OKC,1,38,6,15,0.4,6,11,0.545,0,4,0,3,3,1,0,2,2,8,2,1,2,2,15,13
Victor Oladipo,24-327,G,3/27/17,OKC,DAL,1,37,6,15,0.4,3,9,0.333,3,6,0.5,0,0,,1,9,10,2,1,1,2,3,15,10.2
J.J. Barea,32-203,G,1/15/17,DAL,MIN,0,17,5,5,1,4,4,1,1,1,1,4,5,0.8,1,2,3,3,0,0,2,0,15,14.5
Andre Drummond,23-118,C,12/6/16,DET,CHI,1,25,7,13,0.538,7,13,0.538,0,0,,1,4,0.25,3,7,10,0,1,3,0,3,15,13.6
D'Angelo Russell,20-310,G,12/29/16,LAL,DAL,1,31,5,15,0.333,4,10,0.4,1,5,0.2,4,4,1,0,4,4,6,2,0,3,3,15,9.7
Tim Frazier,25-360,G,10/26/16,NOP,DEN,1,37,6,10,0.6,5,7,0.714,1,3,0.333,2,4,0.5,0,5,5,11,4,0,1,6,15,19.4
Tristan Thompson,25-247,F-C,11/15/16,CLE,TOR,1,30,7,8,0.875,7,8,0.875,0,0,,1,1,1,3,8,11,0,0,1,1,2,15,15.6
DeMarre Carroll,30-200,F,2/12/17,TOR,DET,1,36,6,9,0.667,4,5,0.8,2,4,0.5,1,4,0.25,0,2,2,3,1,0,1,1,15,12.2
Meyers Leonard,24-272,C-F,11/25/16,POR,NOP,0,22,6,11,0.545,3,5,0.6,3,6,0.5,0,0,,1,8,9,2,0,1,1,4,15,12.3
Tony Allen,34-332,G-F,12/8/16,MEM,POR,1,29,6,10,0.6,6,10,0.6,0,0,,3,5,0.6,5,5,10,1,2,0,0,2,15,16.5
Dante Cunningham,29-341,F,3/29/17,NOP,DAL,0,20,6,8,0.75,3,3,1,3,5,0.6,0,2,0,2,0,2,0,2,0,0,2,15,13.6
Dwight Powell,25-138,F-C,12/5/16,DAL,CHO,0,32,7,11,0.636,7,11,0.636,0,0,,1,3,0.333,4,3,7,0,0,1,0,2,15,12.9
K.J. McDaniels,24-062,G-F,4/12/17,BRK,CHI,0,26,5,13,0.385,4,7,0.571,1,6,0.167,4,4,1,0,6,6,0,0,1,1,0,15,9.4
Tobias Harris,24-133,F,11/25/16,DET,LAC,1,29,7,11,0.636,6,8,0.75,1,3,0.333,0,0,,0,3,3,3,0,0,0,2,15,12.3
Johnny O'Bryant,23-276,F-C,3/4/17,CHO,DEN,0,15,7,9,0.778,6,7,0.857,1,2,0.5,0,0,,3,3,6,1,0,0,0,3,15,14
Jeremy Lamb,24-217,G-F,1/2/17,CHO,CHI,0,27,4,7,0.571,3,4,0.75,1,3,0.333,6,7,0.857,0,6,6,3,1,0,1,2,15,14.4
Tobias Harris,24-199,F,1/30/17,DET,BOS,0,30,7,14,0.5,7,10,0.7,0,4,0,1,2,0.5,0,4,4,0,0,1,0,1,15,9.1
Austin Rivers,24-166,G,1/14/17,LAC,LAL,1,31,7,14,0.5,6,9,0.667,1,5,0.2,0,0,,0,1,1,2,2,1,1,1,15,11
Sean Kilpatrick,27-038,G,2/13/17,BRK,MEM,0,25,6,15,0.4,3,6,0.5,3,9,0.333,0,0,,1,5,6,3,1,0,1,1,15,10.8
Domantas Sabonis,20-188,F,11/7/16,OKC,MIA,1,30,5,13,0.385,1,6,0.167,4,7,0.571,1,2,0.5,0,10,10,1,0,0,1,4,15,8.6
Rondae Hollis-Jefferson,22-052,F,2/24/17,BRK,DEN,1,26,7,11,0.636,6,9,0.667,1,2,0.5,0,2,0,3,5,8,4,1,0,5,4,15,10.1
Devin Booker,20-003,G,11/2/16,PHO,POR,1,39,6,15,0.4,5,13,0.385,1,2,0.5,2,4,0.5,0,3,3,2,2,0,2,3,15,7.2
Hassan Whiteside,27-209,C,1/8/17,MIA,LAC,1,31,7,12,0.583,7,12,0.583,0,0,,1,2,0.5,5,8,13,0,0,2,2,2,15,13.5
Devin Booker,20-040,G,12/9/16,PHO,LAL,1,28,6,17,0.353,5,11,0.455,1,6,0.167,2,2,1,1,2,3,4,0,0,2,6,15,5.2
Joel Embiid,22-275,C-F,12/16/16,PHI,LAL,1,29,5,14,0.357,3,10,0.3,2,4,0.5,3,8,0.375,2,2,4,2,0,2,3,2,15,6.2
Trevor Ariza,31-135,F,11/12/16,HOU,SAS,1,37,5,13,0.385,1,2,0.5,4,11,0.364,1,2,0.5,1,3,4,2,3,0,1,0,15,12.5
Trevor Booker,29-004,F,11/29/16,BRK,LAC,1,42,7,13,0.538,7,11,0.636,0,2,0,1,1,1,2,9,11,5,4,0,2,4,15,16.7
Jahlil Okafor,20-342,C-F,11/21/16,PHI,MIA,0,25,7,13,0.538,7,13,0.538,0,0,,1,3,0.333,1,2,3,1,0,1,0,3,15,9.4
Michael Kidd-Gilchrist,23-121,F,1/25/17,CHO,GSW,1,35,7,12,0.583,7,12,0.583,0,0,,1,1,1,5,4,9,0,1,2,0,4,15,14.9
Kyle Korver,35-226,G-F,10/29/16,ATL,PHI,1,24,6,8,0.75,3,4,0.75,3,4,0.75,0,0,,0,2,2,3,2,0,2,0,15,14.5
Julius Randle,22-033,F,1/1/17,LAL,TOR,1,36,3,10,0.3,3,10,0.3,0,0,,9,10,0.9,3,6,9,6,3,2,2,4,15,17.7
Chris Paul,31-180,G,11/2/16,LAC,OKC,1,33,4,11,0.364,2,7,0.286,2,4,0.5,5,6,0.833,1,10,11,9,6,0,5,1,15,19.1
Tobias Harris,24-147,F,12/9/16,DET,MIN,1,25,5,8,0.625,2,5,0.4,3,3,1,2,3,0.667,0,0,0,1,1,0,0,3,15,11.5
Frank Kaminsky,23-229,F-C,11/19/16,CHO,NOP,0,36,6,12,0.5,3,4,0.75,3,8,0.375,0,0,,1,4,5,3,1,0,1,4,15,11.4
Shabazz Muhammad,24-065,F-G,1/17/17,MIN,SAS,0,23,4,6,0.667,2,3,0.667,2,3,0.667,5,5,1,1,3,4,0,0,0,2,3,15,10.8
Juan Hernangomez,21-173,F,3/20/17,DEN,HOU,1,33,6,11,0.545,5,6,0.833,1,5,0.2,2,2,1,1,4,5,1,1,0,0,2,15,12.5
Ersan Ilyasova,29-210,F,12/11/16,PHI,DET,1,34,6,12,0.5,4,7,0.571,2,5,0.4,1,1,1,1,7,8,0,2,0,4,0,15,9.8
Buddy Hield,23-019,G,1/5/17,NOP,ATL,1,31,5,16,0.313,1,7,0.143,4,9,0.444,1,1,1,2,5,7,4,1,0,0,2,15,11.7
Matthew Dellavedova,26-174,G,3/1/17,MIL,DEN,0,23,7,9,0.778,6,7,0.857,1,2,0.5,0,0,,0,0,0,4,1,0,2,2,15,12.5
Jae Crowder,26-169,F,12/22/16,BOS,IND,1,35,5,9,0.556,2,4,0.5,3,5,0.6,2,2,1,1,5,6,2,1,0,3,2,15,11.5
Jonas Valanciunas,24-196,C,11/18/16,TOR,DEN,1,37,6,9,0.667,6,9,0.667,0,0,,3,7,0.429,2,7,9,1,0,1,0,4,15,12.8
Andre Iguodala,33-049,G-F,3/18/17,GSW,MIL,0,30,6,10,0.6,5,7,0.714,1,3,0.333,2,2,1,0,4,4,4,1,2,2,1,15,14.4
Doug McDermott,24-355,F,12/23/16,CHI,CHO,0,33,5,12,0.417,2,5,0.4,3,7,0.429,2,2,1,0,4,4,1,0,0,1,3,15,8.3
Tony Allen,35-030,G-F,2/10/17,MEM,GSW,1,28,5,12,0.417,5,12,0.417,0,0,,5,7,0.714,4,5,9,1,1,1,1,3,15,12.3
Alexis Ajinca,28-336,C,4/7/17,NOP,DEN,0,28,7,10,0.7,7,9,0.778,0,1,0,1,1,1,4,3,7,0,1,1,1,4,15,13.6
J.J. Redick,32-163,G,12/4/16,LAC,IND,1,31,5,15,0.333,0,4,0,5,11,0.455,0,0,,0,3,3,1,0,0,2,5,15,4.1
Avery Bradley,26-133,G,4/8/17,BOS,CHO,1,34,6,14,0.429,3,7,0.429,3,7,0.429,0,0,,2,4,6,4,0,1,1,5,15,10.7
Markieff Morris,27-157,F,2/6/17,WAS,CLE,1,30,6,12,0.5,6,10,0.6,0,2,0,3,4,0.75,1,5,6,2,1,0,2,6,15,8.8
E'Twaun Moore,27-278,G,12/2/16,NOP,LAC,0,19,7,12,0.583,6,9,0.667,1,3,0.333,0,0,,1,3,4,2,0,1,1,1,15,11.7
Trevor Ariza,31-130,F,11/7/16,HOU,WAS,1,34,5,11,0.455,1,2,0.5,4,9,0.444,1,1,1,0,5,5,2,3,0,2,1,15,12.8
D'Angelo Russell,21-029,G,3/24/17,LAL,MIN,1,40,3,9,0.333,1,4,0.25,2,5,0.4,7,8,0.875,0,3,3,6,2,0,2,2,15,13.8
Langston Galloway,24-343,G,11/16/16,NOP,ORL,0,21,6,12,0.5,3,4,0.75,3,8,0.375,0,1,0,1,1,2,2,1,0,0,3,15,10.8
Anthony Morrow,31-069,G,12/5/16,OKC,ATL,0,26,5,8,0.625,1,2,0.5,4,6,0.667,1,1,1,0,2,2,0,1,0,0,1,15,12.6
Kent Bazemore,27-255,G-F,3/13/17,ATL,SAS,1,31,5,6,0.833,4,4,1,1,2,0.5,4,5,0.8,0,2,2,1,1,0,1,6,15,11.3
Devin Harris,34-044,G,4/12/17,DAL,MEM,0,20,6,12,0.5,6,7,0.857,0,5,0,3,4,0.75,0,2,2,8,1,0,1,0,15,14.8
T.J. Warren,23-179,F,3/3/17,PHO,OKC,1,27,6,9,0.667,6,9,0.667,0,0,,3,5,0.6,1,6,7,2,0,0,1,2,15,12.4
Patrick Patterson,28-026,F,4/9/17,TOR,NYK,0,29,6,9,0.667,3,3,1,3,6,0.5,0,0,,0,3,3,1,1,0,0,0,15,13.7
Jon Leuer,27-188,F,11/18/16,DET,CLE,0,22,5,12,0.417,4,10,0.4,1,2,0.5,4,4,1,3,4,7,0,0,0,0,0,15,11.9
Nikola Mirotic,25-283,F,11/20/16,CHI,LAL,1,37,4,9,0.444,1,1,1,3,8,0.375,4,8,0.5,2,13,15,2,0,0,1,2,15,13.6
Al-Farouq Aminu,26-190,F,3/30/17,POR,HOU,0,31,5,10,0.5,3,5,0.6,2,5,0.4,3,4,0.75,1,8,9,1,2,0,1,1,15,14
Serge Ibaka,27-194,F-C,3/31/17,TOR,IND,1,30,6,10,0.6,3,6,0.5,3,4,0.75,0,0,,5,7,12,2,0,2,1,3,15,16.6
Anthony Morrow,31-129,G,2/3/17,OKC,MEM,0,19,5,7,0.714,2,3,0.667,3,4,0.75,2,2,1,1,0,1,0,0,0,1,3,15,10.6
Brandon Ingram,19-140,F,1/20/17,LAL,IND,1,33,6,14,0.429,3,8,0.375,3,6,0.5,0,0,,2,5,7,2,2,0,3,1,15,10.5
Channing Frye,33-232,C-F,1/4/17,CLE,CHI,1,30,6,11,0.545,3,5,0.6,3,6,0.5,0,0,,2,3,5,0,1,0,0,0,15,13
Joakim Noah,31-310,C,12/31/16,NYK,HOU,1,29,7,10,0.7,7,10,0.7,0,0,,1,3,0.333,4,12,16,2,1,1,0,2,15,18.7
Lance Stephenson,26-053,G-F,10/28/16,NOP,GSW,0,31,6,11,0.545,6,10,0.6,0,1,0,3,4,0.75,2,6,8,6,0,0,2,5,15,12.7
Robert Covington,26-102,F,3/26/17,PHI,IND,1,30,4,13,0.308,1,4,0.25,3,9,0.333,4,5,0.8,0,3,3,2,1,2,2,3,15,8.6
James Johnson,29-266,F,11/12/16,MIA,UTA,0,30,6,7,0.857,5,6,0.833,1,1,1,2,3,0.667,0,4,4,4,1,0,2,2,15,14.3
Nicolas Batum,28-057,F-G,2/9/17,CHO,HOU,1,35,5,10,0.5,3,6,0.5,2,4,0.5,3,3,1,1,7,8,10,1,0,3,3,15,16.6
Austin Rivers,24-196,G,2/13/17,LAC,UTA,1,32,6,12,0.5,3,8,0.375,3,4,0.75,0,0,,0,3,3,3,0,0,3,3,15,7.8
Marvin Williams,30-290,F,4/5/17,CHO,MIA,1,36,6,10,0.6,3,4,0.75,3,6,0.5,0,0,,3,9,12,0,0,1,0,1,15,15.5
Boris Diaw,34-262,F-C,1/3/17,UTA,BOS,0,15,6,7,0.857,3,4,0.75,3,3,1,0,0,,0,0,0,0,1,0,2,1,15,11.1
Jordan Crawford,28-157,G,3/29/17,NOP,DAL,0,27,5,7,0.714,2,3,0.667,3,4,0.75,2,4,0.5,1,0,1,4,0,0,1,3,15,12.6
Thaddeus Young,28-287,F,4/4/17,IND,TOR,1,33,7,15,0.467,7,15,0.467,0,0,,1,1,1,6,5,11,0,2,0,1,0,15,14
Anthony Morrow,31-189,G,4/4/17,CHI,NYK,0,19,3,7,0.429,2,4,0.5,1,3,0.333,8,8,1,0,0,0,1,2,0,0,1,15,13.6
Jamal Murray,19-293,G,12/12/16,DEN,DAL,0,28,7,14,0.5,6,9,0.667,1,5,0.2,0,1,0,2,4,6,4,1,0,1,0,15,13
Marquese Chriss,19-228,F,2/15/17,PHO,LAL,1,25,4,11,0.364,4,9,0.444,0,2,0,7,9,0.778,2,6,8,0,2,2,0,2,15,13.9
Avery Bradley,26-026,G,12/22/16,BOS,IND,1,31,6,13,0.462,6,10,0.6,0,3,0,3,3,1,1,4,5,0,3,0,2,4,15,9.6
Mike Conley,29-180,G,4/9/17,MEM,DET,1,23,5,8,0.625,4,6,0.667,1,2,0.5,4,5,0.8,0,2,2,3,1,0,2,3,15,11.5
Ish Smith,28-222,G,2/12/17,DET,TOR,0,31,6,10,0.6,5,8,0.625,1,2,0.5,2,4,0.5,0,5,5,5,0,1,1,2,15,13.5
Taj Gibson,31-251,F,3/2/17,OKC,POR,0,33,6,9,0.667,5,8,0.625,1,1,1,2,2,1,3,3,6,2,2,2,2,3,15,15.7
Nick Young,31-193,G-F,12/11/16,LAL,NYK,1,20,6,11,0.545,5,5,1,1,6,0.167,2,3,0.667,2,2,4,0,0,0,0,2,15,10.5
Rudy Gay,30-085,F,11/10/16,SAC,LAL,1,33,6,13,0.462,6,10,0.6,0,3,0,3,4,0.75,0,8,8,1,2,0,1,1,15,11.6
Ersan Ilyasova,29-295,F,3/6/17,ATL,GSW,0,27,4,6,0.667,2,3,0.667,2,3,0.667,5,6,0.833,0,2,2,0,3,1,1,2,15,14.5
Sean Kilpatrick,27-050,G,2/25/17,BRK,GSW,0,29,6,16,0.375,5,11,0.455,1,5,0.2,2,2,1,1,9,10,2,2,0,0,0,15,13
Trevor Ariza,31-286,F,4/12/17,HOU,MIN,1,38,6,14,0.429,4,6,0.667,2,8,0.25,1,2,0.5,2,3,5,6,1,1,0,1,15,15
Isaiah Whitehead,21-363,G,3/6/17,BRK,MEM,0,23,5,8,0.625,3,4,0.75,2,4,0.5,3,3,1,1,1,2,1,2,1,2,1,15,13.4
Shelvin Mack,26-343,G,3/31/17,UTA,WAS,0,26,5,9,0.556,5,7,0.714,0,2,0,5,6,0.833,0,5,5,1,1,0,1,5,15,10.5
George Hill,30-249,G,1/8/17,UTA,MEM,1,33,6,15,0.4,4,11,0.364,2,4,0.5,1,2,0.5,0,4,4,2,1,1,4,4,15,5.2
Greg Monroe,26-291,C-F,3/22/17,MIL,SAC,0,20,5,6,0.833,5,6,0.833,0,0,,5,6,0.833,2,2,4,1,0,0,3,3,15,10.9
Greg Monroe,26-212,C-F,1/2/17,MIL,OKC,0,27,7,10,0.7,7,10,0.7,0,0,,1,4,0.25,1,7,8,2,1,1,1,2,15,13.7
Enes Kanter,24-230,C,1/5/17,OKC,HOU,0,22,5,8,0.625,5,8,0.625,0,0,,5,6,0.833,6,7,13,1,0,1,1,2,15,16.9
E'Twaun Moore,27-323,G,1/16/17,NOP,IND,0,28,5,9,0.556,4,6,0.667,1,3,0.333,4,4,1,1,3,4,0,1,2,2,0,15,12.7
Tim Frazier,26-009,G,11/10/16,NOP,MIL,1,34,3,8,0.375,1,4,0.25,2,4,0.5,7,7,1,0,5,5,10,1,0,2,4,15,16.5
C.J. Miles,29-324,G-F,3/8/17,IND,DET,1,23,5,10,0.5,1,1,1,4,9,0.444,1,1,1,0,1,1,2,0,0,0,3,15,10.5
Jon Leuer,27-275,F,2/13/17,DET,MIL,1,36,6,9,0.667,5,7,0.714,1,2,0.5,2,2,1,2,9,11,0,0,1,2,2,15,13.1
Arron Afflalo,31-081,G,1/4/17,SAC,MIA,0,31,5,8,0.625,2,5,0.4,3,3,1,2,2,1,0,1,1,1,0,0,3,4,15,7.8
Maurice Harkless,23-195,F-G,11/22/16,POR,NYK,1,34,6,13,0.462,5,10,0.5,1,3,0.333,2,4,0.5,1,7,8,0,1,1,3,3,15,7.8
Marcus Morris,27-215,F,4/5/17,DET,TOR,1,19,6,11,0.545,3,7,0.429,3,4,0.75,0,0,,0,1,1,1,0,0,0,4,15,9.1
Devin Booker,20-040,G,12/9/16,PHO,LAL,1,28,6,17,0.353,5,11,0.455,1,6,0.167,2,2,1,1,2,3,4,0,0,2,6,15,5.2
Jeff Teague,28-177,G,12/4/16,IND,LAC,1,35,5,12,0.417,4,11,0.364,1,1,1,4,4,1,0,1,1,3,3,0,0,4,15,12.4
Jae Crowder,26-194,F,1/16/17,BOS,CHO,1,30,5,11,0.455,2,3,0.667,3,8,0.375,2,2,1,0,7,7,3,1,1,0,0,15,15.2
Henry Ellenson,20-084,F,4/7/17,DET,HOU,1,26,6,16,0.375,5,8,0.625,1,8,0.125,2,2,1,2,9,11,0,0,1,1,1,15,9.6
Terrence Ross,25-347,F-G,1/17/17,TOR,BRK,0,30,6,11,0.545,3,4,0.75,3,7,0.429,0,0,,0,4,4,2,1,2,1,0,15,13.7
Myles Turner,21-004,F-C,3/28/17,IND,MIN,1,37,5,12,0.417,4,11,0.364,1,1,1,4,4,1,3,5,8,4,0,2,2,3,15,13.2
Jeremy Lin,28-205,G,3/16/17,BRK,NYK,1,30,5,16,0.313,3,7,0.429,2,9,0.222,3,3,1,0,4,4,8,2,0,1,3,15,12.4
Nick Young,31-198,G-F,12/16/16,LAL,PHI,1,21,5,9,0.556,3,4,0.75,2,5,0.4,3,4,0.75,0,1,1,2,0,1,0,2,15,11.9
Myles Turner,20-230,F-C,11/9/16,IND,PHI,1,32,6,10,0.6,5,9,0.556,1,1,1,2,2,1,1,8,9,1,0,3,2,4,15,12.7
Darren Collison,29-227,G,4/7/17,SAC,LAL,1,28,5,8,0.625,4,6,0.667,1,2,0.5,4,4,1,0,5,5,10,1,0,4,0,15,16.9
Aaron Gordon,21-110,F,1/4/17,ORL,ATL,1,25,6,11,0.545,4,7,0.571,2,4,0.5,1,1,1,4,6,10,2,0,0,2,1,15,13.3
Goran Dragic,30-339,G,4/10/17,MIA,CLE,1,40,5,15,0.333,5,15,0.333,0,0,,5,7,0.714,0,5,5,5,1,1,0,2,15,11.6
Stephen Curry,28-283,G,12/22/16,GSW,BRK,1,33,6,19,0.316,3,6,0.5,3,13,0.231,0,0,,0,2,2,7,5,0,2,5,15,10.6
Enes Kanter,24-284,C,2/28/17,OKC,UTA,0,27,7,12,0.583,7,12,0.583,0,0,,1,1,1,3,6,9,1,1,1,2,2,15,12.9
Evan Fournier,24-050,G-F,12/18/16,ORL,TOR,1,26,6,10,0.6,6,8,0.75,0,2,0,3,3,1,2,1,3,3,1,0,3,5,15,10.2
Mason Plumlee,26-330,C-F,1/29/17,POR,GSW,1,30,7,14,0.5,7,14,0.5,0,0,,1,3,0.333,3,8,11,1,1,2,2,5,15,10.8
Myles Turner,20-328,F-C,2/15/17,IND,CLE,1,32,7,12,0.583,7,11,0.636,0,1,0,1,3,0.333,3,4,7,1,1,1,4,4,15,8.7
Patty Mills,28-204,G,3/3/17,SAS,NOP,0,29,5,10,0.5,1,1,1,4,9,0.444,1,2,0.5,1,1,2,2,2,0,2,1,15,11.6
Robert Covington,26-082,F,3/6/17,PHI,MIL,1,33,5,12,0.417,2,5,0.4,3,7,0.429,2,2,1,0,3,3,0,1,2,2,3,15,8.7
Marco Belinelli,30-308,G-F,1/27/17,CHO,NYK,0,21,6,10,0.6,4,5,0.8,2,5,0.4,1,1,1,0,2,2,1,1,0,2,0,15,10.7
Russell Westbrook,28-128,G,3/20/17,OKC,GSW,1,27,4,16,0.25,3,10,0.3,1,6,0.167,6,7,0.857,0,8,8,7,2,0,5,4,15,7.7
Juan Hernangomez,21-171,F,3/18/17,DEN,HOU,1,28,5,9,0.556,2,5,0.4,3,4,0.75,2,3,0.667,2,3,5,1,1,0,1,3,15,12.1
Jamal Murray,20-027,G,3/22/17,DEN,CLE,0,20,5,11,0.455,2,4,0.5,3,7,0.429,2,2,1,0,0,0,3,0,0,0,2,15,10.6
Willy Hernangomez,22-209,C,12/22/16,NYK,ORL,0,21,7,11,0.636,6,8,0.75,1,3,0.333,0,0,,3,2,5,0,0,0,1,3,15,10.6
Elfrid Payton,23-011,G,3/5/17,ORL,WAS,1,30,7,8,0.875,7,7,1,0,1,0,1,2,0.5,2,3,5,3,1,1,3,1,15,14.5
T.J. Warren,23-056,F,10/31/16,PHO,LAC,1,29,6,14,0.429,6,13,0.462,0,1,0,3,5,0.6,2,2,4,1,1,0,1,3,15,8.3
Justise Winslow,20-214,F,10/26/16,MIA,ORL,1,34,7,15,0.467,7,13,0.538,0,2,0,1,1,1,3,5,8,4,1,2,2,4,15,12.5
Nicolas Brussino,24-041,G-F,4/12/17,DAL,MEM,1,37,4,8,0.5,0,0,,4,8,0.5,3,3,1,2,6,8,2,2,0,3,2,15,13.8
Marcin Gortat,32-345,C-F,1/27/17,WAS,ATL,1,29,7,8,0.875,7,8,0.875,0,0,,1,2,0.5,6,6,12,2,3,2,1,3,15,21.4
DeMar DeRozan,27-135,G,12/20/16,TOR,BRK,1,29,6,20,0.3,6,18,0.333,0,2,0,3,4,0.75,0,1,1,2,1,0,1,2,15,3.9
Matthew Dellavedova,26-135,G,1/21/17,MIL,MIA,1,36,5,8,0.625,3,5,0.6,2,3,0.667,3,3,1,0,2,2,7,0,0,1,2,15,15.1
Sergio Rodriguez,30-174,G,12/3/16,PHI,BOS,1,32,5,11,0.455,1,4,0.25,4,7,0.571,1,1,1,2,3,5,8,2,0,4,3,15,14
Jahlil Okafor,20-330,C-F,11/9/16,PHI,IND,1,24,7,11,0.636,7,11,0.636,0,0,,1,5,0.2,1,2,3,1,1,2,2,0,15,10.9
Kevin Love,28-155,F,2/9/17,CLE,OKC,1,31,5,12,0.417,5,11,0.455,0,1,0,5,5,1,1,11,12,0,3,0,2,0,15,13.6
Mason Plumlee,27-008,C-F,3/13/17,DEN,LAL,1,36,6,9,0.667,6,9,0.667,0,0,,3,4,0.75,1,9,10,2,1,2,1,3,15,15.7
Giannis Antetokounmpo,22-085,F-G,3/1/17,MIL,DEN,1,34,5,13,0.385,5,12,0.417,0,1,0,5,6,0.833,2,7,9,4,0,3,6,3,15,8.7
Anthony Tolliver,31-298,F-C,3/26/17,SAC,LAC,0,23,5,6,0.833,0,0,,5,6,0.833,0,1,0,1,2,3,0,0,1,2,2,15,11.6
Victor Oladipo,24-266,G,1/25/17,OKC,NOP,1,35,5,11,0.455,2,4,0.5,3,7,0.429,2,3,0.667,0,4,4,2,2,2,1,1,15,13.5
Derrick Rose,28-043,G,11/16/16,NYK,DET,1,34,7,15,0.467,7,13,0.538,0,2,0,1,2,0.5,0,5,5,3,0,1,1,1,15,9.8
Sean Kilpatrick,27-085,G,4/1/17,BRK,ORL,0,22,6,12,0.5,5,8,0.625,1,4,0.25,2,2,1,2,3,5,4,0,0,3,1,15,10.7
Dennis Schroder,23-128,G,1/21/17,ATL,PHI,1,31,6,18,0.333,5,16,0.313,1,2,0.5,2,2,1,0,1,1,9,2,1,1,1,15,12.7
Markieff Morris,27-099,F,12/10/16,WAS,MIL,1,34,5,12,0.417,5,11,0.455,0,1,0,5,8,0.625,2,7,9,3,3,1,1,1,15,15.3
Victor Oladipo,24-336,G,4/5/17,OKC,MEM,1,39,6,15,0.4,5,9,0.556,1,6,0.167,2,2,1,0,3,3,5,2,1,0,3,15,12.8
Robert Covington,26-025,F,1/8/17,PHI,BRK,1,37,5,12,0.417,4,7,0.571,1,5,0.2,4,4,1,1,10,11,1,5,1,2,2,15,15.9
Rudy Gobert,24-193,C,1/5/17,UTA,TOR,1,36,3,10,0.3,3,10,0.3,0,0,,9,10,0.9,7,9,16,0,0,3,2,3,15,15.3
Bojan Bogdanovic,27-196,G-F,10/31/16,BRK,CHI,1,21,5,11,0.455,3,7,0.429,2,4,0.5,3,4,0.75,2,1,3,1,0,0,1,1,15,9.9
Derrick Jones,20-053,F,4/9/17,PHO,DAL,0,28,5,11,0.455,4,10,0.4,1,1,1,4,4,1,2,1,3,0,3,0,2,4,15,10.4
Dwight Howard,31-085,C,3/3/17,ATL,CLE,1,27,6,12,0.5,6,12,0.5,0,0,,3,6,0.5,4,6,10,2,2,1,1,3,15,14.3
Ben McLemore,24-048,G,3/31/17,SAC,NOP,0,25,6,16,0.375,5,12,0.417,1,4,0.25,2,2,1,1,7,8,4,0,0,3,2,15,8
Aaron Gordon,21-170,F,3/5/17,ORL,WAS,1,35,5,13,0.385,4,8,0.5,1,5,0.2,4,5,0.8,5,6,11,3,1,0,2,3,15,12.7
Shabazz Muhammad,24-082,F-G,2/3/17,MIN,DET,0,23,6,11,0.545,3,7,0.429,3,4,0.75,0,0,,0,0,0,0,1,0,1,3,15,8.5
Markieff Morris,27-097,F,12/8/16,WAS,DEN,1,33,5,12,0.417,5,12,0.417,0,0,,5,5,1,2,1,3,4,0,0,1,3,15,10.9
D'Angelo Russell,20-297,G,12/16/16,LAL,PHI,1,27,4,12,0.333,1,4,0.25,3,8,0.375,4,4,1,0,7,7,2,1,0,2,2,15,9.9
Karl-Anthony Towns,20-349,C-F,10/29/16,MIN,SAC,1,37,7,12,0.583,6,10,0.6,1,2,0.5,0,2,0,2,4,6,4,2,1,1,5,15,13.7
Avery Bradley,25-351,G,11/11/16,BOS,NYK,1,32,5,17,0.294,4,13,0.308,1,4,0.25,4,4,1,3,7,10,2,3,0,2,2,15,10.9
Evan Fournier,24-144,G-F,3/22/17,ORL,CHO,1,30,5,12,0.417,2,3,0.667,3,9,0.333,2,3,0.667,2,3,5,3,1,0,3,3,15,9.4
Brian Roberts,31-097,G,3/10/17,CHO,ORL,0,24,5,8,0.625,2,5,0.4,3,3,1,2,2,1,0,1,1,4,1,0,0,1,15,15.1
Malcolm Brogdon,24-092,G,3/13/17,MIL,MEM,0,32,5,10,0.5,2,5,0.4,3,5,0.6,2,2,1,2,0,2,8,1,1,3,4,15,14.1
Dante Cunningham,29-189,F,10/28/16,NOP,GSW,0,32,6,11,0.545,3,5,0.6,3,6,0.5,0,0,,0,8,8,0,0,2,1,3,15,11.3
Jeff Teague,28-250,G,2/15/17,IND,CLE,1,35,5,14,0.357,3,10,0.3,2,4,0.5,3,3,1,1,3,4,11,0,0,2,2,15,13.7
Tyler Johnson,24-217,G,12/10/16,MIA,CHI,0,34,5,13,0.385,3,8,0.375,2,5,0.4,3,3,1,0,3,3,4,0,0,2,4,15,8
C.J. Miles,29-264,G-F,1/7/17,IND,NYK,0,20,6,11,0.545,3,4,0.75,3,7,0.429,0,0,,1,3,4,0,2,0,1,2,15,11.5
Blake Griffin,28-027,F,4/12/17,LAC,SAC,1,34,6,14,0.429,6,11,0.545,0,3,0,3,3,1,2,7,9,8,1,0,0,2,15,16.9
Robert Covington,26-004,F,12/18/16,PHI,BRK,1,35,5,11,0.455,4,7,0.571,1,4,0.25,4,4,1,2,3,5,2,1,0,2,2,15,11.2
Jon Leuer,27-254,F,1/23/17,DET,SAC,1,28,6,11,0.545,3,7,0.429,3,4,0.75,0,0,,0,4,4,4,0,0,2,5,15,9.7
Allen Crabbe,24-235,G-F,11/30/16,POR,IND,0,23,4,8,0.5,2,4,0.5,2,4,0.5,5,5,1,0,1,1,0,0,0,0,4,15,9.7
Derrick Favors,25-105,F-C,10/28/16,UTA,LAL,0,20,4,7,0.571,4,7,0.571,0,0,,7,11,0.636,4,4,8,2,2,2,5,3,15,12.7
Jae Crowder,26-256,F,3/19/17,BOS,PHI,1,36,3,13,0.231,1,8,0.125,2,5,0.4,7,8,0.875,0,6,6,4,1,0,3,3,15,8.1
John Wall,26-147,G,1/31/17,WAS,NYK,1,34,6,18,0.333,5,16,0.313,1,2,0.5,2,3,0.667,2,2,4,13,0,0,2,2,15,12.7
Jamal Crawford,36-241,G,11/16/16,LAC,MEM,0,27,6,12,0.5,5,8,0.625,1,4,0.25,2,2,1,1,0,1,3,0,0,2,2,15,9
Harrison Barnes,24-234,F,1/19/17,DAL,MIA,1,34,7,14,0.5,7,11,0.636,0,3,0,1,1,1,2,5,7,2,1,0,1,0,15,12.3
Robin Lopez,28-321,C,2/16/17,CHI,BOS,1,27,7,13,0.538,7,13,0.538,0,0,,1,1,1,5,3,8,2,0,2,1,1,15,14.5
C.J. Miles,29-193,G-F,10/28/16,IND,BRK,0,21,6,10,0.6,4,5,0.8,2,5,0.4,1,1,1,2,5,7,0,0,0,1,4,15,10.7
Marquese Chriss,19-203,F,1/21/17,PHO,NYK,1,22,6,10,0.6,4,5,0.8,2,5,0.4,1,3,0.333,3,2,5,0,3,1,1,2,15,14.2
Eric Gordon,28-006,G,12/31/16,HOU,NYK,0,32,5,19,0.263,0,4,0,5,15,0.333,0,0,,0,2,2,2,1,0,2,2,15,3.9
Gerald Green,31-057,G-F,3/24/17,BOS,PHO,0,13,4,5,0.8,0,1,0,4,4,1,3,3,1,0,1,1,0,0,0,1,3,15,11.2
Dennis Schroder,23-079,G,12/3/16,ATL,TOR,1,24,7,14,0.5,7,13,0.538,0,1,0,1,1,1,0,1,1,6,1,0,1,0,15,12.5
Mike Conley,29-183,G,4/12/17,MEM,DAL,1,17,5,9,0.556,3,4,0.75,2,5,0.4,3,4,0.75,0,2,2,2,1,0,0,0,15,13.3
Steven Adams,23-121,C,11/18/16,OKC,BRK,1,32,4,6,0.667,4,6,0.667,0,0,,7,8,0.875,3,4,7,0,0,2,3,1,15,13.3
Julius Randle,22-073,F,2/10/17,LAL,MIL,1,26,6,12,0.5,6,11,0.545,0,1,0,3,6,0.5,1,6,7,2,1,0,3,5,15,7.7
Trevor Booker,28-349,F,11/8/16,BRK,MIN,1,27,7,13,0.538,7,12,0.583,0,1,0,1,3,0.333,0,9,9,1,3,1,1,3,15,12.8
Will Barton,25-344,G,12/15/16,DEN,POR,0,23,3,8,0.375,0,2,0,3,6,0.5,6,6,1,0,1,1,2,1,1,2,1,15,11.6
Otto Porter,23-196,F,12/16/16,WAS,DET,1,34,6,10,0.6,3,6,0.5,3,4,0.75,0,0,,0,8,8,3,0,0,1,3,15,12.7
Joe Harris,25-149,G,2/3/17,BRK,IND,0,24,5,10,0.5,2,6,0.333,3,4,0.75,2,2,1,0,2,2,0,3,0,2,3,15,10.4
Kevin Love,28-198,F,3/24/17,CLE,CHO,1,29,6,12,0.5,6,9,0.667,0,3,0,3,4,0.75,1,11,12,4,0,0,2,4,15,11.8
Tyreke Evans,27-157,G-F,2/23/17,SAC,DEN,0,26,4,8,0.5,3,6,0.5,1,2,0.5,6,8,0.75,0,4,4,3,1,0,4,1,15,10.1
Kyle Lowry,30-303,G,1/22/17,TOR,PHO,1,37,5,17,0.294,4,8,0.5,1,9,0.111,4,5,0.8,0,4,4,6,1,0,2,4,15,7.5
Kenneth Faried,27-031,F,12/20/16,DEN,LAC,0,27,5,9,0.556,5,8,0.625,0,1,0,5,6,0.833,4,7,11,1,1,0,0,1,15,16.5
Montrezl Harrell,23-074,F-C,4/10/17,HOU,LAC,0,34,7,12,0.583,7,11,0.636,0,1,0,1,2,0.5,4,9,13,0,0,1,1,3,15,13
Nicolas Batum,27-335,F-G,11/13/16,CHO,CLE,1,33,5,12,0.417,4,7,0.571,1,5,0.2,4,5,0.8,1,8,9,7,2,1,1,1,15,17.5
Marcus Morris,27-098,F,12/9/16,DET,MIN,1,35,6,12,0.5,3,6,0.5,3,6,0.5,0,0,,0,7,7,1,0,0,1,2,15,10
Dante Exum,21-231,G,3/1/17,UTA,MIN,0,29,6,12,0.5,4,7,0.571,2,5,0.4,1,3,0.333,0,1,1,3,1,0,2,1,15,9.2
Luc Mbah a Moute,30-084,F,12/2/16,LAC,NOP,1,33,5,9,0.556,2,5,0.4,3,4,0.75,2,2,1,3,3,6,0,2,2,0,1,15,16.7
Channing Frye,33-217,C-F,12/20/16,CLE,MIL,0,25,5,11,0.455,2,4,0.5,3,7,0.429,2,2,1,1,2,3,2,0,0,0,4,15,10.4
Paul Zipser,23-032,G-F,3/22/17,CHI,DET,1,29,6,9,0.667,5,7,0.714,1,2,0.5,2,3,0.667,1,3,4,2,1,0,1,3,15,12.5
Austin Rivers,24-224,G,3/13/17,LAC,UTA,0,26,6,11,0.545,4,6,0.667,2,5,0.4,1,4,0.25,0,0,0,2,0,0,0,4,15,8.3
Kevin Love,28-210,F,4/5/17,CLE,BOS,1,32,5,15,0.333,4,10,0.4,1,5,0.2,4,4,1,5,11,16,1,0,0,0,4,15,12.4
Kent Bazemore,27-210,G-F,1/27/17,ATL,WAS,1,21,6,14,0.429,4,10,0.4,2,4,0.5,1,1,1,0,0,0,1,1,1,2,1,15,7.6
Jordan Clarkson,24-147,G,11/1/16,LAL,IND,0,31,7,16,0.438,7,12,0.583,0,4,0,1,1,1,1,0,1,0,0,0,0,2,15,6.5
Jrue Holiday,26-241,G,2/8/17,NOP,UTA,1,31,7,12,0.583,6,8,0.75,1,4,0.25,0,3,0,1,5,6,2,1,0,4,2,15,8
Tyreke Evans,27-163,G-F,3/1/17,SAC,BRK,0,20,5,10,0.5,2,5,0.4,3,5,0.6,2,2,1,1,4,5,0,0,1,0,1,15,12.2
Trey Lyles,20-362,F,11/1/16,UTA,SAS,0,29,6,15,0.4,4,8,0.5,2,7,0.286,1,1,1,0,7,7,3,0,2,1,2,15,10.7
Brandon Jennings,27-126,G,1/27/17,NYK,CHO,0,31,6,11,0.545,4,6,0.667,2,5,0.4,1,3,0.333,0,3,3,3,1,1,0,1,15,13.2
Tony Parker,34-231,G,1/3/17,SAS,TOR,1,22,6,9,0.667,5,8,0.625,1,1,1,2,2,1,0,2,2,8,0,0,1,1,15,15.9
Bismack Biyombo,24-167,C-F,2/11/17,ORL,DAL,0,21,5,7,0.714,5,7,0.714,0,0,,5,5,1,5,2,7,2,1,1,2,1,15,16.9
Elfrid Payton,23-003,G,2/25/17,ORL,ATL,1,28,3,8,0.375,3,8,0.375,0,0,,9,10,0.9,3,6,9,9,2,2,1,1,15,22.4
Shabazz Muhammad,24-042,F-G,12/25/16,MIN,OKC,0,25,5,8,0.625,5,7,0.714,0,1,0,5,5,1,0,1,1,0,1,1,0,1,15,13
Marcus Smart,22-294,G,12/25/16,BOS,NYK,0,28,5,9,0.556,3,5,0.6,2,4,0.5,3,4,0.75,1,1,2,7,1,0,1,2,15,15.4
Taurean Waller-Prince,23-006,F,3/28/17,ATL,PHO,1,36,5,10,0.5,4,6,0.667,1,4,0.25,4,5,0.8,0,6,6,1,1,2,2,5,15,10.5
Jordan Clarkson,24-205,G,12/29/16,LAL,DAL,0,30,7,11,0.636,6,8,0.75,1,3,0.333,0,2,0,0,1,1,0,3,0,2,2,15,9.8
Marc Gasol,32-017,C,2/15/17,MEM,NOP,1,36,6,17,0.353,6,14,0.429,0,3,0,3,3,1,2,10,12,9,1,1,3,2,15,14.1
Gary Harris,22-055,G,11/8/16,DEN,MEM,1,30,5,13,0.385,3,7,0.429,2,6,0.333,3,4,0.75,1,2,3,3,1,0,3,3,15,7.7
Cory Joseph,25-228,G,4/5/17,TOR,DET,0,27,6,14,0.429,4,8,0.5,2,6,0.333,1,1,1,1,4,5,1,1,1,2,1,15,9.5
E'Twaun Moore,27-268,G,11/22/16,NOP,ATL,1,23,6,11,0.545,3,6,0.5,3,5,0.6,0,0,,0,3,3,2,1,0,0,0,15,13
Shelvin Mack,26-255,G,1/2/17,UTA,BRK,1,32,7,14,0.5,6,9,0.667,1,5,0.2,0,0,,1,1,2,2,3,0,1,1,15,12
Bojan Bogdanovic,27-289,G-F,2/1/17,BRK,NYK,1,29,6,10,0.6,5,5,1,1,5,0.2,2,4,0.5,1,6,7,0,0,0,3,3,15,7.9
Evan Turner,28-042,G,12/8/16,POR,MEM,1,30,4,9,0.444,4,8,0.5,0,1,0,7,8,0.875,2,8,10,2,0,0,1,2,15,13.3
Monta Ellis,31-087,G,1/21/17,IND,UTA,0,33,6,10,0.6,4,8,0.5,2,2,1,1,2,0.5,1,3,4,1,2,0,3,3,15,10.1
Darren Collison,29-089,G,11/20/16,SAC,TOR,1,32,4,8,0.5,3,4,0.75,1,4,0.25,6,8,0.75,0,0,0,9,2,0,1,1,15,17.1
Jerian Grant,24-181,G,4/8/17,CHI,BRK,1,30,6,8,0.75,3,4,0.75,3,4,0.75,0,0,,0,3,3,5,1,1,2,4,15,14.3
Marco Belinelli,30-291,G-F,1/10/17,CHO,HOU,0,28,6,13,0.462,3,4,0.75,3,9,0.333,0,0,,0,3,3,6,0,0,3,1,15,10
Kelly Olynyk,25-272,C-F,1/16/17,BOS,CHO,0,26,6,9,0.667,4,7,0.571,2,2,1,1,2,0.5,3,6,9,4,1,0,1,2,15,16.6
Lou Williams,30-098,G,2/2/17,LAL,WAS,0,23,4,12,0.333,2,4,0.5,2,8,0.25,5,5,1,0,2,2,4,0,0,3,2,15,7.8
Jae Crowder,26-276,F,4/8/17,BOS,CHO,1,33,6,9,0.667,5,7,0.714,1,2,0.5,2,4,0.5,0,9,9,3,0,0,1,2,15,13.3
Buddy Hield,23-099,G,3/26/17,SAC,LAC,1,23,5,12,0.417,2,4,0.5,3,8,0.375,2,2,1,1,6,7,2,1,0,0,0,15,13.5
Trevor Booker,29-105,F,3/10/17,BRK,DAL,0,27,6,14,0.429,5,12,0.417,1,2,0.5,2,5,0.4,2,5,7,3,0,0,0,2,15,10.6
Taj Gibson,31-229,F,2/8/17,CHI,GSW,1,23,6,10,0.6,6,10,0.6,0,0,,3,4,0.75,3,6,9,0,0,1,2,1,15,12.2
Nene Hilario,34-167,F-C,2/27/17,HOU,IND,0,19,4,7,0.571,4,7,0.571,0,0,,7,9,0.778,5,2,7,1,0,1,0,2,15,15.6
Rodney Hood,24-044,G-F,12/3/16,UTA,DEN,1,28,4,14,0.286,3,8,0.375,1,6,0.167,6,7,0.857,1,5,6,1,2,0,1,2,15,9.5
Thaddeus Young,28-184,F,12/22/16,IND,BOS,1,37,6,11,0.545,3,5,0.6,3,6,0.5,0,2,0,0,12,12,4,1,0,1,2,15,14.5
Dirk Nowitzki,38-224,F,1/29/17,DAL,SAS,1,28,5,11,0.455,3,8,0.375,2,3,0.667,3,3,1,2,8,10,0,0,4,2,1,15,13.5
Victor Oladipo,24-241,G,12/31/16,OKC,LAC,1,29,4,9,0.444,2,4,0.5,2,5,0.4,5,5,1,0,4,4,2,0,0,2,5,15,8.9
Al Horford,30-280,C-F,3/10/17,BOS,DEN,1,33,7,11,0.636,6,9,0.667,1,2,0.5,0,0,,1,5,6,2,1,0,5,2,15,8.9
Malcolm Brogdon,24-020,G,12/31/16,MIL,CHI,1,39,7,13,0.538,6,11,0.545,1,2,0.5,0,0,,1,9,10,12,0,0,3,4,15,15.9
Tim Hardaway,24-346,G,2/25/17,ATL,ORL,1,33,6,11,0.545,4,5,0.8,2,6,0.333,1,2,0.5,1,2,3,0,1,0,3,2,15,7.8
Seth Curry,26-150,G,1/20/17,DAL,UTA,1,30,5,8,0.625,3,5,0.6,2,3,0.667,3,4,0.75,0,3,3,0,1,0,1,5,15,9.9
Justin Holiday,27-299,G,1/29/17,NYK,ATL,0,36,5,15,0.333,0,2,0,5,13,0.385,0,0,,1,8,9,2,1,0,1,2,15,10.2
Brandon Ingram,19-159,F,2/8/17,LAL,DET,1,27,6,10,0.6,3,6,0.5,3,4,0.75,0,0,,0,4,4,5,0,0,3,3,15,10.9
Deron Williams,32-175,G,12/18/16,DAL,SAC,1,33,5,10,0.5,4,6,0.667,1,4,0.25,4,4,1,0,2,2,7,0,0,2,2,15,12.7
Brook Lopez,28-244,C,12/1/16,BRK,MIL,1,28,4,12,0.333,1,4,0.25,3,8,0.375,4,6,0.667,2,2,4,2,0,2,1,2,15,10.4
Jae Crowder,26-259,F,3/22/17,BOS,IND,1,36,7,12,0.583,6,9,0.667,1,3,0.333,0,0,,0,6,6,2,0,0,2,1,15,10.2
Hassan Whiteside,27-152,C,11/12/16,MIA,UTA,1,33,6,13,0.462,6,13,0.462,0,0,,3,6,0.5,2,12,14,1,0,2,1,2,15,12.4
Marreese Speights,29-143,C-F,12/25/16,LAC,LAL,0,21,3,7,0.429,0,2,0,3,5,0.6,6,6,1,1,3,4,1,1,0,0,3,15,13.4
DeMarre Carroll,30-193,F,2/5/17,TOR,BRK,1,32,6,11,0.545,4,6,0.667,2,5,0.4,1,2,0.5,1,4,5,1,2,1,1,0,15,13.6
Seth Curry,26-149,G,1/19/17,DAL,MIA,1,32,6,11,0.545,3,6,0.5,3,5,0.6,0,1,0,2,2,4,0,0,0,1,5,15,8.3
Zach Randolph,35-253,F,3/26/17,MEM,GSW,1,29,7,15,0.467,7,11,0.636,0,4,0,1,2,0.5,0,5,5,3,2,0,1,0,15,11.5
Spencer Hawes,28-349,C-F,4/12/17,MIL,BOS,0,17,5,7,0.714,3,4,0.75,2,3,0.667,3,3,1,0,5,5,2,0,0,2,3,15,11.8
Terrence Jones,25-007,F,1/16/17,NOP,IND,0,26,6,13,0.462,5,12,0.417,1,1,1,2,5,0.4,4,4,8,3,0,2,1,3,15,12.4
Rudy Gobert,24-253,C,3/6/17,UTA,NOP,1,36,6,10,0.6,6,10,0.6,0,0,,3,3,1,8,8,16,3,2,2,2,4,15,20.3
James Johnson,29-332,F,1/17/17,MIA,HOU,0,31,6,14,0.429,5,10,0.5,1,4,0.25,2,2,1,1,7,8,6,3,0,5,4,15,11
Gary Harris,22-173,G,3/6/17,DEN,SAC,1,35,5,7,0.714,3,4,0.75,2,3,0.667,3,4,0.75,0,3,3,3,3,0,2,1,15,15.3
Dwyane Wade,35-010,G,1/27/17,CHI,MIA,0,28,6,17,0.353,6,17,0.353,0,0,,3,4,0.75,1,5,6,3,2,0,4,3,15,6.2
Evan Turner,28-031,G,11/27/16,POR,HOU,0,23,6,12,0.5,4,8,0.5,2,4,0.5,1,2,0.5,0,6,6,2,0,0,1,2,15,10
Justin Holiday,27-270,G,12/31/16,NYK,HOU,0,30,6,12,0.5,3,4,0.75,3,8,0.375,0,0,,1,5,6,0,3,0,1,4,15,11.6
D'Angelo Russell,20-301,G,12/20/16,LAL,CHO,1,26,6,13,0.462,5,9,0.556,1,4,0.25,2,2,1,1,4,5,5,0,2,2,0,15,13.1
Greg Monroe,26-210,C-F,12/31/16,MIL,CHI,0,34,6,13,0.462,6,13,0.462,0,0,,3,4,0.75,4,8,12,2,2,0,1,2,15,14.7
Michael Carter-Williams,25-091,G,1/9/17,CHI,OKC,1,24,6,11,0.545,6,10,0.6,0,1,0,3,3,1,0,1,1,2,0,0,1,2,15,9.6
Kyle Lowry,30-317,G,2/5/17,TOR,BRK,1,39,5,13,0.385,5,8,0.625,0,5,0,5,6,0.833,0,10,10,11,1,0,2,4,15,15.6
Corey Brewer,30-311,F-G,1/10/17,HOU,CHO,0,26,7,10,0.7,6,8,0.75,1,2,0.5,0,0,,0,5,5,0,1,0,1,3,15,11.1
Andre Iguodala,33-070,G-F,4/8/17,GSW,NOP,0,21,7,10,0.7,6,6,1,1,4,0.25,0,0,,0,5,5,5,0,0,0,0,15,15.8
Eric Gordon,28-096,G,3/31/17,HOU,GSW,1,38,5,12,0.417,2,3,0.667,3,9,0.333,2,2,1,0,2,2,1,2,0,2,3,15,8.7
Kent Bazemore,27-243,G-F,3/1/17,ATL,DAL,1,30,6,11,0.545,3,6,0.5,3,5,0.6,0,0,,0,1,1,2,1,0,1,0,15,11.4
Jerami Grant,22-326,F,2/1/17,OKC,CHI,0,20,5,8,0.625,4,4,1,1,4,0.25,4,4,1,0,1,1,0,1,0,0,2,15,11.9
Draymond Green,26-322,F,1/20/17,GSW,HOU,1,33,6,12,0.5,3,7,0.429,3,5,0.6,0,0,,3,6,9,8,1,3,3,3,15,17.4
Andre Drummond,23-135,C,12/23/16,DET,GSW,1,30,6,7,0.857,6,7,0.857,0,0,,3,9,0.333,0,9,9,2,1,2,3,4,15,12
Marvin Williams,30-184,F,12/20/16,CHO,LAL,1,30,6,10,0.6,5,7,0.714,1,3,0.333,2,2,1,2,3,5,2,0,0,0,1,15,13.7
Kristaps Porzingis,21-180,F-C,1/29/17,NYK,ATL,1,30,6,14,0.429,6,11,0.545,0,3,0,3,3,1,3,2,5,1,0,3,2,6,15,8.7
James Johnson,29-359,F,2/13/17,MIA,ORL,0,28,5,9,0.556,4,7,0.571,1,2,0.5,4,5,0.8,1,2,3,3,0,3,1,4,15,13.2
Serge Ibaka,27-192,F-C,3/29/17,TOR,CHO,1,28,4,12,0.333,0,3,0,4,9,0.444,3,4,0.75,0,2,2,2,0,1,3,5,15,5.5
Nik Stauskas,23-093,G,1/8/17,PHI,BRK,1,31,4,7,0.571,1,3,0.333,3,4,0.75,4,4,1,0,5,5,2,0,1,1,2,15,13.5
Dario Saric,22-355,F,3/29/17,PHI,ATL,1,39,5,18,0.278,3,10,0.3,2,8,0.25,3,4,0.75,2,6,8,4,0,1,2,0,15,8.7
Shabazz Muhammad,24-094,F-G,2/15/17,MIN,DEN,0,17,5,7,0.714,5,6,0.833,0,1,0,5,5,1,0,3,3,2,0,0,0,0,15,14.4
Rajon Rondo,30-284,G,12/2/16,CHI,CLE,1,36,7,12,0.583,6,11,0.545,1,1,1,0,0,,2,8,10,12,3,1,3,4,15,20.7
Courtney Lee,31-065,G,12/7/16,NYK,CLE,1,31,5,10,0.5,2,3,0.667,3,7,0.429,2,2,1,1,1,2,5,2,0,1,2,15,14.7
Lance Thomas,28-326,F,3/16/17,NYK,BRK,1,34,5,5,1,4,4,1,1,1,1,4,4,1,1,9,10,1,0,0,0,2,15,16.8
Kenneth Faried,27-054,F,1/12/17,DEN,IND,0,16,6,8,0.75,6,8,0.75,0,0,,3,3,1,4,5,9,0,1,1,2,2,15,15
Jordan Clarkson,24-253,G,2/15/17,LAL,PHO,0,30,6,12,0.5,4,7,0.571,2,5,0.4,1,3,0.333,0,3,3,0,1,0,3,3,15,5.9
Ryan Anderson,28-234,F,12/26/16,HOU,PHO,1,25,6,9,0.667,3,4,0.75,3,5,0.6,0,0,,2,3,5,1,0,0,1,2,15,12.3
Tyler Johnson,24-234,G,12/27/16,MIA,OKC,0,30,5,13,0.385,3,10,0.3,2,3,0.667,3,4,0.75,0,2,2,2,1,1,0,2,15,10.4
Bradley Beal,23-213,G,1/27/17,WAS,ATL,1,26,6,13,0.462,4,6,0.667,2,7,0.286,1,1,1,0,1,1,4,1,0,0,2,15,11.6
Nicolas Batum,28-105,F-G,3/29/17,CHO,TOR,1,28,6,12,0.5,4,7,0.571,2,5,0.4,1,1,1,2,2,4,3,1,0,0,0,15,14.1
Terrence Jones,25-007,F,1/16/17,NOP,IND,0,26,6,13,0.462,5,12,0.417,1,1,1,2,5,0.4,4,4,8,3,0,2,1,3,15,12.4
Cory Joseph,25-195,G,3/3/17,TOR,WAS,1,32,7,13,0.538,7,13,0.538,0,0,,1,2,0.5,2,3,5,3,0,0,2,1,15,10.3
Justin Anderson,23-012,G,12/1/16,DAL,CHO,0,18,4,7,0.571,1,4,0.25,3,3,1,4,4,1,1,2,3,0,0,0,2,3,15,9.8
Lou Williams,30-012,G,11/8/16,LAL,DAL,0,23,5,15,0.333,3,7,0.429,2,8,0.25,3,4,0.75,1,3,4,3,1,0,0,2,15,10
Kyle Lowry,30-324,G,2/12/17,TOR,DET,1,36,5,10,0.5,1,4,0.25,4,6,0.667,1,2,0.5,0,6,6,5,1,1,2,4,15,13
Dwyane Wade,34-290,G,11/2/16,CHI,BOS,1,35,5,13,0.385,5,10,0.5,0,3,0,5,6,0.833,0,1,1,4,2,0,0,0,15,12.6
Iman Shumpert,26-130,G,11/3/16,CLE,BOS,0,26,3,7,0.429,1,2,0.5,2,5,0.4,7,8,0.875,0,2,2,2,0,0,0,4,15,11.3
Terrence Ross,25-271,F-G,11/2/16,TOR,WAS,0,18,6,8,0.75,4,5,0.8,2,3,0.667,1,1,1,1,1,2,2,2,0,1,1,15,14.8
Mike Conley,29-102,G,1/21/17,MEM,HOU,1,35,6,17,0.353,3,9,0.333,3,8,0.375,0,0,,1,3,4,6,0,0,1,1,15,9.9
Avery Bradley,26-097,G,3/3/17,BOS,LAL,1,24,6,11,0.545,4,5,0.8,2,6,0.333,1,4,0.25,1,3,4,4,0,0,1,2,15,11.1
Kristaps Porzingis,21-170,F-C,1/19/17,NYK,WAS,0,29,6,11,0.545,6,8,0.75,0,3,0,3,3,1,3,2,5,2,1,0,1,3,15,12.6
Alex Poythress,23-216,F,4/10/17,PHI,IND,0,23,5,8,0.625,0,1,0,5,7,0.714,0,0,,0,1,1,0,1,0,1,1,15,11.3
Marcin Gortat,32-259,C-F,11/2/16,WAS,TOR,1,43,6,10,0.6,6,10,0.6,0,0,,3,4,0.75,1,9,10,2,1,2,1,2,15,15.4
Buddy Hield,23-070,G,2/25/17,SAC,CHO,0,26,5,10,0.5,3,5,0.6,2,5,0.4,3,3,1,0,1,1,2,0,0,3,1,15,8.3
Tobias Harris,24-192,F,1/23/17,DET,SAC,0,26,7,11,0.636,6,8,0.75,1,3,0.333,0,0,,2,2,4,1,0,0,2,2,15,10
Kentavious Caldwell-Pope,24-019,G,3/9/17,DET,CLE,1,34,5,10,0.5,1,3,0.333,4,7,0.571,1,1,1,0,0,0,2,0,0,0,1,15,11
Andre Drummond,23-142,C,12/30/16,DET,ATL,1,35,5,12,0.417,5,12,0.417,0,0,,5,7,0.714,6,9,15,1,1,1,6,4,15,9.5
Cory Joseph,25-219,G,3/27/17,TOR,ORL,1,29,6,10,0.6,5,9,0.556,1,1,1,2,4,0.5,1,5,6,13,0,1,5,3,15,15.4
Jusuf Nurkic,22-132,C,1/2/17,DEN,GSW,0,21,6,8,0.75,6,8,0.75,0,0,,3,4,0.75,0,6,6,4,1,1,1,3,15,15.5
Josh Richardson,23-072,G,11/26/16,MIA,MEM,1,29,5,12,0.417,2,5,0.4,3,7,0.429,2,2,1,1,2,3,5,0,0,2,3,15,10.2
Pau Gasol,36-129,F-C,11/12/16,SAS,HOU,1,32,5,10,0.5,5,9,0.556,0,1,0,5,8,0.625,1,6,7,6,0,2,1,3,15,14.7
Rodney Hood,24-074,G-F,1/2/17,UTA,BRK,1,28,6,19,0.316,5,15,0.333,1,4,0.25,2,2,1,1,2,3,1,0,0,0,4,15,4.5
Carmelo Anthony,32-207,F,12/22/16,NYK,ORL,1,29,5,17,0.294,5,14,0.357,0,3,0,5,5,1,1,7,8,3,1,0,1,2,15,9.2
Harrison Barnes,24-310,F,4/5/17,DAL,LAC,1,35,6,13,0.462,5,8,0.625,1,5,0.2,2,2,1,1,3,4,2,0,0,3,5,15,6.3
Harrison Barnes,24-202,F,12/18/16,DAL,SAC,1,30,5,15,0.333,4,13,0.308,1,2,0.5,4,6,0.667,3,6,9,2,3,1,0,0,15,14.7
Taj Gibson,31-260,F,3/11/17,OKC,UTA,1,22,7,9,0.778,7,9,0.778,0,0,,1,1,1,1,5,6,0,0,0,1,1,15,12.3
Al Horford,30-205,C-F,12/25/16,BOS,NYK,1,35,7,13,0.538,6,10,0.6,1,3,0.333,0,0,,3,4,7,5,3,2,0,0,15,19.9
Mason Plumlee,26-306,C-F,1/5/17,POR,LAL,1,31,6,7,0.857,6,7,0.857,0,0,,3,8,0.375,1,6,7,5,1,1,2,6,15,13.8
Nik Stauskas,23-040,G,11/16/16,PHI,WAS,0,25,6,8,0.75,4,5,0.8,2,3,0.667,1,2,0.5,0,1,1,2,1,0,1,1,15,12.7
Cody Zeller,24-082,F-C,12/26/16,CHO,BRK,1,29,7,11,0.636,7,11,0.636,0,0,,1,2,0.5,3,6,9,2,1,0,0,5,15,14
Bradley Beal,23-130,G,11/5/16,WAS,ORL,1,33,6,17,0.353,5,12,0.417,1,5,0.2,2,2,1,2,2,4,3,1,1,0,5,15,9.3
James Johnson,29-277,F,11/23/16,MIA,DET,0,35,3,6,0.5,1,2,0.5,2,4,0.5,7,8,0.875,0,4,4,2,2,2,2,4,15,14
Chris Paul,31-296,G,2/26/17,LAC,CHO,1,41,4,18,0.222,2,12,0.167,2,6,0.333,5,6,0.833,0,9,9,17,1,0,0,3,15,18
Nick Young,31-233,G-F,1/20/17,LAL,IND,1,26,5,13,0.385,0,2,0,5,11,0.455,0,0,,1,2,3,1,1,0,1,3,15,8.7
Enes Kanter,24-304,C,3/20/17,OKC,GSW,0,25,6,16,0.375,6,15,0.4,0,1,0,3,4,0.75,6,4,10,0,0,0,0,1,15,10.8
Patrick Beverley,28-228,G,2/25/17,HOU,MIN,1,29,4,10,0.4,1,3,0.333,3,7,0.429,4,5,0.8,1,3,4,7,3,1,0,4,15,17.8
James Johnson,30-047,F,4/8/17,MIA,WAS,1,37,6,14,0.429,6,11,0.545,0,3,0,3,4,0.75,2,9,11,5,1,1,4,4,15,10.9
Goran Dragic,30-299,G,3/1/17,MIA,PHI,1,23,6,13,0.462,5,10,0.5,1,3,0.333,2,3,0.667,0,2,2,2,3,0,2,4,15,9.3
Jahlil Okafor,20-328,C-F,11/7/16,PHI,UTA,0,22,7,14,0.5,7,14,0.5,0,0,,1,2,0.5,2,2,4,1,0,1,2,4,15,7.4
Jrue Holiday,26-163,G,11/22/16,NOP,ATL,0,27,7,15,0.467,7,12,0.583,0,3,0,1,1,1,0,4,4,4,2,1,3,1,15,10.6
Jamal Crawford,36-248,G,11/23/16,LAC,DAL,0,28,5,12,0.417,2,5,0.4,3,7,0.429,2,2,1,0,2,2,2,1,0,0,1,15,11.2
Jahlil Okafor,20-349,C-F,11/28/16,PHI,TOR,1,25,7,14,0.5,7,14,0.5,0,0,,1,2,0.5,3,2,5,0,0,1,0,1,15,10.6
Alec Burks,25-192,G,1/28/17,UTA,MEM,0,16,4,5,0.8,2,3,0.667,2,2,1,5,6,0.833,0,2,2,0,0,0,5,3,15,7.1
Jerami Grant,22-282,F,12/19/16,OKC,ATL,0,28,5,7,0.714,2,4,0.5,3,3,1,2,2,1,0,1,1,0,1,0,0,1,15,13
Rudy Gobert,24-243,C,2/24/17,UTA,MIL,1,33,5,7,0.714,5,7,0.714,0,0,,5,7,0.714,4,12,16,2,0,3,4,3,15,16
Jabari Parker,21-309,F,1/18/17,MIL,HOU,1,31,5,15,0.333,5,13,0.385,0,2,0,5,7,0.714,2,4,6,2,0,1,2,2,15,7.6
Ben McLemore,24-060,G,4/12/17,SAC,LAC,0,31,6,13,0.462,5,10,0.5,1,3,0.333,2,4,0.5,1,6,7,1,1,0,0,5,15,9.7
Pau Gasol,36-235,F-C,2/26/17,SAS,LAL,0,20,6,12,0.5,4,10,0.4,2,2,1,1,1,1,0,7,7,0,1,1,0,2,15,12
Dewayne Dedmon,27-148,C,1/7/17,SAS,CHO,0,23,6,6,1,6,6,1,0,0,,3,4,0.75,1,9,10,1,2,1,0,5,15,17.6
Dirk Nowitzki,38-159,F,11/25/16,DAL,CLE,1,27,7,18,0.389,6,13,0.462,1,5,0.2,0,0,,1,5,6,3,0,0,1,3,15,7.3
Otto Porter,23-166,F,11/16/16,WAS,PHI,1,41,5,17,0.294,3,12,0.25,2,5,0.4,3,4,0.75,5,8,13,1,4,1,0,2,15,15.2
Malcolm Brogdon,24-077,G,2/26/17,MIL,PHO,0,24,6,9,0.667,5,6,0.833,1,3,0.333,2,2,1,0,0,0,7,2,0,2,3,15,14.8
Jordan Crawford,28-171,G,4/12/17,NOP,POR,0,23,6,12,0.5,3,8,0.375,3,4,0.75,0,0,,0,1,1,4,1,0,2,0,15,11.1
T.J. Warren,23-183,F,3/7/17,PHO,WAS,1,30,7,13,0.538,6,11,0.545,1,2,0.5,0,0,,1,9,10,3,0,0,0,4,15,12.6
E'Twaun Moore,27-296,G,12/20/16,NOP,PHI,0,18,6,7,0.857,4,4,1,2,3,0.667,1,1,1,0,0,0,2,0,0,0,3,15,12.7
Kyle Korver,35-263,G-F,12/5/16,ATL,OKC,0,32,5,10,0.5,2,4,0.5,3,6,0.5,2,2,1,0,2,2,1,2,0,1,2,15,11.5
Gerald Henderson,29-052,G,1/30/17,PHI,SAC,0,25,4,7,0.571,4,6,0.667,0,1,0,7,8,0.875,0,2,2,4,2,0,0,0,15,16.7
Karl-Anthony Towns,21-043,C-F,12/28/16,MIN,DEN,1,35,7,17,0.412,6,15,0.4,1,2,0.5,0,0,,5,6,11,10,0,2,3,1,15,16.2
D'Angelo Russell,20-304,G,12/23/16,LAL,ORL,1,30,6,15,0.4,5,11,0.455,1,4,0.25,2,2,1,1,1,2,3,2,1,3,4,15,8.1
E'Twaun Moore,27-351,G,2/13/17,NOP,PHO,0,24,6,11,0.545,6,9,0.667,0,2,0,3,3,1,0,0,0,1,2,0,0,5,15,10.4
Ersan Ilyasova,29-332,F,4/12/17,ATL,IND,1,18,6,10,0.6,5,7,0.714,1,3,0.333,2,2,1,0,3,3,2,1,0,3,2,15,9.9
Myles Turner,20-302,F-C,1/20/17,IND,LAL,1,33,6,12,0.5,6,10,0.6,0,2,0,3,3,1,0,5,5,2,3,1,5,3,15,9.4
C.J. Miles,29-345,G-F,3/29/17,IND,MEM,0,25,5,11,0.455,2,4,0.5,3,7,0.429,2,2,1,0,3,3,2,0,0,2,0,15,9.6
Wayne Ellington,29-084,G,1/21/17,MIA,MIL,0,35,6,12,0.5,3,3,1,3,9,0.333,0,0,,0,5,5,0,2,0,0,1,15,12.1
Jeff Teague,28-300,G,4/6/17,IND,MIL,1,29,5,12,0.417,5,8,0.625,0,4,0,5,6,0.833,0,2,2,7,0,0,1,1,15,12.3
Gorgui Dieng,26-354,C,1/6/17,MIN,WAS,1,40,6,12,0.5,5,11,0.455,1,1,1,2,2,1,3,8,11,2,2,0,1,1,15,15.5
Julius Randle,22-038,F,1/6/17,LAL,MIA,1,25,6,9,0.667,6,9,0.667,0,0,,3,3,1,0,6,6,3,1,1,0,2,15,15.9
Jaylen Brown,20-126,F,2/27/17,BOS,ATL,0,26,6,10,0.6,4,6,0.667,2,4,0.5,1,3,0.333,1,4,5,1,1,0,0,1,15,12.8
James Jones,36-071,F-G,12/14/16,CLE,MEM,0,25,5,8,0.625,2,3,0.667,3,5,0.6,2,3,0.667,0,2,2,0,1,1,1,2,15,11.5
Jordan Clarkson,24-188,G,12/12/16,LAL,SAC,0,22,4,11,0.364,3,9,0.333,1,2,0.5,6,6,1,1,1,2,4,1,0,1,2,15,11.9
Maurice Harkless,23-216,F-G,12/13/16,POR,OKC,1,25,5,10,0.5,4,7,0.571,1,3,0.333,4,4,1,0,4,4,0,5,1,1,2,15,15.1
Kevin Durant,28-115,F-G,1/22/17,GSW,ORL,1,29,5,12,0.417,4,9,0.444,1,3,0.333,4,5,0.8,1,9,10,6,3,2,1,1,15,18.8
Harrison Barnes,24-210,F,12/26/16,DAL,NOP,1,37,6,14,0.429,5,12,0.417,1,2,0.5,2,2,1,0,7,7,1,0,0,2,1,15,8
Elfrid Payton,22-277,G,11/25/16,ORL,WAS,1,26,6,12,0.5,6,11,0.545,0,1,0,3,4,0.75,2,3,5,5,0,0,2,4,15,10.8
Rudy Gobert,24-245,C,2/26/17,UTA,WAS,1,36,2,4,0.5,2,4,0.5,0,0,,11,14,0.786,3,16,19,3,1,4,4,3,15,19.4
Austin Rivers,24-120,G,11/29/16,LAC,BRK,0,26,5,9,0.556,3,5,0.6,2,4,0.5,3,5,0.6,1,1,2,2,0,0,1,1,15,10.9
Lou Williams,30-162,G,4/7/17,HOU,DET,0,22,4,8,0.5,3,4,0.75,1,4,0.25,6,6,1,0,2,2,0,0,0,1,0,15,10.6
Cody Zeller,24-170,F-C,3/24/17,CHO,CLE,1,32,6,6,1,6,6,1,0,0,,3,7,0.429,5,6,11,3,1,2,0,1,15,21
Caris LeVert,22-208,G-F,3/21/17,BRK,DET,1,25,5,8,0.625,2,4,0.5,3,4,0.75,2,2,1,0,1,1,1,1,0,0,1,15,13
Arron Afflalo,31-027,G,11/11/16,SAC,POR,1,32,5,9,0.556,5,8,0.625,0,1,0,5,6,0.833,1,1,2,0,0,0,0,1,15,10.9
Clint Capela,22-322,F-C,4/5/17,HOU,DEN,1,24,7,10,0.7,7,10,0.7,0,0,,1,3,0.333,5,6,11,1,0,0,2,3,15,12.8
Al-Farouq Aminu,26-188,F,3/28/17,POR,DEN,0,28,4,7,0.571,3,5,0.6,1,2,0.5,6,9,0.667,4,5,9,1,0,1,1,0,15,15.2
Iman Shumpert,26-204,G,1/16/17,CLE,GSW,1,30,5,10,0.5,3,5,0.6,2,5,0.4,3,4,0.75,0,9,9,0,3,0,1,0,15,14.3
Reggie Bullock,25-308,G-F,1/18/17,DET,ATL,1,36,6,11,0.545,4,6,0.667,2,5,0.4,1,2,0.5,3,3,6,4,1,0,2,3,15,12.9
Kelly Oubre,21-116,F,4/4/17,WAS,CHO,0,25,4,7,0.571,1,2,0.5,3,5,0.6,4,4,1,1,4,5,1,0,0,1,4,15,11.7
Evan Turner,28-042,G,12/8/16,POR,MEM,1,30,4,9,0.444,4,8,0.5,0,1,0,7,8,0.875,2,8,10,2,0,0,1,2,15,13.3
Steven Adams,23-201,C,2/6/17,OKC,IND,1,37,6,13,0.462,6,13,0.462,0,0,,3,4,0.75,7,2,9,2,0,1,3,3,15,11.3
Ty Lawson,29-118,G,3/1/17,SAC,BRK,0,32,7,11,0.636,6,9,0.667,1,2,0.5,0,0,,1,2,3,9,0,0,4,5,15,11.7
Justin Holiday,27-254,G,12/15/16,NYK,GSW,0,23,5,8,0.625,3,4,0.75,2,4,0.5,3,4,0.75,0,2,2,3,6,1,1,1,15,19
Fred VanVleet,22-344,G,2/3/17,TOR,ORL,0,23,5,12,0.417,3,8,0.375,2,4,0.5,3,3,1,1,2,3,3,1,0,2,2,15,10.2
Blake Griffin,28-009,F,3/25/17,LAC,UTA,1,33,6,16,0.375,5,11,0.455,1,5,0.2,2,2,1,0,6,6,1,3,0,0,2,15,10.9
Ricky Rubio,26-138,G,3/8/17,MIN,LAC,1,33,5,12,0.417,4,7,0.571,1,5,0.2,4,4,1,0,6,6,12,2,0,2,5,15,16.8
Kyle Lowry,30-226,G,11/6/16,TOR,SAC,1,39,5,16,0.313,2,6,0.333,3,10,0.3,2,3,0.667,1,3,4,10,2,1,0,3,15,15.5
Maurice Ndour,24-293,F,4/7/17,NYK,MEM,1,29,7,9,0.778,7,9,0.778,0,0,,1,2,0.5,2,5,7,0,1,3,1,1,15,15.7
Bojan Bogdanovic,27-216,G-F,11/20/16,BRK,POR,1,24,6,11,0.545,5,8,0.625,1,3,0.333,2,2,1,0,2,2,1,0,0,0,2,15,10.2
Iman Shumpert,26-258,G,3/11/17,CLE,ORL,1,31,5,7,0.714,2,3,0.667,3,4,0.75,2,2,1,1,3,4,2,0,0,1,3,15,12.9
Jeff Teague,28-248,G,2/13/17,IND,SAS,1,30,6,8,0.75,5,7,0.714,1,1,1,2,3,0.667,1,4,5,5,0,1,2,1,15,15.1
D.J. Augustin,29-027,G,12/7/16,ORL,BOS,1,24,4,7,0.571,0,1,0,4,6,0.667,3,4,0.75,0,1,1,2,0,0,1,4,15,10.4
Myles Turner,20-224,F-C,11/3/16,IND,MIL,1,24,6,9,0.667,5,7,0.714,1,2,0.5,2,2,1,1,1,2,1,2,0,2,5,15,10.8
Jon Leuer,27-175,F,11/5/16,DET,DEN,0,28,6,10,0.6,5,8,0.625,1,2,0.5,2,2,1,2,1,3,3,1,1,0,2,15,15.1
Buddy Hield,22-359,G,12/10/16,NOP,LAC,1,36,6,13,0.462,4,8,0.5,2,5,0.4,1,1,1,0,3,3,5,0,0,2,0,15,10.7
D.J. Augustin,29-111,G,3/1/17,ORL,NYK,0,27,4,8,0.5,2,3,0.667,2,5,0.4,5,5,1,1,3,4,1,0,0,0,2,15,12.5
Nicolas Batum,27-355,F-G,12/3/16,CHO,MIN,1,41,6,15,0.4,3,6,0.5,3,9,0.333,0,3,0,2,6,8,12,3,1,3,1,15,17.6
Brandon Bass,31-320,F,3/16/17,LAC,DEN,0,24,6,8,0.75,6,8,0.75,0,0,,3,5,0.6,1,3,4,0,1,1,0,0,15,14.3
Shelvin Mack,26-236,G,12/14/16,UTA,OKC,0,29,5,6,0.833,2,3,0.667,3,3,1,2,2,1,1,4,5,5,1,0,5,1,15,13.8
Rajon Rondo,31-003,G,2/25/17,CHI,CLE,0,25,6,12,0.5,6,10,0.6,0,2,0,3,4,0.75,1,1,2,5,2,0,1,2,15,13.3
Zaza Pachulia,32-316,C,12/22/16,GSW,BRK,1,26,6,9,0.667,6,9,0.667,0,0,,3,4,0.75,7,7,14,4,0,1,1,4,15,18.6
Shabazz Muhammad,23-358,F-G,11/5/16,MIN,OKC,0,21,6,9,0.667,6,9,0.667,0,0,,3,3,1,3,1,4,0,0,1,1,1,15,12.8
Clint Capela,22-187,F-C,11/21/16,HOU,DET,1,35,7,10,0.7,7,10,0.7,0,0,,1,2,0.5,4,8,12,2,0,2,2,5,15,14.4
Nikola Vucevic,26-100,C,2/1/17,ORL,IND,1,38,6,15,0.4,6,13,0.462,0,2,0,3,6,0.5,4,11,15,5,2,0,3,2,15,13.5
DeMarcus Cousins,26-218,C-F,3/19/17,NOP,MIN,1,31,7,14,0.5,6,9,0.667,1,5,0.2,0,0,,1,10,11,4,3,0,4,4,15,11.9
Cody Zeller,24-021,F-C,10/26/16,CHO,MIL,0,14,5,6,0.833,5,6,0.833,0,0,,5,6,0.833,1,2,3,1,0,2,1,5,15,12.8
James Harden,27-156,G,1/29/17,HOU,IND,1,32,3,17,0.176,1,7,0.143,2,10,0.2,7,7,1,1,4,5,8,3,0,8,5,15,4.8
Pau Gasol,36-157,F-C,12/10/16,SAS,BRK,1,25,6,13,0.462,5,12,0.417,1,1,1,2,3,0.667,0,5,5,4,0,1,3,5,15,7.9
Derrick Favors,25-176,F-C,1/7/17,UTA,MIN,1,34,7,12,0.583,6,10,0.6,1,2,0.5,0,0,,0,6,6,1,3,2,0,2,15,15.5
Jonathon Simmons,27-073,G-F,11/26/16,SAS,WAS,0,23,5,6,0.833,4,4,1,1,2,0.5,4,4,1,1,0,1,4,2,1,2,5,15,15
Joe Johnson,35-205,G-F,1/20/17,UTA,DAL,0,31,7,11,0.636,6,8,0.75,1,3,0.333,0,0,,2,3,5,1,0,1,1,1,15,12.4
Cameron Payne,22-185,G,2/9/17,OKC,CLE,0,13,6,12,0.5,3,7,0.429,3,5,0.6,0,0,,0,1,1,2,1,0,0,3,15,10.5
Kevin Love,28-086,F,12/2/16,CLE,CHI,1,42,5,14,0.357,2,7,0.286,3,7,0.429,2,3,0.667,0,9,9,3,1,1,3,3,15,9.1
E'Twaun Moore,27-253,G,11/7/16,NOP,GSW,1,31,6,11,0.545,5,8,0.625,1,3,0.333,2,2,1,1,2,3,5,0,0,3,2,15,10.7
Kevin Durant,28-077,F-G,12/15/16,GSW,NYK,1,33,7,18,0.389,6,12,0.5,1,6,0.167,0,0,,1,13,14,8,0,2,2,1,15,14.4
Gary Harris,22-136,G,1/28/17,DEN,PHO,1,35,6,15,0.4,5,9,0.556,1,6,0.167,2,3,0.667,1,6,7,4,2,0,0,4,15,12.2
Kenneth Faried,27-068,F,1/26/17,DEN,PHO,1,21,5,8,0.625,5,8,0.625,0,0,,5,5,1,4,2,6,0,1,0,1,1,15,14.4
Brandon Ingram,19-221,F,4/11/17,LAL,NOP,1,28,6,16,0.375,6,14,0.429,0,2,0,3,5,0.6,3,2,5,6,2,0,1,1,15,12.9
Randy Foye,33-139,G,2/10/17,BRK,MIA,1,26,5,9,0.556,4,7,0.571,1,2,0.5,4,4,1,1,0,1,2,0,0,4,1,15,8.4
J.R. Smith,31-053,G-F,11/1/16,CLE,HOU,1,34,5,12,0.417,0,1,0,5,11,0.455,0,0,,0,3,3,2,0,0,0,3,15,9.7
Justise Winslow,20-229,F,11/10/16,MIA,CHI,1,38,6,11,0.545,3,6,0.5,3,5,0.6,0,0,,1,4,5,6,4,0,2,4,15,16.2
Patrick Patterson,27-287,F,12/26/16,TOR,POR,0,31,5,12,0.417,0,1,0,5,11,0.455,0,0,,3,5,8,0,0,0,1,1,15,10.8
Patty Mills,28-117,G,12/6/16,SAS,MIN,0,27,6,13,0.462,4,6,0.667,2,7,0.286,1,1,1,1,3,4,5,2,0,2,1,15,13
Victor Oladipo,24-214,G,12/4/16,OKC,NOP,1,35,6,15,0.4,5,7,0.714,1,8,0.125,2,7,0.286,0,5,5,4,1,0,0,0,15,10.2
Chris Paul,31-215,G,12/7/16,LAC,GSW,1,32,7,14,0.5,6,8,0.75,1,6,0.167,0,0,,1,5,6,5,1,0,2,4,15,11.1
Jason Terry,39-207,G,4/10/17,MIL,CHO,0,21,5,7,0.714,0,0,,5,7,0.714,0,0,,0,5,5,1,1,1,1,2,15,14.2
Klay Thompson,26-282,G,11/16/16,GSW,TOR,1,32,4,15,0.267,1,4,0.25,3,11,0.273,4,4,1,1,3,4,1,0,1,0,1,15,8.7
Trevor Booker,29-072,F,2/5/17,BRK,TOR,0,26,7,13,0.538,6,12,0.5,1,1,1,0,2,0,2,8,10,2,3,0,1,3,15,13.9
Richaun Holmes,23-137,F-C,3/1/17,PHI,MIA,0,26,7,10,0.7,7,9,0.778,0,1,0,1,1,1,1,5,6,0,1,1,2,2,15,11.9
Jahlil Okafor,20-354,C-F,12/3/16,PHI,BOS,1,33,6,9,0.667,6,9,0.667,0,0,,3,4,0.75,0,4,4,3,1,1,2,5,15,11.7
Kemba Walker,26-232,G,12/26/16,CHO,BRK,1,35,6,17,0.353,5,12,0.417,1,5,0.2,2,2,1,0,3,3,6,2,0,3,3,15,8.4
Matt Barnes,36-252,F,11/16/16,SAC,SAS,0,28,6,9,0.667,4,5,0.8,2,4,0.5,1,2,0.5,1,1,2,2,1,1,2,4,15,11.2
Patty Mills,28-214,G,3/13/17,SAS,ATL,1,37,5,13,0.385,2,6,0.333,3,7,0.429,2,3,0.667,0,2,2,9,2,0,0,2,15,15.6
Rudy Gobert,24-190,C,1/2/17,UTA,BRK,1,38,5,10,0.5,5,10,0.5,0,0,,5,9,0.556,7,9,16,2,1,3,2,4,15,16.9
Tyler Johnson,24-328,G,3/31/17,MIA,NYK,0,27,6,12,0.5,5,10,0.5,1,2,0.5,2,5,0.4,3,0,3,2,1,0,1,2,15,10.5
Wesley Matthews,30-156,G,3/19/17,DAL,BRK,1,36,5,9,0.556,3,6,0.5,2,3,0.667,3,5,0.6,0,5,5,3,1,0,2,4,15,10.9
Mindaugas Kuzminskas,27-077,F,1/4/17,NYK,MIL,0,19,6,10,0.6,4,5,0.8,2,5,0.4,1,2,0.5,2,2,4,1,2,1,1,3,15,13.2
Willie Cauley-Stein,23-199,F-C,3/5/17,SAC,UTA,1,39,6,12,0.5,6,12,0.5,0,0,,3,6,0.5,0,9,9,3,2,1,0,2,15,14.5
Boban Marjanovic,28-221,C,3/24/17,DET,ORL,0,12,5,7,0.714,5,7,0.714,0,0,,5,5,1,0,4,4,0,0,0,0,3,15,12.1
Rodney Hood,24-057,G-F,12/16/16,UTA,DAL,1,31,6,11,0.545,4,6,0.667,2,5,0.4,1,2,0.5,0,3,3,2,2,0,3,2,15,9.8
Michael Kidd-Gilchrist,23-068,F,12/3/16,CHO,MIN,1,30,4,7,0.571,4,7,0.571,0,0,,7,7,1,3,3,6,1,0,0,0,2,15,14.6
DeAndre Jordan,28-228,C,3/6/17,LAC,BOS,1,28,6,7,0.857,6,7,0.857,0,0,,3,16,0.188,3,9,12,0,0,2,0,1,15,13.1
Avery Bradley,26-006,G,12/2/16,BOS,SAC,1,35,6,13,0.462,4,9,0.444,2,4,0.5,1,1,1,2,7,9,2,2,0,1,1,15,13.8
Clint Capela,22-281,F-C,2/23/17,HOU,NOP,0,19,7,8,0.875,7,8,0.875,0,0,,1,2,0.5,2,6,8,0,0,3,2,5,15,13.1
Zach Randolph,35-205,F,2/6/17,MEM,SAS,0,23,6,13,0.462,6,13,0.462,0,0,,3,3,1,3,3,6,0,0,0,1,3,15,9.1
Al-Farouq Aminu,26-197,F,4/6/17,POR,MIN,1,40,4,11,0.364,1,4,0.25,3,7,0.429,4,7,0.571,0,7,7,0,2,1,2,1,15,10.1
Otto Porter,23-178,F,11/28/16,WAS,SAC,1,30,6,9,0.667,4,5,0.8,2,4,0.5,1,2,0.5,1,8,9,0,3,0,0,4,15,15.2
Nerlens Noel,22-351,C-F,3/27/17,DAL,OKC,1,28,6,12,0.5,6,12,0.5,0,0,,3,4,0.75,4,4,8,1,4,2,1,4,15,16.1
Danilo Gallinari,28-215,F,3/11/17,DEN,SAC,1,34,5,11,0.455,4,8,0.5,1,3,0.333,4,5,0.8,0,5,5,2,1,0,1,0,15,11.8
Dario Saric,22-280,F,1/13/17,PHI,CHO,0,21,5,10,0.5,1,4,0.25,4,6,0.667,1,2,0.5,4,2,6,2,1,0,4,0,15,11.4
Nick Young,31-238,G-F,1/25/17,LAL,POR,1,30,5,10,0.5,2,4,0.5,3,6,0.5,2,2,1,0,4,4,0,0,0,1,3,15,9
Jodie Meeks,29-215,G,3/24/17,ORL,DET,0,21,6,12,0.5,3,8,0.375,3,4,0.75,0,0,,1,1,2,0,0,0,0,0,15,10
Joe Johnson,35-201,G-F,1/16/17,UTA,PHO,0,24,5,9,0.556,2,5,0.4,3,4,0.75,2,2,1,1,3,4,1,0,0,0,0,15,13
Hassan Whiteside,27-261,C,3/1/17,MIA,PHI,1,22,6,9,0.667,6,9,0.667,0,0,,3,4,0.75,3,8,11,3,1,4,3,1,15,17.7
Jerian Grant,24-179,G,4/6/17,CHI,PHI,1,31,5,10,0.5,4,6,0.667,1,4,0.25,4,4,1,0,8,8,5,2,0,1,2,15,16.1
Mike Conley,29-032,G,11/12/16,MEM,MIL,1,30,3,10,0.3,2,4,0.5,1,6,0.167,8,8,1,0,4,4,3,1,0,3,1,15,10.1
JaMychal Green,26-211,F,1/18/17,MEM,WAS,1,34,6,7,0.857,4,5,0.8,2,2,1,1,2,0.5,2,11,13,1,1,0,0,4,15,16.9
Nicolas Batum,28-073,F-G,2/25/17,CHO,SAC,1,34,4,17,0.235,3,11,0.273,1,6,0.167,6,6,1,0,6,6,3,1,1,1,0,15,9.3
Serge Ibaka,27-120,F-C,1/16/17,ORL,DEN,1,30,6,12,0.5,3,5,0.6,3,7,0.429,0,0,,0,4,4,0,1,0,3,1,15,7.8
Luc Mbah a Moute,30-064,F,11/12/16,LAC,MIN,1,34,6,8,0.75,4,5,0.8,2,3,0.667,1,1,1,1,0,1,0,1,1,0,2,15,13.4
Andrew Wiggins,22-018,F-G,3/13/17,MIN,WAS,1,39,5,15,0.333,4,13,0.308,1,2,0.5,4,6,0.667,0,5,5,1,0,1,1,3,15,6.4
Emmanuel Mudiay,21-030,G,4/4/17,DEN,NOP,0,29,5,15,0.333,3,11,0.273,2,4,0.5,3,5,0.6,0,0,0,7,0,0,1,2,15,8.8
Kent Bazemore,27-241,G-F,2/27/17,ATL,BOS,1,26,7,13,0.538,6,10,0.6,1,3,0.333,0,0,,1,3,4,0,1,1,2,2,15,9.2
Tim Hardaway,24-244,G,11/15/16,ATL,MIA,0,24,6,10,0.6,5,6,0.833,1,4,0.25,2,3,0.667,1,1,2,1,2,0,0,0,15,13.7
David Lee,33-269,F,1/23/17,SAS,BRK,0,25,7,13,0.538,7,13,0.538,0,0,,1,2,0.5,4,3,7,2,1,0,1,2,15,12.6
Jae Crowder,26-161,F,12/14/16,BOS,SAS,1,36,5,12,0.417,2,4,0.5,3,8,0.375,2,3,0.667,1,5,6,2,1,1,1,3,15,11.3
Rudy Gobert,24-216,C,1/28/17,UTA,MEM,1,38,3,5,0.6,3,5,0.6,0,0,,9,9,1,3,7,10,2,1,1,1,4,15,17.4
Justise Winslow,20-265,F,12/16/16,MIA,LAC,0,29,6,12,0.5,5,11,0.455,1,1,1,2,4,0.5,2,2,4,0,1,0,1,2,15,9.4
Clint Capela,22-183,F-C,11/17/16,HOU,POR,1,27,7,9,0.778,7,9,0.778,0,0,,1,2,0.5,2,5,7,1,1,2,3,3,15,12.9
Lou Williams,30-155,G,3/31/17,HOU,GSW,0,34,5,12,0.417,5,10,0.5,0,2,0,5,5,1,3,4,7,2,1,0,0,0,15,14.3
Eric Gordon,28-001,G,12/26/16,HOU,PHO,0,28,5,13,0.385,2,5,0.4,3,8,0.375,2,2,1,0,3,3,5,1,0,3,2,15,9.5
Enes Kanter,24-324,C,4/9/17,OKC,DEN,0,17,6,13,0.462,6,13,0.462,0,0,,3,5,0.6,6,2,8,1,0,0,2,1,15,10.6
Derrick Rose,28-031,G,11/4/16,NYK,CHI,1,38,6,16,0.375,6,16,0.375,0,0,,3,3,1,0,7,7,11,1,1,3,2,15,13.9
Lou Williams,30-087,G,1/22/17,LAL,DAL,0,20,4,11,0.364,3,5,0.6,1,6,0.167,6,6,1,0,0,0,1,1,0,2,2,15,7.8
Julius Randle,21-347,F,11/10/16,LAL,SAC,1,26,4,10,0.4,4,9,0.444,0,1,0,7,7,1,1,7,8,5,0,1,2,2,15,13.8
Kris Dunn,22-263,G,12/6/16,MIN,SAS,0,17,6,7,0.857,5,6,0.833,1,1,1,2,2,1,1,0,1,2,0,0,2,3,15,11.4
Nikola Vucevic,26-082,C,1/14/17,ORL,UTA,1,33,7,15,0.467,6,12,0.5,1,3,0.333,0,0,,2,6,8,3,3,0,4,4,15,10
Greg Monroe,26-186,C-F,12/7/16,MIL,POR,0,23,5,7,0.714,5,7,0.714,0,0,,5,8,0.625,0,4,4,1,3,0,1,0,15,14.8
Jeff Green,30-067,F,11/3/16,ORL,SAC,0,19,5,9,0.556,2,5,0.4,3,4,0.75,2,2,1,1,2,3,0,0,0,1,0,15,11
Wesley Matthews,30-118,G,2/9/17,DAL,UTA,1,42,6,10,0.6,5,7,0.714,1,3,0.333,2,2,1,0,6,6,5,1,0,2,3,15,13.5
Blake Griffin,27-360,F,3/11/17,LAC,PHI,1,35,5,12,0.417,5,10,0.5,0,2,0,5,5,1,3,7,10,6,3,0,4,2,15,15.2
JaVale McGee,28-339,C,12/23/16,GSW,DET,0,9,6,7,0.857,6,7,0.857,0,0,,3,3,1,0,3,3,0,0,1,1,3,15,11.9
Taj Gibson,31-149,F,11/20/16,CHI,LAL,1,32,7,12,0.583,7,12,0.583,0,0,,1,3,0.333,3,4,7,3,1,1,6,5,15,7.7
Tim Hardaway,24-262,G,12/3/16,ATL,TOR,0,23,6,10,0.6,3,4,0.75,3,6,0.5,0,2,0,0,1,1,1,1,1,2,2,15,9.5
Hassan Whiteside,27-263,C,3/3/17,MIA,ORL,1,35,5,10,0.5,5,10,0.5,0,0,,5,6,0.833,1,17,18,0,0,1,1,2,15,14.3
Myles Turner,20-353,F-C,3/12/17,IND,MIA,1,30,4,14,0.286,4,11,0.364,0,3,0,7,7,1,5,3,8,1,0,1,1,3,15,10.4
Pau Gasol,36-276,F-C,4/8/17,SAS,LAC,0,27,4,8,0.5,3,5,0.6,1,3,0.333,6,7,0.857,1,6,7,1,0,1,1,2,15,12.7
Courtney Lee,31-130,G,2/10/17,NYK,DEN,1,31,6,10,0.6,3,3,1,3,7,0.429,0,0,,0,3,3,4,2,0,2,5,15,12.1
Josh Richardson,23-065,G,11/19/16,MIA,WAS,1,34,4,8,0.5,0,2,0,4,6,0.667,3,5,0.6,1,6,7,1,1,1,1,1,15,13.7
Harrison Barnes,24-172,F,11/18/16,DAL,MEM,1,34,5,17,0.294,5,16,0.313,0,1,0,5,5,1,1,6,7,0,0,0,4,0,15,3.6
Kentavious Caldwell-Pope,23-258,G,11/2/16,DET,BRK,1,37,4,14,0.286,2,6,0.333,2,8,0.25,5,5,1,2,5,7,2,4,0,3,4,15,10.5
Raymond Felton,32-204,G,1/16/17,LAC,OKC,0,27,7,7,1,7,7,1,0,0,,1,2,0.5,0,3,3,6,1,1,2,1,15,16.9
Will Barton,25-336,G,12/7/16,DEN,BRK,1,39,6,15,0.4,5,6,0.833,1,9,0.111,2,2,1,3,6,9,2,2,1,6,4,15,7.3
Boban Marjanovic,28-143,C,1/5/17,DET,CHO,0,22,3,4,0.75,3,4,0.75,0,0,,9,11,0.818,9,10,19,0,0,1,3,0,15,19.6
Markieff Morris,27-126,F,1/6/17,WAS,MIN,1,36,6,13,0.462,5,10,0.5,1,3,0.333,2,2,1,0,6,6,1,0,0,1,4,15,8.2
Serge Ibaka,27-162,F-C,2/27/17,TOR,NYK,1,36,5,14,0.357,3,8,0.375,2,6,0.333,3,4,0.75,1,3,4,0,0,1,1,4,15,6.5
Skal Labissiere,20-355,F,3/8/17,SAC,SAS,0,15,7,10,0.7,7,10,0.7,0,0,,1,1,1,2,4,6,1,0,1,3,3,15,10.6
Trevor Booker,29-091,F,2/24/17,BRK,DEN,0,22,6,11,0.545,6,10,0.6,0,1,0,3,5,0.6,0,9,9,2,0,0,0,1,15,12.6
Jabari Parker,21-263,F,12/3/16,MIL,BRK,1,33,6,13,0.462,6,11,0.545,0,2,0,3,7,0.429,2,6,8,2,2,0,0,1,15,12.9
Joe Ingles,29-060,F-G,12/1/16,UTA,MIA,0,22,6,8,0.75,3,4,0.75,3,4,0.75,0,0,,0,4,4,4,0,0,0,2,15,15
Tyler Johnson,24-221,G,12/14/16,MIA,IND,0,33,6,13,0.462,5,8,0.625,1,5,0.2,2,4,0.5,1,4,5,3,0,4,0,2,15,13.5
Ricky Rubio,26-112,G,2/10/17,MIN,NOP,1,39,5,10,0.5,4,7,0.571,1,3,0.333,4,6,0.667,0,1,1,12,4,0,4,2,15,17.1
Marcin Gortat,33-022,C-F,3/11/17,WAS,POR,1,34,6,8,0.75,6,8,0.75,0,0,,3,6,0.5,4,11,15,1,0,0,0,3,15,16.2
Roy Hibbert,29-320,C,10/26/16,CHO,MIL,1,32,6,9,0.667,6,9,0.667,0,0,,3,3,1,4,6,10,3,0,5,2,4,15,17.7
Tony Allen,35-014,G-F,1/25/17,MEM,TOR,1,35,7,14,0.5,6,12,0.5,1,2,0.5,0,1,0,3,8,11,1,0,2,2,3,15,11
Marcus Morris,27-115,F,12/26/16,DET,CLE,1,36,6,15,0.4,3,9,0.333,3,6,0.5,0,0,,0,4,4,2,3,0,1,2,15,10.7
Marreese Speights,29-093,C-F,11/5/16,LAC,SAS,0,18,4,8,0.5,3,5,0.6,1,3,0.333,6,6,1,2,6,8,1,0,0,0,2,15,14.1
Evan Fournier,24-133,G-F,3/11/17,ORL,CLE,1,32,4,10,0.4,2,5,0.4,2,5,0.4,5,6,0.833,0,1,1,2,2,0,0,2,15,12.1
Alex Len,23-244,C,2/15/17,PHO,LAL,0,23,5,10,0.5,5,10,0.5,0,0,,5,6,0.833,3,6,9,2,0,2,6,6,15,7.9
Jameer Nelson,34-310,G,12/15/16,DEN,POR,0,26,6,11,0.545,5,9,0.556,1,2,0.5,2,2,1,0,0,0,3,1,0,1,3,15,10.6
Anthony Davis,24-003,F-C,3/14/17,NOP,POR,1,29,5,15,0.333,5,15,0.333,0,0,,5,6,0.833,3,11,14,2,2,3,0,1,15,16.6
Yogi Ferrell,23-273,G,2/6/17,DAL,DEN,1,35,4,11,0.364,2,6,0.333,2,5,0.4,5,5,1,0,2,2,5,2,1,2,0,15,13.7
Elfrid Payton,22-353,G,2/9/17,ORL,PHI,0,26,7,11,0.636,7,9,0.778,0,2,0,1,2,0.5,0,1,1,3,1,0,2,1,15,10.7
Marcin Gortat,32-349,C-F,1/31/17,WAS,NYK,1,31,7,7,1,7,7,1,0,0,,1,1,1,0,10,10,2,1,1,1,3,15,16.8
Raymond Felton,32-202,G,1/14/17,LAC,LAL,0,25,7,11,0.636,6,9,0.667,1,2,0.5,0,0,,0,2,2,4,0,1,0,1,15,13.8
Patrick Beverley,28-151,G,12/10/16,HOU,DAL,1,29,5,7,0.714,1,1,1,4,6,0.667,1,2,0.5,1,6,7,2,1,0,1,4,15,14
Cody Zeller,24-168,F-C,3/22/17,CHO,ORL,1,29,7,10,0.7,7,10,0.7,0,0,,1,1,1,4,2,6,2,3,0,2,4,15,15
Tyler Johnson,24-330,G,4/2/17,MIA,DEN,0,30,4,14,0.286,1,10,0.1,3,4,0.75,4,5,0.8,0,3,3,5,0,1,1,2,15,9.7
David Lee,33-210,F,11/25/16,SAS,BOS,0,18,6,9,0.667,6,9,0.667,0,0,,3,3,1,7,5,12,3,0,0,3,0,15,16.6
Evan Turner,28-031,G,11/27/16,POR,HOU,0,23,6,12,0.5,4,8,0.5,2,4,0.5,1,2,0.5,0,6,6,2,0,0,1,2,15,10
Ish Smith,28-220,G,2/10/17,DET,SAS,0,19,6,9,0.667,5,8,0.625,1,1,1,2,2,1,0,3,3,4,0,2,2,0,15,14.2
Aaron Gordon,21-052,F,11/7/16,ORL,CHI,1,30,6,15,0.4,5,11,0.455,1,4,0.25,2,2,1,1,3,4,4,1,1,1,2,15,11.2
Josh Richardson,23-209,G,4/12/17,MIA,WAS,1,37,6,12,0.5,3,6,0.5,3,6,0.5,0,0,,0,2,2,1,0,1,1,2,15,9.2
Bojan Bogdanovic,27-242,G-F,12/16/16,BRK,ORL,1,30,5,14,0.357,2,7,0.286,3,7,0.429,2,2,1,0,3,3,1,1,0,2,5,15,5.8
Jon Leuer,27-298,F,3/8/17,DET,IND,1,27,7,13,0.538,6,10,0.6,1,3,0.333,0,0,,1,3,4,1,0,0,3,1,15,7.6
Marcus Smart,22-253,G,11/14/16,BOS,NOP,1,37,6,12,0.5,3,6,0.5,3,6,0.5,0,0,,2,4,6,3,4,0,2,1,15,15.3
Dion Waiters,25-081,G,3/1/17,MIA,PHI,1,24,7,12,0.583,7,11,0.636,0,1,0,1,2,0.5,0,4,4,2,0,0,4,0,15,7.6
Maurice Harkless,23-304,F-G,3/11/17,POR,WAS,1,33,7,12,0.583,6,9,0.667,1,3,0.333,0,1,0,3,2,5,2,0,0,0,1,15,12.7
Iman Shumpert,26-140,G,11/13/16,CLE,CHO,0,32,6,9,0.667,3,4,0.75,3,5,0.6,0,0,,1,2,3,2,0,1,3,0,15,11.5
Danilo Gallinari,28-152,F,1/7/17,DEN,OKC,1,35,5,18,0.278,5,14,0.357,0,4,0,5,5,1,0,7,7,0,1,0,0,4,15,5.9
Glenn Robinson,22-327,G-F,11/30/16,IND,POR,1,34,6,10,0.6,4,6,0.667,2,4,0.5,1,1,1,0,4,4,1,1,0,0,3,15,12.1
Zach LaVine,21-247,G,11/12/16,MIN,LAC,1,40,7,15,0.467,6,10,0.6,1,5,0.2,0,0,,0,3,3,4,2,1,0,5,15,11.7
Eric Gordon,27-320,G,11/9/16,HOU,SAS,0,34,5,14,0.357,3,7,0.429,2,7,0.286,3,3,1,0,1,1,2,0,1,2,3,15,6.4
Terrence Ross,26-043,F-G,3/20/17,ORL,PHI,1,35,4,15,0.267,2,6,0.333,2,9,0.222,5,5,1,0,5,5,2,1,1,4,1,15,6.3
Anthony Tolliver,31-254,F-C,2/10/17,SAC,ATL,0,26,5,7,0.714,0,0,,5,7,0.714,0,0,,1,2,3,1,0,0,2,3,15,10.9
Solomon Hill,26-017,F,4/4/17,NOP,DEN,1,41,5,11,0.455,0,4,0,5,7,0.714,0,0,,2,2,4,0,1,1,0,4,15,11.4
Stephen Curry,28-286,G,12/25/16,GSW,CLE,1,37,4,11,0.364,2,4,0.5,2,7,0.286,5,6,0.833,0,3,3,3,3,0,3,4,15,9.9
Zach Randolph,35-270,F,4/12/17,MEM,DAL,0,20,7,14,0.5,7,13,0.538,0,1,0,1,1,1,1,4,5,2,0,0,2,2,15,8.5
Gorgui Dieng,26-313,C,11/26/16,MIN,GSW,1,38,7,12,0.583,6,10,0.6,1,2,0.5,0,0,,1,5,6,2,1,2,0,3,15,14.2
Draymond Green,26-291,F,12/20/16,GSW,UTA,1,31,6,11,0.545,4,6,0.667,2,5,0.4,1,2,0.5,0,11,11,4,5,0,2,3,15,17.2
Victor Oladipo,24-326,G,3/26/17,OKC,HOU,1,29,6,15,0.4,3,8,0.375,3,7,0.429,0,0,,0,4,4,4,2,0,2,2,15,10.1
Frank Kaminsky,23-306,F-C,2/4/17,CHO,UTA,1,32,6,15,0.4,3,9,0.333,3,6,0.5,0,0,,0,2,2,1,2,0,1,6,15,6.8
Terrence Jones,24-310,F,11/14/16,NOP,BOS,0,30,7,12,0.583,7,11,0.636,0,1,0,1,3,0.333,3,7,10,1,1,2,0,2,15,15.1
Markieff Morris,27-147,F,1/27/17,WAS,ATL,1,25,4,11,0.364,2,7,0.286,2,4,0.5,5,6,0.833,5,4,9,1,2,1,5,4,15,10
Terrence Ross,25-302,F-G,12/3/16,TOR,ATL,0,18,6,8,0.75,3,4,0.75,3,4,0.75,0,0,,0,1,1,2,0,0,0,0,15,13.5
Evan Fournier,24-146,G-F,3/24/17,ORL,DET,1,23,6,10,0.6,5,6,0.833,1,4,0.25,2,2,1,0,3,3,2,0,0,1,0,15,11.7
Wesley Matthews,30-065,G,12/18/16,DAL,SAC,1,35,6,13,0.462,3,5,0.6,3,8,0.375,0,0,,0,2,2,1,1,0,2,3,15,7.4
Danilo Gallinari,28-106,F,11/22/16,DEN,CHI,1,37,6,9,0.667,5,7,0.714,1,2,0.5,2,4,0.5,0,5,5,0,1,0,0,3,15,11.6
Andre Drummond,23-089,C,11/7/16,DET,LAC,1,25,6,10,0.6,6,10,0.6,0,0,,3,5,0.6,4,8,12,0,2,1,3,3,15,13.3
Darren Collison,29-184,G,2/23/17,SAC,DEN,1,32,5,13,0.385,3,10,0.3,2,3,0.667,3,3,1,0,4,4,10,2,1,1,1,15,17.4
Jordan Crawford,28-161,G,4/2/17,NOP,CHI,0,24,5,11,0.455,4,5,0.8,1,6,0.167,4,4,1,0,0,0,3,1,0,0,1,15,12
Jahlil Okafor,21-046,C-F,1/30/17,PHI,SAC,1,22,5,11,0.455,5,11,0.455,0,0,,5,6,0.833,3,1,4,2,0,0,1,2,15,10.9
Victor Oladipo,24-248,G,1/7/17,OKC,DEN,1,33,7,19,0.368,7,11,0.636,0,8,0,1,2,0.5,1,2,3,3,2,1,0,3,15,9
Jeremy Lin,28-222,G,4/2/17,BRK,ATL,1,31,5,10,0.5,3,6,0.5,2,4,0.5,3,4,0.75,1,5,6,6,0,0,3,1,15,12.6
Elfrid Payton,22-317,G,1/4/17,ORL,ATL,1,35,6,13,0.462,5,10,0.5,1,3,0.333,2,2,1,1,3,4,6,3,1,3,2,15,14
Cory Joseph,25-158,G,1/25/17,TOR,MEM,0,29,5,11,0.455,5,10,0.5,0,1,0,5,6,0.833,0,2,2,1,0,0,0,3,15,9
J.J. Redick,32-236,G,2/15/17,LAC,ATL,1,25,5,11,0.455,0,3,0,5,8,0.625,0,0,,0,1,1,0,1,0,0,3,15,9.4
Patty Mills,28-224,G,3/23/17,SAS,MEM,0,23,5,8,0.625,2,2,1,3,6,0.5,2,2,1,0,1,1,5,1,1,1,0,15,15.9
Danilo Gallinari,28-150,F,1/5/17,DEN,SAS,1,28,5,13,0.385,4,10,0.4,1,3,0.333,4,4,1,0,3,3,1,0,0,0,1,15,9.1
LaMarcus Aldridge,31-208,F-C,2/12/17,SAS,NYK,1,37,5,16,0.313,5,15,0.333,0,1,0,5,6,0.833,6,4,10,1,0,0,0,1,15,11.1
Bobby Brown,32-198,G,4/10/17,HOU,LAC,0,32,6,15,0.4,3,7,0.429,3,8,0.375,0,0,,0,0,0,9,1,0,1,0,15,13.2
Tyson Chandler,34-082,C,12/23/16,PHO,PHI,1,33,5,9,0.556,5,9,0.556,0,0,,5,8,0.625,3,9,12,1,0,0,1,4,15,12.4
Willie Cauley-Stein,23-226,F-C,4/1/17,SAC,MIN,1,27,5,9,0.556,5,9,0.556,0,0,,5,7,0.714,2,8,10,3,2,0,1,5,15,14.8
Robin Lopez,28-246,C,12/3/16,CHI,DAL,1,26,7,12,0.583,7,12,0.583,0,0,,1,2,0.5,5,2,7,0,0,1,2,4,15,10.2
LaMarcus Aldridge,31-230,F-C,3/6/17,SAS,HOU,1,37,4,10,0.4,4,10,0.4,0,0,,7,8,0.875,1,3,4,4,0,1,1,0,15,13.3
Willy Hernangomez,22-283,C,3/6/17,NYK,ORL,0,18,7,10,0.7,7,10,0.7,0,0,,0,0,,4,4,8,3,0,0,2,4,14,12.3
Marcus Morris,27-138,F,1/18/17,DET,ATL,1,36,5,13,0.385,4,7,0.571,1,6,0.167,3,4,0.75,1,9,10,7,0,0,0,3,14,13.6
Langston Galloway,25-124,G,4/12/17,SAC,LAC,1,42,4,11,0.364,2,9,0.222,2,2,1,4,4,1,1,3,4,6,1,0,2,2,14,11.9
Gary Harris,22-142,G,2/3/17,DEN,MIL,1,27,6,13,0.462,4,7,0.571,2,6,0.333,0,0,,0,2,2,2,2,0,1,4,14,8.7
Gordon Hayward,26-311,F-G,1/28/17,UTA,MEM,1,36,4,13,0.308,4,10,0.4,0,3,0,6,7,0.857,1,6,7,5,0,1,1,0,14,11.8
Marvin Williams,30-262,F,3/8/17,CHO,MIA,1,37,5,8,0.625,4,5,0.8,1,3,0.333,3,4,0.75,2,10,12,3,0,3,3,2,14,14.8
Jonathon Simmons,27-118,G-F,1/10/17,SAS,MIL,0,23,5,8,0.625,3,4,0.75,2,4,0.5,2,2,1,0,0,0,0,0,0,0,2,14,9.6
Marcus Morris,27-148,F,1/28/17,DET,MIA,1,36,7,11,0.636,7,9,0.778,0,2,0,0,1,0,0,2,2,2,1,0,2,2,14,8.9
Marcus Smart,22-357,G,2/26/17,BOS,DET,0,31,5,10,0.5,5,7,0.714,0,3,0,4,5,0.8,4,1,5,2,1,0,2,3,14,10.9
Al Horford,30-287,C-F,3/17/17,BOS,BRK,1,29,6,16,0.375,5,14,0.357,1,2,0.5,1,2,0.5,4,4,8,4,1,4,1,4,14,12.8
Mike Muscala,25-120,F-C,10/29/16,ATL,PHI,0,21,7,8,0.875,7,7,1,0,1,0,0,0,,1,4,5,2,1,2,0,3,14,15.7
Jahlil Okafor,20-326,C-F,11/5/16,PHI,CLE,0,23,7,11,0.636,7,11,0.636,0,0,,0,2,0,0,5,5,0,1,3,1,1,14,11.5
Michael Carter-Williams,25-092,G,1/10/17,CHI,WAS,1,29,4,12,0.333,4,10,0.4,0,2,0,6,7,0.857,0,7,7,2,2,0,3,1,14,8.9
Ersan Ilyasova,29-180,F,11/11/16,PHI,IND,0,24,4,6,0.667,1,1,1,3,5,0.6,3,3,1,2,9,11,2,0,0,0,2,14,16.1
Brandon Ingram,19-217,F,4/7/17,LAL,SAC,1,25,6,14,0.429,6,12,0.5,0,2,0,2,3,0.667,2,0,2,1,2,0,1,1,14,8.9
Jimmy Butler,27-182,G-F,3/15/17,CHI,MEM,1,40,4,16,0.25,4,13,0.308,0,3,0,6,8,0.75,3,4,7,1,0,2,1,0,14,8
Thaddeus Young,28-133,F,11/1/16,IND,LAL,1,28,6,8,0.75,4,4,1,2,4,0.5,0,0,,1,5,6,3,2,1,0,2,14,17
Trevor Ariza,31-263,F,3/20/17,HOU,DEN,1,41,5,11,0.455,2,4,0.5,3,7,0.429,1,2,0.5,0,4,4,3,2,0,0,2,14,12.4
Gary Harris,22-168,G,3/1/17,DEN,MIL,1,34,6,12,0.5,4,6,0.667,2,6,0.333,0,0,,1,2,3,2,1,0,3,3,14,7.5
Dwyane Wade,35-081,G,4/8/17,CHI,BRK,1,25,5,11,0.455,5,9,0.556,0,2,0,4,4,1,2,5,7,2,0,1,5,3,14,7.1
E'Twaun Moore,27-262,G,11/16/16,NOP,ORL,1,32,6,16,0.375,6,13,0.462,0,3,0,2,2,1,2,1,3,4,2,0,4,3,14,6.5
George Hill,30-255,G,1/14/17,UTA,ORL,1,34,4,13,0.308,4,8,0.5,0,5,0,6,8,0.75,0,0,0,7,2,0,2,3,14,9.4
Joe Johnson,35-128,G-F,11/4/16,UTA,SAS,1,24,5,8,0.625,3,6,0.5,2,2,1,2,2,1,0,1,1,2,0,1,1,2,14,11
D'Angelo Russell,21-035,G,3/30/17,LAL,MIN,1,38,4,15,0.267,2,7,0.286,2,8,0.25,4,4,1,0,3,3,6,3,0,5,5,14,6.2
Michael Beasley,28-009,F,1/18/17,MIL,HOU,0,24,6,14,0.429,4,11,0.364,2,3,0.667,0,0,,3,5,8,2,0,2,1,1,14,11.6
Reggie Jackson,26-271,G,1/12/17,DET,GSW,1,25,5,11,0.455,4,5,0.8,1,6,0.167,3,3,1,0,2,2,3,1,0,3,3,14,7.8
Marcin Gortat,32-359,C-F,2/10/17,WAS,IND,1,35,7,12,0.583,7,12,0.583,0,0,,0,0,,8,8,16,1,0,1,1,0,14,16.8
Dario Saric,22-332,F,3/6/17,PHI,MIL,1,33,5,15,0.333,4,10,0.4,1,5,0.2,3,4,0.75,2,6,8,6,2,0,3,1,14,11.1
Spencer Hawes,28-207,C-F,11/21/16,CHO,MEM,0,37,6,14,0.429,4,10,0.4,2,4,0.5,0,0,,1,9,10,1,1,2,3,3,14,8.9
Tony Snell,24-359,G-F,11/3/16,MIL,IND,1,29,6,9,0.667,4,4,1,2,5,0.4,0,0,,0,1,1,2,2,0,2,0,14,11.8
Cory Joseph,25-088,G,11/16/16,TOR,GSW,0,22,4,7,0.571,4,5,0.8,0,2,0,6,7,0.857,1,1,2,2,1,0,0,4,14,12.1
Wesley Matthews,30-048,G,12/1/16,DAL,CHO,1,39,4,15,0.267,3,4,0.75,1,11,0.091,5,5,1,0,3,3,2,0,0,1,2,14,5.6
Enes Kanter,24-205,C,12/11/16,OKC,BOS,0,25,6,10,0.6,6,8,0.75,0,2,0,2,2,1,3,4,7,2,0,2,0,1,14,15.1
David Lee,33-318,F,3/13/17,SAS,ATL,1,30,7,8,0.875,7,8,0.875,0,0,,0,0,,2,4,6,4,0,1,2,4,14,13.7
Montrezl Harrell,22-350,F-C,1/10/17,HOU,CHO,1,29,5,5,1,5,5,1,0,0,,4,6,0.667,1,2,3,2,2,3,0,1,14,18.1
John Henson,25-348,C-F,12/10/16,MIL,WAS,1,25,7,10,0.7,7,10,0.7,0,0,,0,0,,2,2,4,1,0,2,3,2,14,10.1
Alexis Ajinca,28-340,C,4/11/17,NOP,LAL,1,24,5,8,0.625,5,8,0.625,0,0,,4,6,0.667,0,8,8,1,1,1,1,3,14,12.2
Markieff Morris,27-175,F,2/24/17,WAS,PHI,1,27,6,10,0.6,6,10,0.6,0,0,,2,2,1,2,5,7,0,1,0,3,5,14,8.3
Tony Parker,34-242,G,1/14/17,SAS,PHO,1,31,5,10,0.5,3,7,0.429,2,3,0.667,2,4,0.5,1,0,1,2,1,0,2,1,14,8.9
Caris LeVert,22-145,G-F,1/17/17,BRK,TOR,0,23,6,8,0.75,4,5,0.8,2,3,0.667,0,0,,0,3,3,4,2,0,1,3,14,14.3
Kristaps Porzingis,21-172,F-C,1/21/17,NYK,PHO,1,33,7,13,0.538,7,10,0.7,0,3,0,0,0,,1,0,1,2,1,1,2,3,14,8.3
Jusuf Nurkic,22-214,C,3/25/17,POR,MIN,1,23,7,14,0.5,7,14,0.5,0,0,,0,2,0,2,7,9,4,0,1,0,1,14,12.8
Luis Scola,36-265,F,1/20/17,BRK,NOP,0,8,6,8,0.75,5,6,0.833,1,2,0.5,1,1,1,2,1,3,0,0,0,0,2,14,11.7
Michael Beasley,28-037,F,2/15/17,MIL,BRK,1,22,7,9,0.778,7,9,0.778,0,0,,0,1,0,1,2,3,0,1,1,0,1,14,12.7
Taj Gibson,31-217,F,1/27/17,CHI,MIA,1,26,4,6,0.667,4,6,0.667,0,0,,6,6,1,2,3,5,2,1,4,2,1,14,16.5
Karl-Anthony Towns,21-024,C-F,12/9/16,MIN,DET,1,32,6,12,0.5,6,10,0.6,0,2,0,2,4,0.5,3,9,12,1,0,1,5,3,14,7.2
Aaron Gordon,21-124,F,1/18/17,ORL,NOP,1,31,6,13,0.462,5,9,0.556,1,4,0.25,1,3,0.333,1,7,8,4,1,0,1,1,14,11.7
K.J. McDaniels,24-054,G-F,4/4/17,BRK,PHI,0,23,5,9,0.556,2,4,0.5,3,5,0.6,1,2,0.5,0,2,2,1,0,1,1,2,14,9.5
Alex Len,23-297,C,4/9/17,PHO,DAL,1,28,5,7,0.714,5,7,0.714,0,0,,4,5,0.8,3,7,10,1,0,2,1,2,14,15.2
Ersan Ilyasova,29-272,F,2/11/17,PHI,MIA,1,22,5,12,0.417,4,8,0.5,1,4,0.25,3,6,0.5,1,3,4,2,0,0,2,2,14,6.6
Willy Hernangomez,22-241,C,1/23/17,NYK,IND,0,24,5,8,0.625,5,8,0.625,0,0,,4,4,1,2,8,10,2,1,2,0,1,14,17.6
Tobias Harris,24-145,F,12/7/16,DET,CHO,1,39,7,19,0.368,7,12,0.583,0,7,0,0,0,,1,6,7,2,0,1,2,3,14,4.9
LaMarcus Aldridge,31-255,F-C,3/31/17,SAS,OKC,1,37,5,14,0.357,5,13,0.385,0,1,0,4,6,0.667,5,5,10,2,1,3,2,5,14,10.9
Jabari Parker,21-330,F,2/8/17,MIL,MIA,1,20,6,11,0.545,6,10,0.6,0,1,0,2,3,0.667,0,1,1,2,1,0,2,3,14,7.8
Derrick Williams,25-278,F,2/27/17,CLE,MIL,0,27,5,7,0.714,3,3,1,2,4,0.5,2,2,1,1,6,7,0,0,0,2,2,14,10.8
Kentavious Caldwell-Pope,23-340,G,1/23/17,DET,SAC,1,37,4,14,0.286,3,6,0.5,1,8,0.125,5,6,0.833,0,5,5,4,3,1,0,0,14,13.4
Wilson Chandler,29-272,F,2/6/17,DEN,DAL,1,40,6,11,0.545,6,9,0.667,0,2,0,2,2,1,0,10,10,4,1,1,1,3,14,14
Bojan Bogdanovic,27-303,G-F,2/15/17,BRK,MIL,1,31,6,12,0.5,5,8,0.625,1,4,0.25,1,1,1,1,5,6,2,0,0,3,2,14,7.8
Dante Cunningham,29-273,F,1/20/17,NOP,BRK,1,30,5,7,0.714,1,1,1,4,6,0.667,0,0,,3,4,7,1,0,1,1,3,14,13.6
Al Horford,30-303,C-F,4/2/17,BOS,NYK,1,26,6,9,0.667,5,5,1,1,4,0.25,1,1,1,1,6,7,1,0,0,1,1,14,11.9
Jerian Grant,24-095,G,1/12/17,CHI,NYK,0,25,5,10,0.5,3,6,0.5,2,4,0.5,2,3,0.667,0,3,3,4,1,0,0,1,14,12.9
Thaddeus Young,28-291,F,4/8/17,IND,ORL,1,31,7,8,0.875,7,8,0.875,0,0,,0,0,,1,3,4,2,1,2,1,2,14,14.8
Cory Joseph,25-196,G,3/4/17,TOR,MIL,1,37,5,11,0.455,3,7,0.429,2,4,0.5,2,2,1,1,4,5,8,0,0,1,3,14,13.6
Channing Frye,33-190,C-F,11/23/16,CLE,POR,0,14,4,6,0.667,0,0,,4,6,0.667,2,2,1,0,3,3,1,0,1,0,0,14,13.7
Kyle Korver,35-331,G-F,2/11/17,CLE,DEN,0,27,6,9,0.667,4,6,0.667,2,3,0.667,0,0,,0,5,5,1,1,0,1,3,14,11.1
Matthew Dellavedova,26-212,G,4/8/17,MIL,PHI,1,33,5,14,0.357,3,7,0.429,2,7,0.286,2,2,1,1,2,3,3,0,0,1,3,14,7.4
Paul George,26-238,F,12/26/16,IND,CHI,1,39,6,14,0.429,5,9,0.556,1,5,0.2,1,1,1,0,3,3,8,1,0,4,2,14,9.3
Bismack Biyombo,24-100,C-F,12/6/16,ORL,WAS,1,31,4,7,0.571,4,7,0.571,0,0,,6,13,0.462,4,9,13,2,0,3,2,3,14,13.7
Patrick Beverley,28-251,G,3/20/17,HOU,DEN,1,32,5,9,0.556,1,4,0.25,4,5,0.8,0,0,,1,5,6,3,1,0,1,4,14,12.4
Josh Richardson,23-187,G,3/21/17,MIA,PHO,1,36,6,13,0.462,4,8,0.5,2,5,0.4,0,0,,1,1,2,2,0,1,1,3,14,8.2
Brandon Knight,25-026,G,12/28/16,PHO,SAS,0,23,6,12,0.5,4,10,0.4,2,2,1,0,1,0,0,1,1,5,1,1,3,2,14,9.3
Klay Thompson,26-265,G,10/30/16,GSW,PHO,1,40,5,15,0.333,5,9,0.556,0,6,0,4,5,0.8,0,6,6,2,0,1,2,3,14,5.8
Jamal Crawford,36-250,G,11/25/16,LAC,DET,0,27,4,12,0.333,3,7,0.429,1,5,0.2,5,6,0.833,0,5,5,4,0,0,0,1,14,10.7
Greg Monroe,26-155,C-F,11/6/16,MIL,DAL,0,29,5,10,0.5,5,10,0.5,0,0,,4,4,1,1,11,12,1,3,0,5,2,14,10.9
Dion Waiters,25-076,G,2/24/17,MIA,ATL,1,31,6,19,0.316,4,14,0.286,2,5,0.4,0,0,,1,2,3,10,1,2,2,1,14,11.4
Juan Hernangomez,21-195,F,4/11/17,DEN,DAL,0,27,5,9,0.556,2,4,0.5,3,5,0.6,1,2,0.5,0,6,6,1,1,0,2,1,14,10.4
Greg Monroe,26-188,C-F,12/9/16,MIL,ATL,0,23,6,13,0.462,6,13,0.462,0,0,,2,2,1,2,4,6,5,2,0,1,1,14,14
Alan Williams,24-034,F-C,3/3/17,PHO,OKC,0,30,7,15,0.467,7,15,0.467,0,0,,0,0,,6,7,13,1,1,3,2,4,14,12.8
Cory Joseph,25-140,G,1/7/17,TOR,CHI,0,23,5,6,0.833,2,3,0.667,3,3,1,1,1,1,0,3,3,1,1,0,2,1,14,12
Kyle O'Quinn,26-299,F-C,1/19/17,NYK,WAS,1,21,7,10,0.7,7,10,0.7,0,0,,0,0,,4,4,8,3,1,3,1,1,14,17.6
Joe Johnson,35-217,G-F,2/1/17,UTA,MIL,0,27,5,9,0.556,3,6,0.5,2,3,0.667,2,3,0.667,1,5,6,5,0,0,1,0,14,14
Nerlens Noel,22-263,C-F,12/29/16,PHI,UTA,0,22,6,10,0.6,6,10,0.6,0,0,,2,2,1,2,3,5,0,1,0,0,2,14,11.9
Jamal Murray,19-358,G,2/15/17,DEN,MIN,0,23,5,13,0.385,1,5,0.2,4,8,0.5,0,0,,1,1,2,0,0,0,4,1,14,3.5
Jrue Holiday,26-227,G,1/25/17,NOP,OKC,1,32,6,11,0.545,4,7,0.571,2,4,0.5,0,0,,1,1,2,8,4,1,4,2,14,15.2
Markieff Morris,27-199,F,3/20/17,WAS,BOS,1,31,6,15,0.4,5,9,0.556,1,6,0.167,1,1,1,1,3,4,0,0,0,0,4,14,5.9
Dwight Howard,31-033,C,1/10/17,ATL,BRK,1,28,6,9,0.667,6,9,0.667,0,0,,2,8,0.25,7,9,16,0,0,1,2,1,14,13.6
Kentavious Caldwell-Pope,23-268,G,11/12/16,DET,DEN,1,35,4,11,0.364,3,6,0.5,1,5,0.2,5,6,0.833,0,1,1,2,2,0,1,2,14,9.4
Cory Joseph,25-230,G,4/7/17,TOR,MIA,0,26,5,10,0.5,3,8,0.375,2,2,1,2,2,1,3,1,4,3,3,0,2,1,14,14.1
Evan Turner,28-005,G,11/1/16,POR,GSW,0,21,5,6,0.833,4,5,0.8,1,1,1,3,4,0.75,0,1,1,2,1,0,3,1,14,10.7
Malcolm Brogdon,24-107,G,3/28/17,MIL,CHO,1,29,6,7,0.857,4,5,0.8,2,2,1,0,0,,0,3,3,10,1,0,1,1,14,19
Marreese Speights,29-090,C-F,11/2/16,LAC,OKC,0,16,6,9,0.667,5,7,0.714,1,2,0.5,1,2,0.5,1,3,4,2,0,0,0,1,14,12.3
Andre Drummond,23-114,C,12/2/16,DET,ATL,1,28,6,9,0.667,6,9,0.667,0,0,,2,4,0.5,3,11,14,2,1,1,3,1,14,14.4
Joakim Noah,31-307,C,12/28/16,NYK,ATL,1,38,5,8,0.625,5,8,0.625,0,0,,4,4,1,6,10,16,3,2,1,1,3,14,20.2
Buddy Hield,23-100,G,3/27/17,SAC,MEM,1,34,5,12,0.417,3,5,0.6,2,7,0.286,2,2,1,0,4,4,0,0,0,1,1,14,7.4
Nik Stauskas,23-035,G,11/11/16,PHI,IND,0,24,5,7,0.714,3,3,1,2,4,0.5,2,4,0.5,0,0,0,1,0,1,1,1,14,10.3
Dario Saric,22-215,F,11/9/16,PHI,IND,1,34,5,9,0.556,3,7,0.429,2,2,1,2,2,1,2,10,12,3,0,2,3,4,14,13
Dante Cunningham,29-271,F,1/18/17,NOP,ORL,1,27,7,11,0.636,7,8,0.875,0,3,0,0,0,,2,3,5,0,0,0,0,1,14,11
Marcin Gortat,32-264,C-F,11/7/16,WAS,HOU,1,37,5,9,0.556,5,9,0.556,0,0,,4,6,0.667,3,9,12,2,0,2,1,2,14,14.7
Kristaps Porzingis,21-126,F-C,12/6/16,NYK,MIA,1,30,6,16,0.375,6,12,0.5,0,4,0,2,4,0.5,2,10,12,0,0,1,0,4,14,7.9
Marco Belinelli,30-262,G-F,12/12/16,CHO,IND,0,28,4,9,0.444,3,6,0.5,1,3,0.333,5,5,1,0,3,3,2,1,0,1,3,14,10.4
Clint Capela,22-173,F-C,11/7/16,HOU,WAS,1,27,7,10,0.7,7,10,0.7,0,0,,0,2,0,2,4,6,0,1,4,2,3,14,12.2
Joel Embiid,22-267,C-F,12/8/16,PHI,NOP,1,27,5,15,0.333,5,10,0.5,0,5,0,4,5,0.8,3,4,7,2,3,4,3,3,14,11.4
Greg Monroe,26-293,C-F,3/24/17,MIL,ATL,0,26,7,15,0.467,7,15,0.467,0,0,,0,0,,3,7,10,3,0,0,0,2,14,11.8
Tristan Thompson,25-314,F-C,1/21/17,CLE,SAS,1,39,7,13,0.538,7,13,0.538,0,0,,0,4,0,5,7,12,1,0,1,1,2,14,11.3
Jordan Clarkson,24-271,G,3/5/17,LAL,NOP,0,24,4,9,0.444,4,7,0.571,0,2,0,6,6,1,0,2,2,3,1,0,3,0,14,10
Jamal Crawford,37-009,G,3/29/17,LAC,WAS,0,29,6,16,0.375,4,9,0.444,2,7,0.286,0,0,,0,1,1,3,1,0,2,0,14,6.6
Andre Iguodala,33-060,G-F,3/29/17,GSW,SAS,0,30,6,9,0.667,4,6,0.667,2,3,0.667,0,0,,0,6,6,1,2,0,0,0,14,14.6
Ersan Ilyasova,29-219,F,12/20/16,PHI,NOP,0,26,5,9,0.556,3,5,0.6,2,4,0.5,2,2,1,2,2,4,0,0,1,2,2,14,9.6
Evan Fournier,24-016,G-F,11/14/16,ORL,IND,1,33,4,15,0.267,3,11,0.273,1,4,0.25,5,5,1,0,2,2,2,1,0,1,2,14,6.3
Jordan Crawford,28-155,G,3/27/17,NOP,UTA,0,30,5,16,0.313,3,10,0.3,2,6,0.333,2,2,1,0,1,1,2,0,1,1,4,14,4.6
Enes Kanter,24-302,C,3/18/17,OKC,SAC,0,18,5,10,0.5,5,10,0.5,0,0,,4,6,0.667,1,3,4,0,0,1,2,2,14,7.7
Markieff Morris,27-214,F,4/4/17,WAS,CHO,1,22,6,9,0.667,4,6,0.667,2,3,0.667,0,0,,0,6,6,0,0,0,0,3,14,10.7
Marc Gasol,31-350,C,1/13/17,MEM,HOU,1,34,6,9,0.667,5,7,0.714,1,2,0.5,1,2,0.5,0,6,6,6,1,1,6,3,14,10.2
James Harden,27-133,G,1/6/17,HOU,ORL,1,34,5,15,0.333,5,7,0.714,0,8,0,4,6,0.667,1,5,6,10,1,0,6,4,14,7.3
Bradley Beal,23-124,G,10/30/16,WAS,MEM,1,40,5,17,0.294,3,9,0.333,2,8,0.25,2,2,1,0,3,3,1,2,1,1,2,14,6.6
Kristaps Porzingis,21-243,F-C,4/2/17,NYK,BOS,1,28,6,10,0.6,6,10,0.6,0,0,,2,4,0.5,0,1,1,0,1,0,0,1,14,9.5
Jamal Murray,20-005,G,2/28/17,DEN,CHI,0,18,4,9,0.444,2,4,0.5,2,5,0.4,4,4,1,0,2,2,2,0,0,1,1,14,9.9
Tyler Johnson,24-187,G,11/10/16,MIA,CHI,0,32,4,11,0.364,2,7,0.286,2,4,0.5,4,7,0.571,1,7,8,4,0,0,1,2,14,10.5
Dario Saric,22-300,F,2/2/17,PHI,SAS,1,36,5,17,0.294,3,10,0.3,2,7,0.286,2,2,1,3,5,8,1,1,0,6,3,14,2.2
Dwight Howard,31-100,C,3/18/17,ATL,POR,1,34,6,10,0.6,6,10,0.6,0,0,,2,3,0.667,5,5,10,3,4,1,3,0,14,17.8
Ivica Zubac,19-356,C,3/9/17,LAL,PHO,0,17,7,13,0.538,7,13,0.538,0,0,,0,1,0,2,1,3,0,1,2,0,1,14,11
Jusuf Nurkic,22-091,C,11/22/16,DEN,CHI,1,29,7,13,0.538,7,13,0.538,0,0,,0,0,,5,9,14,4,0,2,2,1,14,15.7
Mindaugas Kuzminskas,27-155,F,3/23/17,NYK,POR,1,32,3,8,0.375,1,3,0.333,2,5,0.4,6,6,1,1,7,8,2,0,0,2,3,14,10.6
Gerald Henderson,29-105,G,3/24/17,PHI,CHI,0,28,5,9,0.556,2,4,0.5,3,5,0.6,1,2,0.5,1,4,5,2,1,1,0,2,14,13.5
Avery Bradley,26-038,G,1/3/17,BOS,UTA,1,36,4,7,0.571,2,3,0.667,2,4,0.5,4,4,1,0,3,3,2,0,0,3,3,14,8.8
Tristan Thompson,25-363,F-C,3/11/17,CLE,ORL,1,28,6,9,0.667,6,9,0.667,0,0,,2,7,0.286,3,10,13,1,0,2,1,0,14,14.3
Otto Porter,23-176,F,11/26/16,WAS,SAS,1,38,6,8,0.75,5,7,0.714,1,1,1,1,1,1,2,6,8,3,3,0,1,5,14,16.1
JaMychal Green,26-268,F,3/16/17,MEM,ATL,1,26,6,11,0.545,4,7,0.571,2,4,0.5,0,0,,3,9,12,0,2,2,2,4,14,13.3
Alan Williams,24-046,F-C,3/15/17,PHO,SAC,0,31,6,16,0.375,6,16,0.375,0,0,,2,3,0.667,4,7,11,2,1,2,1,5,14,10.5
Jodie Meeks,29-143,G,1/11/17,ORL,LAC,0,28,6,11,0.545,4,6,0.667,2,5,0.4,0,0,,0,5,5,2,5,0,0,2,14,15.8
Paul Millsap,32-051,F,4/2/17,ATL,BRK,0,26,4,14,0.286,3,9,0.333,1,5,0.2,5,6,0.833,0,4,4,2,0,0,0,3,14,6.8
Julius Randle,21-350,F,11/13/16,LAL,MIN,1,28,5,8,0.625,4,7,0.571,1,1,1,3,5,0.6,1,5,6,3,1,0,4,2,14,10.1
Frank Kaminsky,23-212,F-C,11/2/16,CHO,PHI,0,25,6,12,0.5,4,6,0.667,2,6,0.333,0,0,,2,3,5,1,1,0,2,1,14,9.6
Brook Lopez,28-253,C,12/10/16,BRK,SAS,1,25,3,7,0.429,3,6,0.5,0,1,0,8,8,1,3,2,5,5,0,1,0,0,14,17.2
Ersan Ilyasova,29-194,F,11/25/16,PHI,CHI,1,26,5,8,0.625,4,6,0.667,1,2,0.5,3,4,0.75,1,6,7,2,0,0,1,1,14,12.5
Blake Griffin,27-233,F,11/4/16,LAC,MEM,1,36,5,13,0.385,5,13,0.385,0,0,,4,6,0.667,2,8,10,2,1,0,2,3,14,9.1
Paul Millsap,31-335,F,1/10/17,ATL,BRK,1,29,6,14,0.429,6,13,0.462,0,1,0,2,4,0.5,3,5,8,4,1,3,1,3,14,13.1
Allen Crabbe,24-256,G-F,12/21/16,POR,DAL,0,37,5,9,0.556,1,3,0.333,4,6,0.667,0,0,,0,6,6,1,0,0,1,2,14,10.4
Timofey Mozgov,30-113,C,11/6/16,LAL,PHO,1,22,6,9,0.667,6,9,0.667,0,0,,2,3,0.667,4,4,8,2,0,0,3,1,14,11.7
Andre Iguodala,33-062,G-F,3/31/17,GSW,HOU,0,28,6,12,0.5,4,6,0.667,2,6,0.333,0,0,,1,4,5,5,2,3,0,2,14,16.7
Brandon Jennings,27-085,G,12/17/16,NYK,DEN,1,36,2,8,0.25,0,3,0,2,5,0.4,8,8,1,0,0,0,7,3,0,3,2,14,13.3
Gorgui Dieng,27-065,C,3/24/17,MIN,LAL,1,39,6,11,0.545,6,10,0.6,0,1,0,2,2,1,4,2,6,3,1,3,3,5,14,12.3
Ryan Anderson,28-177,F,10/30/16,HOU,DAL,1,32,6,10,0.6,6,8,0.75,0,2,0,2,2,1,4,8,12,0,0,0,1,2,14,12.8
Tim Frazier,26-040,G,12/11/16,NOP,PHO,0,38,4,10,0.4,4,8,0.5,0,2,0,6,7,0.857,3,8,11,11,5,1,1,4,14,23.5
Greg Monroe,26-238,C-F,1/28/17,MIL,BOS,0,35,4,10,0.4,4,10,0.4,0,0,,6,9,0.667,3,10,13,1,3,3,1,5,14,15.3
Michael Beasley,28-085,F,4/4/17,MIL,OKC,0,12,5,8,0.625,5,8,0.625,0,0,,4,4,1,0,1,1,1,0,1,0,1,14,11.7
Tyler Johnson,24-229,G,12/22/16,MIA,LAL,0,34,5,14,0.357,1,8,0.125,4,6,0.667,0,0,,0,1,1,6,1,1,0,1,14,12
Dario Saric,22-265,F,12/29/16,PHI,UTA,0,25,6,11,0.545,5,8,0.625,1,3,0.333,1,1,1,2,2,4,1,0,1,2,1,14,9.7
Arron Afflalo,31-036,G,11/20/16,SAC,TOR,0,20,5,7,0.714,4,5,0.8,1,2,0.5,3,3,1,1,4,5,1,0,0,0,1,14,13.3
Mike Dunleavy,36-099,F-G,12/23/16,CLE,BRK,0,22,6,9,0.667,4,5,0.8,2,4,0.5,0,0,,2,2,4,1,0,0,2,4,14,9.2
Norman Powell,23-302,G,3/23/17,TOR,MIA,0,26,5,10,0.5,3,5,0.6,2,5,0.4,2,2,1,1,2,3,0,1,1,3,2,14,8.2
Trevor Ariza,31-144,F,11/21/16,HOU,DET,1,35,5,15,0.333,1,5,0.2,4,10,0.4,0,0,,2,4,6,3,1,0,1,1,14,9.8
Jamal Crawford,36-318,G,2/1/17,LAC,PHO,0,32,5,11,0.455,5,9,0.556,0,2,0,4,6,0.667,1,2,3,5,1,1,1,4,14,11.4
Zaza Pachulia,32-354,C,1/29/17,GSW,POR,1,24,3,5,0.6,3,5,0.6,0,0,,8,10,0.8,2,3,5,2,4,0,1,3,14,16.4
Courtney Lee,31-183,G,4/4/17,NYK,CHI,1,33,6,12,0.5,6,10,0.6,0,2,0,2,2,1,2,2,4,3,0,0,2,5,14,8.1
Dirk Nowitzki,38-237,F,2/11/17,DAL,ORL,1,18,6,12,0.5,4,9,0.444,2,3,0.667,0,0,,0,7,7,1,2,0,0,1,14,12.4
T.J. Warren,23-051,F,10/26/16,PHO,SAC,1,30,5,14,0.357,5,12,0.417,0,2,0,4,4,1,2,3,5,1,2,0,0,5,14,9.2
Gerald Henderson,28-362,G,12/5/16,PHI,DEN,1,26,4,9,0.444,3,5,0.6,1,4,0.25,5,6,0.833,0,5,5,1,3,0,1,2,14,12.3
Zach LaVine,21-238,G,11/3/16,MIN,DEN,1,36,4,13,0.308,2,7,0.286,2,6,0.333,4,6,0.667,1,4,5,3,1,0,0,2,14,9.9
Leandro Barbosa,34-070,G,2/6/17,PHO,NOP,0,20,5,7,0.714,3,5,0.6,2,2,1,2,2,1,0,2,2,2,1,0,0,2,14,13.3
Willie Cauley-Stein,23-193,F-C,2/27/17,SAC,MIN,1,34,5,11,0.455,5,11,0.455,0,0,,4,8,0.5,0,6,6,5,1,1,4,3,14,8.5
Zaza Pachulia,32-347,C,1/22/17,GSW,ORL,1,20,7,8,0.875,7,8,0.875,0,0,,0,2,0,2,3,5,1,2,0,1,2,14,13.6
Alan Williams,24-073,F-C,4/11/17,PHO,SAC,0,28,7,10,0.7,7,10,0.7,0,0,,0,0,,2,9,11,1,1,0,0,4,14,14
Tim Hardaway,25-017,G,4/2/17,ATL,BRK,1,36,5,10,0.5,4,7,0.571,1,3,0.333,3,4,0.75,0,6,6,1,0,0,5,2,14,5.3
Kyle Korver,35-250,G-F,11/22/16,ATL,NOP,1,29,5,6,0.833,1,1,1,4,5,0.8,0,0,,0,2,2,4,0,0,1,2,14,13.4
Rondae Hollis-Jefferson,22-014,F,1/17/17,BRK,TOR,0,26,5,8,0.625,5,8,0.625,0,0,,4,4,1,0,8,8,3,1,1,1,0,14,15.6
Justin Holiday,27-330,G,3/1/17,NYK,ORL,0,16,6,11,0.545,4,6,0.667,2,5,0.4,0,0,,0,1,1,0,1,1,0,1,14,10.3
Terrence Ross,26-040,F-G,3/17/17,ORL,PHO,1,31,6,10,0.6,4,7,0.571,2,3,0.667,0,0,,0,1,1,2,0,0,3,6,14,5.7
Victor Oladipo,24-200,G,11/20/16,OKC,IND,1,38,6,14,0.429,4,8,0.5,2,6,0.333,0,0,,0,5,5,6,2,0,4,2,14,9.5
Ben McLemore,24-030,G,3/13/17,SAC,ORL,0,23,4,10,0.4,1,4,0.25,3,6,0.5,3,5,0.6,0,5,5,1,1,0,3,4,14,6.4
Rondae Hollis-Jefferson,22-068,F,3/12/17,BRK,NYK,1,24,6,8,0.75,6,8,0.75,0,0,,2,4,0.5,5,6,11,0,0,1,1,5,14,13
Tony Parker,34-238,G,1/10/17,SAS,MIL,1,33,7,15,0.467,7,14,0.5,0,1,0,0,0,,0,3,3,7,1,0,2,1,14,10.7
Michael Kidd-Gilchrist,23-181,F,3/26/17,CHO,PHO,1,35,7,11,0.636,7,11,0.636,0,0,,0,0,,2,3,5,3,1,1,0,2,14,14.4
Gerald Henderson,29-064,G,2/11/17,PHI,MIA,1,30,2,11,0.182,2,9,0.222,0,2,0,10,10,1,0,6,6,1,1,1,1,1,14,9.9
Jonathon Simmons,27-185,G-F,3/18/17,SAS,MEM,0,18,4,6,0.667,2,3,0.667,2,3,0.667,4,4,1,1,0,1,3,1,0,0,4,14,13.6
Marcus Smart,23-027,G,4/2/17,BOS,NYK,0,27,6,11,0.545,5,6,0.833,1,5,0.2,1,1,1,1,1,2,5,1,0,3,3,14,10
Jahlil Okafor,20-362,C-F,12/11/16,PHI,DET,1,27,6,9,0.667,6,9,0.667,0,0,,2,4,0.5,1,8,9,1,1,2,5,4,14,8.9
Tobias Harris,24-154,F,12/16/16,DET,WAS,1,33,5,16,0.313,4,11,0.364,1,5,0.2,3,3,1,2,4,6,2,0,1,0,1,14,9.1
Shaun Livingston,31-170,G,2/28/17,GSW,WAS,0,24,5,8,0.625,5,7,0.714,0,1,0,4,4,1,1,2,3,2,1,1,3,3,14,10.6
Anthony Tolliver,31-217,F-C,1/4/17,SAC,MIA,0,29,5,6,0.833,4,4,1,1,2,0.5,3,3,1,0,3,3,2,0,0,1,3,14,11.9
T.J. Warren,23-206,F,3/30/17,PHO,LAC,1,38,6,15,0.4,6,15,0.4,0,0,,2,6,0.333,4,6,10,0,1,1,2,2,14,7.8
Derrick Rose,28-095,G,1/7/17,NYK,IND,1,26,6,12,0.5,6,10,0.6,0,2,0,2,2,1,0,2,2,3,2,0,2,2,14,9.9
Ersan Ilyasova,29-238,F,1/8/17,PHI,BRK,1,26,5,16,0.313,4,9,0.444,1,7,0.143,3,5,0.6,2,5,7,2,0,1,0,2,14,8.2
Marcin Gortat,32-308,C-F,12/21/16,WAS,CHI,1,35,7,9,0.778,7,9,0.778,0,0,,0,0,,1,10,11,2,0,1,3,4,14,11.7
Wayne Ellington,29-038,G,12/6/16,MIA,NYK,1,33,5,14,0.357,1,3,0.333,4,11,0.364,0,0,,0,2,2,3,1,0,0,1,14,9.5
Reggie Bullock,26-024,G-F,4/9/17,DET,MEM,1,23,5,8,0.625,1,1,1,4,7,0.571,0,0,,1,3,4,0,1,0,0,2,14,12.2
Gordon Hayward,27-020,F-G,4/12/17,UTA,SAS,1,23,7,9,0.778,7,8,0.875,0,1,0,0,0,,1,1,2,1,1,1,1,1,14,12.5
Frank Kaminsky,23-350,F-C,3/20/17,CHO,ATL,0,36,5,11,0.455,2,5,0.4,3,6,0.5,1,1,1,0,3,3,5,0,2,2,2,14,11.3
Eric Gordon,28-089,G,3/24/17,HOU,NOP,0,33,5,10,0.5,3,5,0.6,2,5,0.4,2,3,0.667,1,4,5,4,1,0,5,1,14,8.9
Andre Drummond,23-206,C,3/4/17,DET,PHI,1,32,7,13,0.538,7,13,0.538,0,0,,0,0,,5,9,14,2,4,3,1,1,14,20
J.J. Redick,32-211,G,1/21/17,LAC,DEN,1,26,6,15,0.4,4,8,0.5,2,7,0.286,0,0,,0,1,1,3,2,0,0,1,14,9.9
Robert Covington,26-002,F,12/16/16,PHI,LAL,1,36,6,16,0.375,6,10,0.6,0,6,0,2,2,1,3,3,6,2,0,1,3,4,14,5.7
Michael Kidd-Gilchrist,23-134,F,2/7/17,CHO,BRK,1,28,7,12,0.583,7,12,0.583,0,0,,0,0,,3,4,7,2,0,1,0,2,14,13
James Ennis,26-275,F,4/2/17,MEM,LAL,1,37,5,10,0.5,3,6,0.5,2,4,0.5,2,2,1,1,7,8,4,1,1,2,0,14,14.3
Kristaps Porzingis,21-216,F-C,3/6/17,NYK,ORL,1,30,6,12,0.5,6,12,0.5,0,0,,2,2,1,2,5,7,1,0,1,1,4,14,9.7
Zach Randolph,35-240,F,3/13/17,MEM,MIL,0,21,6,13,0.462,6,13,0.462,0,0,,2,3,0.667,3,4,7,1,0,0,0,1,14,10.5
Otto Porter,23-287,F,3/17/17,WAS,CHI,1,38,6,14,0.429,6,11,0.545,0,3,0,2,2,1,3,5,8,0,0,0,0,1,14,9.8
Marvin Williams,30-258,F,3/4/17,CHO,DEN,1,38,5,7,0.714,3,5,0.6,2,2,1,2,2,1,6,6,12,3,0,2,1,4,14,18
Andre Roberson,24-345,G-F,11/13/16,OKC,ORL,1,32,6,11,0.545,4,5,0.8,2,6,0.333,0,3,0,2,1,3,0,1,4,0,3,14,11.8
Mindaugas Kuzminskas,27-073,F,12/31/16,NYK,HOU,0,16,5,9,0.556,3,4,0.75,2,5,0.4,2,2,1,0,2,2,1,1,0,0,3,14,10.8
Ersan Ilyasova,29-222,F,12/23/16,PHI,PHO,0,25,5,11,0.455,2,6,0.333,3,5,0.6,1,1,1,2,1,3,3,0,1,5,4,14,6.2
Nicolas Batum,27-359,F-G,12/7/16,CHO,DET,1,36,4,10,0.4,3,9,0.333,1,1,1,5,6,0.833,0,15,15,3,0,0,1,1,14,13.4
Marvin Williams,30-220,F,1/25/17,CHO,GSW,1,30,6,12,0.5,5,9,0.556,1,3,0.333,1,2,0.5,0,5,5,2,2,1,1,2,14,11.4
Justin Anderson,23-008,G,11/27/16,DAL,NOP,0,23,4,7,0.571,2,4,0.5,2,3,0.667,4,5,0.8,1,7,8,2,0,0,2,0,14,12.5
Jamal Crawford,36-259,G,12/4/16,LAC,IND,0,27,4,10,0.4,4,7,0.571,0,3,0,6,7,0.857,0,2,2,1,1,0,2,3,14,7.3
Tristan Thompson,25-338,F-C,2/14/17,CLE,MIN,1,35,6,7,0.857,6,7,0.857,0,0,,2,3,0.667,6,5,11,1,0,0,2,2,14,14.7
Marcus Morris,27-123,F,1/3/17,DET,IND,1,29,6,14,0.429,4,7,0.571,2,7,0.286,0,0,,1,0,1,4,0,1,1,3,14,8.6
Kemba Walker,26-277,G,2/9/17,CHO,HOU,1,36,6,14,0.429,4,8,0.5,2,6,0.333,0,0,,0,5,5,5,1,2,6,3,14,6.8
Greg Monroe,26-267,C-F,2/26/17,MIL,PHO,0,34,5,13,0.385,5,13,0.385,0,0,,4,5,0.8,2,6,8,3,3,2,3,3,14,12
Goran Dragic,30-175,G,10/28/16,MIA,CHO,1,34,4,12,0.333,1,7,0.143,3,5,0.6,3,3,1,1,3,4,9,1,0,4,3,14,10.9
Brandon Ingram,19-134,F,1/14/17,LAL,LAC,0,31,4,8,0.5,2,6,0.333,2,2,1,4,6,0.667,0,5,5,5,1,0,1,0,14,14.2
Chandler Parsons,28-078,F,1/11/17,MEM,OKC,1,18,7,12,0.583,7,9,0.778,0,3,0,0,0,,0,0,0,0,1,0,0,3,14,8.2
Mindaugas Kuzminskas,27-042,F,11/30/16,NYK,MIN,0,20,5,9,0.556,1,4,0.25,4,5,0.8,0,0,,2,0,2,1,0,0,1,2,14,10
Ryan Anderson,28-279,F,2/9/17,HOU,CHO,1,35,5,11,0.455,3,5,0.6,2,6,0.333,2,2,1,1,3,4,1,0,0,1,2,14,8.8
Enes Kanter,24-293,C,3/9/17,OKC,SAS,0,24,6,10,0.6,6,10,0.6,0,0,,2,2,1,6,4,10,0,0,0,2,2,14,12
DeMar DeRozan,27-222,G,3/17/17,TOR,DET,1,36,3,9,0.333,3,8,0.375,0,1,0,8,8,1,0,8,8,6,0,0,2,1,14,13.1
Jabari Parker,21-255,F,11/25/16,MIL,TOR,1,33,6,14,0.429,5,9,0.556,1,5,0.2,1,2,0.5,1,3,4,0,0,0,2,3,14,4.6
David Lee,33-275,F,1/29/17,SAS,DAL,0,25,7,9,0.778,7,9,0.778,0,0,,0,0,,1,2,3,4,0,0,0,2,14,13.8
Kevin Love,28-065,F,11/11/16,CLE,WAS,1,34,4,12,0.333,4,11,0.364,0,1,0,6,9,0.667,7,9,16,1,1,0,3,4,14,10.7
Marco Belinelli,30-302,G-F,1/21/17,CHO,BRK,0,22,5,10,0.5,3,5,0.6,2,5,0.4,2,2,1,0,1,1,5,0,0,0,3,14,11.6
Gordon Hayward,26-360,F-G,3/18/17,UTA,CHI,1,36,5,16,0.313,2,8,0.25,3,8,0.375,1,2,0.5,2,4,6,2,4,0,4,1,14,8
Kenneth Faried,27-073,F,1/31/17,DEN,LAL,1,28,5,12,0.417,5,12,0.417,0,0,,4,6,0.667,6,11,17,1,2,0,1,3,14,14.8
Juan Hernangomez,21-073,F,12/10/16,DEN,ORL,0,18,5,9,0.556,1,4,0.25,4,5,0.8,0,0,,3,1,4,2,0,0,0,1,14,13.1
DeAndre Jordan,28-245,C,3/23/17,LAC,DAL,1,35,6,6,1,6,6,1,0,0,,2,4,0.5,6,12,18,1,0,2,0,4,14,19.7
Reggie Jackson,26-337,G,3/19/17,DET,PHO,1,25,5,15,0.333,3,11,0.273,2,4,0.5,2,2,1,0,2,2,4,1,0,2,4,14,6.3
Lou Williams,30-010,G,11/6/16,LAL,PHO,0,26,5,12,0.417,4,10,0.4,1,2,0.5,3,5,0.6,1,3,4,6,2,0,4,1,14,10.2
Brook Lopez,28-276,C,1/2/17,BRK,UTA,1,31,6,16,0.375,5,10,0.5,1,6,0.167,1,2,0.5,1,5,6,0,2,2,2,5,14,6.4
Al Jefferson,31-346,C-F,12/15/16,IND,NOP,0,18,6,13,0.462,6,13,0.462,0,0,,2,2,1,2,3,5,0,0,1,0,2,14,9.5
Manu Ginobili,39-155,G,12/30/16,SAS,POR,0,17,4,8,0.5,2,3,0.667,2,5,0.4,4,4,1,1,6,7,2,0,0,2,1,14,11.5
Eric Bledsoe,26-363,G,12/6/16,PHO,UTA,1,25,5,10,0.5,5,10,0.5,0,0,,4,4,1,1,5,6,2,1,0,3,1,14,10.2
Victor Oladipo,24-202,G,11/22/16,OKC,LAL,1,39,6,13,0.462,4,9,0.444,2,4,0.5,0,0,,0,4,4,4,2,1,3,1,14,10.6
Buddy Hield,22-327,G,11/8/16,NOP,SAC,0,22,6,16,0.375,5,9,0.556,1,7,0.143,1,2,0.5,0,2,2,1,0,0,0,2,14,5.3
Victor Oladipo,24-278,G,2/6/17,OKC,IND,1,36,4,16,0.25,4,10,0.4,0,6,0,6,6,1,0,5,5,2,1,1,1,3,14,6.8
Tim Hardaway,24-295,G,1/5/17,ATL,NOP,0,26,5,12,0.417,1,5,0.2,4,7,0.571,0,0,,0,6,6,0,1,0,0,0,14,10.4
Jae Crowder,26-235,F,2/26/17,BOS,DET,1,33,3,8,0.375,2,4,0.5,1,4,0.25,7,9,0.778,0,11,11,5,1,0,0,3,14,15.4
Nick Young,31-196,G-F,12/14/16,LAL,BRK,1,30,5,15,0.333,2,5,0.4,3,10,0.3,1,1,1,3,1,4,0,1,1,1,3,14,7.4
Jordan Clarkson,24-185,G,12/9/16,LAL,PHO,1,34,6,17,0.353,6,12,0.5,0,5,0,2,3,0.667,1,1,2,3,0,0,4,4,14,1.6
Mike Conley,29-068,G,12/18/16,MEM,UTA,1,29,3,16,0.188,2,7,0.286,1,9,0.111,7,9,0.778,0,0,0,4,1,0,0,1,14,6.6
Devin Harris,33-306,G,12/29/16,DAL,LAL,0,21,5,10,0.5,2,5,0.4,3,5,0.6,1,1,1,0,1,1,2,0,0,2,1,14,8.3
Zach Randolph,35-179,F,1/11/17,MEM,OKC,0,27,6,13,0.462,6,13,0.462,0,0,,2,3,0.667,4,5,9,1,0,0,4,2,14,7.1
Garrett Temple,30-245,G,1/8/17,SAC,GSW,1,42,5,9,0.556,3,4,0.75,2,5,0.4,2,4,0.5,0,1,1,3,1,1,1,2,14,11.2
Davis Bertans,24-144,F,4/5/17,SAS,LAL,0,23,5,11,0.455,1,1,1,4,10,0.4,0,0,,0,1,1,1,0,1,2,2,14,7.2
Dirk Nowitzki,38-277,F,3/23/17,DAL,LAC,1,29,7,12,0.583,7,10,0.7,0,2,0,0,0,,0,4,4,4,2,0,2,2,14,11.6
Danny Green,29-202,G-F,1/10/17,SAS,MIL,1,26,5,12,0.417,1,3,0.333,4,9,0.444,0,0,,0,3,3,0,0,1,1,3,14,7
Dejounte Murray,20-124,G,1/21/17,SAS,CLE,1,22,7,10,0.7,7,10,0.7,0,0,,0,0,,0,2,2,5,0,0,2,0,14,11.9
J.R. Smith,31-099,G-F,12/17/16,CLE,LAL,1,31,5,8,0.625,1,3,0.333,4,5,0.8,0,0,,0,1,1,0,1,0,1,1,14,10.3
Buddy Hield,23-079,G,3/6/17,SAC,DEN,0,23,4,7,0.571,2,5,0.4,2,2,1,4,5,0.8,0,3,3,0,1,0,4,1,14,7.8
Jason Smith,31-027,F-C,3/29/17,WAS,LAC,0,26,5,13,0.385,1,3,0.333,4,10,0.4,0,0,,1,7,8,0,0,0,0,3,14,8.5
Dwyane Wade,34-300,G,11/12/16,CHI,WAS,1,30,5,17,0.294,5,15,0.333,0,2,0,4,4,1,2,0,2,2,1,1,2,2,14,5.8
Myles Turner,20-309,F-C,1/27/17,IND,SAC,1,35,6,9,0.667,5,7,0.714,1,2,0.5,1,2,0.5,1,1,2,4,3,1,0,5,14,15.2
Ricky Rubio,26-084,G,1/13/17,MIN,OKC,1,36,6,12,0.5,6,10,0.6,0,2,0,2,2,1,1,3,4,14,4,0,5,3,14,17.2
Jahlil Okafor,21-001,C-F,12/16/16,PHI,LAL,1,24,4,7,0.571,4,7,0.571,0,0,,6,6,1,2,6,8,0,1,0,0,1,14,14.5
Randy Foye,33-163,G,3/6/17,BRK,MEM,1,16,5,7,0.714,1,3,0.333,4,4,1,0,0,,0,3,3,1,2,0,0,1,14,14.3
Avery Bradley,25-346,G,11/6/16,BOS,DEN,1,34,6,17,0.353,5,12,0.417,1,5,0.2,1,2,0.5,2,9,11,6,0,1,0,2,14,12.3
LaMarcus Aldridge,31-149,F-C,12/15/16,SAS,PHO,1,27,6,11,0.545,6,11,0.545,0,0,,2,2,1,3,4,7,2,0,1,5,4,14,7.5
Nerlens Noel,22-345,C-F,3/21/17,DAL,GSW,0,17,5,7,0.714,5,7,0.714,0,0,,4,4,1,2,5,7,0,0,1,2,2,14,11.9
LaMarcus Aldridge,31-251,F-C,3/27/17,SAS,CLE,1,29,4,11,0.364,4,10,0.4,0,1,0,6,6,1,4,3,7,4,1,1,2,1,14,13.7
Andre Drummond,23-094,C,11/12/16,DET,DEN,1,27,7,11,0.636,7,11,0.636,0,0,,0,2,0,5,7,12,0,2,0,0,4,14,14.3
Taj Gibson,31-129,F,10/31/16,CHI,BRK,1,25,7,9,0.778,7,9,0.778,0,0,,0,0,,2,9,11,0,1,1,2,3,14,13.1
Timofey Mozgov,30-159,C,12/22/16,LAL,MIA,1,30,6,11,0.545,6,11,0.545,0,0,,2,2,1,0,5,5,0,0,1,1,1,14,9.5
Draymond Green,26-299,F,12/28/16,GSW,TOR,1,38,6,8,0.75,4,5,0.8,2,3,0.667,0,0,,0,6,6,10,2,2,4,3,14,17.8
Andre Iguodala,33-047,G-F,3/16/17,GSW,ORL,0,23,6,8,0.75,6,7,0.857,0,1,0,2,6,0.333,1,5,6,3,2,0,1,1,14,14.1
Paul Millsap,31-292,F,11/28/16,ATL,GSW,1,35,3,11,0.273,1,6,0.167,2,5,0.4,6,7,0.857,5,9,14,3,1,0,3,2,14,12.6
Sean Kilpatrick,26-351,G,12/22/16,BRK,GSW,1,32,4,11,0.364,3,6,0.5,1,5,0.2,5,7,0.714,0,4,4,2,0,0,4,1,14,5.3
Shaun Livingston,31-209,G,4/8/17,GSW,NOP,1,24,7,10,0.7,7,10,0.7,0,0,,0,0,,1,0,1,6,0,0,1,1,14,13.3
Mason Plumlee,26-321,C-F,1/20/17,POR,PHI,1,33,4,14,0.286,4,14,0.286,0,0,,6,10,0.6,3,8,11,2,1,3,1,3,14,11
Nikola Vucevic,26-095,C,1/27/17,ORL,BOS,1,23,7,10,0.7,7,9,0.778,0,1,0,0,0,,0,7,7,2,1,0,1,2,14,12.5
Lou Williams,30-046,G,12/12/16,LAL,SAC,0,26,3,12,0.25,1,7,0.143,2,5,0.4,6,8,0.75,0,1,1,2,1,1,2,0,14,7.4
Montrezl Harrell,22-342,F-C,1/2/17,HOU,WAS,1,33,6,11,0.545,6,11,0.545,0,0,,2,3,0.667,3,6,9,1,0,2,2,1,14,11.9
Tyler Johnson,24-251,G,1/13/17,MIA,MIL,0,30,6,12,0.5,5,7,0.714,1,5,0.2,1,2,0.5,0,2,2,5,3,2,0,4,14,14.5
Cameron Payne,22-210,G,3/6/17,CHI,DET,0,23,5,14,0.357,1,5,0.2,4,9,0.444,0,0,,0,3,3,3,0,0,1,1,14,7.8
Boban Marjanovic,28-240,C,4/12/17,DET,ORL,0,21,6,12,0.5,6,12,0.5,0,0,,2,2,1,6,5,11,0,1,3,0,2,14,16
Otto Porter,23-270,F,2/28/17,WAS,GSW,1,38,5,8,0.625,3,5,0.6,2,3,0.667,2,2,1,2,6,8,3,2,0,0,3,14,16.5
Clint Capela,22-261,F-C,2/3/17,HOU,CHI,1,32,7,8,0.875,7,8,0.875,0,0,,0,0,,2,7,9,0,0,1,1,4,14,12.8
Willy Hernangomez,22-288,C,3/11/17,NYK,DET,1,27,7,12,0.583,7,12,0.583,0,0,,0,0,,2,7,9,3,1,0,4,3,14,9.8
Matthew Dellavedova,26-142,G,1/28/17,MIL,BOS,1,28,4,7,0.571,3,5,0.6,1,2,0.5,5,6,0.833,0,3,3,6,1,0,4,4,14,10.8
Danilo Gallinari,28-122,F,12/8/16,DEN,WAS,1,32,3,11,0.273,2,3,0.667,1,8,0.125,7,9,0.778,0,4,4,1,1,0,5,4,14,3
Dwight Powell,25-194,F-C,1/30/17,DAL,CLE,0,29,6,11,0.545,6,9,0.667,0,2,0,2,2,1,4,4,8,0,2,2,0,3,14,14.9
Courtney Lee,31-048,G,11/20/16,NYK,ATL,1,38,6,13,0.462,4,10,0.4,2,3,0.667,0,0,,1,4,5,5,2,0,2,3,14,11.5
Willie Cauley-Stein,23-170,F-C,2/4/17,SAC,GSW,0,18,7,12,0.583,7,12,0.583,0,0,,0,0,,0,4,4,1,2,1,0,0,14,13
Marvin Williams,30-223,F,1/28/17,CHO,SAC,1,31,5,12,0.417,3,4,0.75,2,8,0.25,2,2,1,1,1,2,1,0,0,0,5,14,7.3
Nicolas Batum,27-357,F-G,12/5/16,CHO,DAL,1,37,5,14,0.357,5,8,0.625,0,6,0,4,4,1,0,14,14,7,0,0,2,3,14,12.1
D'Angelo Russell,20-353,G,2/10/17,LAL,MIL,1,27,4,9,0.444,0,1,0,4,8,0.5,2,2,1,0,3,3,5,1,0,2,1,14,12.3
Mirza Teletovic,31-059,F,11/16/16,MIL,ATL,0,26,5,10,0.5,1,1,1,4,9,0.444,0,0,,0,4,4,0,1,0,2,5,14,7.2
Kelly Oubre,21-053,F,1/31/17,WAS,NYK,0,28,5,7,0.714,3,3,1,2,4,0.5,2,2,1,0,2,2,0,0,0,0,4,14,10.1
Hollis Thompson,25-230,G-F,11/19/16,PHI,PHO,0,26,5,9,0.556,2,4,0.5,3,5,0.6,1,2,0.5,2,2,4,1,0,0,1,3,14,9.8
Eric Gordon,28-073,G,3/8/17,HOU,UTA,1,40,4,11,0.364,2,4,0.5,2,7,0.286,4,5,0.8,0,2,2,2,2,0,1,3,14,9.3
Austin Rivers,24-128,G,12/7/16,LAC,GSW,0,29,4,10,0.4,2,6,0.333,2,4,0.5,4,4,1,0,2,2,2,0,0,0,2,14,9.8
Clint Capela,22-287,F-C,3/1/17,HOU,LAC,1,26,4,9,0.444,4,9,0.444,0,0,,6,7,0.857,6,6,12,0,0,0,3,5,14,9.9
Seth Curry,26-172,G,2/11/17,DAL,ORL,1,27,6,12,0.5,4,7,0.571,2,5,0.4,0,0,,1,2,3,4,0,0,1,0,14,11.1
Timothe Luwawu-Cabarrot,21-338,F,4/12/17,PHI,NYK,1,24,5,10,0.5,4,7,0.571,1,3,0.333,3,4,0.75,0,2,2,3,0,0,3,5,14,6.3
Troy Williams,21-307,F,11/1/16,MEM,MIN,1,30,4,7,0.571,4,6,0.667,0,1,0,6,7,0.857,1,1,2,1,1,1,3,2,14,9.9
Blake Griffin,27-231,F,11/2/16,LAC,OKC,1,34,7,21,0.333,7,19,0.368,0,2,0,0,3,0,3,6,9,5,2,1,2,4,14,7.4
Markieff Morris,27-139,F,1/19/17,WAS,NYK,1,35,6,11,0.545,4,8,0.5,2,3,0.667,0,0,,2,4,6,4,0,2,3,1,14,12.1
J.J. Redick,32-279,G,3/30/17,LAC,PHO,1,30,4,10,0.4,1,4,0.25,3,6,0.5,3,4,0.75,0,1,1,0,0,0,2,5,14,4.5
Trevor Booker,29-010,F,12/5/16,BRK,WAS,1,31,6,9,0.667,6,8,0.75,0,1,0,2,4,0.5,6,7,13,1,2,1,4,1,14,14.6
Rudy Gobert,24-230,C,2/11/17,UTA,BOS,1,34,5,10,0.5,5,10,0.5,0,0,,4,5,0.8,4,9,13,0,1,2,2,5,14,12.5
Skal Labissiere,21-001,F,3/19/17,SAC,SAS,0,23,7,9,0.778,7,9,0.778,0,0,,0,0,,2,5,7,1,0,0,3,1,14,10.7
Stephen Curry,28-291,G,12/30/16,GSW,DAL,1,30,5,12,0.417,2,6,0.333,3,6,0.5,1,1,1,0,4,4,5,1,0,1,2,14,11.5
Jamal Crawford,36-267,G,12/12/16,LAC,POR,0,23,4,9,0.444,3,7,0.429,1,2,0.5,5,5,1,0,0,0,3,0,1,3,1,14,8.7
Matt Barnes,36-236,F,10/31/16,SAC,ATL,0,28,4,9,0.444,0,1,0,4,8,0.5,2,2,1,0,5,5,3,1,0,4,4,14,8.3
Devin Booker,20-099,G,2/6/17,PHO,NOP,1,37,5,20,0.25,4,12,0.333,1,8,0.125,3,4,0.75,0,2,2,5,1,2,3,4,14,3.5
Julius Randle,22-069,F,2/6/17,LAL,NYK,1,17,7,14,0.5,7,14,0.5,0,0,,0,0,,2,0,2,2,0,1,0,6,14,8.1
Al-Farouq Aminu,26-162,F,3/2/17,POR,OKC,0,32,6,9,0.667,5,6,0.833,1,3,0.333,1,3,0.333,1,5,6,1,3,1,0,1,14,15.5
J.J. Redick,32-269,G,3/20/17,LAC,NYK,1,23,4,11,0.364,1,5,0.2,3,6,0.5,3,3,1,0,3,3,3,0,0,1,1,14,9.5
Marshall Plumlee,24-272,C,4/12/17,NYK,PHI,0,26,7,11,0.636,7,11,0.636,0,0,,0,2,0,4,7,11,0,0,1,3,5,14,8.9
Lou Williams,30-154,G,3/30/17,HOU,POR,0,29,5,16,0.313,5,11,0.455,0,5,0,4,7,0.571,0,3,3,3,1,0,2,1,14,5.2
P.J. Tucker,31-238,F,12/29/16,PHO,TOR,1,30,4,7,0.571,2,4,0.5,2,3,0.667,4,4,1,1,3,4,0,0,0,0,5,14,10.3
Terrence Ross,26-031,F-G,3/8/17,ORL,CHI,1,31,5,12,0.417,3,8,0.375,2,4,0.5,2,3,0.667,1,2,3,1,0,0,0,3,14,8
Khris Middleton,25-228,F-G,3/28/17,MIL,CHO,1,35,4,12,0.333,4,7,0.571,0,5,0,6,7,0.857,0,5,5,1,0,0,1,4,14,6.4
Elfrid Payton,23-030,G,3/24/17,ORL,DET,1,29,5,11,0.455,4,10,0.4,1,1,1,3,5,0.6,2,9,11,10,0,0,3,1,14,15.2
Patrick Beverley,28-232,G,3/1/17,HOU,LAC,1,32,4,9,0.444,0,1,0,4,8,0.5,2,2,1,4,8,12,4,1,0,1,3,14,16.1
Jamal Crawford,37-000,G,3/20/17,LAC,NYK,0,29,5,10,0.5,4,6,0.667,1,4,0.25,3,4,0.75,0,1,1,0,1,0,1,4,14,7.3
Dwyane Wade,35-012,G,1/29/17,CHI,PHI,1,26,6,12,0.5,6,12,0.5,0,0,,2,2,1,2,4,6,6,3,0,4,1,14,13.4
Chris Paul,31-323,G,3/25/17,LAC,UTA,1,29,5,18,0.278,5,10,0.5,0,8,0,4,4,1,1,2,3,5,1,0,3,0,14,6.2
Anthony Tolliver,31-241,F-C,1/28/17,SAC,CHO,0,30,5,9,0.556,1,1,1,4,8,0.5,0,0,,0,7,7,3,2,1,0,2,14,15.8
Tim Hardaway,24-329,G,2/8/17,ATL,DEN,1,38,6,15,0.4,4,8,0.5,2,7,0.286,0,0,,1,1,2,6,1,0,0,1,14,11.7
Willie Reed,26-254,F-C,1/25/17,MIA,BRK,0,24,4,5,0.8,4,5,0.8,0,0,,6,8,0.75,1,3,4,1,1,1,0,3,14,14.1
Jordan Clarkson,24-187,G,12/11/16,LAL,NYK,0,32,6,10,0.6,6,9,0.667,0,1,0,2,3,0.667,2,2,4,4,0,0,0,1,14,13.4
Michael Kidd-Gilchrist,23-063,F,11/28/16,CHO,MEM,1,20,6,10,0.6,6,10,0.6,0,0,,2,4,0.5,2,5,7,2,1,1,1,1,14,13.2
Khris Middleton,25-226,F-G,3/26/17,MIL,CHI,1,35,6,17,0.353,4,11,0.364,2,6,0.333,0,0,,1,5,6,2,4,0,0,2,14,11.3
Evan Fournier,24-105,G-F,2/11/17,ORL,DAL,1,29,6,14,0.429,6,10,0.6,0,4,0,2,4,0.5,1,1,2,1,0,0,0,4,14,5.9
Malcolm Brogdon,24-105,G,3/26/17,MIL,CHI,1,30,5,12,0.417,5,11,0.455,0,1,0,4,4,1,3,1,4,4,2,0,1,1,14,13.4
Wilson Chandler,29-292,F,2/26/17,DEN,MEM,1,36,5,15,0.333,3,8,0.375,2,7,0.286,2,2,1,6,3,9,6,1,0,4,3,14,10.6
DeAndre Jordan,28-242,C,3/20/17,LAC,NYK,1,28,7,9,0.778,7,9,0.778,0,0,,0,0,,3,7,10,0,0,3,0,1,14,16.4
Andre Drummond,23-208,C,3/6/17,DET,CHI,1,30,5,8,0.625,5,8,0.625,0,0,,4,8,0.5,1,7,8,0,1,1,0,2,14,12.5
Joel Embiid,22-236,C-F,11/7/16,PHI,UTA,1,19,4,8,0.5,4,8,0.5,0,0,,6,9,0.667,4,5,9,0,1,1,5,5,14,7.8
Al Horford,30-148,C-F,10/29/16,BOS,CHO,1,31,6,10,0.6,5,9,0.556,1,1,1,1,2,0.5,0,4,4,3,0,2,1,2,14,11.9
Ersan Ilyasova,29-171,F,11/2/16,PHI,CHO,0,23,5,12,0.417,3,6,0.5,2,6,0.333,2,2,1,2,1,3,2,0,0,1,3,14,8.5
Elfrid Payton,22-331,G,1/18/17,ORL,NOP,1,24,5,10,0.5,3,7,0.429,2,3,0.667,2,2,1,0,2,2,3,1,0,3,2,14,8.9
Jeremy Lin,28-213,G,3/24/17,BRK,WAS,1,20,5,13,0.385,4,8,0.5,1,5,0.2,3,4,0.75,0,1,1,3,0,1,2,3,14,6.4
Shabazz Muhammad,24-019,F-G,12/2/16,MIN,NYK,0,21,6,10,0.6,4,5,0.8,2,5,0.4,0,0,,0,2,2,1,0,0,2,1,14,8.3
Robin Lopez,28-262,C,12/19/16,CHI,DET,1,26,7,10,0.7,7,10,0.7,0,0,,0,0,,3,3,6,0,0,0,1,3,14,10.6
Rudy Gobert,24-225,C,2/6/17,UTA,ATL,1,34,5,5,1,5,5,1,0,0,,4,7,0.571,1,5,6,3,1,3,2,3,14,15.5
Andre Iguodala,32-354,G-F,1/16/17,GSW,CLE,0,25,5,5,1,3,3,1,2,2,1,2,2,1,1,2,3,5,0,1,1,0,14,17
Matt Barnes,36-231,F,10/26/16,SAC,PHO,0,28,6,9,0.667,4,4,1,2,5,0.4,0,0,,1,6,7,3,0,0,1,4,14,12.1
Wesley Matthews,30-077,G,12/30/16,DAL,GSW,1,30,5,14,0.357,3,10,0.3,2,4,0.5,2,2,1,1,1,2,1,3,0,0,1,14,10.5
Marreese Speights,29-140,C-F,12/22/16,LAC,SAS,0,29,5,10,0.5,4,5,0.8,1,5,0.2,3,3,1,2,4,6,5,1,1,1,5,14,13.8
Danilo Gallinari,28-177,F,2/1/17,DEN,MEM,1,30,4,12,0.333,4,9,0.444,0,3,0,6,8,0.75,1,2,3,2,0,0,2,3,14,5.9
Alex Len,23-176,C,12/9/16,PHO,LAL,0,34,6,10,0.6,6,10,0.6,0,0,,2,4,0.5,5,9,14,2,1,4,1,4,14,17.4
Luc Mbah a Moute,30-102,F,12/20/16,LAC,DEN,1,31,5,8,0.625,4,6,0.667,1,2,0.5,3,3,1,1,2,3,1,0,1,1,0,14,12.1
James Johnson,29-298,F,12/14/16,MIA,IND,0,25,6,9,0.667,5,8,0.625,1,1,1,1,2,0.5,1,2,3,6,0,0,1,3,14,13
Jae Crowder,26-210,F,2/1/17,BOS,TOR,1,34,5,13,0.385,4,9,0.444,1,4,0.25,3,4,0.75,3,5,8,1,1,0,1,1,14,10.4
Ricky Rubio,26-099,G,1/28/17,MIN,BRK,1,22,5,9,0.556,5,7,0.714,0,2,0,4,4,1,0,3,3,6,1,0,2,5,14,11.8
Justin Holiday,27-267,G,12/28/16,NYK,ATL,0,34,5,12,0.417,3,5,0.6,2,7,0.286,2,2,1,1,2,3,4,2,1,3,1,14,11
Al Jefferson,32-003,C-F,1/7/17,IND,NYK,0,15,4,9,0.444,4,9,0.444,0,0,,6,6,1,4,3,7,2,1,0,0,0,14,15.4
Courtney Lee,31-091,G,1/2/17,NYK,ORL,1,34,6,11,0.545,5,7,0.714,1,4,0.25,1,1,1,1,2,3,0,1,0,2,2,14,8.2
Greg Monroe,26-144,C-F,10/26/16,MIL,CHO,0,29,5,13,0.385,5,13,0.385,0,0,,4,5,0.8,5,5,10,3,1,3,1,0,14,15.7
Jordan Clarkson,24-219,G,1/12/17,LAL,SAS,0,24,6,11,0.545,6,9,0.667,0,2,0,2,4,0.5,0,1,1,3,0,0,0,3,14,9.1
Patrick Patterson,27-261,F,11/30/16,TOR,MEM,0,30,5,10,0.5,1,4,0.25,4,6,0.667,0,0,,3,10,13,0,1,0,1,1,14,13.7
Rondae Hollis-Jefferson,22-012,F,1/15/17,BRK,HOU,0,17,5,8,0.625,5,8,0.625,0,0,,4,4,1,2,5,7,2,3,0,5,1,14,12.3
Derrick Rose,28-047,G,11/20/16,NYK,ATL,1,30,5,14,0.357,5,12,0.417,0,2,0,4,4,1,1,2,3,7,0,0,4,0,14,8.4
Kyle Korver,35-316,G-F,1/27/17,CLE,BRK,0,22,5,11,0.455,2,5,0.4,3,6,0.5,1,1,1,1,1,2,0,0,0,1,0,14,8.3
Glenn Robinson,23-021,G-F,1/29/17,IND,HOU,0,21,6,8,0.75,4,6,0.667,2,2,1,0,0,,1,5,6,0,0,0,0,0,14,13
Jrue Holiday,26-303,G,4/11/17,NOP,LAL,1,29,6,9,0.667,6,7,0.857,0,2,0,2,2,1,1,3,4,7,0,0,5,1,14,11.2
Dante Cunningham,29-323,F,3/11/17,NOP,CHO,0,34,6,7,0.857,5,5,1,1,2,0.5,1,1,1,2,4,6,1,0,1,0,1,14,15.1
Richard Jefferson,36-247,F,2/23/17,CLE,NYK,0,23,5,6,0.833,3,3,1,2,3,0.667,2,2,1,0,2,2,0,0,0,1,2,14,10.6
Amir Johnson,29-329,F,3/26/17,BOS,MIA,1,27,6,6,1,5,5,1,1,1,1,1,1,1,1,6,7,5,2,0,1,1,14,18.8
Spencer Dinwiddie,23-332,G,3/4/17,BRK,POR,0,27,4,7,0.571,4,5,0.8,0,2,0,6,6,1,1,2,3,3,0,1,1,2,14,13
Terry Rozier,23-002,G,3/19/17,BOS,PHI,0,26,4,12,0.333,2,5,0.4,2,7,0.286,4,4,1,4,6,10,2,1,1,2,2,14,12.1
Trey Lyles,21-035,F,12/10/16,UTA,SAC,0,19,4,14,0.286,1,6,0.167,3,8,0.375,3,3,1,3,2,5,2,1,0,3,0,14,7.9
Jon Leuer,27-296,F,3/6/17,DET,CHI,1,32,6,12,0.5,6,10,0.6,0,2,0,2,2,1,1,5,6,1,0,0,0,2,14,10.1
Tarik Black,25-056,C-F,1/17/17,LAL,DEN,0,20,7,13,0.538,7,13,0.538,0,0,,0,0,,6,2,8,0,0,1,1,3,14,11
Robert Covington,26-041,F,1/24/17,PHI,LAC,1,37,6,15,0.4,4,7,0.571,2,8,0.25,0,0,,4,4,8,2,3,2,1,5,14,12.7
Jusuf Nurkic,22-087,C,11/18/16,DEN,TOR,1,25,5,9,0.556,5,9,0.556,0,0,,4,6,0.667,0,1,1,1,1,0,1,3,14,8.7
E'Twaun Moore,28-019,G,3/19/17,NOP,MIN,0,28,6,11,0.545,5,8,0.625,1,3,0.333,1,1,1,2,1,3,3,0,0,1,1,14,11.1
Zach Randolph,35-147,F,12/10/16,MEM,GSW,0,21,6,11,0.545,5,9,0.556,1,2,0.5,1,1,1,2,5,7,1,0,0,0,1,14,11.9
Devin Harris,34-012,G,3/11/17,DAL,PHO,0,23,3,8,0.375,0,1,0,3,7,0.429,5,6,0.833,0,3,3,2,0,1,3,3,14,8
Nikola Mirotic,26-032,F,3/15/17,CHI,MEM,0,28,3,10,0.3,0,2,0,3,8,0.375,5,5,1,2,3,5,2,0,2,2,4,14,9.7
LaMarcus Aldridge,31-192,F-C,1/27/17,SAS,NOP,1,32,6,20,0.3,6,18,0.333,0,2,0,2,4,0.5,4,10,14,0,0,1,0,1,14,7.7
Lou Williams,30-059,G,12/25/16,LAL,LAC,0,24,5,11,0.455,4,8,0.5,1,3,0.333,3,4,0.75,0,3,3,1,1,1,3,2,14,7.4
Ricky Rubio,26-172,G,4/11/17,MIN,OKC,1,36,4,13,0.308,3,10,0.3,1,3,0.333,5,5,1,2,2,4,10,1,0,3,3,14,12.3
Steven Adams,23-112,C,11/9/16,OKC,TOR,1,35,3,5,0.6,3,5,0.6,0,0,,8,8,1,6,6,12,1,2,1,1,3,14,18.9
Tony Allen,35-084,G-F,4/5/17,MEM,OKC,1,28,7,10,0.7,7,9,0.778,0,1,0,0,0,,3,4,7,4,2,0,2,4,14,14.3
David Lee,33-283,F,2/6/17,SAS,MEM,0,17,6,6,1,6,6,1,0,0,,2,5,0.4,1,2,3,0,1,1,0,3,14,12.8
Bojan Bogdanovic,27-336,G-F,3/20/17,WAS,BOS,0,28,5,12,0.417,5,7,0.714,0,5,0,4,5,0.8,3,3,6,2,1,1,3,4,14,8.7
Channing Frye,33-263,C-F,2/4/17,CLE,NYK,0,16,5,9,0.556,1,1,1,4,8,0.5,0,2,0,1,2,3,2,0,0,2,2,14,8.8
Jeremy Lamb,24-280,G-F,3/6/17,CHO,IND,0,25,6,9,0.667,4,6,0.667,2,3,0.667,0,0,,1,4,5,2,0,0,1,1,14,12
Gorgui Dieng,26-343,C,12/26/16,MIN,ATL,1,35,6,12,0.5,6,12,0.5,0,0,,2,2,1,2,5,7,3,3,0,2,3,14,12.8
Robin Lopez,28-351,C,3/18/17,CHI,UTA,1,30,6,12,0.5,6,12,0.5,0,0,,2,2,1,3,2,5,1,0,2,1,2,14,11
Tobias Harris,24-177,F,1/8/17,DET,POR,0,38,7,16,0.438,7,11,0.636,0,5,0,0,0,,0,9,9,3,1,1,2,1,14,9.7
Ben McLemore,24-016,G,2/27/17,SAC,MIN,1,25,5,10,0.5,3,7,0.429,2,3,0.667,2,2,1,1,3,4,1,0,0,3,2,14,7.5
Sean Kilpatrick,27-022,G,1/28/17,BRK,MIN,0,25,6,10,0.6,6,9,0.667,0,1,0,2,2,1,0,1,1,1,0,0,0,0,14,10.4
Jaylen Brown,20-137,F,3/10/17,BOS,DEN,0,22,5,8,0.625,3,3,1,2,5,0.4,2,3,0.667,1,1,2,1,0,0,1,4,14,9.1
Joe Johnson,35-271,G-F,3/27/17,UTA,NOP,0,31,5,10,0.5,3,7,0.429,2,3,0.667,2,3,0.667,1,6,7,6,0,0,1,2,14,13.5
Kosta Koufos,28-010,C,3/6/17,SAC,DEN,1,24,7,12,0.583,7,12,0.583,0,0,,0,0,,3,6,9,1,1,1,2,3,14,11.5
Solomon Hill,25-313,F,1/25/17,NOP,OKC,1,28,6,10,0.6,4,6,0.667,2,4,0.5,0,0,,3,5,8,2,0,2,1,2,14,14
Tyler Johnson,24-251,G,1/13/17,MIA,MIL,0,30,6,12,0.5,5,7,0.714,1,5,0.2,1,2,0.5,0,2,2,5,3,2,0,4,14,14.5
Giannis Antetokounmpo,22-003,F-G,12/9/16,MIL,ATL,1,24,5,12,0.417,4,8,0.5,1,4,0.25,3,4,0.75,0,6,6,1,0,1,6,5,14,2.4
James Harden,27-227,G,4/10/17,HOU,LAC,1,24,2,9,0.222,1,3,0.333,1,6,0.167,9,14,0.643,1,6,7,6,1,0,5,5,14,7.2
Kent Bazemore,27-222,G-F,2/8/17,ATL,DEN,1,21,4,8,0.5,1,4,0.25,3,4,0.75,3,4,0.75,1,1,2,2,2,1,4,4,14,9.1
Dennis Schroder,23-195,G,3/29/17,ATL,PHI,1,38,6,16,0.375,6,16,0.375,0,0,,2,2,1,1,2,3,5,1,0,9,4,14,0.4
Jamal Murray,19-343,G,1/31/17,DEN,LAL,0,27,5,12,0.417,1,4,0.25,4,8,0.5,0,0,,1,1,2,3,1,0,1,0,14,10.7
Jordan Clarkson,24-159,G,11/13/16,LAL,MIN,0,22,6,10,0.6,6,10,0.6,0,0,,2,2,1,0,3,3,1,1,0,0,2,14,11.2
Tim Hardaway,24-327,G,2/6/17,ATL,UTA,1,29,4,9,0.444,3,7,0.429,1,2,0.5,5,6,0.833,0,3,3,3,1,0,3,1,14,9.5
Rashad Vaughn,20-081,G,11/5/16,MIL,SAC,0,25,5,9,0.556,1,1,1,4,8,0.5,0,0,,0,3,3,2,0,2,1,2,14,11.6
Evan Turner,28-047,G,12/13/16,POR,OKC,0,27,6,8,0.75,5,6,0.833,1,2,0.5,1,2,0.5,0,3,3,3,1,1,1,3,14,12.9
Markieff Morris,27-112,F,12/23/16,WAS,MIL,1,26,5,10,0.5,4,8,0.5,1,2,0.5,3,4,0.75,0,2,2,0,0,0,1,3,14,7
Tony Parker,34-330,G,4/12/17,SAS,UTA,1,24,5,8,0.625,5,7,0.714,0,1,0,4,4,1,0,1,1,2,1,0,2,2,14,10.3
Jae Crowder,26-113,F,10/27/16,BOS,CHI,1,35,4,6,0.667,3,4,0.75,1,2,0.5,5,5,1,1,5,6,1,1,0,1,4,14,12.7
Luis Scola,36-182,F,10/29/16,BRK,MIL,0,18,5,5,1,3,3,1,2,2,1,2,2,1,5,3,8,2,1,0,1,2,14,17.5
Aaron Brooks,31-353,G,1/1/17,IND,ORL,0,18,6,9,0.667,4,6,0.667,2,3,0.667,0,0,,0,2,2,2,0,1,0,2,14,12
Sergio Rodriguez,30-139,G,10/29/16,PHI,ATL,1,29,7,13,0.538,7,11,0.636,0,2,0,0,0,,1,3,4,5,1,0,4,1,14,9.4
Frank Kaminsky,23-348,F-C,3/18/17,CHO,WAS,0,30,4,14,0.286,2,7,0.286,2,7,0.286,4,8,0.5,1,3,4,2,0,1,1,2,14,6.1
Steven Adams,23-146,C,12/13/16,OKC,POR,1,26,6,10,0.6,6,9,0.667,0,1,0,2,3,0.667,2,2,4,1,4,0,4,0,14,11.7
Dion Waiters,25-095,G,3/15/17,MIA,NOP,1,29,5,15,0.333,4,9,0.444,1,6,0.167,3,4,0.75,0,1,1,3,2,0,3,1,14,6.1
Wayne Ellington,29-062,G,12/30/16,MIA,BOS,0,30,6,11,0.545,4,4,1,2,7,0.286,0,0,,0,1,1,2,0,0,0,2,14,9.6
Shelvin Mack,26-341,G,3/29/17,UTA,SAC,0,29,5,8,0.625,4,4,1,1,4,0.25,3,3,1,0,4,4,1,1,0,0,3,14,12.1
Allen Crabbe,24-207,G-F,11/2/16,POR,PHO,0,37,5,9,0.556,3,4,0.75,2,5,0.4,2,2,1,0,1,1,3,1,0,0,4,14,11.5
Jrue Holiday,26-220,G,1/18/17,NOP,ORL,1,26,6,13,0.462,4,9,0.444,2,4,0.5,0,0,,1,3,4,5,5,2,2,1,14,16.4
Trey Lyles,21-026,F,12/1/16,UTA,MIA,0,25,5,8,0.625,1,4,0.25,4,4,1,0,0,,0,1,1,1,1,1,1,0,14,12.1
James Johnson,30-020,F,3/12/17,MIA,IND,0,32,6,16,0.375,5,11,0.455,1,5,0.2,1,1,1,0,4,4,0,0,0,2,4,14,2.8
Trevor Booker,29-107,F,3/12/17,BRK,NYK,0,25,6,12,0.5,4,9,0.444,2,3,0.667,0,0,,5,4,9,0,0,0,1,2,14,10.9
Gorgui Dieng,26-285,C,10/29/16,MIN,SAC,1,35,5,9,0.556,5,8,0.625,0,1,0,4,4,1,4,9,13,2,0,2,1,4,14,15.4
Tyler Johnson,24-229,G,12/22/16,MIA,LAL,0,34,5,14,0.357,1,8,0.125,4,6,0.667,0,0,,0,1,1,6,1,1,0,1,14,12
Robin Lopez,28-284,C,1/10/17,CHI,WAS,1,34,5,10,0.5,5,10,0.5,0,0,,4,5,0.8,5,1,6,1,1,1,2,2,14,12
Spencer Dinwiddie,23-258,G,12/20/16,BRK,TOR,0,22,4,9,0.444,4,6,0.667,0,3,0,6,7,0.857,1,3,4,1,0,1,3,4,14,7.3
Jeremy Lamb,24-189,G-F,12/5/16,CHO,DAL,0,21,5,10,0.5,4,7,0.571,1,3,0.333,3,3,1,1,4,5,3,0,1,1,2,14,11.9
Bojan Bogdanovic,27-200,G-F,11/4/16,BRK,CHO,1,33,4,17,0.235,2,8,0.25,2,9,0.222,4,4,1,1,3,4,1,0,0,2,3,14,2.8
Thaddeus Young,28-280,F,3/28/17,IND,MIN,1,32,7,15,0.467,7,14,0.5,0,1,0,0,0,,1,3,4,2,1,0,2,2,14,7.5
Nene Hilario,34-198,F-C,3/30/17,HOU,POR,0,23,6,8,0.75,6,8,0.75,0,0,,2,2,1,3,4,7,4,0,0,3,1,14,13.5
Tony Snell,25-007,G-F,11/17/16,MIL,MIA,1,32,5,10,0.5,1,1,1,4,9,0.444,0,0,,2,4,6,1,0,0,0,2,14,11.5
Vince Carter,39-340,G-F,12/31/16,MEM,SAC,0,21,5,8,0.625,1,2,0.5,4,6,0.667,0,0,,0,3,3,0,1,1,1,0,14,12
Monta Ellis,31-112,G,2/15/17,IND,CLE,0,31,6,8,0.75,4,6,0.667,2,2,1,0,0,,0,2,2,7,1,0,3,1,14,13.9
Kent Bazemore,27-245,G-F,3/3/17,ATL,CLE,1,35,5,12,0.417,3,7,0.429,2,5,0.4,2,2,1,0,4,4,7,1,2,1,1,14,14.7
Deron Williams,32-158,G,12/1/16,DAL,CHO,1,30,6,14,0.429,5,7,0.714,1,7,0.143,1,1,1,0,3,3,9,0,0,2,2,14,11
Markieff Morris,27-208,F,3/29/17,WAS,LAC,1,15,4,6,0.667,2,3,0.667,2,3,0.667,4,4,1,0,4,4,0,0,0,1,4,14,10
Kawhi Leonard,25-287,F,4/12/17,SAS,UTA,1,31,5,13,0.385,4,11,0.364,1,2,0.5,3,3,1,1,4,5,2,1,0,1,2,14,9.4
Al Horford,30-221,C-F,1/10/17,BOS,TOR,1,35,5,11,0.455,3,7,0.429,2,4,0.5,2,2,1,2,7,9,4,1,0,3,1,14,12.2
Draymond Green,26-361,F,2/28/17,GSW,WAS,1,40,6,11,0.545,4,8,0.5,2,3,0.667,0,0,,1,7,8,14,2,1,2,1,14,21.6
Terrence Ross,25-292,F-G,11/23/16,TOR,HOU,0,20,6,12,0.5,4,9,0.444,2,3,0.667,0,0,,1,2,3,1,1,1,0,0,14,11.7
Tyreke Evans,27-128,G-F,1/25/17,NOP,OKC,0,22,5,11,0.455,4,8,0.5,1,3,0.333,3,6,0.5,0,5,5,9,1,0,2,3,14,12.7
Nik Stauskas,23-177,G,4/2/17,PHI,TOR,0,31,4,10,0.4,2,2,1,2,8,0.25,4,4,1,0,1,1,5,0,1,2,2,14,10.3
Avery Bradley,26-100,G,3/6/17,BOS,LAC,1,26,5,12,0.417,4,9,0.444,1,3,0.333,3,4,0.75,0,3,3,1,0,0,2,2,14,6
Anthony Morrow,31-062,G,11/28/16,OKC,NYK,0,20,5,7,0.714,2,2,1,3,5,0.6,1,2,0.5,0,0,0,1,0,0,0,0,14,11.4
Evan Fournier,24-132,G-F,3/10/17,ORL,CHO,1,25,6,13,0.462,4,7,0.571,2,6,0.333,0,0,,0,1,1,2,1,0,1,3,14,7.8
Marvin Williams,30-233,F,2/7/17,CHO,BRK,1,33,6,11,0.545,6,8,0.75,0,3,0,2,2,1,1,8,9,0,0,2,1,3,14,11
Deron Williams,32-124,G,10/28/16,DAL,HOU,1,34,5,11,0.455,4,7,0.571,1,4,0.25,3,4,0.75,0,0,0,4,1,0,3,3,14,7.5
Glenn Robinson,23-024,G-F,2/1/17,IND,ORL,0,21,5,5,1,3,3,1,2,2,1,2,2,1,1,6,7,0,0,0,0,1,14,14.6
Ish Smith,28-134,G,11/16/16,DET,NYK,1,35,6,7,0.857,5,6,0.833,1,1,1,1,2,0.5,1,1,2,8,1,0,3,1,14,15.3
DeMar DeRozan,27-113,G,11/28/16,TOR,PHI,1,31,4,13,0.308,4,13,0.308,0,0,,6,6,1,0,5,5,5,1,1,3,1,14,9.8
Marreese Speights,29-136,C-F,12/18/16,LAC,WAS,0,12,4,7,0.571,2,2,1,2,5,0.4,4,4,1,3,1,4,0,0,0,0,3,14,11.9
Zach Randolph,35-128,F,11/21/16,MEM,CHO,0,21,7,14,0.5,7,14,0.5,0,0,,0,0,,1,7,8,1,0,0,0,2,14,9.7
Jamal Murray,19-261,G,11/10/16,DEN,GSW,0,29,5,15,0.333,3,8,0.375,2,7,0.286,2,2,1,2,1,3,6,0,1,3,3,14,7.9
Pascal Siakam,22-303,F,12/3/16,TOR,ATL,1,27,7,12,0.583,7,11,0.636,0,1,0,0,0,,1,2,3,0,1,2,1,2,14,10.3
Matthew Dellavedova,26-051,G,10/29/16,MIL,BRK,1,36,5,10,0.5,5,9,0.556,0,1,0,4,4,1,1,2,3,9,3,0,1,4,14,17
Jaylen Brown,20-108,F,2/9/17,BOS,POR,1,33,3,7,0.429,1,4,0.25,2,3,0.667,6,8,0.75,1,6,7,2,1,0,1,1,14,13
Brandon Knight,25-007,G,12/9/16,PHO,LAL,0,23,5,11,0.455,4,8,0.5,1,3,0.333,3,3,1,1,1,2,4,1,0,0,1,14,12.7
Jonas Valanciunas,24-331,C,4/2/17,TOR,PHI,1,28,7,9,0.778,7,9,0.778,0,0,,0,0,,3,5,8,1,2,1,1,1,14,16.1
Danny Green,29-264,G-F,3/13/17,SAS,ATL,1,29,5,9,0.556,1,4,0.25,4,5,0.8,0,0,,0,5,5,1,2,2,2,1,14,12.9
Garrett Temple,30-234,G,12/28/16,SAC,POR,0,31,6,13,0.462,4,7,0.571,2,6,0.333,0,0,,0,3,3,1,2,0,1,3,14,8.7
Trevor Booker,29-075,F,2/8/17,BRK,WAS,0,28,6,12,0.5,6,12,0.5,0,0,,2,5,0.4,6,4,10,2,0,1,1,3,14,12.1
Tyson Chandler,34-102,C,1/12/17,PHO,DAL,1,38,5,8,0.625,5,8,0.625,0,0,,4,6,0.667,7,12,19,0,0,1,2,1,14,16.4
Darren Collison,29-108,G,12/9/16,SAC,NYK,1,30,5,11,0.455,4,9,0.444,1,2,0.5,3,3,1,0,3,3,3,2,0,0,1,14,12.9
Paul Millsap,31-345,F,1/20/17,ATL,CHI,1,24,4,5,0.8,2,3,0.667,2,2,1,4,4,1,2,7,9,2,1,2,3,1,14,16
Willie Cauley-Stein,23-232,F-C,4/7/17,SAC,LAL,1,23,6,11,0.545,6,11,0.545,0,0,,2,4,0.5,5,2,7,0,0,3,1,2,14,12.3
Channing Frye,33-282,C-F,2/23/17,CLE,NYK,1,27,5,14,0.357,3,7,0.429,2,7,0.286,2,2,1,0,4,4,0,0,2,2,1,14,6.4
Jonas Valanciunas,24-246,C,1/7/17,TOR,CHI,1,33,7,11,0.636,7,11,0.636,0,0,,0,0,,1,6,7,0,0,2,1,5,14,10
T.J. Warren,23-181,F,3/5/17,PHO,BOS,1,32,6,10,0.6,6,8,0.75,0,2,0,2,3,0.667,2,5,7,1,1,2,0,3,14,13.8
Seth Curry,26-152,G,1/22/17,DAL,LAL,1,27,6,8,0.75,4,4,1,2,4,0.5,0,0,,1,1,2,3,1,0,1,1,14,13.5
Marcus Morris,27-159,F,2/8/17,DET,LAL,1,28,6,14,0.429,5,11,0.455,1,3,0.333,1,2,0.5,2,4,6,3,1,0,0,0,14,11.9
Joe Harris,25-161,G,2/15/17,BRK,MIL,0,21,5,9,0.556,1,3,0.333,4,6,0.667,0,0,,0,1,1,2,1,0,0,0,14,12.4
Marquese Chriss,19-164,F,12/13/16,PHO,NYK,1,31,5,12,0.417,4,9,0.444,1,3,0.333,3,3,1,4,8,12,0,1,1,1,5,14,11.5
Ryan Anderson,28-205,F,11/27/16,HOU,POR,1,27,5,7,0.714,3,3,1,2,4,0.5,2,2,1,1,5,6,3,1,0,1,1,14,15
Evan Fournier,24-163,G-F,4/10/17,ORL,CHI,1,28,6,13,0.462,5,9,0.556,1,4,0.25,1,1,1,0,0,0,3,0,1,3,2,14,6.3
Tyreke Evans,27-117,G-F,1/14/17,NOP,CHI,0,22,6,15,0.4,6,12,0.5,0,3,0,2,3,0.667,0,1,1,6,1,0,1,1,14,9.6
Kenneth Faried,27-013,F,12/2/16,DEN,HOU,1,23,6,15,0.4,6,15,0.4,0,0,,2,2,1,9,2,11,1,0,0,1,2,14,11.7
Jeff Green,30-095,F,12/1/16,ORL,MEM,0,27,5,8,0.625,5,5,1,0,3,0,4,5,0.8,0,2,2,1,1,0,2,2,14,9.5
Andre Drummond,23-123,C,12/11/16,DET,PHI,1,36,6,14,0.429,6,14,0.429,0,0,,2,4,0.5,5,9,14,1,6,0,3,4,14,14.1
Ricky Rubio,26-127,G,2/25/17,MIN,HOU,1,32,3,8,0.375,1,3,0.333,2,5,0.4,6,7,0.857,1,2,3,11,1,0,6,3,14,12
Jon Leuer,27-177,F,11/7/16,DET,LAC,0,29,6,10,0.6,5,7,0.714,1,3,0.333,1,2,0.5,2,4,6,3,0,0,2,3,14,10.5
Avery Bradley,26-004,G,11/30/16,BOS,DET,1,36,4,12,0.333,0,4,0,4,8,0.5,2,2,1,0,6,6,0,1,0,1,1,14,8.6
Tobias Harris,24-177,F,1/8/17,DET,POR,0,38,7,16,0.438,7,11,0.636,0,5,0,0,0,,0,9,9,3,1,1,2,1,14,9.7
John Wall,26-192,G,3/17/17,WAS,CHI,1,34,4,13,0.308,3,10,0.3,1,3,0.333,5,6,0.833,0,0,0,20,1,1,2,2,14,19
Steven Adams,23-108,C,11/5/16,OKC,MIN,1,28,6,7,0.857,6,7,0.857,0,0,,2,2,1,3,5,8,2,2,2,3,1,14,16.5
Raymond Felton,32-209,G,1/21/17,LAC,DEN,0,30,6,17,0.353,4,11,0.364,2,6,0.333,0,0,,0,3,3,3,0,0,0,1,14,7.1
Jonas Valanciunas,24-327,C,3/29/17,TOR,CHO,1,29,5,6,0.833,5,6,0.833,0,0,,4,4,1,4,11,15,0,1,3,0,2,14,20.2
Meyers Leonard,24-267,C-F,11/20/16,POR,BRK,0,27,4,8,0.5,0,2,0,4,6,0.667,2,2,1,0,11,11,1,0,0,0,2,14,13.2
Caris LeVert,22-193,G-F,3/6/17,BRK,MEM,1,25,5,6,0.833,3,3,1,2,3,0.667,2,5,0.4,1,2,3,1,0,0,2,2,14,9.8
J.J. Redick,32-257,G,3/8/17,LAC,MIN,1,26,6,14,0.429,4,9,0.444,2,5,0.4,0,0,,0,1,1,1,2,1,1,0,14,9.3
Archie Goodwin,22-230,G,4/4/17,BRK,PHI,0,22,5,6,0.833,5,5,1,0,1,0,4,4,1,0,2,2,2,1,0,1,0,14,13.8
Eric Bledsoe,27-052,G,1/30/17,PHO,MEM,1,32,3,11,0.273,2,6,0.333,1,5,0.2,7,11,0.636,0,5,5,4,1,2,6,2,14,5.8
Dwight Howard,31-083,C,3/1/17,ATL,DAL,1,32,5,5,1,5,5,1,0,0,,4,6,0.667,2,10,12,4,3,2,5,3,14,17.1
Glenn Robinson,23-029,G-F,2/6/17,IND,OKC,0,24,5,5,1,2,2,1,3,3,1,1,2,0.5,1,1,2,1,1,0,0,0,14,14.8
Joffrey Lauvergne,25-188,C-F,4/6/17,CHI,PHI,0,15,6,10,0.6,6,9,0.667,0,1,0,2,2,1,1,1,2,1,1,0,2,0,14,10.1
Tim Hardaway,24-275,G,12/16/16,ATL,TOR,1,36,5,16,0.313,4,11,0.364,1,5,0.2,3,3,1,0,1,1,3,3,0,3,2,14,6.4
Dennis Schroder,23-068,G,11/22/16,ATL,NOP,1,27,6,13,0.462,5,9,0.556,1,4,0.25,1,2,0.5,0,4,4,7,0,0,0,1,14,12.6
Marcin Gortat,32-357,C-F,2/8/17,WAS,BRK,1,41,5,10,0.5,5,10,0.5,0,0,,4,4,1,3,11,14,1,1,1,1,5,14,13.8
Nikola Vucevic,26-149,C,3/22/17,ORL,CHO,1,30,6,12,0.5,6,10,0.6,0,2,0,2,2,1,2,10,12,8,1,3,1,2,14,19.3
Dwight Powell,25-162,F-C,12/29/16,DAL,LAL,0,14,7,9,0.778,7,8,0.875,0,1,0,0,0,,1,5,6,0,0,0,0,1,14,12.3
Joe Johnson,35-257,G-F,3/13/17,UTA,LAC,0,28,6,12,0.5,4,7,0.571,2,5,0.4,0,0,,0,3,3,2,0,0,1,1,14,8.9
Sean Kilpatrick,27-004,G,1/10/17,BRK,ATL,0,25,6,14,0.429,5,11,0.455,1,3,0.333,1,2,0.5,2,3,5,0,1,0,2,1,14,7.1
Harrison Barnes,24-281,F,3/7/17,DAL,LAL,1,35,6,14,0.429,6,12,0.5,0,2,0,2,4,0.5,1,5,6,2,0,0,3,1,14,6
Jeremy Lamb,24-285,G-F,3/11/17,CHO,NOP,0,21,4,9,0.444,3,5,0.6,1,4,0.25,5,5,1,0,4,4,2,1,1,0,0,14,13.6
Isaiah Whitehead,21-358,G,3/1/17,BRK,SAC,0,18,3,4,0.75,2,2,1,1,2,0.5,7,7,1,0,2,2,0,0,0,4,2,14,8.2
Christian Wood,21-164,F,3/10/17,CHO,ORL,0,16,5,6,0.833,5,6,0.833,0,0,,4,5,0.8,3,2,5,0,2,1,1,3,14,14.6
Andre Drummond,23-210,C,3/8/17,DET,IND,1,26,6,11,0.545,6,11,0.545,0,0,,2,5,0.4,6,9,15,1,2,0,1,4,14,14.5
T.J. Warren,23-218,F,4/11/17,PHO,SAC,1,37,6,19,0.316,5,17,0.294,1,2,0.5,1,2,0.5,3,4,7,2,2,0,0,2,14,8.6
Eric Gordon,27-336,G,11/25/16,HOU,SAC,0,29,5,13,0.385,1,1,1,4,12,0.333,0,0,,0,2,2,1,1,0,1,2,14,7.4
Steven Adams,23-102,C,10/30/16,OKC,LAL,1,30,6,12,0.5,6,12,0.5,0,0,,2,2,1,3,9,12,2,3,2,2,2,14,15.8
Joel Embiid,22-227,C-F,10/29/16,PHI,ATL,1,15,5,9,0.556,4,8,0.5,1,1,1,3,4,0.75,0,2,2,1,1,2,3,3,14,8.8
Markieff Morris,27-134,F,1/14/17,WAS,PHI,1,30,6,10,0.6,4,8,0.5,2,2,1,0,0,,0,9,9,1,0,0,3,4,14,8.2
Timofey Mozgov,30-171,C,1/3/17,LAL,MEM,1,38,7,12,0.583,7,12,0.583,0,0,,0,0,,1,4,5,1,1,1,1,6,14,9.3
Ricky Rubio,26-103,G,2/1/17,MIN,CLE,1,38,5,11,0.455,4,8,0.5,1,3,0.333,3,3,1,0,2,2,13,0,1,4,3,14,13.5
Darrell Arthur,28-313,F,2/1/17,DEN,MEM,0,16,4,9,0.444,0,2,0,4,7,0.571,2,2,1,0,5,5,0,0,0,0,1,14,10.4
Terry Rozier,22-353,G,3/5/17,BOS,PHO,0,20,5,9,0.556,1,4,0.25,4,5,0.8,0,0,,1,3,4,0,1,0,0,1,14,11.9
Alex Len,23-203,C,1/5/17,PHO,DAL,0,17,6,12,0.5,6,12,0.5,0,0,,2,2,1,5,2,7,0,0,1,2,2,14,10
Dennis Schroder,23-042,G,10/27/16,ATL,WAS,1,25,6,12,0.5,4,8,0.5,2,4,0.5,0,0,,0,2,2,2,1,0,4,3,14,5.8
Toney Douglas,30-273,G,12/14/16,MEM,CLE,0,28,6,10,0.6,4,7,0.571,2,3,0.667,0,1,0,0,6,6,5,2,0,1,3,14,14.1
Anthony Davis,23-275,F-C,12/11/16,NOP,PHO,1,44,4,17,0.235,4,14,0.286,0,3,0,6,6,1,3,9,12,4,1,2,3,4,14,9.1
Tyler Ennis,22-231,G,4/12/17,LAL,GSW,1,38,5,12,0.417,3,6,0.5,2,6,0.333,2,2,1,0,0,0,5,0,1,4,2,14,7
Jamal Crawford,36-360,G,3/15/17,LAC,MIL,0,31,5,8,0.625,4,5,0.8,1,3,0.333,3,3,1,0,2,2,3,0,0,3,4,14,8.5
Greg Monroe,26-207,C-F,12/28/16,MIL,DET,0,27,7,10,0.7,7,10,0.7,0,0,,0,1,0,0,5,5,6,2,1,2,2,14,15
Troy Daniels,25-208,G,2/8/17,MEM,PHO,0,22,5,11,0.455,1,2,0.5,4,9,0.444,0,0,,0,3,3,0,1,0,2,4,14,6.6
Ersan Ilyasova,29-318,F,3/29/17,ATL,PHI,1,32,5,10,0.5,3,6,0.5,2,4,0.5,2,2,1,1,2,3,3,0,1,2,3,14,9.9
Evan Fournier,24-039,G-F,12/7/16,ORL,BOS,1,29,4,14,0.286,3,11,0.273,1,3,0.333,5,6,0.833,0,3,3,5,1,0,0,2,14,10
Emmanuel Mudiay,21-035,G,4/9/17,DEN,OKC,0,24,7,10,0.7,7,9,0.778,0,1,0,0,0,,1,4,5,3,1,0,3,1,14,11.4
Greg Monroe,26-178,C-F,11/29/16,MIL,CLE,0,26,6,8,0.75,6,8,0.75,0,0,,2,2,1,3,3,6,4,2,1,3,2,14,15.5
Kristaps Porzingis,21-101,F-C,11/11/16,NYK,BOS,1,23,5,15,0.333,5,13,0.385,0,2,0,4,4,1,2,4,6,1,1,2,1,4,14,8.6
David Lee,33-267,F,1/21/17,SAS,CLE,1,36,7,11,0.636,7,11,0.636,0,0,,0,0,,3,8,11,3,0,1,1,3,14,14.2
Manu Ginobili,39-175,G,1/19/17,SAS,DEN,0,20,6,11,0.545,5,8,0.625,1,3,0.333,1,1,1,0,5,5,4,3,0,0,0,14,16
Tyler Ulis,21-057,G,3/3/17,PHO,OKC,0,21,6,9,0.667,6,9,0.667,0,0,,2,2,1,0,4,4,7,3,0,4,2,14,14.4
Patrick Patterson,27-252,F,11/21/16,TOR,LAC,0,36,4,8,0.5,1,2,0.5,3,6,0.5,3,3,1,0,6,6,2,2,0,2,4,14,11.6
Paul Zipser,22-344,G-F,1/27/17,CHI,MIA,1,27,5,11,0.455,4,7,0.571,1,4,0.25,3,3,1,0,5,5,0,1,0,1,2,14,9
Nene Hilario,34-186,F-C,3/18/17,HOU,DEN,0,24,6,12,0.5,6,12,0.5,0,0,,2,4,0.5,3,4,7,2,0,0,1,5,14,8.9
LaMarcus Aldridge,31-113,F-C,11/9/16,SAS,HOU,1,31,5,15,0.333,5,14,0.357,0,1,0,4,5,0.8,3,2,5,2,2,1,3,3,14,7.7
Vince Carter,39-332,G-F,12/23/16,MEM,HOU,0,22,5,8,0.625,1,2,0.5,4,6,0.667,0,0,,0,4,4,0,0,0,0,1,14,11.2
Randy Foye,33-174,G,3/17/17,BRK,BOS,1,27,4,7,0.571,1,2,0.5,3,5,0.6,3,4,0.75,0,1,1,0,0,1,1,4,14,8.7
Eric Bledsoe,27-059,G,2/6/17,PHO,NOP,1,24,3,9,0.333,2,5,0.4,1,4,0.25,7,8,0.875,0,7,7,5,0,0,4,4,14,8.5
Sean Kilpatrick,26-330,G,12/1/16,BRK,MIL,1,30,5,10,0.5,3,4,0.75,2,6,0.333,2,2,1,1,5,6,4,1,0,6,3,14,7.8
Jameer Nelson,34-268,G,11/3/16,DEN,MIN,0,34,5,10,0.5,3,6,0.5,2,4,0.5,2,2,1,1,6,7,7,1,0,5,2,14,11.6
Jonas Valanciunas,24-252,C,1/13/17,TOR,BRK,1,25,4,9,0.444,4,9,0.444,0,0,,6,6,1,3,7,10,1,1,1,0,2,14,15.1
Norman Powell,23-290,G,3/11/17,TOR,MIA,1,35,5,14,0.357,5,10,0.5,0,4,0,4,6,0.667,1,0,1,0,0,0,1,4,14,3.5
DeMar DeRozan,27-213,G,3/8/17,TOR,NOP,1,38,5,15,0.333,5,14,0.357,0,1,0,4,6,0.667,1,1,2,6,3,0,0,0,14,12.9
DeAndre Jordan,28-225,C,3/3/17,LAC,MIL,1,32,5,7,0.714,5,7,0.714,0,0,,4,13,0.308,3,7,10,0,0,1,1,4,14,9.8
T.J. Warren,23-159,F,2/11/17,PHO,HOU,1,28,6,10,0.6,5,8,0.625,1,2,0.5,1,2,0.5,2,3,5,0,3,0,1,3,14,12.1
Markieff Morris,27-204,F,3/25/17,WAS,CLE,1,36,5,12,0.417,5,11,0.455,0,1,0,4,6,0.667,1,5,6,0,0,1,0,4,14,8.1
Hassan Whiteside,27-141,C,11/1/16,MIA,SAC,1,28,6,13,0.462,6,13,0.462,0,0,,2,4,0.5,2,9,11,0,1,2,5,5,14,6
James Jones,36-107,F-G,1/19/17,CLE,PHO,1,20,5,8,0.625,1,2,0.5,4,6,0.667,0,0,,0,0,0,2,0,1,2,3,14,9.3
Al Jefferson,32-081,C-F,3/26/17,IND,PHI,0,11,6,9,0.667,6,9,0.667,0,0,,2,2,1,4,3,7,0,1,0,0,0,14,14.8
Brook Lopez,28-304,C,1/30/17,BRK,MIA,1,31,5,17,0.294,5,11,0.455,0,6,0,4,6,0.667,2,1,3,3,1,2,1,2,14,7.7
Iman Shumpert,26-164,G,12/7/16,CLE,NYK,0,23,4,8,0.5,0,2,0,4,6,0.667,2,2,1,0,6,6,1,2,0,3,4,14,9.9
Isaiah Whitehead,21-274,G,12/7/16,BRK,DEN,1,29,5,11,0.455,3,6,0.5,2,5,0.4,2,3,0.667,0,2,2,2,4,1,2,2,14,11.8
Ian Clark,25-311,G,1/12/17,GSW,DET,0,16,4,8,0.5,1,4,0.25,3,4,0.75,3,4,0.75,0,2,2,1,2,0,0,0,14,12.9
Michael Kidd-Gilchrist,23-066,F,12/1/16,CHO,DAL,1,33,4,9,0.444,4,9,0.444,0,0,,6,8,0.75,1,2,3,2,0,1,1,3,14,9.7
James Johnson,29-319,F,1/4/17,MIA,SAC,0,25,4,8,0.5,2,5,0.4,2,3,0.667,4,4,1,2,4,6,6,0,3,3,6,14,13.5
Andre Roberson,25-015,G-F,12/19/16,OKC,ATL,1,40,5,14,0.357,2,5,0.4,3,9,0.333,1,2,0.5,2,3,5,1,1,0,3,1,14,6.4
Vince Carter,40-006,G-F,2/1/17,MEM,DEN,0,26,4,6,0.667,1,3,0.333,3,3,1,3,4,0.75,1,4,5,6,0,1,0,3,14,16.6
Dwight Powell,25-142,F-C,12/9/16,DAL,IND,0,21,3,6,0.5,3,5,0.6,0,1,0,8,8,1,1,4,5,1,0,0,1,5,14,10.6
James Johnson,29-325,F,1/10/17,MIA,GSW,0,30,6,14,0.429,5,7,0.714,1,7,0.143,1,2,0.5,0,2,2,6,2,0,2,4,14,9.4
Doug McDermott,25-026,F,1/29/17,CHI,PHI,0,20,5,9,0.556,3,6,0.5,2,3,0.667,2,2,1,0,3,3,0,0,0,0,0,14,10.6
Patrick Patterson,28-011,F,3/25/17,TOR,DAL,0,24,5,6,0.833,1,2,0.5,4,4,1,0,0,,2,3,5,1,0,0,0,2,14,14
Tobias Harris,24-168,F,12/30/16,DET,ATL,1,38,5,14,0.357,3,8,0.375,2,6,0.333,2,2,1,1,4,5,2,0,1,1,1,14,8.8
Arron Afflalo,31-137,G,3/1/17,SAC,BRK,1,26,4,7,0.571,2,5,0.4,2,2,1,4,4,1,0,3,3,0,1,0,0,0,14,12.6
Danilo Gallinari,28-162,F,1/17/17,DEN,LAL,1,39,6,13,0.462,4,7,0.571,2,6,0.333,0,1,0,0,5,5,6,1,0,1,1,14,12.2
Klay Thompson,26-267,G,11/1/16,GSW,POR,1,30,6,17,0.353,6,10,0.6,0,7,0,2,2,1,2,3,5,4,0,0,2,4,14,6
Alex Abrines,23-148,G-F,12/27/16,OKC,MIA,0,22,5,9,0.556,1,2,0.5,4,7,0.571,0,0,,1,1,2,0,0,1,0,4,14,9.8
LaMarcus Aldridge,31-115,F-C,11/11/16,SAS,DET,1,37,6,14,0.429,6,14,0.429,0,0,,2,2,1,1,11,12,1,0,0,1,1,14,9.9
Paul Millsap,31-310,F,12/16/16,ATL,TOR,1,28,5,9,0.556,4,7,0.571,1,2,0.5,3,4,0.75,1,4,5,4,1,1,2,4,14,12.1
Ryan Anderson,28-194,F,11/16/16,HOU,OKC,1,33,5,13,0.385,1,4,0.25,4,9,0.444,0,0,,0,3,3,0,0,0,0,1,14,7.4
Steven Adams,23-131,C,11/28/16,OKC,NYK,1,32,7,11,0.636,7,11,0.636,0,0,,0,0,,4,6,10,0,0,0,1,2,14,11.9
Amir Johnson,29-195,F,11/12/16,BOS,IND,1,31,4,8,0.5,4,7,0.571,0,1,0,6,6,1,5,4,9,3,0,1,3,4,14,12.9
JaMychal Green,26-208,F,1/15/17,MEM,CHI,1,20,6,8,0.75,4,5,0.8,2,3,0.667,0,0,,2,3,5,0,0,0,0,4,14,11.5
Vince Carter,40-018,G-F,2/13/17,MEM,BRK,0,20,5,8,0.625,1,3,0.333,4,5,0.8,0,0,,0,3,3,1,2,0,0,1,14,13.6
Andre Roberson,25-032,G-F,1/5/17,OKC,HOU,1,36,6,11,0.545,6,8,0.75,0,3,0,2,2,1,5,4,9,0,0,2,0,4,14,13.2
Jose Calderon,35-164,G,3/11/17,ATL,MEM,0,19,4,6,0.667,2,3,0.667,2,3,0.667,4,5,0.8,0,3,3,1,0,0,1,4,14,10
Kawhi Leonard,25-129,F,11/5/16,SAS,LAC,1,28,3,13,0.231,3,10,0.3,0,3,0,8,8,1,1,5,6,1,1,1,2,1,14,8.3
Jamal Crawford,36-225,G,10/31/16,LAC,PHO,0,27,5,10,0.5,5,10,0.5,0,0,,4,4,1,0,2,2,3,2,0,1,0,14,12.7
Jamal Murray,20-016,G,3/11/17,DEN,SAC,0,20,5,10,0.5,3,5,0.6,2,5,0.4,2,2,1,2,1,3,0,2,0,1,3,14,10.5
Wilson Chandler,29-252,F,1/17/17,DEN,LAL,0,26,5,11,0.455,5,9,0.556,0,2,0,4,5,0.8,2,4,6,1,0,3,2,3,14,10.1
Jared Dudley,31-126,F-G,11/13/16,PHO,GSW,0,31,5,9,0.556,2,4,0.5,3,5,0.6,1,2,0.5,0,3,3,5,1,0,1,2,14,12.9
Dante Cunningham,29-296,F,2/12/17,NOP,SAC,1,38,5,12,0.417,1,5,0.2,4,7,0.571,0,0,,1,5,6,2,0,0,1,3,14,9
Evan Fournier,24-067,G-F,1/4/17,ORL,ATL,0,30,6,14,0.429,4,8,0.5,2,6,0.333,0,0,,0,1,1,1,1,0,2,2,14,5.8
Greg Monroe,26-226,C-F,1/16/17,MIL,PHI,0,21,6,13,0.462,6,13,0.462,0,0,,2,4,0.5,4,2,6,2,1,0,3,1,14,8.9
Jonas Valanciunas,24-311,C,3/13/17,TOR,DAL,1,23,5,11,0.455,5,11,0.455,0,0,,4,5,0.8,3,9,12,2,0,1,1,1,14,13.4
Brandon Ingram,19-154,F,2/3/17,LAL,BOS,0,33,5,10,0.5,3,6,0.5,2,4,0.5,2,2,1,1,5,6,1,0,0,2,2,14,9.1
Dante Exum,21-127,G,11/17/16,UTA,CHI,1,34,5,12,0.417,3,7,0.429,2,5,0.4,2,2,1,1,3,4,2,1,0,0,2,14,10.8
Ryan Anderson,28-217,F,12/9/16,HOU,OKC,1,32,5,15,0.333,1,4,0.25,4,11,0.364,0,0,,3,5,8,1,1,0,1,1,14,9.4
Devin Harris,33-340,G,2/1/17,DAL,PHI,0,19,3,5,0.6,0,2,0,3,3,1,5,5,1,0,1,1,3,0,0,0,2,14,13.3
Jaylen Brown,20-132,F,3/5/17,BOS,PHO,1,30,4,8,0.5,3,7,0.429,1,1,1,5,10,0.5,2,4,6,3,1,0,1,4,14,11.1
Jamal Crawford,36-323,G,2/6/17,LAC,TOR,0,27,5,12,0.417,3,6,0.5,2,6,0.333,2,3,0.667,0,1,1,3,1,2,3,1,14,8.6
Reggie Jackson,26-244,G,12/16/16,DET,WAS,1,24,4,10,0.4,2,5,0.4,2,5,0.4,4,6,0.667,0,1,1,2,0,0,0,4,14,7.9
Serge Ibaka,27-038,F-C,10/26/16,ORL,MIA,1,36,6,17,0.353,4,13,0.308,2,4,0.5,0,0,,2,6,8,0,0,1,0,3,14,7.2
Marcus Smart,22-242,G,11/3/16,BOS,CLE,0,28,5,9,0.556,2,3,0.667,3,6,0.5,1,2,0.5,0,2,2,2,0,1,0,4,14,10.4
Harrison Barnes,24-156,F,11/2/16,DAL,UTA,1,36,6,13,0.462,6,10,0.6,0,3,0,2,2,1,0,2,2,1,0,1,1,1,14,7.9
Matt Barnes,36-336,F,2/8/17,SAC,BOS,0,31,3,6,0.5,0,0,,3,6,0.5,5,5,1,0,11,11,4,1,0,3,3,14,13.9
Michael Beasley,27-335,F,12/9/16,MIL,ATL,0,23,6,7,0.857,5,6,0.833,1,1,1,1,1,1,2,4,6,2,0,3,0,6,14,15.2
Terrence Ross,25-304,F-G,12/5/16,TOR,CLE,0,22,4,9,0.444,0,2,0,4,7,0.571,2,2,1,1,0,1,1,0,4,0,4,14,11.9
Carmelo Anthony,32-185,F,11/30/16,NYK,MIN,1,35,5,16,0.313,4,10,0.4,1,6,0.167,3,4,0.75,1,3,4,2,3,0,3,3,14,6.2
Hassan Whiteside,27-218,C,1/17/17,MIA,HOU,1,33,5,8,0.625,5,8,0.625,0,0,,4,6,0.667,4,11,15,0,1,1,1,4,14,14.8
Will Barton,25-362,G,1/2/17,DEN,GSW,0,27,6,11,0.545,4,6,0.667,2,5,0.4,0,0,,2,5,7,4,0,0,2,2,14,11.6
JaMychal Green,26-157,F,11/25/16,MEM,MIA,1,32,5,9,0.556,5,9,0.556,0,0,,4,4,1,3,3,6,1,0,0,2,3,14,10.2
Paul Millsap,31-362,F,2/6/17,ATL,UTA,1,36,4,14,0.286,3,11,0.273,1,3,0.333,5,8,0.625,3,5,8,3,1,0,2,4,14,7.7
Garrett Temple,30-309,G,3/13/17,SAC,ORL,1,35,6,9,0.667,4,4,1,2,5,0.4,0,0,,0,3,3,4,2,0,4,2,14,11
Kyle Anderson,23-125,F-G,1/23/17,SAS,BRK,1,35,6,10,0.6,5,9,0.556,1,1,1,1,2,0.5,0,3,3,3,1,2,0,0,14,14.4
Buddy Hield,23-001,G,12/18/16,NOP,SAS,1,25,6,11,0.545,4,7,0.571,2,4,0.5,0,0,,1,2,3,2,0,0,2,1,14,9
Georgios Papagiannis,19-258,C,3/18/17,SAC,OKC,0,22,6,10,0.6,6,10,0.6,0,0,,2,2,1,2,9,11,1,1,1,1,2,14,14.1
Dwight Powell,25-201,F-C,2/6/17,DAL,DEN,0,26,6,8,0.75,6,7,0.857,0,1,0,2,4,0.5,2,2,4,2,2,2,0,1,14,16.4
Thaddeus Young,28-153,F,11/21/16,IND,GSW,1,29,6,14,0.429,4,10,0.4,2,4,0.5,0,0,,3,3,6,0,0,0,2,2,14,6.8
D.J. Augustin,29-067,G,1/16/17,ORL,DEN,0,19,5,8,0.625,3,4,0.75,2,4,0.5,2,2,1,0,1,1,3,0,0,0,0,14,12.8
Kelly Olynyk,25-223,C-F,11/28/16,BOS,MIA,0,20,5,7,0.714,3,4,0.75,2,3,0.667,2,2,1,0,6,6,4,0,2,3,4,14,12.5
Bradley Beal,23-150,G,11/25/16,WAS,ORL,1,38,6,15,0.4,4,9,0.444,2,6,0.333,0,0,,0,2,2,8,1,0,3,1,14,9.7
Malcolm Brogdon,24-103,G,3/24/17,MIL,ATL,1,35,6,14,0.429,5,10,0.5,1,4,0.25,1,1,1,1,2,3,7,0,0,3,3,14,8.6
Greg Monroe,26-195,C-F,12/16/16,MIL,CHI,0,23,6,14,0.429,6,14,0.429,0,0,,2,3,0.667,4,8,12,3,0,0,3,2,14,9.7
Brandon Knight,25-011,G,12/13/16,PHO,NYK,0,20,4,11,0.364,2,6,0.333,2,5,0.4,4,6,0.667,0,2,2,3,0,0,2,0,14,7.8
Eric Gordon,28-035,G,1/29/17,HOU,IND,0,26,4,11,0.364,3,4,0.75,1,7,0.143,5,7,0.714,0,1,1,3,0,1,2,4,14,6.6
Joe Johnson,35-174,G-F,12/20/16,UTA,GSW,0,22,5,9,0.556,3,6,0.5,2,3,0.667,2,2,1,0,2,2,0,0,0,2,1,14,7.9
Dwight Howard,30-356,C,11/28/16,ATL,GSW,1,37,5,8,0.625,5,8,0.625,0,0,,4,8,0.5,4,12,16,0,1,1,3,4,14,12.3
Tony Parker,34-183,G,11/16/16,SAS,SAC,1,26,7,10,0.7,7,10,0.7,0,0,,0,0,,0,3,3,7,1,0,2,1,14,14.2
Tobias Harris,24-250,F,3/22/17,DET,CHI,1,31,6,12,0.5,5,9,0.556,1,3,0.333,1,1,1,1,3,4,3,1,0,3,3,14,8.5
Brandon Knight,24-343,G,11/9/16,PHO,DET,0,17,5,9,0.556,4,7,0.571,1,2,0.5,3,3,1,0,1,1,3,0,0,3,0,14,9.1
Nikola Mirotic,25-267,F,11/4/16,CHI,NYK,0,21,4,10,0.4,2,4,0.5,2,6,0.333,4,4,1,0,6,6,0,0,1,2,2,14,8.3
Eric Gordon,28-066,G,3/1/17,HOU,LAC,0,27,4,10,0.4,1,1,1,3,9,0.333,3,4,0.75,0,3,3,1,0,0,2,1,14,7.4
Otto Porter,23-234,F,1/23/17,WAS,CHO,1,35,6,11,0.545,4,5,0.8,2,6,0.333,0,0,,1,11,12,2,0,0,0,1,14,13.7
Russell Westbrook,27-361,G,11/7/16,OKC,MIA,1,27,5,16,0.313,4,10,0.4,1,6,0.167,3,3,1,2,3,5,11,0,0,5,2,14,9
Arron Afflalo,31-102,G,1/25/17,SAC,CLE,1,40,5,8,0.625,1,2,0.5,4,6,0.667,0,0,,0,2,2,3,0,0,2,4,14,9.5
Damjan Rudez,30-224,F,1/27/17,ORL,BOS,0,24,5,5,1,1,1,1,4,4,1,0,0,,0,0,0,1,2,1,0,1,14,15.5
Jon Leuer,27-182,F,11/12/16,DET,DEN,0,26,7,12,0.583,7,11,0.636,0,1,0,0,0,,3,7,10,0,1,0,0,2,14,12.8
Nikola Mirotic,26-014,F,2/25/17,CHI,CLE,0,29,5,8,0.625,3,3,1,2,5,0.4,2,4,0.5,2,8,10,1,2,0,0,1,14,15.7
Jahlil Okafor,21-086,C-F,3/11/17,PHI,LAC,1,21,6,10,0.6,6,10,0.6,0,0,,2,2,1,0,4,4,4,3,0,4,0,14,12.4
Luol Deng,31-269,F,1/10/17,LAL,POR,1,30,5,10,0.5,4,8,0.5,1,2,0.5,3,4,0.75,4,2,6,0,1,0,0,0,14,13
Jahlil Okafor,20-348,C-F,11/27/16,PHI,CLE,0,23,7,11,0.636,7,11,0.636,0,0,,0,0,,2,7,9,1,0,0,2,4,14,9.7
Quincy Acy,26-107,F,1/21/17,BRK,CHO,0,17,5,7,0.714,2,3,0.667,3,4,0.75,1,1,1,0,4,4,1,2,1,0,2,14,14.9
Trevor Booker,28-339,F,10/29/16,BRK,MIL,1,31,4,8,0.5,4,6,0.667,0,2,0,6,6,1,1,13,14,1,1,2,0,2,14,16.9
Tony Parker,34-323,G,4/5/17,SAS,LAL,1,16,7,11,0.636,7,10,0.7,0,1,0,0,1,0,0,1,1,4,1,0,2,0,14,10.8
Eric Bledsoe,27-083,G,3/2/17,PHO,CHO,1,25,3,4,0.75,2,3,0.667,1,1,1,7,8,0.875,0,4,4,7,1,1,4,2,14,15
Rodney Hood,24-086,G-F,1/14/17,UTA,ORL,1,33,6,14,0.429,4,7,0.571,2,7,0.286,0,1,0,0,4,4,2,1,0,3,2,14,6
Michael Carter-Williams,25-097,G,1/15/17,CHI,MEM,1,27,5,8,0.625,5,7,0.714,0,1,0,4,5,0.8,1,6,7,3,1,1,2,3,14,13.1
Klay Thompson,26-345,G,1/18/17,GSW,OKC,1,30,5,12,0.417,2,7,0.286,3,5,0.6,1,2,0.5,1,3,4,3,1,1,1,2,14,10.8
Courtney Lee,31-071,G,12/13/16,NYK,PHO,1,29,6,8,0.75,4,5,0.8,2,3,0.667,0,0,,1,1,2,2,2,0,0,3,14,14
Marco Belinelli,30-306,G-F,1/25/17,CHO,GSW,0,25,3,5,0.6,2,2,1,1,3,0.333,7,7,1,0,1,1,1,1,0,1,2,14,11.9
Maurice Harkless,23-244,F-G,1/10/17,POR,LAL,1,32,5,6,0.833,4,4,1,1,2,0.5,3,4,0.75,0,5,5,1,1,3,2,3,14,13.5
Al-Farouq Aminu,26-162,F,3/2/17,POR,OKC,0,32,6,9,0.667,5,6,0.833,1,3,0.333,1,3,0.333,1,5,6,1,3,1,0,1,14,15.5
DeAndre Jordan,28-184,C,1/21/17,LAC,DEN,1,27,6,10,0.6,6,10,0.6,0,0,,2,2,1,8,5,13,3,0,1,2,5,14,15.3
Danilo Gallinari,28-167,F,1/22/17,DEN,MIN,1,35,4,10,0.4,2,6,0.333,2,4,0.5,4,4,1,1,5,6,4,0,0,1,0,14,12.6
Nikola Vucevic,26-168,C,4/10/17,ORL,CHI,1,27,6,14,0.429,5,13,0.385,1,1,1,1,2,0.5,5,5,10,2,0,1,2,1,14,10.9
Jamal Crawford,36-354,G,3/9/17,LAC,MEM,0,26,5,9,0.556,2,4,0.5,3,5,0.6,1,1,1,0,4,4,2,1,0,1,2,14,11.5
JaMychal Green,26-172,F,12/10/16,MEM,GSW,1,29,4,7,0.571,2,5,0.4,2,2,1,4,5,0.8,2,8,10,2,1,0,2,4,14,12.9
Dwight Powell,25-184,F-C,1/20/17,DAL,UTA,0,27,5,6,0.833,5,6,0.833,0,0,,4,6,0.667,2,1,3,0,0,0,0,5,14,10.7
Dwight Powell,25-240,F-C,3/17/17,DAL,PHI,0,18,6,12,0.5,4,7,0.571,2,5,0.4,0,0,,0,0,0,1,0,0,1,2,14,6.9
Zach LaVine,21-274,G,12/9/16,MIN,DET,1,35,6,12,0.5,6,9,0.667,0,3,0,2,4,0.5,0,3,3,5,1,0,3,1,14,9.2
Bismack Biyombo,24-189,C-F,3/5/17,ORL,WAS,1,34,5,8,0.625,5,8,0.625,0,0,,4,7,0.571,5,10,15,1,2,0,2,4,14,14.8
J.J. Redick,32-134,G,11/5/16,LAC,SAS,1,24,5,9,0.556,3,6,0.5,2,3,0.667,2,2,1,1,1,2,1,2,0,1,1,14,12
D'Angelo Russell,21-022,G,3/17/17,LAL,MIL,0,21,5,9,0.556,3,6,0.5,2,3,0.667,2,5,0.4,0,2,2,2,0,0,2,1,14,8.1
Luc Mbah a Moute,30-215,F,4/12/17,LAC,SAC,1,33,6,8,0.75,4,5,0.8,2,3,0.667,0,3,0,0,3,3,0,0,1,2,1,14,8.8
DeMarre Carroll,30-121,F,11/25/16,TOR,MIL,1,26,4,9,0.444,0,1,0,4,8,0.5,2,2,1,0,1,1,1,0,0,0,1,14,9.9
Giannis Antetokounmpo,21-347,F-G,11/17/16,MIL,MIA,1,35,5,15,0.333,5,13,0.385,0,2,0,4,5,0.8,1,6,7,4,0,4,1,4,14,10.6
Draymond Green,26-360,F,2/27/17,GSW,PHI,1,37,5,10,0.5,4,7,0.571,1,3,0.333,3,6,0.5,1,5,6,11,5,0,4,3,14,17.5
Greg Monroe,26-220,C-F,1/10/17,MIL,SAS,0,28,7,13,0.538,7,13,0.538,0,0,,0,0,,4,5,9,4,0,0,3,4,14,10.2
Matthew Dellavedova,26-206,G,4/2/17,MIL,DAL,1,34,6,11,0.545,4,6,0.667,2,5,0.4,0,0,,0,0,0,6,1,0,1,2,14,12.1
Matt Barnes,37-002,F,3/11/17,GSW,SAS,1,36,4,11,0.364,2,4,0.5,2,7,0.286,4,4,1,1,8,9,4,1,0,5,2,14,9
Cody Zeller,24-041,F-C,11/15/16,CHO,MIN,1,31,6,9,0.667,6,9,0.667,0,0,,2,2,1,2,7,9,1,0,1,0,2,14,14.2
Shelvin Mack,26-193,G,11/1/16,UTA,SAS,0,19,6,9,0.667,4,7,0.571,2,2,1,0,0,,0,1,1,0,1,0,2,1,14,9
Eric Gordon,28-062,G,2/25/17,HOU,MIN,0,30,5,13,0.385,1,3,0.333,4,10,0.4,0,0,,0,1,1,2,2,0,0,2,14,9.8
Nikola Vucevic,26-106,C,2/7/17,ORL,HOU,1,30,7,12,0.583,7,12,0.583,0,0,,0,0,,5,14,19,4,3,1,1,4,14,20
Seth Curry,26-099,G,11/30/16,DAL,SAS,0,28,5,11,0.455,3,6,0.5,2,5,0.4,2,2,1,1,1,2,0,1,0,0,0,14,10.3
Alan Williams,24-013,F-C,2/10/17,PHO,CHI,0,24,7,12,0.583,7,12,0.583,0,0,,0,0,,5,6,11,0,0,4,0,4,14,14.9
Jonas Valanciunas,24-231,C,12/23/16,TOR,UTA,1,16,5,5,1,5,5,1,0,0,,4,6,0.667,0,7,7,0,1,1,0,4,14,13.9
Brandon Ingram,19-192,F,3/13/17,LAL,DEN,1,27,7,12,0.583,7,10,0.7,0,2,0,0,0,,0,1,1,2,1,0,1,3,14,8.9
Enes Kanter,24-300,C,3/16/17,OKC,TOR,0,19,5,9,0.556,5,9,0.556,0,0,,4,5,0.8,2,5,7,1,1,0,4,2,14,9.1
Tyler Ennis,22-214,G,3/26/17,LAL,POR,0,26,6,15,0.4,5,9,0.556,1,6,0.167,1,2,0.5,0,3,3,5,4,0,1,1,14,12.5
John Henson,25-358,C-F,12/20/16,MIL,CLE,1,27,5,7,0.714,5,7,0.714,0,0,,4,6,0.667,2,6,8,1,2,1,3,1,14,13.5
Raymond Felton,32-211,G,1/23/17,LAC,ATL,1,30,6,13,0.462,4,9,0.444,2,4,0.5,0,0,,2,3,5,3,0,0,2,5,14,7.7
T.J. McConnell,24-325,G,2/13/17,PHI,CHO,1,36,7,12,0.583,7,11,0.636,0,1,0,0,0,,0,4,4,7,1,0,2,1,14,13.1
Allen Crabbe,24-242,G-F,12/7/16,POR,MIL,0,25,4,7,0.571,0,1,0,4,6,0.667,2,2,1,0,4,4,0,0,0,3,3,14,7.7
Monta Ellis,31-039,G,12/4/16,IND,LAC,1,35,5,11,0.455,5,10,0.5,0,1,0,4,5,0.8,0,4,4,1,1,0,0,0,14,10.8
Tony Snell,25-064,G-F,1/13/17,MIL,MIA,1,29,5,8,0.625,3,5,0.6,2,3,0.667,2,2,1,0,1,1,2,1,0,0,1,14,12.7
Malcolm Brogdon,23-326,G,11/1/16,MIL,NOP,0,24,6,10,0.6,5,8,0.625,1,2,0.5,1,1,1,1,1,2,4,4,0,3,1,14,13.8
Serge Ibaka,27-166,F-C,3/3/17,TOR,WAS,1,33,6,15,0.4,4,8,0.5,2,7,0.286,0,0,,1,7,8,1,0,2,3,4,14,6.2
Kent Bazemore,27-215,G-F,2/1/17,ATL,MIA,1,23,6,11,0.545,5,8,0.625,1,3,0.333,1,1,1,0,0,0,1,2,1,2,0,14,10.1
Langston Galloway,24-331,G,11/4/16,NOP,PHO,0,28,5,10,0.5,1,4,0.25,4,6,0.667,0,0,,0,4,4,0,0,0,1,2,14,8.4
T.J. McConnell,24-310,G,1/29/17,PHI,CHI,1,37,7,14,0.5,7,13,0.538,0,1,0,0,0,,0,4,4,12,0,1,3,3,14,13.1
Dario Saric,22-208,F,11/2/16,PHI,CHO,1,29,5,13,0.385,3,9,0.333,2,4,0.5,2,3,0.667,1,6,7,1,1,0,1,3,14,8.5
Richaun Holmes,23-150,F-C,3/14/17,PHI,GSW,0,21,6,10,0.6,5,8,0.625,1,2,0.5,1,1,1,3,5,8,1,1,2,3,4,14,11.5
Jamal Murray,19-356,G,2/13/17,DEN,GSW,0,23,5,9,0.556,3,4,0.75,2,5,0.4,2,2,1,0,1,1,4,1,0,2,2,14,11
Tyson Chandler,34-070,C,12/11/16,PHO,NOP,1,36,5,6,0.833,5,6,0.833,0,0,,4,5,0.8,7,14,21,0,0,0,2,2,14,17.7
J.R. Smith,31-203,G-F,3/31/17,CLE,PHI,1,26,5,9,0.556,1,2,0.5,4,7,0.571,0,0,,1,3,4,1,1,1,0,1,14,13.3
Yogi Ferrell,23-331,G,4/5/17,DAL,LAC,1,27,5,12,0.417,4,8,0.5,1,4,0.25,3,4,0.75,1,2,3,6,2,0,0,3,14,13.5
Dario Saric,23-000,F,4/8/17,PHI,MIL,1,24,6,12,0.5,5,6,0.833,1,6,0.167,1,1,1,0,8,8,4,2,0,4,3,14,10
Sam Dekker,22-281,F,2/11/17,HOU,PHO,0,28,6,8,0.75,6,7,0.857,0,1,0,2,3,0.667,3,1,4,1,0,1,1,0,14,13.2
Evan Turner,28-017,G,11/13/16,POR,DEN,0,29,5,17,0.294,5,14,0.357,0,3,0,4,4,1,2,3,5,5,2,0,0,4,14,10.3
Jonathon Simmons,27-087,G-F,12/10/16,SAS,BRK,0,18,6,8,0.75,4,6,0.667,2,2,1,0,0,,0,0,0,4,0,0,1,1,14,12.2
Nemanja Bjelica,28-178,F,11/3/16,MIN,DEN,0,22,5,13,0.385,3,8,0.375,2,5,0.4,2,2,1,2,6,8,1,0,0,4,2,14,6
Jon Leuer,27-234,F,1/3/17,DET,IND,1,34,7,11,0.636,7,8,0.875,0,3,0,0,0,,1,6,7,2,1,0,2,3,14,10.8
Jon Leuer,27-266,F,2/4/17,DET,IND,1,27,7,11,0.636,7,9,0.778,0,2,0,0,0,,1,5,6,1,0,0,4,1,14,7.6
Buddy Hield,23-009,G,12/26/16,NOP,DAL,1,23,6,8,0.75,4,4,1,2,4,0.5,0,0,,0,2,2,2,0,0,0,1,14,12.4
Jameer Nelson,34-302,G,12/7/16,DEN,BRK,0,29,7,19,0.368,7,15,0.467,0,4,0,0,0,,3,2,5,5,2,0,3,4,14,7.1
Nikola Vucevic,26-128,C,3/1/17,ORL,NYK,1,27,6,16,0.375,6,16,0.375,0,0,,2,2,1,3,7,10,0,1,0,3,2,14,6.6
Kyle Korver,35-345,G-F,2/25/17,CLE,CHI,0,27,5,8,0.625,1,1,1,4,7,0.571,0,0,,0,2,2,2,0,0,3,3,14,8.2
Derrick Rose,28-036,G,11/9/16,NYK,BRK,1,22,6,10,0.6,5,9,0.556,1,1,1,1,2,0.5,1,2,3,4,0,0,2,1,14,10.7
Eric Bledsoe,27-006,G,12/15/16,PHO,SAS,1,30,5,14,0.357,4,9,0.444,1,5,0.2,3,4,0.75,1,3,4,5,1,0,2,1,14,9.5
Victor Oladipo,24-215,G,12/5/16,OKC,ATL,1,36,6,15,0.4,4,7,0.571,2,8,0.25,0,0,,0,6,6,2,1,0,2,4,14,6.5
Amir Johnson,29-283,F,2/8/17,BOS,SAC,1,27,6,7,0.857,4,5,0.8,2,2,1,0,0,,1,5,6,1,3,0,2,0,14,15.4
Taj Gibson,31-235,F,2/14/17,CHI,TOR,1,27,6,9,0.667,6,8,0.75,0,1,0,2,2,1,0,4,4,0,0,0,0,2,14,10.5
Jeff Teague,28-216,G,1/12/17,IND,DEN,1,25,5,7,0.714,5,6,0.833,0,1,0,4,5,0.8,0,3,3,9,0,0,6,2,14,11.1
Tim Frazier,26-136,G,3/17/17,NOP,HOU,0,23,6,11,0.545,5,6,0.833,1,5,0.2,1,2,0.5,1,4,5,6,2,0,0,2,14,15.6
Tobias Harris,24-154,F,12/16/16,DET,WAS,1,33,5,16,0.313,4,11,0.364,1,5,0.2,3,3,1,2,4,6,2,0,1,0,1,14,9.1
Danny Green,29-259,G-F,3/8/17,SAS,SAC,1,27,5,13,0.385,1,5,0.2,4,8,0.5,0,0,,0,2,2,0,1,0,2,1,14,6.1
Brandon Ingram,19-157,F,2/6/17,LAL,NYK,1,33,5,10,0.5,3,5,0.6,2,5,0.4,2,5,0.4,2,5,7,2,1,0,1,1,14,11.7
Kevin Love,28-107,F,12/23/16,CLE,BRK,1,25,4,14,0.286,2,7,0.286,2,7,0.286,4,4,1,1,14,15,0,0,1,1,0,14,10.4
Jonas Valanciunas,24-240,C,1/1/17,TOR,LAL,1,31,6,7,0.857,6,7,0.857,0,0,,2,2,1,1,8,9,0,2,0,3,3,14,12.4
Nikola Vucevic,26-070,C,1/2/17,ORL,NYK,0,31,7,11,0.636,7,11,0.636,0,0,,0,1,0,5,8,13,5,2,0,2,1,14,17.7
James Jones,36-144,F-G,2/25/17,CLE,CHI,0,23,5,6,0.833,1,1,1,4,5,0.8,0,0,,0,2,2,1,1,1,0,4,14,13.2
Enes Kanter,24-232,C,1/7/17,OKC,DEN,0,21,7,12,0.583,7,12,0.583,0,0,,0,0,,2,4,6,1,0,1,1,0,14,11.4
Darren Collison,29-167,G,2/6/17,SAC,CHI,1,36,6,13,0.462,4,10,0.4,2,3,0.667,0,0,,0,1,1,5,2,0,0,3,14,11.9
Clint Capela,22-210,F-C,12/14/16,HOU,SAC,1,18,7,10,0.7,7,10,0.7,0,0,,0,1,0,1,1,2,2,1,1,2,1,14,11.1
Nik Stauskas,23-141,G,2/25/17,PHI,NYK,0,24,5,9,0.556,3,5,0.6,2,4,0.5,2,2,1,0,3,3,0,0,1,2,0,14,9.3
Allen Crabbe,24-336,G-F,3/11/17,POR,WAS,0,35,5,10,0.5,2,5,0.4,3,5,0.6,1,2,0.5,0,6,6,2,0,0,0,3,14,10.6
Ryan Anderson,28-173,F,10/26/16,HOU,LAL,1,34,6,15,0.4,4,8,0.5,2,7,0.286,0,0,,1,6,7,1,2,0,0,1,14,10.7
Enes Kanter,24-194,C,11/30/16,OKC,WAS,0,15,6,10,0.6,6,10,0.6,0,0,,2,3,0.667,0,3,3,0,0,1,0,1,14,10.2
Willie Cauley-Stein,23-209,F-C,3/15/17,SAC,PHO,1,33,6,11,0.545,6,11,0.545,0,0,,2,6,0.333,4,7,11,5,4,4,3,1,14,18.9
Jae Crowder,26-147,F,11/30/16,BOS,DET,1,36,5,15,0.333,3,5,0.6,2,10,0.2,2,2,1,1,4,5,4,2,0,0,0,14,12.2
Kevin Love,28-154,F,2/8/17,CLE,IND,1,35,3,11,0.273,2,4,0.5,1,7,0.143,7,7,1,0,10,10,2,1,1,1,2,14,11.8
Ed Davis,27-170,F,11/22/16,POR,NYK,1,33,7,9,0.778,7,9,0.778,0,0,,0,0,,4,6,10,0,0,2,1,2,14,14.7
Rajon Rondo,30-282,G,11/30/16,CHI,LAL,1,36,6,12,0.5,4,9,0.444,2,3,0.667,0,0,,1,7,8,6,2,0,1,4,14,14.4
Jonas Valanciunas,24-193,C,11/15/16,TOR,CLE,1,34,5,9,0.556,5,9,0.556,0,0,,4,4,1,3,6,9,2,0,0,2,1,14,12.6
Blake Griffin,27-358,F,3/9/17,LAC,MEM,1,30,4,13,0.308,4,11,0.364,0,2,0,6,8,0.75,3,9,12,8,0,1,2,3,14,13.6
James Johnson,30-009,F,3/1/17,MIA,PHI,0,26,6,11,0.545,6,8,0.75,0,3,0,2,4,0.5,1,3,4,3,1,2,0,4,14,12.4
Gerald Henderson,29-090,G,3/9/17,PHI,POR,0,29,5,10,0.5,5,9,0.556,0,1,0,4,5,0.8,1,2,3,1,1,0,1,3,14,9.4
Courtney Lee,31-188,G,4/9/17,NYK,TOR,1,32,6,13,0.462,4,8,0.5,2,5,0.4,0,0,,1,0,1,3,1,0,2,3,14,7.9
Mindaugas Kuzminskas,27-089,F,1/16/17,NYK,ATL,1,38,6,10,0.6,5,5,1,1,5,0.2,1,1,1,1,4,5,2,2,0,1,3,14,12.5
Rondae Hollis-Jefferson,22-086,F,3/30/17,BRK,DET,1,30,6,14,0.429,6,12,0.5,0,2,0,2,2,1,1,8,9,1,0,1,1,2,14,9.3
Seth Curry,26-118,G,12/19/16,DAL,DEN,0,26,5,7,0.714,3,4,0.75,2,3,0.667,2,2,1,1,3,4,2,0,0,1,0,14,13.1
Frank Kaminsky,23-236,F-C,11/26/16,CHO,NYK,1,35,5,13,0.385,3,9,0.333,2,4,0.5,2,2,1,0,5,5,3,0,0,1,2,14,8.7
James Johnson,29-296,F,12/12/16,MIA,WAS,0,30,6,9,0.667,6,7,0.857,0,2,0,2,4,0.5,2,3,5,3,0,0,2,1,14,11.3
Terrence Jones,24-328,F,12/2/16,NOP,LAC,0,29,5,10,0.5,5,9,0.556,0,1,0,4,7,0.571,2,6,8,1,1,1,0,2,14,12.6
Courtney Lee,31-112,G,1/23/17,NYK,IND,1,25,3,7,0.429,2,4,0.5,1,3,0.333,7,7,1,1,3,4,1,1,0,0,2,14,12.8
Rudy Gobert,24-162,C,12/5/16,UTA,LAL,1,39,4,7,0.571,4,7,0.571,0,0,,6,11,0.545,8,9,17,1,1,5,1,4,14,19.6
Sean Kilpatrick,26-313,G,11/14/16,BRK,LAC,1,18,5,17,0.294,3,10,0.3,2,7,0.286,2,2,1,2,3,5,1,1,0,5,0,14,3.1
Al-Farouq Aminu,26-145,F,2/13/17,POR,ATL,0,39,5,14,0.357,1,5,0.2,4,9,0.444,0,0,,3,12,15,2,1,0,3,3,14,10.1
Jae Crowder,26-240,F,3/3/17,BOS,LAL,1,27,4,6,0.667,2,4,0.5,2,2,1,4,6,0.667,1,5,6,3,0,0,1,1,14,13.5
Ish Smith,28-144,G,11/26/16,DET,OKC,1,31,6,11,0.545,6,11,0.545,0,0,,2,2,1,0,1,1,3,0,0,1,2,14,9.3
Garrett Temple,30-257,G,1/20/17,SAC,MEM,1,33,5,9,0.556,3,4,0.75,2,5,0.4,2,3,0.667,0,3,3,3,1,2,0,3,14,13.5
Justin Holiday,27-307,G,2/6/17,NYK,LAL,0,22,5,8,0.625,2,3,0.667,3,5,0.6,1,2,0.5,0,1,1,0,0,1,2,1,14,8.6
Kenneth Faried,27-008,F,11/27/16,DEN,PHO,1,28,4,8,0.5,4,8,0.5,0,0,,6,7,0.857,2,7,9,1,1,0,1,3,14,12.6
Solomon Hill,25-300,F,1/12/17,NOP,BRK,1,33,5,10,0.5,3,6,0.5,2,4,0.5,2,2,1,1,8,9,3,2,0,1,2,14,14.4
D'Angelo Russell,20-306,G,12/25/16,LAL,LAC,1,32,5,13,0.385,3,7,0.429,2,6,0.333,2,2,1,0,5,5,4,0,0,3,1,14,7.8
Channing Frye,33-230,C-F,1/2/17,CLE,NOP,0,25,5,9,0.556,1,2,0.5,4,7,0.571,0,2,0,0,6,6,0,0,1,2,3,14,8.2
Reggie Jackson,26-296,G,2/6/17,DET,PHI,1,28,4,12,0.333,2,5,0.4,2,7,0.286,4,4,1,1,1,2,6,1,0,1,4,14,10.8
Zach Randolph,35-200,F,2/1/17,MEM,DEN,0,21,7,12,0.583,7,11,0.636,0,1,0,0,0,,1,4,5,2,0,0,4,2,14,6.9
Rashad Vaughn,20-239,G,4/12/17,MIL,BOS,1,40,6,15,0.4,4,11,0.364,2,4,0.5,0,1,0,2,1,3,4,2,1,5,4,14,6.1
Ricky Rubio,26-108,G,2/6/17,MIN,MIA,1,36,4,8,0.5,4,7,0.571,0,1,0,6,6,1,0,3,3,13,2,0,2,1,14,19.6
Bojan Bogdanovic,27-244,G-F,12/18/16,BRK,PHI,1,25,5,13,0.385,3,6,0.5,2,7,0.286,2,2,1,1,5,6,2,1,0,1,0,14,10.5
Ben McLemore,23-279,G,11/16/16,SAC,SAS,0,26,6,10,0.6,4,6,0.667,2,4,0.5,0,0,,0,3,3,0,0,1,2,1,14,8.6
Emmanuel Mudiay,20-318,G,1/17/17,DEN,LAL,1,28,5,7,0.714,3,4,0.75,2,3,0.667,2,3,0.667,0,2,2,6,2,0,3,0,14,14.5
Cory Joseph,25-190,G,2/26/17,TOR,POR,1,33,6,12,0.5,5,11,0.455,1,1,1,1,1,1,0,1,1,6,1,0,1,2,14,11.7
Allen Crabbe,24-225,G-F,11/20/16,POR,BRK,0,30,5,10,0.5,1,3,0.333,4,7,0.571,0,0,,1,1,2,0,0,0,0,1,14,9.6
Patty Mills,28-197,G,2/24/17,SAS,LAC,0,21,5,10,0.5,3,3,1,2,7,0.286,2,3,0.667,0,1,1,1,0,0,2,0,14,7.6
Jeremy Lamb,24-212,G-F,12/28/16,CHO,ORL,0,28,5,10,0.5,4,8,0.5,1,2,0.5,3,3,1,0,4,4,0,0,0,1,1,14,8.8
Reggie Jackson,26-256,G,12/28/16,DET,MIL,1,34,6,15,0.4,5,9,0.556,1,6,0.167,1,1,1,0,3,3,6,0,1,0,1,14,11.3
Justin Holiday,27-326,G,2/25/17,NYK,PHI,0,24,6,14,0.429,4,8,0.5,2,6,0.333,0,0,,3,4,7,0,0,2,0,2,14,10.5
Kevin Durant,28-053,F-G,11/21/16,GSW,IND,1,27,3,9,0.333,2,5,0.4,1,4,0.25,7,7,1,0,11,11,6,2,2,1,0,14,18.8
Tony Parker,34-245,G,1/17/17,SAS,MIN,1,29,6,13,0.462,6,13,0.462,0,0,,2,3,0.667,0,0,0,5,0,0,1,5,14,7.4
Jeremy Lin,28-069,G,10/31/16,BRK,CHI,1,24,6,10,0.6,5,8,0.625,1,2,0.5,1,2,0.5,0,2,2,4,4,0,3,0,14,13.4
Kyle Korver,35-290,G-F,1/1/17,ATL,SAS,0,39,5,12,0.417,1,3,0.333,4,9,0.444,0,0,,0,8,8,4,1,1,0,0,14,14.5
Julius Randle,22-010,F,12/9/16,LAL,PHO,1,33,4,11,0.364,4,9,0.444,0,2,0,6,7,0.857,1,8,9,5,1,0,6,5,14,7.1
Rodney McGruder,25-106,G,11/12/16,MIA,UTA,0,22,5,6,0.833,2,2,1,3,4,0.75,1,2,0.5,0,2,2,2,0,0,0,1,14,13
Mike Muscala,25-137,F-C,11/15/16,ATL,MIA,0,22,6,7,0.857,4,5,0.8,2,2,1,0,0,,0,5,5,4,1,0,0,3,14,15.6
Wayne Ellington,29-125,G,3/3/17,MIA,ORL,0,20,6,10,0.6,4,4,1,2,6,0.333,0,0,,0,2,2,0,1,0,1,0,14,10
Sean Kilpatrick,26-307,G,11/8/16,BRK,MIN,0,28,4,7,0.571,4,5,0.8,0,2,0,6,6,1,0,5,5,3,1,0,6,2,14,8.5
Aaron Brooks,31-364,G,1/12/17,IND,DEN,0,23,6,10,0.6,4,5,0.8,2,5,0.4,0,0,,0,0,0,6,3,0,2,1,14,14.2
Nikola Jokic,21-295,C-F,12/10/16,DEN,ORL,0,26,6,11,0.545,6,8,0.75,0,3,0,2,2,1,1,5,6,6,1,2,1,3,14,15.3
Gerald Henderson,28-343,G,11/16/16,PHI,WAS,1,29,6,11,0.545,6,10,0.6,0,1,0,2,2,1,0,1,1,3,0,1,0,1,14,11.4
Boban Marjanovic,28-237,C,4/9/17,DET,MEM,0,23,4,6,0.667,4,6,0.667,0,0,,6,7,0.857,4,6,10,0,1,0,1,2,14,14.8
Jamal Murray,20-009,G,3/4/17,DEN,CHO,0,26,6,10,0.6,4,7,0.571,2,3,0.667,0,0,,0,3,3,3,2,0,1,2,14,12.6
Andre Drummond,23-166,C,1/23/17,DET,SAC,1,36,6,11,0.545,6,10,0.6,0,1,0,2,5,0.4,2,10,12,1,3,0,3,4,14,11
Austin Rivers,24-152,G,12/31/16,LAC,OKC,1,34,3,11,0.273,2,6,0.333,1,5,0.2,7,7,1,0,1,1,3,0,0,3,3,14,5.7
Jabari Parker,21-286,F,12/26/16,MIL,WAS,1,40,7,18,0.389,7,15,0.467,0,3,0,0,0,,1,5,6,4,0,1,4,3,14,4.7
Evan Fournier,24-041,G-F,12/9/16,ORL,CHO,1,24,6,11,0.545,4,5,0.8,2,6,0.333,0,0,,0,2,2,0,0,0,0,2,14,8.5
Kelly Oubre,21-109,F,3/28/17,WAS,LAL,0,26,5,11,0.455,3,9,0.333,2,2,1,2,2,1,4,1,5,1,1,0,0,3,14,11.9
Jordan Clarkson,24-262,G,2/24/17,LAL,OKC,0,29,6,17,0.353,4,9,0.444,2,8,0.25,0,2,0,0,5,5,5,4,0,3,1,14,9.3
Enes Kanter,24-215,C,12/21/16,OKC,NOP,0,34,6,11,0.545,6,11,0.545,0,0,,2,2,1,5,8,13,1,0,2,2,4,14,13.1
Kris Humphries,31-345,F-C,1/16/17,ATL,NYK,0,24,3,5,0.6,0,2,0,3,3,1,5,8,0.625,3,4,7,1,1,0,1,2,14,13.7
Montrezl Harrell,22-335,F-C,12/26/16,HOU,PHO,1,23,5,6,0.833,5,6,0.833,0,0,,4,6,0.667,1,2,3,1,0,2,2,3,14,11.2
J.J. Barea,32-283,G,4/5/17,DAL,LAC,0,22,6,12,0.5,5,9,0.556,1,3,0.333,1,1,1,0,3,3,3,0,0,4,4,14,5.4
Enes Kanter,24-248,C,1/23/17,OKC,UTA,0,29,5,9,0.556,5,9,0.556,0,0,,4,4,1,2,3,5,0,0,0,0,3,14,10.8
Monta Ellis,31-030,G,11/25/16,IND,BRK,1,26,6,6,1,4,4,1,2,2,1,0,0,,0,3,3,3,1,0,0,3,14,15
Chris Paul,31-245,G,1/6/17,LAC,SAC,1,31,3,5,0.6,2,3,0.667,1,2,0.5,7,8,0.875,0,6,6,12,3,0,3,2,14,20.7
Andrew Wiggins,21-272,F-G,11/21/16,MIN,BOS,1,39,5,18,0.278,5,13,0.385,0,5,0,4,6,0.667,0,4,4,1,0,0,2,1,14,2.1
Draymond Green,26-254,F,11/13/16,GSW,PHO,1,37,4,10,0.4,3,5,0.6,1,5,0.2,5,5,1,2,5,7,11,3,2,3,3,14,19.4
Donatas Motiejunas,26-125,F-C,1/23/17,NOP,CLE,0,24,5,8,0.625,3,5,0.6,2,3,0.667,2,4,0.5,1,3,4,1,1,1,2,2,14,10.8
DeAndre Jordan,28-263,C,4/10/17,LAC,HOU,1,24,6,9,0.667,6,9,0.667,0,0,,2,6,0.333,4,7,11,2,0,0,2,3,14,11.6
Marcus Smart,22-306,G,1/6/17,BOS,PHI,0,30,4,12,0.333,2,7,0.286,2,5,0.4,4,4,1,0,2,2,8,1,2,1,1,14,14.4
Darren Collison,29-176,G,2/15/17,SAC,GSW,1,28,5,9,0.556,4,7,0.571,1,2,0.5,3,4,0.75,0,1,1,3,0,1,4,0,14,8.4
Nikola Jokic,21-292,C-F,12/7/16,DEN,BRK,0,21,5,7,0.714,5,7,0.714,0,0,,4,4,1,7,4,11,3,0,1,1,3,14,17.8
Brandon Ingram,19-188,F,3/9/17,LAL,PHO,1,40,5,11,0.455,5,8,0.625,0,3,0,4,8,0.5,1,5,6,3,1,2,2,3,14,10.2
Robin Lopez,28-256,C,12/13/16,CHI,MIN,1,33,7,9,0.778,7,9,0.778,0,0,,0,0,,4,1,5,0,0,4,2,1,14,14
Trevor Booker,29-118,F,3/23/17,BRK,PHO,0,17,6,16,0.375,4,14,0.286,2,2,1,0,0,,4,4,8,1,0,0,1,1,14,8.5
DeMarre Carroll,30-179,F,1/22/17,TOR,PHO,1,32,4,12,0.333,2,7,0.286,2,5,0.4,4,4,1,1,3,4,0,2,1,2,1,14,9.1
Dwight Powell,25-112,F-C,11/9/16,DAL,GSW,1,26,6,8,0.75,6,7,0.857,0,1,0,2,3,0.667,3,6,9,1,2,0,0,1,14,16.6
Andre Roberson,25-063,G-F,2/5/17,OKC,POR,1,36,6,8,0.75,6,7,0.857,0,1,0,2,2,1,2,9,11,1,3,0,0,4,14,17
Kay Felder,21-260,G,12/14/16,CLE,MEM,0,23,4,8,0.5,2,6,0.333,2,2,1,4,6,0.667,1,2,3,4,2,0,2,1,14,12.9
Marvin Williams,30-227,F,2/1/17,CHO,GSW,1,31,6,13,0.462,4,7,0.571,2,6,0.333,0,0,,0,6,6,1,0,0,1,3,14,7.6
Josh Richardson,23-108,G,1/1/17,MIA,DET,1,38,5,13,0.385,3,8,0.375,2,5,0.4,2,4,0.5,0,1,1,8,2,0,2,4,14,10.4
Alex Len,23-173,C,12/6/16,PHO,UTA,0,21,4,9,0.444,4,9,0.444,0,0,,6,6,1,1,3,4,0,0,0,0,6,14,8.5
Cory Joseph,25-104,G,12/2/16,TOR,LAL,0,25,7,10,0.7,7,9,0.778,0,1,0,0,0,,0,2,2,4,0,0,0,1,14,12.8
Otto Porter,23-285,F,3/15/17,WAS,DAL,1,37,6,9,0.667,4,5,0.8,2,4,0.5,0,0,,1,9,10,5,0,0,0,2,14,16.2
Trevor Ariza,31-184,F,12/31/16,HOU,NYK,1,39,5,15,0.333,3,5,0.6,2,10,0.2,2,2,1,0,7,7,4,2,0,0,2,14,11.6
Danilo Gallinari,28-133,F,12/19/16,DEN,DAL,1,34,3,9,0.333,2,6,0.333,1,3,0.333,7,7,1,0,2,2,4,4,0,0,0,14,16.3
Darren Collison,29-138,G,1/8/17,SAC,GSW,1,30,6,9,0.667,4,6,0.667,2,3,0.667,0,0,,0,1,1,2,3,0,2,1,14,12.4
Wayne Ellington,29-090,G,1/27/17,MIA,CHI,0,27,6,16,0.375,4,8,0.5,2,8,0.25,0,0,,0,5,5,2,2,1,0,1,14,10.4
Jeff Green,30-098,F,12/4/16,ORL,DET,0,30,6,11,0.545,4,8,0.5,2,3,0.667,0,0,,0,5,5,3,0,0,3,1,14,8.9
Myles Turner,20-261,F-C,12/10/16,IND,POR,1,33,5,8,0.625,4,7,0.571,1,1,1,3,4,0.75,3,5,8,1,1,3,0,3,14,16.2
Devin Harris,33-295,G,12/18/16,DAL,SAC,0,20,5,10,0.5,3,5,0.6,2,5,0.4,2,2,1,0,7,7,1,1,0,2,0,14,10.8
Willie Cauley-Stein,23-174,F-C,2/8/17,SAC,BOS,0,24,5,8,0.625,5,8,0.625,0,0,,4,4,1,1,4,5,4,0,1,0,4,14,14.2
Ricky Rubio,26-108,G,2/6/17,MIN,MIA,1,36,4,8,0.5,4,7,0.571,0,1,0,6,6,1,0,3,3,13,2,0,2,1,14,19.6
Bojan Bogdanovic,27-225,G-F,11/29/16,BRK,LAC,1,26,2,7,0.286,2,4,0.5,0,3,0,10,12,0.833,0,6,6,2,0,0,3,3,14,8.1
Jabari Parker,21-228,F,10/29/16,MIL,BRK,1,35,5,11,0.455,5,10,0.5,0,1,0,4,6,0.667,2,6,8,4,2,0,2,1,14,13.1
Allen Crabbe,24-271,G-F,1/5/17,POR,LAL,0,26,4,10,0.4,2,5,0.4,2,5,0.4,4,4,1,2,2,4,0,0,0,0,0,14,10.6
Eric Gordon,27-310,G,10/30/16,HOU,DAL,1,33,5,16,0.313,3,8,0.375,2,8,0.25,2,2,1,0,3,3,1,1,0,3,1,14,4
Patrick Beverley,28-210,G,2/7/17,HOU,ORL,1,29,6,11,0.545,5,6,0.833,1,5,0.2,1,1,1,1,5,6,7,1,0,2,4,14,13.2
Evan Turner,28-081,G,1/16/17,POR,WAS,0,21,5,8,0.625,3,6,0.5,2,2,1,2,2,1,1,2,3,1,0,0,1,2,14,10.6
Jeremy Lin,28-219,G,3/30/17,BRK,DET,1,31,6,14,0.429,5,9,0.556,1,5,0.2,1,1,1,0,5,5,4,1,0,3,1,14,8.5
Bojan Bogdanovic,27-219,G-F,11/23/16,BRK,BOS,1,28,6,12,0.5,4,5,0.8,2,7,0.286,0,0,,0,8,8,2,0,0,2,0,14,9.8
Nik Stauskas,23-062,G,12/8/16,PHI,NOP,0,22,5,7,0.714,2,2,1,3,5,0.6,1,1,1,1,1,2,5,0,0,0,0,14,15.6
Courtney Lee,31-054,G,11/26/16,NYK,CHO,1,30,5,9,0.556,1,2,0.5,4,7,0.571,0,0,,0,2,2,3,0,0,0,4,14,10.8
Gerald Green,30-350,G-F,1/10/17,BOS,TOR,0,24,6,12,0.5,6,9,0.667,0,3,0,2,2,1,0,5,5,0,0,0,2,2,14,6.7
Michael Beasley,27-317,F,11/21/16,MIL,ORL,0,20,7,14,0.5,7,13,0.538,0,1,0,0,0,,1,2,3,1,0,0,0,2,14,8.2
Kyle Korver,35-240,G-F,11/12/16,ATL,PHI,1,28,5,11,0.455,2,3,0.667,3,8,0.375,1,1,1,0,2,2,2,2,2,3,2,14,9.9
DeAndre Jordan,28-218,C,2/24/17,LAC,SAS,1,33,7,9,0.778,7,9,0.778,0,0,,0,1,0,2,6,8,0,2,0,2,4,14,11.7
Ersan Ilyasova,29-270,F,2/9/17,PHI,ORL,1,27,4,16,0.25,3,8,0.375,1,8,0.125,5,6,0.833,2,2,4,2,2,0,1,5,14,6.4
Zach Randolph,35-168,F,12/31/16,MEM,SAC,0,24,7,16,0.438,7,14,0.5,0,2,0,0,0,,2,4,6,3,0,0,2,4,14,6.7
Klay Thompson,26-331,G,1/4/17,GSW,POR,1,37,5,15,0.333,4,8,0.5,1,7,0.143,3,3,1,0,3,3,1,3,2,2,3,14,8.3
Emmanuel Mudiay,20-333,G,2/1/17,DEN,MEM,0,26,4,10,0.4,4,9,0.444,0,1,0,6,10,0.6,2,4,6,7,0,0,2,2,14,11.7
Dwyane Wade,34-286,G,10/29/16,CHI,IND,1,21,4,7,0.571,4,7,0.571,0,0,,6,6,1,2,3,5,2,2,0,0,1,14,16
Marco Belinelli,30-241,G-F,11/21/16,CHO,MEM,0,31,3,8,0.375,1,4,0.25,2,4,0.5,6,7,0.857,0,5,5,4,2,2,1,0,14,15.9
Marcin Gortat,32-256,C-F,10/30/16,WAS,MEM,1,38,2,3,0.667,2,3,0.667,0,0,,10,10,1,1,11,12,1,0,0,0,4,14,15.8
Julius Randle,22-123,F,4/1/17,LAL,LAC,1,23,5,10,0.5,3,7,0.429,2,3,0.667,2,3,0.667,1,5,6,2,1,0,2,3,14,10
T.J. McConnell,24-341,G,3/1/17,PHI,MIA,1,32,5,7,0.714,5,7,0.714,0,0,,4,4,1,1,4,5,5,2,0,2,3,14,15.3
Rodney Stuckey,30-235,G,12/12/16,IND,CHO,0,21,5,11,0.455,4,9,0.444,1,2,0.5,3,4,0.75,0,4,4,4,0,0,2,3,14,8.7
Kyrie Irving,24-315,G,2/1/17,CLE,MIN,1,31,5,18,0.278,4,12,0.333,1,6,0.167,3,4,0.75,2,0,2,14,1,0,1,2,14,13.4
Robin Lopez,28-306,C,2/1/17,CHI,OKC,1,21,7,8,0.875,7,8,0.875,0,0,,0,0,,1,1,2,0,0,1,0,4,14,11.3
Markieff Morris,27-131,F,1/11/17,WAS,BOS,1,38,6,21,0.286,5,15,0.333,1,6,0.167,1,2,0.5,2,7,9,4,2,0,1,1,14,8.2
Julius Randle,21-357,F,11/20/16,LAL,CHI,1,25,6,11,0.545,6,10,0.6,0,1,0,2,4,0.5,0,3,3,2,0,1,2,3,14,7.7
DeMarcus Cousins,26-079,C-F,10/31/16,SAC,ATL,1,32,6,16,0.375,5,11,0.455,1,5,0.2,1,3,0.333,2,10,12,1,0,1,4,5,14,4.2
Leandro Barbosa,34-095,G,3/3/17,PHO,OKC,0,20,5,9,0.556,4,5,0.8,1,4,0.25,3,3,1,0,1,1,2,0,0,0,0,14,11.4
David Nwaba,24-087,G,4/11/17,LAL,NOP,0,28,6,8,0.75,6,8,0.75,0,0,,2,2,1,1,1,2,1,2,0,2,3,14,11.3
Kosta Koufos,28-003,C,2/27/17,SAC,MIN,1,25,6,8,0.75,6,8,0.75,0,0,,2,2,1,3,8,11,1,0,0,1,3,14,13.8
Dwight Howard,31-104,C,3/22/17,ATL,WAS,1,36,5,11,0.455,5,11,0.455,0,0,,4,6,0.667,3,12,15,2,2,1,2,1,14,14.9
Arron Afflalo,31-151,G,3/15/17,SAC,PHO,1,30,5,11,0.455,5,9,0.556,0,2,0,4,4,1,0,4,4,0,0,0,0,2,14,8.7
Marcus Morris,27-201,F,3/22/17,DET,CHI,1,32,5,12,0.417,5,8,0.625,0,4,0,4,5,0.8,2,1,3,1,0,0,1,0,14,8.6
Darren Collison,29-199,G,3/10/17,SAC,WAS,1,33,5,12,0.417,5,9,0.556,0,3,0,4,5,0.8,1,1,2,10,0,0,1,2,14,13.4
Ricky Rubio,26-106,G,2/4/17,MIN,MEM,1,38,5,15,0.333,3,9,0.333,2,6,0.333,2,2,1,0,1,1,6,0,0,2,4,14,6.4
J.J. Redick,32-229,G,2/8/17,LAC,NYK,1,28,4,12,0.333,2,6,0.333,2,6,0.333,4,4,1,0,5,5,2,0,0,0,1,14,9.7
Brandon Knight,25-001,G,12/3/16,PHO,GSW,0,22,6,12,0.5,6,9,0.667,0,3,0,2,2,1,0,1,1,2,0,0,3,2,14,5.9
Lou Williams,30-141,G,3/17/17,HOU,NOP,0,31,4,12,0.333,4,9,0.444,0,3,0,6,8,0.75,0,1,1,2,0,0,1,0,14,7.1
Willy Hernangomez,22-166,C,11/9/16,NYK,BRK,0,15,6,7,0.857,6,7,0.857,0,0,,2,2,1,2,4,6,0,1,2,1,2,14,14.7
Mike Conley,29-048,G,11/28/16,MEM,CHO,1,20,6,11,0.545,4,5,0.8,2,6,0.333,0,0,,0,1,1,5,2,0,0,2,14,13.7
Kyle O'Quinn,26-271,F-C,12/22/16,NYK,ORL,0,24,6,12,0.5,6,11,0.545,0,1,0,2,2,1,5,11,16,0,0,5,1,2,14,16.5
Jordan Clarkson,24-178,G,12/2/16,LAL,TOR,0,31,4,15,0.267,1,6,0.167,3,9,0.333,3,3,1,1,0,1,1,2,0,1,2,14,6.7
Jonathon Simmons,27-175,G-F,3/8/17,SAS,SAC,1,25,5,13,0.385,4,11,0.364,1,2,0.5,3,3,1,1,3,4,4,0,1,2,6,14,7.6
Pau Gasol,36-264,F-C,3/27/17,SAS,CLE,0,21,5,8,0.625,3,6,0.5,2,2,1,2,2,1,1,3,4,0,1,0,2,2,14,10.2
Austin Rivers,24-184,G,2/1/17,LAC,PHO,1,28,4,12,0.333,4,8,0.5,0,4,0,6,8,0.75,0,2,2,4,3,0,1,4,14,10.2
Damian Lillard,26-180,G,1/11/17,POR,CLE,1,32,5,15,0.333,4,11,0.364,1,4,0.25,3,3,1,0,3,3,3,0,0,1,1,14,7.1
Jeff Green,30-114,F,12/20/16,ORL,MIA,0,32,4,9,0.444,4,8,0.5,0,1,0,6,6,1,0,3,3,1,1,0,0,2,14,11.1
Michael Kidd-Gilchrist,23-100,F,1/4/17,CHO,OKC,1,32,7,9,0.778,7,9,0.778,0,0,,0,2,0,2,9,11,0,0,1,1,4,14,11.9
Lou Williams,30-068,G,1/3/17,LAL,MEM,0,17,4,9,0.444,3,5,0.6,1,4,0.25,5,5,1,0,1,1,2,1,0,0,0,14,12
Andrew Wiggins,21-321,F-G,1/9/17,MIN,DAL,1,36,5,11,0.455,5,10,0.5,0,1,0,3,6,0.5,3,1,4,0,0,0,3,3,13,4.3
Tyson Chandler,34-072,C,12/13/16,PHO,NYK,1,41,5,8,0.625,5,8,0.625,0,0,,3,3,1,9,14,23,0,1,1,2,3,13,18.4
Steven Adams,23-206,C,2/11/17,OKC,GSW,1,35,6,9,0.667,6,9,0.667,0,0,,1,6,0.167,2,1,3,0,1,1,0,1,13,10.1
C.J. Miles,29-207,G-F,11/11/16,IND,PHI,1,30,4,9,0.444,3,6,0.5,1,3,0.333,4,4,1,0,4,4,1,1,0,0,1,13,10.8
Klay Thompson,27-026,G,3/6/17,GSW,ATL,1,30,5,12,0.417,3,4,0.75,2,8,0.25,1,2,0.5,0,0,0,3,0,1,2,3,13,5.8
Eric Bledsoe,27-090,G,3/9/17,PHO,LAL,1,32,4,12,0.333,3,8,0.375,1,4,0.25,4,6,0.667,0,7,7,5,2,1,7,0,13,6.7
Joe Johnson,35-162,G-F,12/8/16,UTA,GSW,1,28,4,12,0.333,2,6,0.333,2,6,0.333,3,5,0.6,1,2,3,0,1,0,1,2,13,5.9
Otto Porter,23-219,F,1/8/17,WAS,MIL,1,39,3,8,0.375,0,1,0,3,7,0.429,4,4,1,1,6,7,7,1,2,2,4,13,14.8
Maurice Harkless,23-175,F-G,11/2/16,POR,PHO,1,35,5,10,0.5,3,6,0.5,2,4,0.5,1,1,1,2,3,5,2,1,1,2,2,13,10.6
Kentavious Caldwell-Pope,23-261,G,11/5/16,DET,DEN,1,28,5,11,0.455,2,5,0.4,3,6,0.5,0,0,,0,1,1,2,1,0,0,0,13,10
Delon Wright,24-331,G,3/23/17,TOR,MIA,0,24,4,7,0.571,4,7,0.571,0,0,,5,7,0.714,1,6,7,3,2,0,2,1,13,13.1
Dennis Schroder,23-206,G,4/9/17,ATL,CLE,1,27,6,13,0.462,5,9,0.556,1,4,0.25,0,0,,0,3,3,5,1,1,0,2,13,11.6
Marcus Smart,22-245,G,11/6/16,BOS,DEN,0,27,6,13,0.462,5,9,0.556,1,4,0.25,0,0,,2,3,5,2,0,0,1,2,13,8.2
Marquese Chriss,19-258,F,3/17/17,PHO,ORL,1,26,6,9,0.667,5,7,0.714,1,2,0.5,0,0,,0,9,9,0,0,4,2,4,13,11
Dirk Nowitzki,38-285,F,3/31/17,DAL,MEM,1,30,3,17,0.176,2,11,0.182,1,6,0.167,6,6,1,0,12,12,1,0,0,1,2,13,4.8
Nicolas Batum,28-049,F-G,2/1/17,CHO,GSW,1,24,4,7,0.571,1,3,0.333,3,4,0.75,2,2,1,2,3,5,7,0,0,2,0,13,14.9
Paul George,26-285,F,2/11/17,IND,MIL,1,38,4,11,0.364,2,8,0.25,2,3,0.667,3,3,1,1,7,8,3,0,0,5,6,13,4.4
Myles Turner,20-218,F-C,10/28/16,IND,BRK,1,33,5,11,0.455,5,9,0.556,0,2,0,3,3,1,5,6,11,0,0,3,1,4,13,12.1
Enes Kanter,24-175,C,11/11/16,OKC,LAC,0,21,6,11,0.545,6,10,0.6,0,1,0,1,1,1,3,8,11,0,1,0,0,3,13,12
Bojan Bogdanovic,27-293,G-F,2/5/17,BRK,TOR,1,27,4,11,0.364,1,3,0.333,3,8,0.375,2,2,1,0,3,3,2,0,0,5,0,13,4.2
Marc Gasol,31-297,C,11/21/16,MEM,CHO,1,34,5,14,0.357,3,11,0.273,2,3,0.667,1,1,1,1,7,8,9,1,3,5,1,13,12
Jeff Teague,28-154,G,11/11/16,IND,PHI,1,35,5,10,0.5,4,6,0.667,1,4,0.25,2,2,1,0,1,1,4,3,0,4,2,13,9.3
Greg Monroe,26-182,C-F,12/3/16,MIL,BRK,0,21,5,10,0.5,5,10,0.5,0,0,,3,3,1,2,5,7,1,4,1,2,4,13,12.7
Tony Allen,35-009,G-F,1/20/17,MEM,SAC,1,31,6,11,0.545,6,10,0.6,0,1,0,1,2,0.5,5,5,10,0,0,0,1,2,13,10.5
Jae Crowder,26-273,F,4/5/17,BOS,CLE,1,29,5,11,0.455,3,6,0.5,2,5,0.4,1,2,0.5,3,1,4,2,1,0,1,4,13,9.1
Trey Lyles,21-023,F,11/28/16,UTA,MIN,0,21,6,8,0.75,5,5,1,1,3,0.333,0,0,,1,0,1,1,1,0,1,1,13,10.8
Jason Smith,31-018,F-C,3/20/17,WAS,BOS,0,17,5,8,0.625,2,3,0.667,3,5,0.6,0,0,,0,5,5,1,0,1,2,6,13,7.9
Tyler Johnson,24-213,G,12/6/16,MIA,NYK,0,36,5,11,0.455,4,9,0.444,1,2,0.5,2,2,1,1,4,5,1,2,0,1,2,13,10.1
J.J. Barea,32-207,G,1/19/17,DAL,MIA,0,16,5,10,0.5,2,4,0.5,3,6,0.5,0,0,,0,1,1,1,0,0,2,0,13,7
Kenneth Faried,27-063,F,1/21/17,DEN,LAC,1,24,5,7,0.714,5,7,0.714,0,0,,3,4,0.75,3,4,7,2,0,0,0,2,13,13.6
Al Jefferson,32-019,C-F,1/23/17,IND,NYK,0,19,5,8,0.625,5,8,0.625,0,0,,3,4,0.75,1,2,3,0,0,1,1,2,13,9.2
Norman Powell,23-295,G,3/16/17,TOR,OKC,0,22,4,12,0.333,3,9,0.333,1,3,0.333,4,5,0.8,1,3,4,0,0,0,0,3,13,6.2
Skal Labissiere,21-000,F,3/18/17,SAC,OKC,0,18,5,10,0.5,5,9,0.556,0,1,0,3,3,1,2,2,4,1,0,0,1,3,13,8.5
Alan Williams,24-071,F-C,4/9/17,PHO,DAL,0,13,4,7,0.571,4,7,0.571,0,0,,5,7,0.714,1,2,3,1,0,0,0,1,13,10.5
Marcus Smart,23-004,G,3/10/17,BOS,DEN,0,25,4,15,0.267,3,13,0.231,1,2,0.5,4,4,1,4,3,7,2,1,0,2,3,13,7
Sean Kilpatrick,26-294,G,10/26/16,BRK,BOS,0,22,5,13,0.385,4,7,0.571,1,6,0.167,2,2,1,1,3,4,2,0,0,2,0,13,6.9
Jarell Eddie,25-140,G-F,3/19/17,PHO,DET,0,29,3,8,0.375,1,1,1,2,7,0.286,5,5,1,0,2,2,0,0,0,0,1,13,8.8
Leandro Barbosa,34-113,G,3/21/17,PHO,MIA,0,18,4,7,0.571,3,5,0.6,1,2,0.5,4,4,1,0,1,1,1,0,0,1,2,13,8.9
Julius Randle,22-026,F,12/25/16,LAL,LAC,1,31,5,11,0.455,5,10,0.5,0,1,0,3,4,0.75,2,5,7,8,2,0,0,4,13,15.8
Draymond Green,26-251,F,11/10/16,GSW,DEN,1,29,4,7,0.571,1,3,0.333,3,4,0.75,2,2,1,0,9,9,5,3,0,1,2,13,17.1
Khris Middleton,25-233,F-G,4/2/17,MIL,DAL,1,37,5,15,0.333,4,7,0.571,1,8,0.125,2,2,1,0,5,5,4,1,0,0,5,13,7.8
Wilson Chandler,29-224,F,12/20/16,DEN,LAC,1,28,5,13,0.385,4,9,0.444,1,4,0.25,2,4,0.5,1,3,4,3,0,0,2,2,13,6
Jameer Nelson,34-352,G,1/26/17,DEN,PHO,1,42,6,11,0.545,5,7,0.714,1,4,0.25,0,0,,0,4,4,9,2,1,2,3,13,14.7
Otto Porter,23-214,F,1/3/17,WAS,DAL,1,37,5,11,0.455,2,6,0.333,3,5,0.6,0,0,,0,4,4,3,3,3,1,3,13,13.5
Ersan Ilyasova,29-215,F,12/16/16,PHI,LAL,0,27,6,14,0.429,5,6,0.833,1,8,0.125,0,0,,2,8,10,1,1,0,2,2,13,8.3
Dewayne Dedmon,27-174,C,2/2/17,SAS,PHI,1,22,5,7,0.714,5,7,0.714,0,0,,3,3,1,2,8,10,1,0,2,2,4,13,12.4
Tony Snell,25-108,G-F,2/26/17,MIL,PHO,1,32,5,9,0.556,2,3,0.667,3,6,0.5,0,0,,1,2,3,2,0,0,1,1,13,10
Mason Plumlee,26-328,C-F,1/27/17,POR,MEM,1,34,5,11,0.455,5,11,0.455,0,0,,3,3,1,4,6,10,3,1,0,1,3,13,12.8
Manu Ginobili,39-127,G,12/2/16,SAS,WAS,0,24,4,6,0.667,3,3,1,1,3,0.333,4,4,1,0,1,1,7,3,0,2,2,13,15.8
Damian Lillard,26-203,G,2/3/17,POR,DAL,1,38,4,20,0.2,3,12,0.25,1,8,0.125,4,5,0.8,2,7,9,6,0,1,2,3,13,5.4
Thaddeus Young,28-264,F,3/12/17,IND,MIA,1,38,5,9,0.556,5,9,0.556,0,0,,3,6,0.5,1,4,5,1,0,0,0,1,13,9.7
Pau Gasol,36-280,F-C,4/12/17,SAS,UTA,0,23,6,13,0.462,5,11,0.455,1,2,0.5,0,0,,3,4,7,0,1,0,0,3,13,9.4
Jerami Grant,22-340,F,2/15/17,OKC,NYK,0,24,3,3,1,1,1,1,2,2,1,5,8,0.625,1,4,5,2,1,2,0,2,13,15.8
Marreese Speights,29-160,C-F,1/11/17,LAC,ORL,0,16,5,7,0.714,2,3,0.667,3,4,0.75,0,1,0,0,3,3,1,0,0,2,3,13,8.1
Tobias Harris,24-234,F,3/6/17,DET,CHI,0,28,5,10,0.5,4,8,0.5,1,2,0.5,2,2,1,1,7,8,3,1,0,0,0,13,13.9
Trevor Booker,29-080,F,2/13/17,BRK,MEM,0,23,6,10,0.6,6,8,0.75,0,2,0,1,1,1,2,2,4,0,1,0,2,1,13,9
Marco Belinelli,30-270,G-F,12/20/16,CHO,LAL,0,33,4,10,0.4,1,4,0.25,3,6,0.5,2,3,0.667,0,2,2,2,0,1,1,0,13,8.9
Lou Williams,30-029,G,11/25/16,LAL,GSW,0,26,5,13,0.385,5,9,0.556,0,4,0,3,4,0.75,1,2,3,2,1,0,4,0,13,5.2
Wayne Ellington,29-048,G,12/16/16,MIA,LAC,1,23,6,9,0.667,5,5,1,1,4,0.25,0,0,,1,1,2,0,0,0,0,1,13,9.7
Elfrid Payton,23-022,G,3/16/17,ORL,GSW,1,22,6,11,0.545,6,11,0.545,0,0,,1,1,1,4,4,8,2,0,2,5,2,13,8.7
Domantas Sabonis,20-273,F,1/31/17,OKC,SAS,1,35,5,11,0.455,3,7,0.429,2,4,0.5,1,2,0.5,1,9,10,0,2,1,6,5,13,5
Luc Mbah a Moute,30-115,F,1/2/17,LAC,PHO,1,23,5,6,0.833,4,5,0.8,1,1,1,2,3,0.667,1,2,3,0,0,1,3,3,13,8.2
Nikola Vucevic,26-112,C,2/13/17,ORL,MIA,1,31,4,14,0.286,4,14,0.286,0,0,,5,8,0.625,4,13,17,3,3,0,1,2,13,13.6
Rudy Gobert,24-180,C,12/23/16,UTA,TOR,1,35,5,7,0.714,5,7,0.714,0,0,,3,3,1,3,11,14,1,1,0,1,1,13,15.8
Eric Gordon,27-327,G,11/16/16,HOU,OKC,1,39,5,20,0.25,2,8,0.25,3,12,0.25,0,0,,1,4,5,4,0,1,2,2,13,3.6
Norman Powell,23-265,G,2/14/17,TOR,CHI,0,18,4,8,0.5,4,5,0.8,0,3,0,5,6,0.833,1,1,2,4,2,0,1,4,13,11.8
Pau Gasol,36-240,F-C,3/3/17,SAS,NOP,0,36,4,10,0.4,3,5,0.6,1,5,0.2,4,8,0.5,3,6,9,2,0,0,2,4,13,7.7
Cody Zeller,24-103,F-C,1/16/17,CHO,BOS,1,31,5,7,0.714,5,7,0.714,0,0,,3,4,0.75,5,3,8,2,0,1,2,2,13,13.4
Evan Fournier,24-031,G-F,11/29/16,ORL,SAS,1,33,4,9,0.444,3,7,0.429,1,2,0.5,4,4,1,0,3,3,7,2,0,6,3,13,8.9
Tyreke Evans,27-161,G-F,2/27/17,SAC,MIN,0,25,5,12,0.417,2,9,0.222,3,3,1,0,0,,0,5,5,1,1,1,2,3,13,7.3
Amir Johnson,29-250,F,1/6/17,BOS,PHI,1,26,4,6,0.667,2,3,0.667,2,3,0.667,3,4,0.75,0,5,5,3,1,4,2,1,13,15
Tony Allen,35-081,G-F,4/2/17,MEM,LAL,1,33,6,8,0.75,5,7,0.714,1,1,1,0,0,,1,8,9,3,2,1,1,3,13,15.5
Jarell Martin,22-158,F,10/29/16,MEM,NYK,0,13,5,9,0.556,3,7,0.429,2,2,1,1,2,0.5,2,1,3,0,1,0,1,5,13,8
Nik Stauskas,23-049,G,11/25/16,PHI,CHI,0,24,5,9,0.556,3,5,0.6,2,4,0.5,1,2,0.5,0,5,5,3,0,3,3,1,13,10.6
Avery Bradley,25-359,G,11/19/16,BOS,DET,1,36,6,10,0.6,5,7,0.714,1,3,0.333,0,0,,1,3,4,3,0,0,1,2,13,10.3
Yogi Ferrell,23-306,G,3/11/17,DAL,PHO,1,27,3,7,0.429,2,4,0.5,1,3,0.333,6,6,1,0,0,0,1,1,0,0,3,13,9.8
Jeremy Lin,28-201,G,3/12/17,BRK,NYK,1,27,3,14,0.214,2,8,0.25,1,6,0.167,6,9,0.667,0,4,4,5,1,0,2,2,13,6.1
Chris McCullough,21-283,F,11/14/16,BRK,LAC,0,12,6,9,0.667,5,7,0.714,1,2,0.5,0,0,,3,0,3,1,0,2,0,2,13,12.5
Maurice Harkless,23-245,F-G,1/11/17,POR,CLE,1,31,5,10,0.5,4,8,0.5,1,2,0.5,2,2,1,3,2,5,3,0,0,0,4,13,11.2
Dwight Powell,25-160,F-C,12/27/16,DAL,HOU,0,23,4,6,0.667,3,5,0.6,1,1,1,4,6,0.667,1,1,2,3,1,0,0,5,13,11.7
Cody Zeller,24-028,F-C,11/2/16,CHO,PHI,1,26,5,7,0.714,5,7,0.714,0,0,,3,6,0.5,0,1,1,0,0,1,0,5,13,7.9
E'Twaun Moore,27-334,G,1/27/17,NOP,SAS,0,18,6,11,0.545,5,9,0.556,1,2,0.5,0,0,,2,0,2,3,2,0,0,2,13,12.4
Elfrid Payton,22-315,G,1/2/17,ORL,NYK,0,31,6,12,0.5,5,11,0.455,1,1,1,0,0,,1,2,3,14,1,1,0,4,13,18.2
Marcus Smart,22-276,G,12/7/16,BOS,ORL,1,23,5,7,0.714,4,5,0.8,1,2,0.5,2,2,1,0,3,3,3,2,0,2,4,13,11.5
Tim Frazier,26-006,G,11/7/16,NOP,GSW,1,32,5,11,0.455,4,8,0.5,1,3,0.333,2,2,1,2,2,4,10,2,0,4,4,13,12.7
Greg Monroe,26-225,C-F,1/15/17,MIL,ATL,0,20,6,12,0.5,6,12,0.5,0,0,,1,2,0.5,1,0,1,1,0,0,2,4,13,4.4
Jeff Teague,28-236,G,2/1/17,IND,ORL,1,34,2,5,0.4,1,3,0.333,1,2,0.5,8,9,0.889,0,1,1,9,0,0,5,3,13,10.3
Delon Wright,24-319,G,3/11/17,TOR,MIA,0,25,5,8,0.625,5,8,0.625,0,0,,3,3,1,2,1,3,3,3,0,2,2,13,13.4
Tony Parker,34-222,G,12/25/16,SAS,CHI,1,28,6,15,0.4,5,13,0.385,1,2,0.5,0,0,,0,3,3,7,1,0,4,0,13,7.7
E'Twaun Moore,28-031,G,3/31/17,NOP,SAC,0,24,4,5,0.8,3,3,1,1,2,0.5,4,5,0.8,0,4,4,1,1,1,0,0,13,14.3
James Ennis,26-215,F,2/1/17,MEM,DEN,0,20,4,6,0.667,2,2,1,2,4,0.5,3,3,1,1,5,6,1,0,1,1,2,13,12.2
Trevor Booker,29-066,F,1/30/17,BRK,MIA,1,26,5,9,0.556,5,8,0.625,0,1,0,3,5,0.6,2,6,8,0,2,1,4,3,13,8.6
Aaron Gordon,21-194,F,3/29/17,ORL,OKC,1,41,5,11,0.455,4,6,0.667,1,5,0.2,2,2,1,1,5,6,1,4,1,0,2,13,14.1
Pau Gasol,36-250,F-C,3/13/17,SAS,ATL,0,27,4,10,0.4,2,6,0.333,2,4,0.5,3,4,0.75,3,7,10,4,0,4,2,2,13,14.2
Justin Anderson,23-136,G,4/4/17,PHI,BRK,1,30,4,7,0.571,1,2,0.5,3,5,0.6,2,3,0.667,1,1,2,3,0,0,1,1,13,11
Larry Nance Jr.,24-082,F,3/24/17,LAL,MIN,0,35,4,11,0.364,4,11,0.364,0,0,,5,6,0.833,2,5,7,5,1,0,4,3,13,8.7
Marcus Morris,27-210,F,3/31/17,DET,MIL,1,36,5,13,0.385,4,8,0.5,1,5,0.2,2,3,0.667,0,4,4,3,0,0,2,5,13,4.8
Ryan Anderson,28-203,F,11/25/16,HOU,SAC,1,29,4,10,0.4,1,3,0.333,3,7,0.429,2,2,1,0,0,0,4,0,0,1,2,13,8.6
Cody Zeller,24-152,F-C,3/6/17,CHO,IND,1,34,5,10,0.5,5,9,0.556,0,1,0,3,4,0.75,5,6,11,2,2,0,0,1,13,15.9
Mason Plumlee,26-238,C-F,10/29/16,POR,DEN,1,32,5,8,0.625,5,8,0.625,0,0,,3,6,0.5,0,2,2,5,1,0,2,5,13,9.3
Kelly Olynyk,25-266,C-F,1/10/17,BOS,TOR,0,25,6,10,0.6,5,8,0.625,1,2,0.5,0,2,0,1,3,4,1,0,1,2,4,13,7
Andre Iguodala,33-005,G-F,2/2/17,GSW,LAC,0,30,5,9,0.556,2,5,0.4,3,4,0.75,0,0,,1,3,4,4,3,0,3,1,13,12.7
Dion Waiters,25-034,G,1/13/17,MIA,MIL,1,31,5,17,0.294,3,11,0.273,2,6,0.333,1,1,1,0,2,2,6,0,0,1,2,13,6.1
Kawhi Leonard,25-172,F,12/18/16,SAS,NOP,1,24,5,10,0.5,4,7,0.571,1,3,0.333,2,2,1,0,2,2,0,1,1,0,1,13,9.9
Monta Ellis,31-019,G,11/14/16,IND,ORL,1,36,6,11,0.545,6,7,0.857,0,4,0,1,1,1,0,2,2,2,0,1,2,3,13,7.2
Ish Smith,28-147,G,11/29/16,DET,CHO,1,25,6,10,0.6,6,7,0.857,0,3,0,1,1,1,0,2,2,3,1,0,0,2,13,11.3
Amir Johnson,29-308,F,3/5/17,BOS,PHO,1,27,5,11,0.455,4,8,0.5,1,3,0.333,2,2,1,4,4,8,3,1,3,0,4,13,14.9
Leandro Barbosa,34-008,G,12/6/16,PHO,UTA,0,21,5,10,0.5,3,7,0.429,2,3,0.667,1,1,1,0,3,3,1,1,0,1,3,13,8.4
E'Twaun Moore,28-035,G,4/4/17,NOP,DEN,0,28,6,9,0.667,5,7,0.714,1,2,0.5,0,1,0,0,3,3,3,0,1,0,1,13,12
Jodie Meeks,29-127,G,12/26/16,ORL,MEM,1,29,5,8,0.625,2,3,0.667,3,5,0.6,0,0,,0,3,3,2,2,0,0,1,13,13.3
Arron Afflalo,31-105,G,1/28/17,SAC,CHO,1,31,4,8,0.5,2,4,0.5,2,4,0.5,3,4,0.75,0,2,2,4,1,0,0,1,13,12.6
Jerian Grant,24-120,G,2/6/17,CHI,SAC,1,35,4,5,0.8,2,2,1,2,3,0.667,3,5,0.6,2,3,5,3,0,0,1,0,13,13.7
Bojan Bogdanovic,27-214,G-F,11/18/16,BRK,OKC,1,24,4,6,0.667,3,5,0.6,1,1,1,4,6,0.667,1,2,3,2,0,0,2,1,13,9.9
Eric Gordon,28-103,G,4/7/17,HOU,DET,0,31,5,14,0.357,2,4,0.5,3,10,0.3,0,0,,0,5,5,0,0,0,3,0,13,3.7
Marcus Smart,22-274,G,12/5/16,BOS,HOU,0,27,4,9,0.444,3,5,0.6,1,4,0.25,4,5,0.8,2,3,5,2,0,1,0,3,13,11.1
Patty Mills,28-107,G,11/26/16,SAS,WAS,0,19,4,7,0.571,1,2,0.5,3,5,0.6,2,2,1,0,3,3,4,0,0,1,1,13,12
Seth Curry,26-117,G,12/18/16,DAL,SAC,0,29,5,10,0.5,2,4,0.5,3,6,0.5,0,0,,0,5,5,4,2,0,2,0,13,12.3
Willy Hernangomez,22-285,C,3/8/17,NYK,MIL,1,28,6,10,0.6,6,10,0.6,0,0,,1,3,0.333,3,9,12,1,2,1,6,6,13,7.4
Evan Fournier,24-007,G-F,11/5/16,ORL,WAS,1,30,2,8,0.25,0,2,0,2,6,0.333,7,8,0.875,0,2,2,2,0,0,2,6,13,5.4
Andre Drummond,23-223,C,3/21/17,DET,BRK,1,31,6,12,0.5,6,12,0.5,0,0,,1,3,0.333,4,13,17,2,1,2,2,3,13,13.5
Troy Daniels,25-154,G,12/16/16,MEM,SAC,0,28,4,11,0.364,0,2,0,4,9,0.444,1,1,1,1,2,3,0,0,1,1,2,13,7.1
Brandon Ingram,19-212,F,4/2/17,LAL,MEM,1,23,6,11,0.545,6,9,0.667,0,2,0,1,1,1,0,3,3,1,1,0,1,1,13,8.9
Marcus Morris,27-185,F,3/6/17,DET,CHI,1,31,5,13,0.385,4,8,0.5,1,5,0.2,2,4,0.5,1,5,6,3,0,1,2,3,13,6.9
Al Horford,30-247,C-F,2/5/17,BOS,LAC,1,35,4,13,0.308,1,4,0.25,3,9,0.333,2,2,1,2,13,15,6,1,2,2,5,13,13.4
Solomon Hill,26-001,F,3/19/17,NOP,MIN,1,35,4,9,0.444,2,5,0.4,2,4,0.5,3,4,0.75,0,5,5,5,2,1,1,2,13,13.8
Jamal Murray,20-031,G,3/26/17,DEN,NOP,0,24,5,13,0.385,3,8,0.375,2,5,0.4,1,2,0.5,0,2,2,2,1,0,1,3,13,6.3
Alec Burks,25-187,G,1/23/17,UTA,OKC,0,25,4,7,0.571,4,5,0.8,0,2,0,5,6,0.833,0,2,2,2,0,1,0,3,13,10.8
Danilo Gallinari,28-232,F,3/28/17,DEN,POR,1,32,3,15,0.2,2,7,0.286,1,8,0.125,6,7,0.857,2,5,7,3,0,0,2,3,13,5.1
DeAndre Jordan,28-152,C,12/20/16,LAC,DEN,1,29,6,7,0.857,6,7,0.857,0,0,,1,1,1,2,11,13,2,0,1,0,1,13,16.9
Jeremy Lamb,24-257,G-F,2/11/17,CHO,LAC,0,16,4,9,0.444,2,5,0.4,2,4,0.5,3,5,0.6,1,0,1,3,0,0,0,1,13,9.9
Marc Gasol,32-043,C,3/13/17,MEM,MIL,1,37,6,13,0.462,6,11,0.545,0,2,0,1,2,0.5,1,6,7,7,2,0,1,2,13,13.5
Marcus Smart,22-330,G,1/30/17,BOS,DET,0,30,3,13,0.231,1,10,0.1,2,3,0.667,5,6,0.833,1,4,5,8,0,0,1,2,13,10.4
George Hill,30-251,G,1/10/17,UTA,CLE,1,37,5,11,0.455,3,8,0.375,2,3,0.667,1,4,0.25,1,2,3,7,0,0,2,3,13,9.1
Jae Crowder,26-266,F,3/29/17,BOS,MIL,1,37,4,12,0.333,4,6,0.667,0,6,0,5,7,0.714,1,1,2,3,0,0,4,3,13,3.3
Marco Belinelli,30-316,G-F,2/4/17,CHO,UTA,0,24,4,9,0.444,1,3,0.333,3,6,0.5,2,2,1,0,2,2,0,0,0,1,0,13,7.9
Justin Anderson,23-038,G,12/27/16,DAL,HOU,0,21,4,8,0.5,2,2,1,2,6,0.333,3,4,0.75,2,6,8,2,1,2,0,1,13,15.2
Troy Daniels,25-237,G,3/9/17,MEM,LAC,0,16,4,5,0.8,0,0,,4,5,0.8,1,2,0.5,0,1,1,1,0,0,1,3,13,9.5
Julius Randle,22-131,F,4/9/17,LAL,MIN,1,28,5,9,0.556,5,7,0.714,0,2,0,3,5,0.6,3,5,8,2,1,1,2,3,13,11.4
Derrick Favors,25-266,F-C,4/7/17,UTA,MIN,0,17,6,9,0.667,6,9,0.667,0,0,,1,2,0.5,4,1,5,1,1,0,0,5,13,11.5
Gorgui Dieng,26-310,C,11/23/16,MIN,NOP,1,24,5,7,0.714,5,7,0.714,0,0,,3,4,0.75,1,7,8,5,0,0,2,3,13,12.8
Tyler Johnson,24-282,G,2/13/17,MIA,ORL,0,31,4,9,0.444,4,7,0.571,0,2,0,5,6,0.833,0,3,3,2,2,1,0,1,13,12.5
T.J. McConnell,25-010,G,4/4/17,PHI,BRK,1,34,5,12,0.417,4,10,0.4,1,2,0.5,2,2,1,0,2,2,7,1,1,1,0,13,12.8
Steven Adams,23-116,C,11/13/16,OKC,ORL,1,35,6,13,0.462,6,13,0.462,0,0,,1,1,1,4,6,10,0,1,1,1,1,13,11.2
Wilson Chandler,29-197,F,11/23/16,DEN,UTA,0,25,4,11,0.364,3,8,0.375,1,3,0.333,4,4,1,1,8,9,0,0,0,1,1,13,8.6
Terrence Ross,26-018,F-G,2/23/17,ORL,POR,1,33,4,17,0.235,2,9,0.222,2,8,0.25,3,3,1,2,3,5,1,3,0,1,3,13,6.5
Andrew Harrison,22-046,G,12/13/16,MEM,CLE,1,31,4,11,0.364,3,6,0.5,1,5,0.2,4,5,0.8,0,3,3,4,1,3,2,2,13,10.5
Montrezl Harrell,23-050,F-C,3/17/17,HOU,NOP,0,19,5,5,1,5,5,1,0,0,,3,5,0.6,1,5,6,0,0,1,1,6,13,10.2
Marco Belinelli,30-299,G-F,1/18/17,CHO,POR,0,24,5,8,0.625,4,6,0.667,1,2,0.5,2,2,1,0,5,5,3,1,0,2,1,13,11.6
Marcus Morris,27-193,F,3/14/17,DET,CLE,1,24,5,9,0.556,4,7,0.571,1,2,0.5,2,2,1,2,5,7,0,0,0,0,2,13,10.8
Caris LeVert,22-203,G-F,3/16/17,BRK,NYK,1,25,5,9,0.556,4,6,0.667,1,3,0.333,2,2,1,1,6,7,0,0,0,1,2,13,9.4
E'Twaun Moore,28-008,G,3/8/17,NOP,TOR,0,29,6,11,0.545,5,8,0.625,1,3,0.333,0,0,,0,1,1,2,0,0,1,3,13,7.2
E'Twaun Moore,28-005,G,3/5/17,NOP,LAL,0,31,5,9,0.556,3,6,0.5,2,3,0.667,1,2,0.5,0,1,1,2,1,1,0,2,13,10.9
Spencer Dinwiddie,23-274,G,1/5/17,BRK,IND,0,32,4,7,0.571,3,6,0.5,1,1,1,4,4,1,1,2,3,3,1,2,1,3,13,13.3
Kyle Lowry,31-018,G,4/12/17,TOR,CLE,1,17,4,8,0.5,3,3,1,1,5,0.2,4,6,0.667,0,2,2,4,0,0,4,1,13,7.2
Kris Humphries,31-347,F-C,1/18/17,ATL,DET,0,20,4,5,0.8,3,3,1,1,2,0.5,4,4,1,1,1,2,1,0,0,1,4,13,10.2
Kent Bazemore,27-282,G-F,4/9/17,ATL,CLE,0,30,4,8,0.5,3,4,0.75,1,4,0.25,4,5,0.8,2,0,2,4,4,0,2,2,13,14
Jeff Teague,28-245,G,2/10/17,IND,WAS,1,31,4,12,0.333,3,9,0.333,1,3,0.333,4,4,1,0,4,4,9,0,0,0,3,13,12.5
Darren Collison,29-101,G,12/2/16,SAC,BOS,1,28,4,8,0.5,3,5,0.6,1,3,0.333,4,4,1,0,0,0,3,2,0,1,3,13,10.9
Justise Winslow,20-269,F,12/20/16,MIA,ORL,1,46,6,17,0.353,6,16,0.375,0,1,0,1,1,1,1,4,5,2,0,0,1,4,13,4.2
Aaron Gordon,21-107,F,1/1/17,ORL,IND,1,28,4,10,0.4,3,5,0.6,1,5,0.2,4,4,1,2,4,6,0,2,1,2,4,13,9.3
Donatas Motiejunas,26-187,F-C,3/26/17,NOP,DEN,0,19,6,12,0.5,5,9,0.556,1,3,0.333,0,1,0,1,6,7,0,0,0,1,2,13,7.3
Joe Harris,25-056,G,11/2/16,BRK,DET,0,26,6,9,0.667,5,5,1,1,4,0.25,0,0,,0,2,2,1,1,0,2,2,13,8.6
Brook Lopez,28-236,C,11/23/16,BRK,BOS,1,28,4,14,0.286,3,8,0.375,1,6,0.167,4,5,0.8,1,2,3,2,2,1,0,1,13,9.4
Kelly Oubre,21-118,F,4/6/17,WAS,NYK,0,28,5,8,0.625,4,5,0.8,1,3,0.333,2,2,1,3,2,5,2,0,2,2,2,13,12.1
Leandro Barbosa,33-356,G,11/18/16,PHO,IND,0,24,5,9,0.556,2,5,0.4,3,4,0.75,0,0,,0,1,1,1,2,0,0,0,13,11.7
Luc Mbah a Moute,30-173,F,3/1/17,LAC,HOU,1,18,6,11,0.545,5,9,0.556,1,2,0.5,0,0,,1,1,2,1,0,0,0,2,13,8.6
Jonas Valanciunas,24-302,C,3/4/17,TOR,MIL,1,21,5,5,1,5,5,1,0,0,,3,4,0.75,0,7,7,1,0,0,2,3,13,10.7
Sean Kilpatrick,26-345,G,12/16/16,BRK,ORL,1,27,4,9,0.444,2,4,0.5,2,5,0.4,3,4,0.75,1,5,6,1,1,0,0,5,13,9.8
Gerald Henderson,29-049,G,1/27/17,PHI,HOU,0,23,5,5,1,3,3,1,2,2,1,1,2,0.5,1,1,2,4,2,0,1,2,13,15.1
Rodney Stuckey,30-298,G,2/13/17,IND,SAS,0,21,5,8,0.625,4,6,0.667,1,2,0.5,2,3,0.667,1,3,4,3,1,0,0,0,13,13.7
Bojan Bogdanovic,27-227,G-F,12/1/16,BRK,MIL,1,27,5,14,0.357,3,8,0.375,2,6,0.333,1,1,1,0,3,3,1,0,0,0,2,13,6
Eric Gordon,27-361,G,12/20/16,HOU,SAS,0,33,4,15,0.267,3,7,0.429,1,8,0.125,4,4,1,0,1,1,4,0,2,3,2,13,4.8
Gerald Henderson,28-354,G,11/27/16,PHI,CLE,1,32,5,13,0.385,4,7,0.571,1,6,0.167,2,2,1,1,4,5,4,1,1,0,3,13,11.1
Rajon Rondo,30-274,G,11/22/16,CHI,DEN,1,33,6,11,0.545,5,9,0.556,1,2,0.5,0,0,,0,11,11,8,1,1,3,3,13,14.1
Luol Deng,31-250,F,12/22/16,LAL,MIA,1,34,5,10,0.5,2,4,0.5,3,6,0.5,0,0,,0,7,7,2,2,0,2,1,13,11.1
Beno Udrih,34-115,G,10/28/16,DET,ORL,0,20,6,10,0.6,5,9,0.556,1,1,1,0,0,,0,2,2,5,0,0,0,2,13,11.7
Mike Muscala,25-145,F-C,11/23/16,ATL,IND,0,26,4,7,0.571,2,5,0.4,2,2,1,3,3,1,2,2,4,1,0,0,1,1,13,11
Taj Gibson,31-292,F,4/12/17,OKC,DEN,1,22,4,11,0.364,4,11,0.364,0,0,,5,6,0.833,3,4,7,0,0,2,1,2,13,9.4
Marvin Williams,30-218,F,1/23/17,CHO,WAS,1,29,5,12,0.417,4,6,0.667,1,6,0.167,2,2,1,4,4,8,4,2,1,0,2,13,15.3
James Ennis,26-175,F,12/23/16,MEM,HOU,0,21,5,7,0.714,2,2,1,3,5,0.6,0,0,,0,1,1,0,0,0,2,0,13,8.4
Kristaps Porzingis,21-176,F-C,1/25/17,NYK,DAL,1,23,4,11,0.364,4,9,0.444,0,2,0,5,5,1,2,6,8,1,0,1,1,5,13,8.5
Doug McDermott,25-078,F,3/22/17,OKC,PHI,0,14,6,10,0.6,5,7,0.714,1,3,0.333,0,0,,0,0,0,1,0,0,0,0,13,9.1
George Hill,30-261,G,1/20/17,UTA,DAL,1,31,5,13,0.385,4,9,0.444,1,4,0.25,2,2,1,0,1,1,1,0,0,2,6,13,2.5
Andre Drummond,23-133,C,12/21/16,DET,MEM,1,38,3,8,0.375,3,8,0.375,0,0,,7,10,0.7,7,12,19,1,1,0,4,4,13,12
Isaiah Thomas,28-064,G,4/12/17,BOS,MIL,1,23,3,11,0.273,1,5,0.2,2,6,0.333,5,6,0.833,2,2,4,8,1,1,1,0,13,14.4
Courtney Lee,31-056,G,11/28/16,NYK,OKC,1,36,5,10,0.5,2,5,0.4,3,5,0.6,0,0,,0,3,3,1,2,0,0,2,13,10.8
Greg Monroe,26-282,C-F,3/13/17,MIL,MEM,0,26,5,10,0.5,5,10,0.5,0,0,,3,3,1,1,4,5,1,2,0,5,2,13,6.8
Lucas Nogueira,24-129,C,12/2/16,TOR,LAL,0,18,5,5,1,5,5,1,0,0,,3,3,1,1,2,3,0,2,2,0,2,13,15.4
James Harden,27-082,G,11/16/16,HOU,OKC,1,37,4,16,0.25,3,11,0.273,1,5,0.2,4,7,0.571,3,4,7,13,3,0,6,1,13,11.2
Shelvin Mack,26-345,G,4/2/17,UTA,SAS,0,25,5,10,0.5,5,9,0.556,0,1,0,3,4,0.75,0,1,1,2,2,0,0,2,13,10.5
C.J. McCollum,25-093,G,12/21/16,POR,DAL,1,41,5,16,0.313,5,12,0.417,0,4,0,3,3,1,0,2,2,2,0,2,3,4,13,2.6
Pau Gasol,36-270,F-C,4/2/17,SAS,UTA,0,28,6,12,0.5,5,9,0.556,1,3,0.333,0,0,,3,9,12,3,0,1,2,0,13,12.6
Montrezl Harrell,23-071,F-C,4/7/17,HOU,DET,0,27,5,6,0.833,5,6,0.833,0,0,,3,4,0.75,0,2,2,2,0,2,2,4,13,10.2
Derrick Rose,28-142,G,2/23/17,NYK,CLE,1,32,6,14,0.429,6,14,0.429,0,0,,1,1,1,0,2,2,4,0,0,1,1,13,7.6
Matthew Dellavedova,26-186,G,3/13/17,MIL,MEM,1,23,5,7,0.714,2,3,0.667,3,4,0.75,0,0,,0,3,3,0,0,0,3,1,13,7.6
Jordan Crawford,28-154,G,3/26/17,NOP,DEN,0,24,6,13,0.462,5,9,0.556,1,4,0.25,0,0,,0,5,5,6,1,0,2,3,13,9.8
Mirza Teletovic,31-089,F,12/16/16,MIL,CHI,0,27,5,10,0.5,2,2,1,3,8,0.375,0,0,,0,8,8,2,0,1,0,2,13,11.7
Carmelo Anthony,32-234,F,1/18/17,NYK,BOS,1,33,5,14,0.357,2,5,0.4,3,9,0.333,0,0,,1,3,4,3,0,1,1,2,13,7.8
Paul George,26-196,F,11/14/16,IND,ORL,1,34,5,16,0.313,4,11,0.364,1,5,0.2,2,2,1,1,5,6,5,2,1,2,1,13,9.8
Buddy Hield,23-104,G,3/31/17,SAC,NOP,1,25,6,9,0.667,5,5,1,1,4,0.25,0,0,,2,6,8,3,1,1,4,1,13,11.7
Frank Kaminsky,23-235,F-C,11/25/16,CHO,NYK,0,40,3,14,0.214,2,7,0.286,1,7,0.143,6,6,1,2,7,9,4,0,0,3,1,13,7.3
Trey Lyles,21-041,F,12/16/16,UTA,DAL,0,18,6,8,0.75,5,6,0.833,1,2,0.5,0,0,,1,3,4,3,0,1,0,1,13,13.8
DeMarre Carroll,30-138,F,12/12/16,TOR,MIL,1,29,5,12,0.417,2,5,0.4,3,7,0.429,0,0,,2,4,6,2,1,0,0,3,13,10.4
Jae Crowder,26-176,F,12/29/16,BOS,CLE,1,34,5,9,0.556,3,4,0.75,2,5,0.4,1,2,0.5,0,4,4,3,2,0,0,3,13,12.4
Darrun Hilliard,23-361,G,4/9/17,DET,MEM,0,21,5,7,0.714,2,2,1,3,5,0.6,0,0,,0,0,0,0,1,1,3,3,13,7.6
Nemanja Bjelica,28-296,F,3/1/17,MIN,UTA,0,32,4,10,0.4,3,7,0.429,1,3,0.333,4,5,0.8,1,10,11,5,1,2,0,4,13,15.2
Channing Frye,33-175,C-F,11/8/16,CLE,ATL,0,27,5,15,0.333,2,7,0.286,3,8,0.375,0,0,,2,5,7,1,0,0,0,0,13,8.1
Stephen Curry,28-235,G,11/4/16,GSW,LAL,1,31,5,17,0.294,5,7,0.714,0,10,0,3,3,1,0,8,8,10,2,1,2,3,13,12
Nik Stauskas,23-181,G,4/6/17,PHI,CHI,0,25,4,10,0.4,2,4,0.5,2,6,0.333,3,4,0.75,0,3,3,4,1,0,1,1,13,10.5
Devin Booker,20-064,G,1/2/17,PHO,LAC,1,33,4,15,0.267,3,10,0.3,1,5,0.2,4,6,0.667,0,1,1,2,2,0,3,5,13,2
Markieff Morris,27-180,F,3/1/17,WAS,TOR,1,33,6,14,0.429,5,11,0.455,1,3,0.333,0,0,,2,6,8,5,0,0,0,2,13,11.5
Elfrid Payton,23-019,G,3/13/17,ORL,SAC,1,34,6,10,0.6,6,9,0.667,0,1,0,1,1,1,1,9,10,13,0,1,1,3,13,19.4
Joe Johnson,35-160,G-F,12/6/16,UTA,PHO,0,29,4,10,0.4,1,4,0.25,3,6,0.5,2,2,1,0,2,2,2,1,1,3,3,13,7.1
Alex Abrines,23-167,G-F,1/15/17,OKC,SAC,0,17,3,5,0.6,0,1,0,3,4,0.75,4,5,0.8,1,2,3,1,1,0,2,4,13,9.7
Malcolm Delaney,27-332,G,2/6/17,ATL,UTA,0,18,5,7,0.714,3,4,0.75,2,3,0.667,1,2,0.5,0,2,2,0,0,0,1,3,13,8.1
Clint Capela,22-182,F-C,11/16/16,HOU,OKC,1,28,5,8,0.625,5,8,0.625,0,0,,3,4,0.75,4,10,14,0,0,3,0,1,13,16.5
Dorian Finney-Smith,23-222,F,12/12/16,DAL,DEN,1,32,5,9,0.556,2,4,0.5,3,5,0.6,0,0,,1,8,9,3,2,2,1,3,13,15.1
Nikola Vucevic,26-088,C,1/20/17,ORL,MIL,1,23,6,12,0.5,6,12,0.5,0,0,,1,2,0.5,4,2,6,2,0,0,1,3,13,9.2
Brook Lopez,28-246,C,12/3/16,BRK,MIL,1,29,3,17,0.176,0,8,0,3,9,0.333,4,6,0.667,1,3,4,6,1,3,2,5,13,6.4
Marco Belinelli,30-229,G-F,11/9/16,CHO,UTA,0,27,5,7,0.714,4,5,0.8,1,2,0.5,2,2,1,0,1,1,1,0,0,2,3,13,7.9
JaVale McGee,29-003,C,1/22/17,GSW,ORL,0,13,6,7,0.857,6,7,0.857,0,0,,1,2,0.5,3,1,4,1,0,0,0,1,13,12.8
Serge Ibaka,27-117,F-C,1/13/17,ORL,POR,1,29,4,10,0.4,1,4,0.25,3,6,0.5,2,2,1,1,9,10,1,0,1,1,4,13,9.8
Deron Williams,32-203,G,1/15/17,DAL,MIN,1,31,5,9,0.556,2,4,0.5,3,5,0.6,0,2,0,0,4,4,10,2,0,4,3,13,12.9
Raymond Felton,32-179,G,12/22/16,LAC,SAS,0,23,6,9,0.667,6,8,0.75,0,1,0,1,2,0.5,0,4,4,3,0,0,1,1,13,10.6
Taj Gibson,31-276,F,3/27/17,OKC,DAL,1,24,6,10,0.6,6,10,0.6,0,0,,1,1,1,4,2,6,1,0,1,1,2,13,11.4
Malcolm Brogdon,23-356,G,12/1/16,MIL,BRK,0,26,4,7,0.571,1,3,0.333,3,4,0.75,2,2,1,1,3,4,4,0,0,3,1,13,10.7
Gorgui Dieng,26-326,C,12/9/16,MIN,DET,1,27,6,9,0.667,6,9,0.667,0,0,,1,1,1,1,6,7,3,1,0,0,2,13,13.9
Montrezl Harrell,22-310,F-C,12/1/16,HOU,GSW,0,25,6,10,0.6,6,10,0.6,0,0,,1,1,1,5,5,10,1,0,1,0,3,13,13.6
Dario Saric,22-266,F,12/30/16,PHI,DEN,0,28,4,11,0.364,4,7,0.571,0,4,0,5,7,0.714,4,7,11,5,0,0,1,4,13,11.9
Monta Ellis,31-105,G,2/8/17,IND,CLE,0,24,5,7,0.714,4,5,0.8,1,2,0.5,2,2,1,0,2,2,3,1,0,0,2,13,13
LaMarcus Aldridge,31-177,F-C,1/12/17,SAS,LAL,1,24,5,11,0.455,4,10,0.4,1,1,1,2,2,1,2,2,4,0,0,1,0,0,13,10
Dwight Howard,31-027,C,1/4/17,ATL,ORL,1,30,5,9,0.556,5,9,0.556,0,0,,3,3,1,3,9,12,1,1,1,0,2,13,15.1
Tristan Thompson,25-272,F-C,12/10/16,CLE,CHO,1,28,5,5,1,5,5,1,0,0,,3,6,0.5,4,8,12,0,1,0,3,3,13,12.3
Montrezl Harrell,22-340,F-C,12/31/16,HOU,NYK,1,33,6,7,0.857,6,7,0.857,0,0,,1,1,1,0,4,4,4,0,0,0,4,13,12.9
Raymond Felton,32-242,G,2/23/17,LAC,GSW,0,24,4,7,0.571,3,5,0.6,1,2,0.5,4,4,1,1,2,3,5,3,0,2,3,13,14.3
Paul Millsap,31-264,F,10/31/16,ATL,SAC,1,32,5,14,0.357,5,13,0.385,0,1,0,3,4,0.75,5,8,13,8,3,1,4,4,13,14.4
Marcus Morris,27-095,F,12/6/16,DET,CHI,1,26,5,9,0.556,2,4,0.5,3,5,0.6,0,0,,0,1,1,0,0,0,2,2,13,6.2
Aaron Gordon,21-091,F,12/16/16,ORL,BRK,1,29,4,12,0.333,3,7,0.429,1,5,0.2,4,5,0.8,3,2,5,2,1,0,0,1,13,10.5
Kevin Love,28-083,F,11/29/16,CLE,MIL,1,31,3,10,0.3,1,3,0.333,2,7,0.286,5,7,0.714,1,12,13,2,1,0,1,2,13,11.3
Serge Ibaka,27-124,F-C,1/20/17,ORL,MIL,1,22,4,7,0.571,2,4,0.5,2,3,0.667,3,3,1,1,3,4,1,2,0,3,1,13,10.6
Skal Labissiere,21-013,F,3/31/17,SAC,NOP,1,36,5,17,0.294,5,17,0.294,0,0,,3,6,0.5,5,3,8,0,0,1,3,4,13,2.4
Ryan Anderson,28-249,F,1/10/17,HOU,CHO,1,36,5,12,0.417,2,5,0.4,3,7,0.429,0,0,,2,0,2,1,2,0,0,1,13,10.3
Marvin Williams,30-193,F,12/29/16,CHO,MIA,1,25,6,12,0.5,5,8,0.625,1,4,0.25,0,0,,0,1,1,2,1,0,0,1,13,9.3
Larry Nance Jr.,24-067,F,3/9/17,LAL,PHO,0,27,6,10,0.6,5,8,0.625,1,2,0.5,0,0,,2,6,8,1,1,0,0,2,13,12.5
Spencer Hawes,28-193,C-F,11/7/16,CHO,IND,0,22,6,11,0.545,5,8,0.625,1,3,0.333,0,0,,2,11,13,1,2,0,1,2,13,13.3
Avery Bradley,25-342,G,11/2/16,BOS,CHI,1,39,6,15,0.4,5,8,0.625,1,7,0.143,0,0,,2,3,5,4,0,0,1,4,13,7.4
Patty Mills,28-163,G,1/21/17,SAS,CLE,0,31,4,11,0.364,1,6,0.167,3,5,0.6,2,2,1,2,1,3,5,1,0,2,2,13,10.3
Julius Randle,22-094,F,3/3/17,LAL,BOS,1,29,5,13,0.385,5,13,0.385,0,0,,3,3,1,1,6,7,3,0,0,1,2,13,8.7
Nicolas Batum,28-111,F-G,4/4/17,CHO,WAS,1,32,6,10,0.6,5,5,1,1,5,0.2,0,0,,0,1,1,8,1,0,4,0,13,11.3
Wilson Chandler,29-295,F,3/1/17,DEN,MIL,1,36,4,8,0.5,2,3,0.667,2,5,0.4,3,4,0.75,0,5,5,0,1,0,1,2,13,9.3
Derrick Rose,28-025,G,10/29/16,NYK,MEM,1,32,6,13,0.462,6,12,0.5,0,1,0,1,2,0.5,1,3,4,3,2,1,0,2,13,11.5
Joel Embiid,22-243,C-F,11/14/16,PHI,HOU,1,23,6,10,0.6,6,8,0.75,0,2,0,1,1,1,2,8,10,1,1,2,6,5,13,7.3
JaMychal Green,26-270,F,3/18/17,MEM,SAS,1,24,4,8,0.5,2,4,0.5,2,4,0.5,3,3,1,2,2,4,0,1,0,0,4,13,10.4
C.J. McCollum,25-188,G,3/26/17,POR,LAL,1,29,5,13,0.385,4,10,0.4,1,3,0.333,2,2,1,0,1,1,3,1,0,4,1,13,4.9
Willy Hernangomez,22-291,C,3/14/17,NYK,IND,0,31,6,12,0.5,6,12,0.5,0,0,,1,4,0.25,6,10,16,4,3,1,4,3,13,14.3
Jeremy Lamb,24-307,G-F,4/2/17,CHO,OKC,0,11,5,7,0.714,4,5,0.8,1,2,0.5,2,2,1,0,3,3,0,1,0,1,0,13,11
Myles Turner,20-317,F-C,2/4/17,IND,DET,1,32,5,12,0.417,4,9,0.444,1,3,0.333,2,3,0.667,1,5,6,1,2,1,0,4,13,10.2
Ty Lawson,29-123,G,3/6/17,SAC,DEN,1,34,2,8,0.25,1,5,0.2,1,3,0.333,8,10,0.8,1,1,2,6,4,0,0,1,13,16.2
JaMychal Green,26-168,F,12/6/16,MEM,PHI,1,35,2,7,0.286,2,7,0.286,0,0,,9,10,0.9,3,7,10,3,2,1,3,4,13,12.9
Jeff Green,30-143,F,1/18/17,ORL,NOP,0,23,5,10,0.5,4,6,0.667,1,4,0.25,2,2,1,0,2,2,0,2,0,1,0,13,9.6
Andre Roberson,25-034,G-F,1/7/17,OKC,DEN,1,39,3,7,0.429,1,2,0.5,2,5,0.4,5,8,0.625,0,9,9,0,0,1,0,3,13,10.3
Jeff Green,30-149,F,1/24/17,ORL,CHI,1,34,3,11,0.273,3,8,0.375,0,3,0,7,7,1,1,6,7,1,1,0,2,3,13,7.5
Dario Saric,22-304,F,2/6/17,PHI,DET,0,28,6,14,0.429,5,9,0.556,1,5,0.2,0,0,,3,3,6,4,0,0,2,3,13,8.2
Darren Collison,29-175,G,2/14/17,SAC,LAL,1,40,5,12,0.417,4,8,0.5,1,4,0.25,2,2,1,1,4,5,8,0,0,5,0,13,9.1
Jodie Meeks,29-222,G,3/31/17,ORL,BOS,0,18,4,9,0.444,1,3,0.333,3,6,0.5,2,2,1,0,1,1,0,1,1,1,0,13,9.3
Nikola Jokic,22-010,C-F,3/1/17,DEN,MIL,1,30,6,10,0.6,6,10,0.6,0,0,,1,2,0.5,4,10,14,10,1,0,3,1,13,18.4
Deron Williams,32-210,G,1/22/17,DAL,LAL,1,26,6,9,0.667,5,6,0.833,1,3,0.333,0,0,,0,5,5,8,0,0,0,1,13,15.8
Jeff Green,30-141,F,1/16/17,ORL,DEN,0,17,3,9,0.333,2,5,0.4,1,4,0.25,6,6,1,0,1,1,1,1,0,0,0,13,9.9
Mirza Teletovic,31-185,F,3/22/17,MIL,SAC,0,20,5,10,0.5,2,2,1,3,8,0.375,0,0,,0,4,4,2,0,0,1,2,13,8.8
Frank Kaminsky,23-266,F-C,12/26/16,CHO,BRK,0,20,5,9,0.556,4,6,0.667,1,3,0.333,2,2,1,2,3,5,0,0,0,2,4,13,7.4
Austin Rivers,24-198,G,2/15/17,LAC,ATL,1,27,5,11,0.455,4,8,0.5,1,3,0.333,2,2,1,0,2,2,4,3,0,1,1,13,12.3
Marcin Gortat,32-320,C-F,1/2/17,WAS,HOU,1,40,6,10,0.6,6,10,0.6,0,0,,1,2,0.5,4,10,14,3,1,0,4,2,13,12.1
Jusuf Nurkic,22-069,C,10/31/16,DEN,TOR,1,38,5,14,0.357,5,14,0.357,0,0,,3,7,0.429,5,13,18,1,1,5,1,2,13,14.4
Cristiano Felicio,24-189,F-C,1/12/17,CHI,NYK,0,24,6,9,0.667,6,9,0.667,0,0,,1,2,0.5,4,1,5,0,0,1,0,0,13,12.5
Robert Covington,26-028,F,1/11/17,PHI,NYK,1,32,5,10,0.5,2,4,0.5,3,6,0.5,0,0,,1,4,5,4,1,0,2,1,13,11.3
Larry Nance Jr.,24-075,F,3/17/17,LAL,MIL,0,28,3,6,0.5,3,4,0.75,0,2,0,7,7,1,0,4,4,2,4,0,2,4,13,13
Seth Curry,26-094,G,11/25/16,DAL,CLE,0,26,5,13,0.385,5,7,0.714,0,6,0,3,3,1,0,4,4,3,0,0,3,3,13,5
Marvin Williams,30-274,F,3/20/17,CHO,ATL,1,36,5,10,0.5,5,6,0.833,0,4,0,3,3,1,1,7,8,3,1,0,0,4,13,12.3
Tony Parker,34-240,G,1/12/17,SAS,LAL,1,21,6,10,0.6,6,10,0.6,0,0,,1,1,1,0,2,2,6,0,0,0,1,13,12.8
Derrick Rose,28-129,G,2/10/17,NYK,DEN,1,28,6,9,0.667,6,9,0.667,0,0,,1,1,1,1,2,3,4,1,0,1,0,13,13.2
Tobias Harris,24-182,F,1/13/17,DET,UTA,1,34,4,12,0.333,3,9,0.333,1,3,0.333,4,5,0.8,0,2,2,1,0,0,0,2,13,6.3
Luol Deng,31-253,F,12/25/16,LAL,LAC,1,34,4,9,0.444,4,6,0.667,0,3,0,5,7,0.714,5,7,12,2,2,2,0,1,13,17.5
Eric Bledsoe,27-019,G,12/28/16,PHO,SAS,1,27,6,9,0.667,6,7,0.857,0,2,0,1,1,1,1,1,2,3,0,0,1,3,13,10
Yogi Ferrell,23-328,G,4/2/17,DAL,MIL,1,31,4,8,0.5,2,4,0.5,2,4,0.5,3,4,0.75,0,5,5,5,1,0,1,2,13,12.8
Patrick Beverley,28-157,G,12/16/16,HOU,NOP,1,34,5,10,0.5,2,2,1,3,8,0.375,0,0,,6,5,11,8,1,0,4,4,13,14.7
DeMarcus Cousins,26-186,C-F,2/15/17,SAC,GSW,1,23,6,14,0.429,5,11,0.455,1,3,0.333,0,1,0,0,4,4,6,0,1,3,1,13,7.9
Reggie Jackson,26-254,G,12/26/16,DET,CLE,1,30,5,9,0.556,3,6,0.5,2,3,0.667,1,1,1,0,1,1,6,1,0,6,4,13,6.6
George Hill,30-184,G,11/4/16,UTA,SAS,1,28,5,13,0.385,2,7,0.286,3,6,0.5,0,0,,1,2,3,3,0,0,1,2,13,7.5
Nikola Vucevic,26-063,C,12/26/16,ORL,MEM,0,27,6,11,0.545,5,10,0.5,1,1,1,0,0,,0,9,9,1,0,1,1,3,13,9.6
Otto Porter,23-303,F,4/2/17,WAS,GSW,1,23,5,10,0.5,3,5,0.6,2,5,0.4,1,1,1,2,4,6,1,2,1,0,0,13,14
Jaylen Brown,20-123,F,2/24/17,BOS,TOR,1,28,5,8,0.625,3,4,0.75,2,4,0.5,1,1,1,0,0,0,2,1,1,1,3,13,10.3
Marcus Smart,22-336,G,2/5/17,BOS,LAC,0,30,5,9,0.556,2,4,0.5,3,5,0.6,0,0,,2,1,3,3,0,0,1,2,13,10.7
Jordan Clarkson,24-161,G,11/15/16,LAL,BRK,0,28,4,12,0.333,3,7,0.429,1,5,0.2,4,6,0.667,2,1,3,3,5,0,2,4,13,10.6
Cody Zeller,24-110,F-C,1/23/17,CHO,WAS,1,35,4,7,0.571,4,7,0.571,0,0,,5,5,1,4,5,9,2,3,2,2,6,13,15.4
Meyers Leonard,25-042,C-F,4/10/17,POR,SAS,1,34,5,7,0.714,2,4,0.5,3,3,1,0,0,,0,6,6,0,1,0,0,4,13,11.3
Marcus Morris,27-150,F,1/30/17,DET,BOS,1,35,6,16,0.375,5,9,0.556,1,7,0.143,0,0,,1,4,5,0,0,0,1,3,13,3.9
Channing Frye,33-258,C-F,1/30/17,CLE,DAL,0,19,4,8,0.5,1,2,0.5,3,6,0.5,2,2,1,2,5,7,0,0,2,2,1,13,10.9
Derrick Rose,28-115,G,1/27/17,NYK,CHO,1,22,5,10,0.5,5,10,0.5,0,0,,3,3,1,1,1,2,4,2,0,2,2,13,11
Dirk Nowitzki,38-200,F,1/5/17,DAL,PHO,1,28,5,14,0.357,2,7,0.286,3,7,0.429,0,0,,1,6,7,3,0,1,1,5,13,7.5
Doug McDermott,24-351,F,12/19/16,CHI,DET,0,25,6,12,0.5,5,9,0.556,1,3,0.333,0,0,,0,3,3,2,0,0,0,1,13,8.9
Ryan Anderson,28-201,F,11/23/16,HOU,TOR,1,29,5,13,0.385,2,5,0.4,3,8,0.375,0,0,,2,1,3,2,1,0,3,3,13,5.8
Zach Randolph,35-163,F,12/26/16,MEM,ORL,0,23,6,15,0.4,5,12,0.417,1,3,0.333,0,0,,1,4,5,3,1,1,0,1,13,10.2
Dirk Nowitzki,38-264,F,3/10/17,DAL,BRK,1,23,5,12,0.417,2,4,0.5,3,8,0.375,0,0,,0,3,3,0,1,0,0,3,13,7.3
Jeff Teague,28-239,G,2/4/17,IND,DET,1,31,5,13,0.385,5,10,0.5,0,3,0,3,4,0.75,0,2,2,7,2,1,0,0,13,13.7
Sean Kilpatrick,26-299,G,10/31/16,BRK,CHI,0,25,3,13,0.231,3,7,0.429,0,6,0,7,7,1,0,2,2,0,1,0,1,1,13,5.3
JaVale McGee,29-020,C,2/8/17,GSW,CHI,1,16,6,10,0.6,6,10,0.6,0,0,,1,1,1,3,4,7,0,0,2,0,3,13,11.9
D.J. Augustin,28-354,G,10/29/16,ORL,CLE,0,21,5,12,0.417,3,6,0.5,2,6,0.333,1,1,1,0,2,2,3,1,0,1,2,13,8.5
Rudy Gobert,24-265,C,3/18/17,UTA,CHI,1,35,5,11,0.455,5,11,0.455,0,0,,3,6,0.5,6,7,13,2,0,5,2,6,13,12.9
Dwight Howard,31-114,C,4/1/17,ATL,CHI,1,37,6,12,0.5,6,12,0.5,0,0,,1,2,0.5,5,7,12,3,0,1,2,1,13,12.6
Nick Young,31-218,G-F,1/5/17,LAL,POR,1,35,5,15,0.333,2,6,0.333,3,9,0.333,0,0,,1,1,2,1,0,0,0,4,13,4.6
Tim Frazier,26-003,G,11/4/16,NOP,PHO,1,25,6,8,0.75,5,7,0.714,1,1,1,0,0,,0,0,0,3,1,0,2,2,13,10.1
Jae Crowder,26-167,F,12/20/16,BOS,MEM,1,40,3,8,0.375,2,4,0.5,1,4,0.25,6,6,1,0,7,7,2,0,0,2,2,13,9.3
Andre Drummond,23-103,C,11/21/16,DET,HOU,1,34,6,18,0.333,6,18,0.333,0,0,,1,6,0.167,6,10,16,1,4,0,3,2,13,8.9
DeMarre Carroll,30-154,F,12/28/16,TOR,GSW,1,28,5,12,0.417,2,7,0.286,3,5,0.6,0,0,,3,4,7,1,3,2,1,1,13,13.6
Brandon Ingram,19-186,F,3/7/17,LAL,DAL,1,35,5,9,0.556,4,6,0.667,1,3,0.333,2,4,0.5,2,2,4,5,0,0,3,3,13,9.2
James Ennis,26-218,F,2/4/17,MEM,MIN,1,35,4,5,0.8,1,2,0.5,3,3,1,2,2,1,3,3,6,1,2,0,1,3,13,14.6
Aaron Gordon,21-130,F,1/24/17,ORL,CHI,1,36,5,12,0.417,4,9,0.444,1,3,0.333,2,3,0.667,4,2,6,2,0,0,1,3,13,8.8
Marco Belinelli,30-337,G-F,2/25/17,CHO,SAC,0,29,4,7,0.571,2,3,0.667,2,4,0.5,3,3,1,0,2,2,6,1,0,1,0,13,14.5
Jahlil Okafor,21-014,C-F,12/29/16,PHI,UTA,1,24,6,15,0.4,6,15,0.4,0,0,,1,1,1,2,2,4,2,0,0,0,2,13,7.5
Gordon Hayward,26-236,F-G,11/14/16,UTA,MEM,1,36,4,14,0.286,3,7,0.429,1,7,0.143,4,4,1,0,4,4,3,0,0,2,2,13,5.3
Terrence Ross,25-313,F-G,12/14/16,TOR,PHI,0,19,3,8,0.375,2,3,0.667,1,5,0.2,6,6,1,0,2,2,0,1,0,0,1,13,9.8
Jeff Green,30-200,F,3/16/17,ORL,GSW,0,18,6,9,0.667,5,7,0.714,1,2,0.5,0,0,,2,2,4,1,1,0,1,4,13,10.2
DeAndre Jordan,28-150,C,12/18/16,LAC,WAS,1,36,5,6,0.833,5,6,0.833,0,0,,3,6,0.5,4,13,17,2,0,1,3,2,13,14.6
Isaiah Whitehead,21-279,G,12/12/16,BRK,HOU,1,24,6,8,0.75,6,7,0.857,0,1,0,1,2,0.5,0,2,2,5,0,0,3,3,13,9.3
Troy Daniels,25-182,G,1/13/17,MEM,HOU,0,22,3,6,0.5,0,0,,3,6,0.5,4,4,1,0,3,3,1,0,0,2,3,13,8.4
Trevor Booker,29-042,F,1/6/17,BRK,CLE,1,32,6,9,0.667,6,9,0.667,0,0,,1,1,1,1,11,12,4,0,0,3,5,13,10.9
Lucas Nogueira,24-180,C,1/22/17,TOR,PHO,1,35,5,5,1,4,4,1,1,1,1,2,2,1,0,5,5,1,1,2,1,5,13,13.1
Ersan Ilyasova,29-183,F,11/14/16,PHI,HOU,0,22,5,11,0.455,4,9,0.444,1,2,0.5,2,2,1,0,6,6,0,0,0,0,1,13,8.7
Ty Lawson,29-024,G,11/27/16,SAC,BRK,0,22,5,10,0.5,4,8,0.5,1,2,0.5,2,2,1,1,3,4,4,1,0,2,1,13,11
Andre Roberson,25-102,G-F,3/16/17,OKC,TOR,1,31,6,8,0.75,5,6,0.833,1,2,0.5,0,0,,1,3,4,3,2,0,0,3,13,14.3
Jameer Nelson,34-333,G,1/7/17,DEN,OKC,0,22,5,10,0.5,3,7,0.429,2,3,0.667,1,3,0.333,1,0,1,8,0,0,2,2,13,10.7
Luol Deng,31-211,F,11/13/16,LAL,MIN,1,24,2,5,0.4,0,2,0,2,3,0.667,7,7,1,1,2,3,0,0,0,1,0,13,10.6
Ryan Anderson,28-322,F,3/24/17,HOU,NOP,1,30,5,12,0.417,2,4,0.5,3,8,0.375,0,0,,4,2,6,0,0,0,2,3,13,6.8
Isaiah Whitehead,21-328,G,1/30/17,BRK,MIA,0,24,6,12,0.5,5,9,0.556,1,3,0.333,0,0,,2,2,4,5,0,1,0,3,13,12
DeAndre Jordan,28-160,C,12/28/16,LAC,NOP,1,39,5,6,0.833,5,6,0.833,0,0,,3,8,0.375,5,20,25,1,0,2,4,4,13,14.8
Ryan Anderson,28-195,F,11/17/16,HOU,POR,1,33,4,8,0.5,1,3,0.333,3,5,0.6,2,3,0.667,2,3,5,1,0,1,0,0,13,12.3
Rudy Gobert,24-286,C,4/8/17,UTA,POR,1,31,5,6,0.833,5,6,0.833,0,0,,3,3,1,2,9,11,1,0,4,1,3,13,16.2
Spencer Dinwiddie,23-325,G,2/25/17,BRK,GSW,0,29,4,6,0.667,2,3,0.667,2,3,0.667,3,5,0.6,0,5,5,5,0,0,0,5,13,12.6
Zaza Pachulia,32-329,C,1/4/17,GSW,POR,1,19,5,7,0.714,5,7,0.714,0,0,,3,3,1,1,2,3,1,1,3,1,1,13,13.8
Tyler Zeller,26-283,F-C,10/26/16,BOS,BRK,0,16,6,7,0.857,6,7,0.857,0,0,,1,2,0.5,2,2,4,3,0,2,1,2,13,13.8
Tony Snell,25-021,G-F,12/1/16,MIL,BRK,1,28,3,7,0.429,0,1,0,3,6,0.5,4,4,1,2,3,5,1,0,0,0,2,13,11.5
Wesley Matthews,30-168,G,3/31/17,DAL,MEM,1,35,5,10,0.5,2,4,0.5,3,6,0.5,0,0,,0,3,3,7,0,1,2,1,13,12.1
Dennis Schroder,23-125,G,1/18/17,ATL,DET,1,27,5,11,0.455,5,9,0.556,0,2,0,3,3,1,0,0,0,6,0,0,2,3,13,8.3
Darren Collison,29-143,G,1/13/17,SAC,CLE,1,22,5,10,0.5,3,6,0.5,2,4,0.5,1,1,1,0,1,1,4,0,0,1,2,13,9.3
Doug McDermott,24-312,F,11/10/16,CHI,MIA,0,32,5,11,0.455,3,6,0.5,2,5,0.4,1,1,1,0,4,4,1,1,0,1,2,13,8.4
Maurice Harkless,23-325,F-G,4/1/17,POR,PHO,1,26,5,8,0.625,5,7,0.714,0,1,0,3,3,1,2,2,4,2,0,1,2,4,13,9.9
Denzel Valentine,23-116,G,3/12/17,CHI,BOS,0,23,5,8,0.625,2,2,1,3,6,0.5,0,0,,0,3,3,0,0,0,3,1,13,6.9
Jeremy Lamb,24-222,G-F,1/7/17,CHO,SAS,1,29,4,12,0.333,4,9,0.444,0,3,0,5,6,0.833,0,8,8,3,0,1,1,1,13,9.6
Carmelo Anthony,32-196,F,12/11/16,NYK,LAL,1,38,4,16,0.25,4,12,0.333,0,4,0,5,6,0.833,0,7,7,7,2,0,4,2,13,7.2
Timofey Mozgov,30-140,C,12/3/16,LAL,MEM,1,27,4,6,0.667,4,6,0.667,0,0,,5,7,0.714,3,2,5,2,0,0,2,3,13,10.5
Danilo Gallinari,28-242,F,4/7/17,DEN,NOP,1,33,4,11,0.364,2,5,0.4,2,6,0.333,3,4,0.75,0,4,4,2,0,0,1,1,13,7.7
Frank Kaminsky,23-263,F-C,12/23/16,CHO,CHI,0,24,5,14,0.357,4,10,0.4,1,4,0.25,2,2,1,1,4,5,1,0,1,0,1,13,8.1
Andre Drummond,23-203,C,3/1/17,DET,NOP,1,29,6,13,0.462,6,13,0.462,0,0,,1,10,0.1,10,7,17,0,1,1,1,4,13,10.9
Zach Randolph,35-172,F,1/4/17,MEM,LAC,0,19,6,12,0.5,6,12,0.5,0,0,,1,2,0.5,0,3,3,0,0,0,2,1,13,5.1
Julius Randle,22-087,F,2/24/17,LAL,OKC,1,29,6,12,0.5,6,11,0.545,0,1,0,1,2,0.5,3,8,11,3,1,0,1,5,13,11.2
Justin Holiday,27-293,G,1/23/17,NYK,IND,0,32,4,9,0.444,1,2,0.5,3,7,0.429,2,2,1,1,2,3,0,3,2,0,1,13,13.6
Tyler Ulis,21-069,G,3/15/17,PHO,SAC,1,39,6,18,0.333,5,13,0.385,1,5,0.2,0,0,,0,1,1,13,2,1,1,2,13,13.1
Eric Gordon,28-039,G,2/2/17,HOU,ATL,0,30,4,14,0.286,2,4,0.5,2,10,0.2,3,4,0.75,0,2,2,3,1,1,1,3,13,6.6
Pau Gasol,36-155,F-C,12/8/16,SAS,CHI,1,31,6,11,0.545,5,8,0.625,1,3,0.333,0,0,,2,8,10,3,0,1,1,0,13,13.3
Rudy Gay,30-114,F,12/9/16,SAC,NYK,1,35,4,15,0.267,4,10,0.4,0,5,0,5,6,0.833,0,5,5,1,1,0,0,5,13,4.9
Andrew Wiggins,21-274,F-G,11/23/16,MIN,NOP,1,31,2,19,0.105,2,16,0.125,0,3,0,9,10,0.9,0,0,0,0,1,0,2,1,13,-1.3
Nicolas Batum,27-364,F-G,12/12/16,CHO,IND,1,35,4,13,0.308,0,6,0,4,7,0.571,1,2,0.5,1,9,10,3,0,0,4,4,13,5
Rudy Gay,30-107,F,12/2/16,SAC,BOS,1,35,6,14,0.429,5,7,0.714,1,7,0.143,0,0,,0,8,8,3,1,0,6,3,13,3.9
Michael Beasley,27-313,F,11/17/16,MIL,MIA,0,16,5,11,0.455,5,11,0.455,0,0,,3,5,0.6,4,6,10,0,0,0,2,2,13,8.3
Nik Stauskas,23-125,G,2/9/17,PHI,ORL,0,28,4,8,0.5,2,5,0.4,2,3,0.667,3,3,1,1,4,5,5,0,0,5,1,13,9
Courtney Lee,31-037,G,11/9/16,NYK,BRK,1,31,5,10,0.5,5,7,0.714,0,3,0,3,4,0.75,0,3,3,1,0,0,0,0,13,9.2
Dion Waiters,24-323,G,10/28/16,MIA,CHO,1,34,5,16,0.313,2,9,0.222,3,7,0.429,0,2,0,1,6,7,3,1,0,3,4,13,4
Tony Parker,34-310,G,3/23/17,SAS,MEM,1,30,5,12,0.417,4,9,0.444,1,3,0.333,2,4,0.5,0,2,2,7,0,0,0,2,13,10.5
Bradley Beal,23-121,G,10/27/16,WAS,ATL,1,24,6,12,0.5,6,10,0.6,0,2,0,1,1,1,0,0,0,4,0,0,3,4,13,5.2
George Hill,30-343,G,4/12/17,UTA,SAS,1,22,4,7,0.571,3,5,0.6,1,2,0.5,4,5,0.8,1,1,2,5,1,0,0,1,13,14.4
Denzel Valentine,23-136,G,4/1/17,CHI,ATL,0,28,5,11,0.455,2,3,0.667,3,8,0.375,0,0,,0,2,2,1,0,1,1,2,13,7.5
Mike Muscala,25-280,F-C,4/7/17,ATL,CLE,0,23,6,8,0.75,5,7,0.714,1,1,1,0,0,,2,4,6,5,1,0,0,0,13,16.9
Jrue Holiday,26-287,G,3/26/17,NOP,DEN,1,27,5,12,0.417,2,6,0.333,3,6,0.5,0,0,,0,7,7,7,1,0,0,0,13,14.6
Mason Plumlee,26-296,C-F,12/26/16,POR,TOR,1,30,5,10,0.5,5,10,0.5,0,0,,3,4,0.75,4,11,15,4,0,0,1,4,13,13.9
Draymond Green,26-327,F,1/25/17,GSW,CHO,1,36,4,7,0.571,2,4,0.5,2,3,0.667,3,6,0.5,0,4,4,6,2,3,0,4,13,16.4
Enes Kanter,24-182,C,11/18/16,OKC,BRK,0,13,3,4,0.75,2,3,0.667,1,1,1,6,6,1,0,3,3,0,0,1,3,2,13,9.2
Robin Lopez,28-228,C,11/15/16,CHI,POR,1,29,6,15,0.4,6,14,0.429,0,1,0,1,1,1,3,8,11,1,0,1,0,2,13,10
Montrezl Harrell,22-357,F-C,1/17/17,HOU,MIA,0,16,5,6,0.833,5,6,0.833,0,0,,3,5,0.6,1,0,1,0,0,0,0,4,13,9.1
Markieff Morris,27-123,F,1/3/17,WAS,DAL,1,26,5,10,0.5,4,8,0.5,1,2,0.5,2,3,0.667,1,4,5,0,0,0,0,3,13,8.3
Maurice Ndour,24-290,F,4/4/17,NYK,CHI,1,33,5,10,0.5,5,9,0.556,0,1,0,3,5,0.6,4,8,12,1,2,1,1,2,13,14
Ramon Sessions,30-249,G,12/16/16,CHO,BOS,1,32,5,16,0.313,4,13,0.308,1,3,0.333,2,2,1,2,4,6,6,0,0,1,3,13,8.4
Bismack Biyombo,24-083,C-F,11/19/16,ORL,DAL,0,23,4,6,0.667,4,6,0.667,0,0,,5,7,0.714,3,7,10,2,0,3,0,4,13,15.7
Al Horford,30-241,C-F,1/30/17,BOS,DET,1,35,6,10,0.6,5,7,0.714,1,3,0.333,0,0,,1,5,6,6,0,2,3,0,13,13.2
Marquese Chriss,19-194,F,1/12/17,PHO,DAL,1,23,4,6,0.667,1,2,0.5,3,4,0.75,2,2,1,0,3,3,0,0,0,1,3,13,9.1
Gordon Hayward,26-358,F-G,3/16/17,UTA,CLE,1,35,4,14,0.286,3,10,0.3,1,4,0.25,4,4,1,1,4,5,4,1,0,3,1,13,7.1
Ersan Ilyasova,29-321,F,4/1/17,ATL,CHI,1,34,6,15,0.4,5,12,0.417,1,3,0.333,0,0,,2,2,4,4,0,0,1,3,13,7.5
Jameer Nelson,34-265,G,10/31/16,DEN,TOR,0,22,5,9,0.556,2,5,0.4,3,4,0.75,0,0,,1,1,2,1,1,0,0,4,13,9.8
Markieff Morris,27-201,F,3/22/17,WAS,ATL,1,33,6,12,0.5,6,10,0.6,0,2,0,1,1,1,1,6,7,2,1,1,1,3,13,10.4
Joe Johnson,35-279,G-F,4/4/17,UTA,POR,0,25,4,11,0.364,0,5,0,4,6,0.667,1,1,1,0,2,2,2,1,0,1,2,13,8.1
Larry Nance Jr.,24-101,F,4/12/17,LAL,GSW,1,30,6,14,0.429,5,11,0.455,1,3,0.333,0,0,,5,6,11,2,3,1,0,3,13,14.8
Yogi Ferrell,23-189,G,11/14/16,BRK,LAC,0,26,5,11,0.455,3,6,0.5,2,5,0.4,1,4,0.25,0,1,1,5,0,0,3,0,13,6.9
Luc Mbah a Moute,30-057,F,11/5/16,LAC,SAS,1,24,5,9,0.556,3,5,0.6,2,4,0.5,1,1,1,0,1,1,1,1,0,1,2,13,8.9
Marquese Chriss,19-179,F,12/28/16,PHO,SAS,1,21,5,9,0.556,4,6,0.667,1,3,0.333,2,6,0.333,2,0,2,1,1,0,3,2,13,6.4
Rodney Hood,24-022,G-F,11/11/16,UTA,ORL,1,33,5,15,0.333,4,8,0.5,1,7,0.143,2,2,1,1,3,4,2,0,1,2,2,13,5.4
Kyle Korver,35-326,G-F,2/6/17,CLE,WAS,0,30,4,9,0.444,0,1,0,4,8,0.5,1,1,1,1,2,3,2,0,0,4,4,13,5.4
Alex Len,23-137,C,10/31/16,PHO,LAC,0,25,4,13,0.308,4,13,0.308,0,0,,5,8,0.625,2,4,6,1,1,0,2,5,13,4.6
Julius Randle,22-098,F,3/7/17,LAL,DAL,1,35,3,8,0.375,3,8,0.375,0,0,,7,8,0.875,4,14,18,10,1,0,3,4,13,18.6
James Johnson,29-269,F,11/15/16,MIA,ATL,0,26,5,8,0.625,2,3,0.667,3,5,0.6,0,0,,2,2,4,0,1,1,4,5,13,7.1
Gordon Hayward,26-268,F-G,12/16/16,UTA,DAL,1,35,4,11,0.364,1,5,0.2,3,6,0.5,2,3,0.667,0,9,9,4,0,0,7,3,13,3.8
Devin Booker,20-019,G,11/18/16,PHO,IND,1,23,4,11,0.364,3,6,0.5,1,5,0.2,4,4,1,0,1,1,3,1,0,1,3,13,8.1
Lou Williams,30-026,G,11/22/16,LAL,OKC,0,23,4,12,0.333,2,6,0.333,2,6,0.333,3,3,1,0,1,1,5,0,0,0,1,13,9.6
Rudy Gobert,24-124,C,10/28/16,UTA,LAL,1,32,4,9,0.444,4,9,0.444,0,0,,5,8,0.625,6,7,13,1,0,4,1,2,13,15.1
Tim Frazier,26-042,G,12/13/16,NOP,GSW,0,30,5,9,0.556,2,5,0.4,3,4,0.75,0,0,,0,2,2,8,1,0,2,2,13,13.1
Jeremy Lamb,24-305,G-F,3/31/17,CHO,DEN,0,15,6,8,0.75,5,6,0.833,1,2,0.5,0,0,,0,5,5,0,1,0,0,1,13,11.9
Jonas Valanciunas,24-341,C,4/12/17,TOR,CLE,1,15,6,10,0.6,5,9,0.556,1,1,1,0,0,,3,4,7,1,1,0,1,1,13,12
Tim Hardaway,24-245,G,11/16/16,ATL,MIL,0,21,4,7,0.571,3,3,1,1,4,0.25,4,6,0.667,0,1,1,3,0,0,0,0,13,11.3
Danilo Gallinari,28-104,F,11/20/16,DEN,UTA,1,36,4,14,0.286,3,8,0.375,1,6,0.167,4,6,0.667,0,5,5,8,0,0,2,2,13,8.3
Richard Jefferson,36-126,F,10/25/16,CLE,NYK,0,26,5,7,0.714,3,4,0.75,2,3,0.667,1,2,0.5,0,4,4,1,2,0,2,1,13,11.2
Stephen Curry,28-338,G,2/15/17,GSW,SAC,1,30,4,14,0.286,2,6,0.333,2,8,0.25,3,4,0.75,0,6,6,9,0,2,3,2,13,10.1
Andre Drummond,23-161,C,1/18/17,DET,ATL,1,23,6,15,0.4,6,15,0.4,0,0,,1,6,0.167,8,9,17,2,1,0,1,2,13,11.8
Nerlens Noel,22-271,C-F,1/6/17,PHI,BOS,0,25,6,8,0.75,6,8,0.75,0,0,,1,2,0.5,2,6,8,2,2,3,0,5,13,16.1
Mario Hezonja,22-038,F-G,4/4/17,ORL,CLE,0,22,3,8,0.375,2,5,0.4,1,3,0.333,6,6,1,0,2,2,1,1,1,2,1,13,9.2
Juan Hernangomez,21-166,F,3/13/17,DEN,LAL,0,19,3,5,0.6,0,0,,3,5,0.6,4,4,1,0,6,6,1,0,0,1,0,13,12.2
Zach LaVine,21-260,G,11/25/16,MIN,PHO,1,36,6,13,0.462,6,10,0.6,0,3,0,1,1,1,1,2,3,0,1,0,2,5,13,4.6
Amir Johnson,29-280,F,2/5/17,BOS,LAC,1,28,6,9,0.667,5,6,0.833,1,3,0.333,0,0,,2,4,6,1,0,0,0,3,13,11.2
Wayne Ellington,29-067,G,1/4/17,MIA,SAC,0,24,4,8,0.5,0,3,0,4,5,0.8,1,1,1,0,0,0,0,1,1,0,0,13,10.7
P.J. Tucker,31-275,F,2/4/17,PHO,MIL,0,37,5,7,0.714,3,4,0.75,2,3,0.667,1,1,1,1,3,4,1,7,0,1,5,13,16.4
Kawhi Leonard,25-186,F,1/1/17,SAS,ATL,1,28,3,12,0.25,2,6,0.333,1,6,0.167,6,7,0.857,2,2,4,2,1,1,1,3,13,8.3
Bojan Bogdanovic,27-204,G-F,11/8/16,BRK,MIN,1,27,3,9,0.333,0,1,0,3,8,0.375,4,4,1,0,1,1,2,1,0,0,0,13,10.6
Jamal Murray,20-025,G,3/20/17,DEN,HOU,0,23,5,8,0.625,4,5,0.8,1,3,0.333,2,2,1,0,4,4,0,0,0,3,3,13,6.4
Seth Curry,26-115,G,12/16/16,DAL,UTA,0,28,5,11,0.455,2,6,0.333,3,5,0.6,0,1,0,0,5,5,4,0,0,0,1,13,10.8
Hassan Whiteside,27-296,C,4/5/17,MIA,CHO,1,31,5,9,0.556,5,9,0.556,0,0,,3,3,1,4,16,20,0,1,3,1,3,13,17.2
Will Barton,26-054,G,3/1/17,DEN,MIL,0,20,5,11,0.455,5,8,0.625,0,3,0,3,3,1,4,0,4,2,0,0,0,2,13,10.7
Damian Lillard,26-215,G,2/15/17,POR,UTA,1,35,3,19,0.158,2,15,0.133,1,4,0.25,6,8,0.75,2,4,6,7,0,0,1,1,13,6.2
Nikola Jokic,21-282,C-F,11/27/16,DEN,PHO,0,31,3,8,0.375,2,6,0.333,1,2,0.5,6,6,1,3,8,11,3,0,1,1,2,13,14.1
Draymond Green,27-004,F,3/8/17,GSW,BOS,1,34,6,15,0.4,5,9,0.556,1,6,0.167,0,0,,0,8,8,2,3,3,3,4,13,9.2
Marvin Williams,30-249,F,2/23/17,CHO,DET,1,40,4,8,0.5,4,6,0.667,0,2,0,5,5,1,0,7,7,2,0,2,1,1,13,12.5
Mirza Teletovic,31-088,F,12/15/16,MIL,CHI,0,19,5,10,0.5,2,5,0.4,3,5,0.6,0,0,,0,0,0,2,0,0,1,3,13,7.2
Malcolm Brogdon,24-085,G,3/6/17,MIL,PHI,1,21,6,7,0.857,5,6,0.833,1,1,1,0,0,,1,4,5,1,1,1,2,0,13,12.8
Trevor Ariza,31-253,F,3/10/17,HOU,CHI,1,30,3,6,0.5,1,2,0.5,2,4,0.5,5,6,0.833,1,10,11,1,2,0,1,3,13,13.8
Malcolm Brogdon,23-362,G,12/7/16,MIL,POR,0,24,4,6,0.667,1,3,0.333,3,3,1,2,2,1,0,1,1,3,2,1,1,4,13,12.9
D'Angelo Russell,21-043,G,4/7/17,LAL,SAC,1,33,4,10,0.4,2,5,0.4,2,5,0.4,3,3,1,0,5,5,5,1,0,4,1,13,9.2
Derrick Favors,25-114,F-C,11/6/16,UTA,NYK,1,27,6,10,0.6,6,10,0.6,0,0,,1,3,0.333,3,3,6,0,0,0,2,5,13,6.6
Dwight Howard,31-102,C,3/20/17,ATL,CHO,1,33,6,9,0.667,6,9,0.667,0,0,,1,2,0.5,3,7,10,3,1,1,2,4,13,13.1
Amir Johnson,29-306,F,3/3/17,BOS,LAL,1,25,5,7,0.714,3,3,1,2,4,0.5,1,1,1,0,6,6,4,2,1,2,4,13,13.8
Devin Harris,33-348,G,2/9/17,DAL,UTA,0,29,5,11,0.455,5,9,0.556,0,2,0,3,4,0.75,1,3,4,2,2,0,0,5,13,9.9
Mike Conley,29-149,G,3/9/17,MEM,LAC,1,36,3,14,0.214,3,10,0.3,0,4,0,7,7,1,0,3,3,4,1,0,2,2,13,6.3
Marvin Williams,30-153,F,11/19/16,CHO,NOP,1,30,3,14,0.214,2,8,0.25,1,6,0.167,6,6,1,1,1,2,0,0,0,1,4,13,2.8
Kay Felder,21-277,G,12/31/16,CLE,CHO,0,19,5,6,0.833,3,4,0.75,2,2,1,1,2,0.5,0,0,0,2,2,1,0,2,13,13.7
Jon Leuer,27-226,F,12/26/16,DET,CLE,1,28,5,11,0.455,3,8,0.375,2,3,0.667,1,1,1,1,4,5,1,2,0,0,3,13,10.7
Patrick Patterson,27-240,F,11/9/16,TOR,OKC,0,33,5,11,0.455,2,3,0.667,3,8,0.375,0,0,,0,3,3,3,2,0,0,3,13,11.1
Tony Allen,34-359,G-F,1/4/17,MEM,LAC,1,30,5,9,0.556,5,8,0.625,0,1,0,3,3,1,2,4,6,2,0,1,1,4,13,10.8
Jabari Parker,21-229,F,10/30/16,MIL,DET,1,29,6,16,0.375,6,15,0.4,0,1,0,1,2,0.5,3,3,6,1,0,0,0,1,13,7.1
Marcus Smart,23-035,G,4/10/17,BOS,BRK,0,31,3,9,0.333,1,3,0.333,2,6,0.333,5,5,1,0,2,2,6,1,1,1,2,13,12.6
Tony Snell,25-057,G-F,1/6/17,MIL,NYK,1,38,5,6,0.833,2,2,1,3,4,0.75,0,0,,0,3,3,0,2,2,1,0,13,14.1
Jusuf Nurkic,22-176,C,2/15/17,POR,UTA,0,21,5,5,1,5,5,1,0,0,,3,4,0.75,1,7,8,1,3,1,4,3,13,13.1
Darrell Arthur,29-018,F,4/12/17,DEN,OKC,0,23,2,7,0.286,1,3,0.333,1,4,0.25,8,9,0.889,0,2,2,0,4,1,1,2,13,12
JaVale McGee,29-071,C,3/31/17,GSW,HOU,0,11,6,10,0.6,6,10,0.6,0,0,,1,3,0.333,3,1,4,0,0,5,0,2,13,12.7
Nik Stauskas,23-019,G,10/26/16,PHI,OKC,0,23,5,6,0.833,5,5,1,0,1,0,3,3,1,0,4,4,1,0,0,0,0,13,12.7
Chris Paul,31-226,G,12/18/16,LAC,WAS,1,37,6,15,0.4,5,10,0.5,1,5,0.2,0,1,0,1,3,4,12,2,0,3,4,13,11.9
Gorgui Dieng,27-019,C,2/6/17,MIN,MIA,1,25,6,8,0.75,6,8,0.75,0,0,,1,1,1,0,7,7,0,1,0,0,1,13,12.5
Michael Kidd-Gilchrist,23-196,F,4/10/17,CHO,MIL,1,32,6,11,0.545,6,11,0.545,0,0,,1,2,0.5,1,4,5,2,1,1,0,1,13,11.9
Clint Capela,22-205,F-C,12/9/16,HOU,OKC,1,17,5,10,0.5,5,10,0.5,0,0,,3,5,0.6,3,3,6,0,0,0,2,2,13,7.4
J.J. Barea,32-278,G,3/31/17,DAL,MEM,0,23,4,14,0.286,0,3,0,4,11,0.364,1,2,0.5,1,0,1,5,0,0,0,2,13,7.8
Lou Williams,30-057,G,12/23/16,LAL,ORL,0,21,3,11,0.273,2,8,0.25,1,3,0.333,6,7,0.857,0,2,2,1,2,0,0,0,13,9.4
Rudy Gobert,24-247,C,2/28/17,UTA,OKC,1,32,6,9,0.667,6,9,0.667,0,0,,1,1,1,1,9,10,0,0,3,1,3,13,12.4
Troy Daniels,25-224,G,2/24/17,MEM,IND,0,15,4,10,0.4,0,3,0,4,7,0.571,1,2,0.5,0,0,0,2,3,0,1,0,13,10.6
Cody Zeller,24-079,F-C,12/23/16,CHO,CHI,1,32,5,9,0.556,5,9,0.556,0,0,,3,4,0.75,5,2,7,4,1,2,1,1,13,16.2
Alec Burks,25-203,G,2/8/17,UTA,NOP,0,23,4,8,0.5,3,5,0.6,1,3,0.333,4,4,1,0,5,5,0,2,0,0,2,13,11.7
Kris Humphries,31-280,F-C,11/12/16,ATL,PHI,0,18,5,7,0.714,4,5,0.8,1,2,0.5,2,2,1,4,5,9,2,0,1,0,3,13,15.3
Randy Foye,33-113,G,1/15/17,BRK,HOU,0,17,4,6,0.667,1,2,0.5,3,4,0.75,2,2,1,0,0,0,3,0,0,2,4,13,8.9
Glenn Robinson,23-048,G-F,2/25/17,IND,MIA,0,24,5,8,0.625,3,6,0.5,2,2,1,1,2,0.5,0,5,5,0,0,0,0,2,13,9.7
Aaron Gordon,21-048,F,11/3/16,ORL,SAC,1,31,5,10,0.5,4,7,0.571,1,3,0.333,2,3,0.667,3,7,10,3,1,1,1,3,13,13.4
Taj Gibson,31-141,F,11/12/16,CHI,WAS,1,29,6,10,0.6,6,10,0.6,0,0,,1,3,0.333,2,3,5,1,1,1,1,2,13,10.5
Doug McDermott,24-363,F,12/31/16,CHI,MIL,0,29,5,10,0.5,2,4,0.5,3,6,0.5,0,0,,1,0,1,3,1,0,0,2,13,11
Danilo Gallinari,28-131,F,12/17/16,DEN,NYK,1,28,4,9,0.444,2,2,1,2,7,0.286,3,4,0.75,0,2,2,3,0,0,0,5,13,8.6
Paul Zipser,22-338,G-F,1/21/17,CHI,SAC,0,23,4,8,0.5,1,2,0.5,3,6,0.5,2,2,1,2,2,4,0,0,0,2,2,13,8.2
Troy Williams,21-349,F,12/13/16,MEM,CLE,1,36,6,16,0.375,5,12,0.417,1,4,0.25,0,0,,2,4,6,1,0,0,3,5,13,2.5
Andrew Harrison,22-022,G,11/19/16,MEM,MIN,0,24,3,6,0.5,3,3,1,0,3,0,7,7,1,1,3,4,7,1,0,1,3,13,15.3
Nik Stauskas,23-041,G,11/17/16,PHI,MIN,0,24,4,8,0.5,1,2,0.5,3,6,0.5,2,2,1,1,4,5,1,2,0,1,1,13,12.2
Shelvin Mack,26-355,G,4/12/17,UTA,SAS,0,26,4,7,0.571,2,4,0.5,2,3,0.667,3,4,0.75,2,1,3,3,1,1,1,1,13,13.4
Omri Casspi,28-173,F,12/12/16,SAC,LAL,0,30,6,10,0.6,5,9,0.556,1,1,1,0,3,0,1,5,6,3,1,0,1,2,13,10.7
Patty Mills,28-216,G,3/15/17,SAS,POR,1,37,5,10,0.5,2,2,1,3,8,0.375,0,0,,1,2,3,6,0,0,1,2,13,11.7
Wesley Matthews,30-063,G,12/16/16,DAL,UTA,1,33,4,11,0.364,1,4,0.25,3,7,0.429,2,2,1,0,3,3,1,3,0,3,3,13,7.3
Tony Snell,25-134,G-F,3/24/17,MIL,ATL,1,32,5,9,0.556,2,3,0.667,3,6,0.5,0,0,,0,0,0,2,2,0,0,1,13,11.7
Harrison Barnes,24-249,F,2/3/17,DAL,POR,1,38,6,14,0.429,5,11,0.455,1,3,0.333,0,0,,0,7,7,2,1,0,0,1,13,9.7
Rodney McGruder,25-185,G,1/30/17,MIA,BRK,1,32,5,9,0.556,2,3,0.667,3,6,0.5,0,0,,0,1,1,0,2,1,0,2,13,10.9
Nene Hilario,34-147,F-C,2/7/17,HOU,ORL,0,18,6,8,0.75,6,8,0.75,0,0,,1,1,1,0,3,3,0,1,0,1,2,13,9.9
DeAndre Jordan,28-240,C,3/18/17,LAC,CLE,1,27,4,5,0.8,4,5,0.8,0,0,,5,11,0.455,5,12,17,2,1,0,0,0,13,18.2
Jamal Murray,20-015,G,3/10/17,DEN,BOS,0,17,6,11,0.545,5,7,0.714,1,4,0.25,0,0,,0,3,3,0,0,0,2,0,13,6.6
Caris LeVert,22-188,G-F,3/1/17,BRK,SAC,1,25,6,9,0.667,5,8,0.625,1,1,1,0,0,,3,4,7,2,3,0,2,1,13,14.4
Wilson Chandler,29-277,F,2/11/17,DEN,CLE,1,34,6,15,0.4,6,9,0.667,0,6,0,1,1,1,3,3,6,1,0,0,3,3,13,4.4
Alex Len,23-240,C,2/11/17,PHO,HOU,1,20,5,9,0.556,5,9,0.556,0,0,,3,5,0.6,4,5,9,2,0,1,4,6,13,7.9
Shabazz Muhammad,23-362,F-G,11/9/16,MIN,ORL,0,19,4,6,0.667,3,5,0.6,1,1,1,4,7,0.571,0,1,1,0,1,0,1,3,13,8.3
Mike Muscala,25-175,F-C,12/23/16,ATL,DEN,0,21,5,7,0.714,4,4,1,1,3,0.333,2,3,0.667,0,3,3,2,0,1,0,5,13,10.7
Alec Burks,25-188,G,1/24/17,UTA,DEN,0,22,5,9,0.556,5,8,0.625,0,1,0,3,4,0.75,0,2,2,0,2,1,1,2,13,9.8
Brook Lopez,29-007,C,4/8/17,BRK,CHI,1,31,6,14,0.429,5,11,0.455,1,3,0.333,0,0,,3,2,5,1,0,1,2,1,13,7.3
Derrick Williams,25-293,F,3/14/17,CLE,DET,0,21,4,8,0.5,1,3,0.333,3,5,0.6,2,4,0.5,0,0,0,1,0,0,0,2,13,8.1
Joffrey Lauvergne,25-121,C-F,1/29/17,OKC,CLE,0,21,6,10,0.6,6,10,0.6,0,0,,1,2,0.5,0,6,6,1,0,0,3,0,13,7.5
Jimmy Butler,27-085,G-F,12/8/16,CHI,SAS,1,38,4,14,0.286,3,11,0.273,1,3,0.333,4,5,0.8,2,7,9,4,2,1,3,2,13,9.6
Julius Randle,21-355,F,11/18/16,LAL,SAS,1,30,6,13,0.462,6,12,0.5,0,1,0,1,2,0.5,1,8,9,7,0,0,2,2,13,11.1
Austin Rivers,24-139,G,12/18/16,LAC,WAS,0,25,6,9,0.667,5,6,0.833,1,3,0.333,0,0,,0,0,0,2,2,0,1,6,13,9.1
Greg Monroe,26-297,C-F,3/28/17,MIL,CHO,0,25,6,7,0.857,6,7,0.857,0,0,,1,1,1,1,7,8,6,0,0,4,2,13,12.7
Joffrey Lauvergne,25-108,C-F,1/16/17,OKC,LAC,0,30,5,14,0.357,4,10,0.4,1,4,0.25,2,3,0.667,3,6,9,1,1,0,0,0,13,10.4
Greg Monroe,26-268,C-F,2/27/17,MIL,CLE,0,19,5,7,0.714,5,7,0.714,0,0,,3,4,0.75,2,1,3,4,0,0,1,2,13,12.4
Joe Johnson,35-283,G-F,4/8/17,UTA,POR,0,24,5,12,0.417,2,6,0.333,3,6,0.5,0,0,,0,1,1,0,0,1,0,1,13,7.2
Marcus Morris,27-200,F,3/21/17,DET,BRK,1,38,5,14,0.357,4,9,0.444,1,5,0.2,2,4,0.5,0,4,4,2,0,1,1,3,13,5.5
Tony Snell,24-357,G-F,11/1/16,MIL,NOP,1,33,5,12,0.417,2,3,0.667,3,9,0.333,0,0,,1,9,10,2,0,0,1,2,13,9.6
Ben McLemore,23-261,G,10/29/16,SAC,MIN,0,18,5,10,0.5,3,6,0.5,2,4,0.5,1,1,1,0,0,0,0,0,0,1,1,13,6.6
Seth Curry,26-176,G,2/15/17,DAL,DET,1,31,5,9,0.556,2,2,1,3,7,0.429,0,0,,0,2,2,3,2,0,0,3,13,12.2
LaMarcus Aldridge,31-202,F-C,2/6/17,SAS,MEM,1,34,4,19,0.211,4,18,0.222,0,1,0,5,7,0.714,5,5,10,1,0,2,3,5,13,2.6
Patrick McCaw,21-169,G,4/12/17,GSW,LAL,0,28,5,12,0.417,4,7,0.571,1,5,0.2,2,2,1,2,2,4,1,0,1,1,1,13,8.6
Harrison Barnes,24-230,F,1/15/17,DAL,MIN,1,32,6,16,0.375,6,12,0.5,0,4,0,1,2,0.5,0,3,3,0,1,1,1,2,13,4.6
Khris Middleton,25-222,F-G,3/22/17,MIL,SAC,1,31,5,11,0.455,2,5,0.4,3,6,0.5,0,0,,0,2,2,4,2,1,2,0,13,11.4
Patty Mills,28-149,G,1/7/17,SAS,CHO,0,19,6,14,0.429,5,9,0.556,1,5,0.2,0,0,,0,2,2,1,2,0,1,1,13,7.5
Robin Lopez,28-345,C,3/12/17,CHI,BOS,1,25,5,6,0.833,5,6,0.833,0,0,,3,3,1,2,1,3,3,1,2,2,0,13,15
Justin Hamilton,27-000,C,4/1/17,BRK,ORL,0,19,5,9,0.556,4,6,0.667,1,3,0.333,2,2,1,1,4,5,0,0,0,2,1,13,8.2
Bobby Portis,21-335,F,1/10/17,CHI,WAS,0,18,5,8,0.625,2,4,0.5,3,4,0.75,0,0,,2,5,7,0,1,0,1,2,13,11.5
Gerald Henderson,29-011,G,12/20/16,PHI,NOP,1,27,3,9,0.333,0,4,0,3,5,0.6,4,4,1,0,3,3,1,0,1,2,2,13,7.4
Garrett Temple,30-336,G,4/9/17,SAC,HOU,1,36,5,12,0.417,2,4,0.5,3,8,0.375,0,0,,0,5,5,1,4,0,0,2,13,12
Shaun Livingston,31-127,G,1/16/17,GSW,CLE,0,15,6,7,0.857,6,7,0.857,0,0,,1,1,1,0,2,2,1,0,0,1,4,13,9.2
Ben McLemore,24-059,G,4/11/17,SAC,PHO,0,27,3,7,0.429,3,5,0.6,0,2,0,7,9,0.778,0,10,10,1,1,0,1,3,13,11
Paul George,26-289,F,2/15/17,IND,CLE,1,36,4,19,0.211,1,13,0.077,3,6,0.5,2,2,1,2,5,7,3,0,0,1,0,13,5.3
Elfrid Payton,22-300,G,12/18/16,ORL,TOR,0,25,6,10,0.6,6,8,0.75,0,2,0,1,1,1,0,2,2,3,0,0,1,0,13,10.1
Richaun Holmes,23-164,F-C,3/28/17,PHI,BRK,1,25,4,12,0.333,4,9,0.444,0,3,0,5,6,0.833,1,4,5,2,0,0,1,3,13,6.9
Zach Randolph,35-105,F,10/29/16,MEM,NYK,0,21,5,14,0.357,4,13,0.308,1,1,1,2,2,1,2,7,9,2,0,0,1,3,13,7.9
Nikola Mirotic,25-353,F,1/29/17,CHI,PHI,0,26,6,10,0.6,5,7,0.714,1,3,0.333,0,0,,1,2,3,2,1,0,1,1,13,10.7
Willie Cauley-Stein,23-181,F-C,2/15/17,SAC,GSW,0,24,6,16,0.375,6,16,0.375,0,0,,1,1,1,3,4,7,1,1,1,4,2,13,5.1
Bojan Bogdanovic,27-223,G-F,11/27/16,BRK,SAC,1,28,4,9,0.444,2,4,0.5,2,5,0.4,3,4,0.75,0,1,1,2,0,0,1,2,13,7.8
Myles Turner,20-303,F-C,1/21/17,IND,UTA,1,33,5,9,0.556,4,7,0.571,1,2,0.5,2,2,1,1,6,7,2,1,0,2,3,13,10.4
Joe Johnson,35-244,G-F,2/28/17,UTA,OKC,0,23,6,10,0.6,5,9,0.556,1,1,1,0,0,,3,1,4,1,1,0,1,3,13,10.3
Stanley Johnson,20-313,F,4/7/17,DET,HOU,0,32,4,9,0.444,1,4,0.25,3,5,0.6,2,2,1,1,3,4,4,0,0,1,3,13,10.5
David Lee,33-273,F,1/27/17,SAS,NOP,1,29,5,7,0.714,5,7,0.714,0,0,,3,4,0.75,5,5,10,0,1,1,1,2,13,14.6
Malcolm Delaney,27-257,G,11/23/16,ATL,IND,0,22,3,6,0.5,2,4,0.5,1,2,0.5,6,6,1,0,1,1,1,1,1,1,4,13,10.1
LaMarcus Aldridge,31-179,F-C,1/14/17,SAS,PHO,1,34,6,14,0.429,5,13,0.385,1,1,1,0,0,,2,2,4,2,0,0,0,1,13,8.6
Kelly Olynyk,25-292,C-F,2/5/17,BOS,LAC,0,22,5,10,0.5,4,6,0.667,1,4,0.25,2,2,1,2,2,4,2,1,0,2,4,13,8.8
JaMychal Green,26-278,F,3/26/17,MEM,GSW,1,31,6,11,0.545,6,9,0.667,0,2,0,1,3,0.333,3,5,8,0,0,0,1,2,13,8.7
Nerlens Noel,22-329,C-F,3/5/17,DAL,OKC,0,16,6,7,0.857,6,7,0.857,0,0,,1,1,1,2,2,4,0,0,0,2,5,13,8.5
James Harden,27-181,G,2/23/17,HOU,NOP,1,30,3,9,0.333,2,3,0.667,1,6,0.167,6,6,1,0,4,4,14,3,0,4,1,13,17.5
Derrick Favors,25-213,F-C,2/13/17,UTA,LAC,1,24,5,11,0.455,5,11,0.455,0,0,,3,6,0.5,1,2,3,1,2,2,0,2,13,10.7
Julius Randle,22-100,F,3/9/17,LAL,PHO,1,32,5,11,0.455,3,8,0.375,2,3,0.667,1,2,0.5,4,4,8,4,1,1,2,3,13,12.2
Mason Plumlee,26-337,C-F,2/5/17,POR,OKC,1,29,4,10,0.4,4,10,0.4,0,0,,5,7,0.714,3,1,4,3,0,1,3,6,13,6.6
Malcolm Brogdon,24-033,G,1/13/17,MIL,MIA,1,30,3,6,0.5,2,4,0.5,1,2,0.5,6,6,1,3,3,6,5,2,0,1,4,13,15.9
Rondae Hollis-Jefferson,21-320,F,11/18/16,BRK,OKC,1,28,3,14,0.214,2,12,0.167,1,2,0.5,6,7,0.857,0,5,5,2,2,0,2,3,13,5.7
Julius Randle,22-134,F,4/12/17,LAL,GSW,1,24,6,10,0.6,6,10,0.6,0,0,,1,1,1,1,7,8,3,0,0,1,1,13,11.9
Klay Thompson,27-022,G,3/2/17,GSW,CHI,1,37,5,22,0.227,4,11,0.364,1,11,0.091,2,2,1,0,1,1,1,0,0,2,1,13,-1.8
Marvin Williams,30-267,F,3/13/17,CHO,CHI,1,38,5,12,0.417,4,7,0.571,1,5,0.2,2,2,1,5,13,18,5,0,1,0,3,13,17
Dwyane Wade,34-298,G,11/10/16,CHI,MIA,1,32,5,17,0.294,5,13,0.385,0,4,0,3,3,1,1,6,7,4,1,0,3,1,13,6
Bismack Biyombo,24-085,C-F,11/21/16,ORL,MIL,0,22,6,8,0.75,6,8,0.75,0,0,,1,2,0.5,3,7,10,1,0,1,2,2,13,12.2
Alex Abrines,23-214,G-F,3/3/17,OKC,PHO,1,33,5,11,0.455,2,3,0.667,3,8,0.375,0,0,,0,1,1,0,1,0,1,4,13,6
Malcolm Brogdon,24-055,G,2/4/17,MIL,PHO,0,26,5,8,0.625,4,7,0.571,1,1,1,2,3,0.667,2,3,5,8,3,1,1,1,13,19.2
Willie Cauley-Stein,23-205,F-C,3/11/17,SAC,DEN,1,35,3,11,0.273,3,11,0.273,0,0,,7,8,0.875,0,5,5,5,0,0,3,0,13,8.1
Kris Humphries,31-339,F-C,1/10/17,ATL,BRK,0,16,5,8,0.625,5,7,0.714,0,1,0,3,4,0.75,2,6,8,2,1,1,0,3,13,14.1
Willie Cauley-Stein,23-236,F-C,4/11/17,SAC,PHO,1,21,6,12,0.5,6,12,0.5,0,0,,1,2,0.5,0,5,5,2,2,0,1,2,13,9.7
Al Jefferson,31-331,C-F,11/30/16,IND,POR,0,21,5,8,0.625,5,8,0.625,0,0,,3,4,0.75,0,1,1,1,0,0,0,1,13,9.6
Nikola Jokic,21-300,C-F,12/15/16,DEN,POR,1,19,5,6,0.833,4,5,0.8,1,1,1,2,3,0.667,0,4,4,5,0,0,1,5,13,12.1
Jerami Grant,23-031,F,4/12/17,OKC,DEN,0,17,5,6,0.833,4,5,0.8,1,1,1,2,2,1,0,4,4,1,1,0,0,1,13,13.3
Rondae Hollis-Jefferson,22-036,F,2/8/17,BRK,WAS,1,31,5,7,0.714,5,6,0.833,0,1,0,3,4,0.75,3,8,11,2,1,0,2,2,13,13.8
Jae Crowder,26-261,F,3/24/17,BOS,PHO,1,27,4,8,0.5,2,3,0.667,2,5,0.4,3,3,1,0,10,10,3,0,0,2,3,13,10.9
Rudy Gobert,24-138,C,11/11/16,UTA,ORL,1,34,6,9,0.667,6,9,0.667,0,0,,1,2,0.5,6,7,13,1,1,3,1,1,13,17.4
Shawn Long,24-052,C-F,3/22/17,PHI,OKC,0,15,4,7,0.571,4,6,0.667,0,1,0,5,6,0.833,2,4,6,0,0,0,0,5,13,9.9
Tyler Ulis,21-037,G,2/11/17,PHO,HOU,0,28,5,13,0.385,4,9,0.444,1,4,0.25,2,2,1,1,0,1,6,1,0,1,1,13,10.4
Markieff Morris,27-190,F,3/11/17,WAS,POR,1,43,6,12,0.5,6,12,0.5,0,0,,1,1,1,3,8,11,3,2,2,0,3,13,15.8
Zach Randolph,35-176,F,1/8/17,MEM,UTA,0,27,6,16,0.375,6,14,0.429,0,2,0,1,1,1,2,9,11,1,3,1,2,1,13,10.3
Tarik Black,25-072,C-F,2/2/17,LAL,WAS,1,26,5,6,0.833,5,6,0.833,0,0,,3,5,0.6,2,9,11,1,1,0,3,4,13,11.2
Nicolas Batum,27-345,F-G,11/23/16,CHO,SAS,1,40,5,9,0.556,3,6,0.5,2,3,0.667,1,1,1,1,6,7,5,0,0,5,1,13,9.3
T.J. McConnell,24-308,G,1/27/17,PHI,HOU,1,28,4,5,0.8,4,5,0.8,0,0,,5,7,0.714,0,1,1,8,2,1,3,5,13,13.9
Sergio Rodriguez,30-278,G,3/17/17,PHI,DAL,0,26,5,5,1,3,3,1,2,2,1,1,2,0.5,1,3,4,6,0,0,0,4,13,15.3
Jabari Parker,21-225,F,10/26/16,MIL,CHO,1,30,4,9,0.444,3,8,0.375,1,1,1,4,4,1,2,4,6,3,0,0,3,3,13,8.8
Mario Hezonja,21-246,F-G,10/28/16,ORL,DET,0,24,5,15,0.333,3,8,0.375,2,7,0.286,1,1,1,0,2,2,1,2,0,1,0,13,6.8
Jon Leuer,27-312,F,3/22/17,DET,CHI,0,17,5,8,0.625,4,7,0.571,1,1,1,2,3,0.667,4,2,6,1,0,0,0,0,13,13.1
Taurean Waller-Prince,23-011,F,4/2/17,ATL,BRK,1,36,5,12,0.417,4,9,0.444,1,3,0.333,2,5,0.4,1,4,5,2,2,1,0,4,13,9.8
Marcus Smart,22-324,G,1/24/17,BOS,WAS,1,33,4,13,0.308,2,7,0.286,2,6,0.333,3,4,0.75,1,4,5,1,4,0,2,3,13,8.5
Rondae Hollis-Jefferson,22-041,F,2/13/17,BRK,MEM,1,25,4,6,0.667,3,4,0.75,1,2,0.5,4,6,0.667,0,3,3,2,2,0,1,4,13,11.3
Marcin Gortat,32-315,C-F,12/28/16,WAS,IND,1,41,4,8,0.5,4,8,0.5,0,0,,5,7,0.714,4,12,16,4,1,0,2,2,13,15.6
Robert Covington,26-087,F,3/11/17,PHI,LAC,1,31,5,9,0.556,3,4,0.75,2,5,0.4,1,1,1,2,4,6,0,3,0,1,6,13,10.9
Taj Gibson,31-138,F,11/9/16,CHI,ATL,1,37,6,15,0.4,6,15,0.4,0,0,,1,1,1,3,4,7,1,1,2,0,2,13,10.5
Myles Turner,20-289,F-C,1/7/17,IND,NYK,1,32,6,13,0.462,6,12,0.5,0,1,0,1,1,1,3,7,10,2,0,0,2,4,13,8.3
Clint Capela,22-206,F-C,12/10/16,HOU,DAL,1,27,4,8,0.5,4,8,0.5,0,0,,5,7,0.714,5,5,10,3,0,0,1,4,13,12.7
Trevor Ariza,31-249,F,3/6/17,HOU,SAS,1,35,5,11,0.455,3,3,1,2,8,0.25,1,1,1,0,8,8,1,0,0,0,4,13,8.8
Nikola Vucevic,26-098,C,1/30/17,ORL,MIN,1,38,5,15,0.333,5,12,0.417,0,3,0,3,6,0.5,2,9,11,5,0,1,2,4,13,8
Allen Crabbe,24-247,G-F,12/12/16,POR,LAC,0,21,5,9,0.556,4,7,0.571,1,2,0.5,2,2,1,0,2,2,0,1,0,2,0,13,8.3
Chasson Randle,24-046,G,3/23/17,NYK,POR,0,19,4,7,0.571,2,3,0.667,2,4,0.5,3,3,1,1,1,2,2,0,0,0,0,13,12.1
Ersan Ilyasova,29-262,F,2/1/17,PHI,DAL,1,31,4,9,0.444,3,5,0.6,1,4,0.25,4,4,1,1,9,10,1,0,0,1,2,13,10.6
Timothe Luwawu-Cabarrot,21-314,F,3/19/17,PHI,BOS,1,29,4,12,0.333,1,4,0.25,3,8,0.375,2,2,1,1,1,2,1,0,0,2,2,13,5.1
Evan Fournier,24-011,G-F,11/9/16,ORL,MIN,1,28,4,11,0.364,2,5,0.4,2,6,0.333,3,3,1,0,3,3,2,0,0,2,2,13,6.4
Jameer Nelson,34-298,G,12/3/16,DEN,UTA,0,26,5,8,0.625,2,3,0.667,3,5,0.6,0,1,0,1,3,4,7,0,1,4,2,13,11.4
Thabo Sefolosha,32-238,G-F,12/26/16,ATL,MIN,1,21,5,10,0.5,2,6,0.333,3,4,0.75,0,0,,1,4,5,0,0,3,1,0,13,11
Marvin Williams,30-129,F,10/26/16,CHO,MIL,1,29,5,12,0.417,2,8,0.25,3,4,0.75,0,0,,2,8,10,2,0,1,1,4,13,9.9
Ersan Ilyasova,29-196,F,11/27/16,PHI,CLE,1,28,5,10,0.5,3,5,0.6,2,5,0.4,1,1,1,2,4,6,1,0,0,3,3,13,7.1
Andre Drummond,23-178,C,2/4/17,DET,IND,1,31,5,8,0.625,5,8,0.625,0,0,,3,5,0.6,2,7,9,1,1,1,6,2,13,7.7
Jrue Holiday,26-237,G,2/4/17,NOP,WAS,1,36,5,17,0.294,5,14,0.357,0,3,0,3,4,0.75,2,8,10,8,0,0,6,4,13,4.5
E'Twaun Moore,27-346,G,2/8/17,NOP,UTA,0,19,6,11,0.545,5,7,0.714,1,4,0.25,0,0,,0,0,0,2,0,0,4,1,13,4.7
Goran Dragic,30-324,G,3/26/17,MIA,BOS,1,34,6,14,0.429,5,9,0.556,1,5,0.2,0,0,,1,0,1,4,2,0,5,5,13,4.1
Mindaugas Kuzminskas,27-080,F,1/7/17,NYK,IND,0,15,5,8,0.625,4,4,1,1,4,0.25,2,2,1,1,2,3,2,0,0,1,3,13,9.9
Darren Collison,29-103,G,12/4/16,SAC,NYK,1,39,4,10,0.4,3,7,0.429,1,3,0.333,4,4,1,1,2,3,6,2,0,2,3,13,11.9
Ricky Rubio,26-063,G,12/23/16,MIN,SAC,1,34,4,10,0.4,1,4,0.25,3,6,0.5,2,2,1,2,4,6,8,3,0,3,4,13,14.2
Patrick Beverley,28-192,G,1/20/17,HOU,GSW,1,24,5,10,0.5,2,6,0.333,3,4,0.75,0,2,0,1,2,3,2,1,0,0,3,13,9.7
Malcolm Delaney,27-316,G,1/21/17,ATL,PHI,0,19,6,9,0.667,5,6,0.833,1,3,0.333,0,1,0,0,0,0,1,1,0,1,3,13,8.2
Patrick Beverley,28-243,G,3/12/17,HOU,CLE,1,34,4,10,0.4,1,4,0.25,3,6,0.5,2,4,0.5,2,1,3,4,2,0,0,2,13,12.5
Jeremy Lin,28-212,G,3/23/17,BRK,PHO,1,21,3,7,0.429,2,4,0.5,1,3,0.333,6,7,0.857,1,2,3,5,0,0,2,2,13,10.9
Spencer Dinwiddie,23-292,G,1/23/17,BRK,SAS,1,32,6,9,0.667,5,7,0.714,1,2,0.5,0,0,,0,2,2,2,0,2,1,0,13,11.5
Richaun Holmes,23-041,F-C,11/25/16,PHI,CHI,0,21,4,8,0.5,3,6,0.5,1,2,0.5,4,4,1,3,2,5,0,1,3,2,1,13,12.4
Carmelo Anthony,32-198,F,12/13/16,NYK,PHO,1,39,3,15,0.2,3,13,0.231,0,2,0,7,8,0.875,0,6,6,5,0,0,0,2,13,7.8
Blake Griffin,27-260,F,12/1/16,LAC,CLE,1,31,4,14,0.286,4,13,0.308,0,1,0,5,8,0.625,2,3,5,11,1,0,3,0,13,11.6
Jamal Murray,19-331,G,1/19/17,DEN,SAS,0,26,4,15,0.267,2,7,0.286,2,8,0.25,3,3,1,1,5,6,2,0,0,0,2,13,6.9
Wesley Matthews,30-036,G,11/19/16,DAL,ORL,1,36,4,11,0.364,1,5,0.2,3,6,0.5,2,2,1,0,4,4,2,0,0,2,0,13,7.5
Trevor Ariza,31-274,F,3/31/17,HOU,GSW,1,37,4,12,0.333,2,3,0.667,2,9,0.222,3,4,0.75,0,2,2,1,2,0,2,1,13,6.7
Trevor Ariza,31-271,F,3/28/17,HOU,GSW,1,41,4,10,0.4,3,4,0.75,1,6,0.167,4,4,1,0,4,4,3,6,0,0,2,13,16.1
Marvin Williams,30-176,F,12/12/16,CHO,IND,1,28,4,7,0.571,2,3,0.667,2,4,0.5,3,4,0.75,0,2,2,2,2,0,0,1,13,12.9
Jusuf Nurkic,22-107,C,12/8/16,DEN,WAS,1,21,6,6,1,6,6,1,0,0,,1,2,0.5,1,6,7,1,0,0,4,4,13,8.4
Nicolas Batum,28-017,F-G,12/31/16,CHO,CLE,1,35,5,11,0.455,4,9,0.444,1,2,0.5,2,2,1,0,6,6,8,0,2,2,0,13,14.1
Domantas Sabonis,20-184,F,11/3/16,OKC,GSW,1,27,6,12,0.5,5,11,0.455,1,1,1,0,0,,1,5,6,3,1,1,2,2,13,10.2
Patrick Beverley,28-164,G,12/23/16,HOU,MEM,1,33,4,11,0.364,1,2,0.5,3,9,0.333,2,2,1,2,4,6,1,2,0,0,3,13,11
Mason Plumlee,27-030,C-F,4/4/17,DEN,NOP,0,27,6,12,0.5,6,12,0.5,0,0,,1,1,1,5,6,11,3,0,1,1,3,13,12.9
Ben McLemore,24-059,G,4/11/17,SAC,PHO,0,27,3,7,0.429,3,5,0.6,0,2,0,7,9,0.778,0,10,10,1,1,0,1,3,13,11
Terrence Jones,25-011,F,1/20/17,NOP,BRK,0,22,4,12,0.333,4,10,0.4,0,2,0,5,6,0.833,3,5,8,0,1,2,1,2,13,10
Justin Holiday,27-241,G,12/2/16,NYK,MIN,1,31,3,9,0.333,1,3,0.333,2,6,0.333,5,5,1,0,6,6,0,3,1,1,4,13,10.8
Nicolas Batum,28-107,F-G,3/31/17,CHO,DEN,1,34,4,13,0.308,3,8,0.375,1,5,0.2,4,5,0.8,0,5,5,9,1,1,3,3,13,10.4
Deron Williams,32-261,G,3/14/17,CLE,DET,0,14,6,6,1,5,5,1,1,1,1,0,0,,0,2,2,3,0,0,1,3,13,11.7
Dario Saric,22-222,F,11/16/16,PHI,WAS,0,26,5,13,0.385,4,7,0.571,1,6,0.167,2,3,0.667,1,11,12,1,0,0,4,2,13,5.4
Draymond Green,27-001,F,3/5/17,GSW,NYK,1,40,4,9,0.444,3,5,0.6,1,4,0.25,4,4,1,1,6,7,4,2,1,0,3,13,15.1
Aaron Gordon,21-173,F,3/8/17,ORL,CHI,1,29,4,7,0.571,4,6,0.667,0,1,0,5,6,0.833,1,3,4,0,2,0,2,2,13,10.1
Rudy Gobert,24-234,C,2/15/17,UTA,POR,1,32,4,5,0.8,4,5,0.8,0,0,,5,8,0.625,3,9,12,0,0,3,3,2,13,13
Jaylen Brown,20-125,F,2/26/17,BOS,DET,1,26,5,9,0.556,3,7,0.429,2,2,1,1,3,0.333,2,3,5,1,2,0,4,2,13,8.1
Nerlens Noel,22-276,C-F,1/11/17,PHI,NYK,0,21,5,8,0.625,5,8,0.625,0,0,,3,4,0.75,4,4,8,1,2,0,2,1,13,13.3
Steven Adams,23-221,C,2/26/17,OKC,NOP,1,29,6,10,0.6,6,10,0.6,0,0,,1,5,0.2,9,1,10,0,0,0,0,3,13,12.2
Dwight Howard,31-044,C,1/21/17,ATL,PHI,1,32,5,7,0.714,5,7,0.714,0,0,,3,7,0.429,5,10,15,3,0,1,2,4,13,14.2
Nick Young,31-149,G-F,10/28/16,LAL,UTA,1,24,3,7,0.429,2,5,0.4,1,2,0.5,6,6,1,0,0,0,0,0,1,0,5,13,8
Aaron Gordon,21-133,F,1/27/17,ORL,BOS,1,23,4,13,0.308,3,10,0.3,1,3,0.333,4,4,1,3,2,5,0,1,0,2,0,13,7.2
Courtney Lee,31-110,G,1/21/17,NYK,PHO,1,37,5,9,0.556,2,6,0.333,3,3,1,0,0,,2,2,4,3,0,1,0,3,13,12.3
Jonas Valanciunas,24-190,C,11/12/16,TOR,NYK,1,22,4,8,0.5,4,8,0.5,0,0,,5,6,0.833,2,6,8,0,1,1,3,2,13,9.7
Patty Mills,28-131,G,12/20/16,SAS,HOU,0,24,5,9,0.556,2,3,0.667,3,6,0.5,0,0,,0,0,0,1,2,0,2,1,13,9
Draymond Green,26-312,F,1/10/17,GSW,MIA,1,36,4,11,0.364,4,8,0.5,0,3,0,5,6,0.833,0,9,9,5,2,2,1,0,13,15.1
Kelly Olynyk,25-296,C-F,2/9/17,BOS,POR,0,23,5,9,0.556,3,5,0.6,2,4,0.5,1,1,1,2,5,7,1,0,0,0,5,13,10.3
Eric Gordon,28-077,G,3/12/17,HOU,CLE,0,29,4,11,0.364,2,3,0.667,2,8,0.25,3,3,1,2,1,3,3,1,1,0,0,13,12.4
E'Twaun Moore,27-254,G,11/8/16,NOP,SAC,1,33,6,10,0.6,5,8,0.625,1,2,0.5,0,0,,0,0,0,5,0,0,1,3,13,9.7
Andre Roberson,25-000,G-F,12/4/16,OKC,NOP,1,37,6,8,0.75,5,6,0.833,1,2,0.5,0,1,0,1,4,5,2,1,2,1,3,13,12.9
Derrick Williams,25-185,F,11/26/16,MIA,MEM,1,16,5,9,0.556,4,4,1,1,5,0.2,2,2,1,1,1,2,0,0,1,0,1,13,10
Al-Farouq Aminu,26-158,F,2/26/17,POR,TOR,0,29,3,6,0.5,2,3,0.667,1,3,0.333,6,6,1,3,5,8,2,0,1,2,5,13,11.7
Chris Paul,31-205,G,11/27/16,LAC,IND,1,32,3,11,0.273,3,5,0.6,0,6,0,7,7,1,0,4,4,4,2,1,4,1,13,8.8
Dario Saric,22-244,F,12/8/16,PHI,NOP,0,25,5,11,0.455,3,5,0.6,2,6,0.333,1,1,1,2,3,5,1,0,1,1,2,13,9.2
Kelly Olynyk,25-354,C-F,4/8/17,BOS,CHO,1,28,6,10,0.6,6,8,0.75,0,2,0,1,1,1,1,10,11,4,0,1,0,6,13,13.2
Otto Porter,23-240,F,1/29/17,WAS,NOP,1,34,5,10,0.5,2,5,0.4,3,5,0.6,0,0,,1,5,6,0,4,0,0,1,13,13.8
Wesley Matthews,30-100,G,1/22/17,DAL,LAL,1,14,5,9,0.556,2,4,0.5,3,5,0.6,0,0,,1,1,2,2,1,0,1,0,13,11.1
Nene Hilario,34-062,F-C,11/14/16,HOU,PHI,0,16,6,8,0.75,6,7,0.857,0,1,0,1,4,0.25,3,1,4,0,0,1,3,2,13,7.9
Marcus Smart,22-296,G,12/27/16,BOS,MEM,0,29,3,9,0.333,1,5,0.2,2,4,0.5,5,6,0.833,1,3,4,6,2,1,2,1,13,13.6
Joe Johnson,35-231,G-F,2/15/17,UTA,POR,0,23,4,7,0.571,2,3,0.667,2,4,0.5,3,4,0.75,0,2,2,0,0,0,1,1,13,8.5
Domantas Sabonis,20-206,F,11/25/16,OKC,DEN,1,28,5,7,0.714,2,4,0.5,3,3,1,0,0,,1,5,6,1,1,0,2,2,13,11.2
Carmelo Anthony,32-286,F,3/11/17,NYK,DET,1,36,4,9,0.444,1,3,0.333,3,6,0.5,2,2,1,0,1,1,4,0,0,2,1,13,9
Paul George,26-187,F,11/5/16,IND,CHI,1,29,5,10,0.5,2,5,0.4,3,5,0.6,0,0,,2,4,6,3,2,0,1,3,13,12.5
Joe Johnson,35-126,G-F,11/2/16,UTA,DAL,1,33,5,11,0.455,3,8,0.375,2,3,0.667,1,1,1,0,5,5,4,1,0,1,0,13,11.6
Jamal Crawford,36-363,G,3/18/17,LAC,CLE,0,28,4,11,0.364,1,6,0.167,3,5,0.6,2,2,1,0,2,2,3,0,0,3,1,13,6.2
Shelvin Mack,26-243,G,12/21/16,UTA,SAC,1,34,4,10,0.4,2,5,0.4,2,5,0.4,3,4,0.75,0,3,3,2,0,0,1,3,13,7.3
Michael Kidd-Gilchrist,23-042,F,11/7/16,CHO,IND,1,19,4,4,1,4,4,1,0,0,,5,5,1,0,1,1,1,1,2,0,1,13,14.8
Justise Winslow,20-223,F,11/4/16,MIA,TOR,1,39,5,18,0.278,5,16,0.313,0,2,0,3,4,0.75,1,2,3,4,2,0,1,2,13,6.3
Kevin Love,28-136,F,1/21/17,CLE,SAS,1,36,4,15,0.267,1,4,0.25,3,11,0.273,2,3,0.667,1,10,11,3,0,0,3,3,13,5.3
Evan Turner,28-034,G,11/30/16,POR,IND,0,27,5,7,0.714,4,6,0.667,1,1,1,2,2,1,0,4,4,6,3,0,1,2,13,16.7
J.J. Redick,32-129,G,10/31/16,LAC,PHO,1,26,6,13,0.462,5,10,0.5,1,3,0.333,0,0,,0,3,3,1,1,0,2,1,13,6.5
Kosta Koufos,27-256,C,11/6/16,SAC,TOR,1,25,6,8,0.75,6,8,0.75,0,0,,1,2,0.5,2,4,6,0,0,1,0,2,13,11.9
Khris Middleton,25-206,F-G,3/6/17,MIL,PHI,1,32,5,10,0.5,3,5,0.6,2,5,0.4,1,2,0.5,1,4,5,8,0,1,4,2,13,11
Frank Kaminsky,23-219,F-C,11/9/16,CHO,UTA,0,20,6,10,0.6,5,7,0.714,1,3,0.333,0,1,0,1,4,5,3,0,1,0,1,13,12.3
Willy Hernangomez,22-314,C,4/6/17,NYK,WAS,1,31,5,15,0.333,5,15,0.333,0,0,,3,3,1,5,3,8,1,0,0,2,4,13,6
Alex Abrines,23-209,G-F,2/26/17,OKC,NOP,1,35,4,12,0.333,1,5,0.2,3,7,0.429,2,2,1,1,2,3,1,0,0,0,4,13,6.6
Greg Monroe,26-242,C-F,2/1/17,MIL,UTA,0,24,6,12,0.5,6,12,0.5,0,0,,1,2,0.5,1,3,4,1,2,0,0,3,13,9.7
J.J. Barea,32-289,G,4/11/17,DAL,DEN,1,27,5,14,0.357,2,6,0.333,3,8,0.375,0,0,,0,4,4,9,2,0,3,1,13,11.3
P.J. Tucker,31-222,F,12/13/16,PHO,NYK,1,40,6,13,0.462,5,8,0.625,1,5,0.2,0,2,0,1,6,7,1,3,1,2,5,13,8.4
Jaylen Brown,20-044,F,12/7/16,BOS,ORL,0,22,5,8,0.625,4,5,0.8,1,3,0.333,2,3,0.667,1,1,2,1,0,0,3,3,13,6.5
Andre Roberson,24-343,G-F,11/11/16,OKC,LAC,1,34,5,10,0.5,2,4,0.5,3,6,0.5,0,0,,3,6,9,2,1,1,2,4,13,11.4
Spencer Dinwiddie,23-297,G,1/28/17,BRK,MIN,1,24,3,7,0.429,3,5,0.6,0,2,0,7,8,0.875,0,4,4,5,1,0,1,2,13,12.8
Nick Young,31-239,G-F,1/26/17,LAL,UTA,1,29,5,12,0.417,2,5,0.4,3,7,0.429,0,0,,0,3,3,0,1,0,1,4,13,5.9
Ricky Rubio,26-126,G,2/24/17,MIN,DAL,1,35,6,13,0.462,6,12,0.5,0,1,0,1,2,0.5,1,4,5,14,3,0,3,3,13,16.4
Marco Belinelli,30-257,G-F,12/7/16,CHO,DET,0,28,5,10,0.5,4,6,0.667,1,4,0.25,2,2,1,0,5,5,1,2,0,0,2,13,11.4
James Johnson,29-279,F,11/25/16,MIA,MEM,0,31,4,10,0.4,1,6,0.167,3,4,0.75,2,2,1,1,5,6,1,0,2,2,4,13,8.3
Nene Hilario,34-049,F-C,11/1/16,HOU,CLE,0,25,4,4,1,3,3,1,1,1,1,4,6,0.667,3,2,5,4,0,1,2,3,13,14
Hassan Whiteside,27-220,C,1/19/17,MIA,DAL,1,29,6,12,0.5,6,12,0.5,0,0,,1,1,1,1,7,8,2,1,0,3,2,13,8.4
Frank Kaminsky,24-001,F-C,4/5/17,CHO,MIA,0,22,5,9,0.556,4,6,0.667,1,3,0.333,2,3,0.667,0,1,1,1,0,0,0,1,13,8.9
Allen Crabbe,24-325,G-F,2/28/17,POR,DET,0,35,5,7,0.714,3,5,0.6,2,2,1,1,2,0.5,0,1,1,0,2,0,0,4,13,10.4
Kyle Korver,35-286,G-F,12/28/16,ATL,NYK,0,25,4,10,0.4,1,5,0.2,3,5,0.6,2,2,1,0,5,5,1,0,0,1,0,13,8.8
Dennis Schroder,23-055,G,11/9/16,ATL,CHI,1,31,5,19,0.263,4,15,0.267,1,4,0.25,2,3,0.667,2,5,7,3,0,0,4,2,13,1.5
Spencer Dinwiddie,23-261,G,12/23/16,BRK,CLE,0,21,6,7,0.857,5,6,0.833,1,1,1,0,1,0,1,2,3,3,1,0,0,2,13,13.7
Cody Zeller,24-033,F-C,11/7/16,CHO,IND,1,23,5,7,0.714,5,7,0.714,0,0,,3,3,1,0,5,5,0,0,0,0,2,13,10.8
Marc Gasol,32-053,C,3/23/17,MEM,SAS,1,39,6,15,0.4,5,13,0.385,1,2,0.5,0,0,,3,7,10,3,0,1,6,1,13,5.5
Thabo Sefolosha,32-178,G-F,10/27/16,ATL,WAS,0,22,6,8,0.75,5,7,0.714,1,1,1,0,2,0,3,4,7,5,5,0,1,2,13,19
Julius Randle,22-078,F,2/15/17,LAL,PHO,1,29,4,9,0.444,4,9,0.444,0,0,,5,5,1,3,7,10,3,1,0,0,4,13,14
Randy Foye,33-171,G,3/14/17,BRK,OKC,1,28,4,6,0.667,1,3,0.333,3,3,1,2,2,1,0,1,1,4,0,0,1,0,13,12.5
Ty Lawson,29-078,G,1/20/17,SAC,MEM,0,23,4,10,0.4,4,8,0.5,0,2,0,5,7,0.714,0,4,4,5,1,0,1,1,13,11.1
Trey Lyles,21-024,F,11/29/16,UTA,HOU,0,24,5,8,0.625,3,5,0.6,2,3,0.667,1,2,0.5,0,4,4,1,0,0,0,4,13,9.3
Serge Ibaka,27-118,F-C,1/14/17,ORL,UTA,1,33,5,10,0.5,3,3,1,2,7,0.286,1,1,1,0,5,5,2,0,0,1,3,13,8.7
Shabazz Muhammad,24-132,F-G,3/25/17,MIN,POR,0,20,4,6,0.667,4,5,0.8,0,1,0,5,7,0.714,0,2,2,0,0,0,1,0,13,9.2
Courtney Lee,31-164,G,3/16/17,NYK,BRK,1,35,5,9,0.556,5,7,0.714,0,2,0,3,3,1,0,0,0,2,0,1,1,2,13,9
Avery Bradley,25-352,G,11/12/16,BOS,IND,1,36,5,11,0.455,4,7,0.571,1,4,0.25,2,2,1,1,7,8,5,2,1,4,3,13,11.1
Rajon Rondo,30-340,G,1/27/17,CHI,MIA,0,32,6,8,0.75,5,7,0.714,1,1,1,0,0,,1,6,7,7,3,0,3,1,13,16.8
Blake Griffin,27-236,F,11/7/16,LAC,DET,1,28,5,11,0.455,5,10,0.5,0,1,0,3,4,0.75,1,9,10,9,0,0,1,2,13,14.8
Austin Rivers,24-234,G,3/23/17,LAC,DAL,0,26,5,10,0.5,3,5,0.6,2,5,0.4,1,2,0.5,0,2,2,1,0,0,1,1,13,7.5
Gorgui Dieng,27-066,C,3/25/17,MIN,POR,1,35,3,7,0.429,3,6,0.5,0,1,0,7,8,0.875,1,6,7,2,4,2,0,1,13,17.8
Darrell Arthur,28-322,F,2/10/17,DEN,NYK,1,21,5,9,0.556,2,3,0.667,3,6,0.5,0,0,,0,3,3,2,0,0,1,1,13,9.6
Michael Beasley,27-313,F,11/17/16,MIL,MIA,0,16,5,11,0.455,5,11,0.455,0,0,,3,5,0.6,4,6,10,0,0,0,2,2,13,8.3
Marcus Morris,27-143,F,1/23/17,DET,SAC,1,38,5,11,0.455,4,8,0.5,1,3,0.333,2,2,1,0,3,3,1,0,0,0,0,13,8.9
Spencer Dinwiddie,23-303,G,2/3/17,BRK,IND,0,27,4,9,0.444,1,5,0.2,3,4,0.75,2,2,1,1,3,4,1,0,1,1,1,13,9.9
Robert Covington,26-020,F,1/3/17,PHI,MIN,1,39,4,14,0.286,3,5,0.6,1,9,0.111,4,4,1,1,9,10,2,4,1,2,4,13,10.7
Joe Johnson,35-277,G-F,4/2/17,UTA,SAS,0,29,5,10,0.5,2,4,0.5,3,6,0.5,0,0,,0,3,3,3,0,0,1,1,13,9.6
Ricky Rubio,26-080,G,1/9/17,MIN,DAL,1,30,3,9,0.333,3,7,0.429,0,2,0,7,7,1,0,5,5,15,5,0,3,4,13,20.3
Josh McRoberts,29-279,F,12/3/16,MIA,POR,1,28,5,9,0.556,3,6,0.5,2,3,0.667,1,1,1,0,2,2,4,2,0,2,1,13,11.7
Justin Holiday,27-288,G,1/18/17,NYK,BOS,0,19,4,8,0.5,2,3,0.667,2,5,0.4,3,3,1,0,5,5,0,0,1,2,3,13,8
Trevor Ariza,31-190,F,1/6/17,HOU,ORL,1,29,5,10,0.5,2,2,1,3,8,0.375,0,0,,2,4,6,2,0,0,0,2,13,11.2
Draymond Green,27-035,F,4/8/17,GSW,NOP,1,21,4,8,0.5,1,2,0.5,3,6,0.5,2,2,1,2,6,8,3,0,2,1,2,13,13.9
Michael Carter-Williams,25-086,G,1/4/17,CHI,CLE,1,28,6,13,0.462,6,10,0.6,0,3,0,1,2,0.5,0,3,3,3,1,1,2,3,13,7.4
Alec Burks,25-185,G,1/21/17,UTA,IND,0,19,5,8,0.625,4,4,1,1,4,0.25,2,2,1,1,3,4,1,1,0,1,4,13,10.1
Evan Fournier,24-009,G-F,11/7/16,ORL,CHI,1,30,6,12,0.5,5,7,0.714,1,5,0.2,0,0,,1,1,2,1,1,0,3,2,13,5.9
Mike Conley,29-039,G,11/19/16,MEM,MIN,1,34,3,9,0.333,2,6,0.333,1,3,0.333,6,6,1,2,2,4,3,1,2,1,1,13,13
Vince Carter,40-001,G-F,1/27/17,MEM,POR,0,25,4,8,0.5,3,7,0.429,1,1,1,4,4,1,2,0,2,1,1,0,0,2,13,11.3
Wesley Matthews,30-012,G,10/26/16,DAL,IND,1,40,3,16,0.188,1,6,0.167,2,10,0.2,5,6,0.833,0,5,5,3,3,0,1,4,13,6.6
Derrick Rose,28-113,G,1/25/17,NYK,DAL,1,35,6,15,0.4,5,14,0.357,1,1,1,0,0,,2,1,3,3,0,0,3,2,13,4.9
Gary Harris,22-147,G,2/8/17,DEN,ATL,1,34,5,14,0.357,4,6,0.667,1,8,0.125,2,3,0.667,0,1,1,3,2,0,2,2,13,6.4
Sergio Rodriguez,30-153,G,11/12/16,PHI,ATL,1,25,5,9,0.556,2,5,0.4,3,4,0.75,0,0,,0,3,3,4,1,1,0,1,13,13.7
Jason Smith,30-315,F-C,1/11/17,WAS,BOS,0,19,5,9,0.556,5,8,0.625,0,1,0,3,4,0.75,2,3,5,1,0,0,1,1,13,9.9
Clint Capela,22-198,F-C,12/2/16,HOU,DEN,1,26,6,8,0.75,6,8,0.75,0,0,,1,1,1,2,7,9,1,0,1,2,3,13,11.5
Avery Bradley,25-361,G,11/21/16,BOS,MIN,1,33,5,12,0.417,4,9,0.444,1,3,0.333,2,2,1,0,3,3,0,0,0,1,3,13,5.3
Caris LeVert,22-199,G-F,3/12/17,BRK,NYK,1,26,4,4,1,2,2,1,2,2,1,3,4,0.75,0,4,4,4,2,0,0,2,13,16.6
Jonathan Gibson,29-027,G,12/5/16,DAL,CHO,0,18,5,9,0.556,2,5,0.4,3,4,0.75,0,1,0,0,2,2,2,0,0,1,2,13,8.5
Julius Randle,22-001,F,11/30/16,LAL,CHI,1,31,4,13,0.308,4,13,0.308,0,0,,5,8,0.625,9,11,20,2,2,0,5,4,13,10.7
Gordon Hayward,26-343,F-G,3/1/17,UTA,MIN,1,25,6,15,0.4,5,11,0.455,1,4,0.25,0,0,,0,4,4,2,2,1,0,1,13,9.8
Andre Drummond,23-128,C,12/16/16,DET,WAS,1,30,5,7,0.714,5,7,0.714,0,0,,3,6,0.5,4,8,12,1,0,0,2,2,13,12
Marc Gasol,32-073,C,4/12/17,MEM,DAL,1,24,5,13,0.385,4,11,0.364,1,2,0.5,2,2,1,0,8,8,4,0,2,2,1,13,10.1
Devin Booker,20-031,G,11/30/16,PHO,ATL,1,33,5,13,0.385,4,11,0.364,1,2,0.5,2,6,0.333,0,1,1,4,1,0,1,2,13,6.6
Jamal Crawford,37-023,G,4/12/17,LAC,SAC,0,23,4,7,0.571,3,5,0.6,1,2,0.5,4,4,1,0,0,0,3,0,0,0,0,13,11.8
Gerald Henderson,28-360,G,12/3/16,PHI,BOS,1,32,4,7,0.571,2,4,0.5,2,3,0.667,3,4,0.75,1,2,3,2,0,0,1,3,13,9.8
Marc Gasol,32-070,C,4/9/17,MEM,DET,1,24,5,9,0.556,4,7,0.571,1,2,0.5,2,2,1,0,2,2,5,2,1,3,2,13,11.7
Aron Baynes,30-100,C,3/19/17,DET,PHO,0,18,5,9,0.556,5,9,0.556,0,0,,3,3,1,5,12,17,0,0,0,0,2,13,15
Solomon Hill,25-267,F,12/10/16,NOP,LAC,1,30,5,8,0.625,3,6,0.5,2,2,1,1,1,1,0,3,3,4,0,0,0,2,13,12.3
Kosta Koufos,28-019,C,3/15/17,SAC,PHO,1,20,6,10,0.6,6,10,0.6,0,0,,1,1,1,1,5,6,2,0,2,1,1,13,12
T.J. McConnell,25-004,G,3/29/17,PHI,ATL,1,37,5,9,0.556,4,6,0.667,1,3,0.333,2,2,1,1,2,3,8,2,0,5,2,13,11.8
Brook Lopez,28-213,C,10/31/16,BRK,CHI,1,22,5,11,0.455,5,10,0.5,0,1,0,3,3,1,2,0,2,0,0,1,1,2,13,7.6
Willie Cauley-Stein,23-163,F-C,1/28/17,SAC,CHO,0,14,6,7,0.857,6,7,0.857,0,0,,1,4,0.25,1,2,3,0,0,0,1,3,13,8.4
Draymond Green,26-301,F,12/30/16,GSW,DAL,1,27,6,10,0.6,5,7,0.714,1,3,0.333,0,0,,2,6,8,7,0,0,3,3,13,12.3
Jerian Grant,24-150,G,3/8/17,CHI,ORL,1,24,5,9,0.556,2,5,0.4,3,4,0.75,0,0,,1,4,5,2,1,0,0,4,13,11.4
Boris Diaw,34-234,F-C,12/6/16,UTA,PHO,1,33,5,11,0.455,4,6,0.667,1,5,0.2,2,2,1,1,3,4,6,0,0,2,1,13,10.7
Nick Young,31-279,G-F,3/7/17,LAL,DAL,1,21,4,10,0.4,1,2,0.5,3,8,0.375,2,2,1,0,2,2,0,0,0,0,1,13,7.8
Richaun Holmes,23-140,F-C,3/4/17,PHI,DET,1,24,6,9,0.667,5,7,0.714,1,2,0.5,0,1,0,0,2,2,0,2,0,0,2,13,10.5
Eric Gordon,28-019,G,1/13/17,HOU,MEM,0,31,4,11,0.364,1,2,0.5,3,9,0.333,2,2,1,0,1,1,1,0,0,2,3,13,4.7
Jared Sullinger,24-334,F,2/1/17,TOR,BOS,0,16,5,8,0.625,4,5,0.8,1,3,0.333,2,5,0.4,2,4,6,1,0,0,0,3,13,10.3
Tobias Harris,24-215,F,2/15/17,DET,DAL,0,24,4,8,0.5,3,7,0.429,1,1,1,4,4,1,1,3,4,1,0,0,3,0,13,8.3
Lou Williams,30-036,G,12/2/16,LAL,TOR,0,25,4,14,0.286,3,8,0.375,1,6,0.167,4,5,0.8,0,1,1,4,0,0,4,3,13,2.3
Tony Snell,25-093,G-F,2/11/17,MIL,IND,1,21,4,5,0.8,0,0,,4,5,0.8,1,2,0.5,1,4,5,1,1,1,0,0,13,15
Spencer Dinwiddie,23-363,G,4/4/17,BRK,PHI,0,25,4,5,0.8,3,3,1,1,2,0.5,4,4,1,0,2,2,7,2,0,2,0,13,16.6
Derrick Williams,25-265,F,2/14/17,CLE,MIN,0,23,5,7,0.714,5,6,0.833,0,1,0,3,5,0.6,0,6,6,0,1,0,0,3,13,10.9
Tobias Harris,24-155,F,12/17/16,DET,IND,1,31,5,12,0.417,4,6,0.667,1,6,0.167,2,2,1,0,7,7,2,0,0,1,2,13,8.3
Brandan Wright,29-175,F-C,3/29/17,MEM,IND,1,28,6,10,0.6,6,10,0.6,0,0,,1,2,0.5,0,4,4,1,0,2,0,3,13,10.1
J.J. Redick,32-218,G,1/28/17,LAC,GSW,1,26,4,8,0.5,1,3,0.333,3,5,0.6,2,2,1,0,1,1,0,1,0,4,1,13,5.9
Paul Zipser,22-346,G-F,1/29/17,CHI,PHI,0,29,5,8,0.625,2,3,0.667,3,5,0.6,0,0,,0,3,3,0,0,0,0,0,13,10.3
Rodney Hood,24-072,G-F,12/31/16,UTA,PHO,1,25,5,11,0.455,2,4,0.5,3,7,0.429,0,0,,1,3,4,1,0,0,1,4,13,7
Alec Burks,25-223,G,2/28/17,UTA,OKC,0,15,5,9,0.556,4,7,0.571,1,2,0.5,2,2,1,1,1,2,1,1,0,1,2,13,9.6
Terry Rozier,22-346,G,2/26/17,BOS,DET,0,18,4,5,0.8,1,1,1,3,4,0.75,2,2,1,1,2,3,2,0,0,1,3,13,11.6
Frank Kaminsky,23-359,F-C,3/29/17,CHO,TOR,0,20,4,7,0.571,1,2,0.5,3,5,0.6,2,3,0.667,0,4,4,2,0,0,2,4,13,8.3
Markieff Morris,27-212,F,4/2/17,WAS,GSW,1,24,6,11,0.545,5,9,0.556,1,2,0.5,0,0,,2,3,5,1,1,0,2,2,13,8.9
Allen Crabbe,24-263,G-F,12/28/16,POR,SAC,1,33,4,8,0.5,1,4,0.25,3,4,0.75,2,2,1,0,2,2,2,2,1,1,2,13,11.9
Spencer Hawes,28-190,C-F,11/4/16,CHO,BRK,0,27,5,8,0.625,4,7,0.571,1,1,1,2,2,1,1,4,5,0,0,1,4,2,13,7.2
Eric Gordon,28-095,G,3/30/17,HOU,POR,1,36,5,12,0.417,2,5,0.4,3,7,0.429,0,0,,0,0,0,1,0,0,3,4,13,2.7
Rodney McGruder,25-237,G,3/23/17,MIA,TOR,1,36,5,9,0.556,3,6,0.5,2,3,0.667,1,2,0.5,2,2,4,3,0,1,1,1,13,11.7
Kyle Anderson,23-172,F-G,3/11/17,SAS,GSW,1,32,5,7,0.714,4,5,0.8,1,2,0.5,2,2,1,1,7,8,6,0,1,0,0,13,17.8
Ersan Ilyasova,29-327,F,4/7/17,ATL,CLE,1,26,6,14,0.429,5,8,0.625,1,6,0.167,0,0,,2,5,7,2,1,0,1,3,13,8.7
Victor Oladipo,24-250,G,1/9/17,OKC,CHI,1,25,6,9,0.667,5,7,0.714,1,2,0.5,0,0,,0,2,2,2,2,0,1,4,13,10.5
Jeff Green,30-169,F,2/13/17,ORL,MIA,0,20,5,11,0.455,5,9,0.556,0,2,0,3,3,1,0,2,2,0,1,0,0,4,13,7.3
Taj Gibson,31-227,F,2/6/17,CHI,SAC,1,28,6,12,0.5,6,11,0.545,0,1,0,1,2,0.5,0,4,4,1,1,0,0,6,13,7.1
Al Horford,30-194,C-F,12/14/16,BOS,SAS,1,35,4,12,0.333,3,8,0.375,1,4,0.25,4,4,1,1,4,5,4,0,0,2,2,13,8.1
Wesley Matthews,30-014,G,10/28/16,DAL,HOU,1,37,4,14,0.286,3,6,0.5,1,8,0.125,4,4,1,0,4,4,1,1,0,1,3,13,5.5
Kristaps Porzingis,21-218,F-C,3/8/17,NYK,MIL,1,37,5,15,0.333,3,10,0.3,2,5,0.4,1,2,0.5,1,7,8,2,0,3,2,2,13,7.6
C.J. Miles,29-292,G-F,2/4/17,IND,DET,1,27,5,9,0.556,3,4,0.75,2,5,0.4,1,1,1,0,3,3,1,1,0,0,3,13,10.1
Ramon Sessions,30-261,G,12/28/16,CHO,ORL,0,22,5,9,0.556,4,8,0.5,1,1,1,2,2,1,1,3,4,1,1,0,1,2,13,10.2
Matt Barnes,36-294,F,12/28/16,SAC,POR,1,29,5,11,0.455,4,7,0.571,1,4,0.25,2,2,1,1,4,5,2,1,1,3,5,13,7.3
Lance Thomas,28-322,F,3/12/17,NYK,BRK,0,32,4,7,0.571,1,3,0.333,3,4,0.75,2,3,0.667,2,3,5,4,0,1,0,1,13,14.7
Dwyane Wade,35-083,G,4/10/17,CHI,ORL,1,22,5,10,0.5,5,10,0.5,0,0,,3,4,0.75,1,5,6,2,0,2,2,1,13,10.2
Kyle O'Quinn,26-311,F-C,1/31/17,NYK,WAS,0,17,6,10,0.6,6,10,0.6,0,0,,1,1,1,6,4,10,1,0,2,1,2,13,14.1
Kyle Korver,35-347,G-F,2/27/17,CLE,MIL,0,29,5,11,0.455,2,2,1,3,9,0.333,0,0,,0,3,3,0,0,0,0,2,13,7.4
Seth Curry,26-186,G,2/25/17,DAL,NOP,1,37,4,12,0.333,1,7,0.143,3,5,0.6,2,2,1,0,7,7,8,3,0,3,2,13,13.1
Nikola Mirotic,25-312,F,12/19/16,CHI,DET,0,21,5,10,0.5,2,4,0.5,3,6,0.5,0,0,,0,4,4,2,0,2,2,3,13,8.8
Derrick Williams,25-280,F,3/1/17,CLE,BOS,0,31,5,10,0.5,3,5,0.6,2,5,0.4,1,2,0.5,0,3,3,0,1,1,2,2,13,7.4
Anthony Davis,23-256,F-C,11/22/16,NOP,ATL,1,19,6,12,0.5,6,11,0.545,0,1,0,1,1,1,2,1,3,1,1,3,2,1,13,10.1
Gordon Hayward,27-002,F-G,3/25/17,UTA,LAC,1,31,5,12,0.417,3,7,0.429,2,5,0.4,1,1,1,0,5,5,3,0,0,2,2,13,7.4
Nicolas Brussino,24-033,G-F,4/4/17,DAL,SAC,1,33,4,12,0.333,2,4,0.5,2,8,0.25,3,4,0.75,3,4,7,5,2,0,4,1,13,10.2
Shawn Long,24-036,C-F,3/6/17,PHI,MIL,0,15,5,8,0.625,4,7,0.571,1,1,1,2,7,0.286,2,5,7,1,0,1,1,1,13,10.3
Mason Plumlee,26-258,C-F,11/18/16,POR,NOP,1,34,6,10,0.6,6,10,0.6,0,0,,1,2,0.5,3,9,12,7,0,0,2,1,13,15.3
Tristan Thompson,25-335,F-C,2/11/17,CLE,DEN,1,36,5,9,0.556,5,9,0.556,0,0,,3,6,0.5,4,9,13,1,1,1,0,3,13,14.2
Alex Abrines,23-225,G-F,3/14/17,OKC,BRK,0,26,5,7,0.714,2,2,1,3,5,0.6,0,0,,0,3,3,3,2,1,0,1,13,15.4
Will Barton,26-081,G,3/28/17,DEN,POR,0,20,6,14,0.429,6,12,0.5,0,2,0,1,1,1,0,1,1,1,0,1,1,2,13,5.5
Jarell Martin,22-200,F,12/10/16,MEM,GSW,0,17,5,10,0.5,4,8,0.5,1,2,0.5,2,2,1,3,4,7,1,1,0,0,1,13,12.6
Mindaugas Kuzminskas,27-102,F,1/29/17,NYK,ATL,0,36,5,13,0.385,4,6,0.667,1,7,0.143,2,3,0.667,0,4,4,4,1,1,1,1,13,9.8
Otto Porter,23-149,F,10/30/16,WAS,MEM,1,36,6,15,0.4,6,10,0.6,0,5,0,1,1,1,3,1,4,0,1,0,0,2,13,7.5
Zach Randolph,35-260,F,4/2/17,MEM,LAL,0,30,6,16,0.375,6,15,0.4,0,1,0,1,3,0.333,2,4,6,1,1,0,3,3,13,3.5
Nicolas Batum,28-037,F-G,1/20/17,CHO,TOR,1,31,4,11,0.364,3,9,0.333,1,2,0.5,4,5,0.8,0,4,4,6,1,0,5,1,13,7.5
Aron Baynes,29-324,C,10/28/16,DET,ORL,0,18,6,8,0.75,6,8,0.75,0,0,,1,2,0.5,1,2,3,1,1,0,0,0,13,12.4
J.J. Redick,32-253,G,3/4/17,LAC,CHI,1,24,6,12,0.5,5,7,0.714,1,5,0.2,0,0,,0,1,1,0,0,0,0,2,13,6.5
Taj Gibson,31-169,F,12/10/16,CHI,MIA,1,26,6,11,0.545,6,11,0.545,0,0,,1,2,0.5,2,5,7,1,0,0,1,2,13,9.1
Victor Oladipo,24-329,G,3/29/17,OKC,ORL,1,44,5,17,0.294,4,11,0.364,1,6,0.167,2,2,1,0,5,5,1,1,1,1,4,13,4.4
Sean Kilpatrick,26-345,G,12/16/16,BRK,ORL,1,27,4,9,0.444,2,4,0.5,2,5,0.4,3,4,0.75,1,5,6,1,1,0,0,5,13,9.8
Dwyane Wade,34-337,G,12/19/16,CHI,DET,1,22,6,10,0.6,6,10,0.6,0,0,,1,1,1,1,3,4,5,1,0,1,0,13,13.5
Al Jefferson,32-031,C-F,2/4/17,IND,DET,0,14,6,9,0.667,6,9,0.667,0,0,,1,2,0.5,1,2,3,0,0,1,1,3,13,8.5
Yogi Ferrell,23-322,G,3/27/17,DAL,OKC,1,32,5,10,0.5,2,6,0.333,3,4,0.75,0,0,,1,3,4,5,3,0,3,2,13,12.3
Andrew Wiggins,21-298,F-G,12/17/16,MIN,HOU,1,44,5,17,0.294,5,15,0.333,0,2,0,3,4,0.75,2,4,6,5,3,1,1,3,13,10.3
Patty Mills,28-188,G,2/15/17,SAS,ORL,0,18,5,11,0.455,2,4,0.5,3,7,0.429,0,0,,1,1,2,6,2,0,2,2,13,11.7
Marquese Chriss,19-267,F,3/26/17,PHO,CHO,1,30,5,11,0.455,4,6,0.667,1,5,0.2,2,4,0.5,1,2,3,1,0,0,2,2,13,5.7
Marcus Thornton,29-165,G,11/17/16,WAS,NYK,0,18,5,7,0.714,2,4,0.5,3,3,1,0,0,,1,1,2,1,1,0,2,3,13,9.6
Bismack Biyombo,24-145,C-F,1/20/17,ORL,MIL,0,25,5,6,0.833,5,6,0.833,0,0,,3,5,0.6,1,12,13,0,1,4,1,4,13,15.5
C.J. Miles,29-321,G-F,3/5/17,IND,ATL,1,33,5,12,0.417,2,2,1,3,10,0.3,0,0,,1,4,5,2,0,0,1,2,13,8.1
Devin Booker,20-038,G,12/7/16,PHO,IND,1,31,4,13,0.308,2,7,0.286,2,6,0.333,3,4,0.75,1,2,3,5,1,0,4,5,13,4.9
Luol Deng,31-200,F,11/2/16,LAL,ATL,1,26,4,11,0.364,3,10,0.3,1,1,1,4,4,1,3,7,10,2,2,1,1,1,13,13.8
Derrick Jones,20-041,F,3/28/17,PHO,ATL,1,34,6,11,0.545,5,9,0.556,1,2,0.5,0,2,0,2,1,3,0,1,0,0,1,13,9.2
Rudy Gobert,24-133,C,11/6/16,UTA,NYK,1,33,5,6,0.833,5,6,0.833,0,0,,3,4,0.75,2,6,8,1,1,3,0,6,13,15
Rondae Hollis-Jefferson,21-354,F,12/22/16,BRK,GSW,0,24,6,15,0.4,5,12,0.417,1,3,0.333,0,1,0,3,3,6,1,2,1,1,2,13,9.1
Sean Kilpatrick,26-299,G,10/31/16,BRK,CHI,0,25,3,13,0.231,3,7,0.429,0,6,0,7,7,1,0,2,2,0,1,0,1,1,13,5.3
Zach LaVine,21-297,G,1/1/17,MIN,POR,1,36,5,12,0.417,3,7,0.429,2,5,0.4,1,3,0.333,1,2,3,1,1,0,2,3,13,5.6
Seth Curry,26-088,G,11/19/16,DAL,ORL,1,35,4,12,0.333,2,7,0.286,2,5,0.4,3,4,0.75,0,1,1,4,2,0,2,1,13,8.5
Gary Harris,22-059,G,11/12/16,DEN,DET,1,28,5,11,0.455,5,9,0.556,0,2,0,3,3,1,0,4,4,4,0,0,1,2,13,9.5
Stephen Curry,28-266,G,12/5/16,GSW,IND,1,29,4,10,0.4,2,3,0.667,2,7,0.286,3,4,0.75,0,4,4,11,2,1,0,4,13,17.2
Gorgui Dieng,27-001,C,1/19/17,MIN,LAC,1,26,5,8,0.625,5,8,0.625,0,0,,3,3,1,4,3,7,1,0,0,0,5,13,11.8
Boban Marjanovic,28-150,C,1/12/17,DET,GSW,0,16,5,7,0.714,5,7,0.714,0,0,,3,3,1,6,5,11,2,0,0,0,1,13,16.8
Manu Ginobili,39-124,G,11/29/16,SAS,ORL,0,23,4,9,0.444,2,4,0.5,2,5,0.4,3,4,0.75,4,2,6,3,2,0,2,3,13,12.2
Avery Bradley,26-113,G,3/19/17,BOS,PHI,1,34,6,14,0.429,6,9,0.667,0,5,0,1,1,1,1,2,3,2,2,0,4,0,13,6.3
Greg Monroe,26-245,C-F,2/4/17,MIL,PHO,0,20,5,5,1,5,5,1,0,0,,3,3,1,0,4,4,2,3,1,1,5,13,14.8
Davis Bertans,24-119,F,3/11/17,SAS,GSW,0,21,4,7,0.571,1,2,0.5,3,5,0.6,2,2,1,1,2,3,2,0,1,1,3,13,10.9
Marc Gasol,32-033,C,3/3/17,MEM,DAL,1,36,6,18,0.333,6,15,0.4,0,3,0,1,4,0.25,1,5,6,4,0,0,4,4,13,1
Ersan Ilyasova,29-309,F,3/20/17,ATL,CHO,1,28,5,11,0.455,2,2,1,3,9,0.333,0,0,,1,5,6,2,0,0,2,1,13,8.5
Kevin Love,28-142,F,1/27/17,CLE,BRK,1,28,5,13,0.385,2,7,0.286,3,6,0.5,0,0,,2,12,14,2,1,1,2,1,13,11.6
Cory Joseph,25-116,G,12/14/16,TOR,PHI,0,29,5,9,0.556,5,8,0.625,0,1,0,3,4,0.75,1,4,5,7,1,0,1,1,13,14.7
Trey Lyles,21-020,F,11/25/16,UTA,ATL,0,27,6,14,0.429,5,8,0.625,1,6,0.167,0,0,,4,6,10,2,0,0,5,0,13,6.6
Wayne Selden,22-189,G-F,4/7/17,MEM,NYK,0,32,5,7,0.714,5,7,0.714,0,0,,3,4,0.75,1,1,2,2,0,0,3,3,13,7.9
Eric Bledsoe,27-057,G,2/4/17,PHO,MIL,1,35,3,11,0.273,2,8,0.25,1,3,0.333,6,6,1,1,3,4,6,1,0,6,0,13,7.3
Ron Baker,23-260,G,12/15/16,NYK,GSW,0,23,6,7,0.857,5,5,1,1,2,0.5,0,0,,0,2,2,3,0,0,2,1,13,10.8
Jrue Holiday,26-209,G,1/7/17,NOP,BOS,1,29,5,10,0.5,4,6,0.667,1,4,0.25,2,2,1,0,1,1,4,2,1,3,3,13,9.6
Rondae Hollis-Jefferson,21-310,F,11/8/16,BRK,MIN,1,27,3,4,0.75,2,3,0.667,1,1,1,6,6,1,0,4,4,2,0,0,2,3,13,10.8
Jordan Crawford,28-142,G,3/14/17,NOP,POR,0,23,5,11,0.455,3,6,0.5,2,5,0.4,1,2,0.5,0,0,0,1,0,0,0,0,13,7.6
Brandon Jennings,27-077,G,12/9/16,NYK,SAC,1,39,5,10,0.5,5,6,0.833,0,4,0,3,4,0.75,0,5,5,7,0,0,4,1,13,9.6
K.J. McDaniels,23-270,G-F,11/5/16,HOU,ATL,0,19,5,6,0.833,4,4,1,1,2,0.5,2,2,1,0,2,2,0,0,1,1,2,13,10.3
Dirk Nowitzki,38-217,F,1/22/17,DAL,LAL,1,20,5,11,0.455,4,8,0.5,1,3,0.333,2,2,1,1,4,5,1,1,1,1,2,13,9.8
DeMarre Carroll,30-203,F,2/15/17,TOR,CHO,1,39,4,13,0.308,1,5,0.2,3,8,0.375,2,2,1,3,8,11,4,1,0,1,2,13,12
Draymond Green,26-279,F,12/8/16,GSW,UTA,1,35,4,9,0.444,0,3,0,4,6,0.667,1,4,0.25,2,8,10,8,4,0,1,2,13,18.7
Nikola Jokic,21-353,C-F,2/6/17,DEN,DAL,1,24,5,9,0.556,5,8,0.625,0,1,0,3,3,1,1,3,4,9,1,0,2,5,13,13.6
Georgios Papagiannis,19-282,C,4/11/17,SAC,PHO,0,27,5,9,0.556,5,9,0.556,0,0,,3,4,0.75,2,5,7,1,0,1,4,2,13,7.8
Courtney Lee,31-159,G,3/11/17,NYK,DET,1,35,5,9,0.556,3,5,0.6,2,4,0.5,1,2,0.5,1,6,7,5,1,0,2,2,13,12.5
Joe Ingles,29-086,F-G,12/27/16,UTA,LAL,0,24,5,8,0.625,2,2,1,3,6,0.5,0,0,,0,2,2,2,1,0,0,3,13,11.2
Frank Kaminsky,23-233,F-C,11/23/16,CHO,SAS,0,30,5,12,0.417,4,9,0.444,1,3,0.333,2,4,0.5,3,5,8,5,0,0,3,1,13,9.5
Justin Anderson,23-018,G,12/7/16,DAL,SAC,0,16,3,8,0.375,3,6,0.5,0,2,0,7,8,0.875,2,1,3,0,1,0,2,0,13,8.9
Gorgui Dieng,27-045,C,3/4/17,MIN,SAS,1,37,5,11,0.455,5,11,0.455,0,0,,3,4,0.75,5,6,11,4,1,1,3,2,13,12.9
Eric Gordon,28-002,G,12/27/16,HOU,DAL,0,27,4,9,0.444,2,4,0.5,2,5,0.4,3,3,1,1,4,5,3,0,1,1,2,13,11.2
Gary Harris,22-193,G,3/26/17,DEN,NOP,1,23,5,12,0.417,4,8,0.5,1,4,0.25,2,2,1,0,0,0,1,0,0,1,0,13,6.3
Trey Lyles,21-063,F,1/7/17,UTA,MIN,0,20,4,6,0.667,2,2,1,2,4,0.5,3,6,0.5,0,3,3,1,0,0,1,1,13,9.4
Kyrie Irving,24-275,G,12/23/16,CLE,BRK,1,26,5,11,0.455,4,8,0.5,1,3,0.333,2,2,1,1,4,5,10,6,0,1,1,13,20.8
Chris Paul,31-318,G,3/20/17,LAC,NYK,1,28,5,11,0.455,3,6,0.5,2,5,0.4,1,1,1,0,5,5,13,1,0,0,2,13,18.1
Sean Kilpatrick,27-088,G,4/4/17,BRK,PHI,0,12,4,5,0.8,1,1,1,3,4,0.75,2,2,1,0,3,3,3,1,0,1,0,13,14.1
Goran Dragic,30-321,G,3/23/17,MIA,TOR,1,33,5,18,0.278,4,15,0.267,1,3,0.333,2,2,1,2,5,7,7,4,0,3,0,13,11.2
Steven Adams,23-254,C,3/31/17,OKC,SAS,1,35,5,8,0.625,5,8,0.625,0,0,,3,4,0.75,4,4,8,1,1,0,2,5,13,10.7
Nicolas Batum,27-341,F-G,11/19/16,CHO,NOP,1,35,3,10,0.3,1,4,0.25,2,6,0.333,5,5,1,1,6,7,4,0,2,1,0,13,12.9
Joffrey Lauvergne,25-049,C-F,11/18/16,OKC,BRK,0,14,6,9,0.667,5,5,1,1,4,0.25,0,0,,0,4,4,1,0,0,0,3,13,9.8
Andrew Wiggins,21-279,F-G,11/28/16,MIN,UTA,1,34,6,16,0.375,5,14,0.357,1,2,0.5,0,0,,0,2,2,4,0,0,2,6,13,3.2
Marcus Morris,27-080,F,11/21/16,DET,HOU,1,35,5,15,0.333,4,11,0.364,1,4,0.25,2,2,1,0,2,2,0,0,1,0,4,13,4.2
Kyle Lowry,30-224,G,11/4/16,TOR,MIA,1,41,4,15,0.267,2,7,0.286,2,8,0.25,3,3,1,4,4,8,5,3,3,5,3,13,10.5
Marcin Gortat,32-266,C-F,11/9/16,WAS,BOS,1,32,6,9,0.667,6,9,0.667,0,0,,1,2,0.5,5,4,9,2,0,2,1,4,13,13.6
Rudy Gobert,24-290,C,4/12/17,UTA,SAS,1,29,5,9,0.556,5,9,0.556,0,0,,3,5,0.6,1,8,9,0,0,1,3,2,13,7.9
Rodney McGruder,25-210,G,2/24/17,MIA,ATL,1,23,5,5,1,3,3,1,2,2,1,1,1,1,0,3,3,0,0,0,0,1,13,12
Stephen Curry,28-331,G,2/8/17,GSW,CHI,1,28,5,11,0.455,4,7,0.571,1,4,0.25,2,2,1,0,1,1,6,1,0,2,4,13,9.2
Hassan Whiteside,27-266,C,3/6/17,MIA,CLE,1,36,4,10,0.4,4,10,0.4,0,0,,5,6,0.833,2,9,11,1,1,2,2,3,13,11.2
Mirza Teletovic,31-108,F,1/4/17,MIL,NYK,0,21,4,10,0.4,1,2,0.5,3,8,0.375,2,2,1,1,0,1,0,0,0,2,0,13,6.3
Solomon Hill,26-025,F,4/12/17,NOP,POR,1,30,4,8,0.5,3,4,0.75,1,4,0.25,4,6,0.667,0,3,3,0,1,1,1,0,13,9.8
Darrell Arthur,28-286,F,1/5/17,DEN,SAS,1,19,5,8,0.625,3,4,0.75,2,4,0.5,1,1,1,1,3,4,0,0,1,0,1,13,11.3
Georgios Papagiannis,19-275,C,4/4/17,SAC,DAL,0,28,6,10,0.6,6,10,0.6,0,0,,1,2,0.5,1,3,4,1,0,1,4,3,13,5.8
DeMarcus Cousins,26-144,C-F,1/4/17,SAC,MIA,1,32,4,15,0.267,4,11,0.364,0,4,0,5,8,0.625,0,6,6,4,2,0,1,5,13,6.5
Lou Williams,30-079,G,1/14/17,LAL,LAC,1,22,4,12,0.333,2,7,0.286,2,5,0.4,3,4,0.75,0,2,2,1,1,0,1,1,13,6.7
Kelly Olynyk,25-339,C-F,3/24/17,BOS,PHO,0,17,4,7,0.571,3,4,0.75,1,3,0.333,4,5,0.8,1,3,4,2,0,0,1,4,13,9.7
C.J. McCollum,25-065,G,11/23/16,POR,CLE,1,33,5,12,0.417,4,8,0.5,1,4,0.25,2,2,1,0,1,1,2,1,0,1,2,13,7.5
James Johnson,30-039,F,3/31/17,MIA,NYK,0,27,3,10,0.3,2,6,0.333,1,4,0.25,5,5,1,0,4,4,1,3,0,3,1,12,7.7
Davis Bertans,24-082,F,2/2/17,SAS,PHI,1,30,5,14,0.357,3,6,0.5,2,8,0.25,0,0,,2,4,6,3,2,0,2,2,12,8.1
Tyler Johnson,24-216,G,12/9/16,MIA,CLE,0,38,5,17,0.294,3,11,0.273,2,6,0.333,0,0,,0,5,5,2,2,1,1,1,12,6.3
J.J. Redick,32-274,G,3/25/17,LAC,UTA,1,23,4,10,0.4,2,6,0.333,2,4,0.5,2,3,0.667,0,3,3,1,0,0,1,0,12,6.8
Terrence Ross,25-364,F-G,2/3/17,TOR,ORL,0,28,4,10,0.4,0,4,0,4,6,0.667,0,0,,1,3,4,1,0,1,1,1,12,8.2
E'Twaun Moore,28-026,G,3/26/17,NOP,DEN,0,27,6,13,0.462,6,11,0.545,0,2,0,0,0,,2,0,2,3,0,0,1,1,12,7.4
Matt Barnes,36-301,F,1/4/17,SAC,MIA,1,33,5,9,0.556,3,5,0.6,2,4,0.5,0,0,,1,6,7,5,0,1,4,5,12,8.4
Larry Nance Jr.,23-331,F,11/27/16,LAL,ATL,0,32,6,10,0.6,6,9,0.667,0,1,0,0,0,,4,6,10,3,0,0,3,3,12,9.9
Anthony Davis,23-334,F-C,2/8/17,NOP,UTA,1,30,4,12,0.333,4,12,0.333,0,0,,4,5,0.8,3,6,9,2,0,6,1,1,12,12.9
Ricky Rubio,26-078,G,1/7/17,MIN,UTA,1,34,5,7,0.714,5,6,0.833,0,1,0,2,3,0.667,0,3,3,7,1,0,2,4,12,11.9
Noah Vonleh,21-229,F,4/10/17,POR,SAS,1,37,6,9,0.667,6,9,0.667,0,0,,0,0,,7,4,11,1,0,0,0,4,12,13.3
Boris Diaw,34-275,F-C,1/16/17,UTA,PHO,0,22,6,10,0.6,6,8,0.75,0,2,0,0,0,,2,1,3,6,0,0,0,2,12,12.5
Elfrid Payton,22-340,G,1/27/17,ORL,BOS,1,24,4,10,0.4,3,9,0.333,1,1,1,3,3,1,1,4,5,7,1,0,2,1,12,12
Michael Kidd-Gilchrist,23-123,F,1/27/17,CHO,NYK,1,37,5,9,0.556,5,8,0.625,0,1,0,2,2,1,1,5,6,1,1,0,0,3,12,10.4
Luc Mbah a Moute,30-176,F,3/4/17,LAC,CHI,1,30,5,6,0.833,5,6,0.833,0,0,,2,3,0.667,1,2,3,1,1,0,1,1,12,11
Terrence Ross,25-343,F-G,1/13/17,TOR,BRK,0,31,5,11,0.455,3,5,0.6,2,6,0.333,0,0,,0,2,2,1,0,0,0,1,12,7.2
Robin Lopez,28-235,C,11/22/16,CHI,DEN,1,35,6,12,0.5,6,12,0.5,0,0,,0,0,,4,4,8,1,1,6,0,2,12,15.1
Greg Monroe,26-275,C-F,3/6/17,MIL,PHI,0,22,5,10,0.5,5,10,0.5,0,0,,2,2,1,2,0,2,0,0,0,2,5,12,4.4
Will Barton,26-036,G,2/11/17,DEN,CLE,0,23,3,11,0.273,1,7,0.143,2,4,0.5,4,4,1,1,2,3,4,1,0,1,2,12,8.8
Robin Lopez,28-354,C,3/21/17,CHI,TOR,1,25,5,8,0.625,5,8,0.625,0,0,,2,2,1,3,1,4,1,0,3,1,1,12,12.2
Ryan Anderson,28-254,F,1/15/17,HOU,BRK,1,23,2,8,0.25,0,5,0,2,3,0.667,6,6,1,3,4,7,1,1,0,3,0,12,9.2
Jonas Jerebko,29-302,F,12/29/16,BOS,CLE,0,17,4,7,0.571,2,3,0.667,2,4,0.5,2,2,1,1,6,7,0,2,0,0,1,12,12.8
Malcolm Brogdon,24-022,G,1/2/17,MIL,OKC,1,32,3,12,0.25,2,8,0.25,1,4,0.25,5,5,1,0,2,2,5,0,0,2,5,12,4.9
Joe Ingles,29-164,F-G,3/15/17,UTA,DET,0,27,4,6,0.667,0,1,0,4,5,0.8,0,0,,0,3,3,4,1,0,1,2,12,12.3
Justin Anderson,23-004,G,11/23/16,DAL,LAC,0,16,4,7,0.571,3,6,0.5,1,1,1,3,3,1,0,5,5,0,0,0,2,3,12,7
Lou Williams,29-365,G,10/26/16,LAL,HOU,0,14,2,5,0.4,0,1,0,2,4,0.5,6,7,0.857,0,0,0,2,3,0,1,0,12,12.3
Solomon Hill,25-270,F,12/13/16,NOP,GSW,1,30,5,10,0.5,3,6,0.5,2,4,0.5,0,0,,1,5,6,1,0,0,1,4,12,7.3
Cristiano Felicio,24-201,F-C,1/24/17,CHI,ORL,0,21,4,6,0.667,4,6,0.667,0,0,,4,6,0.667,1,9,10,0,0,0,0,1,12,11.6
Joe Johnson,35-259,G-F,3/15/17,UTA,DET,1,29,4,10,0.4,2,5,0.4,2,5,0.4,2,2,1,0,5,5,1,3,1,2,1,12,10.1
Rajon Rondo,30-290,G,12/8/16,CHI,SAS,1,36,6,12,0.5,6,11,0.545,0,1,0,0,0,,1,9,10,9,2,0,4,3,12,12.5
Luc Mbah a Moute,30-136,F,1/23/17,LAC,ATL,1,29,4,5,0.8,3,4,0.75,1,1,1,3,4,0.75,1,6,7,1,2,4,1,3,12,15.5
E'Twaun Moore,27-306,G,12/30/16,NOP,NYK,0,27,5,10,0.5,3,7,0.429,2,3,0.667,0,0,,1,3,4,2,0,0,2,1,12,7.6
Jodie Meeks,29-234,G,4/12/17,ORL,DET,0,18,3,7,0.429,0,2,0,3,5,0.6,3,4,0.75,0,0,0,1,0,0,2,2,12,5.8
Gordon Hayward,26-345,F-G,3/3/17,UTA,BRK,1,35,5,11,0.455,4,6,0.667,1,5,0.2,1,2,0.5,0,3,3,6,2,0,1,1,12,11.6
Andrew Harrison,22-004,G,11/1/16,MEM,MIN,0,32,2,7,0.286,1,5,0.2,1,2,0.5,7,8,0.875,1,1,2,5,6,0,3,4,12,13.4
Derrick Rose,28-094,G,1/6/17,NYK,MIL,1,32,4,14,0.286,4,13,0.308,0,1,0,4,4,1,0,2,2,8,0,0,1,1,12,8.6
Marvin Williams,30-264,F,3/10/17,CHO,ORL,1,33,4,6,0.667,4,5,0.8,0,1,0,4,5,0.8,2,16,18,7,1,0,1,2,12,19.3
Brandon Rush,31-270,G-F,4/3/17,MIN,POR,1,37,4,8,0.5,3,5,0.6,1,3,0.333,3,4,0.75,3,4,7,3,1,2,2,2,12,12.6
Jon Leuer,27-200,F,11/30/16,DET,BOS,0,23,4,5,0.8,2,2,1,2,3,0.667,2,2,1,0,7,7,2,0,0,0,2,12,12.8
Clint Capela,22-203,F-C,12/7/16,HOU,LAL,1,20,6,10,0.6,6,10,0.6,0,0,,0,0,,1,8,9,2,2,2,2,2,12,12.5
Serge Ibaka,27-082,F-C,12/9/16,ORL,CHO,1,29,3,9,0.333,1,5,0.2,2,4,0.5,4,4,1,2,4,6,3,0,1,1,1,12,10.9
Marvin Williams,30-235,F,2/9/17,CHO,HOU,1,35,3,8,0.375,2,4,0.5,1,4,0.25,5,6,0.833,1,6,7,0,2,0,1,2,12,9.9
Dario Saric,22-294,F,1/27/17,PHI,HOU,0,21,4,9,0.444,4,8,0.5,0,1,0,4,6,0.667,0,4,4,2,1,1,2,2,12,8
James Johnson,30-019,F,3/11/17,MIA,TOR,0,28,4,10,0.4,4,7,0.571,0,3,0,4,6,0.667,0,5,5,5,1,2,2,3,12,10
Justin Hamilton,26-301,C,1/27/17,BRK,CLE,1,23,6,11,0.545,6,10,0.6,0,1,0,0,0,,1,4,5,0,1,1,0,1,12,9.9
Jamal Crawford,37-019,G,4/8/17,LAC,SAS,0,23,5,10,0.5,4,8,0.5,1,2,0.5,1,2,0.5,0,0,0,2,0,0,0,2,12,7.2
Markieff Morris,27-091,F,12/2/16,WAS,SAS,1,38,4,7,0.571,4,7,0.571,0,0,,4,4,1,1,3,4,3,0,1,4,3,12,7.9
Derrick Williams,25-260,F,2/9/17,CLE,OKC,0,22,3,3,1,3,3,1,0,0,,6,8,0.75,0,0,0,1,0,0,1,3,12,8.8
Sergio Rodriguez,30-265,G,3/4/17,PHI,DET,0,30,4,7,0.571,0,1,0,4,6,0.667,0,0,,0,1,1,8,0,0,2,1,12,12.2
Allen Crabbe,24-306,G-F,2/9/17,POR,BOS,0,30,5,8,0.625,3,5,0.6,2,3,0.667,0,0,,0,3,3,2,1,0,0,4,12,10.1
Jameer Nelson,35-017,G,2/26/17,DEN,MEM,1,32,5,8,0.625,3,4,0.75,2,4,0.5,0,0,,0,2,2,4,1,1,0,4,12,11.9
Cody Zeller,24-108,F-C,1/21/17,CHO,BRK,1,31,5,7,0.714,5,7,0.714,0,0,,2,2,1,0,9,9,3,0,1,0,1,12,14.2
Kent Bazemore,27-137,G-F,11/15/16,ATL,MIA,1,31,4,12,0.333,3,10,0.3,1,2,0.5,3,4,0.75,0,3,3,1,2,2,2,3,12,6.6
Cristiano Felicio,24-176,F-C,12/30/16,CHI,IND,0,22,4,5,0.8,4,5,0.8,0,0,,4,5,0.8,6,6,12,2,1,0,0,3,12,16.9
Luol Deng,31-195,F,10/28/16,LAL,UTA,1,34,5,12,0.417,3,7,0.429,2,5,0.4,0,0,,2,10,12,0,2,1,1,2,12,10.9
Tony Snell,25-128,G-F,3/18/17,MIL,GSW,1,28,5,8,0.625,3,4,0.75,2,4,0.5,0,1,0,1,2,3,2,0,0,1,1,12,9.3
Quincy Acy,26-157,F,3/12/17,BRK,NYK,0,19,4,6,0.667,0,2,0,4,4,1,0,0,,0,6,6,1,0,0,3,3,12,7.7
Doug McDermott,25-031,F,2/3/17,CHI,HOU,0,21,4,9,0.444,2,5,0.4,2,4,0.5,2,2,1,0,1,1,1,0,0,0,3,12,7.1
Joe Harris,25-130,G,1/15/17,BRK,HOU,1,20,5,11,0.455,3,3,1,2,8,0.25,0,0,,1,2,3,2,0,0,0,1,12,8.6
Yogi Ferrell,23-316,G,3/21/17,DAL,GSW,1,27,4,10,0.4,0,4,0,4,6,0.667,0,0,,1,0,1,4,2,0,3,1,12,8.7
Michael Kidd-Gilchrist,23-150,F,2/23/17,CHO,DET,1,39,5,9,0.556,5,9,0.556,0,0,,2,2,1,2,12,14,2,2,2,0,2,12,16.7
Kenneth Faried,27-006,F,11/25/16,DEN,OKC,1,24,6,8,0.75,6,8,0.75,0,0,,0,0,,3,5,8,1,1,2,2,2,12,12.7
Marcus Smart,22-291,G,12/22/16,BOS,IND,0,25,2,8,0.25,1,4,0.25,1,4,0.25,7,8,0.875,0,4,4,3,2,1,0,5,12,10.8
Victor Oladipo,24-193,G,11/13/16,OKC,ORL,1,31,6,9,0.667,6,8,0.75,0,1,0,0,0,,0,1,1,2,1,0,1,0,12,9.8
Marco Belinelli,30-351,G-F,3/11/17,CHO,NOP,0,23,4,9,0.444,3,5,0.6,1,4,0.25,3,3,1,0,1,1,0,0,0,0,1,12,7.2
Terry Rozier,23-016,G,4/2/17,BOS,NYK,0,24,4,6,0.667,3,3,1,1,3,0.333,3,5,0.6,0,2,2,4,3,0,1,2,12,13.2
Domantas Sabonis,20-271,F,1/29/17,OKC,CLE,1,26,6,12,0.5,6,9,0.667,0,3,0,0,0,,2,3,5,0,0,0,2,1,12,5.9
Zaza Pachulia,33-018,C,2/28/17,GSW,WAS,1,18,4,8,0.5,4,8,0.5,0,0,,4,5,0.8,6,2,8,0,1,0,2,2,12,10.6
Kris Humphries,31-324,F-C,12/26/16,ATL,MIN,0,11,3,5,0.6,3,4,0.75,0,1,0,6,7,0.857,5,0,5,2,0,0,0,0,12,14.2
Justin Holiday,27-364,G,4/4/17,NYK,CHI,0,21,5,8,0.625,3,3,1,2,5,0.4,0,0,,0,4,4,3,0,0,0,0,12,11.7
Chandler Parsons,28-018,F,11/12/16,MEM,MIL,1,23,5,11,0.455,3,5,0.6,2,6,0.333,0,0,,0,4,4,1,1,0,1,0,12,8.2
Clint Capela,22-189,F-C,11/23/16,HOU,TOR,1,31,6,7,0.857,6,7,0.857,0,0,,0,0,,3,3,6,0,0,5,0,0,12,16
Tony Snell,25-079,G-F,1/28/17,MIL,BOS,1,33,4,6,0.667,0,1,0,4,5,0.8,0,0,,0,3,3,0,0,1,0,2,12,10.2
Al Jefferson,31-308,C-F,11/7/16,IND,CHO,0,19,6,12,0.5,6,12,0.5,0,0,,0,1,0,4,6,10,1,1,0,0,2,12,11.1
Jrue Holiday,26-222,G,1/20/17,NOP,BRK,1,28,4,12,0.333,3,10,0.3,1,2,0.5,3,4,0.75,1,2,3,8,1,0,3,2,12,8.9
Larry Nance Jr.,24-091,F,4/2/17,LAL,MEM,1,40,4,8,0.5,3,7,0.429,1,1,1,3,4,0.75,6,8,14,1,3,1,1,5,12,15.6
Hassan Whiteside,27-271,C,3/11/17,MIA,TOR,1,33,4,8,0.5,4,8,0.5,0,0,,4,4,1,2,12,14,0,0,4,0,3,12,14.6
Andre Drummond,23-155,C,1/12/17,DET,GSW,1,27,5,6,0.833,5,6,0.833,0,0,,2,4,0.5,2,8,10,0,2,2,6,4,12,8.6
Patrick Patterson,27-316,F,1/24/17,TOR,SAS,0,21,5,6,0.833,3,3,1,2,3,0.667,0,0,,0,4,4,1,0,0,0,1,12,11.3
Norman Powell,23-174,G,11/15/16,TOR,CLE,1,29,4,7,0.571,1,2,0.5,3,5,0.6,1,2,0.5,0,3,3,3,0,1,1,5,12,9
Derrick Favors,25-208,F-C,2/8/17,UTA,NOP,1,25,5,7,0.714,5,6,0.833,0,1,0,2,2,1,2,5,7,2,1,0,2,3,12,11.2
Kent Bazemore,27-138,G-F,11/16/16,ATL,MIL,1,30,4,10,0.4,1,5,0.2,3,5,0.6,1,2,0.5,1,4,5,3,0,0,3,3,12,6
Kevin Love,28-125,F,1/10/17,CLE,UTA,1,37,4,14,0.286,2,8,0.25,2,6,0.333,2,2,1,0,9,9,3,0,0,2,4,12,5
Rodney McGruder,25-117,G,11/23/16,MIA,DET,0,31,5,8,0.625,3,4,0.75,2,4,0.5,0,0,,3,1,4,0,0,0,1,2,12,9
Jeff Teague,28-205,G,1/1/17,IND,ORL,1,27,5,9,0.556,5,7,0.714,0,2,0,2,2,1,1,2,3,9,1,1,3,2,12,13.2
Anthony Tolliver,31-196,F-C,12/14/16,SAC,HOU,1,35,5,13,0.385,4,5,0.8,1,8,0.125,1,2,0.5,3,7,10,0,2,2,1,1,12,10.7
Mason Plumlee,27-017,C-F,3/22/17,DEN,CLE,1,26,4,10,0.4,4,10,0.4,0,0,,4,4,1,3,4,7,4,1,0,1,2,12,11.9
Shabazz Muhammad,24-085,F-G,2/6/17,MIN,MIA,0,21,4,11,0.364,4,11,0.364,0,0,,4,4,1,1,2,3,1,0,0,1,1,12,6.5
Al Horford,30-251,C-F,2/9/17,BOS,POR,1,33,5,12,0.417,4,10,0.4,1,2,0.5,1,1,1,2,4,6,4,0,1,1,2,12,9.9
Nerlens Noel,22-295,C-F,1/30/17,PHI,SAC,0,25,5,5,1,5,5,1,0,0,,2,4,0.5,2,1,3,2,3,1,2,5,12,12.5
Marcus Morris,27-091,F,12/2/16,DET,ATL,1,29,5,12,0.417,3,9,0.333,2,3,0.667,0,0,,0,4,4,2,0,0,1,0,12,7.2
Jared Dudley,31-259,F-G,3/26/17,PHO,CHO,0,24,4,6,0.667,2,3,0.667,2,3,0.667,2,2,1,0,2,2,5,0,0,3,1,12,10.1
Nemanja Bjelica,28-299,F,3/4/17,MIN,SAS,0,21,5,12,0.417,3,6,0.5,2,6,0.333,0,0,,1,2,3,3,1,0,2,3,12,6.8
Brook Lopez,28-279,C,1/5/17,BRK,IND,1,26,5,14,0.357,4,9,0.444,1,5,0.2,1,2,0.5,0,6,6,3,0,1,2,2,12,5.6
Al Horford,30-301,C-F,3/31/17,BOS,ORL,1,36,4,11,0.364,4,9,0.444,0,2,0,4,4,1,2,7,9,6,1,0,5,1,12,9.2
Archie Goodwin,22-218,G,3/23/17,BRK,PHO,0,8,4,4,1,3,3,1,1,1,1,3,4,0.75,0,3,3,3,0,0,0,0,12,13.4
J.J. Barea,32-205,G,1/17/17,DAL,CHI,0,18,5,8,0.625,3,4,0.75,2,4,0.5,0,0,,0,1,1,6,0,0,1,1,12,11.5
Gorgui Dieng,26-338,C,12/21/16,MIN,ATL,1,40,5,10,0.5,5,9,0.556,0,1,0,2,2,1,2,7,9,1,1,3,2,3,12,11.1
Jakob Poeltl,21-163,C,3/27/17,TOR,ORL,0,13,5,6,0.833,5,6,0.833,0,0,,2,4,0.5,4,0,4,0,0,0,2,2,12,9
Dario Saric,22-262,F,12/26/16,PHI,SAC,0,27,5,11,0.455,3,6,0.5,2,5,0.4,0,0,,1,8,9,2,1,0,1,1,12,10.4
Isaiah Whitehead,21-353,G,2/24/17,BRK,DEN,0,19,4,7,0.571,2,4,0.5,2,3,0.667,2,2,1,0,2,2,3,0,0,4,3,12,6.2
Channing Frye,33-220,C-F,12/23/16,CLE,BRK,0,22,5,9,0.556,4,4,1,1,5,0.2,1,1,1,0,6,6,2,0,0,1,1,12,9.5
Malcolm Brogdon,23-352,G,11/27/16,MIL,ORL,0,20,5,10,0.5,3,7,0.429,2,3,0.667,0,0,,2,1,3,2,1,0,0,3,12,9.9
Kent Bazemore,27-260,G-F,3/18/17,ATL,POR,1,32,5,12,0.417,5,8,0.625,0,4,0,2,2,1,0,0,0,2,0,1,1,2,12,5.9
Leandro Barbosa,34-075,G,2/11/17,PHO,HOU,0,20,4,11,0.364,3,8,0.375,1,3,0.333,3,4,0.75,0,3,3,0,0,0,0,0,12,6.4
Taj Gibson,31-167,F,12/8/16,CHI,SAS,1,28,5,11,0.455,5,11,0.455,0,0,,2,2,1,0,5,5,1,0,2,1,1,12,8.5
Jose Calderon,35-196,G,4/12/17,ATL,IND,1,30,5,8,0.625,3,4,0.75,2,4,0.5,0,0,,0,2,2,5,0,0,3,1,12,9.1
Blake Griffin,27-344,F,2/23/17,LAC,GSW,1,35,3,13,0.231,2,11,0.182,1,2,0.5,5,9,0.556,0,5,5,8,1,0,2,2,12,7.8
Rudy Gobert,24-262,C,3/15/17,UTA,DET,1,36,5,6,0.833,5,6,0.833,0,0,,2,5,0.4,3,6,9,5,0,4,4,2,12,14
Jakob Poeltl,21-155,C,3/19/17,TOR,IND,0,23,4,6,0.667,4,6,0.667,0,0,,4,4,1,3,4,7,0,1,2,1,4,12,12.5
Terrence Jones,25-016,F,1/25/17,NOP,OKC,1,27,6,17,0.353,6,16,0.375,0,1,0,0,1,0,2,2,4,1,1,1,0,2,12,5.7
Nikola Mirotic,25-331,F,1/7/17,CHI,TOR,0,33,4,10,0.4,1,2,0.5,3,8,0.375,1,2,0.5,0,9,9,2,1,1,1,4,12,9.4
Kosta Koufos,28-012,C,3/8/17,SAC,SAS,1,25,6,10,0.6,6,10,0.6,0,0,,0,0,,0,10,10,0,0,0,1,4,12,7.8
Stanley Johnson,20-297,F,3/22/17,DET,CHI,0,16,5,10,0.5,3,6,0.5,2,4,0.5,0,0,,0,3,3,0,0,0,1,2,12,6.1
DeMarre Carroll,30-247,F,3/31/17,TOR,IND,1,22,4,9,0.444,0,1,0,4,8,0.5,0,0,,1,0,1,4,0,1,1,3,12,9.3
P.J. Tucker,31-268,F,1/28/17,PHO,DEN,0,36,5,10,0.5,3,6,0.5,2,4,0.5,0,0,,2,5,7,5,1,0,0,5,12,12.4
J.R. Smith,31-202,G-F,3/30/17,CLE,CHI,1,38,4,9,0.444,0,2,0,4,7,0.571,0,0,,0,3,3,4,1,0,2,0,12,10
Mario Hezonja,22-008,F-G,3/5/17,ORL,WAS,0,17,4,9,0.444,1,4,0.25,3,5,0.6,1,2,0.5,0,2,2,1,1,0,1,1,12,7.8
Jonathon Simmons,27-095,G-F,12/18/16,SAS,NOP,0,17,5,6,0.833,3,4,0.75,2,2,1,0,0,,0,1,1,0,1,0,2,2,12,8.3
Kemba Walker,26-293,G,2/25/17,CHO,SAC,1,36,5,12,0.417,3,7,0.429,2,5,0.4,0,0,,1,2,3,6,1,0,4,1,12,7.7
Meyers Leonard,25-008,C-F,3/7/17,POR,OKC,0,20,5,8,0.625,3,4,0.75,2,4,0.5,0,0,,0,1,1,1,0,0,0,4,12,7.8
Nikola Jokic,21-255,C-F,10/31/16,DEN,TOR,1,22,6,9,0.667,6,8,0.75,0,1,0,0,0,,2,2,4,1,0,0,4,4,12,5.2
David Lee,33-206,F,11/21/16,SAS,DAL,0,28,6,10,0.6,6,10,0.6,0,0,,0,1,0,2,2,4,3,2,1,0,2,12,13
Al Jefferson,32-043,C-F,2/16/17,IND,WAS,0,11,6,8,0.75,6,8,0.75,0,0,,0,0,,0,3,3,0,0,0,0,4,12,8.1
Marcus Morris,27-103,F,12/14/16,DET,DAL,1,37,4,10,0.4,2,5,0.4,2,5,0.4,2,2,1,0,6,6,2,2,0,4,1,12,7.4
Sean Kilpatrick,26-352,G,12/23/16,BRK,CLE,1,21,4,10,0.4,2,5,0.4,2,5,0.4,2,2,1,0,5,5,4,2,0,1,2,12,11.1
Tyreke Evans,27-112,G-F,1/9/17,NOP,NYK,0,21,5,9,0.556,3,4,0.75,2,5,0.4,0,0,,0,2,2,4,0,0,3,2,12,7.3
Dwyane Wade,34-331,G,12/13/16,CHI,MIN,1,32,4,13,0.308,3,10,0.3,1,3,0.333,3,6,0.5,1,4,5,8,2,1,2,2,12,10.7
Nikola Vucevic,26-039,C,12/2/16,ORL,PHI,0,27,5,9,0.556,3,7,0.429,2,2,1,0,0,,0,11,11,5,1,1,1,3,12,14
Kay Felder,21-279,G,1/2/17,CLE,NOP,0,22,6,11,0.545,6,11,0.545,0,0,,0,0,,0,1,1,2,0,0,0,2,12,7.6
Tyler Ennis,22-218,G,3/30/17,LAL,MIN,0,19,4,8,0.5,2,5,0.4,2,3,0.667,2,2,1,0,1,1,3,1,0,0,1,12,11
Isaiah Whitehead,21-300,G,1/2/17,BRK,UTA,1,31,4,11,0.364,3,8,0.375,1,3,0.333,3,4,0.75,1,5,6,1,0,1,3,3,12,4.9
Nik Stauskas,23-187,G,4/12/17,PHI,NYK,0,30,3,11,0.273,1,5,0.2,2,6,0.333,4,4,1,0,4,4,3,1,0,3,3,12,5.6
Joe Ingles,29-155,F-G,3/6/17,UTA,NOP,1,32,4,6,0.667,0,1,0,4,5,0.8,0,0,,1,4,5,4,2,0,2,0,12,14.1
T.J. McConnell,24-261,G,12/11/16,PHI,DET,1,37,6,9,0.667,6,9,0.667,0,0,,0,0,,1,9,10,9,3,0,3,2,12,17
Thomas Robinson,26-013,F,3/30/17,LAL,MIN,0,14,6,9,0.667,6,9,0.667,0,0,,0,0,,1,2,3,0,0,0,3,3,12,5.2
Trey Lyles,21-028,F,12/3/16,UTA,DEN,0,20,4,9,0.444,2,4,0.5,2,5,0.4,2,2,1,0,4,4,1,0,1,0,1,12,9.5
Vince Carter,39-295,G-F,11/16/16,MEM,LAC,0,27,5,10,0.5,3,6,0.5,2,4,0.5,0,0,,0,3,3,2,1,0,1,3,12,8.1
Kemba Walker,26-218,G,12/12/16,CHO,IND,1,35,4,16,0.25,3,12,0.25,1,4,0.25,3,3,1,1,1,2,5,2,0,3,1,12,5.5
Quincy Acy,26-155,F,3/10/17,BRK,DAL,1,23,5,7,0.714,3,5,0.6,2,2,1,0,0,,0,4,4,1,1,0,1,1,12,10.6
C.J. McCollum,25-192,G,3/30/17,POR,HOU,1,32,4,15,0.267,2,7,0.286,2,8,0.25,2,2,1,0,1,1,3,0,0,1,2,12,3.7
Larry Nance Jr.,23-308,F,11/4/16,LAL,GSW,0,30,6,6,1,6,6,1,0,0,,0,0,,2,7,9,2,0,1,0,1,12,15.4
Wesley Matthews,30-019,G,11/2/16,DAL,UTA,1,36,4,9,0.444,1,4,0.25,3,5,0.6,1,1,1,0,1,1,2,0,1,1,2,12,7.9
Alex Abrines,23-246,G-F,4/4/17,OKC,MIL,0,12,4,6,0.667,0,0,,4,6,0.667,0,0,,0,1,1,0,0,0,1,0,12,8.7
Taj Gibson,31-284,F,4/4/17,OKC,MIL,1,20,5,7,0.714,5,7,0.714,0,0,,2,2,1,0,3,3,0,1,1,0,0,12,11.7
Thaddeus Young,28-137,F,11/5/16,IND,CHI,1,25,6,10,0.6,6,8,0.75,0,2,0,0,0,,3,2,5,1,1,1,2,1,12,10.1
Bismack Biyombo,24-147,C-F,1/22/17,ORL,GSW,0,24,5,8,0.625,5,8,0.625,0,0,,2,7,0.286,4,9,13,0,0,3,0,1,12,13.6
Andre Drummond,23-197,C,2/23/17,DET,CHO,1,26,6,10,0.6,6,10,0.6,0,0,,0,0,,4,9,13,0,0,0,2,1,12,10.5
Bojan Bogdanovic,27-334,G-F,3/18/17,WAS,CHO,0,23,4,9,0.444,2,4,0.5,2,5,0.4,2,2,1,0,3,3,1,0,0,4,3,12,3.7
Andre Iguodala,33-059,G-F,3/28/17,GSW,HOU,0,31,4,9,0.444,3,4,0.75,1,5,0.2,3,4,0.75,0,6,6,7,0,0,1,1,12,12.2
Nik Stauskas,23-036,G,11/12/16,PHI,ATL,0,24,4,6,0.667,2,2,1,2,4,0.5,2,2,1,2,2,4,1,3,0,4,2,12,10.3
Pau Gasol,36-172,F-C,12/25/16,SAS,CHI,1,24,5,8,0.625,4,7,0.571,1,1,1,1,3,0.333,2,5,7,1,0,1,0,1,12,11.5
Hassan Whiteside,27-243,C,2/11/17,MIA,PHI,1,34,5,11,0.455,5,11,0.455,0,0,,2,2,1,2,17,19,0,0,1,1,3,12,11.3
Cameron Payne,22-189,G,2/13/17,OKC,WAS,0,23,5,9,0.556,3,5,0.6,2,4,0.5,0,0,,0,3,3,2,2,0,3,1,12,8.6
Randy Foye,33-192,G,4/4/17,BRK,PHI,1,19,2,5,0.4,0,0,,2,5,0.4,6,6,1,0,3,3,2,2,0,1,2,12,11.8
Paul Millsap,31-322,F,12/28/16,ATL,NYK,1,41,4,20,0.2,3,14,0.214,1,6,0.167,3,4,0.75,3,4,7,6,1,2,0,3,12,7.9
Kentavious Caldwell-Pope,24-040,G,3/30/17,DET,BRK,1,37,5,14,0.357,3,10,0.3,2,4,0.5,0,1,0,0,3,3,2,1,0,2,0,12,5.1
Deron Williams,32-234,G,2/15/17,DAL,DET,1,30,4,14,0.286,2,7,0.286,2,7,0.286,2,2,1,0,2,2,6,1,0,2,3,12,6.4
Skal Labissiere,21-024,F,4/11/17,SAC,PHO,1,26,3,7,0.429,3,7,0.429,0,0,,6,8,0.75,2,4,6,2,0,0,0,4,12,9.9
Enes Kanter,24-327,C,4/12/17,OKC,DEN,0,20,6,8,0.75,6,8,0.75,0,0,,0,0,,2,3,5,1,1,0,2,2,12,10
DeMar DeRozan,27-241,G,4/5/17,TOR,DET,1,34,5,17,0.294,5,16,0.313,0,1,0,2,3,0.667,1,3,4,10,0,0,3,2,12,6.5
Wayne Ellington,29-126,G,3/4/17,MIA,CLE,0,24,4,9,0.444,0,2,0,4,7,0.571,0,0,,1,3,4,0,1,0,1,2,12,8.1
Omri Casspi,28-170,F,12/9/16,SAC,NYK,0,20,4,5,0.8,3,4,0.75,1,1,1,3,3,1,0,3,3,1,0,0,1,2,12,9.9
Rudy Gobert,24-195,C,1/7/17,UTA,MIN,1,31,5,10,0.5,5,10,0.5,0,0,,2,3,0.667,7,6,13,1,1,4,1,5,12,14.8
Ron Baker,23-292,G,1/16/17,NYK,ATL,1,22,4,9,0.444,0,2,0,4,7,0.571,0,0,,1,2,3,1,2,0,1,4,12,8.7
Richard Jefferson,36-195,F,1/2/17,CLE,NOP,0,29,4,9,0.444,3,5,0.6,1,4,0.25,3,3,1,1,11,12,2,0,0,2,0,12,10.7
Andre Drummond,23-079,C,10/28/16,DET,ORL,1,28,5,14,0.357,5,14,0.357,0,0,,2,2,1,4,16,20,1,2,0,1,1,12,13.1
Sergio Rodriguez,30-242,G,2/9/17,PHI,ORL,0,18,4,7,0.571,0,3,0,4,4,1,0,0,,0,3,3,5,0,0,4,0,12,9.1
Anthony Tolliver,31-314,F-C,4/11/17,SAC,PHO,0,22,2,4,0.5,0,0,,2,4,0.5,6,7,0.857,1,6,7,3,1,1,0,0,12,15.9
Steven Adams,23-154,C,12/21/16,OKC,NOP,1,23,6,11,0.545,6,11,0.545,0,0,,0,0,,4,0,4,3,0,1,2,4,12,8.7
Taj Gibson,31-237,F,2/16/17,CHI,BOS,1,28,5,8,0.625,5,8,0.625,0,0,,2,2,1,3,6,9,2,0,0,1,1,12,12.3
Rajon Rondo,30-254,G,11/2/16,CHI,BOS,1,34,6,11,0.545,6,9,0.667,0,2,0,0,0,,2,7,9,5,1,1,4,3,12,10.2
John Henson,25-339,C-F,12/1/16,MIL,BRK,1,25,4,9,0.444,4,9,0.444,0,0,,4,4,1,3,5,8,1,0,5,3,2,12,11.3
Channing Frye,33-318,C-F,3/31/17,CLE,PHI,0,16,5,8,0.625,3,6,0.5,2,2,1,0,0,,0,1,1,0,0,0,1,0,12,7.7
Brandon Jennings,27-040,G,11/2/16,NYK,HOU,0,23,3,7,0.429,3,5,0.6,0,2,0,6,8,0.75,0,3,3,3,0,0,1,2,12,8.7
Nikola Jokic,21-263,C-F,11/8/16,DEN,MEM,1,28,4,10,0.4,3,7,0.429,1,3,0.333,3,4,0.75,1,4,5,2,2,0,0,4,12,9.9
Tobias Harris,24-243,F,3/15/17,DET,UTA,0,30,5,8,0.625,5,8,0.625,0,0,,2,2,1,0,4,4,2,1,0,0,4,12,10.4
Patrick Beverley,28-189,G,1/17/17,HOU,MIA,1,33,5,9,0.556,5,6,0.833,0,3,0,2,2,1,0,7,7,3,2,0,1,3,12,11.7
Anthony Morrow,31-073,G,12/9/16,OKC,HOU,0,26,5,11,0.455,3,6,0.5,2,5,0.4,0,0,,1,1,2,0,1,0,1,2,12,6.5
Stanley Johnson,20-160,F,11/5/16,DET,DEN,0,19,5,7,0.714,4,4,1,1,3,0.333,1,2,0.5,0,1,1,0,1,0,1,2,12,8.2
Kevin Love,28-072,F,11/18/16,CLE,DET,1,27,5,10,0.5,5,9,0.556,0,1,0,2,2,1,1,12,13,1,0,0,4,1,12,7.6
Elfrid Payton,23-009,G,3/3/17,ORL,MIA,1,27,5,8,0.625,5,8,0.625,0,0,,2,3,0.667,0,10,10,8,3,0,3,2,12,15.8
Robin Lopez,28-233,C,11/20/16,CHI,LAL,1,28,6,11,0.545,6,11,0.545,0,0,,0,0,,4,7,11,2,0,2,0,0,12,14.4
Trevor Ariza,31-255,F,3/12/17,HOU,CLE,1,39,3,10,0.3,1,3,0.333,2,7,0.286,4,5,0.8,1,6,7,2,1,0,0,2,12,9.9
Kent Bazemore,27-142,G-F,11/20/16,ATL,NYK,1,30,4,11,0.364,4,8,0.5,0,3,0,4,4,1,0,3,3,5,1,0,1,3,12,9.1
Avery Bradley,26-123,G,3/29/17,BOS,MIL,1,36,5,14,0.357,4,8,0.5,1,6,0.167,1,2,0.5,4,6,10,2,2,0,1,2,12,10
Kevin Seraphin,27-068,F,2/13/17,IND,SAS,1,27,6,9,0.667,6,8,0.75,0,1,0,0,2,0,0,4,4,1,0,1,2,4,12,6.3
Quincy Acy,26-106,F,1/20/17,BRK,NOP,0,22,3,5,0.6,1,1,1,2,4,0.5,4,4,1,1,7,8,1,0,0,2,2,12,10.4
Nik Stauskas,23-038,G,11/14/16,PHI,HOU,0,29,4,9,0.444,3,4,0.75,1,5,0.2,3,4,0.75,0,2,2,1,1,0,1,2,12,7.4
Rondae Hollis-Jefferson,22-091,F,4/4/17,BRK,PHI,1,21,5,6,0.833,5,5,1,0,1,0,2,4,0.5,1,2,3,2,0,0,1,1,12,10.3
LaMarcus Aldridge,31-102,F-C,10/29/16,SAS,NOP,1,25,4,13,0.308,3,11,0.273,1,2,0.5,3,4,0.75,1,5,6,0,0,1,0,4,12,5.4
Norman Powell,23-252,G,2/1/17,TOR,BOS,1,32,6,9,0.667,6,7,0.857,0,2,0,0,0,,0,5,5,2,0,0,4,5,12,5
Avery Bradley,26-020,G,12/16/16,BOS,CHO,1,31,5,14,0.357,3,8,0.375,2,6,0.333,0,0,,1,6,7,2,1,0,2,3,12,5.9
Thabo Sefolosha,32-307,G-F,3/5/17,ATL,IND,1,36,4,12,0.333,2,6,0.333,2,6,0.333,2,2,1,1,5,6,4,2,0,0,3,12,11
Derrick Rose,28-153,G,3/6/17,NYK,ORL,1,27,2,9,0.222,2,9,0.222,0,0,,8,8,1,0,5,5,6,0,0,2,0,12,10.2
Jonas Valanciunas,24-206,C,11/28/16,TOR,PHI,1,22,6,12,0.5,6,12,0.5,0,0,,0,0,,3,8,11,0,1,2,1,1,12,11.5
Toney Douglas,30-353,G,3/4/17,MEM,HOU,0,29,4,13,0.308,3,9,0.333,1,4,0.25,3,5,0.6,5,0,5,5,3,0,1,5,12,10.7
Evan Fournier,24-095,G-F,2/1/17,ORL,IND,1,30,3,8,0.375,1,3,0.333,2,5,0.4,4,4,1,0,1,1,4,2,0,4,6,12,6.3
Bojan Bogdanovic,27-248,G-F,12/22/16,BRK,GSW,1,26,5,10,0.5,3,5,0.6,2,5,0.4,0,0,,1,2,3,0,0,1,3,3,12,4.8
Jakob Poeltl,21-169,C,4/2/17,TOR,PHI,0,20,5,6,0.833,5,6,0.833,0,0,,2,4,0.5,3,2,5,0,2,2,1,5,12,12.1
Mike Muscala,25-282,F-C,4/9/17,ATL,CLE,0,25,5,6,0.833,3,4,0.75,2,2,1,0,0,,0,5,5,4,0,1,1,3,12,12.6
Elfrid Payton,23-041,G,4/4/17,ORL,CLE,1,23,5,9,0.556,5,8,0.625,0,1,0,2,2,1,2,2,4,6,0,0,1,0,12,12.9
Alex Len,23-278,C,3/21/17,PHO,MIA,1,36,5,13,0.385,5,11,0.455,0,2,0,2,2,1,3,8,11,0,0,4,3,3,12,8
Cody Zeller,24-037,F-C,11/11/16,CHO,TOR,1,26,5,8,0.625,5,8,0.625,0,0,,2,4,0.5,3,4,7,0,0,1,0,1,12,11.2
Tyler Johnson,24-176,G,10/30/16,MIA,SAS,0,30,5,11,0.455,5,10,0.5,0,1,0,2,3,0.667,0,0,0,3,0,0,1,4,12,5.4
Enes Kanter,24-211,C,12/17/16,OKC,PHO,0,14,3,7,0.429,3,7,0.429,0,0,,6,7,0.857,3,2,5,1,0,1,1,0,12,11
Jusuf Nurkic,22-151,C,1/21/17,DEN,LAC,0,20,4,7,0.571,4,7,0.571,0,0,,4,7,0.571,0,5,5,3,0,0,0,2,12,10.3
Dion Waiters,25-058,G,2/6/17,MIA,MIN,1,33,4,13,0.308,4,9,0.444,0,4,0,4,4,1,0,3,3,5,2,2,1,1,12,10.9
Timothe Luwawu-Cabarrot,21-263,F,1/27/17,PHI,HOU,0,13,5,5,1,4,4,1,1,1,1,1,1,1,0,1,1,0,0,0,3,1,12,7.4
Jose Calderon,35-055,G,11/22/16,LAL,OKC,1,23,4,5,0.8,0,0,,4,5,0.8,0,0,,0,6,6,4,2,0,2,3,12,13.5
Jerian Grant,24-103,G,1/20/17,CHI,ATL,0,11,3,5,0.6,2,3,0.667,1,2,0.5,5,5,1,0,0,0,1,1,0,4,0,12,7.4
Rudy Gobert,24-129,C,11/2/16,UTA,DAL,1,23,3,5,0.6,3,5,0.6,0,0,,6,14,0.429,4,8,12,1,2,3,1,5,12,13.5
Frank Kaminsky,23-309,F-C,2/7/17,CHO,BRK,1,33,4,17,0.235,2,10,0.2,2,7,0.286,2,4,0.5,3,8,11,5,1,0,0,4,12,8.3
J.R. Smith,31-186,G-F,3/14/17,CLE,DET,0,23,4,5,0.8,1,1,1,3,4,0.75,1,2,0.5,0,5,5,1,1,0,1,2,12,11.1
Willie Cauley-Stein,23-229,F-C,4/4/17,SAC,DAL,1,34,6,12,0.5,6,12,0.5,0,0,,0,0,,4,12,16,1,3,0,0,2,12,15.3
Monta Ellis,31-124,G,2/27/17,IND,HOU,0,32,6,8,0.75,6,7,0.857,0,1,0,0,0,,2,6,8,8,0,0,6,4,12,10
Trevor Booker,29-068,F,2/1/17,BRK,NYK,0,16,6,11,0.545,6,9,0.667,0,2,0,0,0,,2,6,8,3,1,1,3,3,12,9.5
Solomon Hill,25-361,F,3/14/17,NOP,POR,1,31,4,5,0.8,2,2,1,2,3,0.667,2,2,1,0,3,3,0,0,2,1,1,12,11
Greg Monroe,26-218,C-F,1/8/17,MIL,WAS,0,33,5,12,0.417,5,12,0.417,0,0,,2,2,1,2,10,12,3,4,1,3,1,12,13.4
Tristan Thompson,25-339,F-C,2/15/17,CLE,IND,1,37,6,11,0.545,6,11,0.545,0,0,,0,0,,7,5,12,1,1,0,0,3,12,13.6
Deron Williams,32-129,G,11/2/16,DAL,UTA,1,34,5,11,0.455,3,6,0.5,2,5,0.4,0,0,,0,2,2,9,0,0,1,3,12,11
Nikola Vucevic,26-044,C,12/7/16,ORL,BOS,0,27,5,14,0.357,5,12,0.417,0,2,0,2,2,1,1,9,10,2,2,0,4,1,12,6.6
Sasha Vujacic,32-330,G,2/1/17,NYK,BRK,0,22,4,10,0.4,2,5,0.4,2,5,0.4,2,2,1,0,2,2,0,0,1,0,3,12,6.7
Malachi Richardson,21-020,G,1/25/17,SAC,CLE,0,14,5,6,0.833,4,4,1,1,2,0.5,1,1,1,1,2,3,1,1,0,1,3,12,10.6
Kent Bazemore,27-279,G-F,4/6/17,ATL,BOS,0,19,4,8,0.5,3,6,0.5,1,2,0.5,3,4,0.75,0,3,3,2,4,0,2,6,12,9.5
Nik Stauskas,23-060,G,12/6/16,PHI,MEM,1,38,3,10,0.3,2,2,1,1,8,0.125,5,10,0.5,0,4,4,1,0,1,0,2,12,6
Leandro Barbosa,34-033,G,12/31/16,PHO,UTA,0,13,5,8,0.625,5,8,0.625,0,0,,2,2,1,1,4,5,0,1,0,1,1,12,9.9
Joe Ingles,29-110,F-G,1/20/17,UTA,DAL,1,38,4,9,0.444,2,5,0.4,2,4,0.5,2,2,1,0,3,3,4,3,0,2,1,12,11.6
Matt Barnes,36-261,F,11/25/16,SAC,HOU,1,33,5,10,0.5,3,3,1,2,7,0.286,0,0,,0,3,3,2,0,0,1,1,12,7.9
Ish Smith,28-209,G,1/30/17,DET,BOS,0,19,6,7,0.857,6,7,0.857,0,0,,0,0,,1,2,3,2,0,2,1,3,12,11.4
Nikola Vucevic,26-090,C,1/22/17,ORL,GSW,1,24,6,8,0.75,6,8,0.75,0,0,,0,0,,1,3,4,1,2,1,0,2,12,13
Tobias Harris,24-119,F,11/11/16,DET,SAS,1,31,4,13,0.308,4,9,0.444,0,4,0,4,4,1,0,5,5,2,0,0,1,4,12,4.8
Ian Clark,25-301,G,1/2/17,GSW,DEN,0,16,4,5,0.8,2,3,0.667,2,2,1,2,2,1,0,1,1,1,2,0,0,1,12,12.7
Vince Carter,40-071,G-F,4/7/17,MEM,NYK,1,28,4,5,0.8,0,0,,4,5,0.8,0,0,,0,4,4,3,1,2,0,0,12,15.8
Joe Harris,25-077,G,11/23/16,BRK,BOS,0,25,4,7,0.571,0,1,0,4,6,0.667,0,0,,0,3,3,0,0,0,3,2,12,5.8
Wesley Matthews,30-081,G,1/3/17,DAL,WAS,1,38,5,11,0.455,3,7,0.429,2,4,0.5,0,0,,0,2,2,2,0,1,0,0,12,9
Langston Galloway,25-002,G,12/11/16,NOP,PHO,0,19,4,7,0.571,0,0,,4,7,0.571,0,0,,0,0,0,0,0,0,0,2,12,7.9
Kristaps Porzingis,21-127,F-C,12/7/16,NYK,CLE,1,30,5,15,0.333,3,10,0.3,2,5,0.4,0,0,,1,2,3,0,0,2,1,5,12,3.2
Allen Crabbe,24-359,G-F,4/3/17,POR,MIN,0,29,5,11,0.455,4,8,0.5,1,3,0.333,1,2,0.5,0,2,2,2,1,0,1,0,12,7.9
Maurice Harkless,23-288,F-G,2/23/17,POR,ORL,1,38,4,8,0.5,3,7,0.429,1,1,1,3,4,0.75,0,6,6,1,1,3,1,3,12,11
Marcus Smart,22-250,G,11/11/16,BOS,NYK,1,34,5,13,0.385,3,6,0.5,2,7,0.286,0,0,,1,5,6,10,3,0,1,1,12,15.7
Alan Williams,24-048,F-C,3/17/17,PHO,ORL,0,16,4,6,0.667,4,6,0.667,0,0,,4,6,0.667,1,6,7,2,0,0,2,4,12,8.9
Andre Drummond,23-184,C,2/10/17,DET,SAS,1,37,5,17,0.294,5,17,0.294,0,0,,2,5,0.4,6,9,15,0,3,1,0,4,12,9.9
Jameer Nelson,35-019,G,2/28/17,DEN,CHI,1,30,5,6,0.833,3,3,1,2,3,0.667,0,0,,0,2,2,1,0,0,3,4,12,6.5
Draymond Green,26-320,F,1/18/17,GSW,OKC,1,36,5,9,0.556,5,8,0.625,0,1,0,2,4,0.5,2,9,11,5,1,3,4,2,12,12.8
Sergio Rodriguez,30-168,G,11/27/16,PHI,CLE,1,28,5,9,0.556,3,6,0.5,2,3,0.667,0,0,,0,2,2,7,2,0,2,2,12,12.4
Taj Gibson,31-127,F,10/29/16,CHI,IND,1,25,6,11,0.545,6,11,0.545,0,0,,0,0,,0,8,8,1,1,0,0,1,12,10.4
Bismack Biyombo,24-213,C-F,3/29/17,ORL,OKC,0,20,5,7,0.714,5,7,0.714,0,0,,2,2,1,4,7,11,2,0,2,0,4,12,15.2
Marcus Morris,27-188,F,3/9/17,DET,CLE,1,32,4,11,0.364,2,4,0.5,2,7,0.286,2,2,1,0,5,5,3,2,0,1,2,12,9.7
Dario Saric,22-348,F,3/22/17,PHI,OKC,1,26,4,14,0.286,3,11,0.273,1,3,0.333,3,3,1,1,1,2,2,1,3,3,1,12,5.9
Chandler Parsons,28-024,F,11/18/16,MEM,DAL,1,23,4,7,0.571,1,2,0.5,3,5,0.6,1,2,0.5,1,1,2,0,0,0,2,0,12,7.3
Maurice Harkless,23-332,F-G,4/8/17,POR,UTA,1,37,6,7,0.857,6,7,0.857,0,0,,0,0,,1,2,3,0,3,0,0,5,12,11.8
Nene Hilario,34-090,F-C,12/12/16,HOU,BRK,0,25,4,8,0.5,4,8,0.5,0,0,,4,6,0.667,3,3,6,0,2,0,2,4,12,8.6
Taj Gibson,31-144,F,11/15/16,CHI,POR,1,30,4,9,0.444,4,9,0.444,0,0,,4,5,0.8,5,6,11,0,0,3,2,1,12,11.9
Enes Kanter,24-190,C,11/26/16,OKC,DET,0,18,5,8,0.625,5,8,0.625,0,0,,2,3,0.667,0,3,3,0,0,1,2,3,12,6.4
Dario Saric,22-218,F,11/12/16,PHI,ATL,1,28,5,13,0.385,3,9,0.333,2,4,0.5,0,0,,1,6,7,1,1,0,3,0,12,6.1
Dario Saric,23-002,F,4/10/17,PHI,IND,1,25,3,10,0.3,2,6,0.333,1,4,0.25,5,6,0.833,4,2,6,3,2,1,4,3,12,8.8
Elfrid Payton,22-348,G,2/4/17,ORL,ATL,1,26,3,12,0.25,3,8,0.375,0,4,0,6,8,0.75,2,1,3,0,0,0,2,1,12,3.3
Tobias Harris,24-255,F,3/27/17,DET,NYK,1,34,5,15,0.333,5,13,0.385,0,2,0,2,2,1,2,2,4,1,1,0,0,3,12,6
Terrence Ross,26-058,F-G,4/4/17,ORL,CLE,1,33,5,14,0.357,3,6,0.5,2,8,0.25,0,0,,0,1,1,3,2,0,1,1,12,7.2
Doug McDermott,24-307,F,11/5/16,CHI,IND,0,21,3,7,0.429,2,5,0.4,1,2,0.5,5,6,0.833,0,4,4,0,0,0,0,1,12,8.7
Spencer Hawes,28-275,C-F,1/28/17,CHO,SAC,0,28,4,6,0.667,4,5,0.8,0,1,0,4,4,1,2,5,7,1,0,1,1,5,12,10.7
James Johnson,29-300,F,12/16/16,MIA,LAC,0,22,5,11,0.455,5,6,0.833,0,5,0,2,3,0.667,1,6,7,2,0,1,0,4,12,8.9
Justise Winslow,20-272,F,12/23/16,MIA,NOP,1,38,6,15,0.4,6,13,0.462,0,2,0,0,0,,0,7,7,3,0,0,1,1,12,6.7
Nene Hilario,34-130,F-C,1/21/17,HOU,MEM,0,16,4,5,0.8,4,5,0.8,0,0,,4,6,0.667,0,3,3,0,3,1,1,5,12,10.9
Lance Thomas,28-309,F,2/27/17,NYK,TOR,1,29,3,4,0.75,1,1,1,2,3,0.667,4,6,0.667,1,5,6,0,0,0,1,3,12,9.6
Jamal Murray,19-288,G,12/7/16,DEN,BRK,0,34,4,14,0.286,2,6,0.333,2,8,0.25,2,2,1,1,4,5,3,1,0,0,3,12,7.6
Josh Richardson,23-189,G,3/23/17,MIA,TOR,1,35,5,12,0.417,4,8,0.5,1,4,0.25,1,3,0.333,0,2,2,3,0,2,0,4,12,7.3
Garrett Temple,30-262,G,1/25/17,SAC,CLE,1,38,4,9,0.444,3,5,0.6,1,4,0.25,3,3,1,0,4,4,2,4,0,0,3,12,12.7
Taj Gibson,31-151,F,11/22/16,CHI,DEN,1,35,6,11,0.545,6,11,0.545,0,0,,0,0,,5,6,11,4,0,0,0,3,12,13.6
Ryan Anderson,28-339,F,4/10/17,HOU,LAC,1,20,4,9,0.444,2,2,1,2,7,0.286,2,2,1,0,2,2,2,0,0,1,2,12,7.5
Shabazz Muhammad,24-049,F-G,1/1/17,MIN,POR,0,23,5,11,0.455,3,7,0.429,2,4,0.5,0,0,,1,5,6,0,1,0,2,3,12,6.3
David Lee,33-290,F,2/13/17,SAS,IND,0,22,4,5,0.8,4,5,0.8,0,0,,4,5,0.8,3,8,11,1,0,1,2,3,12,12.4
Pau Gasol,36-272,F-C,4/4/17,SAS,MEM,0,31,5,6,0.833,3,4,0.75,2,2,1,0,0,,3,8,11,1,0,2,1,3,12,14.2
Bobby Portis,22-055,F,4/6/17,CHI,PHI,0,21,6,8,0.75,6,7,0.857,0,1,0,0,0,,2,9,11,0,0,0,1,1,12,11.5
Thaddeus Young,28-137,F,11/5/16,IND,CHI,1,25,6,10,0.6,6,8,0.75,0,2,0,0,0,,3,2,5,1,1,1,2,1,12,10.1
T.J. Warren,23-064,F,11/8/16,PHO,POR,1,31,6,12,0.5,6,11,0.545,0,1,0,0,2,0,3,0,3,0,1,0,2,3,12,5.1
Marcelo Huertas,33-198,G,12/9/16,LAL,PHO,0,19,5,7,0.714,3,4,0.75,2,3,0.667,0,0,,0,1,1,3,0,0,1,2,12,9.7
Clint Capela,22-178,F-C,11/12/16,HOU,SAS,1,25,5,9,0.556,5,9,0.556,0,0,,2,2,1,4,6,10,2,0,1,1,4,12,11.8
Terrence Jones,24-362,F,1/5/17,NOP,ATL,0,30,6,12,0.5,6,12,0.5,0,0,,0,1,0,4,7,11,1,1,3,3,0,12,11.3
Wayne Ellington,29-061,G,12/29/16,MIA,CHO,0,17,4,10,0.4,0,1,0,4,9,0.444,0,0,,0,2,2,1,0,0,0,1,12,7.5
Mason Plumlee,26-298,C-F,12/28/16,POR,SAC,1,23,4,6,0.667,4,6,0.667,0,0,,4,5,0.8,2,12,14,2,0,0,2,2,12,12.6
Zach Randolph,35-143,F,12/6/16,MEM,PHI,0,22,5,16,0.313,5,16,0.313,0,0,,2,4,0.5,6,8,14,1,0,0,0,0,12,9.3
Ersan Ilyasova,29-213,F,12/14/16,PHI,TOR,0,23,5,13,0.385,4,8,0.5,1,5,0.2,1,2,0.5,0,7,7,1,0,0,0,2,12,6.5
Myles Turner,20-255,F-C,12/4/16,IND,LAC,1,30,3,7,0.429,3,5,0.6,0,2,0,6,10,0.6,0,3,3,3,1,1,2,1,12,9
Alex Len,23-289,C,4/1/17,PHO,POR,1,16,5,6,0.833,5,6,0.833,0,0,,2,2,1,4,3,7,0,0,2,1,6,12,11.5
Gary Harris,22-140,G,2/1/17,DEN,MEM,1,25,4,4,1,2,2,1,2,2,1,2,2,1,0,2,2,1,1,0,2,0,12,11.1
James Ennis,26-196,F,1/13/17,MEM,HOU,0,28,4,7,0.571,3,5,0.6,1,2,0.5,3,4,0.75,3,3,6,1,0,1,3,4,12,8.1
Quincy Acy,26-168,F,3/23/17,BRK,PHO,0,26,3,8,0.375,2,4,0.5,1,4,0.25,5,6,0.833,0,3,3,4,2,0,1,4,12,10.3
Timofey Mozgov,30-102,C,10/26/16,LAL,HOU,1,22,6,10,0.6,6,10,0.6,0,0,,0,0,,4,4,8,2,0,0,2,2,12,10
Garrett Temple,30-318,G,3/22/17,SAC,MIL,0,24,5,7,0.714,3,3,1,2,4,0.5,0,0,,0,3,3,3,1,0,1,2,12,11.3
Jeremy Lamb,24-259,G-F,2/13/17,CHO,PHI,0,15,4,8,0.5,2,5,0.4,2,3,0.667,2,3,0.667,0,0,0,0,1,0,0,4,12,7
Joe Johnson,35-260,G-F,3/16/17,UTA,CLE,1,29,5,12,0.417,5,8,0.625,0,4,0,2,2,1,0,4,4,3,1,0,1,2,12,8.1
Malcolm Brogdon,24-082,G,3/3/17,MIL,LAC,1,24,4,8,0.5,0,3,0,4,5,0.8,0,0,,0,3,3,0,0,0,1,3,12,6.7
Rodney Hood,24-028,G-F,11/17/16,UTA,CHI,1,34,5,16,0.313,4,9,0.444,1,7,0.143,1,2,0.5,0,6,6,1,0,0,1,2,12,3.1
Rodney Stuckey,30-301,G,2/16/17,IND,WAS,0,21,4,6,0.667,2,3,0.667,2,3,0.667,2,2,1,0,0,0,2,1,0,0,0,12,11.8
Nik Stauskas,23-070,G,12/16/16,PHI,LAL,0,26,4,9,0.444,2,5,0.4,2,4,0.5,2,2,1,0,1,1,3,1,0,2,2,12,7.9
Georgios Papagiannis,19-266,C,3/26/17,SAC,LAC,0,21,6,9,0.667,6,9,0.667,0,0,,0,0,,1,3,4,4,0,2,0,3,12,12.7
Bojan Bogdanovic,27-329,G-F,3/13/17,WAS,MIN,0,25,3,11,0.273,2,5,0.4,1,6,0.167,5,5,1,0,3,3,1,0,0,3,1,12,3.7
Kelly Olynyk,25-348,C-F,4/2/17,BOS,NYK,0,19,5,7,0.714,4,5,0.8,1,2,0.5,1,3,0.333,0,4,4,2,1,2,2,3,12,10.1
Shelvin Mack,26-347,G,4/4/17,UTA,POR,0,26,4,9,0.444,2,7,0.286,2,2,1,2,2,1,1,1,2,5,0,0,3,3,12,7.6
DeMarre Carroll,30-235,F,3/19/17,TOR,IND,1,18,4,7,0.571,0,2,0,4,5,0.8,0,0,,1,5,6,2,0,0,1,2,12,10.5
Davis Bertans,24-073,F,1/24/17,SAS,TOR,0,15,4,6,0.667,2,2,1,2,4,0.5,2,2,1,0,1,1,2,1,0,0,0,12,12.1
Joe Young,24-161,G,12/5/16,IND,GSW,0,10,5,10,0.5,5,8,0.625,0,2,0,2,2,1,0,2,2,0,3,0,0,0,12,10.6
Ramon Sessions,30-242,G,12/9/16,CHO,ORL,0,18,5,8,0.625,3,6,0.5,2,2,1,0,0,,0,3,3,1,0,1,1,0,12,9.7
Alex Len,23-289,C,4/1/17,PHO,POR,1,16,5,6,0.833,5,6,0.833,0,0,,2,2,1,4,3,7,0,0,2,1,6,12,11.5
Gorgui Dieng,27-081,C,4/9/17,MIN,LAL,1,37,4,6,0.667,4,6,0.667,0,0,,4,4,1,2,5,7,4,1,3,1,2,12,16.4
D.J. Augustin,29-013,G,11/23/16,ORL,PHO,0,20,4,9,0.444,2,5,0.4,2,4,0.5,2,3,0.667,0,2,2,2,0,0,2,3,12,5.7
Wayne Ellington,29-163,G,4/10/17,MIA,CLE,0,23,4,8,0.5,0,1,0,4,7,0.571,0,0,,0,2,2,1,1,0,1,1,12,8.9
JaMychal Green,26-158,F,11/26/16,MEM,MIA,1,33,4,6,0.667,1,2,0.5,3,4,0.75,1,2,0.5,1,6,7,1,1,1,0,3,12,12.7
E'Twaun Moore,27-344,G,2/6/17,NOP,PHO,0,30,5,10,0.5,3,5,0.6,2,5,0.4,0,0,,1,3,4,2,4,1,2,3,12,11.5
Richard Jefferson,36-195,F,1/2/17,CLE,NOP,0,29,4,9,0.444,3,5,0.6,1,4,0.25,3,3,1,1,11,12,2,0,0,2,0,12,10.7
Cory Joseph,25-093,G,11/21/16,TOR,LAC,0,18,3,7,0.429,3,7,0.429,0,0,,6,8,0.75,1,3,4,1,3,0,0,2,12,12
Nicolas Batum,28-078,F-G,3/2/17,CHO,PHO,1,35,3,15,0.2,1,6,0.167,2,9,0.222,4,4,1,0,3,3,5,0,0,3,1,12,3.7
Jon Leuer,27-268,F,2/6/17,DET,PHI,1,23,5,9,0.556,4,7,0.571,1,2,0.5,1,1,1,3,2,5,2,0,1,0,5,12,10.5
Cory Joseph,25-170,G,2/6/17,TOR,LAC,0,20,4,9,0.444,4,6,0.667,0,3,0,4,4,1,1,3,4,2,0,0,0,3,12,9.1
Tony Snell,25-143,G-F,4/2/17,MIL,DAL,1,33,4,8,0.5,0,1,0,4,7,0.571,0,0,,0,1,1,1,1,0,2,1,12,7.6
Joe Harris,25-153,G,2/7/17,BRK,CHO,0,27,4,9,0.444,1,2,0.5,3,7,0.429,1,2,0.5,0,4,4,1,0,0,0,6,12,6.4
Jahlil Okafor,20-323,C-F,11/2/16,PHI,CHO,0,24,4,8,0.5,4,8,0.5,0,0,,4,5,0.8,1,4,5,1,1,0,0,3,12,10
Danny Green,29-236,G-F,2/13/17,SAS,IND,1,35,4,9,0.444,2,4,0.5,2,5,0.4,2,2,1,0,6,6,3,0,1,3,4,12,7.3
Jamal Crawford,36-224,G,10/30/16,LAC,UTA,0,21,4,9,0.444,4,6,0.667,0,3,0,4,4,1,0,1,1,1,1,0,0,1,12,8.9
Greg Monroe,26-202,C-F,12/23/16,MIL,WAS,0,21,5,7,0.714,5,7,0.714,0,0,,2,2,1,1,10,11,4,1,1,2,1,12,14.9
Pau Gasol,36-252,F-C,3/15/17,SAS,POR,0,19,5,10,0.5,3,8,0.375,2,2,1,0,0,,2,3,5,1,1,1,2,3,12,8.5
Jeff Teague,28-275,G,3/12/17,IND,MIA,1,31,4,11,0.364,3,10,0.3,1,1,1,3,3,1,1,4,5,4,0,1,2,2,12,8.5
Taj Gibson,31-275,F,3/26/17,OKC,HOU,1,17,6,7,0.857,6,7,0.857,0,0,,0,0,,3,1,4,1,1,0,1,2,12,11.8
Derrick Favors,25-172,F-C,1/3/17,UTA,BOS,1,29,5,10,0.5,5,10,0.5,0,0,,2,2,1,2,4,6,7,0,0,1,4,12,11.9
Courtney Lee,31-170,G,3/22/17,NYK,UTA,1,35,5,8,0.625,3,5,0.6,2,3,0.667,0,0,,0,0,0,3,1,0,1,4,12,8.9
Willy Hernangomez,22-261,C,2/12/17,NYK,SAS,1,29,6,8,0.75,6,8,0.75,0,0,,0,0,,3,6,9,1,3,0,2,3,12,13.2
Jaylen Brown,20-086,F,1/18/17,BOS,NYK,0,19,3,6,0.5,3,6,0.5,0,0,,6,7,0.857,1,3,4,0,0,1,0,2,12,10.1
Robin Lopez,28-315,C,2/10/17,CHI,PHO,1,23,5,9,0.556,5,9,0.556,0,0,,2,2,1,5,2,7,0,0,0,1,3,12,9.6
Kelly Oubre,20-357,F,11/30/16,WAS,OKC,0,28,4,6,0.667,2,3,0.667,2,3,0.667,2,2,1,0,6,6,1,1,0,1,2,12,11.1
Jeff Green,30-160,F,2/4/17,ORL,ATL,0,18,3,7,0.429,2,4,0.5,1,3,0.333,5,5,1,0,5,5,0,1,0,2,0,12,8.8
Alec Burks,25-204,G,2/9/17,UTA,DAL,0,22,5,11,0.455,4,8,0.5,1,3,0.333,1,1,1,0,3,3,1,0,0,2,3,12,4.7
Joe Ingles,29-165,F-G,3/16/17,UTA,CLE,1,36,5,12,0.417,3,7,0.429,2,5,0.4,0,0,,0,4,4,4,1,0,4,2,12,5.8
Taj Gibson,31-245,F,2/24/17,OKC,LAL,0,21,6,13,0.462,6,13,0.462,0,0,,0,0,,1,3,4,1,1,0,0,2,12,7.8
Bradley Beal,23-204,G,1/18/17,WAS,MEM,1,37,4,14,0.286,3,7,0.429,1,7,0.143,3,4,0.75,0,1,1,4,1,0,3,4,12,2.9
Kosta Koufos,27-321,C,1/10/17,SAC,DET,0,22,5,7,0.714,5,7,0.714,0,0,,2,2,1,1,7,8,0,0,1,1,0,12,11.6
David Lee,33-279,F,2/2/17,SAS,PHI,0,17,4,7,0.571,4,7,0.571,0,0,,4,6,0.667,3,6,9,1,2,2,3,1,12,12.5
Sam Dekker,22-234,F,12/26/16,HOU,PHO,0,25,5,10,0.5,3,6,0.5,2,4,0.5,0,0,,2,2,4,0,0,1,0,0,12,9.7
Marc Gasol,32-026,C,2/24/17,MEM,IND,1,32,5,15,0.333,5,12,0.417,0,3,0,2,2,1,2,2,4,4,0,1,1,1,12,7.6
Rondae Hollis-Jefferson,22-060,F,3/4/17,BRK,POR,1,27,6,9,0.667,6,9,0.667,0,0,,0,1,0,5,3,8,5,1,1,2,3,12,14.1
Glenn Robinson,22-344,G-F,12/17/16,IND,DET,1,36,4,9,0.444,4,7,0.571,0,2,0,4,4,1,3,9,12,0,0,0,1,0,12,11.1
Wayne Ellington,29-066,G,1/3/17,MIA,PHO,0,37,4,12,0.333,3,6,0.5,1,6,0.167,3,3,1,0,1,1,1,1,0,2,2,12,4.4
Cory Joseph,25-083,G,11/11/16,TOR,CHO,0,25,4,8,0.5,2,5,0.4,2,3,0.667,2,2,1,0,4,4,2,0,1,2,2,12,8.5
Terrence Ross,25-345,F-G,1/15/17,TOR,NYK,0,23,4,7,0.571,0,1,0,4,6,0.667,0,0,,0,2,2,1,0,0,0,1,12,9.6
David Lee,33-243,F,12/28/16,SAS,PHO,0,16,6,7,0.857,6,7,0.857,0,0,,0,0,,2,1,3,2,0,0,1,0,12,11.6
Timofey Mozgov,30-199,C,1/31/17,LAL,DEN,1,23,4,5,0.8,4,5,0.8,0,0,,4,4,1,1,5,6,0,0,3,1,3,12,12.2
Julius Randle,22-121,F,3/30/17,LAL,MIN,1,29,5,12,0.417,4,9,0.444,1,3,0.333,1,1,1,6,7,13,1,0,1,3,5,12,8.3
Hassan Whiteside,27-231,C,1/30/17,MIA,BRK,1,30,6,10,0.6,6,10,0.6,0,0,,0,0,,1,8,9,0,1,3,4,6,12,7.2
Tyson Chandler,34-033,C,11/4/16,PHO,NOP,1,36,5,8,0.625,5,8,0.625,0,0,,2,2,1,3,15,18,1,0,0,0,2,12,14.9
Willie Reed,26-309,F-C,3/21/17,MIA,PHO,0,17,4,5,0.8,4,5,0.8,0,0,,4,4,1,6,1,7,0,0,0,0,5,12,12.6
Jonathon Simmons,27-205,G-F,4/7/17,SAS,DAL,1,38,5,19,0.263,5,14,0.357,0,5,0,2,4,0.5,0,5,5,2,1,0,0,1,12,3.4
Blake Griffin,28-005,F,3/21/17,LAC,LAL,1,26,2,9,0.222,1,5,0.2,1,4,0.25,7,8,0.875,1,2,3,8,0,0,4,2,12,8.2
Mason Plumlee,26-356,C-F,2/24/17,DEN,BRK,0,23,5,8,0.625,5,8,0.625,0,0,,2,4,0.5,2,10,12,8,0,0,1,5,12,14.6
Sergio Rodriguez,30-136,G,10/26/16,PHI,OKC,1,32,5,11,0.455,3,5,0.6,2,6,0.333,0,0,,0,4,4,9,0,0,0,1,12,13.4
J.J. Redick,32-133,G,11/4/16,LAC,MEM,1,28,4,10,0.4,3,6,0.5,1,4,0.25,3,3,1,0,1,1,0,2,0,2,0,12,6.9
Nick Young,31-156,G-F,11/4/16,LAL,GSW,1,24,4,11,0.364,3,5,0.6,1,6,0.167,3,3,1,1,2,3,2,0,1,0,4,12,7.7
Jeremy Lin,28-228,G,4/8/17,BRK,CHI,1,29,4,14,0.286,2,10,0.2,2,4,0.5,2,2,1,1,5,6,7,3,0,2,2,12,11.1
DeMar DeRozan,27-105,G,11/20/16,TOR,SAC,1,39,3,15,0.2,3,14,0.214,0,1,0,6,6,1,3,6,9,4,0,0,3,3,12,5.2
Jameer Nelson,35-014,G,2/23/17,DEN,SAC,1,29,5,9,0.556,3,5,0.6,2,4,0.5,0,0,,0,4,4,6,5,0,1,3,12,15.9
Eric Bledsoe,26-357,G,11/30/16,PHO,ATL,1,28,5,17,0.294,5,14,0.357,0,3,0,2,2,1,2,4,6,4,2,1,1,1,12,8.8
Timothe Luwawu-Cabarrot,21-334,F,4/8/17,PHI,MIL,1,34,3,11,0.273,1,5,0.2,2,6,0.333,4,4,1,1,3,4,2,4,0,1,0,12,11.5
Bobby Portis,22-061,F,4/12/17,CHI,BRK,0,25,5,11,0.455,4,9,0.444,1,2,0.5,1,2,0.5,2,8,10,3,2,0,1,1,12,12.4
Brandon Ingram,19-063,F,11/4/16,LAL,GSW,0,27,2,8,0.25,2,4,0.5,0,4,0,8,9,0.889,2,4,6,3,2,0,2,2,12,10.7
Aaron Gordon,21-200,F,4/4/17,ORL,CLE,1,32,5,14,0.357,3,10,0.3,2,4,0.5,0,0,,2,3,5,0,0,0,4,2,12,1.7
Seth Curry,26-220,G,3/31/17,DAL,MEM,1,14,3,5,0.6,0,2,0,3,3,1,3,3,1,0,1,1,0,1,0,0,3,12,9.8
Jerian Grant,24-115,G,2/1/17,CHI,OKC,1,26,5,7,0.714,3,5,0.6,2,2,1,0,0,,0,3,3,3,0,0,1,1,12,10.7
Nerlens Noel,22-309,C-F,2/13/17,PHI,CHO,1,28,5,6,0.833,5,6,0.833,0,0,,2,3,0.667,1,6,7,1,3,2,1,2,12,15.2
Jusuf Nurkic,22-201,C,3/12/17,POR,PHO,1,30,6,9,0.667,6,9,0.667,0,0,,0,0,,2,9,11,2,0,2,2,5,12,11
Kent Bazemore,27-224,G-F,2/10/17,ATL,SAC,1,33,5,11,0.455,4,7,0.571,1,4,0.25,1,2,0.5,0,6,6,2,1,3,1,1,12,10.8
Langston Galloway,24-339,G,11/12/16,NOP,LAL,0,22,5,12,0.417,3,6,0.5,2,6,0.333,0,0,,2,4,6,2,1,0,1,0,12,9.6
Marcus Smart,22-278,G,12/9/16,BOS,TOR,1,36,3,11,0.273,0,4,0,3,7,0.429,3,5,0.6,1,3,4,5,0,0,2,1,12,7.4
George Hill,30-267,G,1/26/17,UTA,LAL,1,34,4,14,0.286,3,9,0.333,1,5,0.2,3,4,0.75,3,4,7,3,3,0,1,0,12,10.8
Marcus Smart,23-006,G,3/12/17,BOS,CHI,0,27,4,10,0.4,2,3,0.667,2,7,0.286,2,2,1,1,5,6,3,2,0,2,1,12,10.5
Jordan Clarkson,24-145,G,10/30/16,LAL,OKC,0,29,6,14,0.429,6,11,0.545,0,3,0,0,0,,2,3,5,2,3,0,4,2,12,6.5
Thomas Robinson,26-016,F,4/2/17,LAL,MEM,0,20,5,9,0.556,5,9,0.556,0,0,,2,5,0.4,5,5,10,1,1,0,2,2,12,10.4
Trevor Booker,28-345,F,11/4/16,BRK,CHO,1,28,5,9,0.556,5,8,0.625,0,1,0,2,2,1,4,9,13,1,1,2,1,2,12,14.5
Danny Green,29-233,G-F,2/10/17,SAS,DET,1,30,4,5,0.8,0,0,,4,5,0.8,0,0,,0,4,4,0,0,0,0,2,12,10.5
Andrew Harrison,22-159,G,4/5/17,MEM,OKC,1,37,3,7,0.429,2,5,0.4,1,2,0.5,5,6,0.833,1,2,3,3,0,0,2,1,12,8.9
Tiago Splitter,32-101,F-C,4/12/17,PHI,NYK,0,22,5,12,0.417,4,9,0.444,1,3,0.333,1,2,0.5,3,2,5,0,1,0,1,3,12,6.7
Evan Turner,28-021,G,11/17/16,POR,HOU,0,28,5,13,0.385,5,12,0.417,0,1,0,2,2,1,1,3,4,3,2,0,1,4,12,8
Brandon Jennings,27-068,G,11/30/16,NYK,MIN,0,34,5,14,0.357,3,9,0.333,2,5,0.4,0,0,,1,1,2,7,2,0,4,2,12,7.3
Caris LeVert,22-153,G-F,1/25/17,BRK,MIA,0,26,4,8,0.5,3,3,1,1,5,0.2,3,4,0.75,0,1,1,4,0,0,1,1,12,9.3
Lou Williams,30-051,G,12/17/16,LAL,CLE,0,27,2,10,0.2,2,6,0.333,0,4,0,8,10,0.8,1,2,3,4,0,1,0,1,12,9.4
Bojan Bogdanovic,27-256,G-F,12/30/16,BRK,WAS,1,21,4,10,0.4,2,6,0.333,2,4,0.5,2,2,1,1,2,3,1,1,0,0,1,12,9.2
Tristan Thompson,25-259,F-C,11/27/16,CLE,PHI,1,36,5,8,0.625,5,8,0.625,0,0,,2,4,0.5,5,7,12,0,0,2,1,4,12,12
Michael Kidd-Gilchrist,23-096,F,12/31/16,CHO,CLE,1,35,5,8,0.625,5,8,0.625,0,0,,2,3,0.667,5,3,8,0,0,1,1,3,12,10.9
Jonas Valanciunas,24-284,C,2/14/17,TOR,CHI,1,22,6,11,0.545,6,11,0.545,0,0,,0,0,,5,4,9,0,0,0,1,2,12,9.6
Michael Beasley,27-356,F,12/30/16,MIL,MIN,0,20,5,10,0.5,5,9,0.556,0,1,0,2,2,1,0,5,5,3,0,0,1,3,12,8.4
Clint Capela,22-273,F-C,2/15/17,HOU,MIA,1,16,5,7,0.714,5,7,0.714,0,0,,2,3,0.667,0,2,2,0,0,0,0,3,12,8.1
Rudy Gobert,24-211,C,1/23/17,UTA,OKC,1,36,5,9,0.556,5,9,0.556,0,0,,2,7,0.286,3,7,10,1,0,4,1,3,12,11.2
Brandon Ingram,19-191,F,3/12/17,LAL,PHI,1,38,5,9,0.556,5,6,0.833,0,3,0,2,2,1,0,3,3,1,3,2,3,1,12,10.3
Kawhi Leonard,25-263,F,3/19/17,SAS,SAC,1,26,3,12,0.25,2,6,0.333,1,6,0.167,5,6,0.833,1,1,2,3,2,0,0,1,12,9.1
Al Horford,30-257,C-F,2/15/17,BOS,PHI,1,29,4,8,0.5,2,5,0.4,2,3,0.667,2,3,0.667,0,5,5,2,2,0,4,3,12,7.3
Brandon Knight,24-353,G,11/19/16,PHO,PHI,0,21,3,9,0.333,2,7,0.286,1,2,0.5,5,6,0.833,1,1,2,2,1,0,0,1,12,9.5
Alan Williams,23-296,F-C,11/19/16,PHO,PHI,0,23,5,8,0.625,5,8,0.625,0,0,,2,4,0.5,4,7,11,0,2,4,1,4,12,14.7
Markieff Morris,27-122,F,1/2/17,WAS,HOU,1,33,5,11,0.455,5,7,0.714,0,4,0,2,3,0.667,1,7,8,3,0,1,2,5,12,7.5
Danny Green,29-225,G-F,2/2/17,SAS,PHI,1,29,5,10,0.5,3,5,0.6,2,5,0.4,0,0,,1,3,4,0,2,0,0,3,12,9.4
Jonas Valanciunas,24-194,C,11/16/16,TOR,GSW,1,18,6,6,1,6,6,1,0,0,,0,0,,3,5,8,0,0,0,1,1,12,12.4
Al Horford,30-282,C-F,3/12/17,BOS,CHI,1,32,5,7,0.714,3,5,0.6,2,2,1,0,0,,3,4,7,6,1,2,4,1,12,14.6
Jeff Green,30-189,F,3/5/17,ORL,WAS,0,22,5,11,0.455,4,9,0.444,1,2,0.5,1,2,0.5,0,2,2,0,0,0,0,0,12,6.5
Jonas Valanciunas,24-234,C,12/26/16,TOR,POR,1,27,5,13,0.385,5,13,0.385,0,0,,2,2,1,3,10,13,1,1,1,0,2,12,11.6
Troy Daniels,25-175,G,1/6/17,MEM,GSW,0,21,4,8,0.5,0,1,0,4,7,0.571,0,0,,0,1,1,1,1,0,2,0,12,8
Clint Capela,22-252,F-C,1/25/17,HOU,BOS,1,20,5,10,0.5,5,10,0.5,0,0,,2,7,0.286,2,5,7,1,0,2,1,2,12,8.2
Cheick Diallo,20-211,F,4/12/17,NOP,POR,0,29,4,9,0.444,4,9,0.444,0,0,,4,5,0.8,4,12,16,0,1,1,1,4,12,12.4
Caris LeVert,22-228,G-F,4/10/17,BRK,BOS,1,28,4,12,0.333,2,6,0.333,2,6,0.333,2,2,1,0,3,3,2,0,1,1,2,12,6.4
Russell Westbrook,28-143,G,4/4/17,OKC,MIL,1,27,4,12,0.333,2,8,0.25,2,4,0.5,2,2,1,3,10,13,13,2,0,3,2,12,17.6
Andrew Harrison,22-060,G,12/27/16,MEM,BOS,1,44,4,12,0.333,4,8,0.5,0,4,0,4,8,0.5,2,3,5,6,2,0,1,4,12,9.5
Willy Hernangomez,22-259,C,2/10/17,NYK,DEN,0,9,6,7,0.857,6,7,0.857,0,0,,0,0,,2,2,4,0,0,0,1,0,12,10.5
Myles Turner,20-337,F-C,2/24/17,IND,MEM,1,34,6,7,0.857,6,7,0.857,0,0,,0,0,,0,6,6,2,3,2,1,2,12,15.3
Dennis Schroder,23-062,G,11/16/16,ATL,MIL,1,31,3,8,0.375,1,4,0.25,2,4,0.5,4,4,1,0,3,3,8,1,0,3,1,12,11.7
Gorgui Dieng,26-304,C,11/17/16,MIN,PHI,1,29,4,11,0.364,4,11,0.364,0,0,,4,4,1,3,7,10,3,1,1,2,5,12,9.9
Marcin Gortat,32-339,C-F,1/21/17,WAS,DET,1,25,4,6,0.667,4,6,0.667,0,0,,4,5,0.8,1,6,7,2,2,0,1,3,12,12.7
Trevor Ariza,31-204,F,1/20/17,HOU,GSW,1,34,5,12,0.417,3,4,0.75,2,8,0.25,0,0,,0,3,3,2,0,0,2,1,12,5.5
Patty Mills,28-175,G,2/2/17,SAS,PHI,0,18,5,9,0.556,3,6,0.5,2,3,0.667,0,0,,0,2,2,4,0,0,1,1,12,9.7
Matthew Dellavedova,26-188,G,3/15/17,MIL,LAC,0,32,4,8,0.5,1,5,0.2,3,3,1,1,1,1,0,2,2,3,1,0,2,5,12,7.7
Patrick Patterson,27-266,F,12/5/16,TOR,CLE,0,30,3,12,0.25,0,5,0,3,7,0.429,3,4,0.75,3,6,9,0,0,0,2,3,12,5.1
Aron Baynes,30-117,C,4/5/17,DET,TOR,0,19,5,5,1,5,5,1,0,0,,2,2,1,3,4,7,0,0,1,3,4,12,9.9
Jeremy Lamb,24-185,G-F,12/1/16,CHO,DAL,0,19,3,7,0.429,2,5,0.4,1,2,0.5,5,5,1,1,5,6,2,0,1,3,1,12,9.2
Gorgui Dieng,27-010,C,1/28/17,MIN,BRK,1,34,4,9,0.444,4,9,0.444,0,0,,4,4,1,1,9,10,4,2,0,2,3,12,12.3
John Wall,26-175,G,2/28/17,WAS,GSW,1,40,6,20,0.3,6,19,0.316,0,1,0,0,0,,2,4,6,19,3,0,5,0,12,14.3
Brandon Knight,25-063,G,2/3/17,PHO,SAC,0,19,5,9,0.556,3,5,0.6,2,4,0.5,0,0,,0,2,2,1,0,0,2,0,12,7
Sergio Rodriguez,30-285,G,3/24/17,PHI,CHI,0,22,5,10,0.5,3,5,0.6,2,5,0.4,0,0,,0,4,4,7,1,0,2,1,12,11.7
Josh Richardson,23-071,G,11/25/16,MIA,MEM,1,27,4,9,0.444,0,2,0,4,7,0.571,0,0,,0,3,3,4,1,0,0,1,12,11.6
Michael Kidd-Gilchrist,23-109,F,1/13/17,CHO,PHI,1,35,2,6,0.333,2,6,0.333,0,0,,8,8,1,4,8,12,4,1,1,1,3,12,16.1
Al-Farouq Aminu,26-105,F,1/4/17,POR,GSW,1,33,4,7,0.571,2,4,0.5,2,3,0.667,2,2,1,1,6,7,5,2,0,4,6,12,10.3
Avery Bradley,26-102,G,3/8/17,BOS,GSW,1,30,6,15,0.4,6,12,0.5,0,3,0,0,0,,3,3,6,1,1,1,1,1,12,7.9
Robin Lopez,28-271,C,12/28/16,CHI,BRK,1,31,5,8,0.625,5,8,0.625,0,0,,2,2,1,1,4,5,1,0,2,1,1,12,11
Dwight Howard,31-028,C,1/5/17,ATL,NOP,1,30,5,8,0.625,5,8,0.625,0,0,,2,4,0.5,4,8,12,1,0,1,1,3,12,12
Solomon Hill,25-332,F,2/13/17,NOP,PHO,1,31,2,5,0.4,1,1,1,1,4,0.25,7,8,0.875,0,4,4,0,0,0,1,2,12,8.3
Kenneth Faried,27-117,F,3/16/17,DEN,LAC,0,18,5,9,0.556,5,9,0.556,0,0,,2,3,0.667,2,4,6,1,0,0,0,1,12,10.2
Tyler Johnson,24-326,G,3/29/17,MIA,NYK,0,31,5,12,0.417,3,8,0.375,2,4,0.5,0,1,0,3,4,7,1,0,0,0,0,12,9.2
Josh Richardson,23-074,G,11/28/16,MIA,BOS,0,29,4,9,0.444,1,1,1,3,8,0.375,1,2,0.5,1,3,4,0,2,0,1,3,12,8.3
Elfrid Payton,22-319,G,1/6/17,ORL,HOU,1,25,6,10,0.6,6,9,0.667,0,1,0,0,0,,1,1,2,2,2,0,1,0,12,10.8
Bobby Portis,22-030,F,3/12/17,CHI,BOS,1,21,6,15,0.4,6,12,0.5,0,3,0,0,0,,3,5,8,0,0,0,1,0,12,6.5
Michael Kidd-Gilchrist,23-091,F,12/26/16,CHO,BRK,1,35,5,10,0.5,5,10,0.5,0,0,,2,2,1,2,8,10,2,0,2,0,1,12,13.2
Corey Brewer,31-019,F-G,3/24/17,LAL,MIN,0,16,5,8,0.625,4,6,0.667,1,2,0.5,1,1,1,2,1,3,1,0,0,1,2,12,9
Tony Parker,34-272,G,2/13/17,SAS,IND,1,29,4,8,0.5,4,8,0.5,0,0,,4,4,1,0,1,1,4,0,0,1,1,12,9.7
Jamal Crawford,36-252,G,11/27/16,LAC,IND,0,34,5,12,0.417,3,8,0.375,2,4,0.5,0,0,,0,0,0,2,0,0,1,1,12,5.6
Kristaps Porzingis,21-235,F-C,3/25/17,NYK,SAS,1,26,3,8,0.375,3,7,0.429,0,1,0,6,6,1,0,5,5,2,1,1,5,5,12,5.2
Chasson Randle,24-034,G,3/11/17,NYK,DET,0,19,4,10,0.4,0,3,0,4,7,0.571,0,0,,0,3,3,3,0,0,1,2,12,7.8
Brandon Rush,31-188,G-F,1/11/17,MIN,HOU,1,36,4,8,0.5,0,1,0,4,7,0.571,0,0,,2,1,3,3,3,3,0,1,12,16.5
Dwyane Wade,34-288,G,10/31/16,CHI,BRK,1,29,5,13,0.385,4,10,0.4,1,3,0.333,1,1,1,0,3,3,4,3,1,5,3,12,6.1
Tim Hardaway,24-311,G,1/21/17,ATL,PHI,0,27,5,14,0.357,3,7,0.429,2,7,0.286,0,0,,2,1,3,6,2,0,4,0,12,8.1
Tristan Thompson,25-303,F-C,1/10/17,CLE,UTA,1,35,5,8,0.625,5,8,0.625,0,0,,2,5,0.4,6,6,12,1,0,0,1,3,12,11.7
Rudy Gobert,24-139,C,11/12/16,UTA,MIA,1,33,3,6,0.5,3,6,0.5,0,0,,6,8,0.75,2,10,12,0,2,2,1,5,12,13
Raymond Felton,32-248,G,3/1/17,LAC,HOU,0,19,5,8,0.625,5,7,0.714,0,1,0,2,3,0.667,1,4,5,1,1,0,0,0,12,11.6
Jon Leuer,27-307,F,3/17/17,DET,TOR,0,29,5,8,0.625,4,5,0.8,1,3,0.333,1,1,1,2,3,5,2,0,1,1,1,12,11.4
Marcin Gortat,32-365,C-F,2/16/17,WAS,IND,1,34,6,10,0.6,6,10,0.6,0,0,,0,0,,1,6,7,0,1,0,1,3,12,8.7
Patrick Beverley,28-190,G,1/18/17,HOU,MIL,1,34,5,10,0.5,3,6,0.5,2,4,0.5,0,0,,2,7,9,5,3,2,3,2,12,14.6
Matt Barnes,36-234,F,10/29/16,SAC,MIN,0,27,4,10,0.4,1,4,0.25,3,6,0.5,1,2,0.5,0,5,5,9,1,1,2,4,12,12.1
Marcus Smart,22-267,G,11/28/16,BOS,MIA,0,33,3,8,0.375,2,5,0.4,1,3,0.333,5,9,0.556,0,2,2,4,1,0,3,5,12,5.4
Maurice Harkless,23-311,F-G,3/18/17,POR,ATL,1,30,5,7,0.714,4,6,0.667,1,1,1,1,2,0.5,1,3,4,4,2,1,2,3,12,12.6
Jusuf Nurkic,22-207,C,3/18/17,POR,ATL,1,32,6,11,0.545,6,11,0.545,0,0,,0,0,,2,7,9,6,2,5,5,4,12,13.3
Glenn Robinson,22-357,G-F,12/30/16,IND,CHI,1,24,4,4,1,3,3,1,1,1,1,3,4,0.75,2,8,10,1,1,0,2,1,12,13.5
Jonathon Simmons,27-120,G-F,1/12/17,SAS,LAL,0,21,6,8,0.75,6,7,0.857,0,1,0,0,0,,0,3,3,3,0,0,1,3,12,9.6
Kyle O'Quinn,26-292,F-C,1/12/17,NYK,CHI,0,17,5,7,0.714,5,7,0.714,0,0,,2,2,1,2,9,11,3,0,4,1,2,12,16.3
Blake Griffin,27-266,F,12/7/16,LAC,GSW,1,31,5,20,0.25,5,19,0.263,0,1,0,2,4,0.5,4,5,9,2,1,0,7,4,12,-2.7
Tyreke Evans,27-100,G-F,12/28/16,NOP,LAC,0,16,5,9,0.556,3,5,0.6,2,4,0.5,0,0,,1,4,5,5,0,0,1,2,12,11.3
Tyler Johnson,24-333,G,4/5/17,MIA,CHO,0,29,3,9,0.333,0,4,0,3,5,0.6,3,4,0.75,1,1,2,3,0,0,0,0,12,9.6
Jared Dudley,31-154,F-G,12/11/16,PHO,NOP,0,19,4,6,0.667,0,1,0,4,5,0.8,0,0,,2,1,3,1,0,0,2,1,12,9.4
Tristan Thompson,26-020,F-C,4/2/17,CLE,IND,1,43,5,7,0.714,5,7,0.714,0,0,,2,4,0.5,5,4,9,0,1,0,2,4,12,10.4
Greg Monroe,26-286,C-F,3/17/17,MIL,LAL,0,16,6,6,1,6,6,1,0,0,,0,0,,1,5,6,3,1,3,1,1,12,16.2
Paul Zipser,23-031,G-F,3/21/17,CHI,TOR,1,41,5,9,0.556,3,4,0.75,2,5,0.4,0,0,,1,4,5,4,1,2,3,5,12,9.8
Thabo Sefolosha,32-301,G-F,2/27/17,ATL,BOS,1,21,5,6,0.833,3,4,0.75,2,2,1,0,0,,0,3,3,2,2,2,1,3,12,13.3
Malcolm Brogdon,24-035,G,1/15/17,MIL,ATL,1,26,5,10,0.5,3,7,0.429,2,3,0.667,0,0,,0,0,0,0,2,1,2,2,12,6.9
Gary Harris,22-100,G,12/23/16,DEN,ATL,1,30,5,12,0.417,5,9,0.556,0,3,0,2,3,0.667,2,0,2,4,1,1,0,1,12,10.7
Rudy Gobert,24-184,C,12/27/16,UTA,LAL,1,37,4,6,0.667,4,5,0.8,0,1,0,4,8,0.5,6,5,11,1,1,2,6,4,12,9
Dwyane Wade,34-341,G,12/23/16,CHI,CHO,1,26,5,16,0.313,5,15,0.333,0,1,0,2,2,1,1,6,7,2,2,0,1,2,12,6.9
Pau Gasol,36-131,F-C,11/14/16,SAS,MIA,1,31,6,15,0.4,6,14,0.429,0,1,0,0,2,0,2,6,8,2,1,1,1,2,12,7.6
J.R. Smith,31-208,G-F,4/5/17,CLE,BOS,1,31,5,10,0.5,3,3,1,2,7,0.286,0,0,,1,2,3,0,1,1,0,1,12,9.6
Robin Lopez,28-211,C,10/29/16,CHI,IND,1,19,5,7,0.714,5,7,0.714,0,0,,2,2,1,2,4,6,2,0,2,0,3,12,13.3
Maurice Harkless,23-231,F-G,12/28/16,POR,SAC,1,33,5,7,0.714,3,4,0.75,2,3,0.667,0,0,,0,4,4,1,1,0,2,3,12,8.8
Dwyane Wade,34-334,G,12/16/16,CHI,MIL,1,24,5,14,0.357,4,12,0.333,1,2,0.5,1,2,0.5,0,5,5,1,1,0,0,0,12,7
Thon Maker,19-342,F-C,2/1/17,MIL,UTA,1,24,4,8,0.5,1,4,0.25,3,4,0.75,1,4,0.25,3,2,5,1,1,3,0,4,12,11.7
Steven Adams,23-175,C,1/11/17,OKC,MEM,1,39,6,13,0.462,6,13,0.462,0,0,,0,1,0,4,4,8,1,1,2,0,2,12,11.2
Michael Carter-Williams,25-125,G,2/12/17,CHI,MIN,1,30,4,12,0.333,3,11,0.273,1,1,1,3,5,0.6,0,7,7,6,2,0,6,3,12,5.5
John Wall,26-176,G,3/1/17,WAS,TOR,1,34,4,12,0.333,4,10,0.4,0,2,0,4,4,1,1,3,4,13,0,1,3,1,12,13.2
Vince Carter,39-358,G-F,1/18/17,MEM,WAS,0,30,4,9,0.444,1,3,0.333,3,6,0.5,1,2,0.5,0,2,2,1,3,0,1,0,12,10.2
Andre Iguodala,33-001,G-F,1/29/17,GSW,POR,0,36,4,6,0.667,1,2,0.5,3,4,0.75,1,1,1,0,3,3,5,2,0,0,2,12,15
Kyle O'Quinn,26-255,F-C,12/6/16,NYK,MIA,0,27,6,8,0.75,6,8,0.75,0,0,,0,1,0,5,2,7,3,1,2,1,4,12,14.4
Aron Baynes,30-096,C,3/15/17,DET,UTA,0,23,6,11,0.545,6,11,0.545,0,0,,0,0,,6,6,12,2,0,1,1,3,12,12.6
Kentavious Caldwell-Pope,23-316,G,12/30/16,DET,ATL,1,39,3,11,0.273,1,3,0.333,2,8,0.25,4,4,1,0,4,4,1,3,1,5,1,12,5.7
Jonas Valanciunas,24-203,C,11/25/16,TOR,MIL,1,31,6,11,0.545,6,11,0.545,0,0,,0,0,,3,4,7,0,0,0,1,3,12,7.8
Tyson Chandler,34-092,C,1/2/17,PHO,LAC,1,23,3,3,1,3,3,1,0,0,,6,6,1,2,4,6,1,1,0,1,4,12,12.8
Monta Ellis,31-025,G,11/20/16,IND,OKC,1,42,5,10,0.5,4,8,0.5,1,2,0.5,1,1,1,0,4,4,7,2,0,8,2,12,6.3
Tony Allen,34-324,G-F,11/30/16,MEM,TOR,1,29,4,8,0.5,4,7,0.571,0,1,0,4,5,0.8,4,0,4,2,1,0,3,4,12,8.2
David Lee,33-320,F,3/15/17,SAS,POR,0,19,5,6,0.833,5,6,0.833,0,0,,2,3,0.667,2,3,5,1,0,0,0,1,12,12
Reggie Jackson,26-289,G,1/30/17,DET,BOS,1,28,4,12,0.333,4,9,0.444,0,3,0,4,6,0.667,0,2,2,6,2,0,2,6,12,6.8
Montrezl Harrell,22-358,F-C,1/18/17,HOU,MIL,1,27,5,8,0.625,5,8,0.625,0,0,,2,3,0.667,4,4,8,4,0,5,2,2,12,15.5
Justin Anderson,23-132,G,3/31/17,PHI,CLE,1,31,4,8,0.5,2,4,0.5,2,4,0.5,2,2,1,3,6,9,3,0,1,2,3,12,11.5
Kentavious Caldwell-Pope,24-037,G,3/27/17,DET,NYK,1,32,3,12,0.25,1,5,0.2,2,7,0.286,4,4,1,1,1,2,1,1,0,3,0,12,4.5
Kentavious Caldwell-Pope,23-354,G,2/6/17,DET,PHI,1,29,4,11,0.364,2,5,0.4,2,6,0.333,2,2,1,1,3,4,3,1,0,2,1,12,8.2
Terrence Ross,25-335,F-G,1/5/17,TOR,UTA,0,30,5,12,0.417,3,4,0.75,2,8,0.25,0,0,,0,0,0,1,0,2,0,2,12,6.9
Garrett Temple,30-171,G,10/26/16,SAC,PHO,0,18,6,8,0.75,6,7,0.857,0,1,0,0,0,,1,1,2,3,0,0,2,2,12,9.1
Jerian Grant,24-122,G,2/8/17,CHI,GSW,1,25,3,6,0.5,2,3,0.667,1,3,0.333,5,5,1,0,3,3,3,1,0,2,2,12,10.2
Shabazz Muhammad,24-147,F-G,4/9/17,MIN,LAL,0,18,4,9,0.444,4,5,0.8,0,4,0,4,5,0.8,1,1,2,0,0,0,2,0,12,5.9
Brook Lopez,28-297,C,1/23/17,BRK,SAS,1,21,4,10,0.4,4,9,0.444,0,1,0,4,4,1,3,1,4,1,1,1,4,3,12,6.2
Meyers Leonard,24-249,C-F,11/2/16,POR,PHO,0,27,5,10,0.5,3,5,0.6,2,5,0.4,0,0,,1,4,5,3,0,0,0,5,12,9
Rodney Stuckey,30-220,G,11/27/16,IND,LAC,0,27,4,10,0.4,4,8,0.5,0,2,0,4,5,0.8,1,4,5,2,1,0,4,1,12,6.1
Josh Richardson,23-058,G,11/12/16,MIA,UTA,1,33,6,16,0.375,6,13,0.462,0,3,0,0,0,,0,3,3,4,2,1,1,3,12,7.4
Nerlens Noel,22-339,C-F,3/15/17,DAL,WAS,0,23,4,8,0.5,4,8,0.5,0,0,,4,4,1,1,2,3,1,0,1,1,2,12,8.9
Thomas Robinson,25-290,F,1/1/17,LAL,TOR,0,17,6,9,0.667,6,9,0.667,0,0,,0,0,,7,2,9,2,1,0,1,2,12,14.2
Dante Exum,21-217,G,2/15/17,UTA,POR,0,20,6,9,0.667,6,9,0.667,0,0,,0,0,,0,2,2,1,1,0,1,3,12,8.2
Buddy Hield,23-113,G,4/9/17,SAC,HOU,1,32,4,16,0.25,3,8,0.375,1,8,0.125,3,4,0.75,1,5,6,3,0,0,1,3,12,4.1
Jodie Meeks,29-146,G,1/14/17,ORL,UTA,1,38,3,8,0.375,0,0,,3,8,0.375,3,4,0.75,0,3,3,6,1,0,2,4,12,9.7
Arron Afflalo,31-158,G,3/22/17,SAC,MIL,1,23,5,9,0.556,3,4,0.75,2,5,0.4,0,0,,0,2,2,0,0,0,2,3,12,5.1
Markieff Morris,27-085,F,11/26/16,WAS,SAS,1,18,4,9,0.444,2,6,0.333,2,3,0.667,2,2,1,1,0,1,1,1,0,1,4,12,7.1
Norman Powell,23-289,G,3/10/17,TOR,ATL,0,18,4,10,0.4,4,7,0.571,0,3,0,4,5,0.8,1,3,4,0,3,0,2,2,12,8
Darren Collison,29-218,G,3/29/17,SAC,UTA,1,22,4,8,0.5,4,8,0.5,0,0,,4,4,1,0,2,2,1,1,0,2,0,12,8.3
Cody Zeller,24-061,F-C,12/5/16,CHO,DAL,1,24,5,5,1,5,5,1,0,0,,2,2,1,1,1,2,1,0,1,3,4,12,8.3
Steven Adams,23-133,C,11/30/16,OKC,WAS,1,28,3,6,0.5,3,6,0.5,0,0,,6,10,0.6,2,4,6,0,0,0,1,1,12,8.6
E'Twaun Moore,27-269,G,11/23/16,NOP,MIN,1,25,6,9,0.667,6,8,0.75,0,1,0,0,0,,0,3,3,2,1,1,1,0,12,11.1
Gary Harris,22-053,G,11/6/16,DEN,BOS,1,22,5,10,0.5,4,8,0.5,1,2,0.5,1,1,1,0,4,4,1,1,1,0,5,12,8.6
Shelvin Mack,26-204,G,11/12/16,UTA,MIA,0,23,6,8,0.75,6,6,1,0,2,0,0,0,,0,2,2,2,0,0,1,3,12,8.6
Kristaps Porzingis,21-142,F-C,12/22/16,NYK,ORL,1,27,5,11,0.455,3,9,0.333,2,2,1,0,0,,2,2,4,1,1,2,3,1,12,8
Michael Kidd-Gilchrist,23-093,F,12/28/16,CHO,ORL,1,30,5,9,0.556,5,9,0.556,0,0,,2,2,1,3,3,6,4,2,0,1,2,12,13.7
Marco Belinelli,30-243,G-F,11/23/16,CHO,SAS,0,21,5,11,0.455,4,6,0.667,1,5,0.2,1,2,0.5,1,3,4,1,0,0,0,3,12,7
Al Horford,30-313,C-F,4/12/17,BOS,MIL,1,21,5,8,0.625,5,6,0.833,0,2,0,2,2,1,0,6,6,2,2,0,1,0,12,12.6
Wilson Chandler,29-221,F,12/17/16,DEN,NYK,1,27,5,14,0.357,3,7,0.429,2,7,0.286,0,0,,1,0,1,3,1,0,1,5,12,5
Jodie Meeks,29-145,G,1/13/17,ORL,POR,0,19,3,6,0.5,1,4,0.25,2,2,1,4,4,1,0,1,1,1,1,0,4,1,12,6.6
T.J. McConnell,25-016,G,4/10/17,PHI,IND,1,37,5,8,0.625,5,7,0.714,0,1,0,2,2,1,0,5,5,8,3,0,5,3,12,12.3
LaMarcus Aldridge,31-144,F-C,12/10/16,SAS,BRK,1,22,6,10,0.6,6,10,0.6,0,0,,0,0,,4,5,9,3,0,1,1,2,12,12.7
DeAndre Jordan,28-243,C,3/21/17,LAC,LAL,1,23,6,9,0.667,6,9,0.667,0,0,,0,0,,6,5,11,1,0,2,1,1,12,14.5
Devin Harris,34-028,G,3/27/17,DAL,OKC,0,21,4,7,0.571,3,4,0.75,1,3,0.333,3,3,1,1,5,6,1,2,1,3,0,12,11.3
John Henson,25-325,C-F,11/17/16,MIL,MIA,1,28,5,8,0.625,5,8,0.625,0,0,,2,2,1,1,4,5,0,1,2,1,4,12,10.1
Beno Udrih,34-129,G,11/11/16,DET,SAS,0,18,4,7,0.571,3,5,0.6,1,2,0.5,3,3,1,0,2,2,0,0,0,1,1,12,7.9
Alan Williams,24-043,F-C,3/12/17,PHO,POR,0,25,4,11,0.364,4,11,0.364,0,0,,4,5,0.8,2,8,10,1,1,1,1,5,12,8.7
DeAndre Jordan,28-158,C,12/26/16,LAC,DEN,1,34,4,7,0.571,4,7,0.571,0,0,,4,5,0.8,2,9,11,0,3,1,1,3,12,13.9
Richaun Holmes,23-112,F-C,2/4/17,PHI,MIA,0,24,4,6,0.667,4,6,0.667,0,0,,4,4,1,2,7,9,2,1,0,2,2,12,12.5
Nikola Vucevic,26-154,C,3/27/17,ORL,TOR,1,29,5,11,0.455,5,10,0.5,0,1,0,2,2,1,3,12,15,4,0,0,1,2,12,13
Tyler Johnson,24-246,G,1/8/17,MIA,LAC,0,33,4,12,0.333,3,9,0.333,1,3,0.333,3,4,0.75,0,7,7,1,1,1,1,5,12,6.3
Dennis Schroder,23-139,G,2/1/17,ATL,MIA,1,26,5,11,0.455,5,9,0.556,0,2,0,2,2,1,0,1,1,2,1,0,4,0,12,5
Ish Smith,28-252,G,3/14/17,DET,CLE,0,21,6,12,0.5,6,12,0.5,0,0,,0,0,,0,1,1,3,1,0,2,2,12,6.6
Jeremy Lamb,24-294,G-F,3/20/17,CHO,ATL,0,17,5,9,0.556,3,5,0.6,2,4,0.5,0,0,,0,3,3,3,1,1,1,1,12,11
Clint Capela,22-171,F-C,11/5/16,HOU,ATL,1,21,6,7,0.857,6,7,0.857,0,0,,0,0,,1,9,10,0,1,0,4,5,12,7.9
Al-Farouq Aminu,26-044,F,11/4/16,POR,DAL,1,33,4,13,0.308,1,5,0.2,3,8,0.375,1,2,0.5,3,7,10,3,1,1,1,1,12,10.7
Austin Rivers,24-109,G,11/18/16,LAC,SAC,0,23,5,7,0.714,4,5,0.8,1,2,0.5,1,1,1,0,1,1,4,1,1,1,2,12,12.1
Rodney Stuckey,30-230,G,12/7/16,IND,PHO,0,26,5,9,0.556,5,7,0.714,0,2,0,2,3,0.667,0,3,3,1,1,0,0,1,12,9.5
Aaron Gordon,21-136,F,1/30/17,ORL,MIN,1,28,4,11,0.364,3,6,0.5,1,5,0.2,3,3,1,2,4,6,1,0,0,0,4,12,7.6
Michael Carter-Williams,25-081,G,12/30/16,CHI,IND,0,27,4,10,0.4,3,7,0.429,1,3,0.333,3,3,1,4,4,8,1,0,1,2,3,12,8.8
Deron Williams,32-131,G,11/4/16,DAL,POR,1,37,3,14,0.214,2,7,0.286,1,7,0.143,5,6,0.833,0,5,5,6,1,0,2,1,12,7.3
Steven Adams,23-261,C,4/7/17,OKC,PHO,1,33,4,10,0.4,4,10,0.4,0,0,,4,6,0.667,8,3,11,2,0,0,0,2,12,12.9
Marcin Gortat,32-287,C-F,11/30/16,WAS,OKC,1,36,6,12,0.5,6,12,0.5,0,0,,0,2,0,4,7,11,2,0,1,0,4,12,10.6
Jeremy Lamb,24-250,G-F,2/4/17,CHO,UTA,0,15,4,8,0.5,4,5,0.8,0,3,0,4,5,0.8,0,2,2,1,0,0,0,2,12,8.1
Eric Gordon,28-082,G,3/17/17,HOU,NOP,0,32,4,13,0.308,1,6,0.167,3,7,0.429,1,1,1,1,1,2,3,0,0,1,0,12,6.6
Joe Ingles,29-178,F-G,3/29/17,UTA,SAC,0,27,4,7,0.571,2,3,0.667,2,4,0.5,2,2,1,0,2,2,5,2,1,1,0,12,14.5
Rajon Rondo,30-358,G,2/14/17,CHI,TOR,0,24,5,8,0.625,3,6,0.5,2,2,1,0,0,,1,2,3,4,0,0,5,0,12,7.5
Robin Lopez,28-218,C,11/5/16,CHI,IND,1,27,6,8,0.75,6,8,0.75,0,0,,0,0,,3,4,7,0,0,2,1,1,12,12.1
James Johnson,29-304,F,12/20/16,MIA,ORL,0,28,5,10,0.5,3,4,0.75,2,6,0.333,0,0,,1,7,8,6,0,0,1,1,12,12.6
Brandon Bass,31-253,F,1/8/17,LAC,MIA,0,20,5,9,0.556,5,9,0.556,0,0,,2,2,1,2,2,4,0,2,0,2,1,12,9.3
Jordan Clarkson,24-244,G,2/6/17,LAL,NYK,0,29,5,13,0.385,5,11,0.455,0,2,0,2,2,1,1,6,7,2,0,0,1,4,12,6.2
Nicolas Batum,27-353,F-G,12/1/16,CHO,DAL,1,36,4,12,0.333,3,7,0.429,1,5,0.2,3,4,0.75,0,9,9,6,1,0,3,1,12,9.3
Kent Bazemore,27-171,G-F,12/19/16,ATL,OKC,1,40,4,9,0.444,4,7,0.571,0,2,0,4,9,0.444,0,5,5,6,2,1,2,3,12,10.5
Kyle Korver,35-271,G-F,12/13/16,ATL,ORL,0,27,4,6,0.667,0,1,0,4,5,0.8,0,0,,0,1,1,0,0,0,0,1,12,9.3
Cody Zeller,24-185,F-C,4/8/17,CHO,BOS,1,30,4,5,0.8,4,5,0.8,0,0,,4,4,1,2,7,9,2,3,0,0,2,12,17.2
Chandler Parsons,28-088,F,1/21/17,MEM,HOU,1,22,4,11,0.364,3,7,0.429,1,4,0.25,3,4,0.75,0,2,2,4,3,0,0,2,12,11.1
Greg Monroe,26-284,C-F,3/15/17,MIL,LAC,0,27,5,10,0.5,5,10,0.5,0,0,,2,4,0.5,1,5,6,4,2,0,2,2,12,10.4
Brandon Knight,25-021,G,12/23/16,PHO,PHI,0,15,4,7,0.571,4,7,0.571,0,0,,4,5,0.8,1,2,3,1,0,0,3,0,12,7.3
Kosta Koufos,28-009,C,3/5/17,SAC,UTA,1,37,5,12,0.417,5,12,0.417,0,0,,2,2,1,4,6,10,1,0,1,1,6,12,8.2
T.J. McConnell,24-327,G,2/15/17,PHI,BOS,1,28,6,9,0.667,6,9,0.667,0,0,,0,0,,0,3,3,8,5,0,3,1,12,16.2
Jared Dudley,31-216,F-G,2/11/17,PHO,HOU,0,26,4,5,0.8,2,3,0.667,2,2,1,2,2,1,0,6,6,2,1,1,2,4,12,11.4
Jeremy Lin,28-119,G,12/20/16,BRK,TOR,1,25,4,8,0.5,2,4,0.5,2,4,0.5,2,4,0.5,0,2,2,4,1,1,2,1,12,9.9
Troy Daniels,25-249,G,3/21/17,MEM,NOP,0,24,4,8,0.5,0,0,,4,8,0.5,0,0,,0,2,2,2,0,0,2,1,12,7.6
Otto Porter,23-227,F,1/16/17,WAS,POR,1,30,4,9,0.444,1,4,0.25,3,5,0.6,1,3,0.333,0,4,4,0,1,0,1,1,12,7.3
Nikola Jokic,21-275,C-F,11/20/16,DEN,UTA,0,21,5,8,0.625,4,7,0.571,1,1,1,1,2,0.5,2,3,5,4,0,1,0,3,12,12.6
JaMychal Green,26-153,F,11/21/16,MEM,CHO,1,31,4,4,1,4,4,1,0,0,,4,5,0.8,1,7,8,1,0,1,1,3,12,12.4
Jonas Valanciunas,24-268,C,1/29/17,TOR,ORL,1,28,4,6,0.667,4,6,0.667,0,0,,4,5,0.8,1,8,9,3,0,0,1,2,12,12.4
Matt Barnes,36-268,F,12/2/16,SAC,BOS,0,31,3,11,0.273,2,7,0.286,1,4,0.25,5,6,0.833,3,13,16,5,2,1,2,2,12,14.5
Gorgui Dieng,26-282,C,10/26/16,MIN,MEM,1,34,5,10,0.5,5,9,0.556,0,1,0,2,2,1,5,9,14,2,2,1,0,3,12,16.1
Tristan Thompson,25-328,F-C,2/4/17,CLE,NYK,1,32,6,8,0.75,6,8,0.75,0,0,,0,0,,4,1,5,1,0,0,1,3,12,10.4
J.J. Redick,32-260,G,3/11/17,LAC,PHI,1,29,4,11,0.364,2,3,0.667,2,8,0.25,2,2,1,0,2,2,2,2,0,1,1,12,8.5
Langston Galloway,25-019,G,12/28/16,NOP,LAC,0,31,4,10,0.4,3,5,0.6,1,5,0.2,3,4,0.75,0,4,4,0,1,1,0,1,12,8.7
Robin Lopez,28-274,C,12/31/16,CHI,MIL,1,31,6,11,0.545,6,11,0.545,0,0,,0,0,,3,7,10,1,0,1,1,2,12,10.5
Gerald Henderson,29-033,G,1/11/17,PHI,NYK,0,26,5,10,0.5,5,10,0.5,0,0,,2,2,1,0,2,2,1,0,0,0,1,12,7.9
Deron Williams,32-126,G,10/30/16,DAL,HOU,1,31,4,11,0.364,1,6,0.167,3,5,0.6,1,2,0.5,0,1,1,3,1,1,2,1,12,7.2
Draymond Green,26-284,F,12/13/16,GSW,NOP,1,36,4,11,0.364,2,6,0.333,2,5,0.4,2,2,1,1,13,14,10,4,1,2,2,12,19.4
Marcus Smart,23-011,G,3/17/17,BOS,BRK,1,29,3,14,0.214,2,9,0.222,1,5,0.2,5,5,1,0,3,3,5,3,0,2,5,12,6.8
Hassan Whiteside,27-197,C,12/27/16,MIA,OKC,1,31,4,11,0.364,4,11,0.364,0,0,,4,6,0.667,4,4,8,1,2,0,4,4,12,6.2
Brandon Ingram,19-096,F,12/7/16,LAL,HOU,0,33,5,13,0.385,3,9,0.333,2,4,0.5,0,2,0,3,4,7,1,1,1,5,4,12,3.2
Al Horford,30-175,C-F,11/25/16,BOS,SAS,1,35,6,13,0.462,6,10,0.6,0,3,0,0,0,,2,8,10,4,0,3,3,3,12,9.8
Ty Lawson,29-025,G,11/28/16,SAC,WAS,0,24,5,9,0.556,5,9,0.556,0,0,,2,2,1,0,0,0,3,3,0,4,2,12,8
T.J. Warren,23-197,F,3/21/17,PHO,MIA,1,31,6,14,0.429,6,14,0.429,0,0,,0,1,0,3,2,5,0,1,1,0,2,12,7.8
Kelly Olynyk,25-351,C-F,4/5/17,BOS,CLE,0,16,5,8,0.625,4,5,0.8,1,3,0.333,1,2,0.5,1,3,4,0,0,0,1,3,12,7.4
Nene Hilario,34-099,F-C,12/21/16,HOU,PHO,0,18,5,6,0.833,5,6,0.833,0,0,,2,2,1,1,1,2,0,0,2,1,3,12,10
Jarrod Uthoff,23-325,F,4/9/17,DAL,PHO,0,27,4,8,0.5,2,5,0.4,2,3,0.667,2,3,0.667,5,4,9,1,1,0,1,3,12,11.8
Leandro Barbosa,33-354,G,11/16/16,PHO,DEN,0,18,6,8,0.75,6,8,0.75,0,0,,0,0,,0,1,1,1,1,0,1,1,12,9.4
Henry Ellenson,20-089,F,4/12/17,DET,ORL,0,19,5,10,0.5,4,6,0.667,1,4,0.25,1,5,0.2,2,4,6,1,1,0,3,1,12,6.3
Marvin Williams,30-141,F,11/7/16,CHO,IND,1,19,4,10,0.4,2,5,0.4,2,5,0.4,2,3,0.667,0,4,4,0,0,0,1,1,12,6
Malcolm Delaney,27-305,G,1/10/17,ATL,BRK,0,16,5,6,0.833,4,4,1,1,2,0.5,1,3,0.333,0,1,1,1,0,0,4,0,12,6
Jordan Clarkson,24-190,G,12/14/16,LAL,BRK,0,19,6,12,0.5,6,10,0.6,0,2,0,0,0,,1,3,4,1,1,0,3,2,12,5.5
JaMychal Green,26-273,F,3/21/17,MEM,NOP,1,18,4,6,0.667,3,4,0.75,1,2,0.5,3,3,1,0,2,2,2,0,0,0,5,12,9.4
Richard Jefferson,36-163,F,12/1/16,CLE,LAC,0,22,4,6,0.667,0,0,,4,6,0.667,0,0,,0,4,4,0,0,0,0,1,12,10.2
Malcolm Brogdon,23-328,G,11/3/16,MIL,IND,0,24,3,5,0.6,1,2,0.5,2,3,0.667,4,4,1,0,2,2,4,3,1,0,1,12,16.4
Ersan Ilyasova,29-246,F,1/16/17,PHI,MIL,1,28,4,14,0.286,2,7,0.286,2,7,0.286,2,2,1,1,3,4,3,0,0,2,3,12,4.3
C.J. Miles,29-205,G-F,11/9/16,IND,PHI,0,32,3,7,0.429,0,3,0,3,4,0.75,3,4,0.75,0,4,4,2,0,1,1,1,12,9.8
Kosta Koufos,27-342,C,1/31/17,SAC,HOU,1,17,6,7,0.857,6,7,0.857,0,0,,0,1,0,2,2,4,0,1,1,0,4,12,11.2
Michael Kidd-Gilchrist,23-088,F,12/23/16,CHO,CHI,1,33,5,9,0.556,5,9,0.556,0,0,,2,3,0.667,2,7,9,2,1,4,0,0,12,16
Nerlens Noel,22-294,C-F,1/29/17,PHI,CHI,1,25,6,11,0.545,6,11,0.545,0,0,,0,0,,1,5,6,2,2,3,0,5,12,12.4
Brandon Knight,25-066,G,2/6/17,PHO,NOP,0,24,5,11,0.455,5,8,0.625,0,3,0,2,2,1,0,2,2,6,0,0,3,0,12,8.1
D.J. Augustin,29-003,G,11/13/16,ORL,OKC,0,15,3,5,0.6,2,2,1,1,3,0.333,5,6,0.833,0,1,1,0,0,0,1,1,12,8.2
Malcolm Brogdon,24-024,G,1/4/17,MIL,NYK,1,38,5,14,0.357,5,11,0.455,0,3,0,2,2,1,1,5,6,8,0,0,0,2,12,11.2
DeAndre Jordan,28-127,C,11/25/16,LAC,DET,1,33,5,5,1,5,5,1,0,0,,2,3,0.667,2,7,9,1,1,3,2,3,12,14.2
Rajon Rondo,30-323,G,1/10/17,CHI,WAS,0,27,6,13,0.462,6,10,0.6,0,3,0,0,0,,0,4,4,6,3,0,2,4,12,10.1
Larry Nance Jr.,23-334,F,11/30/16,LAL,CHI,0,26,5,8,0.625,5,8,0.625,0,0,,2,3,0.667,3,8,11,1,3,0,1,4,12,13.6
Michael Kidd-Gilchrist,23-163,F,3/8/17,CHO,MIA,1,26,5,7,0.714,5,7,0.714,0,0,,2,2,1,1,4,5,1,0,1,1,1,12,11
Monta Ellis,31-131,G,3/6/17,IND,CHO,0,26,5,10,0.5,4,8,0.5,1,2,0.5,1,1,1,0,2,2,3,0,0,3,2,12,5.9
Tim Hardaway,24-317,G,1/27/17,ATL,WAS,0,22,4,11,0.364,2,7,0.286,2,4,0.5,2,2,1,1,3,4,0,1,0,2,2,12,5.7
John Henson,26-005,C-F,1/2/17,MIL,OKC,1,27,6,7,0.857,6,7,0.857,0,0,,0,0,,2,3,5,1,1,1,0,3,12,13
Ivica Zubac,19-313,C,1/25/17,LAL,POR,0,28,5,15,0.333,5,15,0.333,0,0,,2,2,1,4,6,10,2,0,3,4,2,12,6.8
Tony Parker,34-215,G,12/18/16,SAS,NOP,1,24,6,12,0.5,6,12,0.5,0,0,,0,0,,2,2,4,6,0,0,1,0,12,11.2
Marco Belinelli,30-235,G-F,11/15/16,CHO,MIN,0,27,5,8,0.625,3,6,0.5,2,2,1,0,0,,0,1,1,1,0,0,0,1,12,9
Marcin Gortat,32-362,C-F,2/13/17,WAS,OKC,1,25,6,8,0.75,6,8,0.75,0,0,,0,0,,1,4,5,2,0,3,0,2,12,13.4
Nemanja Bjelica,28-208,F,12/3/16,MIN,CHO,0,19,5,7,0.714,3,4,0.75,2,3,0.667,0,0,,0,2,2,3,0,1,0,1,12,12.1
Monta Ellis,31-145,G,3/20/17,IND,UTA,0,25,5,11,0.455,4,8,0.5,1,3,0.333,1,2,0.5,0,2,2,2,2,0,0,2,12,9.1
Rodney McGruder,25-242,G,3/28/17,MIA,DET,1,33,5,8,0.625,4,5,0.8,1,3,0.333,1,2,0.5,2,4,6,4,2,0,2,1,12,13
Nikola Jokic,22-045,C-F,4/5/17,DEN,HOU,1,34,6,17,0.353,6,12,0.5,0,5,0,0,0,,3,16,19,9,5,1,2,3,12,18.2
Evan Turner,28-086,G,1/21/17,POR,BOS,1,40,4,9,0.444,4,8,0.5,0,1,0,4,4,1,0,4,4,4,1,2,2,5,12,9.7
Lou Williams,30-142,G,3/18/17,HOU,DEN,0,23,4,9,0.444,4,5,0.8,0,4,0,4,5,0.8,0,1,1,3,0,2,2,1,12,8.3
Enes Kanter,24-241,C,1/16/17,OKC,LAC,0,23,5,10,0.5,5,9,0.556,0,1,0,2,2,1,3,2,5,1,1,1,3,0,12,9.1
Terry Rozier,22-267,G,12/9/16,BOS,TOR,0,25,4,12,0.333,3,7,0.429,1,5,0.2,3,4,0.75,0,3,3,3,0,1,1,4,12,5.9
Victor Oladipo,24-185,G,11/5/16,OKC,MIN,1,31,5,9,0.556,4,7,0.571,1,2,0.5,1,3,0.333,0,3,3,1,1,0,1,0,12,8.5
Ron Baker,24-007,G,4/6/17,NYK,WAS,1,27,5,9,0.556,5,6,0.833,0,3,0,2,2,1,1,1,2,2,0,0,2,2,12,7.3
Thaddeus Young,28-283,F,3/31/17,IND,TOR,1,28,6,13,0.462,6,13,0.462,0,0,,0,1,0,4,4,8,2,0,0,1,1,12,8.9
Austin Rivers,24-122,G,12/1/16,LAC,CLE,0,23,4,8,0.5,2,4,0.5,2,4,0.5,2,2,1,1,3,4,7,0,0,1,5,12,11.5
Jonas Valanciunas,24-178,C,10/31/16,TOR,DEN,1,31,6,12,0.5,6,12,0.5,0,0,,0,0,,3,6,9,1,0,1,2,4,12,7.7
Maurice Harkless,23-233,F-G,12/30/16,POR,SAS,1,28,5,8,0.625,3,5,0.6,2,3,0.667,0,0,,1,0,1,0,3,1,2,5,12,8.8
Jordan Clarkson,24-203,G,12/27/16,LAL,UTA,0,26,6,10,0.6,6,9,0.667,0,1,0,0,0,,3,2,5,3,1,1,3,2,12,10.1
Dorian Finney-Smith,23-239,F,12/29/16,DAL,LAL,1,32,4,8,0.5,1,1,1,3,7,0.429,1,2,0.5,1,2,3,2,1,0,1,0,12,10.3
Myles Turner,20-340,F-C,2/27/17,IND,HOU,1,28,4,6,0.667,3,5,0.6,1,1,1,3,4,0.75,0,6,6,1,0,3,0,3,12,12.4
Frank Kaminsky,24-000,F-C,4/4/17,CHO,WAS,0,27,3,7,0.429,0,1,0,3,6,0.5,3,4,0.75,0,5,5,3,0,0,3,3,12,7.3
Thaddeus Young,28-188,F,12/26/16,IND,CHI,1,32,5,11,0.455,3,6,0.5,2,5,0.4,0,0,,3,3,6,0,3,0,3,1,12,8.9
Marcin Gortat,32-261,C-F,11/4/16,WAS,ATL,1,31,5,8,0.625,5,8,0.625,0,0,,2,2,1,5,10,15,0,1,1,2,4,12,13
Trevor Booker,29-092,F,2/25/17,BRK,GSW,0,27,6,9,0.667,6,9,0.667,0,0,,0,0,,3,7,10,1,0,0,1,2,12,11.2
Aaron Gordon,21-095,F,12/20/16,ORL,MIA,1,28,4,8,0.5,3,5,0.6,1,3,0.333,3,4,0.75,0,5,5,1,0,0,2,2,12,7
Doug McDermott,25-021,F,1/24/17,CHI,ORL,0,17,4,7,0.571,0,1,0,4,6,0.667,0,0,,0,1,1,1,0,1,0,1,12,10
Sergio Rodriguez,30-142,G,11/1/16,PHI,ORL,1,32,5,11,0.455,3,6,0.5,2,5,0.4,0,0,,0,5,5,11,0,0,4,2,12,10.7
Timofey Mozgov,30-130,C,11/23/16,LAL,GSW,1,17,5,7,0.714,5,7,0.714,0,0,,2,2,1,1,3,4,1,0,0,1,5,12,8.4
Thon Maker,19-352,F-C,2/11/17,MIL,IND,1,22,4,8,0.5,1,3,0.333,3,5,0.6,1,2,0.5,1,2,3,1,2,0,0,2,12,10.8
Bojan Bogdanovic,27-333,G-F,3/17/17,WAS,CHI,0,25,5,12,0.417,3,6,0.5,2,6,0.333,0,0,,1,1,2,0,0,0,1,2,12,4.8
Ish Smith,28-137,G,11/19/16,DET,BOS,1,33,5,10,0.5,5,9,0.556,0,1,0,2,2,1,0,4,4,7,1,1,0,2,12,14
Dennis Schroder,23-093,G,12/17/16,ATL,CHO,1,32,6,12,0.5,6,12,0.5,0,0,,0,2,0,1,3,4,6,0,0,4,4,12,5.4
Alex Len,23-285,C,3/28/17,PHO,ATL,1,25,3,9,0.333,3,8,0.375,0,1,0,6,10,0.6,2,5,7,0,3,1,3,4,12,7.3
Monta Ellis,31-133,G,3/8/17,IND,DET,0,22,5,9,0.556,3,7,0.429,2,2,1,0,0,,0,0,0,3,0,0,1,1,12,8.4
Tim Hardaway,24-272,G,12/13/16,ATL,ORL,1,30,4,12,0.333,3,6,0.5,1,6,0.167,3,3,1,1,2,3,2,0,0,0,2,12,7.1
Willy Hernangomez,22-310,C,4/2/17,NYK,BOS,1,19,6,9,0.667,6,9,0.667,0,0,,0,0,,0,3,3,3,2,0,2,2,12,10.3
Kyle Lowry,31-013,G,4/7/17,TOR,MIA,1,36,5,14,0.357,4,9,0.444,1,5,0.2,1,5,0.2,1,6,7,6,2,0,5,4,12,4.7
Treveon Graham,23-163,G,4/10/17,CHO,MIL,0,16,4,5,0.8,2,3,0.667,2,2,1,2,3,0.667,0,0,0,0,2,0,0,0,12,11.7
James Young,21-088,G-F,11/12/16,BOS,IND,0,16,5,6,0.833,3,3,1,2,3,0.667,0,0,,2,1,3,1,2,0,0,0,12,14.2
James Johnson,30-051,F,4/12/17,MIA,WAS,1,37,5,11,0.455,5,8,0.625,0,3,0,2,2,1,1,7,8,8,0,1,2,3,12,12.2
Ty Lawson,29-053,G,12/26/16,SAC,PHI,0,20,4,8,0.5,4,6,0.667,0,2,0,4,4,1,3,1,4,4,2,0,3,3,12,11
Draymond Green,27-002,F,3/6/17,GSW,ATL,1,30,4,10,0.4,2,5,0.4,2,5,0.4,2,2,1,3,5,8,6,4,0,2,4,12,14.8
Trevor Ariza,31-154,F,12/1/16,HOU,GSW,1,43,5,13,0.385,5,6,0.833,0,7,0,2,2,1,1,3,4,2,1,0,0,3,12,7.7
Tarik Black,24-359,C-F,11/15/16,LAL,BRK,0,13,4,6,0.667,4,6,0.667,0,0,,4,5,0.8,5,4,9,1,0,0,0,1,12,14
Langston Galloway,25-009,G,12/18/16,NOP,SAS,0,20,4,10,0.4,2,4,0.5,2,6,0.333,2,2,1,2,1,3,2,1,0,0,1,12,10.3
Jusuf Nurkic,22-184,C,2/23/17,POR,ORL,1,34,6,12,0.5,6,12,0.5,0,0,,0,0,,4,8,12,5,3,2,3,4,12,14.5
Rodney Stuckey,30-310,G,2/25/17,IND,MIA,0,18,3,8,0.375,3,8,0.375,0,0,,6,7,0.857,0,1,1,3,2,0,1,0,12,10.6
John Wall,26-051,G,10/27/16,WAS,ATL,1,30,3,15,0.2,3,13,0.231,0,2,0,6,7,0.857,2,1,3,10,4,1,5,2,12,9.9
Danilo Gallinari,28-117,F,12/3/16,DEN,UTA,1,35,3,11,0.273,2,9,0.222,1,2,0.5,5,5,1,1,4,5,1,2,0,0,2,12,9.3
Otto Porter,23-210,F,12/30/16,WAS,BRK,1,31,5,10,0.5,3,6,0.5,2,4,0.5,0,0,,0,4,4,2,1,1,0,2,12,10.5
Troy Williams,22-100,F,4/9/17,HOU,SAC,1,36,5,9,0.556,4,5,0.8,1,4,0.25,1,1,1,4,5,9,2,0,0,0,3,12,12.2
Dante Cunningham,29-343,F,3/31/17,NOP,SAC,0,21,6,10,0.6,6,8,0.75,0,2,0,0,0,,2,6,8,1,2,1,0,1,12,13.6
Ben McLemore,23-263,G,10/31/16,SAC,ATL,0,26,5,11,0.455,4,9,0.444,1,2,0.5,1,2,0.5,1,1,2,1,0,1,0,3,12,7.1
Jared Dudley,31-162,F-G,12/19/16,PHO,MIN,0,22,4,6,0.667,2,2,1,2,4,0.5,2,3,0.667,0,1,1,0,1,0,1,4,12,7.7
Victor Oladipo,24-273,G,2/1/17,OKC,CHI,1,25,5,14,0.357,4,8,0.5,1,6,0.167,1,1,1,2,3,5,0,1,0,1,5,12,4.5
Rondae Hollis-Jefferson,22-017,F,1/20/17,BRK,NOP,0,18,4,6,0.667,4,6,0.667,0,0,,4,5,0.8,0,7,7,2,1,0,3,1,12,10.1
Marco Belinelli,30-217,G-F,10/28/16,CHO,MIA,0,28,4,9,0.444,2,6,0.333,2,3,0.667,2,2,1,0,1,1,2,1,0,0,3,12,8.8
Noah Vonleh,21-222,F,4/3/17,POR,MIN,1,26,4,5,0.8,4,5,0.8,0,0,,4,4,1,1,3,4,0,2,2,1,3,12,12.9
Al-Farouq Aminu,26-117,F,1/16/17,POR,WAS,1,25,5,9,0.556,5,8,0.625,0,1,0,2,2,1,2,3,5,1,0,0,2,0,12,8.7
Patrick Beverley,28-235,G,3/4/17,HOU,MEM,1,32,3,5,0.6,1,2,0.5,2,3,0.667,4,4,1,2,3,5,5,3,1,4,4,12,13.6
Denzel Valentine,23-134,G,3/30/17,CHI,CLE,0,32,3,9,0.333,0,3,0,3,6,0.5,3,4,0.75,0,6,6,1,1,0,1,4,12,7.4
Eric Bledsoe,26-327,G,10/31/16,PHO,LAC,1,32,5,14,0.357,5,13,0.385,0,1,0,2,4,0.5,1,7,8,5,0,0,3,3,12,5.5
Nikola Vucevic,26-026,C,11/19/16,ORL,DAL,1,26,5,16,0.313,5,15,0.333,0,1,0,2,2,1,1,11,12,1,0,0,1,0,12,6.5
Timothe Luwawu-Cabarrot,21-250,F,1/14/17,PHI,WAS,0,26,5,10,0.5,3,7,0.429,2,3,0.667,0,2,0,2,4,6,2,0,0,3,1,12,6.8
Marcus Morris,27-110,F,12/21/16,DET,MEM,1,39,1,11,0.091,1,4,0.25,0,7,0,10,14,0.714,0,5,5,0,0,0,2,2,12,1.8
Jabari Parker,21-276,F,12/16/16,MIL,CHI,1,27,6,8,0.75,6,8,0.75,0,0,,0,0,,2,5,7,1,1,0,1,2,12,11.6
Ryan Anderson,28-297,F,2/27/17,HOU,IND,1,23,4,11,0.364,2,4,0.5,2,7,0.286,2,2,1,1,2,3,0,0,1,0,2,12,7.1
Matt Barnes,36-340,F,2/12/17,SAC,NOP,0,34,5,9,0.556,3,3,1,2,6,0.333,0,0,,1,4,5,3,0,1,2,1,12,10
Jaylen Brown,20-158,F,3/31/17,BOS,ORL,1,23,4,9,0.444,2,5,0.4,2,4,0.5,2,2,1,0,3,3,0,0,0,1,4,12,5.6
Courtney Lee,31-053,G,11/25/16,NYK,CHO,1,38,4,10,0.4,2,6,0.333,2,4,0.5,2,2,1,1,1,2,2,2,0,1,2,12,9.2
Bradley Beal,23-221,G,2/4/17,WAS,NOP,1,37,5,12,0.417,3,6,0.5,2,6,0.333,0,0,,0,5,5,3,1,0,4,1,12,5.8
Joe Ingles,29-152,F-G,3/3/17,UTA,BRK,1,36,4,8,0.5,0,1,0,4,7,0.571,0,0,,0,4,4,2,1,0,1,3,12,9.4
Tyreke Evans,27-119,G-F,1/16/17,NOP,IND,0,23,5,13,0.385,5,12,0.417,0,1,0,2,2,1,0,5,5,4,2,0,2,0,12,9.2
Wilson Chandler,29-169,F,10/26/16,DEN,NOP,0,30,5,15,0.333,4,9,0.444,1,6,0.167,1,1,1,0,7,7,1,0,0,2,3,12,3.1
Dwight Powell,25-266,F-C,4/12/17,DAL,MEM,1,34,2,11,0.182,0,2,0,2,9,0.222,6,6,1,1,2,3,0,1,0,2,4,12,3.8
Jordan Clarkson,24-227,G,1/20/17,LAL,IND,0,33,5,12,0.417,4,8,0.5,1,4,0.25,1,1,1,1,4,5,3,5,0,7,0,12,7.6
Rajon Rondo,30-352,G,2/8/17,CHI,GSW,0,23,6,11,0.545,6,10,0.6,0,1,0,0,1,0,1,5,6,8,1,0,2,3,12,11.9
Tony Allen,34-315,G-F,11/21/16,MEM,CHO,1,31,5,9,0.556,4,7,0.571,1,2,0.5,1,2,0.5,1,3,4,1,2,2,1,4,12,10.4
Jaylen Brown,20-102,F,2/3/17,BOS,LAL,1,32,3,7,0.429,2,5,0.4,1,2,0.5,5,6,0.833,1,6,7,1,0,0,0,3,12,9.9
Tim Hardaway,24-264,G,12/5/16,ATL,OKC,0,26,4,9,0.444,3,4,0.75,1,5,0.2,3,3,1,0,3,3,3,0,0,1,1,12,8.9
Channing Frye,33-327,C-F,4/9/17,CLE,ATL,1,24,5,8,0.625,3,3,1,2,5,0.4,0,0,,1,7,8,0,1,2,0,2,12,12.8
Marcus Morris,27-220,F,4/10/17,DET,WAS,1,26,6,14,0.429,6,12,0.5,0,2,0,0,0,,0,4,4,0,1,0,1,2,12,5
Timofey Mozgov,30-151,C,12/14/16,LAL,BRK,1,33,4,10,0.4,4,10,0.4,0,0,,4,6,0.667,7,6,13,0,1,1,1,4,12,11.6
Dorian Finney-Smith,23-297,F,2/25/17,DAL,NOP,0,24,5,6,0.833,3,3,1,2,3,0.667,0,0,,0,2,2,0,0,2,1,2,12,10
DeAndre Jordan,28-113,C,11/11/16,LAC,OKC,1,33,3,5,0.6,3,5,0.6,0,0,,6,12,0.5,4,9,13,1,0,1,3,3,12,10
Taj Gibson,31-184,F,12/25/16,CHI,SAS,1,25,5,13,0.385,5,13,0.385,0,0,,2,2,1,4,3,7,2,0,0,1,4,12,7.4
Nikola Vucevic,26-036,C,11/29/16,ORL,SAS,0,25,6,16,0.375,6,15,0.4,0,1,0,0,0,,3,7,10,0,2,1,2,3,12,6.9
Dante Exum,21-226,G,2/24/17,UTA,MIL,0,16,3,5,0.6,2,2,1,1,3,0.333,5,5,1,1,2,3,3,1,0,1,2,12,12.3
Shabazz Muhammad,24-020,F-G,12/3/16,MIN,CHO,0,25,5,10,0.5,5,9,0.556,0,1,0,2,3,0.667,2,4,6,1,0,0,0,1,12,9.5
Alexis Ajinca,28-285,C,2/15/17,NOP,MEM,1,35,3,6,0.5,3,6,0.5,0,0,,6,8,0.75,2,8,10,0,3,2,3,4,12,11.8
Nene Hilario,34-180,F-C,3/12/17,HOU,CLE,0,22,6,10,0.6,6,10,0.6,0,0,,0,0,,4,2,6,0,3,1,1,4,12,11.9
Andrew Harrison,22-038,G,12/5/16,MEM,NOP,1,40,3,13,0.231,1,6,0.167,2,7,0.286,4,6,0.667,2,1,3,4,1,0,3,5,12,3.8
Greg Monroe,26-280,C-F,3/11/17,MIL,MIN,0,33,6,14,0.429,6,14,0.429,0,0,,0,0,,4,2,6,2,1,0,2,3,12,7.2
Tobias Harris,24-115,F,11/7/16,DET,LAC,1,30,5,13,0.385,5,10,0.5,0,3,0,2,2,1,0,3,3,0,0,0,1,1,12,4.4
David Lee,33-181,F,10/27/16,SAS,SAC,0,16,5,6,0.833,5,6,0.833,0,0,,2,2,1,2,3,5,2,2,1,0,3,12,15
Thaddeus Young,28-179,F,12/17/16,IND,DET,1,33,6,8,0.75,6,8,0.75,0,0,,0,0,,0,2,2,3,1,0,1,2,12,10.7
Ty Lawson,29-022,G,11/25/16,SAC,HOU,1,24,3,6,0.5,2,5,0.4,1,1,1,5,6,0.833,2,2,4,3,0,0,2,2,12,9.9
Harrison Barnes,24-179,F,11/25/16,DAL,CLE,1,30,6,13,0.462,6,10,0.6,0,3,0,0,0,,3,2,5,0,0,0,0,0,12,8
Terrence Jones,25-022,F,1/31/17,NOP,TOR,0,34,6,14,0.429,6,13,0.462,0,1,0,0,1,0,2,2,4,4,3,1,0,2,12,11.9
Manu Ginobili,39-107,G,11/12/16,SAS,HOU,0,16,5,7,0.714,3,5,0.6,2,2,1,0,0,,0,2,2,3,0,1,0,2,12,11.7
Nene Hilario,34-122,F-C,1/13/17,HOU,MEM,0,23,4,6,0.667,4,6,0.667,0,0,,4,4,1,2,1,3,2,2,1,0,3,12,14
Tim Hardaway,24-294,G,1/4/17,ATL,ORL,0,21,5,9,0.556,3,5,0.6,2,4,0.5,0,0,,0,2,2,2,0,0,2,0,12,7.7
Emmanuel Mudiay,20-243,G,11/3/16,DEN,MIN,1,33,4,18,0.222,4,14,0.286,0,4,0,4,4,1,0,6,6,3,5,0,6,3,12,2.7
Zach Randolph,35-155,F,12/18/16,MEM,UTA,0,23,5,13,0.385,5,11,0.455,0,2,0,2,2,1,3,8,11,1,1,0,1,3,12,8.9
Serge Ibaka,27-171,F-C,3/8/17,TOR,NOP,1,30,5,13,0.385,3,9,0.333,2,4,0.5,0,0,,0,5,5,1,1,4,1,3,12,8.7
Jae Crowder,26-163,F,12/16/16,BOS,CHO,1,35,3,7,0.429,1,2,0.5,2,5,0.4,4,4,1,0,5,5,3,0,0,2,2,12,9.1
Luke Babbitt,27-249,F,2/24/17,MIA,ATL,1,14,4,8,0.5,0,2,0,4,6,0.667,0,0,,1,5,6,0,0,0,1,5,12,7.2
Nene Hilario,34-105,F-C,12/27/16,HOU,DAL,1,19,5,8,0.625,5,8,0.625,0,0,,2,5,0.4,1,6,7,0,1,1,1,3,12,9.2
Noah Vonleh,21-231,F,4/12/17,POR,NOP,1,38,5,8,0.625,5,8,0.625,0,0,,2,3,0.667,9,10,19,1,1,0,1,1,12,17.6
Kelly Oubre,21-120,F,4/8/17,WAS,MIA,1,33,5,9,0.556,4,5,0.8,1,4,0.25,1,2,0.5,1,5,6,1,0,0,1,3,12,8
Jason Smith,30-287,F-C,12/14/16,WAS,CHO,0,18,5,9,0.556,5,9,0.556,0,0,,2,2,1,3,3,6,2,3,0,2,1,12,12.7
Justin Holiday,27-360,G,3/31/17,NYK,MIA,0,25,6,10,0.6,6,10,0.6,0,0,,0,0,,0,4,4,2,1,1,2,1,12,9.3
Ish Smith,28-129,G,11/11/16,DET,SAS,1,30,6,10,0.6,6,9,0.667,0,1,0,0,2,0,0,4,4,4,0,0,1,1,12,9.2
Trey Lyles,21-066,F,1/10/17,UTA,CLE,0,17,4,11,0.364,2,4,0.5,2,7,0.286,2,3,0.667,3,2,5,1,0,1,0,1,12,9.2
Dewayne Dedmon,27-076,C,10/27/16,SAS,SAC,0,24,5,6,0.833,5,6,0.833,0,0,,2,2,1,4,3,7,0,0,4,0,4,12,14.7
Willie Cauley-Stein,23-221,F-C,3/27/17,SAC,MEM,1,33,3,6,0.5,3,6,0.5,0,0,,6,6,1,2,7,9,3,1,0,1,2,12,13.8
Larry Nance Jr.,23-306,F,11/2/16,LAL,ATL,0,26,6,8,0.75,6,7,0.857,0,1,0,0,0,,1,6,7,1,2,1,1,1,12,13.3
Jamal Crawford,36-256,G,12/1/16,LAC,CLE,0,21,4,9,0.444,2,4,0.5,2,5,0.4,2,4,0.5,0,0,0,2,0,0,1,2,12,6.1
Marcin Gortat,32-337,C-F,1/19/17,WAS,NYK,1,30,6,12,0.5,6,12,0.5,0,0,,0,0,,5,8,13,2,0,1,1,3,12,11.8
Joffrey Lauvergne,25-053,C-F,11/22/16,OKC,LAL,0,23,5,9,0.556,3,5,0.6,2,4,0.5,0,0,,0,7,7,1,1,1,0,3,12,11
Cory Joseph,25-110,G,12/8/16,TOR,MIN,0,19,6,8,0.75,6,8,0.75,0,0,,0,0,,1,0,1,2,0,1,1,2,12,9.8
Gerald Henderson,28-338,G,11/11/16,PHI,IND,1,29,5,12,0.417,5,10,0.5,0,2,0,2,2,1,2,2,4,1,1,1,2,3,12,6.8
Michael Beasley,27-297,F,11/1/16,MIL,NOP,0,13,5,9,0.556,5,8,0.625,0,1,0,2,2,1,0,1,1,0,0,0,1,1,12,6.6
Taj Gibson,31-287,F,4/7/17,OKC,PHO,1,16,6,10,0.6,6,10,0.6,0,0,,0,0,,0,4,4,0,0,1,0,1,12,8.9
Brandon Knight,25-051,G,1/22/17,PHO,TOR,0,24,3,6,0.5,3,6,0.5,0,0,,6,6,1,0,1,1,1,0,0,1,2,12,8.2
Hassan Whiteside,27-298,C,4/7/17,MIA,TOR,1,27,4,14,0.286,4,14,0.286,0,0,,4,6,0.667,4,6,10,2,0,0,2,5,12,5
Jordan Crawford,28-159,G,3/31/17,NOP,SAC,0,25,4,12,0.333,2,5,0.4,2,7,0.286,2,2,1,1,1,2,4,0,1,0,1,12,9.3
Tim Frazier,26-017,G,11/18/16,NOP,POR,1,32,5,11,0.455,4,8,0.5,1,3,0.333,1,1,1,0,3,3,8,0,1,2,3,12,10.3
Malcolm Brogdon,23-337,G,11/12/16,MIL,MEM,0,22,5,9,0.556,3,6,0.5,2,3,0.667,0,0,,1,0,1,3,0,0,2,2,12,7.7
Harrison Barnes,24-252,F,2/6/17,DAL,DEN,1,34,6,11,0.545,6,9,0.667,0,2,0,0,0,,0,4,4,2,0,0,2,1,12,6.9
Blake Griffin,27-252,F,11/23/16,LAC,DAL,1,26,4,10,0.4,3,9,0.333,1,1,1,3,6,0.5,0,6,6,7,2,0,4,2,12,9.3
Al-Farouq Aminu,26-139,F,2/7/17,POR,DAL,0,28,4,10,0.4,2,5,0.4,2,5,0.4,2,2,1,2,9,11,1,1,1,1,2,12,11.3
Mike Dunleavy,36-136,F-G,1/29/17,ATL,NYK,0,22,5,6,0.833,3,3,1,2,3,0.667,0,0,,0,3,3,1,0,1,0,0,12,12.1
Gorgui Dieng,26-349,C,1/1/17,MIN,POR,1,38,5,13,0.385,5,13,0.385,0,0,,2,2,1,2,7,9,2,2,0,1,5,12,8.8
D.J. Augustin,29-024,G,12/4/16,ORL,DET,1,25,5,8,0.625,3,3,1,2,5,0.4,0,0,,0,3,3,3,0,0,1,2,12,9.6
Al-Farouq Aminu,26-128,F,1/27/17,POR,MEM,0,32,4,9,0.444,2,4,0.5,2,5,0.4,2,2,1,0,4,4,2,1,3,1,3,12,10.8
Kyle Korver,35-314,G-F,1/25/17,CLE,SAC,0,34,4,9,0.444,0,2,0,4,7,0.571,0,0,,1,0,1,3,0,1,1,2,12,9
Hassan Whiteside,27-245,C,2/13/17,MIA,ORL,1,36,5,7,0.714,5,7,0.714,0,0,,2,3,0.667,1,18,19,1,2,2,3,4,12,14.3
Aaron Gordon,21-058,F,11/13/16,ORL,OKC,0,22,5,9,0.556,4,6,0.667,1,3,0.333,1,1,1,0,1,1,1,0,0,1,3,12,6.5
Nicolas Batum,27-320,F-G,10/29/16,CHO,BOS,1,33,3,10,0.3,2,5,0.4,1,5,0.2,5,6,0.833,0,4,4,6,0,2,1,2,12,10.8
Dion Waiters,25-079,G,2/27/17,MIA,DAL,1,33,4,12,0.333,2,7,0.286,2,5,0.4,2,5,0.4,0,3,3,6,2,0,2,3,12,7.9
Tobias Harris,24-268,F,4/9/17,DET,MEM,1,25,5,9,0.556,4,6,0.667,1,3,0.333,1,1,1,1,2,3,2,2,0,2,0,12,10.4
Doug McDermott,24-302,F,10/31/16,CHI,BRK,0,24,4,10,0.4,4,7,0.571,0,3,0,4,4,1,0,3,3,3,0,0,1,2,12,7.8
DeMarcus Cousins,26-196,C-F,2/25/17,NOP,DAL,1,32,3,9,0.333,1,4,0.25,2,5,0.4,4,8,0.5,3,12,15,6,3,0,7,3,12,10
Eric Bledsoe,27-008,G,12/17/16,PHO,OKC,1,31,4,13,0.308,3,7,0.429,1,6,0.167,3,3,1,0,3,3,4,0,0,2,1,12,5.8
Robert Covington,25-329,F,11/7/16,PHI,UTA,1,29,4,5,0.8,1,1,1,3,4,0.75,1,2,0.5,0,8,8,1,0,0,0,2,12,12
J.R. Smith,31-188,G-F,3/16/17,CLE,UTA,0,30,4,10,0.4,0,2,0,4,8,0.5,0,0,,2,4,6,0,1,0,0,1,12,9.8
Andre Roberson,25-119,G-F,4/2/17,OKC,CHO,1,37,6,7,0.857,6,6,1,0,1,0,0,0,,0,6,6,1,1,1,1,3,12,11.5
Shabazz Muhammad,24-043,F-G,12/26/16,MIN,ATL,0,29,4,13,0.308,3,10,0.3,1,3,0.333,3,4,0.75,2,1,3,0,1,0,3,2,12,3
Marcin Gortat,32-353,C-F,2/4/17,WAS,NOP,1,36,5,11,0.455,5,11,0.455,0,0,,2,2,1,4,13,17,0,0,1,0,2,12,12.9
Tyreke Evans,27-168,G-F,3/6/17,SAC,DEN,0,21,5,11,0.455,3,7,0.429,2,4,0.5,0,0,,1,5,6,2,1,0,3,0,12,7.9
Marreese Speights,29-097,C-F,11/9/16,LAC,POR,0,15,4,9,0.444,2,5,0.4,2,4,0.5,2,2,1,1,7,8,1,1,2,1,0,12,12.2
Chasson Randle,24-066,G,4/12/17,NYK,PHI,0,26,5,8,0.625,4,6,0.667,1,2,0.5,1,1,1,0,2,2,0,2,0,4,3,12,5.8
Jameer Nelson,35-050,G,3/31/17,DEN,CHO,1,26,4,8,0.5,0,2,0,4,6,0.667,0,0,,0,1,1,9,1,0,2,3,12,12.4
Cody Zeller,24-035,F-C,11/9/16,CHO,UTA,1,27,4,7,0.571,4,7,0.571,0,0,,4,8,0.5,1,2,3,2,0,0,1,3,12,7.6
Chandler Parsons,28-101,F,2/3/17,MEM,OKC,1,25,3,6,0.5,3,5,0.6,0,1,0,6,6,1,0,3,3,1,1,0,1,1,12,10.2
Lance Stephenson,26-211,G-F,4/4/17,IND,TOR,0,25,5,10,0.5,3,8,0.375,2,2,1,0,0,,0,2,2,3,1,0,1,2,12,8.9
Kent Bazemore,27-196,G-F,1/13/17,ATL,BOS,1,29,4,11,0.364,2,5,0.4,2,6,0.333,2,2,1,0,3,3,3,0,1,2,2,12,6.8
D.J. Augustin,29-127,G,3/17/17,ORL,PHO,0,16,4,8,0.5,3,6,0.5,1,2,0.5,3,4,0.75,0,1,1,0,0,0,1,3,12,5.7
Manu Ginobili,39-242,G,3/27/17,SAS,CLE,0,17,5,7,0.714,3,4,0.75,2,3,0.667,0,0,,1,2,3,1,1,0,0,2,12,11.3
C.J. Watson,32-280,G,1/22/17,ORL,GSW,1,36,4,10,0.4,3,5,0.6,1,5,0.2,3,5,0.6,1,1,2,4,2,0,4,3,12,6.4
Klay Thompson,27-063,G,4/12/17,GSW,LAL,1,26,4,12,0.333,3,7,0.429,1,5,0.2,3,4,0.75,1,1,2,2,2,0,0,0,12,9.2
J.J. Redick,32-133,G,11/4/16,LAC,MEM,1,28,4,10,0.4,3,6,0.5,1,4,0.25,3,3,1,0,1,1,0,2,0,2,0,12,6.9
Aron Baynes,30-059,C,2/6/17,DET,PHI,0,22,5,8,0.625,5,8,0.625,0,0,,2,2,1,4,3,7,1,0,1,0,2,12,12.7
Jeremy Lamb,24-315,G-F,4/10/17,CHO,MIL,0,19,6,12,0.5,6,10,0.6,0,2,0,0,0,,2,2,4,1,1,0,1,0,12,8.7
Blake Griffin,27-314,F,1/24/17,LAC,PHI,1,29,3,11,0.273,3,11,0.273,0,0,,6,10,0.6,2,9,11,5,1,0,6,2,12,5.7
Marco Belinelli,30-227,G-F,11/7/16,CHO,IND,0,27,3,8,0.375,1,4,0.25,2,4,0.5,4,4,1,1,2,3,4,3,0,1,1,12,13.3
Willy Hernangomez,22-306,C,3/29/17,NYK,MIA,1,23,4,10,0.4,4,9,0.444,0,1,0,4,4,1,5,4,9,1,0,0,3,3,12,7.8
Jonas Valanciunas,24-189,C,11/11/16,TOR,CHO,1,21,5,8,0.625,5,8,0.625,0,0,,2,2,1,2,6,8,0,2,1,0,2,12,13.5
Anthony Bennett,23-249,F,11/18/16,BRK,OKC,0,21,4,8,0.5,2,4,0.5,2,4,0.5,2,2,1,0,3,3,0,0,0,0,2,12,8.1
Jahlil Okafor,21-078,C-F,3/3/17,PHI,NYK,1,20,5,10,0.5,5,10,0.5,0,0,,2,2,1,4,4,8,1,0,1,2,5,12,8.4
Raymond Felton,32-159,G,12/2/16,LAC,NOP,1,26,5,10,0.5,3,7,0.429,2,3,0.667,0,0,,0,2,2,3,1,0,2,2,12,7.9
Manu Ginobili,39-153,G,12/28/16,SAS,PHO,0,20,3,9,0.333,1,5,0.2,2,4,0.5,4,4,1,3,2,5,3,2,3,0,2,12,15
Serge Ibaka,27-203,F-C,4/9/17,TOR,NYK,1,27,5,10,0.5,4,6,0.667,1,4,0.25,1,2,0.5,0,4,4,0,0,0,0,1,12,7.4
Trevor Booker,29-103,F,3/8/17,BRK,ATL,0,27,5,8,0.625,5,7,0.714,0,1,0,2,2,1,1,7,8,3,1,1,1,4,12,12.4
Dorian Finney-Smith,23-219,F,12/9/16,DAL,IND,1,33,5,8,0.625,3,4,0.75,2,4,0.5,0,0,,1,7,8,2,0,0,1,3,12,10.4
Michael Kidd-Gilchrist,23-183,F,3/28/17,CHO,MIL,1,23,4,7,0.571,4,7,0.571,0,0,,4,6,0.667,2,4,6,1,1,0,1,3,12,10
Montrezl Harrell,22-319,F-C,12/10/16,HOU,DAL,0,19,5,6,0.833,4,5,0.8,1,1,1,1,1,1,2,0,2,1,1,0,0,1,12,12.5
Monta Ellis,31-078,G,1/12/17,IND,DEN,0,27,4,9,0.444,4,6,0.667,0,3,0,4,4,1,1,1,2,1,2,0,2,0,12,9
Gerald Henderson,29-114,G,4/2/17,PHI,TOR,0,18,5,9,0.556,3,5,0.6,2,4,0.5,0,0,,2,2,4,0,2,0,2,2,12,8.9
Jordan Clarkson,24-246,G,2/8/17,LAL,DET,0,22,3,10,0.3,3,7,0.429,0,3,0,6,7,0.857,0,1,1,0,2,0,3,3,12,3.9
Marreese Speights,29-216,C-F,3/8/17,LAC,MIN,0,15,5,10,0.5,3,6,0.5,2,4,0.5,0,0,,0,7,7,0,0,0,1,1,12,7.7
Jahlil Okafor,21-037,C-F,1/21/17,PHI,ATL,1,30,5,8,0.625,5,8,0.625,0,0,,2,2,1,0,4,4,1,1,3,3,3,12,9.2
Danny Green,29-181,G-F,12/20/16,SAS,HOU,1,34,4,8,0.5,0,0,,4,8,0.5,0,0,,1,2,3,2,2,1,2,2,12,10.6
Trevor Ariza,31-209,F,1/25/17,HOU,BOS,1,37,4,11,0.364,0,3,0,4,8,0.5,0,0,,0,2,2,2,1,0,3,0,12,5.9
Devin Harris,33-313,G,1/5/17,DAL,PHO,0,20,3,5,0.6,1,2,0.5,2,3,0.667,4,4,1,0,3,3,2,1,0,1,0,12,12
Luke Babbitt,27-261,F,3/8/17,MIA,CHO,1,18,4,8,0.5,0,0,,4,8,0.5,0,0,,0,4,4,0,0,0,1,0,12,8.2
Bobby Portis,22-040,F,3/22/17,CHI,DET,0,23,5,9,0.556,5,8,0.625,0,1,0,2,5,0.4,1,5,6,2,0,0,1,5,12,7.1
Langston Galloway,25-001,G,12/10/16,NOP,LAC,0,30,4,13,0.308,3,8,0.375,1,5,0.2,3,5,0.6,0,0,0,3,1,0,3,1,12,3.4
Tim Hardaway,24-249,G,11/20/16,ATL,NYK,0,22,5,8,0.625,3,5,0.6,2,3,0.667,0,0,,0,1,1,2,0,0,1,0,12,9.1
Omri Casspi,28-246,F,2/23/17,NOP,HOU,0,24,5,9,0.556,3,5,0.6,2,4,0.5,0,0,,1,1,2,0,0,0,2,3,12,5.5
Mike Conley,29-118,G,2/6/17,MEM,SAS,1,35,3,10,0.3,2,8,0.25,1,2,0.5,5,5,1,0,2,2,9,2,1,2,0,12,13.8
Marcin Gortat,32-303,C-F,12/16/16,WAS,DET,1,38,6,10,0.6,6,10,0.6,0,0,,0,0,,3,11,14,4,0,0,0,3,12,14.4
Tyler Johnson,24-203,G,11/26/16,MIA,MEM,0,29,3,7,0.429,1,2,0.5,2,5,0.4,4,5,0.8,0,4,4,1,0,1,2,3,12,7.3
Jon Leuer,27-199,F,11/29/16,DET,CHO,0,32,5,12,0.417,4,9,0.444,1,3,0.333,1,1,1,2,5,7,1,1,0,2,3,12,7
Jeremy Lamb,24-193,G-F,12/9/16,CHO,ORL,0,19,6,8,0.75,6,7,0.857,0,1,0,0,0,,1,7,8,2,1,0,0,3,12,12.8
Rudy Gobert,24-146,C,11/19/16,UTA,HOU,1,35,5,7,0.714,5,7,0.714,0,0,,2,3,0.667,2,12,14,1,2,4,2,1,12,16.8
Tony Parker,34-328,G,4/10/17,SAS,POR,1,20,5,7,0.714,5,7,0.714,0,0,,2,2,1,0,2,2,4,0,0,0,2,12,11.7
Kosta Koufos,27-303,C,12/23/16,SAC,MIN,1,21,6,8,0.75,6,8,0.75,0,0,,0,0,,2,2,4,0,1,0,0,3,12,10.6
Jordan Clarkson,24-304,G,4/7/17,LAL,SAC,1,30,5,12,0.417,3,6,0.5,2,6,0.333,0,0,,0,3,3,6,0,0,1,0,12,9.7
Jae Crowder,26-152,F,12/5/16,BOS,HOU,1,36,4,9,0.444,2,4,0.5,2,5,0.4,2,2,1,0,3,3,5,0,0,1,0,12,10.7
Mindaugas Kuzminskas,27-172,F,4/9/17,NYK,TOR,0,22,5,10,0.5,3,4,0.75,2,6,0.333,0,0,,0,1,1,0,0,0,1,1,12,5.9
Thaddeus Young,28-225,F,2/1/17,IND,ORL,1,29,6,11,0.545,6,9,0.667,0,2,0,0,0,,1,4,5,1,3,0,1,4,12,9.7
Caris LeVert,22-127,G-F,12/30/16,BRK,WAS,0,24,4,5,0.8,2,2,1,2,3,0.667,2,2,1,0,3,3,1,2,0,0,3,12,12.5
Marvin Williams,30-171,F,12/7/16,CHO,DET,1,26,5,10,0.5,3,5,0.6,2,5,0.4,0,0,,0,5,5,0,1,0,0,0,12,9.5
Deron Williams,32-180,G,12/23/16,DAL,LAC,1,35,5,16,0.313,3,11,0.273,2,5,0.4,0,0,,0,5,5,9,1,0,4,2,12,6.8
Emmanuel Mudiay,20-273,G,12/3/16,DEN,UTA,1,22,5,11,0.455,3,7,0.429,2,4,0.5,0,0,,0,3,3,0,1,2,0,1,12,9.2
Anthony Davis,23-282,F-C,12/18/16,NOP,SAS,1,30,5,12,0.417,5,12,0.417,0,0,,2,4,0.5,2,2,4,1,0,1,3,4,12,3.6
Jeff Green,30-147,F,1/22/17,ORL,GSW,0,27,4,12,0.333,2,9,0.222,2,3,0.667,2,3,0.667,2,1,3,1,0,1,2,1,12,5.5
Bobby Portis,22-018,F,2/28/17,CHI,DEN,1,28,5,10,0.5,3,5,0.6,2,5,0.4,0,0,,0,6,6,1,3,0,1,4,12,9.9
Manu Ginobili,39-139,G,12/14/16,SAS,BOS,0,22,5,9,0.556,3,5,0.6,2,4,0.5,0,0,,0,2,2,4,1,0,3,1,12,8.7
Wayne Ellington,29-160,G,4/7/17,MIA,TOR,0,20,4,5,0.8,0,0,,4,5,0.8,0,0,,0,1,1,1,1,0,0,0,12,12.1
Boris Diaw,34-233,F-C,12/5/16,UTA,LAL,1,26,5,5,1,3,3,1,2,2,1,0,0,,0,2,2,4,0,0,0,2,12,13.1
Ryan Anderson,28-244,F,1/5/17,HOU,OKC,1,32,5,11,0.455,3,4,0.75,2,7,0.286,0,0,,2,2,4,1,0,0,0,1,12,8.6
Mason Plumlee,26-265,C-F,11/25/16,POR,NOP,1,33,5,12,0.417,5,12,0.417,0,0,,2,3,0.667,3,11,14,8,1,0,1,2,12,15.4
LaMarcus Aldridge,31-200,F-C,2/4/17,SAS,DEN,1,28,4,10,0.4,4,10,0.4,0,0,,4,4,1,0,5,5,2,1,3,1,2,12,10.8
Derrick Favors,25-179,F-C,1/10/17,UTA,CLE,1,25,5,10,0.5,5,10,0.5,0,0,,2,4,0.5,1,4,5,2,1,1,1,4,12,8.6
Nene Hilario,34-192,F-C,3/24/17,HOU,NOP,0,19,6,10,0.6,6,10,0.6,0,0,,0,0,,2,6,8,2,1,0,1,4,12,10.4
Elfrid Payton,22-266,G,11/14/16,ORL,IND,1,29,5,11,0.455,5,10,0.5,0,1,0,2,2,1,1,6,7,2,2,0,3,2,12,8.4
Brandon Jennings,27-101,G,1/2/17,NYK,ORL,0,24,4,9,0.444,2,4,0.5,2,5,0.4,2,3,0.667,1,2,3,4,0,0,3,1,12,7.6
Tyus Jones,20-182,G,11/8/16,MIN,BRK,0,32,4,7,0.571,2,3,0.667,2,4,0.5,2,3,0.667,1,4,5,7,5,0,3,0,12,17.1
Robert Covington,26-098,F,3/22/17,PHI,OKC,1,25,4,9,0.444,3,6,0.5,1,3,0.333,3,3,1,0,4,4,0,0,1,1,1,12,7.8
Jonas Valanciunas,24-254,C,1/15/17,TOR,NYK,1,28,6,11,0.545,6,11,0.545,0,0,,0,0,,5,11,16,1,0,0,2,3,12,11
Manu Ginobili,39-193,G,2/6/17,SAS,MEM,0,17,5,9,0.556,3,4,0.75,2,5,0.4,0,0,,0,0,0,3,1,0,1,1,12,9.4
Andre Drummond,23-177,C,2/3/17,DET,MIN,1,29,6,14,0.429,6,14,0.429,0,0,,0,0,,6,12,18,0,2,3,3,3,12,12.3
Hassan Whiteside,27-157,C,11/17/16,MIA,MIL,1,29,5,12,0.417,5,12,0.417,0,0,,2,4,0.5,7,10,17,0,2,6,1,3,12,16.7
Clint Capela,22-306,F-C,3/20/17,HOU,DEN,1,27,6,8,0.75,6,8,0.75,0,0,,0,0,,2,7,9,4,1,1,0,5,12,14.8
Frank Kaminsky,23-238,F-C,11/28/16,CHO,MEM,1,31,5,12,0.417,5,8,0.625,0,4,0,2,2,1,0,6,6,3,0,0,0,0,12,9.5
Ish Smith,28-238,G,2/28/17,DET,POR,0,29,5,13,0.385,5,12,0.417,0,1,0,2,2,1,0,1,1,7,7,1,2,1,12,15.4
Mason Plumlee,26-339,C-F,2/7/17,POR,DAL,1,27,3,4,0.75,3,4,0.75,0,0,,6,6,1,4,11,15,2,1,0,1,5,12,15.9
Carmelo Anthony,32-166,F,11/11/16,NYK,BOS,1,12,5,8,0.625,4,7,0.571,1,1,1,1,1,1,0,2,2,1,0,0,1,2,12,7.9
Kelly Olynyk,25-263,C-F,1/7/17,BOS,NOP,0,22,5,9,0.556,3,6,0.5,2,3,0.667,0,0,,1,3,4,4,0,0,0,3,12,10.9
Rudy Gobert,24-171,C,12/14/16,UTA,OKC,1,30,5,5,1,5,5,1,0,0,,2,2,1,1,11,12,0,2,3,1,5,12,15.6
Michael Kidd-Gilchrist,23-103,F,1/7/17,CHO,SAS,1,30,6,9,0.667,6,9,0.667,0,0,,0,0,,1,8,9,2,2,0,2,3,12,11.4
Monta Ellis,31-135,G,3/10/17,IND,MIL,0,28,4,7,0.571,4,5,0.8,0,2,0,4,6,0.667,1,1,2,1,0,0,2,5,12,5.6
Tyler Johnson,24-174,G,10/28/16,MIA,CHO,0,29,4,10,0.4,2,6,0.333,2,4,0.5,2,2,1,1,5,6,0,0,0,1,3,12,6.6
Michael Beasley,27-333,F,12/7/16,MIL,POR,0,22,5,7,0.714,4,6,0.667,1,1,1,1,2,0.5,0,8,8,0,1,0,2,2,12,9.3
Justin Holiday,28-002,G,4/7/17,NYK,MEM,1,27,5,13,0.385,3,6,0.5,2,7,0.286,0,0,,1,1,2,2,3,0,1,0,12,9.3
Darren Collison,29-153,G,1/23/17,SAC,DET,1,26,4,5,0.8,2,3,0.667,2,2,1,2,2,1,0,4,4,3,1,0,3,1,12,11
Elfrid Payton,23-037,G,3/31/17,ORL,BOS,1,34,5,13,0.385,5,13,0.385,0,0,,2,2,1,1,8,9,15,2,0,2,3,12,17.3
Danny Green,29-229,G-F,2/6/17,SAS,MEM,1,33,5,12,0.417,3,6,0.5,2,6,0.333,0,0,,2,6,8,2,0,2,3,1,12,8.2
Myles Turner,20-228,F-C,11/7/16,IND,CHO,1,21,5,8,0.625,5,6,0.833,0,2,0,2,2,1,0,5,5,0,0,2,1,2,12,9.5
Thabo Sefolosha,32-235,G-F,12/23/16,ATL,DEN,1,29,4,8,0.5,2,5,0.4,2,3,0.667,2,2,1,2,2,4,3,4,1,0,1,12,16.4
Eric Gordon,28-052,G,2/15/17,HOU,MIA,0,32,4,15,0.267,1,5,0.2,3,10,0.3,1,1,1,0,2,2,2,1,0,1,1,12,4.7
Brandon Rush,31-249,G-F,3/13/17,MIN,WAS,1,33,4,8,0.5,0,1,0,4,7,0.571,0,0,,0,2,2,1,0,1,2,3,12,6.8
Emmanuel Mudiay,20-273,G,12/3/16,DEN,UTA,1,22,5,11,0.455,3,7,0.429,2,4,0.5,0,0,,0,3,3,0,1,2,0,1,12,9.2
Thaddeus Young,28-188,F,12/26/16,IND,CHI,1,32,5,11,0.455,3,6,0.5,2,5,0.4,0,0,,3,3,6,0,3,0,3,1,12,8.9
James Johnson,29-323,F,1/8/17,MIA,LAC,0,27,4,10,0.4,2,5,0.4,2,5,0.4,2,2,1,1,5,6,3,1,1,3,3,12,8.4
Robin Lopez,28-289,C,1/15/17,CHI,MEM,1,37,5,11,0.455,5,11,0.455,0,0,,2,5,0.4,3,4,7,2,0,3,1,1,12,10.5
Reggie Jackson,26-300,G,2/10/17,DET,SAS,1,29,5,13,0.385,3,9,0.333,2,4,0.5,0,0,,0,1,1,7,1,0,2,1,12,8.7
Marcin Gortat,33-011,C-F,2/28/17,WAS,GSW,1,23,5,8,0.625,5,8,0.625,0,0,,2,2,1,3,9,12,1,0,1,4,4,12,9
Allen Crabbe,24-203,G-F,10/29/16,POR,DEN,0,29,4,10,0.4,3,6,0.5,1,4,0.25,3,3,1,0,3,3,4,1,0,1,3,12,9.1
Matt Barnes,37-026,F,4/4/17,GSW,MIN,1,26,5,6,0.833,3,3,1,2,3,0.667,0,0,,0,6,6,4,1,0,0,3,12,14.2
Jusuf Nurkic,22-067,C,10/29/16,DEN,POR,1,23,4,9,0.444,4,9,0.444,0,0,,4,6,0.667,4,5,9,1,0,1,2,2,12,9.4
Robin Lopez,28-337,C,3/4/17,CHI,LAC,1,27,6,14,0.429,6,14,0.429,0,0,,0,0,,4,2,6,2,0,0,2,3,12,6.2
Evan Fournier,24-138,G-F,3/16/17,ORL,GSW,1,24,3,9,0.333,0,2,0,3,7,0.429,3,4,0.75,0,1,1,0,0,0,1,1,12,5.4
Gorgui Dieng,27-027,C,2/14/17,MIN,CLE,1,38,4,9,0.444,3,7,0.429,1,2,0.5,3,3,1,2,8,10,1,0,0,0,4,12,10.2
Courtney Lee,31-156,G,3/8/17,NYK,MIL,1,37,4,12,0.333,2,7,0.286,2,5,0.4,2,2,1,1,6,7,5,0,0,0,1,12,10.8
Will Barton,25-352,G,12/23/16,DEN,ATL,0,34,4,9,0.444,3,6,0.5,1,3,0.333,3,5,0.6,0,4,4,5,0,1,0,3,12,10.7
Taj Gibson,31-202,F,1/12/17,CHI,NYK,1,25,4,8,0.5,4,8,0.5,0,0,,4,5,0.8,5,4,9,0,0,0,3,2,12,8.5
David Lee,33-316,F,3/11/17,SAS,GSW,1,18,4,6,0.667,4,6,0.667,0,0,,4,4,1,1,5,6,2,0,0,1,2,12,11.2
Joakim Noah,31-322,C,1/12/17,NYK,CHI,1,27,6,10,0.6,6,10,0.6,0,0,,0,0,,9,7,16,1,0,1,3,3,12,13
Seth Curry,26-142,G,1/12/17,DAL,PHO,1,24,4,5,0.8,1,1,1,3,4,0.75,1,1,1,0,4,4,1,3,1,1,1,12,14.3
Channing Frye,33-298,C-F,3/11/17,CLE,ORL,0,16,4,7,0.571,2,2,1,2,5,0.4,2,2,1,1,2,3,1,0,1,0,1,12,11
Jrue Holiday,26-201,G,12/30/16,NOP,NYK,1,35,5,10,0.5,5,9,0.556,0,1,0,2,2,1,0,4,4,11,1,2,1,1,12,16.9
Seth Curry,26-120,G,12/21/16,DAL,POR,0,24,4,10,0.4,0,2,0,4,8,0.5,0,0,,0,0,0,0,2,0,2,1,12,6.2
Jrue Holiday,26-191,G,12/20/16,NOP,PHI,1,30,4,14,0.286,3,10,0.3,1,4,0.25,3,4,0.75,1,3,4,9,0,0,1,1,12,9.9
Al-Farouq Aminu,26-192,F,4/1/17,POR,PHO,0,26,5,11,0.455,4,7,0.571,1,4,0.25,1,2,0.5,2,4,6,0,3,0,1,4,12,8.9
Terry Rozier,22-272,G,12/14/16,BOS,SAS,0,25,5,13,0.385,3,8,0.375,2,5,0.4,0,0,,2,1,3,2,1,1,0,0,12,9.7
Noah Vonleh,21-203,F,3/15/17,POR,SAS,1,26,4,4,1,4,4,1,0,0,,4,4,1,1,5,6,3,0,0,0,3,12,13.9
Jeremy Lin,28-067,G,10/29/16,BRK,MIL,1,33,4,16,0.25,3,9,0.333,1,7,0.143,3,5,0.6,1,2,3,11,3,1,4,0,12,10.3
Derrick Williams,25-178,F,11/19/16,MIA,WAS,1,17,5,9,0.556,3,5,0.6,2,4,0.5,0,0,,2,3,5,0,0,0,1,1,12,8.6
Omri Casspi,28-134,F,11/3/16,SAC,ORL,0,23,5,13,0.385,3,9,0.333,2,4,0.5,0,0,,3,2,5,0,1,0,1,3,12,6.4
Draymond Green,26-363,F,3/2/17,GSW,CHI,1,35,4,9,0.444,2,4,0.5,2,5,0.4,2,2,1,1,7,8,7,1,2,4,4,12,11.8
Alex Abrines,23-152,G-F,12/31/16,OKC,LAC,0,12,4,5,0.8,0,0,,4,5,0.8,0,0,,0,1,1,0,2,1,0,2,12,12.3
Kevin Love,28-117,F,1/2/17,CLE,NOP,1,24,5,19,0.263,5,12,0.417,0,7,0,2,3,0.667,3,8,11,3,1,0,1,1,12,6.5
Joel Embiid,22-252,C-F,11/23/16,PHI,MEM,1,27,4,10,0.4,3,6,0.5,1,4,0.25,3,4,0.75,1,10,11,3,1,3,7,5,12,6.1
Bismack Biyombo,24-104,C-F,12/10/16,ORL,DEN,1,34,5,9,0.556,5,9,0.556,0,0,,2,6,0.333,3,3,6,4,1,1,0,1,12,13.2
JaMychal Green,26-292,F,4/9/17,MEM,DET,1,24,5,7,0.714,3,5,0.6,2,2,1,0,0,,2,5,7,2,0,0,5,2,12,7.6
Malcolm Brogdon,24-101,G,3/22/17,MIL,SAC,1,29,5,8,0.625,3,4,0.75,2,4,0.5,0,0,,0,1,1,4,1,0,2,2,12,9.7
Jameer Nelson,35-002,G,2/11/17,DEN,CLE,1,37,5,12,0.417,3,7,0.429,2,5,0.4,0,0,,1,7,8,8,2,0,0,4,12,14.4
Draymond Green,26-266,F,11/25/16,GSW,LAL,1,26,5,7,0.714,4,5,0.8,1,2,0.5,1,3,0.333,0,8,8,4,3,1,2,3,12,14
Clint Capela,22-175,F-C,11/9/16,HOU,SAS,1,18,5,8,0.625,5,8,0.625,0,0,,2,4,0.5,2,3,5,0,0,1,2,4,12,7
Bradley Beal,23-183,G,12/28/16,WAS,IND,1,18,5,9,0.556,4,6,0.667,1,3,0.333,1,4,0.25,0,1,1,2,2,0,0,0,12,10.2
Jeremy Lamb,24-278,G-F,3/4/17,CHO,DEN,0,22,5,10,0.5,3,7,0.429,2,3,0.667,0,0,,1,3,4,0,1,0,1,3,12,7.4
C.J. Miles,29-230,G-F,12/4/16,IND,LAC,0,15,4,7,0.571,3,4,0.75,1,3,0.333,3,3,1,2,3,5,0,0,0,2,2,12,8.2
Langston Galloway,25-045,G,1/23/17,NOP,CLE,0,29,3,9,0.333,0,1,0,3,8,0.375,3,3,1,1,4,5,2,1,0,0,3,12,10
C.J. McCollum,25-119,G,1/16/17,POR,WAS,1,23,5,12,0.417,4,9,0.444,1,3,0.333,1,2,0.5,1,1,2,2,2,1,2,3,12,7.1
Tony Parker,34-207,G,12/10/16,SAS,BRK,1,20,5,8,0.625,4,7,0.571,1,1,1,1,1,1,0,1,1,7,1,0,0,0,12,14.6
Darrell Arthur,28-284,F,1/3/17,DEN,SAC,0,18,4,6,0.667,0,1,0,4,5,0.8,0,0,,0,3,3,0,0,1,2,3,12,7.8
Shelvin Mack,26-228,G,12/6/16,UTA,PHO,0,30,4,7,0.571,2,3,0.667,2,4,0.5,2,2,1,0,2,2,4,1,0,3,5,12,8.1
Andre Iguodala,32-305,G-F,11/28/16,GSW,ATL,0,28,5,9,0.556,3,3,1,2,6,0.333,0,2,0,0,5,5,5,0,1,0,2,12,11.8
Marcin Gortat,32-321,C-F,1/3/17,WAS,DAL,1,40,5,11,0.455,5,11,0.455,0,0,,2,2,1,4,12,16,4,0,1,1,2,12,14.4
Terry Rozier,22-249,G,11/21/16,BOS,MIN,0,16,5,8,0.625,3,4,0.75,2,4,0.5,0,0,,1,3,4,2,1,0,0,0,12,12.4
Wayne Ellington,29-035,G,12/3/16,MIA,POR,1,39,5,13,0.385,4,5,0.8,1,8,0.125,1,2,0.5,0,2,2,3,0,0,1,1,12,5.8
Aaron Gordon,21-040,F,10/26/16,ORL,MIA,1,35,5,12,0.417,3,9,0.333,2,3,0.667,0,0,,2,6,8,4,1,1,3,1,12,9.9
Manu Ginobili,39-145,G,12/20/16,SAS,HOU,0,20,4,9,0.444,0,4,0,4,5,0.8,0,2,0,0,4,4,3,3,0,2,2,12,10
Marcin Gortat,32-332,C-F,1/14/17,WAS,PHI,1,23,6,9,0.667,6,9,0.667,0,0,,0,1,0,2,8,10,0,0,1,1,2,12,10.4
Gary Harris,22-180,G,3/13/17,DEN,LAL,1,35,4,15,0.267,3,9,0.333,1,6,0.167,3,4,0.75,2,2,4,7,3,0,2,2,12,9.8
Leandro Barbosa,34-099,G,3/7/17,PHO,WAS,0,23,3,9,0.333,1,3,0.333,2,6,0.333,4,4,1,0,2,2,3,1,1,3,2,12,7.5
JaMychal Green,26-127,F,10/26/16,MEM,MIN,1,29,4,10,0.4,2,8,0.25,2,2,1,2,2,1,4,3,7,1,0,1,1,4,12,9.1
Bojan Bogdanovic,27-265,G-F,1/8/17,BRK,PHI,1,35,5,14,0.357,3,8,0.375,2,6,0.333,0,0,,1,7,8,3,1,0,2,0,12,8.1
Jamal Crawford,36-246,G,11/21/16,LAC,TOR,0,27,5,11,0.455,4,6,0.667,1,5,0.2,1,1,1,0,0,0,1,0,0,2,0,12,5
Norman Powell,23-283,G,3/4/17,TOR,MIL,0,26,4,8,0.5,4,7,0.571,0,1,0,4,4,1,0,2,2,3,0,0,1,4,12,8.1
Dwyane Wade,35-044,G,3/2/17,CHI,GSW,1,34,5,15,0.333,5,12,0.417,0,3,0,2,4,0.5,0,5,5,3,2,0,4,2,12,3.5
Rodney McGruder,25-183,G,1/28/17,MIA,DET,1,26,3,7,0.429,1,3,0.333,2,4,0.5,4,4,1,1,2,3,0,1,0,1,3,12,8.4
Al-Farouq Aminu,26-167,F,3/7/17,POR,OKC,0,30,5,6,0.833,4,5,0.8,1,1,1,1,2,0.5,1,6,7,0,1,3,2,2,12,12.2
Willie Cauley-Stein,23-158,F-C,1/23/17,SAC,DET,0,21,5,8,0.625,5,8,0.625,0,0,,2,2,1,3,2,5,0,1,1,0,0,12,12.8
Kenneth Faried,26-353,F,11/6/16,DEN,BOS,0,24,2,4,0.5,2,4,0.5,0,0,,8,12,0.667,5,6,11,1,1,1,2,3,12,12.9
Tyler Ulis,21-092,G,4/7/17,PHO,OKC,1,39,4,7,0.571,4,6,0.667,0,1,0,4,4,1,0,0,0,5,2,0,3,3,12,10
Ish Smith,28-247,G,3/9/17,DET,CLE,0,17,5,9,0.556,4,8,0.5,1,1,1,1,2,0.5,0,3,3,3,1,0,1,0,12,10.3
Otto Porter,23-246,F,2/4/17,WAS,NOP,1,34,4,10,0.4,2,4,0.5,2,6,0.333,2,2,1,1,8,9,0,3,0,1,2,12,10.9
Eric Gordon,28-071,G,3/6/17,HOU,SAS,0,34,4,10,0.4,2,3,0.667,2,7,0.286,2,2,1,1,3,4,3,1,1,2,4,12,8.4
Zach Randolph,35-119,F,11/12/16,MEM,MIL,0,23,6,13,0.462,6,12,0.5,0,1,0,0,0,,1,6,7,1,3,0,0,1,12,11.1
Marvin Williams,30-180,F,12/16/16,CHO,BOS,1,31,5,11,0.455,3,7,0.429,2,4,0.5,0,0,,3,3,6,3,0,0,1,1,12,10
Nikola Mirotic,25-326,F,1/2/17,CHI,CHO,0,28,4,10,0.4,2,3,0.667,2,7,0.286,2,2,1,1,1,2,0,2,2,1,1,12,9.6
Vince Carter,39-343,G-F,1/3/17,MEM,LAL,0,21,3,7,0.429,1,3,0.333,2,4,0.5,4,4,1,1,1,2,0,1,1,0,1,12,10.6
Dwight Howard,31-050,C,1/27/17,ATL,WAS,1,29,4,5,0.8,4,5,0.8,0,0,,4,8,0.5,4,9,13,1,2,0,3,3,12,12.5
Kris Humphries,32-060,F-C,4/7/17,ATL,CLE,1,25,5,10,0.5,3,7,0.429,2,3,0.667,0,0,,1,6,7,4,1,0,1,2,12,11.5
Sam Dekker,22-199,F,11/21/16,HOU,DET,0,25,5,8,0.625,3,6,0.5,2,2,1,0,0,,0,4,4,1,0,0,0,1,12,9.9
T.J. Warren,23-131,F,1/14/17,PHO,SAS,1,26,6,10,0.6,6,10,0.6,0,0,,0,0,,0,1,1,0,2,0,2,4,12,6.1
Robin Lopez,28-251,C,12/8/16,CHI,SAS,1,28,6,9,0.667,6,9,0.667,0,0,,0,0,,1,3,4,0,0,1,0,0,12,10.4
Lou Williams,30-132,G,3/8/17,HOU,UTA,0,23,2,10,0.2,0,5,0,2,5,0.4,6,7,0.857,0,3,3,5,0,1,0,1,12,10.1
Rondae Hollis-Jefferson,22-062,F,3/6/17,BRK,MEM,1,23,5,10,0.5,5,8,0.625,0,2,0,2,4,0.5,0,4,4,2,3,1,0,2,12,11.7
Marcus Smart,22-269,G,11/30/16,BOS,DET,0,24,4,14,0.286,2,6,0.333,2,8,0.25,2,2,1,2,0,2,3,1,0,0,3,12,7.1
Clint Capela,22-292,F-C,3/6/17,HOU,SAS,1,25,6,11,0.545,6,11,0.545,0,0,,0,0,,2,6,8,0,1,0,1,4,12,8.3
Marcin Gortat,33-012,C-F,3/1/17,WAS,TOR,1,18,6,8,0.75,6,8,0.75,0,0,,0,0,,1,7,8,1,0,0,1,3,12,10.1
Marcin Gortat,32-282,C-F,11/25/16,WAS,ORL,1,34,6,9,0.667,6,8,0.75,0,1,0,0,0,,1,8,9,2,0,0,1,2,12,10.8
Steven Adams,23-138,C,12/5/16,OKC,ATL,1,28,5,10,0.5,5,10,0.5,0,0,,2,5,0.4,6,4,10,0,1,0,2,4,12,8.6
Devin Harris,33-346,G,2/7/17,DAL,POR,0,27,3,8,0.375,1,4,0.25,2,4,0.5,4,6,0.667,0,7,7,2,1,0,1,3,12,9.1
Gerald Henderson,29-066,G,2/13/17,PHI,CHO,1,28,4,8,0.5,3,4,0.75,1,4,0.25,3,3,1,0,4,4,1,0,0,2,3,12,6.7
Ryan Anderson,28-179,F,11/1/16,HOU,CLE,1,31,4,12,0.333,0,5,0,4,7,0.571,0,0,,3,1,4,1,0,0,0,3,12,7.1
Victor Oladipo,24-219,G,12/9/16,OKC,HOU,1,38,5,13,0.385,3,6,0.5,2,7,0.286,0,0,,0,7,7,1,0,0,3,1,12,4.3
Rudy Gobert,24-121,C,10/25/16,UTA,POR,1,41,4,7,0.571,4,7,0.571,0,0,,4,4,1,4,10,14,2,0,2,3,3,12,13.1
Ian Clark,26-009,G,3/16/17,GSW,ORL,0,20,5,8,0.625,3,5,0.6,2,3,0.667,0,0,,0,2,2,2,1,0,1,4,12,8.8
Evan Fournier,24-165,G-F,4/12/17,ORL,DET,1,27,4,11,0.364,2,7,0.286,2,4,0.5,2,2,1,0,3,3,2,0,0,1,1,12,6.8
Frank Kaminsky,23-315,F-C,2/13/17,CHO,PHI,1,38,5,16,0.313,4,10,0.4,1,6,0.167,1,4,0.25,1,10,11,2,1,3,3,1,12,6.4
Marquese Chriss,19-177,F,12/26/16,PHO,HOU,1,19,5,9,0.556,4,5,0.8,1,4,0.25,1,2,0.5,3,2,5,1,0,2,2,3,12,8.9
Ersan Ilyasova,29-243,F,1/13/17,PHI,CHO,1,30,5,14,0.357,3,7,0.429,2,7,0.286,0,0,,1,2,3,1,2,0,1,2,12,6.4
Myles Turner,20-237,F-C,11/16/16,IND,CLE,1,33,6,11,0.545,6,11,0.545,0,0,,0,3,0,1,8,9,0,1,4,1,1,12,11
Dante Cunningham,29-294,F,2/10/17,NOP,MIN,1,38,4,8,0.5,1,3,0.333,3,5,0.6,1,2,0.5,0,4,4,1,0,1,1,2,12,8.4
Noah Vonleh,21-220,F,4/1/17,POR,PHO,1,35,6,8,0.75,6,8,0.75,0,0,,0,0,,5,8,13,2,2,0,2,5,12,14.1
Kyle Lowry,30-289,G,1/8/17,TOR,HOU,1,40,2,7,0.286,1,4,0.25,1,3,0.333,7,10,0.7,0,5,5,6,4,0,3,3,12,12.2
Richaun Holmes,23-132,F-C,2/24/17,PHI,WAS,0,26,6,9,0.667,6,8,0.75,0,1,0,0,0,,3,7,10,1,2,5,0,3,12,17.3
Yogi Ferrell,23-274,G,2/7/17,DAL,POR,1,35,4,9,0.444,3,5,0.6,1,4,0.25,3,3,1,0,2,2,2,1,0,2,2,12,7.5
Willie Reed,26-284,F-C,2/24/17,MIA,ATL,0,23,6,8,0.75,6,8,0.75,0,0,,0,0,,5,5,10,0,0,0,1,4,12,11.2
Arron Afflalo,31-022,G,11/6/16,SAC,TOR,1,36,5,8,0.625,4,7,0.571,1,1,1,1,2,0.5,0,5,5,1,0,0,0,3,12,9
Greg Monroe,26-287,C-F,3/18/17,MIL,GSW,0,17,6,13,0.462,6,13,0.462,0,0,,0,0,,4,3,7,2,1,0,2,2,12,8.6
Aron Baynes,30-087,C,3/6/17,DET,CHI,0,18,6,9,0.667,6,9,0.667,0,0,,0,0,,3,4,7,2,1,1,1,5,12,11.5
DeMarre Carroll,30-233,F,3/17/17,TOR,DET,1,24,4,9,0.444,3,5,0.6,1,4,0.25,3,4,0.75,1,0,1,1,1,0,0,2,12,8.5
Dwight Powell,25-261,F-C,4/7/17,DAL,SAS,0,25,5,9,0.556,3,3,1,2,6,0.333,0,2,0,2,4,6,1,0,1,1,2,12,9.1
Jamal Murray,20-023,G,3/18/17,DEN,HOU,0,23,4,13,0.308,2,8,0.25,2,5,0.4,2,4,0.5,0,4,4,1,2,0,3,4,12,3
Taj Gibson,31-154,F,11/25/16,CHI,PHI,1,22,4,5,0.8,4,5,0.8,0,0,,4,5,0.8,0,6,6,1,0,2,3,2,12,9.8
Brandon Jennings,27-039,G,11/1/16,NYK,DET,0,19,5,11,0.455,3,7,0.429,2,4,0.5,0,1,0,0,2,2,3,0,0,0,0,12,8.6
Willie Cauley-Stein,23-218,F-C,3/24/17,SAC,GSW,1,28,5,6,0.833,5,6,0.833,0,0,,2,2,1,1,3,4,2,1,0,1,3,12,11.6
Nicolas Batum,27-319,F-G,10/28/16,CHO,MIA,1,31,4,14,0.286,2,7,0.286,2,7,0.286,2,2,1,2,4,6,4,2,0,3,1,12,7.8
Kentavious Caldwell-Pope,23-292,G,12/6/16,DET,CHI,1,31,5,10,0.5,4,5,0.8,1,5,0.2,1,2,0.5,1,2,3,3,1,0,2,3,12,7.8
DeAndre Jordan,28-235,C,3/13/17,LAC,UTA,1,37,5,9,0.556,5,8,0.625,0,1,0,2,2,1,1,6,7,1,0,2,3,3,12,8.1
Gerald Henderson,29-057,G,2/4/17,PHI,MIA,1,25,6,12,0.5,6,12,0.5,0,0,,0,0,,0,0,0,2,2,0,0,2,12,8.6
Montrezl Harrell,23-041,F-C,3/8/17,HOU,UTA,0,16,5,6,0.833,5,6,0.833,0,0,,2,2,1,1,1,2,1,0,1,0,3,12,11
Buddy Hield,23-013,G,12/30/16,NOP,NYK,1,24,3,9,0.333,1,4,0.25,2,5,0.4,4,4,1,0,2,2,1,0,0,1,0,12,7.2
Gorgui Dieng,26-357,C,1/9/17,MIN,DAL,1,25,5,8,0.625,5,8,0.625,0,0,,2,4,0.5,2,3,5,0,0,0,1,1,12,8.5
Omri Casspi,28-171,F,12/10/16,SAC,UTA,0,27,5,9,0.556,3,6,0.5,2,3,0.667,0,0,,2,3,5,2,2,0,1,1,12,12
LaMarcus Aldridge,31-265,F-C,4/10/17,SAS,POR,1,18,5,8,0.625,5,7,0.714,0,1,0,2,2,1,0,4,4,0,0,1,0,1,12,9.9
Clint Capela,22-258,F-C,1/31/17,HOU,SAC,1,20,5,8,0.625,5,8,0.625,0,0,,2,5,0.4,4,7,11,1,0,0,2,5,12,8.8
Jon Leuer,27-191,F,11/21/16,DET,HOU,0,31,4,9,0.444,4,9,0.444,0,0,,4,4,1,2,6,8,0,0,1,2,2,12,8.4
Dion Waiters,25-040,G,1/19/17,MIA,DAL,1,32,5,12,0.417,4,10,0.4,1,2,0.5,1,2,0.5,0,3,3,3,0,0,3,2,12,4.4
Timothe Luwawu-Cabarrot,21-312,F,3/17/17,PHI,DAL,1,30,4,8,0.5,2,5,0.4,2,3,0.667,2,2,1,1,3,4,2,1,0,1,5,12,9
Serge Ibaka,27-133,F-C,1/29/17,ORL,TOR,1,33,5,10,0.5,5,7,0.714,0,3,0,2,2,1,1,6,7,1,0,1,2,3,12,7.7
Meyers Leonard,24-339,C-F,1/31/17,POR,CHO,0,25,4,11,0.364,2,5,0.4,2,6,0.333,2,2,1,0,3,3,4,0,1,0,5,12,8.3
Chandler Parsons,28-132,F,3/6/17,MEM,BRK,1,22,3,6,0.5,1,3,0.333,2,3,0.667,4,4,1,0,1,1,3,1,0,1,1,12,11
DeAndre Jordan,28-148,C,12/16/16,LAC,MIA,1,35,5,7,0.714,5,7,0.714,0,0,,2,3,0.667,3,16,19,0,0,3,0,3,12,16.5
Danilo Gallinari,28-126,F,12/12/16,DEN,DAL,1,28,3,10,0.3,1,5,0.2,2,5,0.4,4,4,1,1,7,8,0,0,0,1,0,12,8
Aron Baynes,30-040,C,1/18/17,DET,ATL,0,22,3,5,0.6,3,5,0.6,0,0,,6,8,0.75,2,2,4,2,0,0,0,4,12,10.7
Beno Udrih,34-141,G,11/23/16,DET,MIA,0,30,5,11,0.455,4,8,0.5,1,3,0.333,1,2,0.5,2,1,3,5,1,0,1,1,12,10.7
Al Horford,30-306,C-F,4/5/17,BOS,CLE,1,28,4,6,0.667,3,5,0.6,1,1,1,3,3,1,1,6,7,3,0,0,2,3,12,10.8
Channing Frye,33-172,C-F,11/5/16,CLE,PHI,0,18,4,9,0.444,0,1,0,4,8,0.5,0,0,,0,2,2,2,2,0,0,3,12,10.1
Norris Cole,28-180,G,4/11/17,OKC,MIN,0,23,4,11,0.364,3,8,0.375,1,3,0.333,3,4,0.75,0,2,2,3,2,0,0,3,12,9
Domantas Sabonis,20-192,F,11/11/16,OKC,LAC,1,28,4,5,0.8,0,0,,4,5,0.8,0,0,,0,1,1,2,0,0,3,2,12,8
Sam Dekker,22-215,F,12/7/16,HOU,LAL,0,23,6,10,0.6,6,7,0.857,0,3,0,0,0,,5,3,8,4,0,0,2,4,12,11
Jordan Crawford,28-152,G,3/24/17,NOP,HOU,0,18,4,10,0.4,2,4,0.5,2,6,0.333,2,2,1,0,1,1,2,1,0,2,0,12,7.3
Malcolm Delaney,27-330,G,2/4/17,ATL,ORL,0,21,5,8,0.625,3,4,0.75,2,4,0.5,0,0,,0,1,1,1,0,0,0,4,12,7.8
Allen Crabbe,24-291,G-F,1/25/17,POR,LAL,0,28,6,9,0.667,6,8,0.75,0,1,0,0,0,,0,3,3,1,0,0,3,1,12,6.3
J.J. Redick,32-244,G,2/23/17,LAC,GSW,1,30,4,10,0.4,2,4,0.5,2,6,0.333,2,2,1,0,2,2,1,2,0,2,0,12,7.9
Kelly Olynyk,25-334,C-F,3/19/17,BOS,PHI,0,11,3,4,0.75,3,3,1,0,1,0,6,7,0.857,0,1,1,1,0,0,0,3,12,9.8
Malcolm Brogdon,23-364,G,12/9/16,MIL,ATL,0,28,5,10,0.5,3,7,0.429,2,3,0.667,0,0,,0,2,2,4,2,0,2,3,12,9.2
Shabazz Muhammad,24-091,F-G,2/12/17,MIN,CHI,0,19,5,7,0.714,5,5,1,0,2,0,2,3,0.667,1,1,2,0,1,0,1,2,12,8.9
Al Jefferson,31-363,C-F,1/1/17,IND,ORL,0,14,5,9,0.556,5,9,0.556,0,0,,2,2,1,0,3,3,1,0,1,1,2,12,8.2
D'Angelo Russell,20-259,G,11/8/16,LAL,DAL,1,26,5,9,0.556,3,5,0.6,2,4,0.5,0,1,0,0,5,5,7,0,0,3,4,12,9.1
Gorgui Dieng,27-051,C,3/10/17,MIN,GSW,1,24,5,10,0.5,5,10,0.5,0,0,,2,2,1,0,4,4,0,1,1,0,2,12,9.1
Ryan Anderson,28-215,F,12/7/16,HOU,LAL,1,25,3,9,0.333,3,6,0.5,0,3,0,6,6,1,2,2,4,0,1,0,1,2,12,8.1
Malik Beasley,19-350,G,11/10/16,DEN,GSW,0,15,5,10,0.5,3,5,0.6,2,5,0.4,0,0,,0,2,2,1,0,0,0,0,12,8.3
Brandon Knight,24-357,G,11/23/16,PHO,ORL,1,25,5,10,0.5,3,5,0.6,2,5,0.4,0,0,,0,0,0,3,0,0,3,2,12,5.3
Skal Labissiere,20-342,F,2/23/17,SAC,DEN,0,14,5,7,0.714,5,7,0.714,0,0,,2,2,1,2,1,3,2,1,0,1,2,12,11.4
Tomas Satoransky,25-013,G,11/12/16,WAS,CHI,1,31,4,12,0.333,3,10,0.3,1,2,0.5,3,3,1,0,4,4,9,1,0,2,3,12,10.5
Ryan Anderson,28-183,F,11/5/16,HOU,ATL,1,31,4,13,0.308,0,3,0,4,10,0.4,0,0,,1,2,3,0,0,0,2,1,12,3.4
Devin Booker,20-044,G,12/13/16,PHO,NYK,1,36,3,16,0.188,2,11,0.182,1,5,0.2,5,5,1,0,1,1,0,0,1,1,2,12,1.2
Trevor Ariza,31-197,F,1/13/17,HOU,MEM,1,37,4,11,0.364,3,5,0.6,1,6,0.167,3,4,0.75,4,5,9,1,1,0,2,0,12,9.5
Eric Bledsoe,27-092,G,3/11/17,PHO,DAL,1,31,4,16,0.25,3,11,0.273,1,5,0.2,3,3,1,0,2,2,6,1,1,4,3,12,3.7
Julius Randle,22-000,F,11/29/16,LAL,NOP,1,22,6,9,0.667,6,8,0.75,0,1,0,0,2,0,0,10,10,3,0,0,2,3,12,9.2
Markieff Morris,27-153,F,2/2/17,WAS,LAL,1,35,3,14,0.214,3,9,0.333,0,5,0,6,8,0.75,2,8,10,2,3,2,2,4,12,8.6
Marquese Chriss,19-190,F,1/8/17,PHO,CLE,1,33,4,11,0.364,3,9,0.333,1,2,0.5,3,4,0.75,1,2,3,4,1,3,1,3,12,10.5
Alex Len,23-287,C,3/30/17,PHO,LAC,1,18,4,4,1,4,4,1,0,0,,4,6,0.667,1,2,3,0,0,1,2,3,12,8.8
Gorgui Dieng,26-296,C,11/9/16,MIN,ORL,1,35,6,9,0.667,6,9,0.667,0,0,,0,0,,3,8,11,7,2,1,2,5,12,16.2
Brandon Jennings,27-064,G,11/26/16,NYK,CHO,0,25,5,10,0.5,3,5,0.6,2,5,0.4,0,1,0,0,1,1,4,5,0,1,4,12,12.1
Patty Mills,28-159,G,1/17/17,SAS,MIN,0,19,4,10,0.4,1,5,0.2,3,5,0.6,0,0,,0,0,0,4,1,0,1,1,11,8
Malcolm Brogdon,24-019,G,12/30/16,MIL,MIN,1,33,4,8,0.5,3,6,0.5,1,2,0.5,2,2,1,1,3,4,4,1,0,2,1,11,10
Tyler Johnson,24-239,G,1/1/17,MIA,DET,0,29,3,10,0.3,2,8,0.25,1,2,0.5,4,5,0.8,0,1,1,5,1,2,1,2,11,9.2
Tony Allen,34-312,G-F,11/18/16,MEM,DAL,0,18,5,6,0.833,5,6,0.833,0,0,,1,1,1,2,1,3,0,2,1,0,5,11,11.2
Richaun Holmes,23-051,F-C,12/5/16,PHI,DEN,0,18,5,8,0.625,5,7,0.714,0,1,0,1,2,0.5,5,3,8,1,0,2,1,4,11,10.9
Mike Muscala,25-157,F-C,12/5/16,ATL,OKC,0,22,3,3,1,2,2,1,1,1,1,4,4,1,0,5,5,2,0,1,2,4,11,10.1
Rondae Hollis-Jefferson,21-344,F,12/12/16,BRK,HOU,0,15,3,4,0.75,3,4,0.75,0,0,,5,6,0.833,2,3,5,0,2,0,0,1,11,12.9
Anthony Morrow,31-081,G,12/17/16,OKC,PHO,1,21,4,6,0.667,1,2,0.5,3,4,0.75,0,0,,0,0,0,0,2,0,0,0,11,10.4
Dewayne Dedmon,27-125,C,12/15/16,SAS,PHO,0,23,5,6,0.833,5,6,0.833,0,0,,1,2,0.5,1,8,9,0,0,1,0,2,11,11.4
Mike Muscala,25-131,F-C,11/9/16,ATL,CHI,0,16,4,8,0.5,3,5,0.6,1,3,0.333,2,2,1,3,3,6,1,0,0,1,2,11,8.9
Shabazz Muhammad,24-117,F-G,3/10/17,MIN,GSW,0,28,5,9,0.556,5,7,0.714,0,2,0,1,2,0.5,2,5,7,0,0,0,1,1,11,7.8
Kent Bazemore,27-124,G-F,11/2/16,ATL,LAL,1,31,5,13,0.385,4,7,0.571,1,6,0.167,0,0,,0,0,0,6,3,0,0,1,11,10.7
Robert Covington,26-054,F,2/6/17,PHI,DET,1,29,2,10,0.2,0,5,0,2,5,0.4,5,7,0.714,1,3,4,1,3,0,1,2,11,7.5
Zach Randolph,35-130,F,11/23/16,MEM,PHI,0,27,5,14,0.357,5,13,0.385,0,1,0,1,2,0.5,1,5,6,1,1,2,0,5,11,6.1
Ricky Rubio,26-134,G,3/4/17,MIN,SAS,1,43,4,12,0.333,3,10,0.3,1,2,0.5,2,4,0.5,2,11,13,10,3,0,4,3,11,12.9
Terry Rozier,22-336,G,2/16/17,BOS,CHI,0,23,3,8,0.375,0,2,0,3,6,0.5,2,2,1,0,3,3,3,0,1,0,2,11,9.5
Ben McLemore,24-001,G,2/12/17,SAC,NOP,1,28,4,7,0.571,1,2,0.5,3,5,0.6,0,0,,2,0,2,1,1,1,2,3,11,8.3
John Henson,26-024,C-F,1/21/17,MIL,MIA,1,22,4,7,0.571,4,7,0.571,0,0,,3,4,0.75,2,7,9,0,0,1,2,3,11,8.3
Kay Felder,21-272,G,12/26/16,CLE,DET,0,20,2,8,0.25,2,7,0.286,0,1,0,7,8,0.875,0,3,3,2,1,0,1,0,11,8.1
Marcus Morris,27-121,F,1/1/17,DET,MIA,1,31,4,9,0.444,2,6,0.333,2,3,0.667,1,2,0.5,0,1,1,1,0,0,1,3,11,4.7
Willy Hernangomez,22-315,C,4/7/17,NYK,MEM,1,29,4,7,0.571,4,7,0.571,0,0,,3,5,0.6,3,7,10,3,2,0,2,4,11,11.6
Kawhi Leonard,25-280,F,4/5/17,SAS,LAL,1,14,5,8,0.625,4,6,0.667,1,2,0.5,0,0,,0,2,2,3,2,1,1,1,11,11.4
Shelvin Mack,26-223,G,12/1/16,UTA,MIA,0,33,4,9,0.444,3,7,0.429,1,2,0.5,2,4,0.5,0,5,5,5,1,0,2,2,11,8.7
Danilo Gallinari,28-094,F,11/10/16,DEN,GSW,1,26,2,9,0.222,1,4,0.25,1,5,0.2,6,7,0.857,0,1,1,2,0,0,2,1,11,4.4
Spencer Hawes,28-209,C-F,11/23/16,CHO,SAS,0,20,4,10,0.4,4,9,0.444,0,1,0,3,4,0.75,1,2,3,3,1,1,0,1,11,9.9
P.J. Tucker,31-187,F,11/8/16,PHO,POR,0,30,3,5,0.6,3,5,0.6,0,0,,5,6,0.833,5,4,9,4,5,0,0,5,11,18.8
Doug McDermott,25-065,F,3/9/17,OKC,SAS,0,22,5,10,0.5,4,7,0.571,1,3,0.333,0,0,,0,0,0,1,0,0,0,1,11,6.3
Aaron Brooks,32-076,G,3/31/17,IND,TOR,0,15,4,9,0.444,3,6,0.5,1,3,0.333,2,2,1,1,2,3,2,0,0,1,3,11,6.8
Damjan Rudez,30-152,F,11/16/16,ORL,NOP,0,15,4,5,0.8,1,1,1,3,4,0.75,0,0,,2,1,3,0,0,0,0,0,11,10.8
Jerami Grant,22-276,F,12/13/16,OKC,POR,1,26,3,8,0.375,3,7,0.429,0,1,0,5,6,0.833,0,1,1,0,1,0,1,4,11,4.9
Quincy Acy,26-164,F,3/19/17,BRK,DAL,0,21,2,5,0.4,0,2,0,2,3,0.667,5,7,0.714,1,2,3,0,0,0,1,2,11,7
Darren Collison,29-148,G,1/18/17,SAC,IND,1,37,4,8,0.5,4,8,0.5,0,0,,3,4,0.75,0,2,2,9,4,0,0,3,11,16.3
Mason Plumlee,26-267,C-F,11/27/16,POR,HOU,1,33,5,7,0.714,5,7,0.714,0,0,,1,4,0.25,5,3,8,7,0,1,3,4,11,12.3
Joe Harris,25-085,G,12/1/16,BRK,MIL,0,23,4,11,0.364,1,3,0.333,3,8,0.375,0,0,,0,4,4,3,0,0,0,1,11,7.8
C.J. Miles,29-246,G-F,12/20/16,IND,NYK,0,26,2,8,0.25,0,3,0,2,5,0.4,5,6,0.833,1,6,7,0,2,0,2,3,11,7.1
Gorgui Dieng,27-021,C,2/8/17,MIN,TOR,1,32,4,8,0.5,3,7,0.429,1,1,1,2,2,1,3,6,9,1,2,0,0,4,11,12
Tristan Thompson,25-229,F-C,10/28/16,CLE,TOR,1,36,5,5,1,5,5,1,0,0,,1,2,0.5,3,7,10,1,0,1,0,1,11,14.3
P.J. Tucker,31-262,F,1/22/17,PHO,TOR,0,32,5,10,0.5,5,8,0.625,0,2,0,1,2,0.5,2,8,10,0,1,0,1,4,11,7.8
Randy Foye,33-118,G,1/20/17,BRK,NOP,0,22,4,7,0.571,1,2,0.5,3,5,0.6,0,0,,0,3,3,1,0,0,1,2,11,7.5
Willie Cauley-Stein,23-090,F-C,11/16/16,SAC,SAS,0,13,3,5,0.6,3,5,0.6,0,0,,5,7,0.714,1,3,4,0,1,0,2,2,11,7.7
Vince Carter,39-285,G-F,11/6/16,MEM,POR,0,26,4,10,0.4,3,5,0.6,1,5,0.2,2,2,1,2,3,5,1,1,0,2,2,11,6.8
Evan Fournier,24-027,G-F,11/25/16,ORL,WAS,1,32,2,9,0.222,1,5,0.2,1,4,0.25,6,6,1,2,0,2,4,1,0,2,4,11,7.1
Aaron Gordon,21-085,F,12/10/16,ORL,DEN,1,22,4,7,0.571,3,4,0.75,1,3,0.333,2,2,1,1,5,6,3,1,0,0,4,11,11.4
Devin Booker,20-024,G,11/23/16,PHO,ORL,1,34,4,10,0.4,3,7,0.429,1,3,0.333,2,2,1,0,3,3,1,2,1,1,4,11,7.3
Kristaps Porzingis,21-122,F-C,12/2/16,NYK,MIN,1,40,2,12,0.167,0,6,0,2,6,0.333,5,7,0.714,2,3,5,3,0,3,4,4,11,3.5
Vince Carter,39-344,G-F,1/4/17,MEM,LAC,0,30,4,10,0.4,1,5,0.2,3,5,0.6,0,2,0,2,5,7,1,0,2,1,3,11,7.6
Toney Douglas,30-329,G,2/8/17,MEM,PHO,0,25,2,6,0.333,1,4,0.25,1,2,0.5,6,6,1,1,3,4,3,0,2,4,3,11,7.5
Iman Shumpert,26-290,G,4/12/17,CLE,TOR,1,30,3,8,0.375,3,5,0.6,0,3,0,5,6,0.833,1,2,3,3,2,0,4,1,11,7.2
Khris Middleton,25-185,F-G,2/13/17,MIL,DET,0,18,4,7,0.571,4,7,0.571,0,0,,3,3,1,0,2,2,3,0,0,2,5,11,6.4
Kent Bazemore,27-180,G-F,12/28/16,ATL,NYK,1,40,4,12,0.333,3,8,0.375,1,4,0.25,2,2,1,0,1,1,4,0,0,3,4,11,2.7
Darren Collison,29-190,G,3/1/17,SAC,BRK,1,31,5,10,0.5,4,9,0.444,1,1,1,0,0,,0,4,4,2,1,1,3,4,11,5.7
Davis Bertans,24-011,F,11/23/16,SAS,CHO,0,11,4,4,1,1,1,1,3,3,1,0,0,,0,0,0,0,0,1,2,0,11,8.5
Joe Ingles,29-079,F-G,12/20/16,UTA,GSW,0,27,4,13,0.308,1,6,0.167,3,7,0.429,0,0,,1,4,5,3,2,0,2,4,11,5.9
Seth Curry,26-087,G,11/18/16,DAL,MEM,1,34,4,14,0.286,2,10,0.2,2,4,0.5,1,1,1,2,2,4,2,0,0,1,3,11,4
Marco Belinelli,31-006,G-F,3/31/17,CHO,DEN,0,19,3,7,0.429,0,1,0,3,6,0.5,2,2,1,0,0,0,0,0,0,1,2,11,5.5
K.J. McDaniels,24-045,G-F,3/26/17,BRK,ATL,0,22,4,7,0.571,4,5,0.8,0,2,0,3,3,1,0,4,4,1,0,1,1,1,11,8.9
Nikola Mirotic,25-316,F,12/23/16,CHI,CHO,0,19,5,16,0.313,4,9,0.444,1,7,0.143,0,0,,5,5,10,0,1,1,0,2,11,7.7
Caris LeVert,22-156,G-F,1/28/17,BRK,MIN,0,27,4,8,0.5,3,6,0.5,1,2,0.5,2,3,0.667,0,4,4,1,2,1,1,3,11,9
Vince Carter,40-029,G-F,2/24/17,MEM,IND,0,24,3,6,0.5,1,3,0.333,2,3,0.667,3,4,0.75,1,2,3,2,1,1,1,2,11,10.2
Stanley Johnson,20-259,F,2/12/17,DET,TOR,0,24,4,9,0.444,1,4,0.25,3,5,0.6,0,0,,0,2,2,0,1,0,0,1,11,7.5
Draymond Green,26-308,F,1/6/17,GSW,MEM,1,40,3,6,0.5,2,3,0.667,1,3,0.333,4,5,0.8,0,8,8,4,3,0,4,6,11,9.4
Joe Harris,25-128,G,1/13/17,BRK,TOR,1,25,4,7,0.571,1,2,0.5,3,5,0.6,0,0,,1,3,4,0,1,0,0,1,11,9.9
Mason Plumlee,26-311,C-F,1/10/17,POR,LAL,1,24,5,7,0.714,5,7,0.714,0,0,,1,2,0.5,1,6,7,1,1,2,3,5,11,8.3
Cristiano Felicio,24-186,F-C,1/9/17,CHI,OKC,0,24,5,6,0.833,5,6,0.833,0,0,,1,1,1,4,7,11,1,3,0,1,2,11,15.6
Tarik Black,25-098,C-F,2/28/17,LAL,CHO,1,14,5,7,0.714,5,7,0.714,0,0,,1,1,1,2,2,4,0,0,2,3,3,11,7.3
Ty Lawson,29-146,G,3/29/17,SAC,UTA,0,20,4,5,0.8,4,4,1,0,1,0,3,4,0.75,0,1,1,3,1,0,3,1,11,8.7
Langston Galloway,25-014,G,12/23/16,NOP,MIA,0,29,4,11,0.364,1,4,0.25,3,7,0.429,0,0,,0,1,1,0,1,0,1,4,11,3.6
Tony Allen,34-300,G-F,11/6/16,MEM,POR,1,22,3,5,0.6,2,4,0.5,1,1,1,4,4,1,2,5,7,0,4,0,1,2,11,13.8
Harrison Barnes,24-173,F,11/19/16,DAL,ORL,1,39,3,13,0.231,2,10,0.2,1,3,0.333,4,5,0.8,1,5,6,3,2,0,0,2,11,8.2
Danny Green,29-231,G-F,2/8/17,SAS,PHI,1,25,4,8,0.5,1,4,0.25,3,4,0.75,0,0,,0,4,4,0,1,2,2,1,11,8.2
Trevor Ariza,31-124,F,11/1/16,HOU,CLE,1,31,4,11,0.364,1,1,1,3,10,0.3,0,0,,0,1,1,2,0,0,1,3,11,4.4
Luol Deng,31-267,F,1/8/17,LAL,ORL,1,31,4,11,0.364,2,5,0.4,2,6,0.333,1,2,0.5,1,2,3,0,0,0,0,1,11,5.4
Andre Drummond,23-138,C,12/26/16,DET,CLE,1,28,5,15,0.333,5,14,0.357,0,1,0,1,7,0.143,7,10,17,4,0,2,1,1,11,10.8
Jodie Meeks,29-133,G,1/1/17,ORL,IND,1,30,3,9,0.333,0,1,0,3,8,0.375,2,2,1,0,3,3,2,0,0,1,1,11,6.8
Al Jefferson,31-357,C-F,12/26/16,IND,CHI,0,20,5,9,0.556,5,9,0.556,0,0,,1,1,1,2,3,5,3,0,0,1,4,11,8.5
Clint Capela,22-267,F-C,2/9/17,HOU,CHO,1,26,5,8,0.625,5,8,0.625,0,0,,1,3,0.333,4,4,8,2,3,1,3,4,11,11.1
Julius Randle,22-127,F,4/5/17,LAL,SAS,1,29,4,10,0.4,4,9,0.444,0,1,0,3,3,1,1,7,8,3,0,1,3,3,11,7
Thaddeus Young,28-146,F,11/14/16,IND,ORL,1,30,5,8,0.625,4,7,0.571,1,1,1,0,0,,0,5,5,1,2,1,0,1,11,11.9
Garrett Temple,30-227,G,12/21/16,SAC,UTA,0,28,4,7,0.571,1,2,0.5,3,5,0.6,0,0,,0,2,2,2,0,0,1,5,11,6.7
Derrick Rose,28-158,G,3/11/17,NYK,DET,1,27,5,12,0.417,5,11,0.455,0,1,0,1,2,0.5,1,1,2,2,1,0,4,0,11,3.6
Taurean Waller-Prince,22-363,F,3/20/17,ATL,CHO,0,30,4,13,0.308,3,10,0.3,1,3,0.333,2,4,0.5,1,3,4,2,0,0,1,3,11,3.5
Derrick Jones,20-051,F,4/7/17,PHO,OKC,0,21,4,4,1,4,4,1,0,0,,3,4,0.75,3,1,4,0,0,1,0,2,11,11.7
Willie Reed,26-175,F-C,11/7/16,MIA,OKC,0,17,4,4,1,4,4,1,0,0,,3,4,0.75,3,1,4,1,0,2,1,2,11,12.1
Tyler Johnson,24-270,G,2/1/17,MIA,ATL,0,32,4,11,0.364,3,6,0.5,1,5,0.2,2,2,1,1,2,3,5,2,2,1,5,11,10.1
Marcus Morris,27-133,F,1/13/17,DET,UTA,1,30,3,15,0.2,2,11,0.182,1,4,0.25,4,4,1,0,5,5,1,0,0,2,4,11,0.3
Thabo Sefolosha,32-266,G-F,1/23/17,ATL,LAC,1,30,5,11,0.455,4,10,0.4,1,1,1,0,0,,1,2,3,2,0,0,0,1,11,7.6
Otto Porter,23-283,F,3/13/17,WAS,MIN,1,31,5,12,0.417,4,9,0.444,1,3,0.333,0,0,,2,4,6,1,2,0,0,2,11,9.1
D'Angelo Russell,20-295,G,12/14/16,LAL,BRK,1,23,2,10,0.2,0,5,0,2,5,0.4,5,8,0.625,1,2,3,2,1,0,2,4,11,3.7
Terry Rozier,22-300,G,1/11/17,BOS,WAS,0,25,4,6,0.667,2,3,0.667,2,3,0.667,1,1,1,0,4,4,1,1,0,0,1,11,10.9
Nikola Jokic,21-351,C-F,2/4/17,DEN,SAS,1,15,5,9,0.556,4,7,0.571,1,2,0.5,0,0,,1,0,1,2,0,0,5,3,11,2.6
Trevor Ariza,31-139,F,11/16/16,HOU,OKC,1,37,4,11,0.364,2,2,1,2,9,0.222,1,1,1,0,7,7,3,4,0,1,0,11,12.1
Frank Kaminsky,23-208,F-C,10/29/16,CHO,BOS,0,24,4,8,0.5,3,6,0.5,1,2,0.5,2,2,1,1,3,4,3,0,0,1,2,11,8.9
Kenneth Faried,27-026,F,12/15/16,DEN,POR,0,26,3,5,0.6,3,5,0.6,0,0,,5,6,0.833,2,7,9,0,1,2,2,4,11,10.6
Nick Young,31-227,G-F,1/14/17,LAL,LAC,1,29,4,8,0.5,2,3,0.667,2,5,0.4,1,2,0.5,0,0,0,0,1,0,0,2,11,6.8
Derrick Rose,28-057,G,11/30/16,NYK,MIN,1,24,5,12,0.417,4,9,0.444,1,3,0.333,0,0,,0,0,0,2,1,0,2,4,11,3.4
D'Angelo Russell,21-017,G,3/12/17,LAL,PHI,1,33,5,17,0.294,4,11,0.364,1,6,0.167,0,0,,0,4,4,7,0,0,3,1,11,3.8
Kelly Oubre,21-043,F,1/21/17,WAS,DET,0,27,5,9,0.556,4,7,0.571,1,2,0.5,0,0,,2,2,4,0,2,0,0,2,11,9.9
Garrett Temple,30-301,G,3/5/17,SAC,UTA,0,24,4,9,0.444,2,5,0.4,2,4,0.5,1,1,1,0,2,2,4,3,0,2,2,11,9.9
Nicolas Brussino,24-038,G-F,4/9/17,DAL,PHO,0,33,4,12,0.333,2,2,1,2,10,0.2,1,2,0.5,0,5,5,5,0,0,1,4,11,6.2
Michael Kidd-Gilchrist,23-186,F,3/31/17,CHO,DEN,1,29,4,6,0.667,4,6,0.667,0,0,,3,4,0.75,2,5,7,3,2,2,0,2,11,15.6
Zach Randolph,35-171,F,1/3/17,MEM,LAL,0,28,3,12,0.25,2,10,0.2,1,2,0.5,4,4,1,3,6,9,1,1,0,0,1,11,9
Bojan Bogdanovic,27-274,G-F,1/17/17,BRK,TOR,1,21,3,7,0.429,1,2,0.5,2,5,0.4,3,3,1,0,3,3,0,1,0,0,2,11,8.4
Kyle Anderson,23-197,F-G,4/5/17,SAS,LAL,0,28,5,8,0.625,4,7,0.571,1,1,1,0,0,,2,5,7,1,0,1,0,3,11,10.5
Buddy Hield,23-051,G,2/6/17,NOP,PHO,1,28,4,9,0.444,1,4,0.25,3,5,0.6,0,0,,1,2,3,4,0,0,0,2,11,9.6
Ersan Ilyasova,29-197,F,11/28/16,PHI,TOR,1,23,4,8,0.5,3,5,0.6,1,3,0.333,2,2,1,0,6,6,3,0,0,1,1,11,9.5
Reggie Bullock,26-025,G-F,4/10/17,DET,WAS,0,20,4,6,0.667,1,1,1,3,5,0.6,0,0,,0,4,4,2,1,0,0,1,11,11.6
Denzel Valentine,23-101,G,2/25/17,CHI,CLE,0,20,4,6,0.667,1,1,1,3,5,0.6,0,0,,0,2,2,2,0,0,0,3,11,9.2
Mason Plumlee,26-273,C-F,12/3/16,POR,MIA,1,33,5,8,0.625,5,8,0.625,0,0,,1,2,0.5,1,8,9,1,1,1,1,5,11,9.5
Jeff Green,30-171,F,2/15/17,ORL,SAS,1,35,4,11,0.364,4,7,0.571,0,4,0,3,3,1,0,3,3,2,1,0,2,2,11,5.4
Joe Johnson,35-121,G-F,10/28/16,UTA,LAL,1,32,4,11,0.364,3,7,0.429,1,4,0.25,2,2,1,2,5,7,2,0,0,1,1,11,7.8
Jonas Valanciunas,24-308,C,3/10/17,TOR,ATL,1,30,5,12,0.417,5,12,0.417,0,0,,1,1,1,4,8,12,1,2,2,1,4,11,11.3
Evan Turner,28-006,G,11/2/16,POR,PHO,0,27,5,9,0.556,5,8,0.625,0,1,0,1,1,1,2,8,10,3,0,1,4,1,11,8.9
Mike Dunleavy,36-139,F-G,2/1/17,ATL,MIA,0,20,3,7,0.429,2,2,1,1,5,0.2,4,4,1,2,4,6,0,0,0,1,0,11,8.9
Ian Clark,25-273,G,12/5/16,GSW,IND,0,19,5,9,0.556,4,6,0.667,1,3,0.333,0,0,,1,0,1,3,2,1,2,1,11,9.8
Marquese Chriss,19-241,F,2/28/17,PHO,MEM,1,33,4,8,0.5,3,5,0.6,1,3,0.333,2,3,0.667,2,4,6,1,0,1,1,4,11,8
Mike Scott,28-195,F,1/27/17,ATL,WAS,0,11,4,6,0.667,3,4,0.75,1,2,0.5,2,2,1,1,3,4,0,1,1,1,1,11,10.3
Steven Adams,23-210,C,2/15/17,OKC,NYK,1,31,4,9,0.444,4,9,0.444,0,0,,3,4,0.75,4,4,8,1,0,1,1,1,11,9.9
Rondae Hollis-Jefferson,22-082,F,3/26/17,BRK,ATL,1,25,3,13,0.231,3,13,0.231,0,0,,5,6,0.833,5,8,13,1,1,1,0,4,11,9.4
Draymond Green,27-029,F,4/2/17,GSW,WAS,1,35,3,8,0.375,2,5,0.4,1,3,0.333,4,6,0.667,0,11,11,13,1,1,4,2,11,15.1
Channing Frye,33-223,C-F,12/26/16,CLE,DET,0,18,4,8,0.5,1,3,0.333,3,5,0.6,0,0,,0,4,4,1,0,0,3,5,11,3.9
Al Horford,30-207,C-F,12/27/16,BOS,MEM,1,34,5,14,0.357,4,10,0.4,1,4,0.25,0,0,,2,2,4,5,0,2,5,3,11,3.9
Emmanuel Mudiay,20-235,G,10/26/16,DEN,NOP,1,28,2,8,0.25,2,7,0.286,0,1,0,7,8,0.875,0,7,7,3,1,0,6,5,11,3
Lance Thomas,28-251,F,12/31/16,NYK,HOU,1,33,3,9,0.333,2,5,0.4,1,4,0.25,4,4,1,0,1,1,1,0,0,1,4,11,4.3
Jerian Grant,24-092,G,1/9/17,CHI,OKC,0,21,4,7,0.571,3,4,0.75,1,3,0.333,2,2,1,0,2,2,0,0,0,1,0,11,7.3
Boris Diaw,34-246,F-C,12/18/16,UTA,MEM,1,30,4,5,0.8,3,4,0.75,1,1,1,2,2,1,1,5,6,3,0,0,2,1,11,11
Justin Anderson,23-023,G,12/12/16,DAL,DEN,0,24,5,10,0.5,5,6,0.833,0,4,0,1,1,1,1,5,6,2,0,1,1,1,11,8.9
Malcolm Brogdon,24-036,G,1/16/17,MIL,PHI,1,28,5,11,0.455,4,9,0.444,1,2,0.5,0,0,,0,2,2,6,2,0,1,0,11,11.1
Tony Snell,25-006,G-F,11/16/16,MIL,ATL,1,31,4,10,0.4,2,3,0.667,2,7,0.286,1,2,0.5,2,2,4,3,2,0,0,1,11,10.9
Robert Covington,26-006,F,12/20/16,PHI,NOP,1,34,4,11,0.364,2,5,0.4,2,6,0.333,1,2,0.5,1,7,8,2,0,2,1,5,11,7.1
Trevor Booker,28-356,F,11/15/16,BRK,LAL,1,29,5,8,0.625,4,7,0.571,1,1,1,0,0,,3,7,10,3,1,2,2,4,11,12.5
JaVale McGee,29-081,C,4/10/17,GSW,UTA,0,15,5,5,1,5,5,1,0,0,,1,3,0.333,2,4,6,0,0,1,0,2,11,11.2
Michael Kidd-Gilchrist,23-079,F,12/14/16,CHO,WAS,1,26,5,7,0.714,5,7,0.714,0,0,,1,2,0.5,1,3,4,0,1,2,2,2,11,8.9
Davis Bertans,24-072,F,1/23/17,SAS,BRK,0,12,3,5,0.6,1,1,1,2,4,0.5,3,3,1,0,2,2,2,0,0,0,5,11,8.7
Bobby Portis,22-022,F,3/4/17,CHI,LAC,1,21,5,11,0.455,5,9,0.556,0,2,0,1,2,0.5,1,6,7,0,0,0,0,3,11,6.2
Ricky Rubio,26-162,G,4/1/17,MIN,SAC,1,37,1,10,0.1,1,7,0.143,0,3,0,9,10,0.9,1,5,6,13,2,0,2,3,11,14.1
David Lee,33-270,F,1/24/17,SAS,TOR,1,21,4,7,0.571,4,7,0.571,0,0,,3,4,0.75,0,5,5,2,0,0,2,2,11,7.4
Evan Fournier,24-021,G-F,11/19/16,ORL,DAL,1,32,3,13,0.231,1,7,0.143,2,6,0.333,3,3,1,2,5,7,2,2,0,4,2,11,4.6
James Ennis,26-141,F,11/19/16,MEM,MIN,1,36,4,11,0.364,4,8,0.5,0,3,0,3,4,0.75,3,4,7,1,2,1,0,1,11,10.8
Hollis Thompson,25-227,G-F,11/16/16,PHI,WAS,0,23,5,8,0.625,4,6,0.667,1,2,0.5,0,1,0,0,1,1,2,1,0,0,2,11,8.9
Evan Fournier,24-125,G-F,3/3/17,ORL,MIA,1,34,4,10,0.4,3,9,0.333,1,1,1,2,3,0.667,0,2,2,5,1,0,0,2,11,9.5
Doug McDermott,24-309,F,11/7/16,CHI,ORL,0,25,5,8,0.625,5,6,0.833,0,2,0,1,1,1,0,4,4,1,0,0,0,0,11,9.3
Jeremy Lamb,24-225,G-F,1/10/17,CHO,HOU,1,28,4,11,0.364,3,8,0.375,1,3,0.333,2,2,1,0,5,5,4,1,0,0,3,11,9
Joakim Noah,31-299,C,12/20/16,NYK,IND,1,30,4,8,0.5,4,8,0.5,0,0,,3,4,0.75,2,9,11,2,0,2,1,4,11,10.9
Frank Kaminsky,23-260,F-C,12/20/16,CHO,LAL,0,18,4,6,0.667,3,4,0.75,1,2,0.5,2,4,0.5,0,3,3,0,1,0,0,2,11,8.7
Nene Hilario,34-140,F-C,1/31/17,HOU,SAC,0,13,5,7,0.714,5,7,0.714,0,0,,1,1,1,0,1,1,1,0,2,1,3,11,8.3
Maurice Harkless,23-223,F-G,12/20/16,POR,SAC,1,24,5,9,0.556,5,8,0.625,0,1,0,1,3,0.333,5,5,10,1,1,1,0,6,11,10.9
Marreese Speights,29-233,C-F,3/25/17,LAC,UTA,0,22,4,7,0.571,3,4,0.75,1,3,0.333,2,2,1,4,6,10,2,0,3,3,5,11,10.8
Taurean Waller-Prince,22-340,F,2/25/17,ATL,ORL,0,27,4,7,0.571,2,4,0.5,2,3,0.667,1,2,0.5,2,2,4,0,1,1,2,0,11,9
E'Twaun Moore,28-014,G,3/14/17,NOP,POR,0,30,5,9,0.556,5,8,0.625,0,1,0,1,2,0.5,0,3,3,3,1,1,1,2,11,9.2
Patrick Beverley,28-237,G,3/6/17,HOU,SAS,1,33,4,9,0.444,1,4,0.25,3,5,0.6,0,0,,0,10,10,1,1,1,1,1,11,10.3
Jaylen Brown,20-104,F,2/5/17,BOS,LAC,1,25,4,10,0.4,3,5,0.6,1,5,0.2,2,4,0.5,0,3,3,1,1,0,1,2,11,5.6
Tristan Thompson,25-293,F-C,12/31/16,CLE,CHO,1,29,4,5,0.8,4,5,0.8,0,0,,3,3,1,2,4,6,0,1,0,0,2,11,11.9
Maurice Harkless,23-336,F-G,4/12/17,POR,NOP,0,22,5,6,0.833,5,6,0.833,0,0,,1,5,0.2,1,1,2,2,1,0,0,1,11,10.2
Justin Anderson,22-355,G,11/8/16,DAL,LAL,0,21,4,8,0.5,3,7,0.429,1,1,1,2,2,1,2,3,5,0,1,1,0,2,11,10.2
Luol Deng,31-248,F,12/20/16,LAL,CHO,1,34,5,10,0.5,4,6,0.667,1,4,0.25,0,0,,0,7,7,1,0,3,1,2,11,9.1
Pau Gasol,36-258,F-C,3/21/17,SAS,MIN,0,24,4,7,0.571,3,4,0.75,1,3,0.333,2,2,1,0,7,7,2,0,1,3,4,11,7.3
J.J. Redick,32-288,G,4/8/17,LAC,SAS,1,26,4,8,0.5,1,3,0.333,3,5,0.6,0,0,,0,1,1,2,0,2,1,0,11,9.1
Ian Clark,25-332,G,2/2/17,GSW,LAC,0,21,5,9,0.556,4,7,0.571,1,2,0.5,0,0,,0,1,1,4,0,0,0,2,11,9
Richaun Holmes,23-044,F-C,11/28/16,PHI,TOR,0,23,4,10,0.4,3,7,0.429,1,3,0.333,2,2,1,4,5,9,1,2,0,2,3,11,9.4
Brook Lopez,28-363,C,3/30/17,BRK,DET,1,31,4,17,0.235,2,10,0.2,2,7,0.286,1,2,0.5,4,5,9,2,1,1,1,2,11,5.9
Cory Joseph,25-188,G,2/24/17,TOR,BOS,1,36,5,12,0.417,5,11,0.455,0,1,0,1,2,0.5,1,0,1,6,3,0,1,2,11,10.3
David Lee,33-287,F,2/10/17,SAS,DET,0,20,5,10,0.5,5,10,0.5,0,0,,1,1,1,3,4,7,2,0,0,0,2,11,9.9
Zach LaVine,21-311,G,1/15/17,MIN,DAL,1,34,3,8,0.375,0,4,0,3,4,0.75,2,2,1,0,5,5,1,1,0,1,1,11,8.4
Rodney McGruder,25-247,G,4/2/17,MIA,DEN,1,27,4,7,0.571,3,5,0.6,1,2,0.5,2,2,1,0,6,6,4,0,0,1,1,11,10.9
Marreese Speights,29-219,C-F,3/11/17,LAC,PHI,0,12,5,6,0.833,4,4,1,1,2,0.5,0,0,,0,2,2,1,0,0,1,3,11,7.9
Jamal Crawford,36-330,G,2/13/17,LAC,UTA,0,22,5,9,0.556,4,6,0.667,1,3,0.333,0,0,,0,2,2,1,2,0,5,1,11,4.6
Marquese Chriss,19-154,F,12/3/16,PHO,GSW,1,25,3,8,0.375,2,4,0.5,1,4,0.25,4,4,1,2,2,4,1,0,1,1,5,11,7
Jarrod Uthoff,23-328,F,4/12/17,DAL,MEM,0,19,4,6,0.667,4,5,0.8,0,1,0,3,4,0.75,0,1,1,1,0,1,0,0,11,9.7
Al-Farouq Aminu,26-122,F,1/21/17,POR,BOS,0,37,2,6,0.333,1,2,0.5,1,4,0.25,6,6,1,1,6,7,0,1,1,1,3,11,9.6
Troy Daniels,25-246,G,3/18/17,MEM,SAS,0,20,4,8,0.5,1,3,0.333,3,5,0.6,0,0,,0,0,0,0,0,0,1,1,11,5.6
Tony Allen,34-355,G-F,12/31/16,MEM,SAC,1,21,5,7,0.714,4,6,0.667,1,1,1,0,0,,2,2,4,1,1,0,0,1,11,11.4
Gerald Henderson,28-329,G,11/2/16,PHI,CHO,1,25,5,8,0.625,4,6,0.667,1,2,0.5,0,0,,0,3,3,3,0,0,2,2,11,7.6
Dwight Howard,31-115,C,4/2/17,ATL,BRK,1,25,4,6,0.667,4,6,0.667,0,0,,3,4,0.75,1,10,11,0,0,1,5,2,11,6.6
Spencer Dinwiddie,24-000,G,4/6/17,BRK,ORL,0,24,4,6,0.667,2,4,0.5,2,2,1,1,2,0.5,1,2,3,3,2,1,2,3,11,10.9
Ron Baker,24-010,G,4/9/17,NYK,TOR,1,38,5,12,0.417,4,7,0.571,1,5,0.2,0,0,,0,8,8,8,1,0,2,3,11,10.4
Michael Kidd-Gilchrist,23-061,F,11/26/16,CHO,NYK,1,35,4,6,0.667,4,6,0.667,0,0,,3,4,0.75,0,8,8,0,0,1,3,1,11,7.7
Evan Turner,28-026,G,11/22/16,POR,NYK,0,24,4,8,0.5,4,8,0.5,0,0,,3,3,1,0,1,1,2,1,0,0,0,11,9.7
Hollis Thompson,25-236,G-F,11/25/16,PHI,CHI,0,21,4,5,0.8,1,2,0.5,3,3,1,0,0,,0,5,5,2,2,0,0,3,11,12.8
Steven Adams,23-126,C,11/23/16,OKC,SAC,1,28,4,7,0.571,4,7,0.571,0,0,,3,4,0.75,0,4,4,0,0,2,0,3,11,8.7
Tyreke Evans,27-159,G-F,2/25/17,SAC,CHO,1,22,4,10,0.4,4,7,0.571,0,3,0,3,3,1,0,5,5,5,0,2,1,3,11,9.8
Willy Hernangomez,22-272,C,2/23/17,NYK,CLE,1,27,4,9,0.444,4,8,0.5,0,1,0,3,4,0.75,3,7,10,4,0,2,1,3,11,12.1
Dwight Howard,31-090,C,3/8/17,ATL,BRK,1,29,5,7,0.714,5,7,0.714,0,0,,1,4,0.25,2,12,14,2,0,2,3,1,11,11.3
Tim Hardaway,24-238,G,11/9/16,ATL,CHI,0,19,5,9,0.556,4,6,0.667,1,3,0.333,0,0,,0,3,3,2,0,0,0,1,11,8.6
Marcus Morris,27-058,F,10/30/16,DET,MIL,1,36,4,16,0.25,3,8,0.375,1,8,0.125,2,2,1,1,4,5,2,1,0,3,2,11,1.9
Will Barton,26-010,G,1/16/17,DEN,ORL,0,24,5,9,0.556,4,6,0.667,1,3,0.333,0,0,,0,0,0,3,1,0,1,2,11,8
Rodney McGruder,25-131,G,12/7/16,MIA,ATL,1,31,3,8,0.375,1,3,0.333,2,5,0.4,3,5,0.6,3,2,5,5,2,1,1,1,11,13.3
Denzel Valentine,23-121,G,3/17/17,CHI,WAS,0,31,4,10,0.4,2,3,0.667,2,7,0.286,1,1,1,0,4,4,2,0,0,0,2,11,7.4
Kevin Seraphin,27-120,F,4/6/17,IND,MIL,0,23,4,8,0.5,4,8,0.5,0,0,,3,3,1,2,5,7,1,0,1,2,1,11,8.9
Andre Roberson,25-064,G-F,2/6/17,OKC,IND,1,36,5,8,0.625,5,8,0.625,0,0,,1,3,0.333,3,8,11,1,2,2,2,2,11,12.4
Jusuf Nurkic,22-137,C,1/7/17,DEN,OKC,1,26,5,14,0.357,5,14,0.357,0,0,,1,4,0.25,5,4,9,0,3,1,2,2,11,7.6
Leandro Barbosa,34-115,G,3/23/17,PHO,BRK,0,31,4,13,0.308,4,11,0.364,0,2,0,3,4,0.75,1,5,6,1,1,0,1,2,11,5.2
Shabazz Muhammad,24-141,F-G,4/3/17,MIN,POR,0,13,4,7,0.571,4,7,0.571,0,0,,3,3,1,0,1,1,0,0,0,0,0,11,8
Serge Ibaka,27-048,F-C,11/5/16,ORL,WAS,1,21,5,13,0.385,4,11,0.364,1,2,0.5,0,0,,2,5,7,0,0,0,0,2,11,6
Kyle O'Quinn,27-007,F-C,4/2/17,NYK,BOS,0,17,2,7,0.286,2,7,0.286,0,0,,7,7,1,3,6,9,0,0,2,2,4,11,8.6
Caris LeVert,22-138,G-F,1/10/17,BRK,ATL,0,23,4,9,0.444,3,5,0.6,1,4,0.25,2,3,0.667,1,2,3,2,0,0,2,1,11,6.2
Rodney Hood,24-162,G-F,3/31/17,UTA,WAS,1,22,4,8,0.5,1,4,0.25,3,4,0.75,0,0,,0,1,1,1,1,0,1,1,11,7.6
Kelly Olynyk,25-327,C-F,3/12/17,BOS,CHI,0,31,5,10,0.5,4,8,0.5,1,2,0.5,0,0,,3,6,9,3,1,0,2,2,11,10.2
Kenneth Faried,27-066,F,1/24/17,DEN,UTA,1,28,4,8,0.5,4,8,0.5,0,0,,3,6,0.5,2,5,7,1,0,0,0,1,11,9
Austin Rivers,24-098,G,11/7/16,LAC,DET,0,23,5,10,0.5,4,7,0.571,1,3,0.333,0,0,,0,2,2,4,0,0,1,1,11,8
Jonathan Gibson,29-023,G,12/1/16,DAL,CHO,0,27,5,15,0.333,4,11,0.364,1,4,0.25,0,2,0,0,2,2,4,2,0,2,2,11,4.3
Meyers Leonard,24-260,C-F,11/13/16,POR,DEN,1,25,4,9,0.444,3,3,1,1,6,0.167,2,2,1,0,4,4,2,0,0,1,5,11,5.9
Robert Covington,26-042,F,1/25/17,PHI,MIL,1,35,3,9,0.333,2,4,0.5,1,5,0.2,4,4,1,1,4,5,2,2,3,5,3,11,7.1
Terrence Jones,25-023,F,2/1/17,NOP,DET,1,27,5,9,0.556,5,9,0.556,0,0,,1,1,1,0,3,3,0,0,0,1,2,11,5.8
Seth Curry,26-156,G,1/26/17,DAL,OKC,1,34,4,12,0.333,1,6,0.167,3,6,0.5,0,0,,0,1,1,4,1,0,4,1,11,3.9
Will Barton,25-348,G,12/19/16,DEN,DAL,0,24,4,7,0.571,3,4,0.75,1,3,0.333,2,2,1,1,1,2,3,0,0,1,0,11,9.8
Brandon Ingram,19-203,F,3/24/17,LAL,MIN,1,30,4,8,0.5,3,6,0.5,1,2,0.5,2,2,1,0,3,3,0,0,0,2,1,11,5.5
Mike Conley,29-018,G,10/29/16,MEM,NYK,1,24,4,9,0.444,4,8,0.5,0,1,0,3,4,0.75,2,3,5,5,0,0,4,2,11,6.9
Denzel Valentine,23-117,G,3/13/17,CHI,CHO,0,28,3,8,0.375,0,0,,3,8,0.375,2,2,1,2,3,5,2,0,0,1,3,11,8.1
Tyler Zeller,26-299,F-C,11/11/16,BOS,NYK,0,21,3,6,0.5,3,6,0.5,0,0,,5,7,0.714,1,3,4,0,2,1,3,4,11,6.9
Alex Abrines,23-211,G-F,2/28/17,OKC,UTA,1,26,4,4,1,1,1,1,3,3,1,0,0,,0,0,0,0,0,0,0,3,11,8.6
Gorgui Dieng,27-073,C,4/1/17,MIN,SAC,1,37,3,8,0.375,2,6,0.333,1,2,0.5,4,4,1,2,6,8,2,3,1,0,3,11,13.7
Lance Thomas,28-226,F,12/6/16,NYK,MIA,0,21,5,6,0.833,4,5,0.8,1,1,1,0,0,,0,3,3,0,0,0,0,1,11,9.3
Tony Allen,35-044,G-F,2/24/17,MEM,IND,1,25,5,9,0.556,4,8,0.5,1,1,1,0,0,,2,5,7,2,5,0,4,5,11,10
Shabazz Muhammad,24-145,F-G,4/7/17,MIN,UTA,0,20,5,8,0.625,5,8,0.625,0,0,,1,1,1,2,1,3,0,1,0,2,3,11,6.9
DeMarre Carroll,30-167,F,1/10/17,TOR,BOS,1,35,4,10,0.4,1,4,0.25,3,6,0.5,0,0,,1,3,4,2,1,1,3,3,11,6.1
Malcolm Brogdon,23-365,G,12/10/16,MIL,WAS,0,20,4,7,0.571,1,4,0.25,3,3,1,0,0,,0,1,1,2,1,0,1,3,11,8.2
Steven Adams,23-249,C,3/26/17,OKC,HOU,1,24,3,6,0.5,3,6,0.5,0,0,,5,6,0.833,3,1,4,2,1,0,0,0,11,12.4
Mike Muscala,25-190,F-C,1/7/17,ATL,DAL,0,21,4,7,0.571,3,4,0.75,1,3,0.333,2,2,1,1,1,2,1,1,0,0,0,11,10.4
Mario Hezonja,22-040,F-G,4/6/17,ORL,BRK,0,22,3,4,0.75,2,3,0.667,1,1,1,4,4,1,1,3,4,1,0,2,2,2,11,10.3
Boris Diaw,34-347,F-C,3/29/17,UTA,SAC,1,19,5,9,0.556,4,6,0.667,1,3,0.333,0,0,,1,2,3,3,0,1,0,0,11,10.8
Patrick Beverley,28-153,G,12/12/16,HOU,BRK,1,32,4,11,0.364,1,4,0.25,3,7,0.429,0,0,,3,2,5,5,1,1,1,2,11,11
Markieff Morris,27-192,F,3/13/17,WAS,MIN,1,33,5,9,0.556,5,8,0.625,0,1,0,1,1,1,1,6,7,0,2,0,1,2,11,9.4
Terrence Ross,25-285,F-G,11/16/16,TOR,GSW,0,22,2,8,0.25,0,4,0,2,4,0.5,5,5,1,1,2,3,0,1,1,0,2,11,8.4
Austin Rivers,24-229,G,3/18/17,LAC,CLE,0,29,4,9,0.444,4,4,1,0,5,0,3,4,0.75,0,3,3,0,0,0,0,3,11,5.6
Troy Williams,21-341,F,12/5/16,MEM,NOP,1,20,5,9,0.556,4,6,0.667,1,3,0.333,0,0,,0,4,4,1,1,0,1,0,11,8.6
Cameron Payne,22-214,G,3/10/17,CHI,HOU,0,16,4,8,0.5,2,4,0.5,2,4,0.5,1,4,0.25,0,2,2,2,1,0,1,2,11,7
Ian Mahinmi,30-154,C,4/8/17,WAS,MIA,0,19,4,4,1,4,4,1,0,0,,3,4,0.75,3,6,9,0,2,1,1,3,11,13.8
Amir Johnson,29-213,F,11/30/16,BOS,DET,1,15,4,7,0.571,4,6,0.667,0,1,0,3,3,1,3,2,5,1,1,1,0,3,11,11.6
Ish Smith,28-117,G,10/30/16,DET,MIL,1,31,5,17,0.294,5,14,0.357,0,3,0,1,1,1,0,2,2,7,0,0,4,2,11,1.8
Devin Booker,20-026,G,11/25/16,PHO,MIN,1,33,4,10,0.4,3,7,0.429,1,3,0.333,2,2,1,0,2,2,2,2,1,4,3,11,5.1
Yogi Ferrell,23-296,G,3/1/17,DAL,ATL,1,32,5,10,0.5,4,7,0.571,1,3,0.333,0,0,,0,2,2,9,0,0,3,0,11,9.9
Patty Mills,28-099,G,11/18/16,SAS,LAL,0,20,5,9,0.556,4,4,1,1,5,0.2,0,0,,0,0,0,3,0,0,2,3,11,5.6
Emmanuel Mudiay,20-298,G,12/28/16,DEN,MIN,1,27,5,10,0.5,4,8,0.5,1,2,0.5,0,0,,1,1,2,5,1,0,2,2,11,8.7
Nik Stauskas,23-172,G,3/28/17,PHI,BRK,0,33,4,8,0.5,1,3,0.333,3,5,0.6,0,0,,1,3,4,2,0,1,2,1,11,8.3
Nikola Mirotic,25-358,F,2/3/17,CHI,HOU,0,17,4,8,0.5,3,6,0.5,1,2,0.5,2,3,0.667,0,7,7,3,2,0,0,1,11,12.4
Dante Cunningham,29-327,F,3/15/17,NOP,MIA,0,23,5,7,0.714,4,5,0.8,1,2,0.5,0,0,,1,2,3,0,1,0,0,0,11,10.4
Evan Turner,28-062,G,12/28/16,POR,SAC,0,30,5,8,0.625,5,7,0.714,0,1,0,1,1,1,0,6,6,4,1,1,5,3,11,7.5
Raymond Felton,32-234,G,2/15/17,LAC,ATL,0,27,5,6,0.833,4,4,1,1,2,0.5,0,0,,1,3,4,3,5,0,2,1,11,15.1
Alex Poythress,23-208,F,4/2/17,PHI,TOR,0,24,4,8,0.5,4,5,0.8,0,3,0,3,3,1,1,2,3,1,0,1,0,1,11,9.3
Chris Paul,31-196,G,11/18/16,LAC,SAC,1,33,2,10,0.2,1,4,0.25,1,6,0.167,6,8,0.75,1,8,9,12,3,0,3,4,11,13.9
Nicolas Batum,28-117,F-G,4/10/17,CHO,MIL,1,30,5,12,0.417,4,9,0.444,1,3,0.333,0,2,0,0,5,5,8,4,1,2,0,11,13.6
Robert Covington,26-033,F,1/16/17,PHI,MIL,1,28,4,8,0.5,2,2,1,2,6,0.333,1,2,0.5,2,4,6,4,0,2,0,4,11,11.8
Kelly Olynyk,25-337,C-F,3/22/17,BOS,IND,0,31,5,6,0.833,4,5,0.8,1,1,1,0,0,,2,6,8,4,1,0,2,0,11,13.8
DeAndre Jordan,28-254,C,4/1/17,LAC,LAL,1,39,4,4,1,4,4,1,0,0,,3,8,0.375,1,11,12,1,4,2,3,2,11,14.1
Enes Kanter,24-287,C,3/3/17,OKC,PHO,0,23,4,9,0.444,4,8,0.5,0,1,0,3,3,1,2,3,5,1,0,0,1,1,11,7.9
Nikola Mirotic,25-345,F,1/21/17,CHI,SAC,0,22,5,11,0.455,4,9,0.444,1,2,0.5,0,0,,2,3,5,1,1,0,0,3,11,8.1
Derrick Rose,28-038,G,11/11/16,NYK,BOS,1,27,3,10,0.3,2,7,0.286,1,3,0.333,4,4,1,0,4,4,6,0,0,7,4,11,2
Greg Monroe,26-270,C-F,3/1/17,MIL,DEN,0,23,4,10,0.4,4,10,0.4,0,0,,3,3,1,4,5,9,6,0,0,1,2,11,12.3
Jonathon Simmons,27-131,G-F,1/23/17,SAS,BRK,0,19,3,7,0.429,2,5,0.4,1,2,0.5,4,4,1,0,4,4,2,0,0,0,2,11,9.1
Al Horford,30-146,C-F,10/27/16,BOS,CHI,1,30,4,9,0.444,4,7,0.571,0,2,0,3,4,0.75,0,7,7,5,0,1,1,5,11,9.2
D'Angelo Russell,20-257,G,11/6/16,LAL,PHO,1,28,2,11,0.182,0,5,0,2,6,0.333,5,6,0.833,2,3,5,6,1,0,4,3,11,6
Solomon Hill,25-249,F,11/22/16,NOP,ATL,0,26,4,6,0.667,1,2,0.5,3,4,0.75,0,0,,0,3,3,0,0,0,0,2,11,8.5
Justin Anderson,23-067,G,1/25/17,DAL,NYK,0,20,3,8,0.375,3,4,0.75,0,4,0,5,7,0.714,1,2,3,2,3,0,1,3,11,9.3
Yogi Ferrell,23-190,G,11/15/16,BRK,LAL,0,19,3,5,0.6,1,2,0.5,2,3,0.667,3,4,0.75,0,1,1,4,0,0,1,5,11,8.4
John Henson,26-073,C-F,3/11/17,MIL,MIN,0,19,5,8,0.625,5,8,0.625,0,0,,1,2,0.5,3,3,6,0,0,2,0,5,11,9.4
Matthew Dellavedova,26-111,G,12/28/16,MIL,DET,1,20,4,7,0.571,2,5,0.4,2,2,1,1,1,1,0,2,2,2,0,0,1,2,11,7.9
Zach Randolph,35-189,F,1/21/17,MEM,HOU,0,24,4,11,0.364,4,9,0.444,0,2,0,3,5,0.6,1,7,8,1,0,0,0,1,11,7.2
Quinn Cook,24-020,G,4/12/17,NOP,POR,0,20,4,7,0.571,3,6,0.5,1,1,1,2,2,1,1,0,1,1,2,0,2,2,11,8.3
Austin Rivers,24-236,G,3/25/17,LAC,UTA,0,25,5,10,0.5,5,9,0.556,0,1,0,1,1,1,0,1,1,1,0,0,1,1,11,5.6
James Johnson,29-352,F,2/6/17,MIA,MIN,0,29,5,9,0.556,4,7,0.571,1,2,0.5,0,2,0,0,4,4,5,0,1,6,4,11,3.7
Steven Adams,23-237,C,3/14/17,OKC,BRK,1,29,4,6,0.667,4,6,0.667,0,0,,3,4,0.75,3,3,6,1,2,0,1,5,11,10.7
Nene Hilario,34-064,F-C,11/16/16,HOU,OKC,0,20,5,8,0.625,5,8,0.625,0,0,,1,2,0.5,2,3,5,1,1,0,5,3,11,4.8
Brandon Knight,24-342,G,11/8/16,PHO,POR,0,19,5,10,0.5,4,7,0.571,1,3,0.333,0,0,,0,4,4,6,1,0,5,2,11,6.6
Doug McDermott,25-029,F,2/1/17,CHI,OKC,0,14,4,7,0.571,3,4,0.75,1,3,0.333,2,2,1,0,1,1,0,0,0,1,1,11,6.6
Taj Gibson,31-165,F,12/6/16,CHI,DET,1,29,5,10,0.5,5,9,0.556,0,1,0,1,2,0.5,1,9,10,0,2,0,2,4,11,7.4
Joe Ingles,29-190,F-G,4/10/17,UTA,GSW,1,34,5,13,0.385,4,7,0.571,1,6,0.167,0,0,,1,3,4,7,1,0,4,3,11,6.2
Trevor Ariza,31-160,F,12/7/16,HOU,LAL,1,27,4,6,0.667,3,4,0.75,1,2,0.5,2,2,1,1,1,2,3,3,0,2,1,11,12.1
Domantas Sabonis,20-304,F,3/3/17,OKC,PHO,1,13,4,5,0.8,2,3,0.667,2,2,1,1,2,0.5,1,2,3,0,1,0,0,2,11,10.2
Nik Stauskas,23-129,G,2/13/17,PHI,CHO,0,25,3,8,0.375,1,5,0.2,2,3,0.667,3,4,0.75,1,5,6,2,1,0,2,3,11,7.6
Robert Covington,25-334,F,11/12/16,PHI,ATL,1,26,3,8,0.375,0,1,0,3,7,0.429,2,2,1,0,3,3,0,4,1,3,3,11,8
Skal Labissiere,21-017,F,4/4/17,SAC,DAL,1,34,3,7,0.429,2,6,0.333,1,1,1,4,4,1,3,5,8,1,2,0,3,2,11,9.8
JaMychal Green,26-232,F,2/8/17,MEM,PHO,1,30,4,4,1,3,3,1,1,1,1,2,2,1,4,6,10,4,0,0,4,4,11,11.6
Joe Ingles,29-106,F-G,1/16/17,UTA,PHO,1,34,4,6,0.667,1,2,0.5,3,4,0.75,0,0,,0,2,2,5,2,0,1,1,11,13.1
Spencer Hawes,28-195,C-F,11/9/16,CHO,UTA,0,19,5,7,0.714,5,6,0.833,0,1,0,1,3,0.333,0,3,3,3,1,1,0,0,11,12
Dwight Howard,31-058,C,2/4/17,ATL,ORL,1,24,5,6,0.833,5,6,0.833,0,0,,1,3,0.333,4,9,13,3,1,0,2,1,11,14.2
Andrew Wiggins,21-287,F-G,12/6/16,MIN,SAS,1,38,5,12,0.417,5,10,0.5,0,2,0,1,3,0.333,2,5,7,2,0,0,4,4,11,2.5
Boris Diaw,34-221,F-C,11/23/16,UTA,DEN,0,23,4,7,0.571,3,5,0.6,1,2,0.5,2,3,0.667,0,3,3,3,0,0,0,0,11,10.3
Gerald Henderson,29-068,G,2/15/17,PHI,BOS,1,25,4,9,0.444,4,7,0.571,0,2,0,3,4,0.75,0,0,0,0,2,0,3,2,11,4.1
Mike Muscala,25-140,F-C,11/18/16,ATL,CHO,0,25,4,8,0.5,2,3,0.667,2,5,0.4,1,1,1,1,4,5,2,0,1,2,1,11,8.6
Mason Plumlee,26-267,C-F,11/27/16,POR,HOU,1,33,5,7,0.714,5,7,0.714,0,0,,1,4,0.25,5,3,8,7,0,1,3,4,11,12.3
Isaiah Canaan,25-161,G,10/29/16,CHI,IND,0,14,4,6,0.667,1,1,1,3,5,0.6,0,0,,0,0,0,2,1,0,0,1,11,10.4
Eric Gordon,28-108,G,4/12/17,HOU,MIN,0,27,4,12,0.333,1,2,0.5,3,10,0.3,0,0,,1,2,3,2,0,1,0,3,11,6.4
Tony Parker,34-181,G,11/14/16,SAS,MIA,1,26,4,10,0.4,4,9,0.444,0,1,0,3,4,0.75,1,2,3,6,1,0,2,1,11,9.3
Rodney McGruder,25-245,G,3/31/17,MIA,NYK,1,31,5,11,0.455,4,5,0.8,1,6,0.167,0,0,,1,4,5,4,0,0,0,2,11,9.2
Robin Lopez,29-003,C,4/4/17,CHI,NYK,1,33,5,12,0.417,5,12,0.417,0,0,,1,1,1,3,1,4,1,1,2,2,0,11,8.1
Kris Dunn,23-006,G,3/24/17,MIN,LAL,0,35,5,12,0.417,4,7,0.571,1,5,0.2,0,0,,0,7,7,2,3,2,0,3,11,11.3
Noah Vonleh,21-195,F,3/7/17,POR,OKC,1,22,5,6,0.833,5,6,0.833,0,0,,1,2,0.5,4,1,5,2,0,0,1,4,11,10.3
Joe Ingles,29-180,F-G,3/31/17,UTA,WAS,0,31,3,7,0.429,0,2,0,3,5,0.6,2,4,0.5,0,3,3,4,4,0,3,1,11,10.8
Ersan Ilyasova,29-186,F,11/17/16,PHI,MIN,1,21,5,12,0.417,4,8,0.5,1,4,0.25,0,0,,0,3,3,3,0,0,2,1,11,5.2
Nik Stauskas,23-051,G,11/27/16,PHI,CLE,0,25,4,6,0.667,2,2,1,2,4,0.5,1,2,0.5,0,3,3,4,0,0,1,2,11,9.9
Shaun Livingston,31-054,G,11/4/16,GSW,LAL,0,20,5,5,1,5,5,1,0,0,,1,1,1,1,0,1,4,0,0,1,1,11,11.6
Goran Dragic,30-222,G,12/14/16,MIA,IND,1,35,4,15,0.267,4,13,0.308,0,2,0,3,4,0.75,0,5,5,6,2,0,5,2,11,3.6
Thabo Sefolosha,32-207,G-F,11/25/16,ATL,UTA,0,23,4,7,0.571,4,6,0.667,0,1,0,3,4,0.75,3,4,7,2,0,0,0,0,11,12
Alec Burks,25-190,G,1/26/17,UTA,LAL,0,14,5,9,0.556,4,7,0.571,1,2,0.5,0,1,0,0,1,1,1,0,0,0,1,11,6.9
Glenn Robinson,23-056,G-F,3/5/17,IND,ATL,0,23,3,5,0.6,0,0,,3,5,0.6,2,2,1,0,4,4,1,1,1,0,2,11,11.5
Rudy Gay,30-091,F,11/16/16,SAC,SAS,1,32,3,11,0.273,2,9,0.222,1,2,0.5,4,4,1,1,2,3,3,0,1,2,1,11,6.2
Kyle O'Quinn,26-345,F-C,3/6/17,NYK,ORL,0,12,5,6,0.833,5,6,0.833,0,0,,1,2,0.5,4,4,8,1,0,0,1,2,11,11.3
Will Barton,25-337,G,12/8/16,DEN,WAS,1,43,5,13,0.385,4,7,0.571,1,6,0.167,0,0,,2,0,2,3,3,0,1,5,11,7.4
Rudy Gobert,24-177,C,12/20/16,UTA,GSW,1,31,5,6,0.833,5,6,0.833,0,0,,1,3,0.333,2,15,17,1,0,2,2,3,11,12.8
Courtney Lee,31-095,G,1/6/17,NYK,MIL,1,35,3,5,0.6,1,2,0.5,2,3,0.667,3,4,0.75,1,1,2,3,1,1,1,0,11,12.1
Rodney Hood,24-170,G-F,4/8/17,UTA,POR,0,22,3,12,0.25,3,11,0.273,0,1,0,5,6,0.833,1,4,5,1,0,1,0,2,11,5.9
Malcolm Delaney,27-299,G,1/4/17,ATL,ORL,0,20,5,7,0.714,4,6,0.667,1,1,1,0,0,,0,3,3,0,1,0,0,1,11,9.6
Marcus Thornton,29-183,G,12/5/16,WAS,BRK,0,18,4,10,0.4,2,5,0.4,2,5,0.4,1,2,0.5,2,1,3,0,2,2,0,0,11,10.3
Giannis Antetokounmpo,21-336,F-G,11/6/16,MIL,DAL,1,26,4,12,0.333,3,7,0.429,1,5,0.2,2,4,0.5,2,5,7,2,3,2,5,5,11,5.1
Deron Williams,32-197,G,1/9/17,DAL,MIN,1,33,5,9,0.556,4,6,0.667,1,3,0.333,0,0,,1,1,2,7,1,0,3,2,11,9.8
Paul Millsap,32-015,F,2/25/17,ATL,ORL,1,29,3,10,0.3,2,6,0.333,1,4,0.25,4,4,1,0,7,7,2,0,1,3,3,11,5.2
Richard Jefferson,36-255,F,3/3/17,CLE,ATL,0,16,4,7,0.571,1,2,0.5,3,5,0.6,0,0,,0,2,2,0,0,0,2,6,11,3.9
Dragan Bender,19-039,F,12/26/16,PHO,HOU,0,27,5,11,0.455,4,7,0.571,1,4,0.25,0,0,,2,11,13,2,3,2,2,2,11,13
Malcolm Brogdon,24-094,G,3/15/17,MIL,LAC,1,26,5,10,0.5,4,7,0.571,1,3,0.333,0,0,,0,2,2,5,1,0,0,2,11,10.3
Marcus Smart,22-283,G,12/14/16,BOS,SAS,1,37,5,12,0.417,5,8,0.625,0,4,0,1,1,1,1,1,2,6,3,0,3,2,11,9
Manu Ginobili,39-161,G,1/5/17,SAS,DEN,0,18,4,10,0.4,1,4,0.25,3,6,0.5,0,0,,0,3,3,3,1,1,0,3,11,9.1
Trevor Ariza,31-251,F,3/8/17,HOU,UTA,1,37,3,6,0.5,0,1,0,3,5,0.6,2,4,0.5,2,3,5,2,0,0,0,2,11,10.1
Jrue Holiday,26-187,G,12/16/16,NOP,HOU,1,35,5,15,0.333,4,8,0.5,1,7,0.143,0,0,,1,4,5,1,0,1,2,1,11,3.4
Enes Kanter,24-189,C,11/25/16,OKC,DEN,0,19,5,9,0.556,5,7,0.714,0,2,0,1,1,1,1,1,2,1,2,0,0,2,11,9.6
Tony Allen,35-048,G-F,2/28/17,MEM,PHO,1,27,5,7,0.714,5,6,0.833,0,1,0,1,2,0.5,2,2,4,1,1,0,2,1,11,9
Marcus Morris,27-180,F,3/1/17,DET,NOP,1,25,5,12,0.417,4,9,0.444,1,3,0.333,0,2,0,4,1,5,1,1,0,1,3,11,6.4
Jamal Crawford,36-254,G,11/29/16,LAC,BRK,0,35,4,15,0.267,3,11,0.273,1,4,0.25,2,2,1,0,3,3,1,0,0,1,2,11,1.9
Karl-Anthony Towns,20-352,C-F,11/1/16,MIN,MEM,1,30,4,10,0.4,4,10,0.4,0,0,,3,4,0.75,2,9,11,4,0,1,3,1,11,9.4
Devin Booker,20-013,G,11/12/16,PHO,BRK,1,32,5,18,0.278,5,14,0.357,0,4,0,1,1,1,1,5,6,3,1,0,0,2,11,4.9
Marco Belinelli,30-249,G-F,11/29/16,CHO,DET,0,25,4,10,0.4,3,6,0.5,1,4,0.25,2,2,1,0,2,2,2,0,1,0,1,11,7.9
Andre Iguodala,32-278,G-F,11/1/16,GSW,POR,0,24,4,7,0.571,3,6,0.5,1,1,1,2,3,0.667,0,5,5,5,0,0,1,1,11,10.9
Tyler Johnson,24-219,G,12/12/16,MIA,WAS,0,30,5,10,0.5,4,8,0.5,1,2,0.5,0,0,,0,3,3,3,1,0,2,3,11,6.8
Al Horford,30-245,C-F,2/3/17,BOS,LAL,1,31,4,11,0.364,3,7,0.429,1,4,0.25,2,4,0.5,2,6,8,8,0,1,2,2,11,10.8
Taj Gibson,31-162,F,12/3/16,CHI,DAL,1,27,5,8,0.625,5,8,0.625,0,0,,1,2,0.5,1,3,4,1,0,1,2,3,11,6.8
Mike Muscala,25-154,F-C,12/2/16,ATL,DET,0,24,5,7,0.714,4,6,0.667,1,1,1,0,0,,0,0,0,1,2,0,1,3,11,8.6
Andre Drummond,23-238,C,4/5/17,DET,TOR,1,29,4,7,0.571,4,7,0.571,0,0,,3,10,0.3,5,9,14,0,0,0,1,3,11,8.9
J.R. Smith,31-183,G-F,3/11/17,CLE,ORL,0,21,4,8,0.5,1,1,1,3,7,0.429,0,0,,0,1,1,1,0,0,0,0,11,8
Brandon Ingram,19-081,F,11/22/16,LAL,OKC,0,25,4,6,0.667,1,3,0.333,3,3,1,0,0,,0,2,2,3,0,0,4,1,11,6.7
Kent Bazemore,27-122,G-F,10/31/16,ATL,SAC,1,28,3,9,0.333,2,4,0.5,1,5,0.2,4,4,1,0,2,2,1,3,1,0,3,11,9.7
Evan Turner,28-103,G,2/7/17,POR,DAL,1,23,4,7,0.571,3,3,1,1,4,0.25,2,2,1,0,2,2,4,0,0,3,0,11,8.1
Mike Muscala,25-161,F-C,12/9/16,ATL,MIL,0,20,4,6,0.667,1,3,0.333,3,3,1,0,0,,2,1,3,4,0,0,0,0,11,12.9
Jrue Holiday,26-218,G,1/16/17,NOP,IND,1,26,4,9,0.444,2,6,0.333,2,3,0.667,1,2,0.5,1,1,2,6,1,0,5,3,11,5.9
Terrence Ross,25-317,F-G,12/18/16,TOR,ORL,0,23,4,13,0.308,1,5,0.2,3,8,0.375,0,0,,0,2,2,0,1,1,0,1,11,5.4
Zach LaVine,21-320,G,1/24/17,MIN,PHO,1,34,5,9,0.556,4,5,0.8,1,4,0.25,0,2,0,0,1,1,4,2,0,2,2,11,8.2
Dejounte Murray,20-127,G,1/24/17,SAS,TOR,1,23,4,7,0.571,4,7,0.571,0,0,,3,4,0.75,0,3,3,2,0,1,3,4,11,5.7
Danny Green,29-161,G-F,11/30/16,SAS,DAL,1,28,4,8,0.5,2,4,0.5,2,4,0.5,1,2,0.5,1,2,3,2,0,0,0,1,11,8.9
J.J. Barea,32-176,G,12/19/16,DAL,DEN,0,13,5,9,0.556,4,7,0.571,1,2,0.5,0,0,,0,3,3,4,1,0,0,0,11,11.4
Alex Abrines,23-237,G-F,3/26/17,OKC,HOU,0,27,4,10,0.4,1,1,1,3,9,0.333,0,0,,0,0,0,2,3,0,1,2,11,8.2
Jordan McRae,25-308,G,1/30/17,CLE,DAL,0,30,5,9,0.556,4,6,0.667,1,3,0.333,0,0,,0,2,2,0,0,0,1,3,11,5.1
Evan Turner,28-090,G,1/25/17,POR,LAL,1,33,5,10,0.5,5,9,0.556,0,1,0,1,3,0.333,1,2,3,3,1,0,1,1,11,8.2
Myles Turner,20-265,F-C,12/14/16,IND,MIA,1,37,5,13,0.385,5,10,0.5,0,3,0,1,1,1,2,5,7,2,1,5,2,5,11,8.7
Justin Holiday,27-349,G,3/20/17,NYK,LAC,0,27,4,8,0.5,3,5,0.6,1,3,0.333,2,2,1,0,4,4,3,1,1,0,0,11,12
Wesley Johnson,29-219,F-G,2/15/17,LAC,ATL,0,19,4,8,0.5,1,3,0.333,3,5,0.6,0,0,,0,4,4,0,3,1,1,1,11,10.5
Tim Hardaway,24-336,G,2/15/17,ATL,LAC,1,28,5,11,0.455,4,7,0.571,1,4,0.25,0,0,,1,2,3,3,0,0,2,0,11,6.7
Channing Frye,33-168,C-F,11/1/16,CLE,HOU,0,15,4,12,0.333,3,9,0.333,1,3,0.333,2,2,1,1,3,4,0,0,0,0,2,11,5
Marcus Smart,22-364,G,3/5/17,BOS,PHO,0,28,1,5,0.2,1,2,0.5,0,3,0,9,12,0.75,0,3,3,3,1,0,2,4,11,7.1
Amir Johnson,29-192,F,11/9/16,BOS,WAS,1,24,5,5,1,4,4,1,1,1,1,0,0,,1,2,3,1,1,1,1,4,11,10.6
Randy Foye,33-095,G,12/28/16,BRK,CHI,0,28,5,9,0.556,4,5,0.8,1,4,0.25,0,2,0,0,5,5,1,1,0,1,3,11,6.9
Jodie Meeks,29-129,G,12/28/16,ORL,CHO,1,22,5,9,0.556,4,5,0.8,1,4,0.25,0,0,,0,1,1,1,2,0,2,0,11,7.7
Ish Smith,28-123,G,11/5/16,DET,DEN,1,28,5,13,0.385,5,12,0.417,0,1,0,1,2,0.5,1,4,5,8,3,0,2,1,11,11.6
Justise Winslow,20-279,F,12/30/16,MIA,BOS,1,31,5,13,0.385,5,13,0.385,0,0,,1,2,0.5,4,5,9,6,0,1,1,4,11,10.1
Jeff Teague,28-224,G,1/20/17,IND,LAL,1,33,3,9,0.333,2,6,0.333,1,3,0.333,4,4,1,1,2,3,7,1,1,6,1,11,7.4
Norman Powell,23-296,G,3/17/17,TOR,DET,0,19,4,10,0.4,4,7,0.571,0,3,0,3,4,0.75,0,2,2,0,0,0,0,2,11,5
Dwight Howard,31-043,C,1/20/17,ATL,CHI,1,25,3,11,0.273,3,11,0.273,0,0,,5,8,0.625,1,5,6,0,2,0,1,3,11,5.3
Beno Udrih,34-150,G,12/2/16,DET,ATL,0,16,5,6,0.833,5,6,0.833,0,0,,1,1,1,0,2,2,3,0,0,1,1,11,10.1
Tyson Chandler,34-127,C,2/6/17,PHO,NOP,1,24,3,6,0.5,3,6,0.5,0,0,,5,6,0.833,5,8,13,0,0,2,0,2,11,14.1
Otto Porter,23-232,F,1/21/17,WAS,DET,1,34,4,13,0.308,2,7,0.286,2,6,0.333,1,2,0.5,1,6,7,3,2,0,1,2,11,7.9
Marcus Morris,27-117,F,12/28/16,DET,MIL,1,23,3,10,0.3,1,4,0.25,2,6,0.333,3,4,0.75,1,1,2,3,0,0,0,3,11,6.7
Yogi Ferrell,23-268,G,2/1/17,DAL,PHI,1,38,3,13,0.231,3,9,0.333,0,4,0,5,5,1,1,2,3,5,1,1,2,2,11,6.8
Jodie Meeks,29-148,G,1/16/17,ORL,DEN,1,34,4,9,0.444,3,6,0.5,1,3,0.333,2,2,1,1,3,4,4,0,0,3,0,11,7.7
Jon Leuer,27-179,F,11/9/16,DET,PHO,0,24,3,8,0.375,1,4,0.25,2,4,0.5,3,3,1,2,7,9,1,0,0,0,3,11,9.6
Marvin Williams,30-136,F,11/2/16,CHO,PHI,1,30,4,12,0.333,2,5,0.4,2,7,0.286,1,2,0.5,1,7,8,1,2,0,0,3,11,8.1
Hassan Whiteside,27-289,C,3/29/17,MIA,NYK,1,28,5,11,0.455,5,11,0.455,0,0,,1,1,1,1,8,9,1,0,4,1,4,11,9.3
Nik Stauskas,23-110,G,1/25/17,PHI,MIL,1,26,4,7,0.571,1,2,0.5,3,5,0.6,0,0,,0,0,0,2,1,0,1,5,11,7.1
Reggie Jackson,26-342,G,3/24/17,DET,ORL,0,20,5,14,0.357,4,9,0.444,1,5,0.2,0,0,,1,3,4,3,0,1,0,1,11,7.2
Richard Jefferson,36-223,F,1/30/17,CLE,DAL,1,25,4,5,0.8,1,2,0.5,3,3,1,0,0,,1,2,3,0,0,1,0,3,11,9.9
Bruno Caboclo,21-203,F,4/12/17,TOR,CLE,0,17,5,11,0.455,4,8,0.5,1,3,0.333,0,0,,2,2,4,1,0,1,0,1,11,8.3
Trevor Ariza,31-224,F,2/9/17,HOU,CHO,1,42,4,11,0.364,1,1,1,3,10,0.3,0,0,,0,7,7,3,2,2,0,2,11,11.7
Nik Stauskas,23-052,G,11/28/16,PHI,TOR,0,29,4,9,0.444,1,3,0.333,3,6,0.5,0,0,,0,0,0,2,0,0,0,2,11,6.9
Rodney McGruder,25-199,G,2/13/17,MIA,ORL,1,22,5,10,0.5,4,6,0.667,1,4,0.25,0,0,,2,2,4,1,0,0,1,2,11,6.9
Alan Williams,24-036,F-C,3/5/17,PHO,BOS,0,31,5,12,0.417,5,12,0.417,0,0,,1,3,0.333,4,11,15,0,2,1,1,5,11,9.6
Dennis Schroder,23-044,G,10/29/16,ATL,PHI,1,28,4,7,0.571,4,6,0.667,0,1,0,3,4,0.75,0,3,3,11,1,0,2,0,11,14.9
Nerlens Noel,22-331,C-F,3/7/17,DAL,LAL,0,23,4,8,0.5,4,8,0.5,0,0,,3,4,0.75,3,10,13,1,0,3,0,1,11,14.1
Draymond Green,26-259,F,11/18/16,GSW,BOS,1,35,3,11,0.273,1,5,0.2,2,6,0.333,3,4,0.75,1,7,8,8,1,2,1,3,11,12.7
Andre Iguodala,33-066,G-F,4/4/17,GSW,MIN,0,23,4,4,1,3,3,1,1,1,1,2,2,1,0,2,2,3,0,0,1,3,11,10.3
Channing Frye,33-290,C-F,3/3/17,CLE,ATL,1,25,4,7,0.571,1,1,1,3,6,0.5,0,0,,1,3,4,1,0,1,1,3,11,8.5
Wayne Ellington,29-133,G,3/11/17,MIA,TOR,0,19,3,8,0.375,0,0,,3,8,0.375,2,2,1,0,3,3,0,1,0,1,1,11,7.1
Anthony Tolliver,31-202,F-C,12/20/16,SAC,POR,0,34,3,5,0.6,0,1,0,3,4,0.75,2,2,1,1,3,4,0,0,0,0,3,11,9.1
K.J. McDaniels,24-040,G-F,3/21/17,BRK,DET,0,21,4,8,0.5,2,4,0.5,2,4,0.5,1,2,0.5,0,2,2,1,0,1,3,1,11,5.2
Cody Zeller,24-107,F-C,1/20/17,CHO,TOR,1,23,4,6,0.667,4,6,0.667,0,0,,3,4,0.75,2,1,3,1,0,0,1,2,11,8.6
Otto Porter,23-313,F,4/12/17,WAS,MIA,1,15,4,8,0.5,4,6,0.667,0,2,0,3,3,1,1,5,6,0,0,0,0,2,11,8.4
Zach LaVine,21-252,G,11/17/16,MIN,PHI,1,39,5,14,0.357,4,7,0.571,1,7,0.143,0,0,,1,0,1,1,1,1,2,0,11,4.3
Monta Ellis,31-126,G,3/1/17,IND,SAS,0,24,5,9,0.556,5,8,0.625,0,1,0,1,4,0.25,1,2,3,2,2,0,3,2,11,6.4
Nik Stauskas,23-131,G,2/15/17,PHI,BOS,0,28,3,8,0.375,2,2,1,1,6,0.167,4,6,0.667,1,5,6,1,0,0,2,1,11,6.3
Josh Richardson,23-110,G,1/3/17,MIA,PHO,1,37,5,16,0.313,4,11,0.364,1,5,0.2,0,0,,0,2,2,3,2,2,3,2,11,4.1
Jeff Teague,28-157,G,11/14/16,IND,ORL,1,29,4,9,0.444,3,6,0.5,1,3,0.333,2,2,1,0,8,8,5,1,3,1,3,11,13.1
Marcus Thornton,29-178,G,11/30/16,WAS,OKC,0,17,4,7,0.571,3,4,0.75,1,3,0.333,2,2,1,1,2,3,0,0,0,0,1,11,8.6
Eric Bledsoe,27-034,G,1/12/17,PHO,DAL,1,28,2,4,0.5,2,4,0.5,0,0,,7,7,1,1,5,6,5,1,1,4,5,11,10.4
Matthew Dellavedova,26-054,G,11/1/16,MIL,NOP,1,29,4,8,0.5,2,4,0.5,2,4,0.5,1,1,1,0,4,4,8,2,0,1,3,11,13.6
Brandon Ingram,19-175,F,2/24/17,LAL,OKC,1,39,4,12,0.333,3,7,0.429,1,5,0.2,2,5,0.4,1,4,5,4,1,0,1,3,11,6.5
Luc Mbah a Moute,30-066,F,11/14/16,LAC,BRK,1,24,5,5,1,5,5,1,0,0,,1,1,1,0,2,2,0,1,0,0,2,11,10.3
Draymond Green,26-318,F,1/16/17,GSW,CLE,1,35,4,6,0.667,4,6,0.667,0,0,,3,4,0.75,2,11,13,11,1,5,0,1,11,24.5
Glenn Robinson,23-059,G-F,3/8/17,IND,DET,0,19,4,8,0.5,3,5,0.6,1,3,0.333,2,3,0.667,0,4,4,0,1,0,0,0,11,8.8
Iman Shumpert,26-209,G,1/21/17,CLE,SAS,1,38,4,8,0.5,1,3,0.333,3,5,0.6,0,0,,1,2,3,2,2,0,1,1,11,10.3
Derrick Favors,25-185,F-C,1/16/17,UTA,PHO,1,24,5,11,0.455,5,11,0.455,0,0,,1,3,0.333,3,1,4,1,1,1,1,1,11,7.9
Kris Dunn,22-289,G,1/1/17,MIN,POR,0,21,5,7,0.714,4,6,0.667,1,1,1,0,0,,0,3,3,4,1,3,2,3,11,11.7
Solomon Hill,26-009,F,3/27/17,NOP,UTA,1,37,4,6,0.667,2,3,0.667,2,3,0.667,1,3,0.333,3,5,8,0,0,1,0,2,11,11.1
Michael Kidd-Gilchrist,23-056,F,11/21/16,CHO,MEM,1,32,4,7,0.571,4,7,0.571,0,0,,3,7,0.429,5,5,10,4,0,0,2,3,11,10.7
Tristan Thompson,25-291,F-C,12/29/16,CLE,BOS,1,32,5,9,0.556,5,8,0.625,0,1,0,1,2,0.5,3,6,9,1,0,0,1,1,11,9.5
Steven Adams,23-106,C,11/3/16,OKC,GSW,1,24,5,7,0.714,5,7,0.714,0,0,,1,2,0.5,3,1,4,1,2,2,1,3,11,12
Otto Porter,23-180,F,11/30/16,WAS,OKC,1,39,5,9,0.556,4,7,0.571,1,2,0.5,0,0,,0,8,8,1,3,0,1,3,11,10.6
Jamal Murray,19-351,G,2/8/17,DEN,ATL,0,22,4,9,0.444,3,4,0.75,1,5,0.2,2,2,1,1,4,5,0,0,1,0,2,11,8.1
Aaron Gordon,21-152,F,2/15/17,ORL,SAS,1,33,3,9,0.333,3,7,0.429,0,2,0,5,5,1,2,4,6,2,0,1,2,1,11,8.2
Rudy Gobert,24-250,C,3/3/17,UTA,BRK,1,33,4,4,1,4,4,1,0,0,,3,6,0.5,0,7,7,0,0,2,2,3,11,8.9
Lucas Nogueira,24-130,C,12/3/16,TOR,ATL,0,23,5,5,1,5,5,1,0,0,,1,1,1,3,5,8,1,2,3,0,1,11,17.5
Dirk Nowitzki,38-194,F,12/30/16,DAL,GSW,1,23,3,12,0.25,3,9,0.333,0,3,0,5,5,1,0,5,5,1,0,1,3,2,11,2.9
Delon Wright,24-321,G,3/13/17,TOR,DAL,0,20,4,8,0.5,3,5,0.6,1,3,0.333,2,2,1,0,4,4,3,1,1,0,1,11,11.6
DeMarre Carroll,30-226,F,3/10/17,TOR,ATL,1,33,3,9,0.333,3,6,0.5,0,3,0,5,7,0.714,3,4,7,1,4,2,0,4,11,12.9
Jamal Murray,20-003,G,2/26/17,DEN,MEM,0,16,5,9,0.556,4,7,0.571,1,2,0.5,0,0,,0,4,4,1,0,0,0,3,11,7.4
Monta Ellis,31-002,G,10/28/16,IND,BRK,1,33,5,12,0.417,5,12,0.417,0,0,,1,2,0.5,1,1,2,4,2,0,4,5,11,4
Cody Zeller,24-052,F-C,11/26/16,CHO,NYK,1,25,2,7,0.286,2,7,0.286,0,0,,7,12,0.583,5,5,10,2,1,2,0,5,11,11.7
Rodney McGruder,25-120,G,11/26/16,MIA,MEM,1,34,5,10,0.5,4,6,0.667,1,4,0.25,0,0,,2,2,4,2,0,1,1,2,11,8.3
Shabazz Napier,25-118,G,11/9/16,POR,LAC,0,21,4,10,0.4,3,4,0.75,1,6,0.167,2,3,0.667,0,2,2,2,2,0,0,0,11,9.2
Toney Douglas,30-331,G,2/10/17,MEM,GSW,0,18,3,8,0.375,2,4,0.5,1,4,0.25,4,4,1,0,1,1,1,0,0,2,4,11,4
Toney Douglas,30-267,G,12/8/16,MEM,POR,0,27,3,6,0.5,2,4,0.5,1,2,0.5,4,4,1,0,1,1,3,0,0,0,1,11,10
Kyle Singler,28-342,F,4/11/17,OKC,MIN,1,28,4,12,0.333,3,8,0.375,1,4,0.25,2,2,1,0,4,4,0,0,0,0,3,11,4.2
Justin Holiday,27-286,G,1/16/17,NYK,ATL,0,23,5,10,0.5,5,7,0.714,0,3,0,1,2,0.5,1,3,4,0,0,0,0,0,11,7.2
Mirza Teletovic,31-178,F,3/15/17,MIL,LAC,0,20,3,9,0.333,0,1,0,3,8,0.375,2,2,1,0,1,1,1,1,1,0,2,11,7.8
Enes Kanter,24-291,C,3/7/17,OKC,POR,0,18,5,6,0.833,5,6,0.833,0,0,,1,1,1,2,5,7,1,0,0,4,1,11,8
D.J. Augustin,29-089,G,2/7/17,ORL,HOU,0,24,1,5,0.2,0,2,0,1,3,0.333,8,12,0.667,1,2,3,3,0,0,1,0,11,8.7
Ryan Anderson,28-266,F,1/27/17,HOU,PHI,1,42,3,11,0.273,0,2,0,3,9,0.333,2,2,1,1,4,5,0,0,0,2,5,11,2.4
Mario Hezonja,21-354,F-G,2/13/17,ORL,MIA,0,16,4,6,0.667,1,3,0.333,3,3,1,0,0,,0,1,1,1,1,0,1,1,11,9
Jonas Valanciunas,24-224,C,12/16/16,TOR,ATL,1,26,5,5,1,5,5,1,0,0,,1,2,0.5,1,5,6,2,2,0,3,4,11,10.1
DeMarre Carroll,30-251,F,4/4/17,TOR,IND,1,27,3,5,0.6,0,0,,3,5,0.6,2,2,1,0,1,1,0,1,0,2,2,11,7.2
Nikola Vucevic,26-005,C,10/29/16,ORL,CLE,1,25,5,8,0.625,5,8,0.625,0,0,,1,2,0.5,2,7,9,1,0,0,4,2,11,6.4
Jonas Valanciunas,24-259,C,1/20/17,TOR,CHO,1,25,5,8,0.625,5,8,0.625,0,0,,1,1,1,3,3,6,1,1,1,2,3,11,9.6
Marvin Williams,30-174,F,12/10/16,CHO,CLE,1,30,5,13,0.385,4,8,0.5,1,5,0.2,0,1,0,1,4,5,1,0,0,0,4,11,4.5
Nene Hilario,34-047,F-C,10/30/16,HOU,DAL,0,22,5,6,0.833,5,6,0.833,0,0,,1,1,1,0,3,3,1,0,0,1,3,11,8.2
Joe Ingles,29-073,F-G,12/14/16,UTA,OKC,0,21,4,5,0.8,1,2,0.5,3,3,1,0,0,,0,4,4,3,0,0,0,3,11,11.2
Trevor Ariza,31-146,F,11/23/16,HOU,TOR,1,31,4,11,0.364,1,2,0.5,3,9,0.333,0,0,,2,0,2,3,1,0,0,4,11,7.8
Courtney Lee,31-185,G,4/6/17,NYK,WAS,1,31,5,12,0.417,4,8,0.5,1,4,0.25,0,0,,3,5,8,3,5,0,1,0,11,14.3
Tristan Thompson,26-005,F-C,3/18/17,CLE,LAC,1,31,5,6,0.833,5,6,0.833,0,0,,1,2,0.5,3,3,6,0,1,0,0,2,11,11.6
Brandon Knight,25-050,G,1/21/17,PHO,NYK,0,20,5,12,0.417,4,8,0.5,1,4,0.25,0,0,,1,4,5,2,1,0,1,2,11,7.1
Kristaps Porzingis,21-224,F-C,3/14/17,NYK,IND,1,25,5,17,0.294,4,11,0.364,1,6,0.167,0,0,,2,1,3,3,1,3,2,1,11,5.6
Thaddeus Young,28-190,F,12/28/16,IND,WAS,1,35,5,10,0.5,5,6,0.833,0,4,0,1,3,0.333,3,3,6,3,6,0,4,5,11,10.3
Joe Young,24-124,G,10/29/16,IND,CHI,0,20,4,7,0.571,2,4,0.5,2,3,0.667,1,1,1,0,2,2,3,0,0,0,0,11,10.4
Gerald Henderson,28-341,G,11/14/16,PHI,HOU,1,28,4,8,0.5,3,7,0.429,1,1,1,2,2,1,1,0,1,3,3,1,0,1,11,13.1
Zach Randolph,35-223,F,2/24/17,MEM,IND,0,26,4,13,0.308,4,12,0.333,0,1,0,3,5,0.6,2,6,8,0,0,1,1,0,11,5.6
Rodney Hood,24-129,G-F,2/26/17,UTA,WAS,1,27,2,7,0.286,0,3,0,2,4,0.5,5,5,1,0,3,3,2,2,1,2,4,11,8.3
Bojan Bogdanovic,27-327,G-F,3/11/17,WAS,POR,0,19,4,9,0.444,2,5,0.4,2,4,0.5,1,2,0.5,0,2,2,0,0,0,1,1,11,5.1
Pascal Siakam,22-298,F,11/28/16,TOR,PHI,1,23,4,6,0.667,4,6,0.667,0,0,,3,4,0.75,0,2,2,0,1,1,1,2,11,8.5
Steven Adams,23-232,C,3/9/17,OKC,SAS,1,29,5,8,0.625,5,8,0.625,0,0,,1,5,0.2,3,3,6,0,1,0,1,2,11,8
Alan Williams,24-050,F-C,3/19/17,PHO,DET,0,26,4,11,0.364,4,11,0.364,0,0,,3,5,0.6,0,12,12,2,2,1,0,3,11,10.6
Jerryd Bayless,28-097,G,11/25/16,PHI,CHI,1,26,4,10,0.4,3,9,0.333,1,1,1,2,2,1,1,3,4,2,0,0,2,1,11,6.2
J.J. Barea,32-264,G,3/17/17,DAL,PHI,0,17,4,10,0.4,2,6,0.333,2,4,0.5,1,2,0.5,1,0,1,4,0,0,3,1,11,5.3
Patrick Beverley,28-167,G,12/26/16,HOU,PHO,1,26,4,10,0.4,1,6,0.167,3,4,0.75,0,0,,0,7,7,2,3,0,2,4,11,8.5
Jeff Teague,28-166,G,11/23/16,IND,ATL,1,39,5,15,0.333,5,10,0.5,0,5,0,1,1,1,1,5,6,8,5,2,2,4,11,13.1
Josh Richardson,23-086,G,12/10/16,MIA,CHI,0,26,5,12,0.417,5,6,0.833,0,6,0,1,2,0.5,1,2,3,4,1,0,1,3,11,7.1
Matthew Dellavedova,26-141,G,1/27/17,MIL,TOR,1,23,3,9,0.333,0,3,0,3,6,0.5,2,2,1,1,1,2,2,1,0,2,2,11,6.5
Julius Randle,22-006,F,12/5/16,LAL,UTA,1,37,5,12,0.417,5,12,0.417,0,0,,1,2,0.5,4,7,11,1,2,0,0,4,11,10.2
Serge Ibaka,27-052,F-C,11/9/16,ORL,MIN,1,27,4,8,0.5,3,7,0.429,1,1,1,2,3,0.667,1,1,2,0,0,2,0,4,11,7.4
Ty Lawson,29-007,G,11/10/16,SAC,LAL,1,25,4,6,0.667,2,3,0.667,2,3,0.667,1,2,0.5,0,1,1,1,2,0,3,4,11,6.4
Jusuf Nurkic,22-077,C,11/8/16,DEN,MEM,1,29,5,7,0.714,5,7,0.714,0,0,,1,1,1,1,6,7,3,0,1,6,5,11,5.4
Mike Dunleavy,36-090,F-G,12/14/16,CLE,MEM,1,23,3,6,0.5,1,2,0.5,2,4,0.5,3,5,0.6,1,5,6,0,1,0,0,1,11,10
Al Horford,30-255,C-F,2/13/17,BOS,DAL,1,32,5,12,0.417,4,10,0.4,1,2,0.5,0,0,,1,4,5,4,1,0,2,1,11,7.9
Andrew Harrison,22-034,G,12/1/16,MEM,ORL,1,30,4,8,0.5,4,8,0.5,0,0,,3,6,0.5,0,4,4,8,0,1,2,3,11,10.1
D'Angelo Russell,20-252,G,11/1/16,LAL,IND,1,19,3,10,0.3,3,6,0.5,0,4,0,5,5,1,0,0,0,3,0,0,2,2,11,4.5
Ish Smith,28-150,G,12/2/16,DET,ATL,1,29,5,10,0.5,4,7,0.571,1,3,0.333,0,0,,0,5,5,13,1,0,1,1,11,16.2
Dwight Powell,25-105,F-C,11/2/16,DAL,UTA,0,16,5,8,0.625,5,8,0.625,0,0,,1,2,0.5,0,1,1,0,0,0,0,3,11,6.1
Dorian Finney-Smith,23-220,F,12/10/16,DAL,HOU,1,30,5,9,0.556,4,6,0.667,1,3,0.333,0,0,,1,3,4,0,1,2,0,2,11,9.9
Thabo Sefolosha,32-240,G-F,12/28/16,ATL,NYK,1,31,3,7,0.429,2,3,0.667,1,4,0.25,4,4,1,1,5,6,0,2,0,4,2,11,6.7
Kyle Korver,36-023,G-F,4/9/17,CLE,ATL,0,28,4,9,0.444,1,2,0.5,3,7,0.429,0,0,,1,2,3,1,0,0,0,3,11,7.1
Markieff Morris,27-084,F,11/25/16,WAS,ORL,1,32,5,10,0.5,5,7,0.714,0,3,0,1,2,0.5,0,3,3,2,3,1,2,3,11,8.4
D.J. Augustin,29-006,G,11/16/16,ORL,NOP,0,18,4,10,0.4,3,6,0.5,1,4,0.25,2,2,1,0,1,1,1,1,0,2,0,11,5.6
Tyler Zeller,26-290,F-C,11/2/16,BOS,CHI,1,25,5,11,0.455,5,11,0.455,0,0,,1,2,0.5,3,1,4,0,1,0,0,3,11,7.1
Michael Kidd-Gilchrist,23-161,F,3/6/17,CHO,IND,1,31,4,8,0.5,4,8,0.5,0,0,,3,3,1,3,10,13,1,2,0,1,1,11,13.4
Timofey Mozgov,30-144,C,12/7/16,LAL,HOU,1,15,5,9,0.556,5,9,0.556,0,0,,1,1,1,2,3,5,0,0,0,3,4,11,4.4
J.R. Smith,31-057,G-F,11/5/16,CLE,PHI,1,32,3,7,0.429,0,0,,3,7,0.429,2,2,1,0,1,1,1,3,1,1,2,11,10.2
Gary Harris,22-057,G,11/10/16,DEN,GSW,1,18,5,7,0.714,4,5,0.8,1,2,0.5,0,2,0,1,1,2,3,0,0,2,0,11,8.4
Ricky Rubio,26-025,G,11/15/16,MIN,CHO,1,35,2,5,0.4,0,2,0,2,3,0.667,5,6,0.833,2,6,8,8,2,0,4,5,11,12.7
T.J. McConnell,24-343,G,3/3/17,PHI,NYK,1,32,5,11,0.455,5,10,0.5,0,1,0,1,2,0.5,0,4,4,4,1,1,1,2,11,8.8
Kyle Korver,35-244,G-F,11/16/16,ATL,MIL,1,27,3,9,0.333,1,2,0.5,2,7,0.286,3,3,1,0,6,6,5,1,2,0,2,11,12.8
Tomas Satoransky,25-162,G,4/10/17,WAS,DET,0,20,4,6,0.667,3,4,0.75,1,2,0.5,2,2,1,0,0,0,3,0,0,3,1,11,7.1
Raymond Felton,32-192,G,1/4/17,LAC,MEM,1,37,4,9,0.444,4,9,0.444,0,0,,3,4,0.75,0,4,4,6,4,0,2,3,11,12.1
Gorgui Dieng,26-328,C,12/11/16,MIN,GSW,1,36,4,10,0.4,4,10,0.4,0,0,,3,4,0.75,3,3,6,0,2,2,3,4,11,7
Devin Harris,33-315,G,1/7/17,DAL,ATL,0,15,3,8,0.375,2,2,1,1,6,0.167,4,4,1,0,1,1,0,0,0,0,1,11,6.5
Danilo Gallinari,28-169,F,1/24/17,DEN,UTA,1,31,3,10,0.3,2,9,0.222,1,1,1,4,4,1,0,3,3,2,1,1,2,1,11,6.8
Alex Len,23-158,C,11/21/16,PHO,WAS,1,31,3,5,0.6,3,5,0.6,0,0,,5,6,0.833,3,7,10,3,0,3,3,4,11,12.1
Ivica Zubac,19-343,C,2/24/17,LAL,OKC,0,27,5,9,0.556,5,9,0.556,0,0,,1,2,0.5,1,5,6,1,1,3,1,1,11,10.9
Dante Exum,21-117,G,11/7/16,UTA,PHI,0,20,4,6,0.667,1,2,0.5,3,4,0.75,0,0,,1,1,2,0,0,1,0,4,11,8.5
Alex Abrines,23-254,G-F,4/12/17,OKC,DEN,0,18,4,11,0.364,1,5,0.2,3,6,0.5,0,0,,3,3,6,1,0,0,1,1,11,7.2
Dwight Howard,30-324,C,10/27/16,ATL,WAS,1,30,4,9,0.444,4,9,0.444,0,0,,3,4,0.75,7,12,19,2,1,3,3,2,11,15.1
Patrick Beverley,28-177,G,1/5/17,HOU,OKC,1,31,4,6,0.667,1,2,0.5,3,4,0.75,0,0,,2,6,8,3,2,0,1,5,11,12.7
Vince Carter,40-009,G-F,2/4/17,MEM,MIN,0,31,3,7,0.429,0,2,0,3,5,0.6,2,2,1,0,3,3,1,1,1,1,3,11,8.4
Ricky Rubio,26-131,G,3/1/17,MIN,UTA,1,29,4,7,0.571,4,7,0.571,0,0,,3,4,0.75,2,4,6,9,2,0,2,1,11,15.8
Gorgui Dieng,26-355,C,1/7/17,MIN,UTA,1,40,4,11,0.364,3,9,0.333,1,2,0.5,2,2,1,1,7,8,4,0,1,1,2,11,9.4
Nikola Mirotic,25-285,F,11/22/16,CHI,DEN,0,22,4,10,0.4,3,8,0.375,1,2,0.5,2,4,0.5,0,3,3,1,1,1,2,2,11,5.3
C.J. Miles,29-238,G-F,12/12/16,IND,CHO,0,19,4,11,0.364,1,2,0.5,3,9,0.333,0,0,,0,2,2,1,0,2,0,3,11,6.4
Jaylen Brown,20-025,F,11/18/16,BOS,GSW,0,23,4,9,0.444,2,3,0.667,2,6,0.333,1,2,0.5,0,1,1,0,0,1,0,3,11,5.7
Paul Zipser,22-351,G-F,2/3/17,CHI,HOU,0,29,4,10,0.4,3,4,0.75,1,6,0.167,2,2,1,2,1,3,1,2,2,2,5,11,7.4
Dorian Finney-Smith,23-267,F,1/26/17,DAL,OKC,1,41,3,7,0.429,1,3,0.333,2,4,0.5,3,4,0.75,1,4,5,2,4,1,2,1,11,12.5
Tristan Thompson,26-014,F-C,3/27/17,CLE,SAS,1,26,4,5,0.8,4,5,0.8,0,0,,3,4,0.75,2,5,7,0,0,1,1,3,11,10.1
DeAndre Jordan,28-154,C,12/22/16,LAC,SAS,1,26,4,6,0.667,4,6,0.667,0,0,,3,4,0.75,2,7,9,2,0,2,2,2,11,11.5
Kyrie Irving,24-262,G,12/10/16,CLE,CHO,1,36,4,13,0.308,2,10,0.2,2,3,0.667,1,1,1,1,3,4,5,0,0,3,3,11,4.4
Iman Shumpert,26-288,G,4/10/17,CLE,MIA,1,39,5,9,0.556,5,8,0.625,0,1,0,1,2,0.5,1,2,3,1,1,1,1,2,11,8.2
DeMarre Carroll,30-114,F,11/18/16,TOR,DEN,1,22,4,9,0.444,3,5,0.6,1,4,0.25,2,2,1,0,3,3,0,1,0,0,1,11,7.8
Bojan Bogdanovic,27-198,G-F,11/2/16,BRK,DET,1,32,3,7,0.429,0,0,,3,7,0.429,2,2,1,1,3,4,2,0,0,2,2,11,7.5
Cody Zeller,24-076,F-C,12/20/16,CHO,LAL,1,25,4,8,0.5,4,8,0.5,0,0,,3,4,0.75,2,3,5,2,2,0,1,2,11,10.5
Allen Crabbe,24-348,G-F,3/23/17,POR,NYK,0,34,4,8,0.5,1,5,0.2,3,3,1,0,0,,1,1,2,2,1,1,0,3,11,9.9
Larry Nance Jr.,23-305,F,11/1/16,LAL,IND,0,30,4,10,0.4,4,9,0.444,0,1,0,3,4,0.75,4,1,5,1,6,1,3,3,11,11.5
Marcus Thornton,29-147,G,10/30/16,WAS,MEM,0,16,4,6,0.667,3,4,0.75,1,2,0.5,2,3,0.667,2,3,5,1,0,0,0,1,11,10.6
Dion Waiters,24-349,G,11/23/16,MIA,DET,1,21,3,10,0.3,2,7,0.286,1,3,0.333,4,4,1,0,2,2,3,0,0,2,3,11,4.7
Gorgui Dieng,27-071,C,3/30/17,MIN,LAL,1,42,4,9,0.444,3,8,0.375,1,1,1,2,3,0.667,4,11,15,6,0,3,1,4,11,15.7
Tyreke Evans,27-130,G-F,1/27/17,NOP,SAS,0,21,5,11,0.455,4,8,0.5,1,3,0.333,0,0,,0,2,2,4,1,0,0,2,11,8.9
Jusuf Nurkic,22-210,C,3/21/17,POR,MIL,1,27,5,9,0.556,5,9,0.556,0,0,,1,3,0.333,5,9,14,1,2,2,4,4,11,10.6
James Johnson,29-249,F,10/26/16,MIA,ORL,0,25,4,8,0.5,2,4,0.5,2,4,0.5,1,1,1,0,2,2,6,0,0,1,1,11,10.4
Kris Humphries,31-270,F-C,11/2/16,ATL,LAL,0,14,3,6,0.5,2,4,0.5,1,2,0.5,4,4,1,1,0,1,1,0,0,2,3,11,6.2
Zaza Pachulia,33-029,C,3/11/17,GSW,SAS,1,20,4,9,0.444,4,9,0.444,0,0,,3,5,0.6,6,6,12,3,1,1,2,0,11,13.3
Isaiah Whitehead,21-285,G,12/18/16,BRK,PHI,1,21,3,6,0.5,1,3,0.333,2,3,0.667,3,4,0.75,0,1,1,0,0,0,0,2,11,7.1
Anthony Tolliver,31-252,F-C,2/8/17,SAC,BOS,1,37,5,12,0.417,4,5,0.8,1,7,0.143,0,0,,0,4,4,0,3,0,2,1,11,6.4
Brandon Knight,24-361,G,11/27/16,PHO,DEN,0,17,2,10,0.2,2,10,0.2,0,0,,7,10,0.7,1,1,2,0,0,0,3,2,11,0.8
Brandon Bass,31-240,F,12/26/16,LAC,DEN,0,20,2,4,0.5,2,4,0.5,0,0,,7,8,0.875,1,3,4,2,0,1,1,0,11,11.3
Jaylen Brown,20-139,F,3/12/17,BOS,CHI,0,26,4,9,0.444,1,3,0.333,3,6,0.5,0,0,,0,3,3,1,1,0,3,4,11,4.3
Ish Smith,28-132,G,11/14/16,DET,OKC,1,30,4,8,0.5,4,8,0.5,0,0,,3,4,0.75,0,6,6,3,2,1,3,1,11,9.8
Jeff Green,30-077,F,11/13/16,ORL,OKC,1,28,4,8,0.5,3,5,0.6,1,3,0.333,2,2,1,0,0,0,3,0,2,0,2,11,9.7
Michael Kidd-Gilchrist,23-048,F,11/13/16,CHO,CLE,1,41,4,13,0.308,4,13,0.308,0,0,,3,3,1,2,8,10,2,1,1,0,5,11,8.4
Pau Gasol,36-122,F-C,11/5/16,SAS,LAC,1,21,3,5,0.6,2,3,0.667,1,2,0.5,4,6,0.667,1,3,4,1,0,1,2,1,11,8.5
Trey Lyles,21-045,F,12/20/16,UTA,GSW,0,24,2,10,0.2,0,6,0,2,4,0.5,5,6,0.833,3,0,3,1,0,0,3,0,11,4.2
Matt Barnes,36-332,F,2/4/17,SAC,GSW,0,34,4,10,0.4,2,6,0.333,2,4,0.5,1,2,0.5,3,14,17,2,1,1,1,3,11,12.4
Terrence Ross,26-034,F-G,3/11/17,ORL,CLE,1,32,4,11,0.364,4,7,0.571,0,4,0,3,4,0.75,0,4,4,1,1,0,1,3,11,5.2
Gerald Henderson,29-046,G,1/24/17,PHI,LAC,0,22,3,7,0.429,2,4,0.5,1,3,0.333,4,4,1,0,1,1,2,0,0,0,5,11,7
Ty Lawson,29-000,G,11/3/16,SAC,ORL,1,35,5,9,0.556,4,7,0.571,1,2,0.5,0,2,0,3,4,7,5,0,0,2,1,11,10.3
Rondae Hollis-Jefferson,22-084,F,3/28/17,BRK,PHI,1,24,5,15,0.333,5,14,0.357,0,1,0,1,2,0.5,3,4,7,2,3,2,1,0,11,10.2
Dion Waiters,24-341,G,11/15/16,MIA,ATL,1,34,5,18,0.278,4,13,0.308,1,5,0.2,0,0,,0,1,1,2,3,1,5,3,11,-0.4
Ish Smith,28-152,G,12/4/16,DET,ORL,0,25,5,10,0.5,5,8,0.625,0,2,0,1,2,0.5,1,0,1,2,0,0,0,4,11,6.1
T.J. McConnell,24-316,G,2/4/17,PHI,MIA,1,28,5,6,0.833,5,6,0.833,0,0,,1,1,1,0,2,2,4,0,0,4,3,11,7
Cristiano Felicio,24-209,F-C,2/1/17,CHI,OKC,0,24,3,3,1,3,3,1,0,0,,5,8,0.625,0,4,4,0,1,0,0,4,11,9.5
Tyler Johnson,24-191,G,11/14/16,MIA,SAS,0,33,4,9,0.444,4,9,0.444,0,0,,3,6,0.5,0,8,8,6,1,0,0,0,11,12.7
Anthony Tolliver,31-269,F-C,2/25/17,SAC,CHO,1,20,3,7,0.429,0,1,0,3,6,0.5,2,4,0.5,0,4,4,1,0,0,4,2,11,3.6
Ryan Anderson,28-207,F,11/29/16,HOU,UTA,1,21,4,7,0.571,1,2,0.5,3,5,0.6,0,0,,1,1,2,0,0,0,2,1,11,6.3
Tyreke Evans,27-193,G-F,3/31/17,SAC,NOP,1,19,3,9,0.333,1,5,0.2,2,4,0.5,3,3,1,0,2,2,2,1,0,0,0,11,8.9
Ben McLemore,24-027,G,3/10/17,SAC,WAS,0,16,3,9,0.333,1,5,0.2,2,4,0.5,3,4,0.75,1,3,4,0,0,0,0,2,11,6.3
Jon Leuer,27-193,F,11/23/16,DET,MIA,0,27,4,6,0.667,2,2,1,2,4,0.5,1,1,1,1,3,4,1,0,1,2,3,11,8.2
Gerald Henderson,29-038,G,1/16/17,PHI,MIL,0,28,3,7,0.429,1,4,0.25,2,3,0.667,3,4,0.75,2,2,4,2,1,1,2,3,11,8.8
Tyler Johnson,24-244,G,1/6/17,MIA,LAL,0,35,4,13,0.308,4,9,0.444,0,4,0,3,4,0.75,1,4,5,2,1,1,1,4,11,5.5
Patrick Patterson,27-251,F,11/20/16,TOR,SAC,0,27,4,7,0.571,1,1,1,3,6,0.5,0,0,,1,4,5,1,1,0,2,2,11,8.5
Marco Belinelli,30-266,G-F,12/16/16,CHO,BOS,0,27,4,13,0.308,3,7,0.429,1,6,0.167,2,3,0.667,2,0,2,4,0,0,0,3,11,6.1
Terry Rozier,22-329,G,2/9/17,BOS,POR,0,25,4,9,0.444,2,5,0.4,2,4,0.5,1,1,1,1,3,4,5,1,0,1,2,11,10.6
DeMarcus Cousins,26-210,C-F,3/11/17,NOP,CHO,1,25,4,11,0.364,3,9,0.333,1,2,0.5,2,5,0.4,0,4,4,4,0,0,6,5,11,-0.3
Noah Vonleh,21-062,F,10/25/16,POR,UTA,0,16,5,5,1,4,4,1,1,1,1,0,0,,0,1,1,0,0,1,0,1,11,10.1
Dwight Howard,30-343,C,11/15/16,ATL,MIA,1,25,5,9,0.556,5,9,0.556,0,0,,1,3,0.333,2,9,11,1,3,0,5,3,11,7.5
Josh McRoberts,29-292,F,12/16/16,MIA,LAC,1,17,4,10,0.4,1,5,0.2,3,5,0.6,0,0,,0,0,0,2,0,1,1,1,11,6.3
Goran Dragic,30-185,G,11/7/16,MIA,OKC,1,25,5,12,0.417,5,11,0.455,0,1,0,1,1,1,0,1,1,4,0,0,2,2,11,4.9
Greg Monroe,26-176,C-F,11/27/16,MIL,ORL,0,17,4,6,0.667,4,6,0.667,0,0,,3,4,0.75,2,5,7,1,1,0,0,2,11,11.8
Eric Gordon,27-318,G,11/7/16,HOU,WAS,0,32,4,10,0.4,1,4,0.25,3,6,0.5,0,0,,0,1,1,2,1,1,2,1,11,6.6
Marc Gasol,32-065,C,4/4/17,MEM,SAS,1,30,5,11,0.455,4,8,0.5,1,3,0.333,0,0,,2,4,6,7,1,0,2,2,11,11
Shabazz Muhammad,24-083,F-G,2/4/17,MIN,MEM,0,26,5,11,0.455,4,8,0.5,1,3,0.333,0,1,0,2,1,3,0,0,0,0,4,11,5
Myles Turner,20-314,F-C,2/1/17,IND,ORL,1,32,4,9,0.444,3,6,0.5,1,3,0.333,2,2,1,0,3,3,3,1,1,0,2,11,10.2
Willie Cauley-Stein,23-118,F-C,12/14/16,SAC,HOU,0,23,5,8,0.625,5,8,0.625,0,0,,1,1,1,1,4,5,2,1,2,0,3,11,11.9
Tony Parker,34-190,G,11/23/16,SAS,CHO,1,29,3,10,0.3,2,6,0.333,1,4,0.25,4,4,1,0,1,1,3,1,0,1,2,11,6.8
Rodney McGruder,25-220,G,3/6/17,MIA,CLE,1,28,4,9,0.444,1,4,0.25,3,5,0.6,0,0,,1,3,4,0,1,0,0,2,11,8.1
Doug McDermott,25-038,F,2/10/17,CHI,PHO,0,20,4,6,0.667,3,3,1,1,3,0.333,2,2,1,0,1,1,0,0,0,0,1,11,8.3
Tim Hardaway,24-345,G,2/24/17,ATL,MIA,1,25,3,13,0.231,0,7,0,3,6,0.5,2,2,1,0,2,2,0,0,1,1,1,11,3
J.J. Redick,32-181,G,12/22/16,LAC,SAS,1,21,3,7,0.429,0,3,0,3,4,0.75,2,2,1,0,0,0,0,2,0,0,1,11,8.9
Tim Frazier,26-022,G,11/23/16,NOP,MIN,1,33,4,5,0.8,2,3,0.667,2,2,1,1,1,1,0,4,4,8,0,0,5,3,11,9.7
Marcin Gortat,33-019,C-F,3/8/17,WAS,DEN,1,33,5,10,0.5,5,10,0.5,0,0,,1,4,0.25,3,12,15,2,0,0,3,2,11,8.1
Devin Harris,34-043,G,4/11/17,DAL,DEN,0,19,3,10,0.3,1,3,0.333,2,7,0.286,3,3,1,0,1,1,3,0,0,2,0,11,5.6
Shelvin Mack,26-238,G,12/16/16,UTA,DAL,0,29,4,7,0.571,4,5,0.8,0,2,0,3,4,0.75,1,2,3,3,1,0,1,0,11,10.7
Devin Booker,20-142,G,3/21/17,PHO,MIA,1,34,4,16,0.25,4,12,0.333,0,4,0,3,4,0.75,2,2,4,5,1,0,7,3,11,-0.7
Alexis Ajinca,28-341,C,4/12/17,NOP,POR,1,25,5,12,0.417,5,12,0.417,0,0,,1,1,1,1,6,7,0,1,0,3,3,11,3.9
Raymond Felton,32-256,G,3/9/17,LAC,MEM,0,26,5,10,0.5,4,7,0.571,1,3,0.333,0,0,,0,4,4,2,0,0,0,2,11,7.8
Avery Bradley,26-029,G,12/25/16,BOS,NYK,1,32,5,12,0.417,4,11,0.364,1,1,1,0,0,,0,6,6,2,3,0,1,2,11,9
Jared Dudley,31-271,F-G,4/7/17,PHO,OKC,0,34,4,8,0.5,1,3,0.333,3,5,0.6,0,0,,0,4,4,3,0,0,1,2,11,8.5
Jrue Holiday,26-282,G,3/21/17,NOP,MEM,1,41,5,17,0.294,4,11,0.364,1,6,0.167,0,0,,1,2,3,6,1,1,1,0,11,7.3
Richaun Holmes,23-018,F-C,11/2/16,PHI,CHO,1,12,4,4,1,3,3,1,1,1,1,2,2,1,1,2,3,2,0,1,2,4,11,9.6
Al Horford,30-299,C-F,3/29/17,BOS,MIL,1,35,4,9,0.444,1,6,0.167,3,3,1,0,0,,2,4,6,6,1,0,1,2,11,12.3
K.J. McDaniels,23-260,G-F,10/26/16,HOU,LAL,0,12,5,5,1,4,4,1,1,1,1,0,0,,1,0,1,0,0,0,0,1,11,9.8
Jamal Crawford,36-254,G,11/29/16,LAC,BRK,0,35,4,15,0.267,3,11,0.273,1,4,0.25,2,2,1,0,3,3,1,0,0,1,2,11,1.9
Jonathon Simmons,27-045,G-F,10/29/16,SAS,NOP,0,26,5,12,0.417,5,11,0.455,0,1,0,1,2,0.5,0,3,3,1,1,1,2,2,11,4.7
Nicolas Brussino,24-013,G-F,3/15/17,DAL,WAS,0,23,4,5,0.8,1,1,1,3,4,0.75,0,0,,2,7,9,0,2,0,0,3,11,13.4
Jon Leuer,27-301,F,3/11/17,DET,NYK,0,21,5,9,0.556,4,7,0.571,1,2,0.5,0,0,,0,3,3,0,0,0,0,1,11,7.2
Cory Joseph,25-122,G,12/20/16,TOR,BRK,0,26,4,11,0.364,3,10,0.3,1,1,1,2,3,0.667,1,6,7,4,0,0,3,0,11,6.8
Arron Afflalo,31-066,G,12/20/16,SAC,POR,0,31,4,7,0.571,3,4,0.75,1,3,0.333,2,3,0.667,0,1,1,1,0,0,2,3,11,5.1
Tim Frazier,26-047,G,12/18/16,NOP,SAS,0,24,4,7,0.571,1,2,0.5,3,5,0.6,0,0,,0,3,3,7,3,1,2,2,11,14.4
Jahlil Okafor,21-071,C-F,2/24/17,PHI,WAS,1,22,3,6,0.5,3,6,0.5,0,0,,5,8,0.625,0,2,2,2,0,0,3,4,11,4.2
Semaj Christon,24-062,G,1/2/17,OKC,MIL,0,12,5,6,0.833,4,4,1,1,2,0.5,0,2,0,0,1,1,2,0,0,1,1,11,8.3
Dwight Powell,25-258,F-C,4/4/17,DAL,SAC,1,34,4,11,0.364,2,3,0.667,2,8,0.25,1,2,0.5,0,7,7,1,0,1,2,2,11,5.2
Mike Conley,29-106,G,1/25/17,MEM,TOR,1,36,4,16,0.25,3,12,0.25,1,4,0.25,2,2,1,1,2,3,5,1,0,1,1,11,5.8
Nikola Vucevic,26-156,C,3/29/17,ORL,OKC,1,33,3,14,0.214,3,14,0.214,0,0,,5,8,0.625,2,14,16,1,1,2,0,3,11,8.7
Roy Hibbert,29-356,C,12/1/16,CHO,DAL,0,17,5,7,0.714,5,7,0.714,0,0,,1,5,0.2,0,4,4,2,0,2,0,3,11,9.3
Tim Frazier,26-024,G,11/25/16,NOP,POR,1,32,3,12,0.25,2,9,0.222,1,3,0.333,4,5,0.8,0,1,1,7,0,0,4,2,11,3.8
Randy Foye,33-176,G,3/19/17,BRK,DAL,1,28,3,7,0.429,2,4,0.5,1,3,0.333,4,4,1,0,6,6,2,1,0,4,3,11,6.3
Dwight Powell,25-152,F-C,12/19/16,DAL,DEN,0,29,5,8,0.625,4,7,0.571,1,1,1,0,0,,3,6,9,1,0,3,0,2,11,13.3
Meyers Leonard,24-258,C-F,11/11/16,POR,SAC,1,29,4,9,0.444,3,5,0.6,1,4,0.25,2,2,1,0,4,4,1,1,0,0,4,11,7.6
Dewayne Dedmon,27-198,C,2/26/17,SAS,LAL,1,20,4,4,1,4,4,1,0,0,,3,4,0.75,4,5,9,3,1,0,1,1,11,15.4
Shabazz Muhammad,24-057,F-G,1/9/17,MIN,DAL,0,20,5,9,0.556,4,7,0.571,1,2,0.5,0,0,,0,2,2,0,0,0,1,2,11,5.5
Rondae Hollis-Jefferson,21-306,F,11/4/16,BRK,CHO,1,32,4,5,0.8,2,3,0.667,2,2,1,1,2,0.5,0,8,8,6,4,0,0,6,11,16.9
Marreese Speights,29-146,C-F,12/28/16,LAC,NOP,0,18,4,11,0.364,2,4,0.5,2,7,0.286,1,1,1,0,4,4,1,0,2,1,4,11,5.6
Brandon Knight,25-075,G,2/15/17,PHO,LAL,0,21,5,10,0.5,4,6,0.667,1,4,0.25,0,0,,0,2,2,4,0,1,0,2,11,9.3
Otto Porter,23-161,F,11/11/16,WAS,CLE,1,34,5,11,0.455,4,8,0.5,1,3,0.333,0,0,,3,5,8,5,0,1,2,3,11,9.9
Justin Hamilton,26-289,C,1/15/17,BRK,HOU,1,18,5,7,0.714,4,5,0.8,1,2,0.5,0,0,,1,2,3,2,0,3,0,3,11,11.7
Marco Belinelli,30-222,G-F,11/2/16,CHO,PHI,0,21,4,9,0.444,1,3,0.333,3,6,0.5,0,0,,0,3,3,2,0,0,0,2,11,7.8
Amir Johnson,29-235,F,12/22/16,BOS,IND,1,24,5,7,0.714,4,5,0.8,1,2,0.5,0,2,0,1,5,6,1,1,0,1,3,11,9
Buddy Hield,23-034,G,1/20/17,NOP,BRK,1,22,4,8,0.5,3,5,0.6,1,3,0.333,2,2,1,1,2,3,1,0,0,0,2,11,8.2
Dennis Schroder,23-064,G,11/18/16,ATL,CHO,1,31,5,12,0.417,5,7,0.714,0,5,0,1,2,0.5,0,1,1,5,1,0,2,0,11,7
Cory Joseph,25-193,G,3/1/17,TOR,WAS,1,28,5,11,0.455,4,7,0.571,1,4,0.25,0,0,,0,4,4,1,0,1,0,0,11,7.9
Kenneth Faried,27-119,F,3/18/17,DEN,HOU,0,23,5,7,0.714,5,7,0.714,0,0,,1,2,0.5,3,5,8,2,1,0,0,1,11,13.3
Nikola Vucevic,26-014,C,11/7/16,ORL,CHI,1,23,5,8,0.625,5,8,0.625,0,0,,1,2,0.5,0,6,6,5,1,0,0,2,11,12.5
Elfrid Payton,23-047,G,4/10/17,ORL,CHI,1,25,5,13,0.385,4,9,0.444,1,4,0.25,0,1,0,2,5,7,4,0,0,2,1,11,6.8
Karl-Anthony Towns,21-021,C-F,12/6/16,MIN,SAS,1,37,3,16,0.188,2,13,0.154,1,3,0.333,4,4,1,3,11,14,4,1,1,2,3,11,7.7
Devin Harris,34-020,G,3/19/17,DAL,BRK,0,17,4,6,0.667,3,4,0.75,1,2,0.5,2,2,1,0,2,2,1,1,0,1,1,11,9.3
Ish Smith,28-216,G,2/6/17,DET,PHI,0,20,5,10,0.5,5,10,0.5,0,0,,1,1,1,0,1,1,4,1,1,0,1,11,10.4
Mindaugas Kuzminskas,27-167,F,4/4/17,NYK,CHI,0,19,5,7,0.714,4,4,1,1,3,0.333,0,2,0,0,0,0,2,1,0,1,0,11,8.7
Spencer Dinwiddie,23-358,G,3/30/17,BRK,DET,0,20,4,7,0.571,3,4,0.75,1,3,0.333,2,2,1,1,2,3,2,0,1,0,1,11,10.7
Brandon Ingram,19-130,F,1/10/17,LAL,POR,0,26,3,6,0.5,1,4,0.25,2,2,1,3,6,0.5,0,4,4,2,0,1,1,0,11,9.1
E'Twaun Moore,27-264,G,11/18/16,NOP,POR,1,29,5,7,0.714,4,4,1,1,3,0.333,0,0,,0,3,3,3,1,0,0,3,11,10.9
Greg Monroe,26-147,C-F,10/29/16,MIL,BRK,0,19,3,7,0.429,3,7,0.429,0,0,,5,5,1,1,2,3,3,4,0,2,0,11,12.7
Doug McDermott,24-365,F,1/2/17,CHI,CHO,1,30,5,12,0.417,5,9,0.556,0,3,0,1,1,1,0,1,1,1,0,0,1,2,11,3.8
Mike Dunleavy,36-047,F-G,11/1/16,CLE,HOU,0,18,3,4,0.75,1,1,1,2,3,0.667,3,4,0.75,0,4,4,2,0,0,0,2,11,10.8
Tyler Johnson,24-320,G,3/23/17,MIA,TOR,0,26,4,9,0.444,3,6,0.5,1,3,0.333,2,3,0.667,0,1,1,1,1,1,4,4,11,3
Marcus Thornton,29-194,G,12/16/16,WAS,DET,0,15,4,6,0.667,3,4,0.75,1,2,0.5,2,2,1,0,1,1,0,0,0,0,3,11,7.5
Kelly Olynyk,25-356,C-F,4/10/17,BOS,BRK,0,15,4,9,0.444,3,6,0.5,1,3,0.333,2,2,1,1,5,6,3,0,0,2,3,11,7.4
Jae Crowder,26-214,F,2/5/17,BOS,LAC,1,34,4,11,0.364,1,2,0.5,3,9,0.333,0,0,,0,6,6,2,3,1,1,1,11,10.4
Justin Hamilton,27-009,C,4/10/17,BRK,BOS,0,17,5,8,0.625,4,5,0.8,1,3,0.333,0,0,,1,3,4,0,1,1,0,2,11,9.9
Kentavious Caldwell-Pope,24-024,G,3/14/17,DET,CLE,1,27,3,10,0.3,3,8,0.375,0,2,0,5,5,1,1,1,2,3,1,0,0,1,11,8.9
Isaiah Whitehead,22-015,G,3/23/17,BRK,PHO,0,28,3,6,0.5,3,4,0.75,0,2,0,5,6,0.833,1,3,4,3,2,1,3,4,11,9.4
JaVale McGee,29-083,C,4/12/17,GSW,LAL,0,18,5,7,0.714,5,7,0.714,0,0,,1,2,0.5,2,3,5,1,1,1,1,4,11,9.8
Jeff Green,30-187,F,3/3/17,ORL,MIA,0,16,5,8,0.625,5,7,0.714,0,1,0,1,2,0.5,0,3,3,1,0,0,1,1,11,7.2
Tim Hardaway,25-004,G,3/20/17,ATL,CHO,1,33,5,11,0.455,4,6,0.667,1,5,0.2,0,0,,0,1,1,2,0,0,2,1,11,4.6
Jonathan Gibson,29-010,G,11/18/16,DAL,MEM,0,20,3,6,0.5,3,3,1,0,3,0,5,8,0.625,0,4,4,3,1,0,4,3,11,5.9
Cory Joseph,25-136,G,1/3/17,TOR,SAS,0,24,3,11,0.273,2,9,0.222,1,2,0.5,4,5,0.8,0,3,3,3,1,0,1,0,11,7.1
Nicolas Batum,28-052,F-G,2/4/17,CHO,UTA,1,33,4,9,0.444,3,6,0.5,1,3,0.333,2,2,1,0,3,3,6,0,0,4,2,11,6.6
Jeff Green,30-139,F,1/14/17,ORL,UTA,0,18,4,9,0.444,3,6,0.5,1,3,0.333,2,4,0.5,1,4,5,0,0,0,2,0,11,5.4
Isaiah Whitehead,21-264,G,11/27/16,BRK,SAC,1,29,4,6,0.667,1,3,0.333,3,3,1,0,0,,0,4,4,2,0,0,3,2,11,7.2
Leandro Barbosa,34-116,G,3/24/17,PHO,BOS,0,30,5,12,0.417,4,9,0.444,1,3,0.333,0,0,,1,4,5,0,1,0,2,1,11,5.1
Kevin Love,28-214,F,4/9/17,CLE,ATL,1,42,4,14,0.286,3,9,0.333,1,5,0.2,2,4,0.5,6,9,15,5,0,1,4,5,11,7.1
DeMar DeRozan,27-209,G,3/4/17,TOR,MIL,1,31,5,13,0.385,5,12,0.417,0,1,0,1,1,1,0,3,3,4,0,0,3,3,11,3.4
P.J. Tucker,31-266,F,1/26/17,PHO,DEN,0,39,4,10,0.4,1,6,0.167,3,4,0.75,0,0,,1,3,4,0,1,0,0,4,11,6.6
Aaron Gordon,21-059,F,11/14/16,ORL,IND,0,22,5,11,0.455,4,7,0.571,1,4,0.25,0,0,,0,3,3,1,0,0,0,1,11,6.5
Jameer Nelson,34-277,G,11/12/16,DEN,DET,0,22,5,8,0.625,4,6,0.667,1,2,0.5,0,0,,0,1,1,2,0,0,2,4,11,5.5
Buddy Hield,23-081,G,3/8/17,SAC,SAS,0,18,4,9,0.444,1,4,0.25,3,5,0.6,0,0,,0,2,2,1,0,0,1,0,11,6.6
Clint Capela,22-312,F-C,3/26/17,HOU,OKC,1,22,5,6,0.833,5,6,0.833,0,0,,1,2,0.5,1,8,9,0,1,2,1,5,11,10.9
Brook Lopez,28-273,C,12/30/16,BRK,WAS,1,31,3,9,0.333,2,4,0.5,1,5,0.2,4,4,1,1,4,5,6,1,0,4,2,11,8.2
Hassan Whiteside,27-186,C,12/16/16,MIA,LAC,1,31,5,12,0.417,5,12,0.417,0,0,,1,5,0.2,2,15,17,2,2,1,1,4,11,10.4
Joe Harris,25-098,G,12/14/16,BRK,LAL,0,26,3,10,0.3,0,3,0,3,7,0.429,2,2,1,0,4,4,0,2,0,1,2,11,6.6
Terrence Ross,26-003,F-G,2/8/17,TOR,MIN,0,14,5,9,0.556,4,5,0.8,1,4,0.25,0,0,,0,2,2,1,1,0,0,2,11,8.2
Vince Carter,39-360,G-F,1/20/17,MEM,SAC,0,22,3,5,0.6,1,1,1,2,4,0.5,3,3,1,0,4,4,2,2,0,0,1,11,12.9
Larry Nance Jr.,23-329,F,11/25/16,LAL,GSW,0,20,5,8,0.625,5,8,0.625,0,0,,1,2,0.5,2,5,7,0,1,0,0,4,11,9.3
Alex Abrines,23-177,G-F,1/25/17,OKC,NOP,0,18,4,5,0.8,2,3,0.667,2,2,1,1,1,1,0,0,0,0,1,1,0,3,11,9.6
Lance Thomas,28-307,F,2/25/17,NYK,PHI,1,37,4,10,0.4,3,8,0.375,1,2,0.5,2,3,0.667,0,6,6,2,0,0,3,4,11,3.8
Danny Green,29-156,G-F,11/25/16,SAS,BOS,1,32,3,4,0.75,0,0,,3,4,0.75,2,2,1,0,7,7,2,0,3,1,1,11,13.6
Maurice Harkless,23-210,F-G,12/7/16,POR,MIL,1,32,5,13,0.385,4,8,0.5,1,5,0.2,0,0,,4,0,4,4,4,0,4,4,11,7.9
Luke Babbitt,27-163,F,11/30/16,MIA,DEN,1,23,4,9,0.444,1,3,0.333,3,6,0.5,0,0,,0,1,1,0,1,0,0,4,11,6
Brandon Knight,25-013,G,12/15/16,PHO,SAS,0,22,2,7,0.286,2,6,0.333,0,1,0,7,8,0.875,0,1,1,2,3,0,1,2,11,9.4
Mirza Teletovic,31-078,F,12/5/16,MIL,SAS,0,21,4,10,0.4,1,2,0.5,3,8,0.375,0,0,,0,2,2,1,0,1,2,1,11,5.2
Dennis Schroder,23-163,G,2/25/17,ATL,ORL,0,31,4,17,0.235,3,12,0.25,1,5,0.2,2,3,0.667,0,5,5,8,0,1,1,1,11,6.7
Noah Vonleh,21-207,F,3/19/17,POR,MIA,1,29,5,7,0.714,5,7,0.714,0,0,,1,2,0.5,2,5,7,1,1,0,1,2,11,10.5
Jameer Nelson,34-325,G,12/30/16,DEN,PHI,0,19,4,5,0.8,1,2,0.5,3,3,1,0,0,,0,0,0,5,0,0,0,2,11,11.8
Draymond Green,26-257,F,11/16/16,GSW,TOR,1,35,5,13,0.385,4,9,0.444,1,4,0.25,0,0,,0,7,7,5,2,3,3,4,11,9
Harrison Barnes,24-191,F,12/7/16,DAL,SAC,1,32,5,16,0.313,5,12,0.417,0,4,0,1,2,0.5,2,2,4,1,0,0,5,3,11,-2.1
Tim Frazier,26-145,G,3/26/17,NOP,DEN,1,36,4,8,0.5,3,5,0.6,1,3,0.333,2,2,1,1,2,3,8,1,0,1,3,11,12.7
Raymond Felton,32-141,G,11/14/16,LAC,BRK,0,22,4,6,0.667,1,2,0.5,3,4,0.75,0,0,,0,0,0,1,2,0,1,4,11,8.5
Dennis Schroder,23-073,G,11/27/16,ATL,LAL,1,32,5,15,0.333,4,10,0.4,1,5,0.2,0,0,,1,3,4,8,1,1,3,2,11,7.6
Al-Farouq Aminu,26-112,F,1/11/17,POR,CLE,1,31,5,16,0.313,5,11,0.455,0,5,0,1,1,1,5,7,12,2,0,1,2,1,11,7.1
Glenn Robinson,22-295,G-F,10/29/16,IND,CHI,0,18,4,7,0.571,4,5,0.8,0,2,0,3,3,1,2,1,3,0,0,0,1,0,11,8.4
Bojan Bogdanovic,27-301,G-F,2/13/17,BRK,MEM,1,25,3,6,0.5,3,4,0.75,0,2,0,5,6,0.833,1,4,5,2,0,0,2,2,11,8.1
Dante Exum,21-210,G,2/8/17,UTA,NOP,0,23,5,7,0.714,4,5,0.8,1,2,0.5,0,0,,0,3,3,5,1,0,3,4,11,8.9
Troy Williams,21-346,F,12/10/16,MEM,GSW,1,19,4,7,0.571,3,4,0.75,1,3,0.333,2,2,1,0,2,2,2,0,2,0,3,11,9.9
Brandon Knight,25-073,G,2/13/17,PHO,NOP,0,18,4,8,0.5,3,7,0.429,1,1,1,2,3,0.667,0,1,1,2,0,0,1,2,11,6.5
Jon Leuer,27-172,F,11/2/16,DET,BRK,0,27,5,8,0.625,4,5,0.8,1,3,0.333,0,0,,2,5,7,0,0,1,1,2,11,9.2
Jerami Grant,22-247,F,11/14/16,OKC,DET,0,26,5,8,0.625,4,4,1,1,4,0.25,0,0,,1,4,5,0,2,2,0,2,11,11.9
Montrezl Harrell,22-365,F-C,1/25/17,HOU,BOS,0,25,5,6,0.833,5,6,0.833,0,0,,1,2,0.5,0,2,2,3,1,0,0,0,11,12.1
Jahlil Okafor,21-005,C-F,12/20/16,PHI,NOP,1,25,5,8,0.625,5,8,0.625,0,0,,1,2,0.5,1,6,7,1,0,2,1,1,11,10.2
Rudy Gay,30-146,F,1/10/17,SAC,DET,1,38,3,11,0.273,2,9,0.222,1,2,0.5,4,4,1,2,5,7,4,3,1,7,5,11,4.9
Marvin Williams,30-202,F,1/7/17,CHO,SAS,1,27,3,10,0.3,2,4,0.5,1,6,0.167,4,4,1,2,3,5,2,0,1,0,1,11,9.2
Alan Williams,24-031,F-C,2/28/17,PHO,MEM,0,22,5,8,0.625,5,8,0.625,0,0,,1,2,0.5,2,2,4,2,0,1,2,3,11,7.9
Brandon Rush,31-190,G-F,1/13/17,MIN,OKC,1,40,4,9,0.444,1,3,0.333,3,6,0.5,0,0,,3,1,4,1,2,2,2,1,11,10.4
Tony Allen,35-023,G-F,2/3/17,MEM,OKC,1,29,4,9,0.444,4,8,0.5,0,1,0,3,4,0.75,2,2,4,0,1,2,2,3,11,7.1
Rodney Hood,24-151,G-F,3/20/17,UTA,IND,1,16,4,10,0.4,2,5,0.4,2,5,0.4,1,1,1,0,2,2,0,0,0,1,5,11,3.2
David Lee,33-324,F,3/19/17,SAS,SAC,0,20,4,7,0.571,4,7,0.571,0,0,,3,3,1,3,4,7,3,0,0,0,0,11,13.1
Jae Crowder,26-278,F,4/10/17,BOS,BRK,1,33,4,6,0.667,1,2,0.5,3,4,0.75,0,0,,1,7,8,6,1,2,2,0,11,15.8
C.J. Watson,32-298,G,2/9/17,ORL,PHI,1,28,2,6,0.333,1,4,0.25,1,2,0.5,6,6,1,0,3,3,4,1,0,5,3,11,6.1
Allen Crabbe,24-327,G-F,3/2/17,POR,OKC,0,24,4,8,0.5,2,4,0.5,2,4,0.5,1,1,1,0,1,1,0,1,0,1,1,11,6.9
Trevor Booker,29-025,F,12/20/16,BRK,TOR,1,20,4,6,0.667,3,4,0.75,1,2,0.5,2,2,1,2,3,5,2,1,0,4,2,11,8.3
Eric Gordon,28-101,G,4/5/17,HOU,DEN,0,38,2,14,0.143,0,4,0,2,10,0.2,5,6,0.833,1,2,3,1,1,0,0,0,11,4.6
Thaddeus Young,28-159,F,11/27/16,IND,LAC,1,32,5,10,0.5,4,6,0.667,1,4,0.25,0,0,,1,5,6,1,1,0,3,3,11,5.7
Kyrie Irving,24-294,G,1/11/17,CLE,POR,1,32,4,16,0.25,3,14,0.214,1,2,0.5,2,2,1,3,0,3,1,2,0,3,2,11,2.4
Nikola Vucevic,26-060,C,12/23/16,ORL,LAL,0,26,5,11,0.455,5,11,0.455,0,0,,1,2,0.5,0,7,7,3,1,1,2,3,11,7.6
Seth Curry,26-214,G,3/25/17,DAL,TOR,1,30,4,10,0.4,2,4,0.5,2,6,0.333,1,1,1,0,1,1,2,1,0,0,1,11,7.9
Marcin Gortat,33-007,C-F,2/24/17,WAS,PHI,1,36,3,10,0.3,3,10,0.3,0,0,,5,8,0.625,5,6,11,1,0,1,3,4,11,6.1
D.J. Augustin,29-043,G,12/23/16,ORL,LAL,1,18,4,5,0.8,1,1,1,3,4,0.75,0,0,,1,1,2,4,0,0,4,3,11,7.7
Zach LaVine,21-326,G,1/30/17,MIN,ORL,1,43,3,9,0.333,2,3,0.667,1,6,0.167,4,5,0.8,0,3,3,0,1,0,0,4,11,5.8
Al Jefferson,32-030,C-F,2/3/17,IND,BRK,0,15,4,9,0.444,4,9,0.444,0,0,,3,4,0.75,2,3,5,0,0,0,0,2,11,7.4
Shabazz Muhammad,24-104,F-G,2/25/17,MIN,HOU,0,13,4,8,0.5,3,6,0.5,1,2,0.5,2,2,1,2,1,3,0,0,0,1,2,11,6.9
C.J. Watson,32-250,G,12/23/16,ORL,LAL,0,23,5,7,0.714,4,5,0.8,1,2,0.5,0,0,,0,1,1,4,1,0,1,1,11,10.8
Gerald Henderson,28-346,G,11/19/16,PHI,PHO,1,22,4,8,0.5,4,7,0.571,0,1,0,3,4,0.75,2,3,5,1,3,0,0,3,11,11.4
Giannis Antetokounmpo,22-119,F-G,4/4/17,MIL,OKC,1,24,3,10,0.3,3,9,0.333,0,1,0,5,8,0.625,4,6,10,4,0,3,4,2,11,8.7
Tyler Zeller,26-291,F-C,11/3/16,BOS,CLE,1,28,5,8,0.625,5,8,0.625,0,0,,1,2,0.5,3,7,10,6,0,2,0,3,11,15.6
Deron Williams,32-205,G,1/17/17,DAL,CHI,1,30,5,11,0.455,4,6,0.667,1,5,0.2,0,0,,0,6,6,9,1,0,4,3,11,9.2
Al Horford,30-183,C-F,12/3/16,BOS,PHI,1,34,4,10,0.4,3,7,0.429,1,3,0.333,2,2,1,0,4,4,3,0,1,1,2,11,7.8
Dwight Howard,31-079,C,2/25/17,ATL,ORL,1,29,3,7,0.429,3,7,0.429,0,0,,5,13,0.385,4,10,14,1,0,1,1,4,11,8.7
Cory Joseph,25-200,G,3/8/17,TOR,NOP,1,32,4,11,0.364,3,5,0.6,1,6,0.167,2,2,1,0,5,5,4,1,0,3,2,11,6.4
Sergio Rodriguez,30-215,G,1/13/17,PHI,CHO,0,16,4,7,0.571,2,2,1,2,5,0.4,1,1,1,0,1,1,4,2,0,2,1,11,10.4
Justin Hamilton,26-287,C,1/13/17,BRK,TOR,0,14,4,8,0.5,3,4,0.75,1,4,0.25,2,2,1,0,2,2,2,1,0,0,0,11,10
Trey Burke,24-093,G,2/13/17,WAS,OKC,0,26,4,8,0.5,4,6,0.667,0,2,0,3,3,1,0,4,4,4,0,0,3,2,11,7.2
Richaun Holmes,23-162,F-C,3/26/17,PHI,IND,1,31,4,7,0.571,3,4,0.75,1,3,0.333,2,2,1,1,11,12,0,2,1,0,2,11,13.6
Michael Carter-Williams,25-096,G,1/14/17,CHI,NOP,1,29,5,12,0.417,5,11,0.455,0,1,0,1,2,0.5,0,3,3,2,1,0,0,5,11,5.5
Amir Johnson,29-220,F,12/7/16,BOS,ORL,1,23,5,7,0.714,5,7,0.714,0,0,,1,1,1,2,3,5,1,0,0,1,3,11,8.9
Harrison Barnes,24-309,F,4/4/17,DAL,SAC,1,28,4,10,0.4,3,8,0.375,1,2,0.5,2,2,1,0,2,2,1,0,0,0,0,11,6.9
Matthew Dellavedova,26-092,G,12/9/16,MIL,ATL,1,27,4,12,0.333,3,8,0.375,1,4,0.25,2,3,0.667,0,4,4,3,1,0,3,3,11,3.9
Deron Williams,32-187,G,12/30/16,DAL,GSW,1,20,4,7,0.571,3,4,0.75,1,3,0.333,2,3,0.667,0,2,2,4,1,0,2,0,11,9.7
Richard Jefferson,36-256,F,3/4/17,CLE,MIA,0,25,5,8,0.625,4,5,0.8,1,3,0.333,0,1,0,0,0,0,0,0,0,2,2,11,4.2
Terrence Ross,25-281,F-G,11/12/16,TOR,NYK,0,18,3,8,0.375,2,6,0.333,1,2,0.5,4,4,1,0,0,0,0,1,0,0,1,11,7.2
Taj Gibson,31-190,F,12/31/16,CHI,MIL,1,28,3,12,0.25,3,12,0.25,0,0,,5,5,1,4,1,5,1,0,1,0,1,11,7.9
Richard Jefferson,36-191,F,12/29/16,CLE,BOS,0,19,2,2,1,2,2,1,0,0,,7,9,0.778,0,3,3,1,0,0,0,2,11,10.4
Gerald Henderson,28-332,G,11/5/16,PHI,CLE,1,24,5,9,0.556,4,5,0.8,1,4,0.25,0,0,,0,2,2,1,2,0,2,5,11,6
Ben McLemore,24-041,G,3/24/17,SAC,GSW,0,22,5,10,0.5,5,8,0.625,0,2,0,1,2,0.5,0,1,1,2,1,0,1,0,11,7.3
Jarell Martin,22-188,F,11/28/16,MEM,CHO,0,20,5,13,0.385,4,12,0.333,1,1,1,0,2,0,2,10,12,0,0,0,1,3,11,5.3
Cristiano Felicio,24-244,F-C,3/8/17,CHI,ORL,0,12,5,7,0.714,5,7,0.714,0,0,,1,2,0.5,0,2,2,1,0,0,0,0,11,9
Alan Williams,24-069,F-C,4/7/17,PHO,OKC,0,27,3,5,0.6,3,5,0.6,0,0,,5,6,0.833,1,3,4,2,0,1,1,5,11,9
Thon Maker,20-036,F-C,4/2/17,MIL,DAL,1,20,5,7,0.714,4,6,0.667,1,1,1,0,0,,1,0,1,0,0,0,0,2,11,8
James Johnson,29-307,F,12/23/16,MIA,NOP,0,22,4,12,0.333,3,10,0.3,1,2,0.5,2,2,1,2,8,10,2,0,1,2,2,11,7.3
Al-Farouq Aminu,26-171,F,3/11/17,POR,WAS,0,34,3,6,0.5,0,2,0,3,4,0.75,2,2,1,0,8,8,1,1,1,0,1,11,12.4
T.J. Warren,23-112,F,12/26/16,PHO,HOU,0,31,5,16,0.313,4,12,0.333,1,4,0.25,0,1,0,2,2,4,0,1,0,2,1,11,2
Patty Mills,28-075,G,10/25/16,SAS,GSW,0,18,4,9,0.444,1,4,0.25,3,5,0.6,0,0,,0,1,1,5,4,0,0,1,11,13.7
Norman Powell,23-298,G,3/19/17,TOR,IND,0,14,4,11,0.364,3,5,0.6,1,6,0.167,2,2,1,1,2,3,1,1,0,2,2,11,5.1
Tyler Johnson,24-230,G,12/23/16,MIA,NOP,0,30,5,13,0.385,4,11,0.364,1,2,0.5,0,0,,0,3,3,1,1,0,0,4,11,4.9
Jason Smith,30-323,F-C,1/19/17,WAS,NYK,0,23,5,8,0.625,4,6,0.667,1,2,0.5,0,0,,1,3,4,0,0,2,2,4,11,6.8
Karl-Anthony Towns,21-047,C-F,1/1/17,MIN,POR,1,34,3,15,0.2,3,9,0.333,0,6,0,5,5,1,4,9,13,6,1,1,3,2,11,9.3
Tobias Harris,24-252,F,3/24/17,DET,ORL,1,26,3,8,0.375,2,5,0.4,1,3,0.333,4,4,1,0,0,0,3,0,0,1,2,11,6.9
Anthony Bennett,23-284,F,12/23/16,BRK,CLE,0,14,4,8,0.5,4,6,0.667,0,2,0,3,4,0.75,1,1,2,1,0,1,0,2,11,8.2
Richaun Holmes,23-158,F-C,3/22/17,PHI,OKC,0,16,5,8,0.625,5,8,0.625,0,0,,1,2,0.5,0,2,2,0,0,0,0,5,11,5.6
Alex Len,23-280,C,3/23/17,PHO,BRK,1,25,4,6,0.667,3,5,0.6,1,1,1,2,3,0.667,2,9,11,1,2,2,2,6,11,11.8
Tobias Harris,24-228,F,2/28/17,DET,POR,0,23,5,12,0.417,4,9,0.444,1,3,0.333,0,0,,1,1,2,1,0,0,0,1,11,5.9
Cody Zeller,24-150,F-C,3/4/17,CHO,DEN,1,26,4,10,0.4,4,10,0.4,0,0,,3,6,0.5,1,7,8,2,1,0,0,5,11,7.6
Domantas Sabonis,20-336,F,4/4/17,OKC,MIL,0,16,3,6,0.5,1,4,0.25,2,2,1,3,4,0.75,0,5,5,1,0,1,1,3,11,8.3
Mario Hezonja,21-258,F-G,11/9/16,ORL,MIN,0,14,4,8,0.5,3,4,0.75,1,4,0.25,2,2,1,0,1,1,0,1,0,2,2,11,5.5
Patty Mills,28-129,G,12/18/16,SAS,NOP,0,20,3,7,0.429,1,3,0.333,2,4,0.5,3,3,1,0,3,3,7,1,0,2,0,11,12.1
Nicolas Laprovittola,26-279,G,11/5/16,SAS,LAC,0,22,4,5,0.8,1,1,1,3,4,0.75,0,0,,1,1,2,5,0,0,2,1,11,11.2
Tyus Jones,20-290,G,2/24/17,MIN,DAL,0,25,4,6,0.667,1,3,0.333,3,3,1,0,1,0,0,2,2,2,1,0,0,1,11,10.6
Patrick Beverley,28-262,G,3/31/17,HOU,GSW,1,30,4,10,0.4,1,5,0.2,3,5,0.6,0,0,,0,3,3,2,0,0,0,1,11,7.5
Markieff Morris,27-105,F,12/16/16,WAS,DET,1,18,5,9,0.556,4,7,0.571,1,2,0.5,0,0,,0,3,3,4,1,1,1,3,11,9.9
Cory Joseph,25-208,G,3/16/17,TOR,OKC,1,30,5,8,0.625,4,7,0.571,1,1,1,0,2,0,0,2,2,6,2,0,2,2,11,10.6
Jameer Nelson,34-338,G,1/12/17,DEN,IND,0,24,4,7,0.571,1,1,1,3,6,0.5,0,0,,0,0,0,5,1,0,1,4,11,9.6
Luol Deng,31-242,F,12/14/16,LAL,BRK,1,32,5,12,0.417,4,8,0.5,1,4,0.25,0,2,0,3,5,8,2,1,1,0,2,11,9.7
Wesley Matthews,30-173,G,4/5/17,DAL,LAC,1,36,4,9,0.444,1,5,0.2,3,4,0.75,0,0,,1,4,5,6,0,0,2,4,11,8.8
Jeremy Lin,28-217,G,3/28/17,BRK,PHI,1,30,4,14,0.286,4,10,0.4,0,4,0,3,4,0.75,1,5,6,7,4,0,2,3,11,10.3
Eric Bledsoe,27-079,G,2/26/17,PHO,MIL,1,34,4,10,0.4,4,8,0.5,0,2,0,3,4,0.75,0,4,4,9,2,2,5,4,11,9.5
Alan Williams,24-057,F-C,3/26/17,PHO,CHO,0,26,5,7,0.714,5,7,0.714,0,0,,1,2,0.5,1,10,11,2,1,1,1,4,11,11.9
Patrick Patterson,27-347,F,2/24/17,TOR,BOS,0,17,4,6,0.667,3,3,1,1,3,0.333,2,2,1,1,1,2,1,0,0,1,3,11,7.9
Deron Williams,32-265,G,3/18/17,CLE,LAC,1,26,4,8,0.5,3,7,0.429,1,1,1,2,2,1,0,3,3,5,0,0,5,2,11,5.6
Cody Zeller,24-159,F-C,3/13/17,CHO,CHI,1,34,4,10,0.4,4,10,0.4,0,0,,3,3,1,1,6,7,2,1,2,1,3,11,9.7
Nik Stauskas,23-140,G,2/24/17,PHI,WAS,0,24,3,7,0.429,2,4,0.5,1,3,0.333,4,4,1,0,3,3,1,0,1,0,2,11,8.8
Marreese Speights,29-185,C-F,2/5/17,LAC,BOS,0,17,2,5,0.4,0,1,0,2,4,0.5,5,6,0.833,1,4,5,0,0,0,0,0,11,9.8
Wayne Ellington,29-143,G,3/21/17,MIA,PHO,0,27,4,8,0.5,1,2,0.5,3,6,0.5,0,0,,0,1,1,2,1,0,0,0,11,9.7
Marcus Smart,22-280,G,12/11/16,BOS,OKC,1,36,5,11,0.455,4,7,0.571,1,4,0.25,0,1,0,1,5,6,8,1,0,2,2,11,10.9
JaVale McGee,28-333,C,12/17/16,GSW,POR,0,11,5,5,1,5,5,1,0,0,,1,3,0.333,0,5,5,0,1,1,1,2,11,10.1
Luol Deng,31-251,F,12/23/16,LAL,ORL,1,31,3,8,0.375,2,6,0.333,1,2,0.5,4,4,1,1,9,10,3,0,1,2,2,11,10
Brandon Rush,31-268,G-F,4/1/17,MIN,SAC,1,22,4,8,0.5,1,3,0.333,3,5,0.6,0,0,,0,2,2,1,0,0,0,1,11,7.9
Jordan Clarkson,24-248,G,2/10/17,LAL,MIL,0,21,4,9,0.444,1,3,0.333,3,6,0.5,0,0,,0,0,0,4,1,0,1,4,11,7.5
Allen Crabbe,24-248,G-F,12/13/16,POR,OKC,0,26,4,8,0.5,2,5,0.4,2,3,0.667,1,2,0.5,1,2,3,2,0,0,0,2,11,8.5
Marco Belinelli,30-355,G-F,3/15/17,CHO,IND,0,26,4,10,0.4,2,4,0.5,2,6,0.333,1,2,0.5,0,1,1,3,2,0,2,0,11,7.6
Jrue Holiday,26-204,G,1/2/17,NOP,CLE,1,35,4,11,0.364,2,8,0.25,2,3,0.667,1,2,0.5,0,4,4,13,3,0,4,1,11,13.4
Kyle Korver,36-018,G-F,4/4/17,CLE,ORL,0,12,4,6,0.667,1,1,1,3,5,0.6,0,0,,0,1,1,1,0,0,1,0,11,8.4
Ish Smith,28-278,G,4/9/17,DET,MEM,1,27,5,12,0.417,5,11,0.455,0,1,0,1,2,0.5,0,2,2,7,0,0,3,1,11,6.3
Khris Middleton,25-211,F-G,3/11/17,MIL,MIN,1,33,3,9,0.333,3,6,0.5,0,3,0,5,5,1,1,8,9,4,1,0,2,3,11,9.6
Ish Smith,28-242,G,3/4/17,DET,PHI,0,23,5,8,0.625,5,7,0.714,0,1,0,1,1,1,0,4,4,13,0,1,0,0,11,18.4
Kosta Koufos,28-031,C,3/27/17,SAC,MEM,1,30,5,7,0.714,5,7,0.714,0,0,,1,1,1,2,3,5,1,2,3,0,6,11,12.8
Tony Allen,34-361,G-F,1/6/17,MEM,GSW,1,48,5,16,0.313,5,15,0.333,0,1,0,1,2,0.5,6,6,12,3,6,0,2,3,11,12.3
Ty Lawson,29-132,G,3/15/17,SAC,PHO,1,26,2,7,0.286,2,7,0.286,0,0,,7,8,0.875,1,2,3,6,0,0,4,0,11,8
Dwight Howard,31-069,C,2/15/17,ATL,LAC,1,24,5,8,0.625,5,7,0.714,0,1,0,1,4,0.25,5,10,15,0,0,0,1,1,11,11.3
C.J. Miles,29-355,G-F,4/8/17,IND,ORL,0,20,4,7,0.571,2,3,0.667,2,4,0.5,1,1,1,1,2,3,0,1,0,0,0,11,10
Justin Holiday,27-289,G,1/19/17,NYK,WAS,0,21,4,6,0.667,3,3,1,1,3,0.333,2,2,1,0,2,2,2,1,1,0,2,11,11.3
Doug McDermott,25-094,F,4/7/17,OKC,PHO,1,40,4,9,0.444,2,3,0.667,2,6,0.333,1,2,0.5,1,4,5,0,0,0,0,2,11,7
Cory Joseph,25-211,G,3/19/17,TOR,IND,1,31,5,9,0.556,4,8,0.5,1,1,1,0,0,,1,3,4,9,1,1,4,3,11,11.1
Dante Exum,21-206,G,2/4/17,UTA,CHO,0,22,5,12,0.417,4,8,0.5,1,4,0.25,0,0,,0,1,1,3,1,0,1,4,11,5.4
Michael Beasley,28-004,F,1/13/17,MIL,MIA,0,21,5,5,1,5,5,1,0,0,,1,1,1,0,7,7,2,1,1,2,3,11,11.5
Andrew Wiggins,22-016,F-G,3/11/17,MIN,MIL,1,37,3,13,0.231,3,11,0.273,0,2,0,5,6,0.833,2,2,4,1,1,0,2,2,11,3.6
Shabazz Muhammad,24-010,F-G,11/23/16,MIN,NOP,0,17,4,6,0.667,4,5,0.8,0,1,0,3,5,0.6,1,1,2,0,1,0,1,0,11,8.6
Serge Ibaka,27-074,F-C,12/1/16,ORL,MEM,1,32,4,10,0.4,4,6,0.667,0,4,0,3,4,0.75,2,6,8,0,0,3,0,3,11,9.3
Dante Cunningham,29-276,F,1/23/17,NOP,CLE,1,31,4,10,0.4,2,3,0.667,2,7,0.286,1,2,0.5,1,5,6,2,0,1,0,3,11,8.3
Nene Hilario,34-087,F-C,12/9/16,HOU,OKC,0,15,5,7,0.714,5,7,0.714,0,0,,1,2,0.5,0,3,3,0,0,1,2,5,11,5.3
D.J. Augustin,29-017,G,11/27/16,ORL,MIL,1,25,5,7,0.714,4,4,1,1,3,0.333,0,0,,0,2,2,5,0,0,0,0,11,12.2
Zach LaVine,21-256,G,11/21/16,MIN,BOS,1,38,4,12,0.333,4,5,0.8,0,7,0,3,3,1,0,3,3,4,1,1,2,2,11,6.8
Trevor Ariza,31-201,F,1/17/17,HOU,MIA,1,39,5,11,0.455,4,6,0.667,1,5,0.2,0,0,,0,7,7,1,1,0,3,3,11,4.9
Amir Johnson,29-272,F,1/28/17,BOS,MIL,1,25,5,7,0.714,4,6,0.667,1,1,1,0,1,0,1,6,7,2,0,1,0,3,11,11.1
Rodney McGruder,25-201,G,2/15/17,MIA,HOU,1,27,4,8,0.5,1,2,0.5,3,6,0.5,0,0,,1,0,1,2,2,0,0,2,11,10.3
Brook Lopez,28-225,C,11/12/16,BRK,PHO,1,28,3,11,0.273,2,6,0.333,1,5,0.2,4,4,1,0,5,5,2,1,5,3,3,11,7.7
Ersan Ilyasova,29-269,F,2/8/17,PHI,SAS,1,28,4,11,0.364,2,5,0.4,2,6,0.333,1,3,0.333,0,2,2,3,1,0,0,3,11,6.6
Ryan Anderson,28-272,F,2/2/17,HOU,ATL,1,34,4,12,0.333,1,3,0.333,3,9,0.333,0,0,,0,2,2,2,0,0,0,3,11,5
Anthony Morrow,31-126,G,1/31/17,OKC,SAS,0,30,3,12,0.25,2,6,0.333,1,6,0.167,4,4,1,1,0,1,0,2,0,1,3,11,4.3
Robert Covington,26-030,F,1/13/17,PHI,CHO,1,28,4,10,0.4,1,4,0.25,3,6,0.5,0,0,,2,4,6,2,1,1,2,5,11,7.3
Joel Embiid,22-279,C-F,12/20/16,PHI,NOP,1,25,4,12,0.333,4,9,0.444,0,3,0,3,5,0.6,0,6,6,1,1,1,2,5,11,3.6
Dario Saric,22-220,F,11/14/16,PHI,HOU,1,24,4,11,0.364,3,8,0.375,1,3,0.333,2,2,1,1,5,6,2,0,0,0,0,11,8.5
Manu Ginobili,39-236,G,3/21/17,SAS,MIN,0,19,4,7,0.571,3,4,0.75,1,3,0.333,2,2,1,2,1,3,2,3,0,1,1,11,12.4
Tony Snell,25-043,G-F,12/23/16,MIL,WAS,1,27,5,8,0.625,4,4,1,1,4,0.25,0,0,,0,3,3,2,0,1,0,1,11,10
James Johnson,29-258,F,11/4/16,MIA,TOR,0,19,4,8,0.5,3,5,0.6,1,3,0.333,2,2,1,1,2,3,2,0,1,1,4,11,7.8
Gerald Henderson,29-014,G,12/23/16,PHI,PHO,1,26,5,10,0.5,4,8,0.5,1,2,0.5,0,0,,0,1,1,3,0,0,0,0,11,8.4
J.J. Redick,32-182,G,12/23/16,LAC,DAL,1,30,4,10,0.4,2,3,0.667,2,7,0.286,1,2,0.5,0,3,3,3,0,0,5,3,11,2
Ben McLemore,23-266,G,11/3/16,SAC,ORL,0,28,5,7,0.714,4,5,0.8,1,2,0.5,0,0,,1,3,4,1,1,0,2,5,11,7.4
Julius Randle,22-077,F,2/14/17,LAL,SAC,1,21,5,11,0.455,4,10,0.4,1,1,1,0,0,,3,4,7,2,0,0,1,1,11,8.6
Iman Shumpert,26-183,G,12/26/16,CLE,DET,0,33,4,10,0.4,3,7,0.429,1,3,0.333,2,2,1,0,1,1,2,3,0,4,0,11,6.3
Willie Cauley-Stein,23-225,F-C,3/31/17,SAC,NOP,1,34,5,8,0.625,5,8,0.625,0,0,,1,2,0.5,3,11,14,1,1,0,3,2,11,10.3
Darrun Hilliard,23-233,G,12/2/16,DET,ATL,0,18,4,8,0.5,1,3,0.333,3,5,0.6,0,0,,0,1,1,2,0,0,1,3,11,6.5
Evan Turner,28-002,G,10/29/16,POR,DEN,0,25,5,9,0.556,4,7,0.571,1,2,0.5,0,0,,0,3,3,2,0,0,2,1,11,6.6
Patrick Patterson,27-364,F,3/13/17,TOR,DAL,0,21,4,6,0.667,1,1,1,3,5,0.6,0,0,,1,6,7,1,0,0,0,2,11,10.8
Taj Gibson,31-159,F,11/30/16,CHI,LAL,1,31,4,9,0.444,4,9,0.444,0,0,,3,6,0.5,1,9,10,4,2,2,1,6,11,11.3
Dirk Nowitzki,38-255,F,3/1/17,DAL,ATL,1,28,5,12,0.417,5,6,0.833,0,6,0,1,1,1,2,8,10,1,0,0,4,4,11,3.5
Trey Lyles,21-012,F,11/17/16,UTA,CHI,0,21,4,11,0.364,4,8,0.5,0,3,0,3,3,1,3,3,6,0,1,0,1,2,11,7.1
Mario Hezonja,22-013,F-G,3/10/17,ORL,CHO,0,22,3,10,0.3,2,4,0.5,1,6,0.167,4,4,1,3,1,4,0,0,0,1,4,11,5
Ersan Ilyasova,29-188,F,11/19/16,PHI,PHO,1,24,5,9,0.556,4,5,0.8,1,4,0.25,0,0,,0,2,2,1,1,0,0,2,11,8.2
Dirk Nowitzki,38-198,F,1/3/17,DAL,WAS,1,24,4,9,0.444,3,5,0.6,1,4,0.25,2,2,1,0,9,9,0,0,0,0,2,11,8.2
Arron Afflalo,31-095,G,1/18/17,SAC,IND,1,31,3,6,0.5,1,2,0.5,2,4,0.5,3,3,1,0,1,1,1,0,1,1,3,11,7.5
Steven Adams,23-234,C,3/11/17,OKC,UTA,1,32,5,8,0.625,5,8,0.625,0,0,,1,2,0.5,4,5,9,0,2,1,1,2,11,12.2
Marcus Morris,27-163,F,2/12/17,DET,TOR,1,32,3,9,0.333,3,5,0.6,0,4,0,5,6,0.833,0,3,3,1,2,1,1,4,11,7.2
Andrew Harrison,22-049,G,12/16/16,MEM,SAC,0,19,2,4,0.5,1,2,0.5,1,2,0.5,6,8,0.75,0,0,0,1,0,1,2,6,11,5.2
Cody Zeller,24-179,F-C,4/2/17,CHO,OKC,1,28,3,7,0.429,3,7,0.429,0,0,,5,7,0.714,1,3,4,2,1,1,1,0,11,10.2
Hassan Whiteside,27-200,C,12/30/16,MIA,BOS,1,32,5,9,0.556,5,9,0.556,0,0,,1,2,0.5,0,8,8,1,1,1,1,0,11,10.1
Buddy Hield,23-023,G,1/9/17,NOP,NYK,1,27,4,7,0.571,1,2,0.5,3,5,0.6,0,0,,0,3,3,3,3,0,0,0,11,13.7
Wesley Matthews,30-095,G,1/17/17,DAL,CHI,1,40,4,10,0.4,1,5,0.2,3,5,0.6,0,0,,0,4,4,2,0,0,1,3,11,6
Delon Wright,24-306,G,2/26/17,TOR,POR,0,15,5,9,0.556,4,6,0.667,1,3,0.333,0,0,,0,2,2,1,0,0,0,4,11,6.4
Allen Crabbe,24-346,G-F,3/21/17,POR,MIL,0,31,4,11,0.364,3,6,0.5,1,5,0.2,2,2,1,0,5,5,1,1,1,1,0,11,7.8
Enes Kanter,24-315,C,3/31/17,OKC,SAS,0,29,5,14,0.357,5,14,0.357,0,0,,1,2,0.5,2,3,5,1,0,1,1,2,11,4.7
Marvin Williams,30-278,F,3/24/17,CHO,CLE,1,38,3,11,0.273,3,8,0.375,0,3,0,5,5,1,2,9,11,2,1,1,0,1,11,11.3
Elfrid Payton,22-342,G,1/29/17,ORL,TOR,1,36,4,13,0.308,4,10,0.4,0,3,0,3,4,0.75,0,4,4,10,1,1,2,5,11,9
Alex Len,23-281,C,3/24/17,PHO,BOS,1,26,4,5,0.8,4,5,0.8,0,0,,3,7,0.429,1,5,6,2,0,2,1,3,11,10.3
JaVale McGee,29-014,C,2/2/17,GSW,LAC,1,15,5,6,0.833,5,6,0.833,0,0,,1,2,0.5,4,4,8,0,1,1,1,4,11,11.5
Kristaps Porzingis,21-197,F-C,2/15/17,NYK,OKC,1,33,4,13,0.308,3,9,0.333,1,4,0.25,2,2,1,0,7,7,1,1,2,4,4,11,3.1
Justin Hamilton,26-233,C,11/20/16,BRK,POR,0,22,4,7,0.571,1,1,1,3,6,0.5,0,0,,0,3,3,1,0,0,0,1,11,8.9
Kelly Oubre,21-059,F,2/6/17,WAS,CLE,0,28,4,10,0.4,3,7,0.429,1,3,0.333,2,2,1,3,4,7,0,4,0,0,6,11,10.5
Trevor Ariza,31-170,F,12/17/16,HOU,MIN,1,38,4,16,0.25,1,5,0.2,3,11,0.273,0,0,,1,4,5,0,3,0,2,1,11,3.9
Troy Daniels,25-204,G,2/4/17,MEM,MIN,0,15,4,8,0.5,2,2,1,2,6,0.333,1,2,0.5,0,0,0,1,0,0,1,1,11,5.9
Serge Ibaka,27-201,F-C,4/7/17,TOR,MIA,1,30,4,9,0.444,1,4,0.25,3,5,0.6,0,0,,2,7,9,0,0,1,1,6,11,7.1
Gorgui Dieng,26-315,C,11/28/16,MIN,UTA,1,32,3,8,0.375,3,8,0.375,0,0,,5,5,1,4,2,6,4,1,1,1,1,11,13.1
P.J. Tucker,31-270,F,1/30/17,PHO,MEM,0,25,5,7,0.714,4,4,1,1,3,0.333,0,0,,0,2,2,0,1,0,0,3,11,8.5
Frank Kaminsky,23-289,F-C,1/18/17,CHO,POR,0,24,4,10,0.4,1,4,0.25,3,6,0.5,0,0,,0,3,3,2,2,0,1,3,11,7.7
Otto Porter,23-275,F,3/5/17,WAS,ORL,1,31,4,9,0.444,3,5,0.6,1,4,0.25,2,2,1,1,3,4,1,1,1,0,2,11,9.5
Rudy Gobert,24-212,C,1/24/17,UTA,DEN,1,25,4,8,0.5,4,8,0.5,0,0,,3,5,0.6,3,6,9,1,0,1,4,4,11,5.9
Tyler Ennis,22-221,G,4/2/17,LAL,MEM,0,22,4,9,0.444,3,8,0.375,1,1,1,2,2,1,0,2,2,1,1,0,0,1,11,8.2
DeAndre Jordan,28-258,C,4/5/17,LAC,DAL,1,33,4,5,0.8,4,5,0.8,0,0,,3,8,0.375,3,17,20,1,2,0,2,1,11,14.6
Marc Gasol,31-332,C,12/26/16,MEM,ORL,1,28,4,9,0.444,4,8,0.5,0,1,0,3,4,0.75,0,4,4,3,2,0,1,2,11,9.4
Andrew Nicholson,27-099,F,3/17/17,BRK,BOS,0,17,4,9,0.444,3,7,0.429,1,2,0.5,2,2,1,1,1,2,2,2,0,0,1,11,10.3
Kevin Seraphin,27-122,F,4/8/17,IND,ORL,0,18,4,7,0.571,4,7,0.571,0,0,,3,5,0.6,0,4,4,1,0,0,0,3,11,7.6
Khris Middleton,25-213,F-G,3/13/17,MIL,MEM,1,35,2,8,0.25,0,2,0,2,6,0.333,5,6,0.833,1,2,3,3,0,1,1,2,11,8.1
James Ennis,26-179,F,12/27/16,MEM,BOS,1,22,4,7,0.571,1,3,0.333,3,4,0.75,0,0,,0,1,1,1,1,0,1,3,11,7.5
Julius Randle,22-133,F,4/11/17,LAL,NOP,1,16,4,7,0.571,4,7,0.571,0,0,,3,4,0.75,0,5,5,2,0,0,0,4,11,8.6
Andrew Harrison,22-043,G,12/10/16,MEM,GSW,1,35,2,9,0.222,2,5,0.4,0,4,0,7,7,1,0,2,2,5,3,0,2,3,11,9.4
Rodney McGruder,25-122,G,11/28/16,MIA,BOS,1,38,4,7,0.571,3,4,0.75,1,3,0.333,2,2,1,2,3,5,0,1,0,6,4,11,3.4
Dirk Nowitzki,38-294,F,4/9/17,DAL,PHO,1,20,4,12,0.333,3,10,0.3,1,2,0.5,2,2,1,0,3,3,3,0,0,1,2,11,5.4
Malcolm Brogdon,24-048,G,1/28/17,MIL,BOS,0,32,4,12,0.333,4,9,0.444,0,3,0,3,3,1,1,1,2,5,0,0,1,2,11,6.9
Joe Johnson,35-153,G-F,11/29/16,UTA,HOU,0,26,4,7,0.571,1,2,0.5,3,5,0.6,0,0,,0,3,3,3,0,0,1,1,11,9.3
Davis Bertans,24-059,F,1/10/17,SAS,MIL,0,19,4,7,0.571,1,1,1,3,6,0.5,0,0,,0,0,0,2,0,1,2,2,11,7
Maurice Harkless,23-196,F-G,11/23/16,POR,CLE,1,34,4,10,0.4,3,5,0.6,1,5,0.2,2,2,1,3,4,7,2,3,1,0,5,11,12
Courtney Lee,31-093,G,1/4/17,NYK,MIL,1,38,4,9,0.444,1,4,0.25,3,5,0.6,0,0,,1,1,2,3,1,1,0,1,11,10.7
Seth Curry,26-129,G,12/30/16,DAL,GSW,0,26,4,8,0.5,3,5,0.6,1,3,0.333,2,2,1,1,0,1,5,2,0,0,1,11,12.8
Tobias Harris,24-142,F,12/4/16,DET,ORL,1,35,5,12,0.417,4,9,0.444,1,3,0.333,0,1,0,2,2,4,1,0,0,0,0,11,6.9
Khris Middleton,25-218,F-G,3/18/17,MIL,GSW,1,29,4,8,0.5,2,6,0.333,2,2,1,1,1,1,0,2,2,5,0,0,3,2,11,7.3
Marcin Gortat,33-050,C-F,4/8/17,WAS,MIA,1,29,4,7,0.571,4,7,0.571,0,0,,3,4,0.75,4,7,11,2,0,1,1,1,11,12.9
Michael Kidd-Gilchrist,23-070,F,12/5/16,CHO,DAL,1,28,5,11,0.455,5,11,0.455,0,0,,1,1,1,4,8,12,1,0,1,0,3,11,10.7
Patrick McCaw,21-128,G,3/2/17,GSW,CHI,1,29,4,5,0.8,3,4,0.75,1,1,1,2,2,1,0,4,4,2,2,1,0,1,11,14
Matthew Dellavedova,26-048,G,10/26/16,MIL,CHO,1,29,5,10,0.5,4,7,0.571,1,3,0.333,0,0,,0,3,3,3,0,0,2,3,11,5.8
Luke Babbitt,27-217,F,1/23/17,MIA,GSW,1,26,3,6,0.5,0,2,0,3,4,0.75,2,2,1,1,5,6,1,1,0,0,3,11,10.7
Davis Bertans,24-141,F,4/2/17,SAS,UTA,1,34,4,8,0.5,1,2,0.5,3,6,0.5,0,0,,0,4,4,1,1,0,0,2,11,9.1
Dante Exum,21-156,G,12/16/16,UTA,DAL,1,19,4,6,0.667,3,3,1,1,3,0.333,2,2,1,0,1,1,1,0,0,0,4,11,7.8
Greg Monroe,26-148,C-F,10/30/16,MIL,DET,0,18,4,9,0.444,4,9,0.444,0,0,,3,3,1,1,4,5,0,2,0,1,2,11,8.4
Michael Beasley,28-006,F,1/15/17,MIL,ATL,0,18,3,7,0.429,3,6,0.5,0,1,0,5,6,0.833,1,2,3,1,2,0,1,2,11,9.1
Derrick Williams,25-171,F,11/12/16,MIA,UTA,0,20,5,8,0.625,4,6,0.667,1,2,0.5,0,2,0,1,3,4,1,0,1,0,0,11,9.6
Norman Powell,23-180,G,11/21/16,TOR,LAC,1,26,4,9,0.444,2,4,0.5,2,5,0.4,1,1,1,0,0,0,1,1,0,3,1,11,4.6
Ricky Rubio,26-053,G,12/13/16,MIN,CHI,1,35,3,6,0.5,2,5,0.4,1,1,1,4,4,1,2,3,5,10,1,0,2,0,11,16.3
Al Horford,30-243,C-F,2/1/17,BOS,TOR,1,32,4,13,0.308,3,8,0.375,1,5,0.2,2,2,1,1,2,3,6,1,0,1,3,11,7.8
Gerald Green,31-050,G-F,3/17/17,BOS,BRK,0,17,4,8,0.5,3,5,0.6,1,3,0.333,2,2,1,0,3,3,0,0,0,1,2,11,6.1
Jusuf Nurkic,22-106,C,12/7/16,DEN,BRK,1,17,4,6,0.667,4,6,0.667,0,0,,3,4,0.75,3,0,3,1,0,0,2,1,11,8.4
Terrence Jones,24-321,F,11/25/16,NOP,POR,0,30,4,10,0.4,2,6,0.333,2,4,0.5,1,2,0.5,0,3,3,2,0,0,1,0,11,6.5
Tyler Ennis,22-216,G,3/28/17,LAL,WAS,0,27,4,9,0.444,2,5,0.4,2,4,0.5,1,2,0.5,0,0,0,1,1,0,4,2,11,2.8
Otto Porter,23-244,F,2/2/17,WAS,LAL,1,38,4,9,0.444,1,3,0.333,3,6,0.5,0,0,,0,6,6,3,2,0,0,1,11,11.8
Ed Davis,27-253,F,2/13/17,POR,ATL,0,27,5,8,0.625,5,8,0.625,0,0,,1,6,0.167,6,7,13,3,0,1,1,6,11,11.1
Terry Rozier,22-240,G,11/12/16,BOS,IND,0,22,4,7,0.571,2,3,0.667,2,4,0.5,1,2,0.5,0,6,6,1,1,1,0,0,11,11.5
Al Horford,30-145,C-F,10/26/16,BOS,BRK,1,27,5,8,0.625,4,4,1,1,4,0.25,0,0,,1,4,5,6,0,4,2,2,11,13.5
Luke Babbitt,27-140,F,11/7/16,MIA,OKC,1,23,4,8,0.5,3,4,0.75,1,4,0.25,2,2,1,2,2,4,0,1,0,1,0,11,9
Thaddeus Young,28-143,F,11/11/16,IND,PHI,1,34,4,6,0.667,3,4,0.75,1,2,0.5,2,2,1,1,9,10,1,1,0,3,0,11,10.5
Kentavious Caldwell-Pope,23-300,G,12/14/16,DET,DAL,1,36,4,9,0.444,3,5,0.6,1,4,0.25,2,2,1,0,2,2,0,0,0,1,1,11,5.5
Otto Porter,23-221,F,1/10/17,WAS,CHI,1,34,5,10,0.5,4,6,0.667,1,4,0.25,0,0,,0,2,2,2,2,1,0,1,11,10.3
Buddy Hield,22-365,G,12/16/16,NOP,HOU,1,26,4,10,0.4,1,6,0.167,3,4,0.75,0,0,,0,5,5,1,0,0,2,4,11,4.2
Dante Cunningham,29-248,F,12/26/16,NOP,DAL,1,37,4,7,0.571,3,4,0.75,1,3,0.333,2,2,1,0,6,6,0,1,0,0,3,11,9.3
Mindaugas Kuzminskas,27-175,F,4/12/17,NYK,PHI,0,18,4,7,0.571,3,5,0.6,1,2,0.5,2,2,1,3,1,4,0,0,0,2,1,11,7.7
Richard Jefferson,36-209,F,1/16/17,CLE,GSW,0,20,3,8,0.375,1,3,0.333,2,5,0.4,3,5,0.6,0,2,2,1,1,0,1,3,11,5.9
Rudy Gobert,24-198,C,1/10/17,UTA,CLE,1,36,5,7,0.714,5,7,0.714,0,0,,1,1,1,4,10,14,1,3,1,5,3,11,12.1
Kyle Korver,35-305,G-F,1/16/17,CLE,GSW,0,27,4,10,0.4,1,2,0.5,3,8,0.375,0,0,,0,2,2,0,0,0,0,2,11,5.4
Dennis Schroder,23-048,G,11/2/16,ATL,LAL,1,29,4,11,0.364,3,8,0.375,1,3,0.333,2,2,1,0,2,2,6,1,0,2,2,11,7.9
Larry Nance Jr.,24-040,F,2/10/17,LAL,MIL,0,28,1,3,0.333,1,3,0.333,0,0,,9,10,0.9,2,3,5,3,1,0,0,2,11,13.5
Skal Labissiere,20-360,F,3/13/17,SAC,ORL,1,20,5,9,0.556,5,9,0.556,0,0,,1,3,0.333,1,6,7,0,0,4,0,2,11,10.4
Channing Frye,33-170,C-F,11/3/16,CLE,BOS,0,15,4,7,0.571,1,4,0.25,3,3,1,0,0,,0,1,1,0,1,1,1,2,11,7.9
Taj Gibson,31-148,F,11/19/16,CHI,LAC,1,32,5,8,0.625,5,8,0.625,0,0,,1,2,0.5,0,4,4,2,0,1,2,2,11,7.5
Will Barton,26-049,G,2/24/17,DEN,BRK,0,30,3,9,0.333,3,8,0.375,0,1,0,5,7,0.714,0,5,5,6,0,0,3,3,11,6.6
Jonas Valanciunas,24-317,C,3/19/17,TOR,IND,1,24,4,8,0.5,4,8,0.5,0,0,,3,4,0.75,6,7,13,0,0,1,0,3,11,12.4
Tim Hardaway,24-261,G,12/2/16,ATL,DET,0,27,5,14,0.357,5,8,0.625,0,6,0,1,2,0.5,0,2,2,2,1,0,0,1,11,5.4
Nikola Mirotic,25-314,F,12/21/16,CHI,WAS,0,22,4,10,0.4,1,4,0.25,3,6,0.5,0,0,,2,4,6,0,0,1,0,2,11,8.1
Thaddeus Young,28-222,F,1/29/17,IND,HOU,1,30,5,9,0.556,5,8,0.625,0,1,0,1,2,0.5,2,3,5,2,2,0,2,3,11,8.8
Ricky Rubio,26-038,G,11/28/16,MIN,UTA,1,25,4,5,0.8,3,3,1,1,2,0.5,2,2,1,0,2,2,3,2,0,1,4,11,11.2
Marcus Smart,23-023,G,3/29/17,BOS,MIL,0,30,4,15,0.267,3,8,0.375,1,7,0.143,2,4,0.5,5,6,11,5,1,1,4,5,11,5.8
Tony Parker,34-212,G,12/15/16,SAS,PHO,1,26,4,8,0.5,3,5,0.6,1,3,0.333,2,2,1,0,1,1,1,1,0,1,1,11,7.6
Luis Scola,36-230,F,12/16/16,BRK,ORL,0,12,4,7,0.571,1,4,0.25,3,3,1,0,0,,0,0,0,2,0,0,2,3,11,5.9
Joe Ingles,29-069,F-G,12/10/16,UTA,SAC,1,38,4,5,0.8,1,1,1,3,4,0.75,0,0,,0,6,6,4,1,0,3,2,11,10.9
Patrick Beverley,28-128,G,11/17/16,HOU,POR,1,25,5,8,0.625,4,6,0.667,1,2,0.5,0,0,,1,1,2,3,0,3,0,3,11,11.4
Paul Millsap,31-289,F,11/25/16,ATL,UTA,1,28,4,11,0.364,3,9,0.333,1,2,0.5,2,2,1,1,4,5,0,1,2,1,3,11,7
Tyson Chandler,34-122,C,2/1/17,PHO,LAC,1,27,5,5,1,5,5,1,0,0,,1,2,0.5,1,3,4,0,0,0,4,5,11,4.7
Kyle Anderson,23-077,F-G,12/6/16,SAS,MIN,0,22,2,4,0.5,1,2,0.5,1,2,0.5,6,6,1,0,6,6,4,0,1,0,2,11,13.5
Brandon Jennings,27-117,G,1/18/17,NYK,BOS,0,27,3,7,0.429,1,2,0.5,2,5,0.4,3,4,0.75,1,3,4,5,0,1,1,1,11,11.3
T.J. McConnell,24-323,G,2/11/17,PHI,MIA,1,32,3,7,0.429,3,7,0.429,0,0,,5,6,0.833,1,3,4,10,2,0,1,0,11,16.5
Kyle O'Quinn,26-217,F-C,10/29/16,NYK,MEM,0,19,3,5,0.6,3,5,0.6,0,0,,5,7,0.714,2,4,6,2,0,0,1,4,11,9.3
T.J. Warren,23-163,F,2/15/17,PHO,LAL,1,21,4,5,0.8,4,5,0.8,0,0,,3,3,1,1,2,3,3,1,2,0,1,11,14.5
Mirza Teletovic,31-110,F,1/6/17,MIL,NYK,0,17,3,5,0.6,0,0,,3,5,0.6,2,2,1,0,1,1,0,1,0,0,0,11,10
James Ennis,26-178,F,12/26/16,MEM,ORL,0,22,3,4,0.75,1,2,0.5,2,2,1,3,4,0.75,1,1,2,1,1,0,0,2,11,10.9
Michael Beasley,28-049,F,2/27/17,MIL,CLE,1,9,4,7,0.571,4,7,0.571,0,0,,3,3,1,0,2,2,1,0,0,0,2,11,8.2
Jeff Green,30-185,F,3/1/17,ORL,NYK,0,24,4,10,0.4,3,5,0.6,1,5,0.2,2,2,1,0,2,2,0,1,2,0,4,11,7
Gorgui Dieng,26-312,C,11/25/16,MIN,PHO,1,37,4,10,0.4,3,8,0.375,1,2,0.5,2,2,1,4,3,7,2,3,4,2,5,11,12.5
Thaddeus Young,28-127,F,10/26/16,IND,DAL,1,34,5,10,0.5,4,9,0.444,1,1,1,0,0,,0,5,5,4,1,0,2,6,11,6.9
Mason Plumlee,26-253,C-F,11/13/16,POR,DEN,1,24,5,7,0.714,5,7,0.714,0,0,,1,3,0.333,4,5,9,3,0,1,1,0,11,13.4
Evan Turner,28-069,G,1/4/17,POR,GSW,0,30,5,10,0.5,4,8,0.5,1,2,0.5,0,0,,0,3,3,2,0,0,2,4,11,4.7
Klay Thompson,26-260,G,10/25/16,GSW,SAS,1,33,5,13,0.385,4,7,0.571,1,6,0.167,0,0,,0,1,1,2,0,0,1,4,11,3
Stephen Curry,28-336,G,2/13/17,GSW,DEN,1,27,4,18,0.222,3,7,0.429,1,11,0.091,2,2,1,1,1,2,5,1,0,1,1,11,4.1
Marco Belinelli,30-358,G-F,3/18/17,CHO,WAS,0,28,3,9,0.333,2,8,0.25,1,1,1,4,5,0.8,0,1,1,2,0,0,1,2,11,5.4
Gerald Green,31-014,G-F,2/9/17,BOS,POR,0,18,5,6,0.833,4,5,0.8,1,1,1,0,0,,1,0,1,1,0,0,0,2,11,9.4
Jodie Meeks,29-226,G,4/4/17,ORL,CLE,0,21,2,7,0.286,1,3,0.333,1,4,0.25,6,6,1,1,5,6,3,2,0,2,1,11,10.8
Delon Wright,24-295,G,2/15/17,TOR,CHO,0,28,3,5,0.6,3,4,0.75,0,1,0,5,6,0.833,1,0,1,2,2,1,0,1,11,12.7
Lance Thomas,28-311,F,3/1/17,NYK,ORL,1,31,4,5,0.8,4,5,0.8,0,0,,3,4,0.75,1,4,5,1,2,0,0,1,11,12.9
E'Twaun Moore,28-001,G,3/1/17,NOP,DET,0,26,4,10,0.4,2,7,0.286,2,3,0.667,1,1,1,0,1,1,3,0,0,0,3,11,6.8
Jabari Parker,21-247,F,11/17/16,MIL,MIA,1,33,5,20,0.25,4,14,0.286,1,6,0.167,0,0,,2,6,8,2,1,1,2,2,11,2.5
Taurean Waller-Prince,23-021,F,4/12/17,ATL,IND,1,25,4,8,0.5,3,5,0.6,1,3,0.333,2,3,0.667,0,2,2,2,1,0,1,4,11,7
Isaiah Whitehead,21-336,G,2/7/17,BRK,CHO,0,26,4,11,0.364,3,9,0.333,1,2,0.5,2,2,1,0,1,1,7,1,0,1,2,11,9.3
Patrick Patterson,27-256,F,11/25/16,TOR,MIL,0,25,3,7,0.429,0,1,0,3,6,0.5,2,2,1,1,4,5,3,0,0,0,4,11,9.7
Wade Baldwin,20-252,G,12/6/16,MEM,PHI,0,24,2,6,0.333,2,5,0.4,0,1,0,7,8,0.875,0,1,1,2,0,0,3,5,11,3.9
Tim Frazier,26-099,G,2/8/17,NOP,UTA,0,24,1,4,0.25,1,3,0.333,0,1,0,9,10,0.9,0,3,3,4,0,0,1,4,11,9.3
Kyle Korver,35-237,G-F,11/9/16,ATL,CHI,1,26,4,5,0.8,2,3,0.667,2,2,1,1,1,1,0,2,2,2,0,0,3,5,11,6.1
Richard Jefferson,36-251,F,2/27/17,CLE,MIL,1,30,3,6,0.5,2,3,0.667,1,3,0.333,4,4,1,1,5,6,2,1,0,2,2,11,9.8
Alex Len,23-222,C,1/24/17,PHO,MIN,0,24,4,5,0.8,4,5,0.8,0,0,,3,3,1,5,5,10,0,0,0,3,1,11,10.7
Rondae Hollis-Jefferson,22-089,F,4/2/17,BRK,ATL,1,27,4,8,0.5,2,6,0.333,2,2,1,1,2,0.5,1,4,5,2,3,0,3,0,11,9.9
Pau Gasol,36-153,F-C,12/6/16,SAS,MIN,1,26,4,10,0.4,2,7,0.286,2,3,0.667,1,2,0.5,1,6,7,1,0,0,1,2,11,6.6
Dorian Finney-Smith,23-213,F,12/3/16,DAL,CHI,1,35,3,5,0.6,1,1,1,2,4,0.5,3,4,0.75,1,1,2,2,1,0,0,1,11,11.3
Thabo Sefolosha,32-322,G-F,3/20/17,ATL,CHO,1,28,4,7,0.571,1,2,0.5,3,5,0.6,0,2,0,2,6,8,4,0,1,0,3,11,12.4
Gary Harris,22-110,G,1/2/17,DEN,GSW,1,31,5,12,0.417,5,9,0.556,0,3,0,1,2,0.5,3,1,4,3,2,0,0,3,11,9.5
Rondae Hollis-Jefferson,21-365,F,1/2/17,BRK,UTA,0,14,3,5,0.6,3,5,0.6,0,0,,5,7,0.714,0,1,1,1,0,0,1,0,11,7.9
Nik Stauskas,23-127,G,2/11/17,PHI,MIA,0,30,4,8,0.5,2,4,0.5,2,4,0.5,1,2,0.5,0,1,1,3,1,2,0,1,11,11
Tyler Ulis,21-086,G,4/1/17,PHO,POR,1,38,4,11,0.364,4,10,0.4,0,1,0,3,4,0.75,0,3,3,5,0,0,2,4,11,5.3
Donatas Motiejunas,26-109,F-C,1/7/17,NOP,BOS,0,20,4,5,0.8,3,4,0.75,1,1,1,2,4,0.5,2,3,5,4,1,0,0,3,11,13.2
Jodie Meeks,29-223,G,4/1/17,ORL,BRK,0,18,4,7,0.571,3,3,1,1,4,0.25,2,2,1,0,0,0,0,0,1,1,1,11,7
Terry Rozier,22-246,G,11/18/16,BOS,GSW,0,26,3,5,0.6,1,2,0.5,2,3,0.667,3,4,0.75,1,6,7,5,0,0,1,1,11,12.9
Rudy Gobert,24-260,C,3/13/17,UTA,LAC,1,37,5,6,0.833,5,6,0.833,0,0,,1,1,1,3,7,10,3,0,1,1,4,11,13.2
Vince Carter,39-351,G-F,1/11/17,MEM,OKC,0,29,3,6,0.5,0,2,0,3,4,0.75,2,4,0.5,1,2,3,1,1,1,0,4,11,9.3
Georgios Papagiannis,19-271,C,3/31/17,SAC,NOP,0,25,4,5,0.8,4,5,0.8,0,0,,3,3,1,2,1,3,1,0,2,1,3,11,10.7
P.J. Tucker,31-284,F,2/13/17,PHO,NOP,0,33,5,11,0.455,4,7,0.571,1,4,0.25,0,0,,7,10,17,1,1,0,2,4,11,11.3
Seth Curry,26-126,G,12/27/16,DAL,HOU,0,22,4,10,0.4,1,4,0.25,3,6,0.5,0,0,,1,2,3,3,1,0,0,0,11,10
Kosta Koufos,27-329,C,1/18/17,SAC,IND,1,24,5,8,0.625,5,8,0.625,0,0,,1,2,0.5,1,3,4,0,1,0,2,0,11,7.6
Tony Snell,25-048,G-F,12/28/16,MIL,DET,1,28,4,4,1,1,1,1,3,3,1,0,0,,0,6,6,1,0,0,0,0,11,12.3
DeMarre Carroll,30-182,F,1/25/17,TOR,MEM,1,22,5,9,0.556,4,6,0.667,1,3,0.333,0,0,,1,5,6,2,2,0,0,2,11,11.5
Mindaugas Kuzminskas,27-165,F,4/2/17,NYK,BOS,0,16,4,7,0.571,1,2,0.5,3,5,0.6,0,0,,0,1,1,1,0,0,0,0,11,8.7
Al-Farouq Aminu,26-195,F,4/4/17,POR,UTA,1,31,3,7,0.429,2,3,0.667,1,4,0.25,4,4,1,1,3,4,1,2,1,2,2,11,9.5
Kevon Looney,20-272,F-C,11/4/16,GSW,LAL,0,13,5,5,1,5,5,1,0,0,,1,2,0.5,2,3,5,0,0,0,1,1,11,10
Clint Capela,22-201,F-C,12/5/16,HOU,BOS,1,22,5,7,0.714,5,7,0.714,0,0,,1,2,0.5,2,7,9,1,1,1,1,1,11,12.2
Dwight Howard,31-036,C,1/13/17,ATL,BOS,1,24,4,4,1,4,4,1,0,0,,3,3,1,2,6,8,0,1,1,3,2,11,10.9
Channing Frye,33-199,C-F,12/2/16,CLE,CHI,0,21,5,6,0.833,4,4,1,1,2,0.5,0,0,,0,2,2,0,1,0,0,2,11,9.6
Nikola Mirotic,25-318,F,12/25/16,CHI,SAS,0,32,4,10,0.4,1,4,0.25,3,6,0.5,0,0,,0,5,5,2,3,1,1,2,11,10.4
Michael Beasley,28-030,F,2/8/17,MIL,MIA,0,12,4,6,0.667,4,6,0.667,0,0,,3,7,0.429,0,2,2,0,0,0,2,0,11,5.4
Patrick Beverley,28-143,G,12/2/16,HOU,DEN,1,28,4,9,0.444,2,4,0.5,2,5,0.4,1,2,0.5,1,2,3,5,1,2,1,2,11,11.3
Denzel Valentine,23-122,G,3/18/17,CHI,UTA,0,28,4,12,0.333,1,5,0.2,3,7,0.429,0,0,,1,11,12,4,1,0,0,4,11,10.4
Brandon Ingram,19-222,F,4/12/17,LAL,GSW,1,29,5,16,0.313,5,16,0.313,0,0,,1,2,0.5,1,4,5,5,3,0,5,2,11,4
Ty Lawson,29-116,G,2/27/17,SAC,MIN,1,35,5,13,0.385,5,11,0.455,0,2,0,1,1,1,0,1,1,9,2,0,3,2,11,8.7
Andre Iguodala,32-335,G-F,12/28/16,GSW,TOR,0,30,5,5,1,5,5,1,0,0,,1,2,0.5,1,2,3,2,1,0,1,0,11,11.8
Brandan Wright,29-173,F-C,3/27/17,MEM,SAC,0,21,5,7,0.714,5,7,0.714,0,0,,1,2,0.5,1,1,2,0,2,0,1,2,11,8.9
Alex Len,23-276,C,3/19/17,PHO,DET,1,21,5,11,0.455,4,9,0.444,1,2,0.5,0,4,0,4,3,7,1,0,0,1,5,11,5.1
Trey Lyles,21-054,F,12/29/16,UTA,PHI,0,19,4,7,0.571,1,2,0.5,3,5,0.6,0,0,,1,1,2,1,2,1,1,0,11,11.1
Thabo Sefolosha,32-180,G-F,10/29/16,ATL,PHI,0,19,4,4,1,4,4,1,0,0,,3,4,0.75,0,4,4,1,1,0,0,1,11,11.9
Tristan Thompson,25-264,F-C,12/2/16,CLE,CHI,1,27,5,5,1,5,5,1,0,0,,1,4,0.25,2,4,6,1,0,0,2,2,11,8.8
Wesley Matthews,30-098,G,1/20/17,DAL,UTA,1,39,4,10,0.4,3,6,0.5,1,4,0.25,2,2,1,1,7,8,3,2,0,2,4,11,8.9
Jonas Valanciunas,24-220,C,12/12/16,TOR,MIL,1,23,4,9,0.444,4,9,0.444,0,0,,3,4,0.75,4,8,12,1,0,0,1,3,11,9.6
Terrence Jones,25-000,F,1/9/17,NOP,NYK,0,14,4,6,0.667,4,6,0.667,0,0,,3,4,0.75,1,2,3,0,1,2,0,0,11,11.7
Dirk Nowitzki,38-202,F,1/7/17,DAL,ATL,1,30,4,10,0.4,4,7,0.571,0,3,0,3,3,1,0,3,3,2,2,1,3,2,11,6.8
Allen Crabbe,24-265,G-F,12/30/16,POR,SAS,1,33,5,9,0.556,4,7,0.571,1,2,0.5,0,0,,0,1,1,1,2,0,1,1,11,8.3
Troy Daniels,25-169,G,12/31/16,MEM,SAC,0,12,4,8,0.5,1,3,0.333,3,5,0.6,0,0,,0,1,1,1,0,0,0,2,11,7.2
Greg Monroe,26-191,C-F,12/12/16,MIL,TOR,0,16,5,5,1,5,5,1,0,0,,1,1,1,1,1,2,0,1,0,1,2,11,9.7
Garrett Temple,30-247,G,1/10/17,SAC,DET,1,30,4,8,0.5,1,4,0.25,3,4,0.75,0,0,,0,1,1,0,1,0,0,4,11,6.7
Courtney Lee,31-083,G,12/25/16,NYK,BOS,1,34,4,9,0.444,2,3,0.667,2,6,0.333,1,2,0.5,1,2,3,0,0,1,0,3,11,6.7
Danilo Gallinari,28-230,F,3/26/17,DEN,NOP,1,24,2,6,0.333,0,2,0,2,4,0.5,5,5,1,0,5,5,0,0,0,0,1,11,8.7
Marco Belinelli,30-340,G-F,2/28/17,CHO,LAL,0,22,4,9,0.444,2,4,0.5,2,5,0.4,1,2,0.5,0,2,2,5,0,0,0,0,11,10
Isaiah Whitehead,21-257,G,11/20/16,BRK,POR,1,24,2,10,0.2,1,6,0.167,1,4,0.25,6,6,1,0,1,1,2,1,1,0,1,11,7.8
Randy Foye,33-119,G,1/21/17,BRK,CHO,0,24,4,12,0.333,1,5,0.2,3,7,0.429,0,0,,0,2,2,5,0,0,0,2,11,7.5
Myles Turner,20-316,F-C,2/3/17,IND,BRK,1,27,4,8,0.5,3,5,0.6,1,3,0.333,2,2,1,1,3,4,1,0,3,1,5,11,8.4
Serge Ibaka,27-122,F-C,1/18/17,ORL,NOP,1,25,5,10,0.5,4,6,0.667,1,4,0.25,0,0,,1,6,7,2,0,5,0,0,11,13.4
Kyle Korver,35-324,G-F,2/4/17,CLE,NYK,0,31,3,9,0.333,1,4,0.25,2,5,0.4,3,3,1,0,4,4,1,0,0,0,1,11,7.4
Thaddeus Young,28-157,F,11/25/16,IND,BRK,1,24,5,9,0.556,4,5,0.8,1,4,0.25,0,1,0,1,3,4,2,0,0,1,0,11,8.3
Montrezl Harrell,23-064,F-C,3/31/17,HOU,GSW,0,22,5,9,0.556,5,9,0.556,0,0,,1,3,0.333,2,2,4,1,0,2,0,3,11,8.8
Malcolm Brogdon,24-010,G,12/21/16,MIL,CLE,0,27,4,7,0.571,3,5,0.6,1,2,0.5,2,4,0.5,0,5,5,7,3,0,1,2,11,14.5
Sergio Rodriguez,30-169,G,11/28/16,PHI,TOR,1,28,4,7,0.571,2,4,0.5,2,3,0.667,1,1,1,1,2,3,7,2,0,4,2,11,11.1
Wilson Chandler,29-240,F,1/5/17,DEN,SAS,0,24,5,10,0.5,4,6,0.667,1,4,0.25,0,0,,1,6,7,2,0,1,1,2,11,8.8
Markieff Morris,27-058,F,10/30/16,WAS,MEM,1,36,5,8,0.625,4,6,0.667,1,2,0.5,0,0,,0,7,7,1,2,1,4,5,11,6.9
Doug McDermott,25-044,F,2/16/17,CHI,BOS,0,30,4,12,0.333,3,6,0.5,1,6,0.167,2,2,1,0,2,2,0,1,0,0,0,11,5.8
JaVale McGee,28-319,C,12/3/16,GSW,PHO,0,13,4,6,0.667,4,6,0.667,0,0,,3,6,0.5,2,0,2,0,0,0,1,3,11,6.4
Denzel Valentine,23-119,G,3/15/17,CHI,MEM,0,28,4,10,0.4,1,3,0.333,3,7,0.429,0,0,,0,7,7,3,1,0,0,1,11,10.4
Elfrid Payton,23-035,G,3/29/17,ORL,OKC,1,38,4,12,0.333,4,12,0.333,0,0,,3,8,0.375,2,3,5,8,0,1,3,4,11,6.2
Garrett Temple,30-260,G,1/23/17,SAC,DET,1,34,3,6,0.5,2,4,0.5,1,2,0.5,4,5,0.8,1,2,3,4,1,0,2,3,11,9.5
Tony Allen,34-320,G-F,11/26/16,MEM,MIA,1,34,4,9,0.444,4,8,0.5,0,1,0,3,4,0.75,0,8,8,2,1,1,0,3,11,10.2
Wayne Ellington,29-044,G,12/12/16,MIA,WAS,1,33,3,11,0.273,1,2,0.5,2,9,0.222,3,3,1,0,2,2,5,2,1,0,2,11,10.5
Jordan Crawford,28-170,G,4/11/17,NOP,LAL,0,21,5,13,0.385,4,8,0.5,1,5,0.2,0,0,,0,3,3,7,2,0,2,1,11,9.3
Evan Turner,28-066,G,1/1/17,POR,MIN,0,30,5,7,0.714,4,6,0.667,1,1,1,0,2,0,0,3,3,1,2,4,4,2,11,8.9
Wayne Selden,22-168,G-F,3/17/17,NOP,HOU,1,19,4,5,0.8,1,1,1,3,4,0.75,0,0,,0,1,1,0,1,0,2,1,11,8
Nene Hilario,34-172,F-C,3/4/17,HOU,MEM,0,16,4,5,0.8,4,5,0.8,0,0,,3,5,0.6,1,3,4,1,1,1,0,1,11,11.9
Kay Felder,21-269,G,12/23/16,CLE,BRK,0,16,4,7,0.571,4,5,0.8,0,2,0,3,4,0.75,0,1,1,3,1,1,1,4,11,8.8
Malcolm Brogdon,24-122,G,4/12/17,MIL,BOS,1,23,5,10,0.5,4,8,0.5,1,2,0.5,0,0,,2,3,5,3,1,1,0,0,11,12.1
Kelly Oubre,21-046,F,1/24/17,WAS,BOS,0,30,4,10,0.4,1,4,0.25,3,6,0.5,0,0,,0,3,3,0,1,1,1,5,11,5.2
Joe Ingles,29-187,F-G,4/7/17,UTA,MIN,1,34,4,6,0.667,2,3,0.667,2,3,0.667,1,2,0.5,1,4,5,8,2,0,3,0,11,14.5
Trey Lyles,21-064,F,1/8/17,UTA,MEM,0,12,3,4,0.75,0,1,0,3,3,1,2,3,0.667,1,1,2,1,1,0,0,2,11,10.9
Buddy Hield,23-091,G,3/18/17,SAC,OKC,1,32,4,12,0.333,2,4,0.5,2,8,0.25,1,1,1,0,1,1,0,1,0,2,1,11,3.1
Anthony Tolliver,31-248,F-C,2/4/17,SAC,GSW,0,36,4,5,0.8,1,2,0.5,3,3,1,0,0,,1,5,6,2,0,1,1,1,11,12
Maurice Harkless,23-208,F-G,12/5/16,POR,CHI,1,31,4,11,0.364,3,7,0.429,1,4,0.25,2,3,0.667,4,5,9,2,1,1,2,4,11,8.3
Terrence Ross,25-331,F-G,1/1/17,TOR,LAL,0,24,4,9,0.444,1,3,0.333,3,6,0.5,0,0,,0,5,5,0,0,0,1,2,11,6
Jrue Holiday,26-276,G,3/15/17,NOP,MIA,1,32,4,12,0.333,3,9,0.333,1,3,0.333,2,3,0.667,0,4,4,8,0,1,1,0,11,10.3
Brandon Ingram,19-196,F,3/17/17,LAL,MIL,1,35,4,11,0.364,3,7,0.429,1,4,0.25,2,4,0.5,0,1,1,4,2,1,1,3,11,7.7
Danny Green,29-189,G-F,12/28/16,SAS,PHO,1,30,4,8,0.5,1,2,0.5,3,6,0.5,0,0,,2,1,3,0,4,1,2,1,11,11
Tristan Thompson,25-257,F-C,11/25/16,CLE,DAL,1,29,4,5,0.8,4,5,0.8,0,0,,3,4,0.75,4,8,12,1,1,0,0,1,11,15.2
Aaron Brooks,32-069,G,3/24/17,IND,DEN,0,15,4,8,0.5,1,3,0.333,3,5,0.6,0,0,,0,0,0,1,0,0,2,2,11,4.9
Jeff Green,30-085,F,11/21/16,ORL,MIL,1,31,4,9,0.444,3,5,0.6,1,4,0.25,2,2,1,1,3,4,4,1,0,3,0,11,8.7
Corey Brewer,31-025,F-G,3/30/17,LAL,MIN,1,18,4,8,0.5,4,6,0.667,0,2,0,3,4,0.75,0,2,2,2,0,0,0,1,11,8.2
Ricky Rubio,26-035,G,11/25/16,MIN,PHO,1,25,4,7,0.571,3,5,0.6,1,2,0.5,2,2,1,0,1,1,4,5,0,5,4,11,9.2
Alex Len,23-237,C,2/8/17,PHO,MEM,0,28,5,8,0.625,4,7,0.571,1,1,1,0,0,,1,4,5,0,1,2,2,5,11,7.7
Ricky Rubio,26-164,G,4/3/17,MIN,POR,1,39,2,7,0.286,2,7,0.286,0,0,,7,9,0.778,0,7,7,16,0,1,5,4,11,13.5
Willy Hernangomez,22-274,C,2/25/17,NYK,PHI,1,23,4,6,0.667,4,6,0.667,0,0,,3,3,1,3,6,9,1,0,2,2,5,11,10.4
Juan Hernangomez,21-043,F,11/10/16,DEN,GSW,0,30,4,10,0.4,2,7,0.286,2,3,0.667,1,2,0.5,3,6,9,0,1,1,1,2,11,9
Kelly Olynyk,25-247,C-F,12/22/16,BOS,IND,0,20,4,8,0.5,2,3,0.667,2,5,0.4,1,1,1,0,5,5,2,1,0,2,3,11,7.7
Markieff Morris,27-187,F,3/8/17,WAS,DEN,1,26,3,3,1,2,2,1,1,1,1,4,4,1,1,5,6,2,0,0,2,4,11,10.1
Jonathan Gibson,29-015,G,11/23/16,DAL,LAC,0,26,3,10,0.3,2,5,0.4,1,5,0.2,4,4,1,0,0,0,2,0,0,2,1,11,4.2
Rodney McGruder,25-196,G,2/10/17,MIA,BRK,1,35,5,12,0.417,4,9,0.444,1,3,0.333,0,0,,1,5,6,3,4,0,1,1,11,11.5
Jamal Crawford,36-277,G,12/22/16,LAC,SAS,0,28,5,9,0.556,4,6,0.667,1,3,0.333,0,0,,0,1,1,0,2,1,4,4,11,4.1
Andre Roberson,25-013,G-F,12/17/16,OKC,PHO,1,35,4,7,0.571,3,5,0.6,1,2,0.5,2,4,0.5,0,1,1,0,3,0,0,3,11,9
Jonathon Simmons,27-141,G-F,2/2/17,SAS,PHI,0,19,3,8,0.375,3,7,0.429,0,1,0,5,6,0.833,0,3,3,0,0,1,0,2,11,7
Manu Ginobili,39-256,G,4/10/17,SAS,POR,0,16,4,7,0.571,1,3,0.333,3,4,0.75,0,0,,0,0,0,1,0,0,3,0,11,5.4
Wayne Ellington,29-098,G,2/4/17,MIA,PHI,0,16,4,7,0.571,2,3,0.667,2,4,0.5,1,1,1,1,1,2,0,1,0,3,5,11,4.7
Darren Collison,29-115,G,12/16/16,SAC,MEM,1,38,4,13,0.308,3,10,0.3,1,3,0.333,2,2,1,0,2,2,6,1,0,1,3,11,7.1
Stanley Johnson,20-162,F,11/7/16,DET,LAC,0,25,4,7,0.571,2,4,0.5,2,3,0.667,1,2,0.5,1,3,4,3,1,0,0,1,11,11.6
Will Barton,25-359,G,12/30/16,DEN,PHI,0,28,4,13,0.308,3,10,0.3,1,3,0.333,2,3,0.667,0,5,5,4,1,1,1,1,11,7.7
Brandon Ingram,19-125,F,1/5/17,LAL,POR,1,37,3,6,0.5,1,2,0.5,2,4,0.5,3,4,0.75,1,3,4,1,0,1,2,4,11,7
Kenneth Faried,27-074,F,2/1/17,DEN,MEM,1,28,5,6,0.833,5,6,0.833,0,0,,1,1,1,5,6,11,1,1,0,3,5,11,10.8
Dwight Howard,31-062,C,2/8/17,ATL,DEN,1,25,5,9,0.556,5,9,0.556,0,0,,1,2,0.5,5,8,13,1,0,0,1,3,11,10.7
Yogi Ferrell,23-333,G,4/7/17,DAL,SAS,1,30,4,13,0.308,3,8,0.375,1,5,0.2,2,2,1,0,2,2,5,0,0,0,5,11,5.6
Jon Leuer,27-195,F,11/25/16,DET,LAC,0,33,5,12,0.417,4,8,0.5,1,4,0.25,0,0,,2,9,11,4,1,0,1,3,11,10.3
Joe Harris,25-062,G,11/8/16,BRK,MIN,0,23,5,9,0.556,4,4,1,1,5,0.2,0,0,,0,1,1,1,0,0,0,2,11,6.9
Elfrid Payton,22-345,G,2/1/17,ORL,IND,1,32,5,10,0.5,5,9,0.556,0,1,0,1,1,1,0,6,6,3,0,0,1,3,11,7.7
Matthew Dellavedova,26-078,G,11/25/16,MIL,TOR,1,29,4,9,0.444,1,4,0.25,3,5,0.6,0,1,0,1,2,3,8,1,0,2,2,11,11
Devin Booker,20-010,G,11/9/16,PHO,DET,1,33,3,9,0.333,2,4,0.5,1,5,0.2,4,5,0.8,0,2,2,4,1,2,3,2,11,7.5
Jeff Teague,28-164,G,11/21/16,IND,GSW,1,26,5,14,0.357,5,11,0.455,0,3,0,1,1,1,1,3,4,3,2,2,2,1,11,7.9
Beno Udrih,34-278,G,4/9/17,DET,MEM,0,21,5,7,0.714,4,6,0.667,1,1,1,0,0,,0,2,2,5,0,0,2,1,11,9.8
Wilson Chandler,29-172,F,10/29/16,DEN,POR,0,30,5,11,0.455,4,8,0.5,1,3,0.333,0,2,0,1,6,7,1,0,0,3,1,11,4.3
Channing Frye,33-284,C-F,2/25/17,CLE,CHI,1,32,4,11,0.364,1,4,0.25,3,7,0.429,0,0,,0,5,5,2,1,0,0,3,11,7.6
Justise Winslow,20-231,F,11/12/16,MIA,UTA,1,34,5,13,0.385,5,12,0.417,0,1,0,1,1,1,0,6,6,3,1,0,1,5,11,5.8
Steven Adams,23-164,C,12/31/16,OKC,LAC,1,29,4,5,0.8,4,5,0.8,0,0,,3,5,0.6,2,3,5,2,1,0,0,1,11,12.6
Ivica Zubac,19-305,C,1/17/17,LAL,DEN,0,26,5,11,0.455,5,11,0.455,0,0,,1,2,0.5,5,8,13,1,1,3,1,2,11,12.8
Jrue Holiday,26-199,G,12/28/16,NOP,LAC,1,34,5,12,0.417,5,11,0.455,0,1,0,1,2,0.5,0,4,4,9,2,0,3,3,11,9.5
Zaza Pachulia,32-327,C,1/2/17,GSW,DEN,1,19,4,8,0.5,4,8,0.5,0,0,,3,3,1,4,5,9,1,0,0,2,4,11,8.4
Nene Hilario,34-165,F-C,2/25/17,HOU,MIN,0,19,5,6,0.833,5,6,0.833,0,0,,1,3,0.333,2,2,4,1,1,2,0,5,11,11.1
Frank Kaminsky,23-217,F-C,11/7/16,CHO,IND,0,30,5,14,0.357,5,8,0.625,0,6,0,1,2,0.5,0,2,2,2,0,1,4,1,11,1.1
Aaron Gordon,21-074,F,11/29/16,ORL,SAS,1,19,5,9,0.556,4,8,0.5,1,1,1,0,0,,2,1,3,0,0,0,0,4,11,6.8
Sam Dekker,22-209,F,12/1/16,HOU,GSW,0,26,4,9,0.444,2,6,0.333,2,3,0.667,1,2,0.5,4,4,8,2,2,0,2,4,11,9.7
Marc Gasol,31-294,C,11/18/16,MEM,DAL,1,24,5,12,0.417,4,11,0.364,1,1,1,0,0,,0,3,3,3,0,0,0,0,11,7.6
Avery Bradley,26-095,G,3/1/17,BOS,CLE,1,22,4,11,0.364,2,6,0.333,2,5,0.4,1,2,0.5,0,2,2,0,0,0,0,2,11,4.3
Tony Allen,35-052,G-F,3/4/17,MEM,HOU,1,27,5,11,0.455,4,10,0.4,1,1,1,0,0,,3,3,6,2,0,0,0,3,11,8.5
Delon Wright,24-339,G,3/31/17,TOR,IND,0,21,4,5,0.8,3,4,0.75,1,1,1,2,4,0.5,2,0,2,6,0,0,1,0,11,12.9
Leandro Barbosa,33-351,G,11/13/16,PHO,GSW,0,15,5,8,0.625,4,5,0.8,1,3,0.333,0,0,,0,1,1,4,0,0,1,2,11,8.7
Markieff Morris,27-182,F,3/3/17,WAS,TOR,1,37,4,13,0.308,3,10,0.3,1,3,0.333,2,2,1,2,6,8,5,1,1,2,3,11,8.7
James Johnson,30-031,F,3/23/17,MIA,TOR,0,31,3,14,0.214,2,8,0.25,1,6,0.167,3,6,0.5,0,4,4,3,2,4,3,1,10,4.9
Ben McLemore,24-012,G,2/23/17,SAC,DEN,1,23,3,6,0.5,1,3,0.333,2,3,0.667,2,2,1,0,2,2,1,0,0,1,4,10,5.7
Robert Covington,25-317,F,10/26/16,PHI,OKC,1,32,3,6,0.5,1,2,0.5,2,4,0.5,2,2,1,1,4,5,2,2,1,0,1,10,12.6
Bobby Portis,22-024,F,3/6/17,CHI,DET,1,26,4,9,0.444,4,8,0.5,0,1,0,2,2,1,2,4,6,0,0,0,1,1,10,6.5
Dwight Howard,31-009,C,12/17/16,ATL,CHO,1,35,4,6,0.667,4,6,0.667,0,0,,2,4,0.5,5,18,23,1,1,0,1,4,10,14.6
Ryan Anderson,28-199,F,11/21/16,HOU,DET,1,29,4,9,0.444,4,6,0.667,0,3,0,2,2,1,1,5,6,1,0,1,0,1,10,8.5
Isaiah Canaan,25-198,G,12/5/16,CHI,POR,0,29,4,11,0.364,4,8,0.5,0,3,0,2,2,1,3,1,4,2,2,0,2,3,10,6.5
Jerian Grant,24-078,G,12/26/16,CHI,IND,0,29,4,7,0.571,2,3,0.667,2,4,0.5,0,0,,1,2,3,0,2,0,1,3,10,7.8
Ramon Sessions,30-210,G,11/7/16,CHO,IND,0,21,3,7,0.429,3,5,0.6,0,2,0,4,5,0.8,0,1,1,7,1,0,2,1,10,9.7
D.J. Augustin,29-069,G,1/18/17,ORL,NOP,0,34,4,14,0.286,2,6,0.333,2,8,0.25,0,0,,0,2,2,2,0,0,4,1,10,-0.6
Tim Hardaway,24-322,G,2/1/17,ATL,MIA,1,26,2,9,0.222,0,4,0,2,5,0.4,4,4,1,0,4,4,2,0,0,0,0,10,7.1
Justise Winslow,20-216,F,10/28/16,MIA,CHO,1,32,4,14,0.286,3,8,0.375,1,6,0.167,1,2,0.5,0,6,6,5,0,0,4,2,10,1.9
Jeremy Lin,28-111,G,12/12/16,BRK,HOU,0,20,4,8,0.5,3,5,0.6,1,3,0.333,1,4,0.25,0,3,3,7,1,1,1,3,10,10.1
Robin Lopez,28-341,C,3/8/17,CHI,ORL,1,36,5,9,0.556,5,9,0.556,0,0,,0,0,,3,6,9,1,0,2,2,1,10,9.3
Jeff Green,30-136,F,1/11/17,ORL,LAC,1,25,3,13,0.231,3,10,0.3,0,3,0,4,5,0.8,2,3,5,0,0,0,1,3,10,1.8
Dante Exum,21-112,G,11/2/16,UTA,DAL,0,20,4,6,0.667,2,4,0.5,2,2,1,0,0,,1,1,2,0,0,0,1,3,10,6.2
Sean Kilpatrick,26-317,G,11/18/16,BRK,OKC,0,20,3,9,0.333,3,6,0.5,0,3,0,4,5,0.8,1,1,2,2,1,0,2,0,10,5.9
Tony Allen,34-344,G-F,12/20/16,MEM,BOS,1,38,5,8,0.625,5,7,0.714,0,1,0,0,0,,5,3,8,0,1,1,0,2,10,11.7
Anthony Davis,23-236,F-C,11/2/16,NOP,MEM,1,36,3,13,0.231,2,9,0.222,1,4,0.25,3,5,0.6,1,6,7,1,2,3,5,5,10,1.6
Tony Parker,34-312,G,3/25/17,SAS,NYK,1,22,5,12,0.417,5,11,0.455,0,1,0,0,0,,0,1,1,3,2,0,1,0,10,7
Spencer Hawes,28-341,C-F,4/4/17,MIL,OKC,0,19,3,6,0.5,2,3,0.667,1,3,0.333,3,4,0.75,1,4,5,1,0,0,0,3,10,8
Caris LeVert,22-140,G-F,1/12/17,BRK,NOP,0,25,4,8,0.5,3,3,1,1,5,0.2,1,2,0.5,0,3,3,1,2,0,0,2,10,8.4
Nikola Vucevic,26-023,C,11/16/16,ORL,NOP,1,27,5,12,0.417,5,12,0.417,0,0,,0,2,0,3,11,14,0,0,3,1,1,10,8.9
Tony Snell,25-127,G-F,3/17/17,MIL,LAL,1,32,3,8,0.375,2,4,0.5,1,4,0.25,3,3,1,0,5,5,1,1,0,2,2,10,6
Mason Plumlee,26-355,C-F,2/23/17,DEN,SAC,0,22,3,3,1,3,3,1,0,0,,4,7,0.571,1,2,3,1,2,0,3,3,10,7.7
Jordan Crawford,28-149,G,3/21/17,NOP,MEM,0,16,3,5,0.6,1,1,1,2,4,0.5,2,2,1,0,2,2,0,0,0,2,3,10,5.1
Andre Iguodala,33-033,G-F,3/2/17,GSW,CHI,0,26,4,6,0.667,4,4,1,0,2,0,2,3,0.667,0,7,7,2,0,0,1,3,10,8.3
Tony Allen,34-350,G-F,12/26/16,MEM,ORL,1,23,4,7,0.571,4,7,0.571,0,0,,2,2,1,0,2,2,0,1,0,0,3,10,7.1
Marcus Thornton,29-199,G,12/21/16,WAS,CHI,0,15,5,9,0.556,5,6,0.833,0,3,0,0,0,,1,1,2,1,1,0,0,0,10,8.4
Omer Asik,30-148,C,11/29/16,NOP,LAL,1,26,4,6,0.667,4,6,0.667,0,0,,2,2,1,4,7,11,1,1,1,1,0,10,13.7
Jamal Murray,19-259,G,11/8/16,DEN,MEM,0,17,4,7,0.571,2,3,0.667,2,4,0.5,0,0,,0,0,0,1,0,0,0,2,10,6.6
Trey Lyles,21-004,F,11/9/16,UTA,CHO,0,18,5,10,0.5,5,6,0.833,0,4,0,0,0,,1,5,6,1,0,0,0,1,10,7.5
Nicolas Batum,28-063,F-G,2/15/17,CHO,TOR,1,31,3,9,0.333,1,2,0.5,2,7,0.286,2,3,0.667,0,4,4,5,2,1,6,4,10,4.3
Troy Daniels,25-144,G,12/6/16,MEM,PHI,0,25,4,14,0.286,3,6,0.5,1,8,0.125,1,1,1,0,1,1,1,0,0,0,5,10,0.8
Al-Farouq Aminu,26-183,F,3/23/17,POR,NYK,0,27,4,11,0.364,3,7,0.429,1,4,0.25,1,4,0.25,2,7,9,0,2,0,1,2,10,6.4
Jahlil Okafor,20-346,C-F,11/25/16,PHI,CHI,1,27,5,11,0.455,5,11,0.455,0,0,,0,2,0,1,5,6,1,1,1,1,3,10,5.9
Rodney Hood,24-059,G-F,12/18/16,UTA,MEM,1,33,5,16,0.313,5,8,0.625,0,8,0,0,0,,1,3,4,1,0,0,0,1,10,2.7
Nikola Vucevic,26-086,C,1/18/17,ORL,NOP,1,26,4,9,0.444,4,9,0.444,0,0,,2,2,1,0,8,8,5,0,0,2,2,10,8.4
Noah Vonleh,21-145,F,1/16/17,POR,WAS,0,20,4,5,0.8,4,5,0.8,0,0,,2,5,0.4,2,6,8,1,0,0,0,1,10,10.4
Joe Johnson,35-266,G-F,3/22/17,UTA,NYK,0,23,4,10,0.4,3,7,0.429,1,3,0.333,1,2,0.5,1,3,4,2,0,1,0,3,10,6.7
Ian Clark,26-003,G,3/10/17,GSW,MIN,0,13,4,7,0.571,2,4,0.5,2,3,0.667,0,0,,1,3,4,2,1,0,0,0,10,10.7
David Nwaba,24-081,G,4/5/17,LAL,SAS,0,29,5,9,0.556,5,9,0.556,0,0,,0,2,0,1,4,5,3,1,0,1,0,10,8.9
Nerlens Noel,22-355,C-F,3/31/17,DAL,MEM,1,24,4,5,0.8,4,5,0.8,0,0,,2,4,0.5,1,5,6,0,1,2,3,2,10,8.1
Robin Lopez,28-363,C,3/30/17,CHI,CLE,1,36,5,12,0.417,5,12,0.417,0,0,,0,0,,3,8,11,0,2,1,2,4,10,7.2
Al Jefferson,32-012,C-F,1/16/17,IND,NOP,0,10,5,7,0.714,5,7,0.714,0,0,,0,0,,1,0,1,0,2,0,2,2,10,7
Manu Ginobili,39-106,G,11/11/16,SAS,DET,0,16,4,4,1,2,2,1,2,2,1,0,1,0,0,1,1,1,1,0,2,0,10,8.4
Jameer Nelson,34-287,G,11/22/16,DEN,CHI,0,21,4,9,0.444,2,5,0.4,2,4,0.5,0,0,,0,4,4,7,0,1,3,1,10,8.7
Montrezl Harrell,23-048,F-C,3/15/17,HOU,LAL,0,13,4,5,0.8,4,5,0.8,0,0,,2,4,0.5,0,0,0,0,0,1,0,2,10,7.2
Markieff Morris,27-189,F,3/10/17,WAS,SAC,1,26,4,9,0.444,4,8,0.5,0,1,0,2,2,1,2,4,6,2,0,0,0,4,10,7.7
Trevor Ariza,31-128,F,11/5/16,HOU,ATL,1,31,4,10,0.4,2,3,0.667,2,7,0.286,0,0,,0,3,3,3,2,1,1,2,10,8.5
Roy Hibbert,29-348,C,11/23/16,CHO,SAS,1,17,4,8,0.5,4,8,0.5,0,0,,2,2,1,1,1,2,2,0,0,1,3,10,6.2
Jon Leuer,27-252,F,1/21/17,DET,WAS,0,25,4,6,0.667,3,5,0.6,1,1,1,1,1,1,2,3,5,2,2,2,2,2,10,11.7
Dwyane Wade,34-353,G,1/4/17,CHI,CLE,1,27,3,9,0.333,0,5,0,3,4,0.75,1,2,0.5,1,3,4,4,2,0,4,1,10,6.5
Reggie Jackson,26-235,G,12/7/16,DET,CHO,1,26,4,12,0.333,2,4,0.5,2,8,0.25,0,0,,0,3,3,2,0,1,4,2,10,1.4
Caris LeVert,22-160,G-F,2/1/17,BRK,NYK,0,27,4,9,0.444,2,5,0.4,2,4,0.5,0,0,,0,4,4,2,2,0,3,1,10,6.5
Jrue Holiday,26-275,G,3/14/17,NOP,POR,1,27,4,6,0.667,3,3,1,1,3,0.333,1,2,0.5,0,1,1,2,3,0,2,3,10,8.5
Al Jefferson,31-312,C-F,11/11/16,IND,PHI,0,22,4,9,0.444,4,9,0.444,0,0,,2,3,0.667,0,3,3,2,0,0,1,4,10,4.6
Nicolas Brussino,23-346,G-F,2/11/17,DAL,ORL,0,12,4,6,0.667,2,3,0.667,2,3,0.667,0,0,,0,3,3,3,1,1,0,1,10,11.7
Isaiah Whitehead,22-011,G,3/19/17,BRK,DAL,0,23,3,7,0.429,2,3,0.667,1,4,0.25,3,6,0.5,1,1,2,2,0,0,0,0,10,7.5
Mike Muscala,25-130,F-C,11/8/16,ATL,CLE,0,22,5,8,0.625,5,6,0.833,0,2,0,0,0,,3,0,3,2,0,1,2,0,10,8.6
Al Horford,30-224,C-F,1/13/17,BOS,ATL,1,35,4,8,0.5,2,3,0.667,2,5,0.4,0,2,0,0,6,6,6,1,1,1,1,10,11.5
Serge Ibaka,27-079,F-C,12/6/16,ORL,WAS,1,31,5,15,0.333,5,11,0.455,0,4,0,0,0,,0,5,5,1,0,4,1,0,10,5.5
Terrence Jones,24-331,F,12/5/16,NOP,MEM,0,32,4,11,0.364,4,11,0.364,0,0,,2,2,1,1,7,8,1,0,1,1,1,10,6.7
David Lee,33-194,F,11/9/16,SAS,HOU,0,16,4,6,0.667,4,6,0.667,0,0,,2,4,0.5,1,3,4,2,1,0,1,1,10,9.2
Spencer Dinwiddie,23-354,G,3/26/17,BRK,ATL,0,21,3,5,0.6,1,2,0.5,2,3,0.667,2,3,0.667,0,2,2,4,2,1,2,3,10,10.2
Shaun Livingston,31-095,G,12/15/16,GSW,NYK,0,19,5,8,0.625,5,8,0.625,0,0,,0,0,,0,1,1,3,0,1,0,2,10,8.7
Wayne Selden,22-194,G-F,4/12/17,MEM,DAL,0,31,4,7,0.571,2,4,0.5,2,3,0.667,0,0,,0,1,1,1,0,0,1,3,10,5.5
Richaun Holmes,23-173,F-C,4/6/17,PHI,CHI,1,31,4,11,0.364,3,7,0.429,1,4,0.25,1,1,1,3,7,10,2,2,1,2,2,10,9.4
Steven Adams,23-239,C,3/16/17,OKC,TOR,1,25,5,8,0.625,5,8,0.625,0,0,,0,0,,2,3,5,2,1,1,1,3,10,9.6
Marquese Chriss,19-246,F,3/5/17,PHO,BOS,1,25,5,9,0.556,5,6,0.833,0,3,0,0,0,,1,5,6,0,1,5,1,2,10,10.6
Matt Barnes,36-289,F,12/23/16,SAC,MIN,1,32,4,6,0.667,2,2,1,2,4,0.5,0,0,,0,5,5,5,0,0,3,2,10,8.6
Jonas Valanciunas,24-297,C,2/27/17,TOR,NYK,1,19,4,4,1,4,4,1,0,0,,2,2,1,1,4,5,0,1,1,3,4,10,7.8
Andre Roberson,25-073,G-F,2/15/17,OKC,NYK,1,34,3,8,0.375,2,7,0.286,1,1,1,3,4,0.75,2,5,7,0,2,0,0,3,10,8.9
Lucas Nogueira,24-108,C,11/11/16,TOR,CHO,0,27,4,6,0.667,4,6,0.667,0,0,,2,2,1,2,5,7,1,1,2,2,4,10,9.8
Sergio Rodriguez,30-237,G,2/4/17,PHI,MIA,0,12,4,7,0.571,2,5,0.4,2,2,1,0,0,,0,1,1,1,0,0,2,1,10,5.3
Alan Anderson,34-075,G-F,12/30/16,LAC,HOU,0,25,4,9,0.444,4,7,0.571,0,2,0,2,2,1,0,3,3,3,0,0,0,4,10,6.7
Kyle O'Quinn,26-231,F-C,11/12/16,NYK,TOR,0,14,5,7,0.714,5,7,0.714,0,0,,0,0,,2,2,4,1,0,1,2,2,10,7.7
Kenneth Faried,27-137,F,4/5/17,DEN,HOU,1,13,4,7,0.571,4,7,0.571,0,0,,2,2,1,1,1,2,1,0,0,0,1,10,8
LaMarcus Aldridge,31-156,F-C,12/22/16,SAS,LAC,1,23,5,13,0.385,5,12,0.417,0,1,0,0,0,,2,2,4,1,0,1,1,4,10,3.7
Andrew Harrison,22-067,G,1/3/17,MEM,LAL,0,17,1,3,0.333,1,1,1,0,2,0,8,10,0.8,0,1,1,1,0,0,2,4,10,4.9
Iman Shumpert,26-196,G,1/8/17,CLE,PHO,0,26,4,7,0.571,2,3,0.667,2,4,0.5,0,0,,0,3,3,1,1,2,0,0,10,10.7
Jaylen Brown,20-018,F,11/11/16,BOS,NYK,0,17,3,9,0.333,2,6,0.333,1,3,0.333,3,8,0.375,0,4,4,0,0,1,0,2,10,4
Jeff Green,30-155,F,1/30/17,ORL,MIN,0,25,4,6,0.667,3,4,0.75,1,2,0.5,1,1,1,0,3,3,4,1,0,2,1,10,9.7
Willie Reed,26-207,F-C,12/9/16,MIA,CLE,0,20,2,7,0.286,2,7,0.286,0,0,,6,8,0.75,8,3,11,0,0,1,0,2,10,11.5
Fred VanVleet,22-346,G,2/5/17,TOR,BRK,0,20,2,10,0.2,2,7,0.286,0,3,0,6,6,1,0,3,3,4,0,0,1,1,10,6.1
Kyle O'Quinn,26-291,F-C,1/11/17,NYK,PHI,0,24,5,6,0.833,5,5,1,0,1,0,0,0,,3,12,15,3,1,2,2,4,10,14.4
Archie Goodwin,22-216,G,3/21/17,BRK,DET,0,18,5,10,0.5,5,7,0.714,0,3,0,0,1,0,2,3,5,3,0,2,1,0,10,9.4
James Johnson,29-350,F,2/4/17,MIA,PHI,0,16,4,5,0.8,4,4,1,0,1,0,2,2,1,0,6,6,3,2,0,1,2,10,12.2
Enes Kanter,24-187,C,11/23/16,OKC,SAC,0,21,3,9,0.333,3,8,0.375,0,1,0,4,4,1,2,5,7,1,1,0,0,2,10,8.7
P.J. Tucker,31-202,F,11/23/16,PHO,ORL,0,27,4,9,0.444,2,5,0.4,2,4,0.5,0,0,,1,6,7,1,1,0,2,2,10,6.7
Malachi Richardson,21-041,G,2/15/17,SAC,GSW,0,27,4,10,0.4,4,9,0.444,0,1,0,2,2,1,1,6,7,2,1,0,0,2,10,8.7
Justin Holiday,27-335,G,3/6/17,NYK,ORL,0,25,4,6,0.667,2,3,0.667,2,3,0.667,0,0,,0,4,4,3,2,0,0,3,10,11.5
Nik Stauskas,23-065,G,12/11/16,PHI,DET,0,25,2,3,0.667,1,1,1,1,2,0.5,5,6,0.833,0,2,2,4,1,0,2,2,10,9.9
Willie Cauley-Stein,23-216,F-C,3/22/17,SAC,MIL,1,27,5,10,0.5,5,10,0.5,0,0,,0,1,0,1,7,8,2,0,4,2,2,10,8.8
Alex Len,23-290,C,4/2/17,PHO,HOU,1,28,2,6,0.333,2,6,0.333,0,0,,6,6,1,3,9,12,0,0,4,2,2,10,11.4
LaMarcus Aldridge,31-129,F-C,11/25/16,SAS,BOS,1,32,4,12,0.333,4,12,0.333,0,0,,2,4,0.5,3,1,4,4,0,2,0,2,10,8.2
Ed Davis,27-186,F,12/8/16,POR,MEM,0,18,3,6,0.5,3,6,0.5,0,0,,4,6,0.667,6,4,10,1,0,2,2,4,10,10.1
Sean Kilpatrick,27-002,G,1/8/17,BRK,PHI,0,25,4,9,0.444,2,5,0.4,2,4,0.5,0,0,,0,3,3,3,1,0,5,3,10,3.1
Reggie Jackson,26-318,G,2/28/17,DET,POR,1,24,4,12,0.333,4,8,0.5,0,4,0,2,2,1,1,0,1,4,0,0,2,2,10,3.9
Tarik Black,25-126,C-F,3/28/17,LAL,WAS,0,23,5,6,0.833,5,6,0.833,0,0,,0,0,,0,2,2,0,0,2,1,5,10,6.8
Matt Barnes,36-320,F,1/23/17,SAC,DET,0,25,4,9,0.444,3,6,0.5,1,3,0.333,1,1,1,1,7,8,2,1,0,2,3,10,7.3
Tyler Ulis,20-318,G,11/18/16,PHO,IND,0,14,4,8,0.5,4,6,0.667,0,2,0,2,2,1,0,0,0,2,4,0,0,3,10,10.2
Alex Abrines,23-150,G-F,12/29/16,OKC,MEM,0,27,2,11,0.182,0,3,0,2,8,0.25,4,4,1,2,1,3,0,0,0,2,0,10,2.8
Marcus Morris,27-066,F,11/7/16,DET,LAC,1,26,5,9,0.556,5,8,0.625,0,1,0,0,0,,1,1,2,1,0,1,2,1,10,5.7
Marcus Smart,23-014,G,3/20/17,BOS,WAS,0,20,3,9,0.333,3,8,0.375,0,1,0,4,6,0.667,1,1,2,2,0,1,1,4,10,4.6
Mario Hezonja,21-364,F-G,2/23/17,ORL,POR,0,25,4,5,0.8,2,3,0.667,2,2,1,0,0,,0,1,1,2,1,0,0,3,10,9.6
Ivica Zubac,20-001,C,3/19/17,LAL,CLE,1,19,4,7,0.571,4,7,0.571,0,0,,2,2,1,2,4,6,2,0,1,0,1,10,11
Nikola Vucevic,26-043,C,12/6/16,ORL,WAS,0,25,4,9,0.444,4,7,0.571,0,2,0,2,2,1,3,7,10,6,1,0,0,3,10,13.5
Mike Muscala,25-222,F-C,2/8/17,ATL,DEN,0,20,3,7,0.429,3,5,0.6,0,2,0,4,5,0.8,1,5,6,0,0,1,1,1,10,7.4
Kyle O'Quinn,26-317,F-C,2/6/17,NYK,LAL,1,16,2,5,0.4,2,5,0.4,0,0,,6,6,1,1,1,2,1,0,0,1,3,10,6.8
Nene Hilario,34-073,F-C,11/25/16,HOU,SAC,0,15,4,5,0.8,4,5,0.8,0,0,,2,2,1,0,0,0,0,0,0,0,4,10,6.5
Jaylen Brown,20-170,F,4/12/17,BOS,MIL,0,22,5,10,0.5,5,8,0.625,0,2,0,0,1,0,2,2,4,1,1,0,1,0,10,7.3
Mindaugas Kuzminskas,27-034,F,11/22/16,NYK,POR,0,21,4,6,0.667,2,3,0.667,2,3,0.667,0,0,,0,3,3,1,1,0,1,2,10,8.2
Richaun Holmes,23-145,F-C,3/9/17,PHI,POR,0,22,4,6,0.667,3,5,0.6,1,1,1,1,2,0.5,2,4,6,0,1,1,2,5,10,7.3
Patty Mills,28-177,G,2/4/17,SAS,DEN,0,16,4,6,0.667,2,4,0.5,2,2,1,0,0,,0,4,4,1,0,0,0,2,10,8.5
Channing Frye,33-202,C-F,12/5/16,CLE,TOR,0,19,3,7,0.429,1,2,0.5,2,5,0.4,2,2,1,1,4,5,2,0,0,1,1,10,8.2
Luc Mbah a Moute,30-211,F,4/8/17,LAC,SAS,1,35,4,7,0.571,4,6,0.667,0,1,0,2,4,0.5,1,1,2,1,2,0,0,1,10,9.2
DeMarre Carroll,30-249,F,4/2/17,TOR,PHI,1,23,4,11,0.364,2,4,0.5,2,7,0.286,0,0,,1,4,5,0,1,0,1,1,10,5.4
Tristan Thompson,25-282,F-C,12/20/16,CLE,MIL,1,26,4,7,0.571,4,7,0.571,0,0,,2,3,0.667,5,7,12,0,1,1,2,5,10,9.6
Tyson Chandler,34-098,C,1/8/17,PHO,CLE,1,32,4,7,0.571,4,7,0.571,0,0,,2,2,1,4,11,15,0,0,1,1,4,10,10.9
Jeff Green,30-061,F,10/28/16,ORL,DET,0,19,4,9,0.444,2,3,0.667,2,6,0.333,0,0,,0,2,2,1,0,1,0,3,10,6.1
Sergio Rodriguez,30-239,G,2/6/17,PHI,DET,0,18,4,8,0.5,2,4,0.5,2,4,0.5,0,0,,0,2,2,3,1,0,1,2,10,7.9
Ish Smith,28-130,G,11/12/16,DET,DEN,1,29,5,12,0.417,5,12,0.417,0,0,,0,0,,1,2,3,8,2,0,4,4,10,6.9
Brook Lopez,29-005,C,4/6/17,BRK,ORL,1,31,4,13,0.308,4,8,0.5,0,5,0,2,5,0.4,1,4,5,2,0,0,4,3,10,-0.6
Josh Richardson,23-185,G,3/19/17,MIA,POR,1,33,4,8,0.5,3,5,0.6,1,3,0.333,1,2,0.5,0,1,1,2,1,1,1,4,10,6.4
Rajon Rondo,30-301,G,12/19/16,CHI,DET,1,28,4,7,0.571,2,4,0.5,2,3,0.667,0,0,,0,8,8,14,3,0,4,2,10,17.1
Justin Hamilton,26-356,C,3/23/17,BRK,PHO,0,8,3,5,0.6,3,4,0.75,0,1,0,4,4,1,0,0,0,1,1,0,0,2,10,8.6
Kris Humphries,31-301,F-C,12/3/16,ATL,TOR,0,17,4,8,0.5,3,6,0.5,1,2,0.5,1,1,1,1,2,3,0,0,0,0,2,10,6.5
Nikola Vucevic,26-072,C,1/4/17,ORL,ATL,0,30,5,13,0.385,5,12,0.417,0,1,0,0,0,,0,6,6,6,1,3,5,2,10,6.2
Patrick Patterson,28-015,F,3/29/17,TOR,CHO,0,22,4,8,0.5,3,4,0.75,1,4,0.25,1,1,1,0,1,1,2,0,0,1,4,10,5.1
Jeremy Lamb,24-284,G-F,3/10/17,CHO,ORL,0,28,4,8,0.5,2,4,0.5,2,4,0.5,0,0,,0,5,5,3,0,2,0,1,10,10.6
Eric Gordon,28-080,G,3/15/17,HOU,LAL,0,30,4,12,0.333,2,5,0.4,2,7,0.286,0,1,0,1,2,3,4,1,1,0,3,10,7.4
Boris Diaw,34-255,F-C,12/27/16,UTA,LAL,0,23,4,9,0.444,2,5,0.4,2,4,0.5,0,0,,0,0,0,2,1,0,4,2,10,2.9
Joe Johnson,35-144,G-F,11/20/16,UTA,DEN,0,27,4,8,0.5,3,6,0.5,1,2,0.5,1,2,0.5,0,5,5,1,0,1,0,2,10,7.7
Joe Johnson,35-136,G-F,11/12/16,UTA,MIA,0,28,4,10,0.4,2,6,0.333,2,4,0.5,0,0,,0,6,6,2,0,0,0,1,10,7.4
Rondae Hollis-Jefferson,21-358,F,12/26/16,BRK,CHO,0,26,1,6,0.167,1,6,0.167,0,0,,8,10,0.8,1,3,4,1,1,2,0,4,10,8.5
Dewayne Dedmon,27-180,C,2/8/17,SAS,PHI,1,26,4,5,0.8,4,5,0.8,0,0,,2,3,0.667,2,9,11,3,0,1,0,3,10,13.4
Tony Snell,25-123,G-F,3/13/17,MIL,MEM,1,28,4,7,0.571,2,4,0.5,2,3,0.667,0,0,,1,2,3,2,2,0,0,1,10,11
Kelly Olynyk,25-211,C-F,11/16/16,BOS,DAL,1,29,5,8,0.625,5,7,0.714,0,1,0,0,0,,0,4,4,0,0,0,2,3,10,4.4
Gary Harris,22-132,G,1/24/17,DEN,UTA,1,27,4,10,0.4,3,4,0.75,1,6,0.167,1,2,0.5,0,2,2,2,0,0,1,1,10,4.8
Ben McLemore,23-259,G,10/27/16,SAC,SAS,0,10,3,4,0.75,3,4,0.75,0,0,,4,4,1,0,2,2,1,0,0,2,2,10,6.9
Derrick Williams,25-221,F,1/1/17,MIA,DET,0,13,4,6,0.667,3,4,0.75,1,2,0.5,1,2,0.5,0,6,6,2,0,0,0,1,10,9.8
Trey Lyles,21-126,F,3/11/17,UTA,OKC,0,26,4,10,0.4,2,5,0.4,2,5,0.4,0,0,,1,5,6,1,1,1,2,6,10,4.8
Ish Smith,28-218,G,2/8/17,DET,LAL,0,21,5,6,0.833,5,6,0.833,0,0,,0,0,,0,4,4,7,2,0,5,0,10,10.9
Thomas Robinson,25-285,F,12/27/16,LAL,UTA,0,18,5,6,0.833,5,6,0.833,0,0,,0,0,,1,2,3,0,1,0,1,2,10,8.3
Kentavious Caldwell-Pope,24-025,G,3/15/17,DET,UTA,1,29,4,12,0.333,2,9,0.222,2,3,0.667,0,2,0,0,1,1,0,1,0,1,1,10,2.3
Kyle Korver,35-233,G-F,11/5/16,ATL,HOU,1,30,4,6,0.667,2,3,0.667,2,3,0.667,0,0,,0,2,2,2,2,1,2,0,10,10.1
Justin Anderson,23-130,G,3/29/17,PHI,ATL,1,25,4,9,0.444,3,5,0.6,1,4,0.25,1,1,1,1,1,2,3,0,0,1,2,10,6.6
Jamal Murray,20-047,G,4/11/17,DEN,DAL,1,33,4,14,0.286,2,6,0.333,2,8,0.25,0,0,,0,2,2,10,1,0,2,2,10,7.6
Tony Allen,35-064,G-F,3/16/17,MEM,ATL,1,28,4,8,0.5,3,6,0.5,1,2,0.5,1,2,0.5,4,2,6,1,2,0,1,4,10,9.1
E'Twaun Moore,28-006,G,3/6/17,NOP,UTA,0,18,4,8,0.5,2,4,0.5,2,4,0.5,0,0,,0,1,1,1,0,0,2,1,10,4.6
Kelly Oubre,20-334,F,11/7/16,WAS,HOU,0,14,3,7,0.429,1,4,0.25,2,3,0.667,2,2,1,1,0,1,0,0,0,0,2,10,6.2
Pau Gasol,36-248,F-C,3/11/17,SAS,GSW,0,20,3,8,0.375,3,7,0.429,0,1,0,4,6,0.667,0,7,7,3,0,1,5,0,10,4.7
Andrew Harrison,22-011,G,11/8/16,MEM,DEN,0,26,3,6,0.5,1,2,0.5,2,4,0.5,2,2,1,0,3,3,6,4,1,3,5,10,11.8
Darrell Arthur,28-312,F,1/31/17,DEN,LAL,0,20,4,8,0.5,3,6,0.5,1,2,0.5,1,2,0.5,4,2,6,3,1,2,3,2,10,9.7
Patrick Patterson,27-233,F,11/2/16,TOR,WAS,0,30,4,9,0.444,2,3,0.667,2,6,0.333,0,0,,1,2,3,2,0,0,1,2,10,6.2
Kelly Oubre,20-362,F,12/5/16,WAS,BRK,0,18,3,8,0.375,1,3,0.333,2,5,0.4,2,2,1,1,4,5,0,1,0,1,3,10,6.3
Nik Stauskas,23-057,G,12/3/16,PHI,BOS,1,33,3,11,0.273,1,3,0.333,2,8,0.25,2,2,1,0,2,2,0,1,2,1,4,10,3.9
Josh Richardson,23-088,G,12/12/16,MIA,WAS,0,29,4,7,0.571,2,4,0.5,2,3,0.667,0,0,,0,4,4,3,1,0,2,2,10,8.2
Norman Powell,23-228,G,1/8/17,TOR,HOU,1,22,3,7,0.429,1,2,0.5,2,5,0.4,2,2,1,0,1,1,3,0,0,3,2,10,4.9
Paul George,26-255,F,1/12/17,IND,DEN,1,31,2,12,0.167,0,6,0,2,6,0.333,4,4,1,0,4,4,3,4,0,2,1,10,7.3
Cody Zeller,24-181,F-C,4/4/17,CHO,WAS,1,32,4,5,0.8,4,5,0.8,0,0,,2,2,1,3,7,10,1,0,1,1,1,10,12.3
Kris Dunn,22-228,G,11/1/16,MIN,MEM,1,29,3,7,0.429,1,4,0.25,2,3,0.667,2,2,1,1,3,4,6,5,0,3,3,10,12.9
T.J. McConnell,24-336,G,2/24/17,PHI,WAS,1,30,4,8,0.5,4,8,0.5,0,0,,2,4,0.5,2,2,4,8,2,1,3,4,10,10.9
Delon Wright,24-324,G,3/16/17,TOR,OKC,0,20,2,6,0.333,2,5,0.4,0,1,0,6,7,0.857,0,2,2,1,2,0,1,2,10,7.7
Matt Barnes,37-005,F,3/14/17,GSW,PHI,0,22,3,7,0.429,1,3,0.333,2,4,0.5,2,2,1,3,6,9,2,1,1,2,4,10,9.7
Buddy Hield,22-323,G,11/4/16,NOP,PHO,0,23,4,14,0.286,2,4,0.5,2,10,0.2,0,0,,0,3,3,1,0,0,0,1,10,3
Darren Collison,29-207,G,3/18/17,SAC,OKC,1,27,4,13,0.308,4,11,0.364,0,2,0,2,2,1,0,3,3,0,0,0,1,2,10,1.6
Marcin Gortat,33-036,C-F,3/25/17,WAS,CLE,1,23,5,8,0.625,5,8,0.625,0,0,,0,0,,1,4,5,1,1,0,2,2,10,7.2
Jamal Murray,20-006,G,3/1/17,DEN,MIL,1,30,4,13,0.308,2,4,0.5,2,9,0.222,0,0,,1,0,1,5,2,1,2,1,10,7
Mason Plumlee,26-248,C-F,11/8/16,POR,PHO,1,31,5,6,0.833,5,6,0.833,0,0,,0,2,0,0,5,5,5,0,1,0,2,10,11.9
Dragan Bender,18-357,F,11/8/16,PHO,POR,0,23,4,9,0.444,2,5,0.4,2,4,0.5,0,0,,1,1,2,1,0,1,2,2,10,4.9
Nene Hilario,34-183,F-C,3/15/17,HOU,LAL,0,14,5,7,0.714,5,7,0.714,0,0,,0,0,,1,2,3,0,1,1,2,2,10,7.3
Taj Gibson,31-231,F,2/10/17,CHI,PHO,1,26,5,10,0.5,5,10,0.5,0,0,,0,0,,1,5,6,0,0,0,2,1,10,4.8
Ish Smith,28-139,G,11/21/16,DET,HOU,1,31,3,9,0.333,1,6,0.167,2,3,0.667,2,2,1,1,3,4,8,0,1,1,1,10,11.4
Allen Crabbe,24-302,G-F,2/5/17,POR,OKC,0,30,4,10,0.4,2,3,0.667,2,7,0.286,0,0,,0,1,1,2,0,0,1,3,10,4.1
Ian Clark,26-017,G,3/24/17,GSW,SAC,0,18,5,10,0.5,5,9,0.556,0,1,0,0,0,,0,0,0,3,0,0,0,1,10,6.7
Lance Thomas,28-253,F,1/2/17,NYK,ORL,1,20,4,8,0.5,3,6,0.5,1,2,0.5,1,2,0.5,2,1,3,1,1,0,1,3,10,6.8
Dewayne Dedmon,27-124,C,12/14/16,SAS,BOS,0,16,5,6,0.833,5,6,0.833,0,0,,0,0,,1,4,5,0,1,0,1,3,10,8.5
Frank Kaminsky,23-292,F-C,1/21/17,CHO,BRK,0,25,4,5,0.8,2,3,0.667,2,2,1,0,0,,0,2,2,2,2,1,2,4,10,9.2
James Ennis,26-203,F,1/20/17,MEM,SAC,1,35,4,7,0.571,3,4,0.75,1,3,0.333,1,4,0.25,3,3,6,3,0,2,3,5,10,7
Spencer Dinwiddie,23-349,G,3/21/17,BRK,DET,1,30,3,9,0.333,3,6,0.5,0,3,0,4,6,0.667,3,6,9,4,0,2,1,2,10,10.4
Rudy Gobert,24-232,C,2/13/17,UTA,LAC,1,25,5,12,0.417,5,12,0.417,0,0,,0,0,,8,6,14,1,0,1,0,1,10,12
Nicolas Laprovittola,26-310,G,12/6/16,SAS,MIN,1,21,4,5,0.8,2,2,1,2,3,0.667,0,0,,0,0,0,2,0,0,3,4,10,4.9
James Johnson,30-023,F,3/15/17,MIA,NOP,0,25,3,7,0.429,1,5,0.2,2,2,1,2,2,1,0,4,4,4,0,0,2,4,10,6.7
Chasson Randle,23-346,G,1/16/17,PHI,MIL,0,16,3,6,0.5,1,2,0.5,2,4,0.5,2,2,1,0,2,2,1,1,0,0,5,10,7.3
Enes Kanter,24-199,C,12/5/16,OKC,ATL,0,15,3,6,0.5,2,4,0.5,1,2,0.5,3,4,0.75,0,3,3,1,0,1,3,3,10,4.7
Marcin Gortat,32-292,C-F,12/5/16,WAS,BRK,1,33,5,9,0.556,5,9,0.556,0,0,,0,0,,3,9,12,2,0,2,1,2,10,11.5
Draymond Green,26-262,F,11/21/16,GSW,IND,1,29,4,7,0.571,4,5,0.8,0,2,0,2,2,1,3,6,9,7,2,2,1,1,10,17.5
Buddy Hield,22-320,G,11/1/16,NOP,MIL,0,14,4,10,0.4,3,4,0.75,1,6,0.167,1,1,1,0,0,0,0,1,0,4,0,10,1.6
Timothe Luwawu-Cabarrot,21-309,F,3/14/17,PHI,GSW,1,23,4,7,0.571,3,5,0.6,1,2,0.5,1,2,0.5,0,3,3,2,1,0,1,5,10,6.6
Raymond Felton,32-216,G,1/28/17,LAC,GSW,0,28,3,12,0.25,1,7,0.143,2,5,0.4,2,2,1,2,5,7,5,0,1,3,1,10,6.5
Taj Gibson,31-182,F,12/23/16,CHI,CHO,1,30,4,10,0.4,4,10,0.4,0,0,,2,2,1,1,2,3,0,0,2,0,1,10,6.9
Roy Hibbert,29-336,C,11/11/16,CHO,TOR,0,13,3,5,0.6,3,5,0.6,0,0,,4,4,1,2,0,2,0,0,0,1,0,10,8.1
Devin Booker,20-020,G,11/19/16,PHO,PHI,1,18,4,13,0.308,4,11,0.364,0,2,0,2,3,0.667,0,1,1,0,2,0,5,0,10,-0.6
Jon Leuer,27-285,F,2/23/17,DET,CHO,1,41,5,14,0.357,5,11,0.455,0,3,0,0,0,,2,7,9,2,0,0,1,2,10,5.3
D'Angelo Russell,21-018,G,3/13/17,LAL,DEN,0,28,4,14,0.286,2,8,0.25,2,6,0.333,0,2,0,1,1,2,3,3,0,2,3,10,3.9
Jeff Teague,28-269,G,3/6/17,IND,CHO,1,29,4,11,0.364,3,9,0.333,1,2,0.5,1,2,0.5,1,4,5,8,0,2,2,1,10,10
Marreese Speights,29-138,C-F,12/20/16,LAC,DEN,0,17,4,5,0.8,2,2,1,2,3,0.667,0,1,0,0,2,2,0,0,0,1,3,10,6.1
Mike Muscala,25-130,F-C,11/8/16,ATL,CLE,0,22,5,8,0.625,5,6,0.833,0,2,0,0,0,,3,0,3,2,0,1,2,0,10,8.6
Marcus Morris,27-128,F,1/8/17,DET,POR,1,46,5,17,0.294,5,13,0.385,0,4,0,0,0,,1,4,5,5,1,0,0,2,10,5.7
Jusuf Nurkic,22-074,C,11/5/16,DEN,DET,1,24,5,8,0.625,5,8,0.625,0,0,,0,0,,4,8,12,1,2,1,4,3,10,9.8
J.J. Redick,32-148,G,11/19/16,LAC,CHI,1,25,3,9,0.333,2,4,0.5,1,5,0.2,3,4,0.75,0,2,2,3,2,1,1,1,10,8.5
Gerald Henderson,29-043,G,1/21/17,PHI,ATL,0,19,3,8,0.375,1,2,0.5,2,6,0.333,2,3,0.667,0,2,2,2,0,0,1,1,10,5.8
Robert Covington,25-333,F,11/11/16,PHI,IND,1,40,3,13,0.231,1,4,0.25,2,9,0.222,2,2,1,1,3,4,3,2,1,0,3,10,7.3
Tim Hardaway,24-350,G,3/1/17,ATL,DAL,0,22,4,9,0.444,3,5,0.6,1,4,0.25,1,2,0.5,0,3,3,0,1,0,1,0,10,5.8
Harrison Barnes,24-153,F,10/30/16,DAL,HOU,1,38,3,11,0.273,3,10,0.3,0,1,0,4,4,1,0,5,5,0,0,0,0,2,10,4.2
Cory Joseph,25-178,G,2/14/17,TOR,CHI,0,28,4,8,0.5,3,7,0.429,1,1,1,1,2,0.5,1,4,5,1,1,0,1,1,10,7.8
Maurice Harkless,23-295,F-G,3/2/17,POR,OKC,1,34,2,7,0.286,1,4,0.25,1,3,0.333,5,8,0.625,2,7,9,0,1,0,0,5,10,7.2
Cody Zeller,24-023,F-C,10/28/16,CHO,MIA,0,23,4,8,0.5,4,8,0.5,0,0,,2,3,0.667,2,1,3,1,2,1,1,2,10,8.9
D.J. Augustin,28-365,G,11/9/16,ORL,MIN,0,19,2,6,0.333,1,3,0.333,1,3,0.333,5,5,1,0,2,2,2,0,0,0,2,10,7.8
Sam Dekker,22-277,F,2/7/17,HOU,ORL,0,18,3,5,0.6,0,1,0,3,4,0.75,1,2,0.5,0,1,1,2,0,0,0,2,10,8.2
Goran Dragic,30-199,G,11/21/16,MIA,PHI,1,35,4,13,0.308,4,9,0.444,0,4,0,2,2,1,2,2,4,7,3,1,3,3,10,8.9
Terry Rozier,22-239,G,11/11/16,BOS,NYK,0,27,1,8,0.125,0,7,0,1,1,1,7,8,0.875,2,3,5,1,2,0,0,2,10,8.6
Rodney Hood,24-174,G-F,4/12/17,UTA,SAS,0,23,4,13,0.308,2,5,0.4,2,8,0.25,0,0,,1,3,4,2,1,0,2,2,10,3.7
Nikola Mirotic,25-324,F,12/31/16,CHI,MIL,0,22,4,5,0.8,2,3,0.667,2,2,1,0,0,,1,3,4,0,0,0,0,2,10,8.9
Victor Oladipo,24-175,G,10/26/16,OKC,PHI,1,26,4,16,0.25,4,11,0.364,0,5,0,2,3,0.667,2,3,5,1,0,1,3,2,10,-0.1
Mike Muscala,25-149,F-C,11/27/16,ATL,LAL,0,25,4,7,0.571,2,4,0.5,2,3,0.667,0,0,,0,5,5,0,0,2,0,2,10,8.8
Patty Mills,28-095,G,11/14/16,SAS,MIA,0,24,2,3,0.667,0,1,0,2,2,1,4,4,1,1,2,3,3,0,0,2,2,10,9.3
Monta Ellis,31-160,G,4/4/17,IND,TOR,1,23,4,8,0.5,3,6,0.5,1,2,0.5,1,1,1,0,4,4,1,2,2,1,2,10,9.5
Aaron Brooks,32-071,G,3/26/17,IND,PHI,0,22,4,5,0.8,4,5,0.8,0,0,,2,2,1,0,2,2,1,0,0,0,1,10,9
Patrick McCaw,21-147,G,3/21/17,GSW,DAL,1,30,4,7,0.571,2,4,0.5,2,3,0.667,0,0,,0,3,3,2,1,0,0,2,10,9.2
Robin Lopez,28-330,C,2/25/17,CHI,CLE,1,21,5,10,0.5,5,10,0.5,0,0,,0,0,,0,1,1,1,1,0,1,0,10,6
Manu Ginobili,39-157,G,1/1/17,SAS,ATL,0,21,2,5,0.4,1,2,0.5,1,3,0.333,5,5,1,0,3,3,3,3,0,1,2,10,11.5
Robin Lopez,28-268,C,12/25/16,CHI,SAS,1,19,4,6,0.667,4,6,0.667,0,0,,2,4,0.5,3,1,4,1,0,0,4,2,10,4.9
Nerlens Noel,22-305,C-F,2/9/17,PHI,ORL,0,22,4,6,0.667,4,6,0.667,0,0,,2,2,1,0,7,7,1,3,2,1,3,10,12.4
Trevor Booker,29-000,F,11/25/16,BRK,IND,1,28,5,8,0.625,5,7,0.714,0,1,0,0,1,0,3,7,10,3,3,1,3,1,10,12.6
Channing Frye,33-320,C-F,4/2/17,CLE,IND,0,19,4,7,0.571,2,2,1,2,5,0.4,0,0,,0,7,7,0,0,1,0,1,10,9.1
Isaiah Canaan,25-196,G,12/3/16,CHI,DAL,0,29,4,6,0.667,3,4,0.75,1,2,0.5,1,1,1,0,3,3,1,1,0,2,1,10,7.6
Kyle Korver,35-279,G-F,12/21/16,ATL,MIN,1,33,4,10,0.4,2,4,0.5,2,6,0.333,0,0,,0,5,5,3,0,4,4,1,10,6.6
Yogi Ferrell,23-320,G,3/25/17,DAL,TOR,0,18,4,10,0.4,2,6,0.333,2,4,0.5,0,0,,0,4,4,4,1,0,2,1,10,7.2
Stanley Johnson,20-229,F,1/13/17,DET,UTA,0,26,4,5,0.8,2,2,1,2,3,0.667,0,0,,0,0,0,0,1,0,2,1,10,6.7
Timofey Mozgov,30-142,C,12/5/16,LAL,UTA,1,20,4,7,0.571,4,7,0.571,0,0,,2,3,0.667,2,2,4,0,0,0,0,1,10,7.9
Paul Zipser,22-337,G-F,1/20/17,CHI,ATL,0,15,3,7,0.429,2,4,0.5,1,3,0.333,3,3,1,0,1,1,0,0,0,0,2,10,5.8
Klay Thompson,26-270,G,11/4/16,GSW,LAL,1,38,4,18,0.222,2,8,0.25,2,10,0.2,0,0,,0,3,3,1,2,1,4,1,10,-1.1
Jeremy Lamb,24-200,G-F,12/16/16,CHO,BOS,0,16,5,10,0.5,5,8,0.625,0,2,0,0,0,,1,5,6,0,1,0,0,4,10,6.6
Matthew Dellavedova,26-160,G,2/15/17,MIL,BRK,1,32,3,5,0.6,2,4,0.5,1,1,1,3,6,0.5,0,0,0,5,2,0,1,3,10,9.8
Montrezl Harrell,23-003,F-C,1/29/17,HOU,IND,1,26,5,9,0.556,5,9,0.556,0,0,,0,0,,6,1,7,1,0,1,1,4,10,9
Jeff Green,30-062,F,10/29/16,ORL,CLE,0,28,2,9,0.222,0,3,0,2,6,0.333,4,6,0.667,1,9,10,2,1,1,3,0,10,7.2
Robin Lopez,28-286,C,1/12/17,CHI,NYK,1,24,5,10,0.5,5,10,0.5,0,0,,0,0,,2,5,7,0,0,2,1,1,10,7.9
Shabazz Muhammad,24-015,F-G,11/28/16,MIN,UTA,0,17,3,6,0.5,3,5,0.6,0,1,0,4,4,1,0,1,1,0,0,0,0,0,10,7.3
Robin Lopez,28-245,C,12/2/16,CHI,CLE,1,26,5,10,0.5,5,10,0.5,0,0,,0,0,,4,1,5,0,0,0,1,2,10,6.3
Patrick Beverley,28-259,G,3/28/17,HOU,GSW,1,31,4,9,0.444,4,7,0.571,0,2,0,2,2,1,1,0,1,1,1,0,1,2,10,5.9
Kelly Oubre,20-338,F,11/11/16,WAS,CLE,0,21,5,8,0.625,5,7,0.714,0,1,0,0,0,,0,6,6,0,1,1,1,4,10,7.3
DeMar DeRozan,27-192,G,2/15/17,TOR,CHO,1,31,5,19,0.263,5,16,0.313,0,3,0,0,2,0,0,3,3,2,0,0,3,0,10,-2.8
James Ennis,26-242,F,2/28/17,MEM,PHO,0,18,2,6,0.333,1,3,0.333,1,3,0.333,5,6,0.833,0,2,2,2,1,1,0,2,10,9.1
Mindaugas Kuzminskas,27-170,F,4/7/17,NYK,MEM,0,23,5,12,0.417,5,8,0.625,0,4,0,0,0,,0,1,1,0,0,0,0,0,10,3.9
Evan Turner,28-161,G,4/6/17,POR,MIN,0,29,3,6,0.5,3,6,0.5,0,0,,4,6,0.667,0,7,7,2,1,1,1,3,10,9.2
Semaj Christon,24-004,G,11/5/16,OKC,MIN,0,20,4,8,0.5,4,7,0.571,0,1,0,2,2,1,0,0,0,5,0,0,0,3,10,8.3
Cheick Diallo,20-094,F,12/16/16,NOP,HOU,0,22,4,5,0.8,4,5,0.8,0,0,,2,2,1,2,5,7,1,0,1,1,1,10,11
Paul George,26-299,F,2/25/17,IND,MIA,1,19,3,8,0.375,3,7,0.429,0,1,0,4,4,1,1,0,1,1,0,0,4,3,10,1.8
DeAndre Liggins,28-258,G,12/14/16,CLE,MEM,1,25,3,9,0.333,2,7,0.286,1,2,0.5,3,3,1,1,2,3,1,2,0,2,3,10,5.7
Anthony Morrow,31-059,G,11/25/16,OKC,DEN,0,22,4,8,0.5,2,6,0.333,2,2,1,0,0,,0,0,0,1,0,1,1,0,10,6.4
Tyler Ulis,20-359,G,12/29/16,PHO,TOR,0,15,4,6,0.667,2,4,0.5,2,2,1,0,0,,0,2,2,1,1,0,1,2,10,7.9
Thomas Robinson,26-025,F,4/11/17,LAL,NOP,0,14,4,5,0.8,4,5,0.8,0,0,,2,4,0.5,1,4,5,1,1,0,1,2,10,9.1
Jerami Grant,22-228,F,10/26/16,PHI,OKC,0,22,4,10,0.4,4,9,0.444,0,1,0,2,4,0.5,0,4,4,0,0,2,2,2,10,3.6
Wayne Selden,22-186,G-F,4/4/17,MEM,SAS,0,24,3,8,0.375,2,4,0.5,1,4,0.25,3,6,0.5,0,0,0,1,2,1,2,0,10,5.8
Alex Len,23-242,C,2/13/17,PHO,NOP,0,19,4,10,0.4,4,10,0.4,0,0,,2,2,1,2,5,7,0,0,1,2,1,10,5.8
Matthew Dellavedova,26-072,G,11/19/16,MIL,GSW,1,34,4,7,0.571,3,6,0.5,1,1,1,1,1,1,0,3,3,5,1,0,1,3,10,9.9
J.J. Barea,32-124,G,10/28/16,DAL,HOU,1,29,3,10,0.3,2,7,0.286,1,3,0.333,3,4,0.75,1,4,5,5,1,0,0,3,10,9
Jeff Teague,28-182,G,12/9/16,IND,DAL,1,31,3,7,0.429,3,7,0.429,0,0,,4,5,0.8,0,3,3,6,1,0,2,0,10,10
Tyson Chandler,34-056,C,11/27/16,PHO,DEN,1,38,5,6,0.833,5,6,0.833,0,0,,0,0,,4,11,15,0,0,2,0,1,10,14.9
Wilson Chandler,29-209,F,12/5/16,DEN,PHI,0,26,3,7,0.429,1,4,0.25,2,3,0.667,2,2,1,0,4,4,2,1,0,3,3,10,5.7
Gorgui Dieng,27-054,C,3/13/17,MIN,WAS,1,32,4,6,0.667,4,6,0.667,0,0,,2,2,1,2,8,10,0,1,3,3,3,10,10.1
Langston Galloway,25-121,G,4/9/17,SAC,HOU,0,26,4,6,0.667,2,3,0.667,2,3,0.667,0,0,,1,1,2,3,0,0,0,1,10,10.1
Hassan Whiteside,27-268,C,3/8/17,MIA,CHO,1,35,4,7,0.571,4,7,0.571,0,0,,2,3,0.667,5,10,15,0,2,4,1,1,10,16.2
Cristiano Felicio,24-222,F-C,2/14/17,CHI,TOR,0,27,4,6,0.667,4,6,0.667,0,0,,2,2,1,3,3,6,1,2,0,0,3,10,11.9
Steven Adams,23-263,C,4/9/17,OKC,DEN,1,27,4,9,0.444,4,9,0.444,0,0,,2,2,1,6,4,10,2,1,0,1,4,10,10.5
James Johnson,29-284,F,11/30/16,MIA,DEN,0,33,4,12,0.333,4,8,0.5,0,4,0,2,3,0.667,0,7,7,5,3,2,2,3,10,9.6
Norman Powell,23-312,G,4/2/17,TOR,PHI,0,20,3,8,0.375,3,6,0.5,0,2,0,4,4,1,0,2,2,4,0,0,2,0,10,7
Marco Belinelli,30-321,G-F,2/9/17,CHO,HOU,0,21,5,13,0.385,5,10,0.5,0,3,0,0,0,,1,3,4,1,0,0,2,2,10,2.4
Spencer Hawes,28-183,C-F,10/28/16,CHO,MIA,0,20,4,10,0.4,4,9,0.444,0,1,0,2,2,1,4,5,9,2,0,2,2,2,10,8.9
Nikola Vucevic,26-010,C,11/3/16,ORL,SAC,1,29,4,11,0.364,4,11,0.364,0,0,,2,6,0.333,4,5,9,3,2,0,3,2,10,6.9
Brandon Bass,31-325,F,3/21/17,LAC,LAL,0,15,3,6,0.5,3,6,0.5,0,0,,4,4,1,0,2,2,0,1,1,2,3,10,6.1
Courtney Lee,31-034,G,11/6/16,NYK,UTA,1,36,3,8,0.375,1,6,0.167,2,2,1,2,2,1,1,5,6,0,3,0,2,3,10,7.6
Trevor Ariza,31-189,F,1/5/17,HOU,OKC,1,35,4,14,0.286,2,6,0.333,2,8,0.25,0,0,,1,2,3,1,1,1,0,1,10,5.1
Marquese Chriss,19-144,F,11/23/16,PHO,ORL,1,17,3,4,0.75,2,3,0.667,1,1,1,3,4,0.75,1,2,3,0,1,1,0,2,10,10.2
Anthony Tolliver,31-228,F-C,1/15/17,SAC,OKC,1,32,4,6,0.667,2,2,1,2,4,0.5,0,0,,0,4,4,2,2,1,2,3,10,9.5
Raymond Felton,32-207,G,1/19/17,LAC,MIN,1,34,5,12,0.417,5,9,0.556,0,3,0,0,0,,1,3,4,8,2,0,0,3,10,11.6
Devin Harris,33-323,G,1/15/17,DAL,MIN,0,16,2,4,0.5,2,2,1,0,2,0,6,6,1,1,2,3,3,0,0,0,0,10,11.4
David West,36-115,F,12/22/16,GSW,BRK,0,16,4,5,0.8,4,5,0.8,0,0,,2,2,1,1,5,6,2,1,2,3,2,10,10.3
Patrick Patterson,27-277,F,12/16/16,TOR,ATL,0,35,4,8,0.5,2,4,0.5,2,4,0.5,0,0,,3,2,5,2,2,0,0,3,10,10.9
Michael Kidd-Gilchrist,23-197,F,4/11/17,CHO,ATL,1,20,4,10,0.4,4,10,0.4,0,0,,2,2,1,3,3,6,1,1,0,0,4,10,7.7
T.J. McConnell,25-014,G,4/8/17,PHI,MIL,1,34,3,7,0.429,3,7,0.429,0,0,,4,4,1,1,1,2,10,3,0,4,1,10,12.9
Rodney McGruder,25-194,G,2/8/17,MIA,MIL,1,36,4,13,0.308,2,5,0.4,2,8,0.25,0,0,,3,3,6,3,1,0,1,1,10,7.2
Monta Ellis,31-110,G,2/13/17,IND,SAS,0,30,4,10,0.4,3,8,0.375,1,2,0.5,1,2,0.5,0,2,2,4,2,0,2,2,10,6.8
JaMychal Green,26-130,F,10/29/16,MEM,NYK,1,30,5,12,0.417,5,9,0.556,0,3,0,0,0,,1,7,8,0,0,1,0,6,10,4.7
Kosta Koufos,27-348,C,2/6/17,SAC,CHI,1,21,5,5,1,5,5,1,0,0,,0,0,,0,2,2,1,0,3,1,4,10,9.3
Derrick Favors,25-226,F-C,2/26/17,UTA,WAS,1,24,5,9,0.556,5,9,0.556,0,0,,0,0,,3,3,6,0,1,4,2,3,10,9.3
Maurice Harkless,23-263,F-G,1/29/17,POR,GSW,0,21,5,9,0.556,5,7,0.714,0,2,0,0,0,,1,1,2,2,2,0,1,3,10,7.9
Ian Clark,25-309,G,1/10/17,GSW,MIA,0,22,4,9,0.444,2,6,0.333,2,3,0.667,0,0,,0,1,1,3,0,0,1,3,10,5.5
Nikola Mirotic,25-273,F,11/10/16,CHI,MIA,0,22,3,7,0.429,1,4,0.25,2,3,0.667,2,2,1,1,4,5,1,0,0,0,3,10,7.7
Kevin Durant,28-128,F-G,2/4/17,GSW,SAC,1,42,2,10,0.2,2,4,0.5,0,6,0,6,7,0.857,0,9,9,2,1,5,3,0,10,9
Marcus Thornton,29-164,G,11/16/16,WAS,PHI,0,37,4,13,0.308,2,7,0.286,2,6,0.333,0,0,,0,2,2,6,0,0,1,4,10,4.7
Marcelo Huertas,33-196,G,12/7/16,LAL,HOU,1,31,3,7,0.429,3,3,1,0,4,0,4,4,1,0,3,3,7,5,0,6,3,10,9.9
Maurice Harkless,23-193,F-G,11/20/16,POR,BRK,1,22,5,7,0.714,5,5,1,0,2,0,0,0,,2,2,4,0,0,0,2,2,10,6.3
Kelly Oubre,21-122,F,4/10/17,WAS,DET,1,37,2,10,0.2,2,10,0.2,0,0,,6,8,0.75,1,5,6,1,1,1,1,1,10,6.2
Bobby Portis,21-310,F,12/16/16,CHI,MIL,0,19,4,8,0.5,2,6,0.333,2,2,1,0,2,0,2,6,8,0,0,0,1,0,10,7.4
Nemanja Bjelica,28-251,F,1/15/17,MIN,DAL,0,22,4,7,0.571,4,4,1,0,3,0,2,3,0.667,1,3,4,1,1,0,1,2,10,7.8
Spencer Dinwiddie,23-289,G,1/20/17,BRK,NOP,1,28,2,4,0.5,1,3,0.333,1,1,1,5,6,0.833,0,2,2,4,0,0,2,4,10,7.4
Derrick Williams,25-274,F,2/23/17,CLE,NYK,0,27,4,8,0.5,2,3,0.667,2,5,0.4,0,0,,0,1,1,2,1,0,0,1,10,8.3
Marcin Gortat,32-278,C-F,11/21/16,WAS,PHO,1,38,5,9,0.556,5,9,0.556,0,0,,0,2,0,4,9,13,1,0,1,2,5,10,7.8
Deron Williams,32-251,G,3/4/17,CLE,MIA,1,27,4,11,0.364,4,7,0.571,0,4,0,2,2,1,0,5,5,7,0,0,2,0,10,8.3
C.J. Watson,32-300,G,2/11/17,ORL,DAL,1,29,3,7,0.429,2,5,0.4,1,2,0.5,3,4,0.75,0,2,2,5,2,0,3,1,10,8.6
Leandro Barbosa,34-036,G,1/3/17,PHO,MIA,0,13,4,5,0.8,2,3,0.667,2,2,1,0,0,,0,0,0,1,1,0,1,3,10,7.6
DeMarre Carroll,30-134,F,12/8/16,TOR,MIN,1,33,3,7,0.429,0,1,0,3,6,0.5,1,2,0.5,1,4,5,2,2,0,1,4,10,8.6
Richaun Holmes,23-052,F-C,12/6/16,PHI,MEM,1,34,5,13,0.385,5,11,0.455,0,2,0,0,1,0,3,3,6,2,1,3,2,4,10,6.4
Austin Rivers,24-180,G,1/28/17,LAC,GSW,1,38,3,11,0.273,2,7,0.286,1,4,0.25,3,6,0.5,0,2,2,6,1,0,1,3,10,5.9
Elfrid Payton,22-298,G,12/16/16,ORL,BRK,0,21,4,11,0.364,4,10,0.4,0,1,0,2,2,1,0,5,5,5,0,0,1,2,10,7.1
Patty Mills,28-220,G,3/19/17,SAS,SAC,0,18,2,7,0.286,0,0,,2,7,0.286,4,4,1,0,1,1,7,3,0,1,2,10,12.3
Trevor Ariza,31-186,F,1/2/17,HOU,WAS,1,44,4,10,0.4,2,4,0.5,2,6,0.333,0,0,,0,6,6,5,3,2,0,1,10,13.9
Larry Nance Jr.,24-098,F,4/9/17,LAL,MIN,1,34,5,7,0.714,5,6,0.833,0,1,0,0,0,,6,4,10,6,1,2,2,3,10,15.9
Alex Len,23-200,C,1/2/17,PHO,LAC,0,20,5,10,0.5,5,10,0.5,0,0,,0,0,,4,3,7,0,1,0,0,2,10,8.9
Brandon Ingram,19-071,F,11/12/16,LAL,NOP,0,22,4,7,0.571,4,7,0.571,0,0,,2,3,0.667,0,0,0,4,1,0,0,1,10,9.7
Jonas Valanciunas,24-285,C,2/15/17,TOR,CHO,1,20,4,6,0.667,4,6,0.667,0,0,,2,2,1,1,9,10,1,1,0,2,1,10,10.1
Shabazz Muhammad,24-051,F-G,1/3/17,MIN,PHI,0,19,3,6,0.5,2,5,0.4,1,1,1,3,4,0.75,1,4,5,0,1,0,2,2,10,6.7
Jordan Crawford,28-143,G,3/15/17,NOP,MIA,0,21,4,9,0.444,2,5,0.4,2,4,0.5,0,0,,1,3,4,3,1,0,2,0,10,8
Raymond Felton,32-216,G,1/28/17,LAC,GSW,0,28,3,12,0.25,1,7,0.143,2,5,0.4,2,2,1,2,5,7,5,0,1,3,1,10,6.5
Malcolm Brogdon,23-335,G,11/10/16,MIL,NOP,0,22,4,6,0.667,4,6,0.667,0,0,,2,2,1,0,3,3,3,1,0,2,0,10,9.4
Allen Crabbe,24-350,G-F,3/25/17,POR,MIN,0,21,4,7,0.571,2,3,0.667,2,4,0.5,0,0,,0,3,3,0,0,2,1,3,10,6.8
Otto Porter,23-242,F,1/31/17,WAS,NYK,1,29,5,9,0.556,5,6,0.833,0,3,0,0,1,0,0,6,6,3,1,0,1,4,10,7.6
Ian Clark,25-278,G,12/10/16,GSW,MEM,0,23,5,9,0.556,5,7,0.714,0,2,0,0,1,0,0,3,3,2,0,1,0,1,10,7.9
Joe Ingles,29-167,F-G,3/18/17,UTA,CHI,1,36,4,9,0.444,3,4,0.75,1,5,0.2,1,2,0.5,1,2,3,5,0,0,0,3,10,8.5
Evan Fournier,24-038,G-F,12/6/16,ORL,WAS,1,28,4,10,0.4,2,4,0.5,2,6,0.333,0,0,,0,3,3,1,0,0,5,5,10,-0.8
Tobias Harris,24-157,F,12/19/16,DET,CHI,1,26,4,11,0.364,3,7,0.429,1,4,0.25,1,1,1,1,3,4,1,0,0,2,0,10,4.2
Tim Frazier,26-050,G,12/21/16,NOP,OKC,0,29,4,9,0.444,4,7,0.571,0,2,0,2,2,1,0,3,3,5,1,0,0,1,10,10.3
Michael Beasley,27-301,F,11/5/16,MIL,SAC,0,16,5,10,0.5,5,9,0.556,0,1,0,0,0,,1,3,4,0,1,0,0,0,10,7.6
Kris Dunn,23-025,G,4/12/17,MIN,HOU,1,32,5,13,0.385,5,11,0.455,0,2,0,0,0,,0,2,2,16,1,2,3,4,10,12.5
Robin Lopez,28-230,C,11/17/16,CHI,UTA,1,38,5,16,0.313,5,16,0.313,0,0,,0,0,,7,5,12,0,0,2,0,2,10,7.8
Andre Drummond,23-108,C,11/26/16,DET,OKC,1,36,5,10,0.5,5,10,0.5,0,0,,0,0,,2,6,8,2,3,0,0,2,10,11.8
Semaj Christon,24-139,G,3/20/17,OKC,GSW,0,22,4,4,1,3,3,1,1,1,1,1,2,0.5,0,2,2,1,1,0,0,1,10,10.3
Al Jefferson,31-350,C-F,12/19/16,IND,WAS,0,15,5,10,0.5,5,10,0.5,0,0,,0,0,,0,2,2,0,0,1,0,3,10,5.1
Justin Holiday,28-004,G,4/9/17,NYK,TOR,1,40,4,13,0.308,2,7,0.286,2,6,0.333,0,0,,1,4,5,5,1,1,0,1,10,9.2
James Young,21-183,G-F,2/15/17,BOS,PHI,0,22,4,7,0.571,3,5,0.6,1,2,0.5,1,1,1,1,2,3,0,1,1,0,2,10,8.9
Paul Millsap,32-060,F,4/11/17,ATL,CHO,1,22,5,10,0.5,5,9,0.556,0,1,0,0,0,,0,7,7,0,0,0,4,3,10,1.9
Thaddeus Young,28-130,F,10/29/16,IND,CHI,1,27,5,8,0.625,5,6,0.833,0,2,0,0,0,,1,4,5,3,2,0,1,0,10,11.4
Ricky Rubio,26-082,G,1/11/17,MIN,HOU,1,35,1,5,0.2,1,3,0.333,0,2,0,8,8,1,0,3,3,17,1,0,1,2,10,18.9
Trevor Booker,29-074,F,2/7/17,BRK,CHO,0,24,5,11,0.455,5,9,0.556,0,2,0,0,0,,1,11,12,3,0,0,3,3,10,6.2
D.J. Augustin,29-046,G,12/26/16,ORL,MEM,1,20,4,8,0.5,2,6,0.333,2,2,1,0,0,,0,0,0,7,1,0,1,2,10,10.1
Tony Snell,25-097,G-F,2/15/17,MIL,BRK,1,33,4,7,0.571,2,2,1,2,5,0.4,0,0,,1,5,6,3,2,1,1,0,10,12.7
Wilson Chandler,29-270,F,2/4/17,DEN,SAS,1,26,4,11,0.364,2,5,0.4,2,6,0.333,0,0,,0,2,2,1,1,0,5,3,10,0
Jonas Valanciunas,24-309,C,3/11/17,TOR,MIA,1,21,5,6,0.833,5,6,0.833,0,0,,0,0,,4,6,10,0,0,0,1,2,10,10.6
Kentavious Caldwell-Pope,23-358,G,2/10/17,DET,SAS,1,35,5,12,0.417,5,8,0.625,0,4,0,0,0,,0,4,4,3,1,0,1,1,10,6.5
Seth Curry,26-078,G,11/9/16,DAL,GSW,1,35,4,17,0.235,2,8,0.25,2,9,0.222,0,1,0,0,1,1,9,5,2,3,3,10,8.1
Tobias Harris,24-152,F,12/14/16,DET,DAL,1,27,5,10,0.5,5,9,0.556,0,1,0,0,1,0,1,1,2,1,1,0,2,1,10,4.9
David Lee,33-289,F,2/12/17,SAS,NYK,0,21,5,8,0.625,5,8,0.625,0,0,,0,0,,4,3,7,1,1,0,2,1,10,9.4
J.R. Smith,31-190,G-F,3/18/17,CLE,LAC,1,28,4,17,0.235,4,10,0.4,0,7,0,2,4,0.5,0,6,6,1,0,0,0,0,10,1.4
Jon Leuer,27-272,F,2/10/17,DET,SAS,1,35,4,9,0.444,4,8,0.5,0,1,0,2,2,1,0,2,2,3,0,0,2,3,10,4.8
Patrick Patterson,27-243,F,11/12/16,TOR,NYK,0,28,3,8,0.375,1,1,1,2,7,0.286,2,2,1,0,5,5,2,1,0,0,3,10,8.3
Ish Smith,28-119,G,11/1/16,DET,NYK,1,32,5,14,0.357,5,14,0.357,0,0,,0,0,,0,2,2,8,1,0,1,4,10,6.8
Thaddeus Young,28-144,F,11/12/16,IND,BOS,1,24,5,8,0.625,5,6,0.833,0,2,0,0,2,0,4,4,8,3,2,1,1,2,10,12.6
Gorgui Dieng,26-325,C,12/8/16,MIN,TOR,1,33,4,9,0.444,4,8,0.5,0,1,0,2,2,1,1,6,7,3,1,0,2,4,10,7.3
Michael Kidd-Gilchrist,23-058,F,11/23/16,CHO,SAS,1,29,5,11,0.455,5,11,0.455,0,0,,0,1,0,0,3,3,2,0,1,0,4,10,5.3
Mirza Teletovic,31-181,F,3/18/17,MIL,GSW,0,22,4,8,0.5,4,6,0.667,0,2,0,2,2,1,0,3,3,0,1,0,0,4,10,6.3
Marcin Gortat,32-329,C-F,1/11/17,WAS,BOS,1,32,5,8,0.625,5,8,0.625,0,0,,0,0,,5,4,9,2,0,0,1,0,10,11.5
J.J. Redick,32-173,G,12/14/16,LAC,ORL,1,29,3,11,0.273,0,5,0,3,6,0.5,1,1,1,0,3,3,0,0,0,0,1,10,4
Mike Conley,29-136,G,2/24/17,MEM,IND,1,32,5,9,0.556,5,6,0.833,0,3,0,0,4,0,1,4,5,7,0,0,1,2,10,9.1
Mason Plumlee,27-011,C-F,3/16/17,DEN,LAC,1,30,5,9,0.556,5,9,0.556,0,0,,0,2,0,2,7,9,6,0,2,1,3,10,11.8
Lucas Nogueira,24-171,C,1/13/17,TOR,BRK,1,30,5,5,1,5,5,1,0,0,,0,1,0,2,7,9,2,0,4,2,2,10,13
E'Twaun Moore,27-364,G,2/26/17,NOP,OKC,0,27,3,8,0.375,1,6,0.167,2,2,1,2,2,1,0,1,1,0,4,0,1,1,10,8.5
Michael Carter-Williams,25-099,G,1/17/17,CHI,DAL,1,21,4,6,0.667,2,4,0.5,2,2,1,0,0,,0,5,5,1,2,0,2,2,10,8.8
Spencer Dinwiddie,23-296,G,1/27/17,BRK,CLE,1,26,3,5,0.6,1,3,0.333,2,2,1,2,2,1,0,1,1,1,0,0,0,2,10,7.9
Rakeem Christmas,25-088,F,2/27/17,IND,HOU,0,20,4,5,0.8,4,5,0.8,0,0,,2,2,1,1,2,3,0,0,0,1,3,10,7.2
Mike Muscala,25-285,F-C,4/12/17,ATL,IND,0,20,3,7,0.429,1,3,0.333,2,4,0.5,2,2,1,0,3,3,2,0,1,1,1,10,7.9
Michael Carter-Williams,25-084,G,1/2/17,CHI,CHO,1,31,4,12,0.333,4,10,0.4,0,2,0,2,2,1,1,8,9,3,0,1,1,5,10,6.1
Paul Millsap,31-266,F,11/2/16,ATL,LAL,1,35,3,10,0.3,2,6,0.333,1,4,0.25,3,4,0.75,1,6,7,2,1,0,3,2,10,4.9
Dwyane Wade,35-046,G,3/4/17,CHI,LAC,1,33,2,11,0.182,1,10,0.1,1,1,1,5,6,0.833,1,5,6,3,1,0,2,3,10,4.8
Kelly Oubre,20-355,F,11/28/16,WAS,SAC,0,24,2,3,0.667,2,2,1,0,1,0,6,6,1,4,7,11,2,2,0,1,2,10,15.2
Kyle O'Quinn,26-307,F-C,1/27/17,NYK,CHO,0,16,4,7,0.571,3,6,0.5,1,1,1,1,1,1,2,5,7,2,0,3,1,1,10,11.7
Andre Drummond,23-229,C,3/27/17,DET,NYK,1,25,5,7,0.714,5,7,0.714,0,0,,0,4,0,5,10,15,3,0,0,1,1,10,12.7
Marcin Gortat,32-328,C-F,1/10/17,WAS,CHI,1,42,5,8,0.625,5,8,0.625,0,0,,0,0,,3,9,12,0,1,1,3,4,10,8.3
Brandon Bass,31-264,F,1/19/17,LAC,MIN,0,19,5,5,1,5,5,1,0,0,,0,1,0,1,3,4,4,1,0,2,2,10,10.7
E'Twaun Moore,28-038,G,4/7/17,NOP,DEN,1,18,4,7,0.571,2,3,0.667,2,4,0.5,0,0,,0,2,2,1,1,0,2,1,10,6.6
Dante Exum,21-265,G,4/4/17,UTA,POR,1,25,4,7,0.571,3,4,0.75,1,3,0.333,1,2,0.5,0,3,3,1,1,0,1,3,10,6.7
Yogi Ferrell,23-200,G,11/25/16,BRK,IND,0,21,3,9,0.333,1,3,0.333,2,6,0.333,2,4,0.5,0,2,2,0,1,0,3,2,10,1.9
Robert Covington,26-044,F,1/27/17,PHI,HOU,1,36,2,5,0.4,2,3,0.667,0,2,0,6,7,0.857,0,5,5,2,2,0,3,3,10,7.6
Patty Mills,28-232,G,3/31/17,SAS,OKC,0,25,3,6,0.5,0,1,0,3,5,0.6,1,2,0.5,0,3,3,2,0,0,1,2,10,7.1
Mario Hezonja,21-307,F-G,12/28/16,ORL,CHO,0,12,4,6,0.667,2,2,1,2,4,0.5,0,0,,0,2,2,1,0,1,1,3,10,7.2
DeMarre Carroll,30-105,F,11/9/16,TOR,OKC,1,22,4,6,0.667,2,3,0.667,2,3,0.667,0,0,,1,3,4,0,0,0,1,1,10,7.6
Channing Frye,33-236,C-F,1/8/17,CLE,PHO,0,18,4,8,0.5,2,2,1,2,6,0.333,0,0,,0,4,4,0,0,0,0,1,10,6.8
Austin Rivers,24-237,G,3/26/17,LAC,SAC,1,43,4,13,0.308,2,6,0.333,2,7,0.286,0,0,,1,8,9,4,0,0,2,3,10,5.2
Gary Harris,22-103,G,12/26/16,DEN,LAC,1,31,2,9,0.222,1,5,0.2,1,4,0.25,5,6,0.833,1,3,4,1,0,0,0,2,10,5.6
Channing Frye,33-305,C-F,3/18/17,CLE,LAC,1,28,4,10,0.4,2,3,0.667,2,7,0.286,0,0,,0,4,4,1,0,0,0,4,10,4.9
Lucas Nogueira,24-106,C,11/9/16,TOR,OKC,0,29,5,5,1,5,5,1,0,0,,0,0,,2,5,7,1,2,2,0,5,10,13.5
David West,36-216,F,4/2/17,GSW,WAS,0,18,3,4,0.75,3,4,0.75,0,0,,4,4,1,1,2,3,2,1,2,3,2,10,9.7
Bismack Biyombo,24-152,C-F,1/27/17,ORL,BOS,0,25,5,8,0.625,5,8,0.625,0,0,,0,1,0,0,7,7,3,0,0,1,2,10,8.4
Troy Williams,21-336,F,11/30/16,MEM,TOR,1,28,4,10,0.4,4,6,0.667,0,4,0,2,3,0.667,0,0,0,2,3,0,3,4,10,4
Norman Powell,23-308,G,3/29/17,TOR,CHO,0,19,2,6,0.333,1,1,1,1,5,0.2,5,8,0.625,0,3,3,0,1,0,3,1,10,3.9
Andre Iguodala,32-314,G-F,12/7/16,GSW,LAC,0,25,5,8,0.625,5,6,0.833,0,2,0,0,0,,1,5,6,2,0,2,0,0,10,11.4
Rodney McGruder,25-119,G,11/25/16,MIA,MEM,1,32,4,10,0.4,2,4,0.5,2,6,0.333,0,0,,1,2,3,2,1,1,3,4,10,4.4
J.J. Redick,32-252,G,3/3/17,LAC,MIL,1,31,4,8,0.5,3,6,0.5,1,2,0.5,1,1,1,0,3,3,4,0,0,3,1,10,6.3
Jodie Meeks,29-213,G,3/22/17,ORL,CHO,0,15,3,6,0.5,0,2,0,3,4,0.75,1,2,0.5,0,2,2,0,0,0,0,1,10,6.8
Jeremy Lin,28-122,G,12/23/16,BRK,CLE,1,25,5,10,0.5,5,8,0.625,0,2,0,0,0,,0,2,2,6,1,0,5,1,10,5.4
Derrick Jones,20-046,F,4/2/17,PHO,HOU,1,34,5,8,0.625,5,7,0.714,0,1,0,0,0,,5,3,8,1,2,1,2,4,10,10.6
DeAndre Jordan,28-174,C,1/11/17,LAC,ORL,1,32,4,8,0.5,4,8,0.5,0,0,,2,4,0.5,8,12,20,1,2,3,1,3,10,17
Dario Saric,22-343,F,3/17/17,PHI,DAL,1,26,3,9,0.333,3,7,0.429,0,2,0,4,4,1,1,6,7,5,1,1,0,1,10,12.2
Brandon Jennings,27-178,G,3/20/17,WAS,BOS,0,15,3,7,0.429,2,4,0.5,1,3,0.333,3,3,1,0,1,1,7,0,0,0,1,10,11.1
Jeremy Lamb,24-194,G-F,12/10/16,CHO,CLE,0,13,3,7,0.429,2,5,0.4,1,2,0.5,3,3,1,2,3,5,2,0,0,0,0,10,10
Matt Barnes,37-017,F,3/26/17,GSW,MEM,0,26,3,6,0.5,2,3,0.667,1,3,0.333,3,3,1,0,4,4,2,0,1,4,4,10,4.7
D.J. Augustin,29-071,G,1/20/17,ORL,MIL,0,28,3,9,0.333,2,3,0.667,1,6,0.167,3,4,0.75,0,2,2,8,0,0,1,1,10,9.3
Victor Oladipo,24-343,G,4/12/17,OKC,DEN,1,25,4,9,0.444,3,7,0.429,1,2,0.5,1,2,0.5,0,3,3,3,1,1,3,0,10,6.6
Ivica Zubac,20-008,C,3/26/17,LAL,POR,1,26,4,9,0.444,4,7,0.571,0,2,0,2,2,1,0,7,7,2,0,0,1,3,10,6.6
Jeff Teague,28-187,G,12/14/16,IND,MIA,1,29,3,9,0.333,2,6,0.333,1,3,0.333,3,3,1,0,3,3,5,2,0,1,5,10,8.3
James Michael McAdoo,24-024,F,1/28/17,GSW,LAC,0,19,5,8,0.625,5,8,0.625,0,0,,0,0,,3,1,4,1,1,0,2,2,10,7.7
Isaiah Whitehead,22-004,G,3/12/17,BRK,NYK,0,26,4,10,0.4,2,5,0.4,2,5,0.4,0,0,,0,3,3,2,2,0,1,3,10,6.7
Anthony Morrow,31-178,G,3/24/17,CHI,PHI,0,18,3,6,0.5,2,4,0.5,1,2,0.5,3,3,1,0,0,0,0,0,0,0,0,10,7
Jonas Valanciunas,24-180,C,11/2/16,TOR,WAS,1,31,4,6,0.667,4,6,0.667,0,0,,2,2,1,0,7,7,3,0,0,1,5,10,8.6
Yogi Ferrell,23-278,G,2/11/17,DAL,ORL,0,32,4,8,0.5,2,5,0.4,2,3,0.667,0,0,,0,3,3,6,0,0,3,3,10,6.9
Brandon Knight,25-005,G,12/7/16,PHO,IND,0,25,3,10,0.3,1,5,0.2,2,5,0.4,2,2,1,1,2,3,3,1,0,1,1,10,7.2
Kyle Korver,35-255,G-F,11/27/16,ATL,LAL,1,32,3,10,0.3,1,2,0.5,2,8,0.25,2,2,1,0,4,4,2,0,0,2,2,10,4
Amir Johnson,29-271,F,1/27/17,BOS,ORL,1,22,5,6,0.833,5,6,0.833,0,0,,0,0,,0,4,4,3,0,1,0,0,10,11.8
Brandon Bass,31-261,F,1/16/17,LAC,OKC,0,18,4,6,0.667,4,6,0.667,0,0,,2,2,1,2,4,6,0,1,0,1,2,10,9.2
Rashad Vaughn,20-207,G,3/11/17,MIL,MIN,0,23,5,9,0.556,5,7,0.714,0,2,0,0,0,,0,1,1,2,1,1,0,3,10,7.9
Kevin Seraphin,27-027,F,1/3/17,IND,DET,0,15,4,5,0.8,4,5,0.8,0,0,,2,2,1,2,3,5,1,1,0,0,0,10,12.1
Aron Baynes,30-061,C,2/8/17,DET,LAL,0,16,4,7,0.571,4,7,0.571,0,0,,2,2,1,2,4,6,0,0,1,1,4,10,7.4
Greg Monroe,26-312,C-F,4/12/17,MIL,BOS,0,17,3,7,0.429,3,5,0.6,0,2,0,4,5,0.8,0,6,6,4,0,0,3,1,10,7.1
Andre Roberson,24-362,G-F,11/30/16,OKC,WAS,1,35,4,6,0.667,2,3,0.667,2,3,0.667,0,0,,0,5,5,0,2,2,1,4,10,9.7
D.J. Augustin,29-030,G,12/10/16,ORL,DEN,1,24,3,8,0.375,1,3,0.333,2,5,0.4,2,2,1,0,1,1,7,1,0,0,3,10,10.6
Brandan Wright,29-162,F-C,3/16/17,MEM,ATL,0,14,3,4,0.75,3,4,0.75,0,0,,4,4,1,3,0,3,1,0,0,0,2,10,10.4
Larry Nance Jr.,23-343,F,12/9/16,LAL,PHO,0,21,4,8,0.5,4,7,0.571,0,1,0,2,3,0.667,1,4,5,0,1,2,0,3,10,8.7
Cristiano Felicio,24-233,F-C,2/25/17,CHI,CLE,0,24,4,6,0.667,4,6,0.667,0,0,,2,3,0.667,4,1,5,1,0,0,1,3,10,8.6
Wayne Ellington,29-041,G,12/9/16,MIA,CLE,1,33,4,12,0.333,2,3,0.667,2,9,0.222,0,0,,0,1,1,2,0,0,1,3,10,2.7
Jason Smith,31-023,F-C,3/25/17,WAS,CLE,0,16,4,4,1,2,2,1,2,2,1,0,0,,2,4,6,0,0,0,1,4,10,8.8
Patrick Beverley,28-134,G,11/23/16,HOU,TOR,1,35,4,6,0.667,2,3,0.667,2,3,0.667,0,0,,4,6,10,4,1,0,4,5,10,9.8
D.J. Augustin,29-083,G,2/1/17,ORL,IND,0,21,3,6,0.5,2,4,0.5,1,2,0.5,3,4,0.75,1,0,1,2,1,0,3,1,10,6.3
Kelly Oubre,21-110,F,3/29/17,WAS,LAC,0,25,3,4,0.75,3,3,1,0,1,0,4,5,0.8,2,4,6,0,2,0,1,5,10,9.6
J.J. Redick,32-138,G,11/9/16,LAC,POR,1,18,3,5,0.6,2,3,0.667,1,2,0.5,3,4,0.75,0,1,1,0,1,0,1,2,10,6.8
DeMarre Carroll,30-107,F,11/11/16,TOR,CHO,1,23,4,7,0.571,4,5,0.8,0,2,0,2,2,1,0,4,4,1,0,0,0,2,10,7.8
Dwight Howard,30-340,C,11/12/16,ATL,PHI,1,28,5,7,0.714,5,7,0.714,0,0,,0,1,0,5,6,11,2,1,0,0,4,10,12.8
Andrew Harrison,22-062,G,12/29/16,MEM,OKC,1,31,3,7,0.429,1,5,0.2,2,2,1,2,2,1,1,1,2,3,0,1,3,3,10,5.9
Nemanja Bjelica,28-222,F,12/17/16,MIN,HOU,0,15,4,6,0.667,2,3,0.667,2,3,0.667,0,0,,1,3,4,0,0,0,1,2,10,7.2
Spencer Dinwiddie,23-294,G,1/25/17,BRK,MIA,1,33,4,8,0.5,3,5,0.6,1,3,0.333,1,2,0.5,0,5,5,4,0,0,1,3,10,7.7
Archie Goodwin,22-219,G,3/24/17,BRK,WAS,0,14,3,3,1,3,3,1,0,0,,4,5,0.8,0,0,0,3,0,0,1,1,10,9.4
Sam Dekker,22-194,F,11/16/16,HOU,OKC,0,19,4,5,0.8,2,3,0.667,2,2,1,0,0,,0,2,2,2,1,0,1,1,10,9.7
Skal Labissiere,20-353,F,3/6/17,SAC,DEN,0,20,4,8,0.5,4,8,0.5,0,0,,2,2,1,3,4,7,0,0,0,2,2,10,6.5
Jordan Clarkson,24-292,G,3/26/17,LAL,POR,1,37,4,16,0.25,3,12,0.25,1,4,0.25,1,2,0.5,0,7,7,6,0,0,3,1,10,2.9
Trevor Booker,28-338,F,10/28/16,BRK,IND,1,27,5,11,0.455,5,9,0.556,0,2,0,0,0,,2,9,11,2,1,0,1,4,10,8.2
Dario Saric,22-361,F,4/4/17,PHI,BRK,1,19,4,9,0.444,3,4,0.75,1,5,0.2,1,2,0.5,1,2,3,2,1,0,2,1,10,6.2
Joel Embiid,22-246,C-F,11/17/16,PHI,MIN,1,22,4,9,0.444,4,8,0.5,0,1,0,2,4,0.5,4,6,10,0,0,1,2,3,10,6.6
Anthony Tolliver,31-191,F-C,12/9/16,SAC,NYK,0,27,4,9,0.444,2,3,0.667,2,6,0.333,0,0,,1,4,5,2,0,0,1,3,10,6.4
Kris Humphries,31-300,F-C,12/2/16,ATL,DET,0,19,3,12,0.25,2,10,0.2,1,2,0.5,3,4,0.75,3,2,5,0,0,0,0,0,10,5.1
Enes Kanter,24-326,C,4/11/17,OKC,MIN,0,18,3,10,0.3,3,10,0.3,0,0,,4,8,0.5,5,3,8,1,0,0,2,2,10,4.9
Dante Exum,21-143,G,12/3/16,UTA,DEN,1,22,3,7,0.429,3,4,0.75,0,3,0,4,4,1,0,2,2,2,0,0,0,1,10,7.9
Kris Humphries,31-321,F-C,12/23/16,ATL,DEN,1,22,4,10,0.4,4,9,0.444,0,1,0,2,2,1,3,5,8,2,0,1,1,4,10,7.7
Dante Exum,21-261,G,3/31/17,UTA,WAS,1,25,4,6,0.667,2,3,0.667,2,3,0.667,0,0,,1,3,4,2,0,0,1,2,10,8.6
Zach Randolph,35-109,F,11/2/16,MEM,NOP,0,20,5,18,0.278,5,16,0.313,0,2,0,0,1,0,4,7,11,0,0,0,2,3,10,0.7
Dwight Powell,25-236,F-C,3/13/17,DAL,TOR,0,21,4,9,0.444,4,9,0.444,0,0,,2,3,0.667,3,7,10,0,0,1,1,2,10,8
Elfrid Payton,23-023,G,3/17/17,ORL,PHO,1,31,4,9,0.444,4,9,0.444,0,0,,2,2,1,0,4,4,11,3,0,1,4,10,14.6
Khris Middleton,25-237,F-G,4/6/17,MIL,IND,1,34,4,10,0.4,3,8,0.375,1,2,0.5,1,1,1,0,3,3,4,2,0,3,6,10,4.9
Isaiah Whitehead,21-326,G,1/28/17,BRK,MIN,0,27,3,9,0.333,3,7,0.429,0,2,0,4,4,1,0,2,2,8,2,1,3,1,10,10.4
Tony Snell,25-120,G-F,3/10/17,MIL,IND,1,32,2,5,0.4,1,3,0.333,1,2,0.5,5,5,1,0,1,1,3,1,0,0,3,10,9.5
Rondae Hollis-Jefferson,22-007,F,1/10/17,BRK,ATL,1,20,2,9,0.222,2,9,0.222,0,0,,6,6,1,1,6,7,1,0,0,3,4,10,3.1
Seth Curry,26-210,G,3/21/17,DAL,GSW,1,27,4,12,0.333,3,8,0.375,1,4,0.25,1,1,1,0,3,3,4,1,0,2,1,10,5.5
Kosta Koufos,27-275,C,11/25/16,SAC,HOU,0,18,5,5,1,5,5,1,0,0,,0,0,,2,3,5,0,0,1,1,3,10,9.3
JaVale McGee,29-004,C,1/23/17,GSW,MIA,0,14,5,6,0.833,5,6,0.833,0,0,,0,1,0,1,4,5,1,1,0,0,2,10,10.2
Luc Mbah a Moute,30-073,F,11/21/16,LAC,TOR,1,24,4,5,0.8,2,2,1,2,3,0.667,0,0,,1,2,3,0,1,1,2,2,10,8.3
Bojan Bogdanovic,27-269,G-F,1/12/17,BRK,NOP,1,25,4,11,0.364,2,4,0.5,2,7,0.286,0,0,,0,3,3,2,1,0,2,1,10,4.8
Buddy Hield,23-032,G,1/18/17,NOP,ORL,1,24,4,11,0.364,2,3,0.667,2,8,0.25,0,1,0,0,4,4,3,0,0,1,2,10,5
Nemanja Bjelica,28-294,F,2/27/17,MIN,SAC,0,35,4,15,0.267,2,7,0.286,2,8,0.25,0,0,,4,8,12,2,2,0,0,3,10,8.5
Ron Baker,24-001,G,3/31/17,NYK,MIA,1,38,4,7,0.571,3,5,0.6,1,2,0.5,1,1,1,0,3,3,6,1,1,1,3,10,11.3
Marvin Williams,30-195,F,12/31/16,CHO,CLE,1,28,4,12,0.333,2,7,0.286,2,5,0.4,0,0,,0,4,4,1,1,2,0,3,10,6.3
Ben McLemore,23-302,G,12/9/16,SAC,NYK,1,22,4,7,0.571,2,5,0.4,2,2,1,0,0,,1,3,4,2,1,0,0,1,10,10.3
P.J. Tucker,31-272,F,2/1/17,PHO,LAC,0,34,3,9,0.333,1,6,0.167,2,3,0.667,2,2,1,4,10,14,2,1,1,0,5,10,11.8
Richaun Holmes,23-014,F-C,10/29/16,PHI,ATL,0,20,5,8,0.625,5,8,0.625,0,0,,0,0,,1,5,6,1,0,0,1,3,10,7.1
Rodney Stuckey,30-237,G,12/14/16,IND,MIA,0,22,3,12,0.25,2,10,0.2,1,2,0.5,3,4,0.75,0,5,5,3,0,0,1,1,10,4.6
DeAndre Jordan,28-187,C,1/24/17,LAC,PHI,1,31,3,4,0.75,3,4,0.75,0,0,,4,12,0.333,6,14,20,3,0,0,2,3,10,12.5
Tim Hardaway,24-322,G,2/1/17,ATL,MIA,1,26,2,9,0.222,0,4,0,2,5,0.4,4,4,1,0,4,4,2,0,0,0,0,10,7.1
Justin Anderson,23-027,G,12/16/16,DAL,UTA,0,18,2,6,0.333,0,2,0,2,4,0.5,4,5,0.8,2,1,3,0,0,0,0,4,10,6.3
Briante Weber,24-103,G,4/11/17,CHO,ATL,0,24,3,9,0.333,2,6,0.333,1,3,0.333,3,4,0.75,0,0,0,2,1,0,2,3,10,3.7
T.J. McConnell,25-006,G,3/31/17,PHI,CLE,1,28,4,9,0.444,4,9,0.444,0,0,,2,2,1,0,3,3,7,2,0,1,3,10,10.9
Kelly Oubre,21-041,F,1/19/17,WAS,NYK,0,25,3,6,0.5,2,2,1,1,4,0.25,3,3,1,0,3,3,1,0,0,0,4,10,7
Taj Gibson,31-269,F,3/20/17,OKC,GSW,1,21,5,10,0.5,5,10,0.5,0,0,,0,2,0,2,0,2,1,1,1,1,2,10,6.2
Willy Hernangomez,22-300,C,3/23/17,NYK,POR,1,21,5,10,0.5,5,10,0.5,0,0,,0,1,0,3,5,8,2,0,2,0,2,10,10.2
Derrick Favors,25-229,F-C,3/1/17,UTA,MIN,1,27,5,13,0.385,5,13,0.385,0,0,,0,0,,8,4,12,0,1,1,2,4,10,7.8
Buddy Hield,23-030,G,1/16/17,NOP,IND,1,15,4,5,0.8,2,2,1,2,3,0.667,0,0,,0,4,4,0,0,1,2,1,10,7.6
JaMychal Green,26-279,F,3/27/17,MEM,SAC,1,21,2,7,0.286,1,3,0.333,1,4,0.25,5,6,0.833,4,0,4,1,1,0,1,2,10,8.2
Markieff Morris,27-101,F,12/12/16,WAS,MIA,1,37,4,10,0.4,3,7,0.429,1,3,0.333,1,2,0.5,2,3,5,3,0,0,1,3,10,6.4
Wesley Johnson,29-152,F-G,12/10/16,LAC,NOP,0,22,4,6,0.667,2,2,1,2,4,0.5,0,0,,0,6,6,0,1,0,0,4,10,8.6
Jeff Green,30-129,F,1/4/17,ORL,ATL,0,21,3,4,0.75,2,3,0.667,1,1,1,3,4,0.75,0,1,1,1,0,1,0,2,10,8.9
Zach Randolph,35-233,F,3/6/17,MEM,BRK,0,16,4,12,0.333,4,12,0.333,0,0,,2,4,0.5,2,5,7,3,0,0,2,1,10,5
Elfrid Payton,22-250,G,10/29/16,ORL,CLE,1,34,5,11,0.455,5,9,0.556,0,2,0,0,2,0,0,4,4,5,0,1,0,3,10,7.7
Bojan Bogdanovic,27-347,G-F,3/31/17,WAS,UTA,0,20,4,7,0.571,4,6,0.667,0,1,0,2,2,1,0,4,4,2,0,0,0,2,10,8.5
Thabo Sefolosha,32-219,G-F,12/7/16,ATL,MIA,1,29,5,11,0.455,5,8,0.625,0,3,0,0,0,,3,2,5,5,1,0,0,0,10,11.5
Spencer Dinwiddie,23-356,G,3/28/17,BRK,PHI,0,18,2,6,0.333,1,4,0.25,1,2,0.5,5,8,0.625,2,2,4,5,1,0,1,0,10,10.9
Marreese Speights,29-229,C-F,3/21/17,LAC,LAL,0,19,4,8,0.5,2,4,0.5,2,4,0.5,0,0,,3,4,7,1,0,0,1,2,10,8.2
Wesley Matthews,30-115,G,2/6/17,DAL,DEN,1,34,3,8,0.375,2,5,0.4,1,3,0.333,3,4,0.75,0,7,7,8,1,0,1,3,10,11.7
Zach Randolph,35-125,F,11/18/16,MEM,DAL,0,22,4,12,0.333,4,10,0.4,0,2,0,2,2,1,2,6,8,3,0,0,1,0,10,7.5
Domantas Sabonis,20-268,F,1/26/17,OKC,DAL,1,29,3,4,0.75,2,3,0.667,1,1,1,3,4,0.75,0,5,5,0,1,0,2,3,10,7.3
Kevin Seraphin,27-036,F,1/12/17,IND,DEN,0,20,5,6,0.833,5,6,0.833,0,0,,0,0,,1,4,5,2,0,1,1,0,10,10.8
Robert Covington,26-035,F,1/18/17,PHI,TOR,1,36,4,6,0.667,3,4,0.75,1,2,0.5,1,2,0.5,0,5,5,2,2,1,5,2,10,6.8
Timofey Mozgov,30-136,C,11/29/16,LAL,NOP,1,21,5,8,0.625,5,8,0.625,0,0,,0,0,,4,5,9,0,0,2,2,2,10,9.3
Dwight Powell,25-128,F-C,11/25/16,DAL,CLE,0,12,4,6,0.667,4,5,0.8,0,1,0,2,2,1,0,1,1,3,0,1,1,1,10,9.1
Lou Williams,30-073,G,1/8/17,LAL,ORL,0,17,3,12,0.25,3,5,0.6,0,7,0,4,4,1,0,1,1,3,0,0,2,0,10,3.2
DeMarre Carroll,30-124,F,11/28/16,TOR,PHI,1,21,4,5,0.8,2,2,1,2,3,0.667,0,0,,1,4,5,3,1,2,0,2,10,13.7
Austin Rivers,24-219,G,3/8/17,LAC,MIN,0,29,3,10,0.3,1,6,0.167,2,4,0.5,2,3,0.667,0,2,2,3,0,1,1,2,10,5.4
Monta Ellis,31-045,G,12/10/16,IND,POR,1,19,2,3,0.667,2,2,1,0,1,0,6,7,0.857,0,0,0,5,0,0,0,1,10,11.4
Tristan Thompson,25-347,F-C,2/23/17,CLE,NYK,1,31,5,7,0.714,5,7,0.714,0,0,,0,0,,6,8,14,2,0,4,1,2,10,16.1
Robin Lopez,28-317,C,2/12/17,CHI,MIN,1,24,5,11,0.455,5,11,0.455,0,0,,0,1,0,3,1,4,2,0,1,1,3,10,6.2
Patty Mills,28-125,G,12/14/16,SAS,BOS,0,24,4,9,0.444,2,4,0.5,2,5,0.4,0,0,,0,0,0,2,1,0,2,1,10,5.3
Luke Babbitt,27-134,F,11/1/16,MIA,SAC,1,24,3,9,0.333,0,0,,3,9,0.333,1,1,1,0,2,2,0,1,0,0,2,10,5.7
Darrell Arthur,28-303,F,1/22/17,DEN,MIN,0,21,4,9,0.444,2,3,0.667,2,6,0.333,0,0,,1,3,4,4,0,3,1,4,10,9.2
Will Barton,26-071,G,3/18/17,DEN,HOU,0,33,2,13,0.154,1,4,0.25,1,9,0.111,5,9,0.556,0,1,1,4,0,0,1,3,10,1
Terrence Ross,26-026,F-G,3/3/17,ORL,MIA,1,35,5,9,0.556,5,7,0.714,0,2,0,0,0,,0,4,4,5,2,2,1,1,10,12.4
JaMychal Green,26-183,F,12/21/16,MEM,DET,1,28,3,10,0.3,1,6,0.167,2,4,0.5,2,2,1,3,6,9,2,0,0,1,4,10,6.9
Bobby Portis,22-059,F,4/10/17,CHI,ORL,0,14,4,5,0.8,2,2,1,2,3,0.667,0,0,,3,3,6,0,0,0,0,1,10,10.7
Dwight Powell,25-133,F-C,11/30/16,DAL,SAS,0,15,4,6,0.667,4,6,0.667,0,0,,2,2,1,2,2,4,0,1,0,1,2,10,8.6
Bradley Beal,23-178,G,12/23/16,WAS,MIL,1,31,3,10,0.3,2,5,0.4,1,5,0.2,3,3,1,1,1,2,6,0,1,3,2,10,6.3
Luol Deng,31-199,F,11/1/16,LAL,IND,1,21,5,10,0.5,5,9,0.556,0,1,0,0,0,,1,5,6,1,0,0,1,1,10,6.5
Marcus Smart,22-257,G,11/18/16,BOS,GSW,1,25,4,10,0.4,2,6,0.333,2,4,0.5,0,0,,0,0,0,1,2,0,2,0,10,5.3
Troy Daniels,25-263,G,4/4/17,MEM,SAS,0,30,4,9,0.444,2,3,0.667,2,6,0.333,0,1,0,2,4,6,2,0,0,1,2,10,7.1
Terrence Jones,24-306,F,11/10/16,NOP,MIL,1,34,2,6,0.333,2,5,0.4,0,1,0,6,6,1,3,4,7,0,0,1,0,2,10,9.8
Tyler Johnson,24-300,G,3/3/17,MIA,ORL,0,28,4,14,0.286,4,12,0.333,0,2,0,2,2,1,1,4,5,5,2,1,0,2,10,9.1
Alex Abrines,23-227,G-F,3/16/17,OKC,TOR,0,20,3,7,0.429,1,1,1,2,6,0.333,2,2,1,0,2,2,2,2,0,1,1,10,8.9
Jonas Valanciunas,24-315,C,3/17/17,TOR,DET,1,24,5,7,0.714,5,7,0.714,0,0,,0,0,,2,6,8,0,1,1,1,2,10,10.2
James Michael McAdoo,24-029,F,2/2/17,GSW,LAC,0,17,5,6,0.833,5,6,0.833,0,0,,0,0,,4,5,9,0,0,1,0,4,10,11.2
Robin Lopez,28-294,C,1/20/17,CHI,ATL,1,25,5,7,0.714,5,7,0.714,0,0,,0,0,,1,3,4,1,1,3,0,2,10,11.7
Michael Kidd-Gilchrist,23-197,F,4/11/17,CHO,ATL,1,20,4,10,0.4,4,10,0.4,0,0,,2,2,1,3,3,6,1,1,0,0,4,10,7.7
Maurice Harkless,23-191,F-G,11/18/16,POR,NOP,1,35,4,13,0.308,2,6,0.333,2,7,0.286,0,0,,2,4,6,1,0,0,2,1,10,3.4
Roy Hibbert,30-027,C,1/7/17,CHO,SAS,0,15,4,6,0.667,4,6,0.667,0,0,,2,2,1,1,4,5,0,0,0,1,1,10,7.9
Elfrid Payton,23-026,G,3/20/17,ORL,PHI,1,31,5,9,0.556,5,9,0.556,0,0,,0,0,,5,8,13,4,2,1,4,5,10,11.1
DeAndre Jordan,28-139,C,12/7/16,LAC,GSW,1,32,5,7,0.714,5,7,0.714,0,0,,0,4,0,5,7,12,0,0,2,0,3,10,11.3
Cory Joseph,25-157,G,1/24/17,TOR,SAS,0,26,5,6,0.833,5,6,0.833,0,0,,0,0,,0,3,3,2,2,0,1,2,10,10.3
Kevin Love,28-190,F,3/16/17,CLE,UTA,1,20,5,9,0.556,5,6,0.833,0,3,0,0,0,,2,7,9,0,0,0,1,0,10,8.2
Joe Ingles,29-080,F-G,12/21/16,UTA,SAC,1,39,3,9,0.333,1,2,0.5,2,7,0.286,2,2,1,1,3,4,5,2,0,2,4,10,8.4
Pau Gasol,36-167,F-C,12/20/16,SAS,HOU,1,26,5,8,0.625,5,8,0.625,0,0,,0,0,,1,9,10,2,0,2,2,3,10,9.4
JaMychal Green,26-155,F,11/23/16,MEM,PHI,1,34,4,6,0.667,3,5,0.6,1,1,1,1,2,0.5,3,8,11,1,0,1,1,3,10,10.7
Jeff Teague,28-271,G,3/8/17,IND,DET,1,24,2,5,0.4,2,4,0.5,0,1,0,6,6,1,1,4,5,6,0,0,3,1,10,10
Nikola Mirotic,25-363,F,2/8/17,CHI,GSW,0,24,3,10,0.3,1,2,0.5,2,8,0.25,2,2,1,0,2,2,1,1,1,2,4,10,3.6
Malcolm Brogdon,24-052,G,2/1/17,MIL,UTA,0,31,4,8,0.5,2,6,0.333,2,2,1,0,0,,1,2,3,4,3,0,3,1,10,9.7
Boris Diaw,34-359,F-C,4/10/17,UTA,GSW,1,25,3,7,0.429,3,6,0.5,0,1,0,4,4,1,0,2,2,5,1,0,1,0,10,10.4
Klay Thompson,26-304,G,12/8/16,GSW,UTA,1,28,5,13,0.385,5,9,0.556,0,4,0,0,0,,2,4,6,2,0,0,3,4,10,2.3
Kenneth Faried,27-014,F,12/3/16,DEN,UTA,1,29,4,8,0.5,4,8,0.5,0,0,,2,3,0.667,2,4,6,0,0,1,1,1,10,7.5
Taj Gibson,31-172,F,12/13/16,CHI,MIN,1,28,5,11,0.455,5,11,0.455,0,0,,0,0,,2,2,4,1,0,0,2,4,10,3.4
Zaza Pachulia,32-345,C,1/20/17,GSW,HOU,1,20,3,5,0.6,3,5,0.6,0,0,,4,6,0.667,2,7,9,2,2,0,1,4,10,11.2
Dewayne Dedmon,27-164,C,1/23/17,SAS,BRK,1,29,4,5,0.8,4,5,0.8,0,0,,2,2,1,1,7,8,1,1,1,2,4,10,9.7
Meyers Leonard,24-354,C-F,2/15/17,POR,UTA,1,23,4,8,0.5,2,4,0.5,2,4,0.5,0,0,,0,1,1,0,1,2,0,1,10,8.3
Channing Frye,33-241,C-F,1/13/17,CLE,SAC,0,19,3,7,0.429,1,2,0.5,2,5,0.4,2,2,1,0,0,0,1,3,0,0,4,10,8.4
Patrick Patterson,27-324,F,2/1/17,TOR,BOS,1,21,3,6,0.5,2,2,1,1,4,0.25,3,5,0.6,1,2,3,0,1,0,0,0,10,8.5
James Johnson,29-280,F,11/26/16,MIA,MEM,0,32,4,8,0.5,4,5,0.8,0,3,0,2,3,0.667,0,4,4,3,0,1,2,4,10,6
C.J. McCollum,25-089,G,12/17/16,POR,GSW,1,25,5,12,0.417,5,8,0.625,0,4,0,0,0,,2,1,3,2,0,1,1,1,10,6
Jonas Jerebko,29-266,F,11/23/16,BOS,BRK,0,17,4,4,1,3,3,1,1,1,1,1,1,1,1,0,1,0,1,0,1,2,10,8.7
Allen Crabbe,24-201,G-F,10/27/16,POR,LAC,0,32,3,7,0.429,3,5,0.6,0,2,0,4,4,1,0,1,1,4,0,0,0,4,10,7.8
Dragan Bender,18-344,F,10/26/16,PHO,SAC,0,12,4,5,0.8,2,2,1,2,3,0.667,0,0,,1,1,2,0,0,0,0,0,10,9.1
Rajon Rondo,31-039,G,4/2/17,CHI,NOP,1,34,5,14,0.357,5,11,0.455,0,3,0,0,0,,1,8,9,9,3,0,3,4,10,10
Tony Snell,25-036,G-F,12/16/16,MIL,CHI,1,25,4,8,0.5,2,5,0.4,2,3,0.667,0,0,,1,4,5,2,0,0,1,1,10,7.9
Taurean Waller-Prince,22-245,F,11/22/16,ATL,NOP,0,17,4,6,0.667,2,2,1,2,4,0.5,0,0,,0,1,1,0,0,0,2,0,10,5.7
Ish Smith,28-225,G,2/15/17,DET,DAL,0,20,4,10,0.4,4,9,0.444,0,1,0,2,2,1,0,2,2,3,0,1,2,0,10,6
Dante Exum,21-129,G,11/19/16,UTA,HOU,1,28,4,11,0.364,3,8,0.375,1,3,0.333,1,2,0.5,0,1,1,1,0,0,1,4,10,1.9
Noah Vonleh,21-149,F,1/20/17,POR,PHI,1,26,4,6,0.667,3,5,0.6,1,1,1,1,3,0.333,1,4,5,0,1,0,0,3,10,8.3
Tony Snell,25-118,G-F,3/8/17,MIL,NYK,1,38,3,9,0.333,1,6,0.167,2,3,0.667,2,2,1,1,6,7,1,2,0,1,2,10,8.3
Dirk Nowitzki,38-271,F,3/17/17,DAL,PHI,1,19,5,9,0.556,5,9,0.556,0,0,,0,0,,0,1,1,0,0,1,1,2,10,4.9
Buddy Hield,23-078,G,3/5/17,SAC,UTA,0,19,4,7,0.571,2,3,0.667,2,4,0.5,0,0,,0,2,2,1,1,0,5,0,10,4
T.J. Warren,23-152,F,2/4/17,PHO,MIL,1,37,5,18,0.278,5,13,0.385,0,5,0,0,0,,3,3,6,4,1,0,0,4,10,4.6
Danny Green,29-272,G-F,3/21/17,SAS,MIN,1,32,4,7,0.571,2,2,1,2,5,0.4,0,0,,0,3,3,3,1,1,0,4,10,9.8
Dennis Schroder,23-182,G,3/16/17,ATL,MEM,1,26,4,16,0.25,3,10,0.3,1,6,0.167,1,1,1,1,2,3,3,2,0,1,0,10,4.8
James Johnson,30-029,F,3/21/17,MIA,PHO,0,23,3,9,0.333,2,7,0.286,1,2,0.5,3,6,0.5,0,1,1,1,1,1,2,3,10,3.2
Nemanja Bjelica,28-235,F,12/30/16,MIN,MIL,0,19,4,6,0.667,2,3,0.667,2,3,0.667,0,0,,0,3,3,1,1,0,0,3,10,8.8
Kelly Olynyk,25-316,C-F,3/1/17,BOS,CLE,0,19,4,5,0.8,4,5,0.8,0,0,,2,2,1,1,1,2,2,0,1,2,5,10,7.2
Spencer Dinwiddie,23-282,G,1/13/17,BRK,TOR,1,28,3,7,0.429,0,3,0,3,4,0.75,1,2,0.5,0,5,5,3,1,0,0,3,10,9.3
Noah Vonleh,21-206,F,3/18/17,POR,ATL,1,27,4,7,0.571,4,7,0.571,0,0,,2,3,0.667,3,8,11,0,0,0,4,3,10,5.6
Dirk Nowitzki,38-212,F,1/17/17,DAL,CHI,1,27,3,9,0.333,3,6,0.5,0,3,0,4,6,0.667,0,10,10,2,1,0,0,2,10,8.7
Al Horford,30-187,C-F,12/7/16,BOS,ORL,1,29,3,9,0.333,3,6,0.5,0,3,0,4,4,1,1,5,6,8,0,2,0,2,10,13.3
Jeff Withey,27-028,C,4/4/17,UTA,POR,0,13,5,5,1,5,5,1,0,0,,0,0,,2,1,3,1,1,1,0,1,10,12.2
Ryan Anderson,28-318,F,3/20/17,HOU,DEN,1,25,4,8,0.5,2,2,1,2,6,0.333,0,0,,1,1,2,1,0,0,0,2,10,6.9
Caris LeVert,22-230,G-F,4/12/17,BRK,CHI,1,25,5,13,0.385,5,8,0.625,0,5,0,0,0,,0,5,5,2,1,0,2,1,10,4.4
Darren Collison,29-085,G,11/16/16,SAC,SAS,0,30,4,7,0.571,4,6,0.667,0,1,0,2,2,1,1,3,4,6,2,0,2,1,10,12.1
Marcin Gortat,32-283,C-F,11/26/16,WAS,SAS,1,33,5,7,0.714,5,7,0.714,0,0,,0,0,,2,8,10,1,0,0,1,3,10,9.4
Kosta Koufos,27-261,C,11/11/16,SAC,POR,1,19,4,7,0.571,4,7,0.571,0,0,,2,4,0.5,3,3,6,0,0,0,1,3,10,6.7
Otto Porter,23-194,F,12/14/16,WAS,CHO,1,36,5,9,0.556,5,7,0.714,0,2,0,0,0,,2,3,5,2,1,2,0,3,10,10.6
Justin Hamilton,27-005,C,4/6/17,BRK,ORL,0,17,4,9,0.444,3,6,0.5,1,3,0.333,1,2,0.5,1,2,3,0,1,1,2,2,10,5.1
Robin Lopez,28-333,C,2/28/17,CHI,DEN,1,26,5,14,0.357,5,14,0.357,0,0,,0,0,,3,0,3,4,0,2,1,3,10,6.3
DeAndre' Bembry,22-219,F,2/8/17,ATL,DEN,0,17,5,7,0.714,5,7,0.714,0,0,,0,0,,1,3,4,2,0,1,0,0,10,10.8
Ersan Ilyasova,29-190,F,11/21/16,PHI,MIA,1,31,4,7,0.571,2,2,1,2,5,0.4,0,0,,0,11,11,3,1,0,2,3,10,9.9
C.J. Miles,29-342,G-F,3/26/17,IND,PHI,0,23,2,4,0.5,0,1,0,2,3,0.667,4,4,1,1,5,6,0,0,0,2,2,10,7.4
Al Jefferson,32-028,C-F,2/1/17,IND,ORL,0,16,4,7,0.571,4,7,0.571,0,0,,2,2,1,2,5,7,3,0,0,1,2,10,9.9
Troy Daniels,25-255,G,3/27/17,MEM,SAC,0,29,3,12,0.25,2,5,0.4,1,7,0.143,3,3,1,0,3,3,0,0,0,0,3,10,2.5
Jon Leuer,27-288,F,2/26/17,DET,BOS,1,25,4,11,0.364,2,4,0.5,2,7,0.286,0,2,0,1,3,4,1,0,0,3,2,10,1.6
Dario Saric,22-299,F,2/1/17,PHI,DAL,0,24,3,9,0.333,2,5,0.4,1,4,0.25,3,6,0.5,2,5,7,2,1,0,2,1,10,6.6
Mason Plumlee,26-291,C-F,12/21/16,POR,DAL,1,29,4,4,1,4,4,1,0,0,,2,7,0.286,1,6,7,4,1,1,3,1,10,10.4
Kris Dunn,22-310,G,1/22/17,MIN,DEN,1,34,3,8,0.375,1,6,0.167,2,2,1,2,4,0.5,1,7,8,9,3,1,1,4,10,15
Thabo Sefolosha,32-258,G-F,1/15/17,ATL,MIL,1,35,4,11,0.364,3,8,0.375,1,3,0.333,1,1,1,1,1,2,3,3,0,2,3,10,6.8
Matthew Dellavedova,26-058,G,11/5/16,MIL,SAC,1,21,4,7,0.571,2,4,0.5,2,3,0.667,0,0,,1,4,5,4,2,0,2,0,10,11.4
Dante Exum,21-215,G,2/13/17,UTA,LAC,0,22,4,8,0.5,4,6,0.667,0,2,0,2,2,1,0,3,3,3,1,0,0,2,10,9.2
Jeff Green,30-116,F,12/22/16,ORL,NYK,0,29,3,8,0.375,3,6,0.5,0,2,0,4,4,1,0,1,1,0,3,0,2,0,10,6.9
Devin Harris,33-330,G,1/22/17,DAL,LAL,0,12,3,5,0.6,1,1,1,2,4,0.5,2,2,1,0,2,2,1,0,0,0,1,10,8.6
Dejounte Murray,20-115,G,1/12/17,SAS,LAL,0,10,3,5,0.6,1,3,0.333,2,2,1,2,2,1,0,1,1,2,0,0,1,1,10,8
Salah Mejri,30-294,C,4/5/17,DAL,LAC,0,20,4,6,0.667,4,6,0.667,0,0,,2,4,0.5,4,5,9,0,2,1,2,1,10,11.2
Kevon Looney,21-002,F-C,2/8/17,GSW,CHI,0,14,5,6,0.833,5,6,0.833,0,0,,0,1,0,0,4,4,0,0,0,1,1,10,7.2
Josh Richardson,23-090,G,12/14/16,MIA,IND,0,30,4,8,0.5,2,4,0.5,2,4,0.5,0,0,,1,4,5,3,0,0,3,0,10,7
Ersan Ilyasova,29-164,F,10/26/16,OKC,PHI,0,20,4,7,0.571,2,2,1,2,5,0.4,0,0,,1,4,5,1,1,0,0,1,10,9.9
Gerald Henderson,29-054,G,2/1/17,PHI,DAL,0,24,3,7,0.429,3,6,0.5,0,1,0,4,4,1,1,2,3,2,1,0,1,1,10,8.6
David Lee,33-265,F,1/19/17,SAS,DEN,1,33,5,7,0.714,5,7,0.714,0,0,,0,0,,5,11,16,2,1,1,0,2,10,16.2
JaVale McGee,28-296,C,11/10/16,GSW,DEN,0,15,4,6,0.667,4,6,0.667,0,0,,2,2,1,1,2,3,1,0,2,1,0,10,9.8
Serge Ibaka,27-179,F-C,3/16/17,TOR,OKC,1,27,5,11,0.455,5,7,0.714,0,4,0,0,0,,0,3,3,1,0,1,3,3,10,2.4
Norman Powell,23-256,G,2/5/17,TOR,BRK,1,33,5,14,0.357,5,13,0.385,0,1,0,0,0,,4,2,6,3,0,1,1,2,10,6.6
Lucas Nogueira,24-190,C,2/1/17,TOR,BOS,0,28,3,4,0.75,3,3,1,0,1,0,4,4,1,1,4,5,0,1,4,1,4,10,11.5
Ricky Rubio,26-061,G,12/21/16,MIN,ATL,1,33,3,5,0.6,1,2,0.5,2,3,0.667,2,2,1,1,4,5,8,2,0,6,0,10,11.2
J.J. Barea,32-274,G,3/27/17,DAL,OKC,0,29,3,9,0.333,1,5,0.2,2,4,0.5,2,2,1,0,1,1,8,1,0,1,0,10,10.8
Derrick Jones,20-043,F,3/30/17,PHO,LAC,0,19,4,5,0.8,4,5,0.8,0,0,,2,2,1,3,1,4,0,1,0,0,1,10,11.1
Reggie Jackson,26-293,G,2/3/17,DET,MIN,1,27,4,13,0.308,4,11,0.364,0,2,0,2,2,1,0,3,3,8,1,0,0,0,10,10
Rondae Hollis-Jefferson,22-073,F,3/17/17,BRK,BOS,1,16,3,7,0.429,3,6,0.5,0,1,0,4,6,0.667,0,5,5,1,1,0,2,4,10,5.1
Cory Joseph,25-227,G,4/4/17,TOR,IND,1,32,5,7,0.714,5,5,1,0,2,0,0,0,,0,4,4,2,1,1,3,3,10,7.2
Malcolm Delaney,27-256,G,11/22/16,ATL,NOP,0,18,5,11,0.455,5,9,0.556,0,2,0,0,0,,0,2,2,2,1,0,4,1,10,2.9
Brandon Ingram,19-114,F,12/25/16,LAL,LAC,0,28,3,8,0.375,3,7,0.429,0,1,0,4,5,0.8,1,5,6,0,0,0,1,3,10,5.2
Kosta Koufos,28-015,C,3/11/17,SAC,DEN,1,28,5,8,0.625,5,8,0.625,0,0,,0,0,,3,5,8,1,0,0,1,4,10,8.1
Gorgui Dieng,27-025,C,2/12/17,MIN,CHI,1,34,5,9,0.556,5,8,0.625,0,1,0,0,0,,3,10,13,0,2,1,1,3,10,11.3
Kelly Olynyk,25-218,C-F,11/23/16,BOS,BRK,0,19,3,9,0.333,1,4,0.25,2,5,0.4,2,2,1,1,1,2,1,2,0,1,4,10,6
Tim Hardaway,24-308,G,1/18/17,ATL,DET,0,19,4,8,0.5,2,4,0.5,2,4,0.5,0,0,,0,1,1,0,0,0,0,0,10,6.3
Quinn Cook,23-349,G,3/7/17,DAL,LAL,0,17,4,6,0.667,2,3,0.667,2,3,0.667,0,0,,0,0,0,3,1,0,2,1,10,8.1
Shaun Livingston,31-123,G,1/12/17,GSW,DET,0,21,5,7,0.714,5,7,0.714,0,0,,0,0,,1,0,1,2,0,0,0,1,10,8.8
Tarik Black,25-045,C-F,1/6/17,LAL,MIA,0,25,3,5,0.6,3,5,0.6,0,0,,4,4,1,6,5,11,2,0,1,1,4,10,12.9
Rudy Gay,30-100,F,11/25/16,SAC,HOU,1,37,4,12,0.333,4,8,0.5,0,4,0,2,2,1,0,4,4,3,3,0,0,1,10,9.1
Trevor Ariza,31-218,F,2/3/17,HOU,CHI,1,39,3,7,0.429,1,1,1,2,6,0.333,2,4,0.5,0,6,6,1,3,0,0,0,10,11
Shabazz Napier,25-243,G,3/14/17,POR,NOP,0,19,3,7,0.429,1,3,0.333,2,4,0.5,2,3,0.667,0,1,1,3,1,1,1,0,10,9
Elfrid Payton,22-347,G,2/3/17,ORL,TOR,1,32,5,12,0.417,5,10,0.5,0,2,0,0,0,,0,4,4,6,1,0,1,0,10,9
Richaun Holmes,23-139,F-C,3/3/17,PHI,NYK,0,25,3,4,0.75,3,4,0.75,0,0,,4,4,1,1,3,4,1,0,1,0,0,10,11.4
Sergio Rodriguez,30-260,G,2/27/17,PHI,GSW,0,28,4,12,0.333,2,5,0.4,2,7,0.286,0,0,,0,5,5,4,0,0,1,2,10,5.7
Tony Allen,35-063,G-F,3/15/17,MEM,CHI,1,24,4,10,0.4,4,9,0.444,0,1,0,2,2,1,3,3,6,3,0,0,0,2,10,8.9
Dante Cunningham,29-354,F,4/11/17,NOP,LAL,1,21,4,6,0.667,2,2,1,2,4,0.5,0,0,,0,3,3,1,1,0,0,1,10,9.6
Nikola Jokic,21-302,C-F,12/17/16,DEN,NYK,1,20,5,8,0.625,5,8,0.625,0,0,,0,0,,2,7,9,5,0,0,1,5,10,10.4
Brandon Ingram,19-219,F,4/9/17,LAL,MIN,1,30,3,10,0.3,2,9,0.222,1,1,1,3,5,0.6,2,0,2,1,2,1,2,4,10,4.6
Brandon Bass,31-247,F,1/2/17,LAC,PHO,0,14,4,6,0.667,4,6,0.667,0,0,,2,3,0.667,1,0,1,0,0,0,1,0,10,6.7
JaMychal Green,26-220,F,1/27/17,MEM,POR,1,22,2,3,0.667,2,2,1,0,1,0,6,7,0.857,2,3,5,1,0,0,1,2,10,9.5
Tim Frazier,26-049,G,12/20/16,NOP,PHI,0,27,4,7,0.571,2,5,0.4,2,2,1,0,1,0,1,3,4,6,1,0,5,2,10,7.3
Marvin Williams,30-157,F,11/23/16,CHO,SAS,1,29,4,6,0.667,2,3,0.667,2,3,0.667,0,0,,2,3,5,1,1,1,2,1,10,9.7
Kenneth Faried,27-011,F,11/30/16,DEN,MIA,1,27,4,8,0.5,4,8,0.5,0,0,,2,4,0.5,3,5,8,3,1,3,2,2,10,11.2
Hassan Whiteside,27-193,C,12/23/16,MIA,NOP,1,36,4,10,0.4,4,10,0.4,0,0,,2,6,0.333,7,11,18,2,0,2,1,3,10,11.8
J.J. Redick,32-204,G,1/14/17,LAC,LAL,1,30,4,12,0.333,2,5,0.4,2,7,0.286,0,0,,0,1,1,2,1,0,1,4,10,3.3
Evan Turner,28-147,G,3/23/17,POR,NYK,0,24,3,5,0.6,3,5,0.6,0,0,,4,6,0.667,0,6,6,1,1,0,1,0,10,9.4
Malcolm Delaney,28-032,G,4/12/17,ATL,IND,0,26,2,7,0.286,1,4,0.25,1,3,0.333,5,5,1,0,2,2,5,2,0,3,2,10,8.2
Bojan Bogdanovic,27-324,G-F,3/8/17,WAS,DEN,0,22,4,10,0.4,4,8,0.5,0,2,0,2,2,1,0,2,2,1,1,0,0,3,10,5.7
Dwight Howard,31-060,C,2/6/17,ATL,UTA,1,25,4,5,0.8,4,5,0.8,0,0,,2,5,0.4,3,5,8,0,0,2,0,1,10,11.5
J.J. Redick,32-152,G,11/23/16,LAC,DAL,1,22,4,9,0.444,3,5,0.6,1,4,0.25,1,1,1,0,2,2,1,0,0,3,1,10,3.2
Tyus Jones,20-270,G,2/4/17,MIN,MEM,0,24,3,6,0.5,1,1,1,2,5,0.4,2,2,1,1,2,3,6,2,1,3,4,10,10.6
Marreese Speights,29-141,C-F,12/23/16,LAC,DAL,0,14,4,7,0.571,2,4,0.5,2,3,0.667,0,0,,1,3,4,0,1,0,0,1,10,8.9
Courtney Lee,31-080,G,12/22/16,NYK,ORL,1,29,4,7,0.571,2,4,0.5,2,3,0.667,0,0,,1,2,3,3,2,1,2,1,10,10.4
Hassan Whiteside,27-224,C,1/23/17,MIA,GSW,1,36,4,13,0.308,4,13,0.308,0,0,,2,5,0.4,4,11,15,0,2,1,3,5,10,5.1
Elfrid Payton,22-304,G,12/22/16,ORL,NYK,0,31,4,11,0.364,3,7,0.429,1,4,0.25,1,2,0.5,2,6,8,4,2,0,6,1,10,5.1
Kelly Oubre,21-112,F,3/31/17,WAS,UTA,0,23,5,7,0.714,5,5,1,0,2,0,0,1,0,1,3,4,0,3,0,1,4,10,8.7
Matthew Dellavedova,26-179,G,3/6/17,MIL,PHI,0,27,3,6,0.5,1,4,0.25,2,2,1,2,2,1,1,2,3,7,0,0,2,0,10,11.2
Markieff Morris,27-095,F,12/6/16,WAS,ORL,1,33,3,10,0.3,3,8,0.375,0,2,0,4,5,0.8,2,5,7,1,0,1,0,3,10,6.9
Darrell Arthur,28-315,F,2/3/17,DEN,MIL,0,17,4,9,0.444,2,6,0.333,2,3,0.667,0,0,,1,2,3,2,0,0,1,3,10,5.8
Glenn Robinson,23-039,G-F,2/16/17,IND,WAS,1,24,4,6,0.667,3,4,0.75,1,2,0.5,1,1,1,0,1,1,1,0,0,0,1,10,8
Nik Stauskas,23-047,G,11/23/16,PHI,MEM,0,43,3,12,0.25,1,5,0.2,2,7,0.286,2,2,1,0,5,5,4,1,0,2,2,10,5.3
Timothe Luwawu-Cabarrot,21-257,F,1/21/17,PHI,ATL,0,21,2,3,0.667,1,2,0.5,1,1,1,5,6,0.833,0,0,0,2,1,0,5,4,10,4.1
Thaddeus Young,28-167,F,12/5/16,IND,GSW,1,23,5,10,0.5,5,8,0.625,0,2,0,0,0,,1,1,2,0,0,0,2,1,10,3.6
Dwight Powell,25-149,F-C,12/16/16,DAL,UTA,0,24,3,9,0.333,3,7,0.429,0,2,0,4,5,0.8,1,3,4,1,0,0,0,0,10,6.8
Shelvin Mack,26-227,G,12/5/16,UTA,LAL,0,30,4,9,0.444,2,3,0.667,2,6,0.333,0,0,,0,2,2,7,0,0,3,3,10,6.6
Dante Cunningham,29-354,F,4/11/17,NOP,LAL,1,21,4,6,0.667,2,2,1,2,4,0.5,0,0,,0,3,3,1,1,0,0,1,10,9.6
Tristan Thompson,25-320,F-C,1/27/17,CLE,BRK,1,28,5,5,1,5,5,1,0,0,,0,2,0,2,8,10,2,0,1,0,2,10,12.8
Isaiah Whitehead,21-304,G,1/6/17,BRK,CLE,0,30,4,10,0.4,4,9,0.444,0,1,0,2,3,0.667,1,9,10,3,1,0,4,4,10,5.1
Marcus Morris,27-187,F,3/8/17,DET,IND,1,29,4,13,0.308,3,8,0.375,1,5,0.2,1,3,0.333,0,1,1,2,0,1,0,1,10,3.7
Omri Casspi,28-175,F,12/14/16,SAC,HOU,1,27,4,12,0.333,3,9,0.333,1,3,0.333,1,2,0.5,1,4,5,1,0,0,2,3,10,2.2
Nerlens Noel,23-002,C-F,4/12/17,DAL,MEM,1,23,4,8,0.5,4,8,0.5,0,0,,2,2,1,1,6,7,0,1,1,2,0,10,8.2
T.J. McConnell,24-344,G,3/4/17,PHI,DET,1,23,5,7,0.714,5,7,0.714,0,0,,0,0,,2,1,3,8,1,0,4,1,10,11
Greg Monroe,26-184,C-F,12/5/16,MIL,SAS,0,21,5,9,0.556,5,9,0.556,0,0,,0,1,0,2,11,13,2,0,0,2,2,10,8.6
Jae Crowder,26-222,F,2/13/17,BOS,DAL,1,29,3,9,0.333,1,4,0.25,2,5,0.4,2,3,0.667,0,4,4,2,1,1,1,6,10,5.4
Paul George,26-189,F,11/7/16,IND,CHO,1,33,4,12,0.333,3,6,0.5,1,6,0.167,1,1,1,2,5,7,6,2,0,5,2,10,6.5
Trevor Ariza,31-174,F,12/21/16,HOU,PHO,1,34,4,6,0.667,3,5,0.6,1,1,1,1,4,0.25,1,2,3,1,2,0,1,3,10,8
Randy Foye,33-062,G,11/25/16,BRK,IND,0,18,4,6,0.667,2,3,0.667,2,3,0.667,0,1,0,0,1,1,2,1,0,1,0,10,8.7
Alex Poythress,23-210,F,4/4/17,PHI,BRK,0,28,4,10,0.4,3,8,0.375,1,2,0.5,1,3,0.333,5,2,7,3,1,0,0,4,10,9.4
Myles Turner,20-319,F-C,2/6/17,IND,OKC,1,36,3,12,0.25,3,10,0.3,0,2,0,4,7,0.571,3,2,5,2,2,4,1,4,10,7.9
Dante Exum,21-109,G,10/30/16,UTA,LAC,0,26,3,6,0.5,3,5,0.6,0,1,0,4,4,1,0,2,2,2,1,0,0,2,10,9.2
Shabazz Muhammad,24-078,F-G,1/30/17,MIN,ORL,0,22,4,10,0.4,2,5,0.4,2,5,0.4,0,0,,0,5,5,1,0,0,0,0,10,6.8
Jahlil Okafor,21-032,C-F,1/16/17,PHI,MIL,0,20,4,5,0.8,4,5,0.8,0,0,,2,2,1,0,2,2,1,1,0,1,1,10,9
Alex Len,23-149,C,11/12/16,PHO,BRK,1,29,4,10,0.4,4,10,0.4,0,0,,2,4,0.5,3,8,11,0,0,2,1,2,10,7.9
Patrick Patterson,27-319,F,1/27/17,TOR,MIL,1,27,4,6,0.667,2,2,1,2,4,0.5,0,0,,2,5,7,2,2,1,0,1,10,14
Shabazz Muhammad,24-106,F-G,2/27/17,MIN,SAC,0,15,4,7,0.571,3,5,0.6,1,2,0.5,1,2,0.5,0,0,0,1,1,0,1,0,10,7
Tyson Chandler,34-065,C,12/6/16,PHO,UTA,1,28,3,7,0.429,3,7,0.429,0,0,,4,4,1,4,1,5,1,0,0,1,3,10,7.9
C.J. Miles,29-245,G-F,12/19/16,IND,WAS,0,30,3,7,0.429,2,4,0.5,1,3,0.333,3,3,1,1,1,2,0,0,0,0,2,10,6.5
Lavoy Allen,27-360,F-C,1/29/17,IND,HOU,0,15,5,5,1,5,5,1,0,0,,0,0,,0,2,2,1,0,0,0,2,10,9
Rodney Stuckey,30-295,G,2/10/17,IND,WAS,0,17,4,10,0.4,4,8,0.5,0,2,0,2,2,1,0,1,1,5,0,0,2,2,10,5.6
Mason Plumlee,26-277,C-F,12/7/16,POR,MIL,1,33,4,10,0.4,4,10,0.4,0,0,,2,4,0.5,2,8,10,4,2,3,1,2,10,12.7
Julius Randle,22-110,F,3/19/17,LAL,CLE,1,38,3,9,0.333,2,6,0.333,1,3,0.333,3,4,0.75,2,5,7,7,0,0,1,5,10,9.3
Dwight Powell,25-265,F-C,4/11/17,DAL,DEN,0,22,3,9,0.333,1,2,0.5,2,7,0.286,2,2,1,2,3,5,0,1,0,0,1,10,7.8
Trevor Booker,29-017,F,12/12/16,BRK,HOU,1,32,4,8,0.5,4,8,0.5,0,0,,2,3,0.667,0,13,13,1,4,0,3,3,10,10
Frank Kaminsky,23-254,F-C,12/14/16,CHO,WAS,0,22,3,9,0.333,0,3,0,3,6,0.5,1,2,0.5,0,4,4,1,0,1,3,0,10,4.1
Marvin Williams,30-145,F,11/11/16,CHO,TOR,1,35,3,15,0.2,0,5,0,3,10,0.3,1,2,0.5,3,10,13,1,0,1,1,1,10,5.4
Brandon Jennings,27-083,G,12/15/16,NYK,GSW,1,29,4,13,0.308,4,11,0.364,0,2,0,2,4,0.5,1,5,6,6,0,0,3,1,10,4.7
Caris LeVert,22-183,G-F,2/24/17,BRK,DEN,1,26,4,9,0.444,3,4,0.75,1,5,0.2,1,2,0.5,0,2,2,1,1,0,0,0,10,7.2
Aaron Brooks,32-082,G,4/6/17,IND,MIL,0,19,3,5,0.6,1,3,0.333,2,2,1,2,2,1,0,2,2,1,0,0,2,0,10,7
Malcolm Delaney,27-280,G,12/16/16,ATL,TOR,0,22,4,7,0.571,4,6,0.667,0,1,0,2,3,0.667,0,1,1,4,0,0,1,4,10,6.8
Richaun Holmes,23-148,F-C,3/12/17,PHI,LAL,0,22,3,6,0.5,2,3,0.667,1,3,0.333,3,4,0.75,0,5,5,1,2,1,0,3,10,10.3
Clint Capela,22-197,F-C,12/1/16,HOU,GSW,1,25,5,8,0.625,5,8,0.625,0,0,,0,3,0,1,3,4,0,0,2,3,4,10,3.6
Ivica Zubac,20-010,C,3/28/17,LAL,WAS,1,18,3,8,0.375,3,8,0.375,0,0,,4,4,1,1,3,4,1,2,1,0,4,10,9
Tristan Thompson,25-356,F-C,3/4/17,CLE,MIA,1,28,4,9,0.444,4,9,0.444,0,0,,2,4,0.5,5,1,6,3,0,0,2,1,10,8
Marcus Smart,22-342,G,2/11/17,BOS,UTA,1,37,4,11,0.364,4,6,0.667,0,5,0,2,2,1,1,4,5,5,3,0,3,3,10,8.1
James Ennis,26-224,F,2/10/17,MEM,GSW,1,30,4,6,0.667,2,3,0.667,2,3,0.667,0,0,,0,1,1,0,1,0,0,5,10,6.7
James Ennis,26-194,F,1/11/17,MEM,OKC,0,19,4,5,0.8,4,5,0.8,0,0,,2,4,0.5,2,2,4,0,1,0,1,5,10,7.3
Tyler Zeller,27-010,F-C,1/27/17,BOS,ORL,0,20,5,9,0.556,5,9,0.556,0,0,,0,0,,1,2,3,2,1,1,0,1,10,9.7
Tim Hardaway,24-257,G,11/28/16,ATL,GSW,0,14,3,8,0.375,2,2,1,1,6,0.167,3,4,0.75,0,1,1,0,1,0,0,1,10,6.1
Andre Roberson,24-355,G-F,11/23/16,OKC,SAC,1,35,4,7,0.571,3,3,1,1,4,0.25,1,2,0.5,1,4,5,1,1,2,0,4,10,9.7
Enes Kanter,24-186,C,11/22/16,OKC,LAL,0,19,4,8,0.5,4,8,0.5,0,0,,2,2,1,3,2,5,2,0,0,2,2,10,7.3
Rajon Rondo,31-049,G,4/12/17,CHI,BRK,1,20,4,9,0.444,2,7,0.286,2,2,1,0,0,,4,2,6,5,1,0,1,3,10,11
Gorgui Dieng,26-359,C,1/11/17,MIN,HOU,1,26,5,5,1,5,5,1,0,0,,0,0,,0,2,2,2,0,1,2,2,10,8.4
Kelly Oubre,21-045,F,1/23/17,WAS,CHO,0,23,4,5,0.8,2,2,1,2,3,0.667,0,2,0,0,2,2,1,1,1,0,2,10,9.5
Myles Turner,20-323,F-C,2/10/17,IND,WAS,1,31,4,9,0.444,4,8,0.5,0,1,0,2,2,1,2,5,7,3,0,1,3,3,10,6.8
Brandon Knight,24-338,G,11/4/16,PHO,NOP,0,23,4,10,0.4,3,7,0.429,1,3,0.333,1,1,1,0,1,1,1,1,0,2,1,10,4.2
Bismack Biyombo,24-190,C-F,3/6/17,ORL,NYK,1,42,3,6,0.5,3,6,0.5,0,0,,4,8,0.5,5,9,14,0,0,1,1,3,10,10.1
JaMychal Green,26-290,F,4/7/17,MEM,NYK,1,29,4,7,0.571,3,5,0.6,1,2,0.5,1,2,0.5,2,3,5,1,0,1,1,1,10,8.6
DeMarre Carroll,30-160,F,1/3/17,TOR,SAS,1,19,3,7,0.429,2,4,0.5,1,3,0.333,3,4,0.75,4,1,5,0,2,0,1,2,10,9.2
Tyler Ulis,21-077,G,3/23/17,PHO,BRK,1,45,5,19,0.263,5,17,0.294,0,2,0,0,0,,1,4,5,12,2,0,4,1,10,6.6
Sam Dekker,22-187,F,11/9/16,HOU,SAS,0,18,4,5,0.8,2,3,0.667,2,2,1,0,0,,0,7,7,1,1,1,1,1,10,11.2
Dwight Powell,25-163,F-C,12/30/16,DAL,GSW,0,26,5,7,0.714,5,7,0.714,0,0,,0,0,,3,10,13,1,0,2,0,1,10,13.9
Zaza Pachulia,32-333,C,1/8/17,GSW,SAC,1,22,4,5,0.8,4,5,0.8,0,0,,2,2,1,5,2,7,2,3,0,1,5,10,13.6
Nikola Jokic,22-007,C-F,2/26/17,DEN,MEM,1,33,5,11,0.455,5,9,0.556,0,2,0,0,0,,2,9,11,6,1,1,2,3,10,11.1
Alexis Ajinca,28-299,C,3/1/17,NOP,DET,0,19,4,7,0.571,4,7,0.571,0,0,,2,2,1,1,7,8,0,0,3,0,4,10,10
Marcus Smart,22-332,G,2/1/17,BOS,TOR,0,35,4,11,0.364,3,6,0.5,1,5,0.2,1,2,0.5,2,3,5,5,2,0,2,3,10,8.1
Alan Williams,24-042,F-C,3/11/17,PHO,DAL,0,26,5,7,0.714,5,7,0.714,0,0,,0,0,,0,5,5,1,0,1,1,2,10,8.2
JaVale McGee,29-073,C,4/2/17,GSW,WAS,0,8,4,6,0.667,4,6,0.667,0,0,,2,3,0.667,4,2,6,0,1,3,1,0,10,12.5
Josh McRoberts,29-277,F,12/1/16,MIA,UTA,1,24,5,10,0.5,5,9,0.556,0,1,0,0,0,,2,3,5,1,0,0,2,0,10,6
K.J. McDaniels,24-043,G-F,3/24/17,BRK,WAS,0,26,4,8,0.5,4,7,0.571,0,1,0,2,2,1,1,1,2,1,1,1,1,5,10,6.4
Darren Collison,29-188,G,2/27/17,SAC,MIN,1,30,5,13,0.385,5,12,0.417,0,1,0,0,0,,1,1,2,3,0,0,0,1,10,5.6
Justin Holiday,27-334,G,3/5/17,NYK,GSW,0,15,4,6,0.667,2,2,1,2,4,0.5,0,0,,0,3,3,1,0,0,1,1,10,7.6
Enes Kanter,24-320,C,4/5/17,OKC,MEM,0,21,4,10,0.4,4,9,0.444,0,1,0,2,2,1,2,3,5,0,0,0,2,2,10,4.1
Mason Plumlee,26-322,C-F,1/21/17,POR,BOS,1,28,4,8,0.5,4,8,0.5,0,0,,2,4,0.5,3,8,11,8,1,0,3,4,10,11.7
Alec Burks,25-241,G,3/18/17,UTA,CHI,0,19,4,11,0.364,3,8,0.375,1,3,0.333,1,2,0.5,2,2,4,0,0,0,2,0,10,3.5
Timothe Luwawu-Cabarrot,21-298,F,3/3/17,PHI,NYK,0,25,4,12,0.333,2,8,0.25,2,4,0.5,0,0,,2,7,9,1,1,0,1,3,10,6.2
Doug McDermott,25-092,F,4/5/17,OKC,MEM,0,32,3,7,0.429,0,1,0,3,6,0.5,1,3,0.333,1,6,7,0,0,0,1,1,10,6.6
Nene Hilario,34-119,F-C,1/10/17,HOU,CHO,0,19,3,6,0.5,3,6,0.5,0,0,,4,6,0.667,1,4,5,1,1,2,2,3,10,8
DeMarre Carroll,30-129,F,12/3/16,TOR,ATL,1,26,4,10,0.4,2,4,0.5,2,6,0.333,0,0,,1,4,5,0,3,0,1,0,10,8.5
Paul Zipser,23-014,G-F,3/4/17,CHI,LAC,0,18,4,6,0.667,3,4,0.75,1,2,0.5,1,2,0.5,0,2,2,0,0,0,2,2,10,4.8
Al Horford,30-278,C-F,3/8/17,BOS,GSW,1,32,4,8,0.5,3,7,0.429,1,1,1,1,1,1,1,5,6,6,2,0,1,1,10,13
Devin Booker,20-138,G,3/17/17,PHO,ORL,1,30,3,13,0.231,3,11,0.273,0,2,0,4,4,1,0,4,4,3,2,0,3,2,10,3.6
Ramon Sessions,30-284,G,1/20/17,CHO,TOR,0,21,4,8,0.5,3,7,0.429,1,1,1,1,1,1,0,1,1,1,1,0,1,2,10,6.2
John Henson,25-354,C-F,12/16/16,MIL,CHI,1,20,4,10,0.4,4,10,0.4,0,0,,2,2,1,0,4,4,0,1,2,1,2,10,6.4
Domantas Sabonis,20-258,F,1/16/17,OKC,LAC,1,27,4,7,0.571,2,4,0.5,2,3,0.667,0,0,,0,0,0,4,2,0,2,3,10,8.3
Serge Ibaka,27-126,F-C,1/22/17,ORL,GSW,1,21,4,9,0.444,2,5,0.4,2,4,0.5,0,0,,0,3,3,1,1,1,1,3,10,6.4
Nene Hilario,34-098,F-C,12/20/16,HOU,SAS,1,18,4,6,0.667,4,6,0.667,0,0,,2,2,1,5,2,7,2,1,0,1,1,10,12.5
Seth Curry,26-111,G,12/12/16,DAL,DEN,0,16,4,7,0.571,2,4,0.5,2,3,0.667,0,0,,0,0,0,4,1,0,1,3,10,8.3
Kelly Olynyk,25-330,C-F,3/15/17,BOS,MIN,0,13,3,4,0.75,3,3,1,0,1,0,4,6,0.667,0,1,1,3,0,0,1,1,10,8.6
Marcus Smart,22-339,G,2/8/17,BOS,SAC,0,28,3,7,0.429,1,1,1,2,6,0.333,2,2,1,0,2,2,2,1,0,3,4,10,4.7
Miles Plumlee,28-144,C-F,1/23/17,MIL,HOU,1,20,4,5,0.8,4,5,0.8,0,0,,2,2,1,1,1,2,1,1,1,0,2,10,10.7
Ricky Rubio,26-149,G,3/19/17,MIN,NOP,1,35,4,11,0.364,2,5,0.4,2,6,0.333,0,0,,0,3,3,14,1,0,3,3,10,11.4
Elfrid Payton,22-337,G,1/24/17,ORL,CHI,1,38,5,16,0.313,5,13,0.385,0,3,0,0,2,0,3,4,7,5,0,0,8,2,10,-2
Tony Snell,25-023,G-F,12/3/16,MIL,BRK,1,27,4,10,0.4,2,3,0.667,2,7,0.286,0,0,,0,3,3,1,0,1,1,4,10,4.3
LaMarcus Aldridge,31-142,F-C,12/8/16,SAS,CHI,1,31,5,15,0.333,5,14,0.357,0,1,0,0,0,,3,3,6,1,1,4,2,1,10,6.6
Chasson Randle,24-056,G,4/2/17,NYK,BOS,0,22,3,8,0.375,2,4,0.5,1,4,0.25,3,4,0.75,0,2,2,3,1,0,3,5,10,3.9
Georgios Papagiannis,19-278,C,4/7/17,SAC,LAL,0,25,5,8,0.625,5,8,0.625,0,0,,0,0,,3,7,10,3,0,0,2,4,10,9.1
Richard Jefferson,36-277,F,3/25/17,CLE,WAS,0,18,3,5,0.6,2,3,0.667,1,2,0.5,3,5,0.6,0,1,1,2,1,0,0,1,10,9.2
Marc Gasol,32-051,C,3/21/17,MEM,NOP,1,37,5,13,0.385,5,10,0.5,0,3,0,0,1,0,0,8,8,4,2,0,3,3,10,5.5
Anthony Tolliver,31-240,F-C,1/27/17,SAC,IND,0,26,3,5,0.6,1,2,0.5,2,3,0.667,2,2,1,2,3,5,0,0,0,2,2,10,7.2
Jon Leuer,27-309,F,3/19/17,DET,PHO,0,24,4,10,0.4,3,9,0.333,1,1,1,1,1,1,1,6,7,2,1,0,2,5,10,5.5
Terrence Ross,25-315,F-G,12/16/16,TOR,ATL,0,22,4,7,0.571,3,3,1,1,4,0.25,1,1,1,0,1,1,0,0,0,0,1,10,6.6
Gary Harris,22-191,G,3/24/17,DEN,IND,1,30,3,3,1,1,1,1,2,2,1,2,2,1,1,1,2,2,1,0,4,2,10,7.7
Cody Zeller,24-030,F-C,11/4/16,CHO,BRK,1,21,3,7,0.429,3,7,0.429,0,0,,4,5,0.8,2,4,6,6,2,1,0,5,10,13.4
Jrue Holiday,26-300,G,4/8/17,NOP,GSW,1,32,5,15,0.333,5,11,0.455,0,4,0,0,0,,1,5,6,10,0,0,1,2,10,8.9
Joe Harris,25-120,G,1/5/17,BRK,IND,1,26,4,8,0.5,2,3,0.667,2,5,0.4,0,0,,1,1,2,2,0,2,2,3,10,6.6
Raul Neto,24-307,G,3/22/17,UTA,NYK,0,14,4,4,1,2,2,1,2,2,1,0,0,,0,0,0,1,0,0,0,3,10,8.3
Anthony Tolliver,31-290,F-C,3/18/17,SAC,OKC,0,20,4,7,0.571,2,5,0.4,2,2,1,0,0,,0,2,2,0,0,0,0,2,10,6.5
Alec Burks,25-229,G,3/6/17,UTA,NOP,0,16,3,9,0.333,1,4,0.25,2,5,0.4,2,2,1,1,7,8,0,0,0,0,1,10,7.3
DeMarre Carroll,30-140,F,12/14/16,TOR,PHI,1,20,3,9,0.333,1,3,0.333,2,6,0.333,2,2,1,2,1,3,1,1,0,1,0,10,7.3
DeAndre Jordan,28-207,C,2/13/17,LAC,UTA,1,31,5,7,0.714,5,7,0.714,0,0,,0,2,0,2,11,13,1,1,3,0,1,10,14.4
Rajon Rondo,30-288,G,12/6/16,CHI,DET,1,37,4,10,0.4,3,8,0.375,1,2,0.5,1,3,0.333,1,2,3,1,0,1,3,4,10,1.9
Cory Joseph,25-141,G,1/8/17,TOR,HOU,0,23,4,8,0.5,4,8,0.5,0,0,,2,2,1,0,1,1,2,0,0,1,2,10,5.9
Thabo Sefolosha,32-324,G-F,3/22/17,ATL,WAS,1,31,4,8,0.5,2,6,0.333,2,2,1,0,0,,2,3,5,2,3,0,1,0,10,11.7
Robin Lopez,28-243,C,11/30/16,CHI,LAL,1,32,4,12,0.333,4,12,0.333,0,0,,2,2,1,4,5,9,1,1,8,2,3,10,11.6
Dwight Powell,25-176,F-C,1/12/17,DAL,PHO,0,15,3,7,0.429,3,7,0.429,0,0,,4,4,1,3,2,5,0,2,2,2,1,10,10
Kyle Korver,36-008,G-F,3/25/17,CLE,WAS,0,21,3,6,0.5,0,0,,3,6,0.5,1,1,1,0,2,2,0,0,0,0,3,10,6.4
Steven Adams,23-147,C,12/14/16,OKC,UTA,1,28,4,7,0.571,4,7,0.571,0,0,,2,2,1,3,2,5,1,1,2,2,3,10,9.3
Quincy Acy,26-162,F,3/17/17,BRK,BOS,0,32,3,11,0.273,1,3,0.333,2,8,0.25,2,4,0.5,0,8,8,3,1,0,1,2,10,6.4
P.J. Tucker,31-230,F,12/21/16,PHO,HOU,1,31,4,6,0.667,2,3,0.667,2,3,0.667,0,0,,3,3,6,2,1,0,1,3,10,10.6
Emmanuel Mudiay,20-250,G,11/10/16,DEN,GSW,1,24,4,15,0.267,2,10,0.2,2,5,0.4,0,0,,1,3,4,4,1,0,3,1,10,3.1
Enes Kanter,24-178,C,11/14/16,OKC,DET,0,17,4,9,0.444,4,7,0.571,0,2,0,2,2,1,2,1,3,1,0,1,0,0,10,8.4
Luol Deng,31-228,F,11/30/16,LAL,CHI,1,25,3,9,0.333,2,7,0.286,1,2,0.5,3,6,0.5,1,7,8,0,2,0,3,1,10,5.1
Doug McDermott,24-362,F,12/30/16,CHI,IND,0,29,4,5,0.8,2,3,0.667,2,2,1,0,2,0,0,4,4,2,1,0,0,1,10,10.5
T.J. Warren,23-188,F,3/12/17,PHO,POR,1,34,4,10,0.4,4,8,0.5,0,2,0,2,2,1,1,5,6,2,1,0,0,2,10,8.4
Pau Gasol,36-177,F-C,12/30/16,SAS,POR,1,23,4,11,0.364,4,11,0.364,0,0,,2,2,1,2,5,7,3,1,0,1,2,10,8.1
Zaza Pachulia,33-034,C,3/16/17,GSW,ORL,1,21,5,8,0.625,5,8,0.625,0,0,,0,0,,3,7,10,3,1,0,0,3,10,12.5
Allen Crabbe,24-267,G-F,1/1/17,POR,MIN,1,40,4,10,0.4,3,5,0.6,1,5,0.2,1,2,0.5,0,8,8,1,0,1,2,3,10,4.8
Ty Lawson,29-045,G,12/18/16,SAC,DAL,0,29,4,9,0.444,2,5,0.4,2,4,0.5,0,0,,0,2,2,3,1,0,2,1,10,6.6
JaVale McGee,29-060,C,3/20/17,GSW,OKC,0,13,5,7,0.714,5,7,0.714,0,0,,0,0,,3,2,5,0,0,4,0,0,10,12.6
Dante Exum,21-130,G,11/20/16,UTA,DEN,1,35,5,12,0.417,5,7,0.714,0,5,0,0,0,,4,2,6,2,0,0,1,3,10,6.2
David Nwaba,24-069,G,3/24/17,LAL,MIN,0,26,4,5,0.8,4,5,0.8,0,0,,2,3,0.667,2,5,7,2,0,0,0,3,10,10.8
Doug McDermott,24-353,F,12/21/16,CHI,WAS,0,26,4,11,0.364,2,5,0.4,2,6,0.333,0,0,,1,2,3,2,0,0,0,0,10,6.6
Myles Turner,20-273,F-C,12/22/16,IND,BOS,1,30,5,11,0.455,5,10,0.5,0,1,0,0,0,,1,6,7,0,0,1,2,3,10,4.3
Jonas Valanciunas,24-333,C,4/4/17,TOR,IND,1,28,4,6,0.667,4,6,0.667,0,0,,2,2,1,1,9,10,2,0,1,1,3,10,10.7
Al Horford,30-250,C-F,2/8/17,BOS,SAC,1,32,4,8,0.5,3,6,0.5,1,2,0.5,1,1,1,0,6,6,1,1,1,3,1,10,6.8
Allen Crabbe,24-340,G-F,3/15/17,POR,SAS,0,35,4,7,0.571,2,3,0.667,2,4,0.5,0,0,,0,2,2,1,2,0,1,3,10,7.8
Lou Williams,30-077,G,1/12/17,LAL,SAS,0,18,2,7,0.286,1,3,0.333,1,4,0.25,5,6,0.833,1,1,2,2,0,0,2,2,10,5.1
Dwight Powell,25-111,F-C,11/8/16,DAL,LAL,0,27,5,9,0.556,5,9,0.556,0,0,,0,0,,1,3,4,0,5,1,1,0,10,12
T.J. McConnell,24-364,G,3/24/17,PHI,CHI,1,26,4,6,0.667,4,6,0.667,0,0,,2,2,1,1,4,5,8,3,0,3,0,10,14.9
Anthony Tolliver,31-282,F-C,3/10/17,SAC,WAS,0,17,4,5,0.8,2,3,0.667,2,2,1,0,0,,0,3,3,0,0,0,1,2,10,7.2
Taj Gibson,31-265,F,3/16/17,OKC,TOR,1,24,4,8,0.5,4,8,0.5,0,0,,2,3,0.667,3,1,4,1,2,0,0,1,10,10.3
Serge Ibaka,27-091,F-C,12/18/16,ORL,TOR,1,22,5,9,0.556,5,8,0.625,0,1,0,0,0,,0,4,4,0,0,0,0,0,10,6.9
Ryan Anderson,28-316,F,3/18/17,HOU,DEN,1,27,3,7,0.429,2,3,0.667,1,4,0.25,3,3,1,0,4,4,0,0,0,1,2,10,5.7
Nik Stauskas,23-143,G,2/27/17,PHI,GSW,0,24,3,7,0.429,1,3,0.333,2,4,0.5,2,3,0.667,0,3,3,3,1,0,2,1,10,7.5
Jason Smith,30-310,F-C,1/6/17,WAS,MIN,0,22,5,8,0.625,5,8,0.625,0,0,,0,0,,0,3,3,2,0,2,0,0,10,10.1
Jordan Clarkson,24-229,G,1/22/17,LAL,DAL,0,25,5,13,0.385,5,11,0.455,0,2,0,0,0,,0,3,3,0,0,0,2,0,10,1.8
Lance Thomas,28-257,F,1/6/17,NYK,MIL,0,20,4,4,1,2,2,1,2,2,1,0,0,,1,1,2,0,1,0,2,3,10,7.6
Justin Holiday,27-256,G,12/17/16,NYK,DEN,0,20,3,6,0.5,2,3,0.667,1,3,0.333,3,4,0.75,0,1,1,1,0,0,1,3,10,5.4
Dwight Howard,31-022,C,12/30/16,ATL,DET,1,30,4,7,0.571,4,7,0.571,0,0,,2,3,0.667,5,10,15,1,0,1,0,3,10,13
Elfrid Payton,23-045,G,4/8/17,ORL,IND,1,33,5,10,0.5,5,10,0.5,0,0,,0,0,,0,3,3,10,1,0,6,1,10,7.5
Paul Millsap,32-034,F,3/16/17,ATL,MEM,1,31,3,9,0.333,1,6,0.167,2,3,0.667,2,4,0.5,0,3,3,3,1,1,4,2,10,4
Monta Ellis,31-151,G,3/26/17,IND,PHI,1,28,4,10,0.4,3,7,0.429,1,3,0.333,1,2,0.5,0,4,4,2,2,1,1,1,10,8.1
Clint Capela,22-213,F-C,12/17/16,HOU,MIN,1,15,5,5,1,5,5,1,0,0,,0,0,,1,3,4,0,0,0,1,1,10,8.7
Corey Brewer,30-300,F-G,12/30/16,HOU,LAC,0,16,3,5,0.6,3,3,1,0,2,0,4,4,1,1,2,3,1,3,0,0,4,10,11.1
Al Jefferson,31-340,C-F,12/9/16,IND,DAL,0,17,4,9,0.444,4,9,0.444,0,0,,2,2,1,1,2,3,0,0,1,2,2,10,4.5
Deron Williams,32-258,G,3/11/17,CLE,ORL,0,25,4,9,0.444,2,5,0.4,2,4,0.5,0,0,,0,1,1,4,0,1,0,3,10,7.9
Shabazz Napier,25-160,G,12/21/16,POR,DAL,0,16,3,6,0.5,1,4,0.25,2,2,1,2,2,1,1,0,1,1,1,0,0,2,10,8.6
Tony Parker,34-322,G,4/4/17,SAS,MEM,1,31,4,8,0.5,3,7,0.429,1,1,1,1,2,0.5,0,1,1,7,2,0,3,1,10,9.4
Dante Exum,21-145,G,12/5/16,UTA,LAL,1,18,4,5,0.8,2,3,0.667,2,2,1,0,0,,0,0,0,1,0,0,1,5,10,5.8
Michael Kidd-Gilchrist,23-058,F,11/23/16,CHO,SAS,1,29,5,11,0.455,5,11,0.455,0,0,,0,1,0,0,3,3,2,0,1,0,4,10,5.3
Vince Carter,40-051,G-F,3/18/17,MEM,SAS,1,30,3,9,0.333,1,2,0.5,2,7,0.286,2,2,1,0,4,4,3,2,0,2,3,10,7
Ricky Rubio,26-023,G,11/13/16,MIN,LAL,1,34,4,6,0.667,3,3,1,1,3,0.333,1,2,0.5,0,4,4,10,3,0,2,3,10,15
Alex Len,23-155,C,11/18/16,PHO,IND,1,22,5,7,0.714,5,7,0.714,0,0,,0,0,,3,7,10,1,1,3,2,4,10,11.5
Iman Shumpert,26-166,G,12/9/16,CLE,MIA,0,21,4,8,0.5,2,4,0.5,2,4,0.5,0,0,,0,4,4,1,1,0,1,1,10,7.5
Nikola Vucevic,26-059,C,12/22/16,ORL,NYK,0,27,4,11,0.364,4,10,0.4,0,1,0,2,4,0.5,3,2,5,6,1,0,1,4,10,8.4
Thabo Sefolosha,32-263,G-F,1/20/17,ATL,CHI,1,26,4,6,0.667,4,6,0.667,0,0,,2,2,1,2,2,4,1,3,0,0,1,10,12.7
Shawn Long,24-059,C-F,3/29/17,PHI,ATL,0,16,4,5,0.8,2,3,0.667,2,2,1,0,0,,0,1,1,1,0,0,0,1,10,8.7
Tyson Chandler,34-076,C,12/17/16,PHO,OKC,1,27,5,5,1,5,5,1,0,0,,0,1,0,3,6,9,0,1,0,0,2,10,12.2
Larry Nance Jr.,23-354,F,12/20/16,LAL,CHO,0,21,4,5,0.8,3,4,0.75,1,1,1,1,2,0.5,2,2,4,2,2,0,2,4,10,9.5
Domantas Sabonis,20-211,F,11/30/16,OKC,WAS,1,19,5,5,1,5,5,1,0,0,,0,0,,0,3,3,2,2,1,0,3,10,12.3
Malcolm Delaney,28-027,G,4/7/17,ATL,CLE,0,26,3,7,0.429,1,4,0.25,2,3,0.667,2,2,1,0,3,3,8,0,0,0,1,10,12.4
Dwight Howard,31-119,C,4/6/17,ATL,BOS,1,21,3,5,0.6,3,5,0.6,0,0,,4,8,0.5,1,7,8,1,0,0,3,4,10,5
Chandler Parsons,28-073,F,1/6/17,MEM,GSW,1,16,4,7,0.571,2,3,0.667,2,4,0.5,0,0,,0,1,1,0,1,0,1,2,10,6.2
Andre Iguodala,32-296,G-F,11/19/16,GSW,MIL,0,25,4,8,0.5,2,3,0.667,2,5,0.4,0,0,,2,1,3,3,1,0,0,1,10,10.4
David Lee,33-256,F,1/10/17,SAS,MIL,1,26,5,6,0.833,5,6,0.833,0,0,,0,0,,4,3,7,1,0,1,2,0,10,10.9
Joakim Noah,31-285,C,12/6/16,NYK,MIA,1,14,5,6,0.833,5,6,0.833,0,0,,0,0,,7,3,10,2,0,0,0,4,10,13.4
Emmanuel Mudiay,20-260,G,11/20/16,DEN,UTA,1,32,5,13,0.385,5,10,0.5,0,3,0,0,0,,1,7,8,8,0,0,0,0,10,11.3
Paul Zipser,23-042,G-F,4/1/17,CHI,ATL,1,27,3,5,0.6,1,1,1,2,4,0.5,2,2,1,0,2,2,1,0,2,0,4,10,8.8
Omer Asik,30-129,C,11/10/16,NOP,MIL,0,19,4,5,0.8,4,5,0.8,0,0,,2,4,0.5,3,3,6,0,0,0,0,3,10,9.1
Zaza Pachulia,32-261,C,10/28/16,GSW,NOP,1,17,4,6,0.667,4,6,0.667,0,0,,2,2,1,2,9,11,1,0,0,2,2,10,9.4
Jonathon Simmons,27-186,G-F,3/19/17,SAS,SAC,0,27,3,6,0.5,1,2,0.5,2,4,0.5,2,2,1,0,0,0,2,0,1,1,5,10,6.1
Patrick McCaw,21-044,G,12/8/16,GSW,UTA,0,16,4,5,0.8,2,2,1,2,3,0.667,0,0,,0,1,1,0,1,0,2,2,10,6.6
Justin Holiday,27-220,G,11/11/16,NYK,BOS,0,26,4,11,0.364,2,6,0.333,2,5,0.4,0,0,,4,1,5,0,1,2,1,2,10,7.6
Kelly Olynyk,25-245,C-F,12/20/16,BOS,MEM,0,26,2,7,0.286,1,5,0.2,1,2,0.5,5,6,0.833,1,2,3,1,3,2,2,1,10,9.5
Alec Burks,25-231,G,3/8/17,UTA,HOU,0,15,4,8,0.5,2,3,0.667,2,5,0.4,0,0,,0,4,4,0,0,0,2,0,10,5.2
Dwight Howard,31-001,C,12/9/16,ATL,MIL,1,28,3,4,0.75,3,4,0.75,0,0,,4,6,0.667,2,5,7,2,1,2,2,2,10,11.5
Treveon Graham,23-164,G,4/11/17,CHO,ATL,0,25,5,10,0.5,5,8,0.625,0,2,0,0,0,,0,4,4,1,2,0,1,0,10,7.9
James Young,21-179,G-F,2/11/17,BOS,UTA,0,15,4,7,0.571,2,2,1,2,5,0.4,0,1,0,0,0,0,0,0,0,0,2,10,5.5
Giannis Antetokounmpo,22-125,F-G,4/10/17,MIL,CHO,1,36,5,11,0.455,5,11,0.455,0,0,,0,0,,0,11,11,10,0,1,4,0,10,11.3
David West,36-096,F,12/3/16,GSW,PHO,0,13,5,6,0.833,5,6,0.833,0,0,,0,0,,0,2,2,2,0,0,0,1,10,9.4
Aaron Gordon,21-166,F,3/1/17,ORL,NYK,1,24,4,12,0.333,4,9,0.444,0,3,0,2,2,1,2,3,5,0,0,0,0,5,10,3.5
Gerald Henderson,29-009,G,12/18/16,PHI,BRK,1,29,4,6,0.667,3,5,0.6,1,1,1,1,1,1,0,2,2,3,1,0,0,1,10,10.7
James Harden,27-158,G,1/31/17,HOU,SAC,1,32,3,9,0.333,3,4,0.75,0,5,0,4,4,1,0,7,7,8,1,0,5,2,10,7.8
Vince Carter,40-069,G-F,4/5/17,MEM,OKC,1,25,3,10,0.3,1,3,0.333,2,7,0.286,2,2,1,1,1,2,2,0,0,1,5,10,3.6
Leandro Barbosa,34-021,G,12/19/16,PHO,MIN,0,14,4,6,0.667,2,4,0.5,2,2,1,0,0,,0,0,0,2,2,0,0,0,10,10.8
Vince Carter,39-355,G-F,1/15/17,MEM,CHI,0,31,4,8,0.5,2,3,0.667,2,5,0.4,0,0,,0,1,1,2,0,1,0,2,10,7.6
DeMarre Carroll,30-096,F,10/31/16,TOR,DEN,1,29,4,8,0.5,2,3,0.667,2,5,0.4,0,0,,0,2,2,0,0,1,0,4,10,5.7
LaMarcus Aldridge,31-184,F-C,1/19/17,SAS,DEN,1,29,4,9,0.444,4,9,0.444,0,0,,2,2,1,1,2,3,6,0,1,1,5,10,8.5
Maurice Harkless,23-238,F-G,1/4/17,POR,GSW,1,30,4,9,0.444,2,6,0.333,2,3,0.667,0,0,,3,4,7,1,1,1,2,5,10,7
Sean Kilpatrick,27-033,G,2/8/17,BRK,WAS,0,18,3,7,0.429,1,4,0.25,2,3,0.667,2,4,0.5,0,4,4,2,0,0,3,1,10,4.7
C.J. Miles,29-280,G-F,1/23/17,IND,NYK,1,34,4,14,0.286,2,5,0.4,2,9,0.222,0,0,,1,2,3,1,0,1,0,0,10,4.5
Raymond Felton,32-169,G,12/12/16,LAC,POR,0,24,4,8,0.5,2,5,0.4,2,3,0.667,0,0,,0,0,0,1,2,1,0,3,10,8.2
Cory Joseph,25-105,G,12/3/16,TOR,ATL,0,23,5,12,0.417,5,11,0.455,0,1,0,0,0,,1,4,5,6,1,0,1,3,10,8.5
Evan Turner,28-039,G,12/5/16,POR,CHI,0,29,5,6,0.833,5,5,1,0,1,0,0,0,,0,2,2,4,0,0,2,2,10,8.4
Lavoy Allen,28-006,F-C,2/10/17,IND,WAS,1,23,5,6,0.833,5,6,0.833,0,0,,0,0,,3,2,5,0,1,0,2,1,10,9.1
Jared Dudley,31-119,F-G,11/6/16,PHO,LAL,1,25,3,6,0.5,2,3,0.667,1,3,0.333,3,5,0.6,2,1,3,3,0,0,1,5,10,7
Joe Harris,25-094,G,12/10/16,BRK,SAS,0,19,4,8,0.5,3,6,0.5,1,2,0.5,1,2,0.5,0,4,4,0,0,0,1,2,10,5
Mason Plumlee,27-001,C-F,3/6/17,DEN,SAC,1,31,3,9,0.333,3,9,0.333,0,0,,4,6,0.667,2,9,11,5,1,1,6,3,10,6.2
Myles Turner,21-013,F-C,4/6/17,IND,MIL,1,25,3,8,0.375,3,8,0.375,0,0,,4,5,0.8,1,5,6,1,1,1,0,4,10,8.2
Aaron Brooks,31-296,G,11/5/16,IND,CHI,0,22,4,7,0.571,2,3,0.667,2,4,0.5,0,0,,0,0,0,0,0,1,3,4,10,2.8
Vince Carter,40-036,G-F,3/3/17,MEM,DAL,0,27,3,7,0.429,0,1,0,3,6,0.5,1,2,0.5,0,2,2,2,0,0,0,3,10,6.7
Joffrey Lauvergne,25-082,C-F,12/21/16,OKC,NOP,0,25,5,7,0.714,5,6,0.833,0,1,0,0,0,,1,5,6,3,2,0,0,1,10,13
Markieff Morris,27-119,F,12/30/16,WAS,BRK,1,21,5,8,0.625,5,6,0.833,0,2,0,0,0,,2,4,6,0,1,0,1,4,10,7.4
Mike Conley,29-028,G,11/8/16,MEM,DEN,1,30,4,15,0.267,4,12,0.333,0,3,0,2,4,0.5,0,3,3,7,5,0,3,1,10,7.7
Michael Kidd-Gilchrist,23-064,F,11/29/16,CHO,DET,1,32,3,7,0.429,3,7,0.429,0,0,,4,4,1,1,3,4,0,1,1,0,3,10,8.4
Jerian Grant,24-130,G,2/16/17,CHI,BOS,1,28,3,10,0.3,1,3,0.333,2,7,0.286,2,2,1,0,2,2,1,0,0,0,0,10,5.5
Lance Stephenson,26-060,G-F,11/4/16,NOP,PHO,0,28,5,15,0.333,5,11,0.455,0,4,0,0,2,0,0,1,1,7,0,0,1,3,10,3.7
Taj Gibson,31-189,F,12/30/16,CHI,IND,1,28,4,12,0.333,4,12,0.333,0,0,,2,2,1,3,2,5,1,1,0,0,1,10,7.2
J.J. Barea,32-208,G,1/20/17,DAL,UTA,0,23,5,10,0.5,5,8,0.625,0,2,0,0,0,,0,5,5,6,0,0,2,1,10,8.3
Patrick Beverley,28-148,G,12/7/16,HOU,LAL,1,32,4,9,0.444,2,3,0.667,2,6,0.333,0,0,,2,5,7,12,3,0,5,3,10,13.4
Zaza Pachulia,33-023,C,3/5/17,GSW,NYK,1,18,5,6,0.833,5,6,0.833,0,0,,0,0,,0,1,1,2,1,1,2,1,10,8.8
Lou Williams,30-075,G,1/10/17,LAL,POR,0,16,4,10,0.4,2,7,0.286,2,3,0.667,0,0,,0,0,0,1,0,0,1,1,10,3.9
Marcin Gortat,32-276,C-F,11/19/16,WAS,MIA,1,38,4,6,0.667,4,6,0.667,0,0,,2,4,0.5,6,10,16,4,0,5,1,2,10,18.3
Nicolas Batum,28-098,F-G,3/22/17,CHO,ORL,1,32,5,14,0.357,5,10,0.5,0,4,0,0,0,,0,2,2,6,2,0,5,0,10,4
Al-Farouq Aminu,26-082,F,12/12/16,POR,LAC,1,21,4,6,0.667,2,3,0.667,2,3,0.667,0,0,,1,3,4,2,0,0,2,1,10,8
Dirk Nowitzki,38-157,F,11/23/16,DAL,LAC,1,20,3,10,0.3,2,7,0.286,1,3,0.333,3,3,1,0,6,6,1,0,0,1,2,10,4.9
Jerami Grant,22-290,F,12/27/16,OKC,MIA,0,24,3,7,0.429,3,4,0.75,0,3,0,4,4,1,0,0,0,1,0,1,0,5,10,5.7
Nemanja Bjelica,28-292,F,2/25/17,MIN,HOU,0,14,4,5,0.8,2,3,0.667,2,2,1,0,0,,1,0,1,0,0,0,3,4,10,4.2
Patrick Beverley,28-155,G,12/14/16,HOU,SAC,1,29,4,9,0.444,2,3,0.667,2,6,0.333,0,0,,0,4,4,7,1,0,2,3,10,9.2
Harrison Barnes,24-301,F,3/27/17,DAL,OKC,1,37,4,14,0.286,3,10,0.3,1,4,0.25,1,2,0.5,1,1,2,0,1,0,1,1,10,2
Willie Cauley-Stein,23-166,F-C,1/31/17,SAC,HOU,0,24,4,10,0.4,4,9,0.444,0,1,0,2,2,1,2,4,6,2,0,3,1,2,10,8.9
Wesley Matthews,30-134,G,2/25/17,DAL,NOP,1,30,3,7,0.429,1,1,1,2,6,0.333,2,2,1,0,2,2,3,1,0,2,1,10,7.6
Dirk Nowitzki,38-190,F,12/26/16,DAL,NOP,1,17,4,9,0.444,2,5,0.4,2,4,0.5,0,0,,0,2,2,4,0,0,0,1,10,8.3
Yogi Ferrell,23-337,G,4/11/17,DAL,DEN,1,35,4,12,0.333,3,7,0.429,1,5,0.2,1,1,1,0,5,5,3,1,0,3,1,10,4.4
Rudy Gobert,24-152,C,11/25/16,UTA,ATL,1,29,2,2,1,2,2,1,0,0,,6,7,0.857,0,10,10,1,0,5,1,3,10,14
Luc Mbah a Moute,30-132,F,1/19/17,LAC,MIN,1,28,4,6,0.667,4,4,1,0,2,0,2,2,1,1,0,1,0,2,0,2,3,10,6.9
Pascal Siakam,22-276,F,11/6/16,TOR,SAC,1,24,4,8,0.5,4,8,0.5,0,0,,2,3,0.667,3,3,6,1,0,1,0,4,10,8.4
T.J. McConnell,24-299,G,1/18/17,PHI,TOR,1,29,4,6,0.667,4,6,0.667,0,0,,2,2,1,0,5,5,8,1,0,1,4,10,12.9
Malcolm Delaney,27-243,G,11/9/16,ATL,CHI,0,17,4,6,0.667,4,5,0.8,0,1,0,2,2,1,0,1,1,2,0,0,1,0,10,8.1
Shabazz Napier,25-165,G,12/26/16,POR,TOR,0,14,2,5,0.4,0,1,0,2,4,0.5,4,4,1,0,1,1,0,2,0,3,0,10,6.6
Beno Udrih,34-120,G,11/2/16,DET,BRK,0,17,4,9,0.444,4,8,0.5,0,1,0,2,2,1,1,0,1,4,1,0,0,0,10,9.8
Will Barton,25-321,G,11/22/16,DEN,CHI,1,26,3,13,0.231,1,9,0.111,2,4,0.5,2,2,1,2,1,3,2,0,0,2,0,10,3.2
Larry Nance Jr.,24-036,F,2/6/17,LAL,NYK,0,31,4,9,0.444,4,9,0.444,0,0,,2,2,1,4,6,10,2,3,0,1,5,10,11.3
Kay Felder,21-354,G,3/18/17,CLE,LAC,0,15,4,12,0.333,4,10,0.4,0,2,0,2,2,1,0,2,2,2,0,0,2,1,10,2.8
Elfrid Payton,22-281,G,11/29/16,ORL,SAS,0,23,5,9,0.556,5,9,0.556,0,0,,0,0,,1,2,3,4,3,1,1,2,10,11.7
Thaddeus Young,28-248,F,2/24/17,IND,MEM,1,26,5,7,0.714,5,7,0.714,0,0,,0,0,,0,5,5,1,1,1,0,2,10,10.2
Brandon Rush,31-183,G-F,1/6/17,MIN,WAS,0,20,4,4,1,2,2,1,2,2,1,0,0,,1,0,1,0,0,1,0,0,10,10.2
Darren Collison,29-119,G,12/20/16,SAC,POR,1,21,3,8,0.375,3,7,0.429,0,1,0,4,5,0.8,1,2,3,3,0,0,1,2,10,6.8
Dragan Bender,19-016,F,12/3/16,PHO,GSW,0,25,4,6,0.667,2,2,1,2,4,0.5,0,0,,0,4,4,1,0,1,0,0,10,10
Allen Crabbe,24-258,G-F,12/23/16,POR,SAS,0,30,4,7,0.571,2,4,0.5,2,3,0.667,0,0,,0,1,1,2,1,0,2,2,10,6.6
Frank Kaminsky,23-302,F-C,1/31/17,CHO,POR,0,25,4,10,0.4,4,6,0.667,0,4,0,2,3,0.667,0,1,1,0,1,0,1,1,10,4.1
Gorgui Dieng,26-336,C,12/19/16,MIN,PHO,1,40,5,10,0.5,5,10,0.5,0,0,,0,0,,4,5,9,1,1,2,2,5,10,8.4
Zaza Pachulia,32-331,C,1/6/17,GSW,MEM,1,30,3,4,0.75,3,4,0.75,0,0,,4,4,1,0,5,5,2,0,0,0,3,10,10.1
Otto Porter,23-155,F,11/5/16,WAS,ORL,1,29,4,8,0.5,2,5,0.4,2,3,0.667,0,0,,3,10,13,0,0,0,0,4,10,9.5
Kosta Koufos,27-294,C,12/14/16,SAC,HOU,1,25,5,11,0.455,5,11,0.455,0,0,,0,0,,5,2,7,1,0,2,1,3,10,8.3
Pascal Siakam,22-286,F,11/16/16,TOR,GSW,1,30,5,10,0.5,5,10,0.5,0,0,,0,0,,4,5,9,0,1,0,1,4,10,7.7
Marquese Chriss,19-166,F,12/15/16,PHO,SAS,1,31,4,9,0.444,2,5,0.4,2,4,0.5,0,0,,1,1,2,0,1,1,0,1,10,7.6
Tim Frazier,26-013,G,11/14/16,NOP,BOS,1,30,2,5,0.4,2,3,0.667,0,2,0,6,8,0.75,1,2,3,6,1,0,3,0,10,10
Anthony Tolliver,31-244,F-C,1/31/17,SAC,HOU,0,22,3,4,0.75,1,1,1,2,3,0.667,2,5,0.4,0,3,3,0,2,1,1,1,10,9.4
Donatas Motiejunas,26-131,F-C,1/29/17,NOP,WAS,0,22,5,6,0.833,5,5,1,0,1,0,0,3,0,2,2,4,2,0,0,3,2,10,6.2
Brandon Ingram,19-072,F,11/13/16,LAL,MIN,0,27,3,5,0.6,2,3,0.667,1,2,0.5,3,4,0.75,0,1,1,1,1,1,1,4,10,7.4
Kyle Lowry,30-215,G,10/26/16,TOR,DET,1,38,3,13,0.231,2,8,0.25,1,5,0.2,3,3,1,1,4,5,8,1,0,2,2,10,7.8
Andrew Harrison,22-144,G,3/21/17,MEM,NOP,0,24,3,5,0.6,2,4,0.5,1,1,1,3,5,0.6,1,3,4,0,0,1,5,3,10,3
Wesley Johnson,29-172,F-G,12/30/16,LAC,HOU,1,24,3,7,0.429,1,2,0.5,2,5,0.4,2,3,0.667,1,4,5,1,3,0,1,4,10,8.9
Dario Saric,22-327,F,3/1/17,PHI,MIA,1,28,4,12,0.333,2,9,0.222,2,3,0.667,0,0,,3,3,6,2,0,0,3,4,10,3
Manu Ginobili,39-113,G,11/18/16,SAS,LAL,0,21,4,6,0.667,2,2,1,2,4,0.5,0,0,,0,0,0,3,0,1,1,3,10,8
Kent Bazemore,27-182,G-F,12/30/16,ATL,DET,1,29,4,8,0.5,4,7,0.571,0,1,0,2,3,0.667,0,2,2,4,2,1,2,4,10,8.1
Tristan Thompson,25-299,F-C,1/6/17,CLE,BRK,1,30,3,3,1,3,3,1,0,0,,4,13,0.308,2,7,9,2,3,2,2,5,10,10.8
Kent Bazemore,27-238,G-F,2/24/17,ATL,MIA,1,23,4,9,0.444,2,6,0.333,2,3,0.667,0,0,,0,3,3,2,0,2,2,2,10,6.2
Paul Millsap,31-286,F,11/22/16,ATL,NOP,1,23,4,9,0.444,3,6,0.5,1,3,0.333,1,2,0.5,1,7,8,2,1,1,1,3,10,8.6
Draymond Green,26-260,F,11/19/16,GSW,MIL,1,36,3,7,0.429,3,6,0.5,0,1,0,4,4,1,1,1,2,5,3,2,2,3,10,12
Solomon Hill,25-283,F,12/26/16,NOP,DAL,1,31,2,5,0.4,0,0,,2,5,0.4,4,4,1,0,7,7,2,1,0,0,4,10,10.2
Sean Kilpatrick,27-056,G,3/3/17,BRK,UTA,0,23,4,10,0.4,4,9,0.444,0,1,0,2,3,0.667,0,2,2,1,0,0,0,0,10,5.5
Josh Richardson,23-204,G,4/7/17,MIA,TOR,1,36,4,12,0.333,2,8,0.25,2,4,0.5,0,0,,2,0,2,4,3,1,2,3,10,7.9
Kelly Olynyk,25-277,C-F,1/21/17,BOS,POR,0,25,4,4,1,4,4,1,0,0,,2,2,1,2,6,8,1,0,0,4,4,10,7.1
Patrick Patterson,27-323,F,1/31/17,TOR,NOP,1,35,4,8,0.5,2,3,0.667,2,5,0.4,0,0,,0,7,7,1,0,1,3,2,10,5.7
Rajon Rondo,30-252,G,10/31/16,CHI,BRK,1,25,5,8,0.625,5,7,0.714,0,1,0,0,0,,1,3,4,4,2,1,3,2,10,9.7
Andrew Wiggins,21-329,F-G,1/17/17,MIN,SAS,1,38,3,8,0.375,3,7,0.429,0,1,0,4,6,0.667,0,3,3,3,1,0,3,3,10,4.6
Willie Reed,26-163,F-C,10/26/16,MIA,ORL,0,17,5,6,0.833,5,6,0.833,0,0,,0,0,,3,3,6,1,0,1,0,1,10,11.8
Okaro White,24-181,F,2/10/17,MIA,BRK,0,31,2,6,0.333,1,4,0.25,1,2,0.5,5,6,0.833,4,1,5,1,0,0,2,4,10,6.4
Dwight Howard,30-346,C,11/18/16,ATL,CHO,1,31,4,9,0.444,4,9,0.444,0,0,,2,6,0.333,2,16,18,2,3,2,1,2,10,13.9
Clint Capela,22-256,F-C,1/29/17,HOU,IND,0,22,4,6,0.667,4,6,0.667,0,0,,2,2,1,1,3,4,1,1,1,0,2,10,10.6
Omri Casspi,28-168,F,12/7/16,SAC,DAL,0,18,5,7,0.714,5,6,0.833,0,1,0,0,0,,0,5,5,3,0,0,1,1,10,9.3
Jake Layman,23-036,F,4/12/17,POR,NOP,1,37,4,10,0.4,2,5,0.4,2,5,0.4,0,0,,2,2,4,3,0,0,4,2,10,3.9
Danny Green,29-183,G-F,12/22/16,SAS,LAC,1,30,4,8,0.5,2,3,0.667,2,5,0.4,0,0,,1,4,5,1,1,0,1,1,10,8.2
Amir Johnson,29-291,F,2/16/17,BOS,CHI,1,17,5,6,0.833,5,6,0.833,0,0,,0,0,,0,2,2,0,1,2,1,2,10,9
Buddy Hield,23-003,G,12/20/16,NOP,PHI,1,21,4,9,0.444,2,7,0.286,2,2,1,0,0,,0,1,1,1,0,0,2,1,10,3.9
Channing Frye,33-323,C-F,4/5/17,CLE,BOS,1,17,3,7,0.429,1,1,1,2,6,0.333,2,2,1,3,5,8,1,2,0,1,3,10,10.4
Jaylen Brown,20-166,F,4/8/17,BOS,CHO,0,17,4,7,0.571,2,4,0.5,2,3,0.667,0,0,,1,2,3,0,0,0,0,1,10,7.6
James Ennis,26-138,F,11/16/16,MEM,LAC,1,31,2,8,0.25,1,5,0.2,1,3,0.333,5,6,0.833,1,2,3,2,0,0,2,3,10,4.3
Gorgui Dieng,26-351,C,1/3/17,MIN,PHI,1,27,4,6,0.667,4,6,0.667,0,0,,2,2,1,1,7,8,2,1,2,1,4,10,11.4
Ersan Ilyasova,29-297,F,3/8/17,ATL,BRK,0,26,3,7,0.429,2,5,0.4,1,2,0.5,3,4,0.75,2,5,7,3,2,0,2,3,10,9.7
Tyler Johnson,24-296,G,2/27/17,MIA,DAL,0,24,4,7,0.571,3,6,0.5,1,1,1,1,2,0.5,1,3,4,4,2,0,3,5,10,7.7
Ersan Ilyasova,29-260,F,1/30/17,PHI,SAC,1,23,3,8,0.375,2,3,0.667,1,5,0.2,3,4,0.75,1,1,2,1,1,0,1,2,10,6.1
Randy Foye,33-173,G,3/16/17,BRK,NYK,1,28,3,9,0.333,1,5,0.2,2,4,0.5,2,3,0.667,0,4,4,2,1,0,1,2,10,6.3
Michael Kidd-Gilchrist,23-064,F,11/29/16,CHO,DET,1,32,3,7,0.429,3,7,0.429,0,0,,4,4,1,1,3,4,0,1,1,0,3,10,8.4
Leandro Barbosa,33-346,G,11/8/16,PHO,POR,0,15,3,5,0.6,3,3,1,0,2,0,4,4,1,0,2,2,3,1,0,0,1,10,11
Al Jefferson,31-341,C-F,12/10/16,IND,POR,0,15,4,9,0.444,4,9,0.444,0,0,,2,3,0.667,2,6,8,1,0,1,0,1,10,9.1
Evan Fournier,24-069,G-F,1/6/17,ORL,HOU,1,35,4,13,0.308,4,11,0.364,0,2,0,2,3,0.667,3,6,9,2,1,0,2,2,10,5.6
Tyler Ulis,21-066,G,3/12/17,PHO,POR,0,19,5,8,0.625,5,7,0.714,0,1,0,0,0,,1,1,2,6,0,1,1,0,10,11.3
Jeremy Lamb,24-213,G-F,12/29/16,CHO,MIA,0,23,4,10,0.4,4,9,0.444,0,1,0,2,2,1,0,9,9,0,0,1,0,1,10,7.6
Dragan Bender,19-041,F,12/28/16,PHO,SAS,0,27,4,4,1,2,2,1,2,2,1,0,0,,0,4,4,1,1,1,0,2,10,11.6
Sergio Rodriguez,30-262,G,3/1/17,PHI,MIA,0,18,5,10,0.5,5,10,0.5,0,0,,0,0,,1,0,1,2,0,0,0,1,10,6.7
Andre Drummond,23-116,C,12/4/16,DET,ORL,1,35,5,11,0.455,5,11,0.455,0,0,,0,4,0,4,6,10,3,3,2,3,2,10,10
Jared Dudley,31-158,F-G,12/15/16,PHO,SAS,0,20,4,5,0.8,2,2,1,2,3,0.667,0,0,,0,4,4,0,0,2,0,2,10,9.9
Donatas Motiejunas,26-127,F-C,1/25/17,NOP,OKC,0,17,4,6,0.667,3,4,0.75,1,2,0.5,1,2,0.5,0,4,4,0,0,0,2,5,10,4.2
Tyus Jones,20-183,G,11/9/16,MIN,ORL,0,31,3,9,0.333,1,5,0.2,2,4,0.5,2,2,1,1,3,4,5,2,0,0,1,10,11.6
Eric Gordon,28-083,G,3/18/17,HOU,DEN,0,33,4,7,0.571,3,4,0.75,1,3,0.333,1,2,0.5,0,3,3,2,1,1,0,2,10,9.5
Brandan Wright,29-157,F-C,3/11/17,MEM,ATL,0,13,4,6,0.667,4,6,0.667,0,0,,2,2,1,0,4,4,1,0,0,0,1,10,8.9
Terry Rozier,22-323,G,2/3/17,BOS,LAL,0,18,4,4,1,2,2,1,2,2,1,0,0,,1,3,4,2,0,0,2,0,10,9.8
Alex Abrines,23-109,G-F,11/18/16,OKC,BRK,0,22,4,10,0.4,2,3,0.667,2,7,0.286,0,0,,0,2,2,0,0,0,1,1,10,3.8
Willie Cauley-Stein,23-200,F-C,3/6/17,SAC,DEN,1,28,5,11,0.455,5,11,0.455,0,0,,0,0,,2,4,6,1,1,0,1,6,10,5.2
Thaddeus Young,28-194,F,1/1/17,IND,ORL,1,32,4,12,0.333,2,8,0.25,2,4,0.5,0,0,,1,2,3,1,2,0,3,2,10,3.4
Jeremy Lin,28-071,G,11/2/16,BRK,DET,1,16,4,6,0.667,4,5,0.8,0,1,0,2,2,1,0,2,2,4,0,0,1,0,10,9.8
Doug McDermott,25-022,F,1/25/17,CHI,ATL,0,23,4,9,0.444,2,4,0.5,2,5,0.4,0,0,,0,2,2,1,0,0,1,1,10,5.2
Ivica Zubac,19-359,C,3/12/17,LAL,PHI,1,19,4,5,0.8,4,5,0.8,0,0,,2,3,0.667,0,6,6,0,0,4,2,2,10,9.5
Iman Shumpert,26-178,G,12/21/16,CLE,MIL,0,29,3,7,0.429,0,3,0,3,4,0.75,1,2,0.5,0,3,3,4,1,1,0,1,10,10.9
Matthew Dellavedova,26-181,G,3/8/17,MIL,NYK,0,26,3,8,0.375,1,2,0.5,2,6,0.333,2,2,1,0,2,2,3,0,0,3,0,10,5.3
Marvin Williams,30-215,F,1/20/17,CHO,TOR,1,21,3,6,0.5,1,2,0.5,2,4,0.5,2,2,1,0,8,8,2,1,0,0,1,10,11.4
Paul Zipser,23-036,G-F,3/26/17,CHI,MIL,1,29,3,7,0.429,2,5,0.4,1,2,0.5,3,4,0.75,1,4,5,2,0,1,1,4,10,7.3
Tyler Johnson,24-184,G,11/7/16,MIA,OKC,0,27,4,9,0.444,4,8,0.5,0,1,0,2,2,1,1,3,4,1,3,1,1,1,10,9.9
Taj Gibson,31-200,F,1/10/17,CHI,WAS,1,29,3,11,0.273,2,10,0.2,1,1,1,3,3,1,4,8,12,1,0,1,0,1,10,9.7
Tomas Satoransky,25-078,G,1/16/17,WAS,POR,0,19,4,7,0.571,3,4,0.75,1,3,0.333,1,1,1,3,7,10,3,1,0,2,0,10,12
Jae Crowder,26-150,F,12/3/16,BOS,PHI,1,33,4,8,0.5,2,4,0.5,2,4,0.5,0,0,,1,3,4,3,1,0,0,4,10,9.1
Cristiano Felicio,24-248,F-C,3/12/17,CHI,BOS,0,21,4,8,0.5,4,8,0.5,0,0,,2,2,1,1,3,4,0,1,0,0,1,10,8.2
Devin Harris,34-032,G,3/31/17,DAL,MEM,0,26,2,4,0.5,2,2,1,0,2,0,6,6,1,0,2,2,0,2,0,0,4,10,9
Jeff Teague,28-259,G,2/24/17,IND,MEM,1,31,2,8,0.25,1,5,0.2,1,3,0.333,5,5,1,0,4,4,10,0,0,3,3,10,9.2
Okaro White,24-165,F,1/25/17,MIA,BRK,0,27,3,4,0.75,1,1,1,2,3,0.667,2,2,1,0,7,7,1,1,4,1,4,10,12.4
Iman Shumpert,26-211,G,1/23/17,CLE,NOP,1,28,4,10,0.4,2,4,0.5,2,6,0.333,0,0,,0,2,2,2,1,0,0,1,10,7.2
Spencer Hawes,28-272,C-F,1/25/17,CHO,GSW,0,29,4,13,0.308,3,11,0.273,1,2,0.5,1,1,1,3,10,13,5,0,1,2,3,10,8.6
Jae Crowder,26-119,F,11/2/16,BOS,CHI,1,14,4,6,0.667,2,4,0.5,2,2,1,0,0,,0,5,5,1,0,0,1,1,10,8.2
Otto Porter,23-190,F,12/10/16,WAS,MIL,1,33,4,9,0.444,2,5,0.4,2,4,0.5,0,0,,1,0,1,1,2,1,0,2,10,8.6
Terrence Ross,25-322,F-G,12/23/16,TOR,UTA,0,20,4,7,0.571,2,3,0.667,2,4,0.5,0,0,,0,1,1,1,0,0,0,1,10,7.3
Emmanuel Mudiay,20-285,G,12/15/16,DEN,POR,1,22,3,6,0.5,1,3,0.333,2,3,0.667,2,2,1,0,0,0,4,1,0,4,2,10,6
Patty Mills,28-113,G,12/2/16,SAS,WAS,0,28,4,9,0.444,2,5,0.4,2,4,0.5,0,0,,1,3,4,8,0,0,1,1,10,11.1
Corey Brewer,30-265,F-G,11/25/16,HOU,SAC,0,13,4,5,0.8,2,3,0.667,2,2,1,0,0,,0,2,2,0,1,0,0,3,10,8.5
Derrick Rose,28-063,G,12/6/16,NYK,MIA,1,25,4,12,0.333,4,11,0.364,0,1,0,2,2,1,1,1,2,3,2,0,1,0,10,7.3
Jusuf Nurkic,22-101,C,12/2/16,DEN,HOU,1,20,5,9,0.556,5,9,0.556,0,0,,0,2,0,4,3,7,1,2,3,4,2,10,8.6
Pierre Jackson,25-146,G,1/22/17,DAL,LAL,0,18,4,9,0.444,3,6,0.5,1,3,0.333,1,1,1,0,2,2,5,1,0,0,1,10,10
Rudy Gobert,24-227,C,2/8/17,UTA,NOP,1,30,4,10,0.4,4,10,0.4,0,0,,2,2,1,7,9,16,3,0,2,1,3,10,13.5
Sergio Rodriguez,30-218,G,1/16/17,PHI,MIL,1,32,4,10,0.4,3,4,0.75,1,6,0.167,1,1,1,0,5,5,6,1,0,3,1,10,7.9
Jodie Meeks,29-103,G,12/2/16,ORL,PHI,0,17,2,6,0.333,0,3,0,2,3,0.667,4,4,1,0,1,1,0,3,0,1,1,10,8.5
Marcin Gortat,32-273,C-F,11/16/16,WAS,PHI,1,39,5,6,0.833,5,6,0.833,0,0,,0,1,0,2,12,14,1,0,0,3,3,10,8.9
Dwight Howard,30-361,C,12/3/16,ATL,TOR,1,28,4,9,0.444,4,9,0.444,0,0,,2,4,0.5,7,10,17,1,0,2,1,2,10,12.7
Manu Ginobili,39-089,G,10/25/16,SAS,GSW,0,21,4,10,0.4,2,4,0.5,2,6,0.333,0,0,,0,5,5,2,1,0,0,1,10,8.1
Jaylen Brown,20-071,F,1/3/17,BOS,UTA,0,13,4,6,0.667,3,4,0.75,1,2,0.5,1,1,1,0,3,3,1,0,1,2,1,10,7.3
Spencer Hawes,28-249,C-F,1/2/17,CHO,CHI,0,26,5,9,0.556,5,8,0.625,0,1,0,0,0,,1,2,3,2,0,2,3,3,10,5.6
Tony Allen,35-028,G-F,2/8/17,MEM,PHO,1,29,4,12,0.333,4,12,0.333,0,0,,2,4,0.5,2,5,7,2,2,1,1,3,10,7.2
Danny Green,29-149,G-F,11/18/16,SAS,LAL,1,27,4,6,0.667,2,3,0.667,2,3,0.667,0,0,,0,4,4,6,2,0,1,2,10,13
Kelly Oubre,21-057,F,2/4/17,WAS,NOP,0,23,3,6,0.5,1,1,1,2,5,0.4,2,2,1,0,2,2,0,0,1,1,2,10,6.5
Brook Lopez,28-306,C,2/1/17,BRK,NYK,1,31,4,11,0.364,4,9,0.444,0,2,0,2,4,0.5,2,4,6,1,1,1,0,2,10,7.3
Courtney Lee,31-075,G,12/17/16,NYK,DEN,1,36,4,12,0.333,2,9,0.222,2,3,0.667,0,0,,2,0,2,1,0,0,0,6,10,2.9
Amir Johnson,29-262,F,1/18/17,BOS,NYK,1,18,5,6,0.833,5,6,0.833,0,0,,0,0,,1,6,7,2,1,2,0,4,10,12.5
Aaron Brooks,31-311,G,11/20/16,IND,OKC,0,13,4,6,0.667,2,3,0.667,2,3,0.667,0,0,,1,0,1,1,0,0,2,1,10,6.4
Bojan Bogdanovic,27-285,G-F,1/28/17,BRK,MIN,1,24,4,12,0.333,4,11,0.364,0,1,0,2,3,0.667,0,1,1,2,0,0,2,1,10,2.1
Robin Lopez,28-232,C,11/19/16,CHI,LAC,1,26,5,6,0.833,5,6,0.833,0,0,,0,0,,3,3,6,0,1,0,0,3,10,10.6
Tony Allen,35-086,G-F,4/7/17,MEM,NYK,1,19,5,8,0.625,5,8,0.625,0,0,,0,0,,2,2,4,0,0,0,0,1,10,8
Myles Turner,20-268,F-C,12/17/16,IND,DET,1,28,3,7,0.429,2,6,0.333,1,1,1,3,4,0.75,1,4,5,1,0,2,0,2,10,9.1
Adreian Payne,25-268,F-C,11/13/16,MIN,LAL,0,9,4,5,0.8,2,3,0.667,2,2,1,0,0,,1,1,2,0,0,0,0,1,10,8.7
Ersan Ilyasova,29-292,F,3/3/17,ATL,CLE,0,23,4,4,1,4,4,1,0,0,,2,2,1,1,7,8,2,1,0,1,2,10,12.2
Sam Dekker,22-228,F,12/20/16,HOU,SAS,0,21,3,9,0.333,3,6,0.5,0,3,0,4,4,1,5,2,7,1,1,1,2,0,10,9.4
Andre Drummond,23-186,C,2/12/17,DET,TOR,1,27,3,10,0.3,3,10,0.3,0,0,,4,8,0.5,8,10,18,0,1,1,1,3,10,10.7
Jahlil Okafor,21-092,C-F,3/17/17,PHI,DAL,0,21,4,8,0.5,4,8,0.5,0,0,,2,2,1,0,3,3,1,0,1,6,4,10,0.7
Devin Harris,33-328,G,1/20/17,DAL,UTA,0,18,2,4,0.5,0,0,,2,4,0.5,4,4,1,0,0,0,3,0,0,2,3,10,6.9
Taj Gibson,31-185,F,12/26/16,CHI,IND,1,22,5,12,0.417,5,12,0.417,0,0,,0,0,,0,2,2,0,1,0,2,1,10,2.8
David West,36-189,F,3/6/17,GSW,ATL,0,13,5,7,0.714,5,7,0.714,0,0,,0,0,,0,3,3,1,0,0,2,1,10,6.3
Sasha Vujacic,33-029,G,4/6/17,NYK,WAS,0,21,4,9,0.444,2,7,0.286,2,2,1,0,1,0,1,3,4,3,2,0,0,1,10,10.2
Jrue Holiday,26-184,G,12/13/16,NOP,GSW,1,30,3,12,0.25,2,7,0.286,1,5,0.2,3,6,0.5,2,5,7,6,4,1,3,3,10,9.2
Montrezl Harrell,23-028,F-C,2/23/17,HOU,NOP,0,14,5,6,0.833,5,6,0.833,0,0,,0,2,0,2,1,3,2,0,0,0,5,10,8.1
Wesley Matthews,30-166,G,3/29/17,DAL,NOP,1,37,4,8,0.5,2,4,0.5,2,4,0.5,0,0,,0,3,3,4,0,0,1,2,10,7.9
Patty Mills,28-092,G,11/11/16,SAS,DET,0,26,3,7,0.429,2,3,0.667,1,4,0.25,3,3,1,0,2,2,4,1,0,1,2,10,8.9
Channing Frye,33-218,C-F,12/21/16,CLE,MIL,0,22,4,8,0.5,2,3,0.667,2,5,0.4,0,0,,0,1,1,0,0,0,0,3,10,5.1
Nemanja Bjelica,28-305,F,3/10/17,MIN,GSW,0,34,4,10,0.4,3,6,0.5,1,4,0.25,1,2,0.5,5,7,12,2,0,0,0,3,10,10
Jeremy Lin,28-121,G,12/22/16,BRK,GSW,1,32,4,12,0.333,2,5,0.4,2,7,0.286,0,0,,0,8,8,11,2,2,5,1,10,11.3
Maurice Harkless,23-229,F-G,12/26/16,POR,TOR,1,33,5,9,0.556,5,8,0.625,0,1,0,0,2,0,0,5,5,1,2,2,4,4,10,4.9
Ersan Ilyasova,29-331,F,4/11/17,ATL,CHO,0,16,3,9,0.333,2,5,0.4,1,4,0.25,3,4,0.75,2,4,6,2,0,0,0,1,10,8.1
Derrick Williams,25-283,F,3/4/17,CLE,MIA,0,29,2,5,0.4,1,3,0.333,1,2,0.5,5,6,0.833,1,5,6,0,0,0,3,2,10,5.3
Channing Frye,33-222,C-F,12/25/16,CLE,GSW,0,17,4,7,0.571,2,2,1,2,5,0.4,0,0,,0,2,2,0,0,0,3,2,10,3.5
Derrick Jones,20-055,F,4/11/17,PHO,SAC,1,33,3,9,0.333,2,6,0.333,1,3,0.333,3,5,0.6,3,1,4,4,1,0,1,3,10,8.1
Wilson Chandler,29-234,F,12/30/16,DEN,PHI,1,36,4,8,0.5,3,5,0.6,1,3,0.333,1,2,0.5,2,7,9,3,0,0,2,1,10,8.8
Justin Holiday,27-345,G,3/16/17,NYK,BRK,0,25,4,7,0.571,2,3,0.667,2,4,0.5,0,0,,0,1,1,2,1,1,0,1,10,9.7
Tristan Thompson,25-333,F-C,2/9/17,CLE,OKC,1,32,3,7,0.429,3,7,0.429,0,0,,4,5,0.8,1,4,5,1,1,1,1,2,10,8.4
P.J. Tucker,31-248,F,1/8/17,PHO,CLE,0,28,4,6,0.667,4,4,1,0,2,0,2,2,1,0,4,4,2,2,0,2,3,10,8.8
Thaddeus Young,28-198,F,1/5/17,IND,BRK,1,32,3,10,0.3,2,7,0.286,1,3,0.333,3,4,0.75,0,6,6,1,0,2,0,3,10,6.5
Cole Aldrich,28-032,C,12/2/16,MIN,NYK,0,27,4,6,0.667,4,6,0.667,0,0,,2,2,1,5,7,12,2,2,3,0,3,10,17.3
Lavoy Allen,28-020,F-C,2/24/17,IND,MEM,0,21,5,5,1,5,5,1,0,0,,0,0,,2,8,10,0,1,1,1,1,10,12.6
Isaiah Whitehead,22-029,G,4/6/17,BRK,ORL,0,26,3,7,0.429,2,3,0.667,1,4,0.25,3,3,1,1,2,3,3,1,2,2,1,10,9.7
James Johnson,29-328,F,1/13/17,MIA,MIL,0,38,4,7,0.571,3,5,0.6,1,2,0.5,1,1,1,0,2,2,12,0,2,1,1,10,15.7
Ersan Ilyasova,29-254,F,1/24/17,PHI,LAC,1,22,3,9,0.333,1,4,0.25,2,5,0.4,2,2,1,0,5,5,3,1,0,0,5,10,7.5
Manu Ginobili,39-185,G,1/29/17,SAS,DAL,0,24,3,7,0.429,0,3,0,3,4,0.75,1,4,0.25,1,4,5,3,1,0,2,3,10,6.9
Patrick Beverley,28-274,G,4/12/17,HOU,MIN,1,31,3,9,0.333,1,3,0.333,2,6,0.333,2,3,0.667,5,5,10,7,3,0,1,2,10,15.6
Andre Iguodala,32-293,G-F,11/16/16,GSW,TOR,0,25,4,4,1,2,2,1,2,2,1,0,0,,0,3,3,5,2,1,1,1,10,14.5
Otto Porter,23-155,F,11/5/16,WAS,ORL,1,29,4,8,0.5,2,5,0.4,2,3,0.667,0,0,,3,10,13,0,0,0,0,4,10,9.5
Malcolm Brogdon,24-045,G,1/25/17,MIL,PHI,0,26,3,7,0.429,2,5,0.4,1,2,0.5,3,4,0.75,1,1,2,7,2,0,2,2,10,11
Rodney Hood,24-031,G-F,11/20/16,UTA,DEN,1,31,3,12,0.25,3,7,0.429,0,5,0,4,6,0.667,0,5,5,2,1,0,1,3,10,3.7
Ish Smith,28-213,G,2/3/17,DET,MIN,0,21,5,8,0.625,5,7,0.714,0,1,0,0,0,,0,3,3,5,1,0,0,2,10,11
Thaddeus Young,28-262,F,3/10/17,IND,MIL,1,19,5,8,0.625,5,8,0.625,0,0,,0,1,0,1,2,3,1,3,0,2,3,10,7.8
Dario Saric,22-225,F,11/19/16,PHI,PHO,0,25,3,7,0.429,1,3,0.333,2,4,0.5,2,2,1,0,7,7,5,0,1,2,2,10,9.8
Darren Collison,29-211,G,3/22/17,SAC,MIL,1,27,3,5,0.6,2,3,0.667,1,2,0.5,3,3,1,0,1,1,7,1,0,1,0,10,12.9
JaMychal Green,26-237,F,2/13/17,MEM,BRK,1,19,4,5,0.8,4,5,0.8,0,0,,2,2,1,0,6,6,0,0,0,1,3,10,7.7
Al Jefferson,31-313,C-F,11/12/16,IND,BOS,0,17,5,9,0.556,5,9,0.556,0,0,,0,0,,0,3,3,0,0,0,1,0,10,5.6
Terrence Jones,24-341,F,12/15/16,NOP,IND,0,26,4,9,0.444,4,9,0.444,0,0,,2,4,0.5,2,9,11,1,1,2,1,0,10,10.7
Sam Dekker,22-207,F,11/29/16,HOU,UTA,0,27,4,8,0.5,3,6,0.5,1,2,0.5,1,2,0.5,4,2,6,0,1,1,0,1,10,10.3
DeAndre Jordan,28-223,C,3/1/17,LAC,HOU,1,35,5,6,0.833,5,6,0.833,0,0,,0,2,0,3,6,9,0,3,2,1,2,10,13.5
Robin Lopez,28-238,C,11/25/16,CHI,PHI,1,23,4,11,0.364,4,11,0.364,0,0,,2,2,1,3,2,5,1,0,1,2,1,10,5.6
Wilson Chandler,29-238,F,1/3/17,DEN,SAC,1,30,3,10,0.3,1,3,0.333,2,7,0.286,2,2,1,0,3,3,2,1,0,0,4,10,5.9
Robin Lopez,28-225,C,11/12/16,CHI,WAS,1,38,5,16,0.313,5,16,0.313,0,0,,0,0,,6,7,13,1,0,2,2,3,10,6
Eric Gordon,28-093,G,3/28/17,HOU,GSW,1,34,3,9,0.333,1,4,0.25,2,5,0.4,2,2,1,0,4,4,0,0,1,2,1,10,4.4
Bojan Bogdanovic,27-298,G-F,2/10/17,BRK,MIA,1,29,4,12,0.333,2,7,0.286,2,5,0.4,0,0,,0,6,6,0,0,0,2,2,10,2.2
Beno Udrih,34-132,G,11/14/16,DET,OKC,0,18,5,7,0.714,5,6,0.833,0,1,0,0,0,,0,4,4,4,0,0,1,0,10,10.1
Kentavious Caldwell-Pope,23-282,G,11/26/16,DET,OKC,1,34,4,13,0.308,4,7,0.571,0,6,0,2,2,1,0,2,2,0,1,0,1,2,10,2.3
Patrick Patterson,28-022,F,4/5/17,TOR,DET,0,16,4,6,0.667,2,2,1,2,4,0.5,0,0,,0,1,1,2,1,0,1,1,10,8.7
Otto Porter,23-194,F,12/14/16,WAS,CHO,1,36,5,9,0.556,5,7,0.714,0,2,0,0,0,,2,3,5,2,1,2,0,3,10,10.6
Elfrid Payton,22-351,G,2/7/17,ORL,HOU,1,27,5,11,0.455,5,10,0.5,0,1,0,0,0,,0,2,2,8,2,0,2,2,10,9.7
E'Twaun Moore,27-241,G,10/26/16,NOP,DEN,1,28,3,8,0.375,1,4,0.25,2,4,0.5,2,2,1,0,1,1,4,1,1,2,4,10,6.8
Jonathon Simmons,27-100,G-F,12/23/16,SAS,POR,0,18,5,8,0.625,5,7,0.714,0,1,0,0,0,,1,3,4,3,0,0,0,2,10,9.3
Frank Kaminsky,23-356,F-C,3/26/17,CHO,PHO,0,29,3,11,0.273,1,7,0.143,2,4,0.5,2,2,1,2,5,7,2,0,0,1,3,10,5.6
Ian Clark,25-259,G,11/21/16,GSW,IND,0,21,4,10,0.4,2,5,0.4,2,5,0.4,0,0,,1,5,6,1,0,0,0,1,10,7.1
Shabazz Napier,25-224,G,2/23/17,POR,ORL,0,26,4,9,0.444,2,3,0.667,2,6,0.333,0,0,,1,6,7,6,2,0,1,2,10,12.2
Enes Kanter,24-203,C,12/9/16,OKC,HOU,0,14,3,6,0.5,3,5,0.6,0,1,0,4,4,1,1,2,3,1,0,0,0,3,10,7.8
Donatas Motiejunas,26-129,F-C,1/27/17,NOP,SAS,0,22,4,6,0.667,3,4,0.75,1,2,0.5,1,1,1,2,5,7,4,1,2,0,4,10,13.9
Ricky Rubio,26-049,G,12/9/16,MIN,DET,1,28,4,5,0.8,4,5,0.8,0,0,,2,2,1,1,2,3,6,0,0,0,3,10,12.4
C.J. Miles,29-212,G-F,11/16/16,IND,CLE,0,23,4,7,0.571,2,2,1,2,5,0.4,0,0,,0,0,0,0,1,0,0,2,10,6.9
Darrell Arthur,28-320,F,2/8/17,DEN,ATL,0,21,4,10,0.4,2,6,0.333,2,4,0.5,0,0,,2,2,4,1,0,1,2,1,10,5.6
Spencer Dinwiddie,23-299,G,1/30/17,BRK,MIA,1,24,3,7,0.429,3,7,0.429,0,0,,4,4,1,1,4,5,2,0,0,0,2,10,8.8
Jamal Crawford,36-237,G,11/12/16,LAC,MIN,0,21,4,8,0.5,3,6,0.5,1,2,0.5,1,2,0.5,0,1,1,4,1,0,2,2,10,6.9
Marcin Gortat,32-285,C-F,11/28/16,WAS,SAC,1,36,4,6,0.667,4,6,0.667,0,0,,2,4,0.5,3,4,7,0,1,3,1,4,10,10.4
Wayne Ellington,29-161,G,4/8/17,MIA,WAS,0,20,3,6,0.5,1,1,1,2,5,0.4,2,2,1,0,1,1,1,2,0,0,3,10,8.8
Tyler Johnson,24-312,G,3/15/17,MIA,NOP,0,28,4,9,0.444,3,6,0.5,1,3,0.333,1,1,1,0,3,3,9,2,0,2,0,10,12.5
Bojan Bogdanovic,27-254,G-F,12/28/16,BRK,CHI,1,28,4,11,0.364,3,7,0.429,1,4,0.25,1,1,1,0,2,2,2,0,0,1,3,10,3.7
Patty Mills,28-236,G,4/4/17,SAS,MEM,0,25,3,7,0.429,1,4,0.25,2,3,0.667,2,2,1,1,3,4,1,2,0,2,0,10,8.6
Skal Labissiere,21-006,F,3/24/17,SAC,GSW,0,27,5,11,0.455,5,10,0.5,0,1,0,0,0,,1,9,10,8,0,1,2,1,10,11.6
Al Jefferson,32-075,C-F,3/20/17,IND,UTA,0,11,5,9,0.556,5,9,0.556,0,0,,0,0,,1,3,4,0,0,0,0,2,10,6.5
Joe Johnson,35-130,G-F,11/6/16,UTA,NYK,0,24,2,6,0.333,0,2,0,2,4,0.5,4,4,1,1,1,2,2,2,0,1,2,10,9.2
Shelvin Mack,26-240,G,12/18/16,UTA,MEM,0,29,4,7,0.571,2,5,0.4,2,2,1,0,3,0,0,6,6,5,1,0,4,1,10,7.4
Clint Capela,22-310,F-C,3/24/17,HOU,NOP,1,29,5,7,0.714,5,7,0.714,0,0,,0,0,,4,9,13,2,0,2,2,3,10,12.2
Kyle O'Quinn,26-256,F-C,12/7/16,NYK,CLE,0,21,5,7,0.714,5,7,0.714,0,0,,0,0,,3,4,7,3,0,0,1,1,10,11.1
Tim Hardaway,24-233,G,11/4/16,ATL,WAS,0,28,3,7,0.429,3,4,0.75,0,3,0,4,4,1,0,4,4,3,1,0,1,3,10,8.4
Fred VanVleet,22-346,G,2/5/17,TOR,BRK,0,20,2,10,0.2,2,7,0.286,0,3,0,6,6,1,0,3,3,4,0,0,1,1,10,6.1
Taurean Waller-Prince,22-302,F,1/18/17,ATL,DET,0,20,2,5,0.4,2,4,0.5,0,1,0,6,6,1,0,2,2,1,0,0,1,2,10,6.8
Dewayne Dedmon,27-238,C,4/7/17,SAS,DAL,1,18,5,10,0.5,5,10,0.5,0,0,,0,1,0,4,9,13,1,0,1,0,1,10,11.1
Malcolm Brogdon,23-354,G,11/29/16,MIL,CLE,0,23,4,5,0.8,2,3,0.667,2,2,1,0,0,,0,1,1,3,1,0,2,4,10,7.9
Tristan Thompson,26-030,F-C,4/12/17,CLE,TOR,1,18,5,6,0.833,5,6,0.833,0,0,,0,2,0,3,1,4,0,1,0,1,0,10,9.4
James Johnson,30-016,F,3/8/17,MIA,CHO,0,30,4,9,0.444,2,4,0.5,2,5,0.4,0,2,0,0,6,6,5,1,3,1,0,10,11.9
Nikola Vucevic,26-143,C,3/16/17,ORL,GSW,1,25,4,12,0.333,4,10,0.4,0,2,0,2,3,0.667,2,6,8,4,1,0,0,1,10,9.4
Marcus Morris,27-161,F,2/10/17,DET,SAS,1,29,4,10,0.4,3,7,0.429,1,3,0.333,1,2,0.5,1,4,5,3,1,0,0,2,10,8.4
Reggie Jackson,26-239,G,12/11/16,DET,PHI,1,28,5,17,0.294,5,14,0.357,0,3,0,0,0,,0,1,1,3,2,0,1,3,10,2.3
Otto Porter,23-225,F,1/14/17,WAS,PHI,1,30,4,12,0.333,4,10,0.4,0,2,0,2,4,0.5,3,3,6,1,1,0,0,0,10,7.1
Jordan Clarkson,24-192,G,12/16/16,LAL,PHI,0,26,4,9,0.444,2,5,0.4,2,4,0.5,0,0,,0,3,3,2,0,0,2,1,10,5.2
Darrell Arthur,28-288,F,1/7/17,DEN,OKC,1,24,4,9,0.444,2,5,0.4,2,4,0.5,0,0,,1,3,4,1,1,0,1,4,10,6
Derrick Favors,25-192,F-C,1/23/17,UTA,OKC,1,27,5,12,0.417,5,11,0.455,0,1,0,0,0,,4,6,10,0,2,0,2,3,10,7
Arron Afflalo,31-122,G,2/14/17,SAC,LAL,1,37,5,7,0.714,5,7,0.714,0,0,,0,0,,0,2,2,1,1,0,0,3,10,8.2
Bismack Biyombo,24-120,C-F,12/26/16,ORL,MEM,1,24,4,6,0.667,4,6,0.667,0,0,,2,4,0.5,5,5,10,0,0,0,1,2,10,9.8
Dewayne Dedmon,27-187,C,2/15/17,SAS,ORL,1,29,5,6,0.833,5,6,0.833,0,0,,0,1,0,2,9,11,1,0,1,1,3,10,10.7
Darren Collison,29-134,G,1/4/17,SAC,MIA,1,27,4,11,0.364,3,10,0.3,1,1,1,1,1,1,0,2,2,3,0,1,1,3,10,5.1
Isaiah Canaan,25-170,G,11/7/16,CHI,ORL,0,21,3,6,0.5,2,3,0.667,1,3,0.333,3,4,0.75,0,4,4,0,0,0,0,1,10,7.4
Luol Deng,31-216,F,11/18/16,LAL,SAS,1,34,4,10,0.4,2,6,0.333,2,4,0.5,0,0,,3,3,6,3,1,0,1,4,10,8.1
Dwight Howard,31-098,C,3/16/17,ATL,MEM,1,32,3,5,0.6,3,5,0.6,0,0,,4,6,0.667,3,8,11,1,0,3,3,3,10,10
Derrick Williams,25-322,F,4/12/17,CLE,TOR,0,27,3,8,0.375,1,5,0.2,2,3,0.667,2,2,1,0,4,4,3,0,0,0,0,10,8.9
Iman Shumpert,26-265,G,3/18/17,CLE,LAC,1,25,5,11,0.455,5,9,0.556,0,2,0,0,0,,0,5,5,3,0,0,0,4,10,6.3
Jonas Valanciunas,24-175,C,10/28/16,TOR,CLE,1,31,5,15,0.333,5,15,0.333,0,0,,0,0,,6,11,17,0,0,1,3,2,10,5.9
Ersan Ilyasova,29-176,F,11/7/16,PHI,UTA,0,26,2,12,0.167,1,7,0.143,1,5,0.2,5,5,1,1,2,3,2,0,0,2,0,10,3.1
Gerald Green,31-018,G-F,2/13/17,BOS,DAL,0,14,4,8,0.5,2,5,0.4,2,3,0.667,0,0,,0,1,1,2,0,0,0,1,10,7.3
Patty Mills,28-226,G,3/25/17,SAS,NYK,0,26,4,9,0.444,2,4,0.5,2,5,0.4,0,0,,0,0,0,7,1,0,4,1,10,6.8
Timofey Mozgov,30-146,C,12/9/16,LAL,PHO,1,20,4,10,0.4,4,10,0.4,0,0,,2,2,1,3,1,4,1,0,0,1,3,10,5.5
Sergio Rodriguez,30-143,G,11/2/16,PHI,CHO,1,26,3,9,0.333,0,2,0,3,7,0.429,1,1,1,1,2,3,5,0,1,4,0,10,6.4
Willy Hernangomez,22-308,C,3/31/17,NYK,MIA,1,29,3,9,0.333,3,9,0.333,0,0,,4,5,0.8,3,8,11,2,0,0,0,2,10,9.6
Carmelo Anthony,32-213,F,12/28/16,NYK,ATL,1,15,4,9,0.444,3,7,0.429,1,2,0.5,1,2,0.5,1,4,5,1,0,0,1,1,10,6.1
Joe Johnson,35-181,G-F,12/27/16,UTA,LAL,0,16,5,9,0.556,5,8,0.625,0,1,0,0,0,,0,0,0,1,1,1,2,1,10,5.7
Ty Lawson,29-144,G,3/27/17,SAC,MEM,0,19,2,3,0.667,2,3,0.667,0,0,,6,10,0.6,0,1,1,0,0,0,2,1,10,5
Andre Iguodala,32-308,G-F,12/1/16,GSW,HOU,0,42,3,4,0.75,1,1,1,2,3,0.667,2,4,0.5,1,2,3,5,0,0,0,2,10,11.6
Otto Porter,23-292,F,3/22/17,WAS,ATL,1,27,4,10,0.4,2,5,0.4,2,5,0.4,0,0,,6,2,8,0,0,0,1,4,10,6.8
Dante Exum,21-122,G,11/12/16,UTA,MIA,1,29,3,10,0.3,1,6,0.167,2,4,0.5,2,2,1,1,2,3,2,1,0,1,0,10,6.9
Deron Williams,32-290,G,4/12/17,CLE,TOR,1,25,3,6,0.5,0,2,0,3,4,0.75,1,1,1,0,3,3,4,0,0,4,4,10,5.1
Darren Collison,29-186,G,2/25/17,SAC,CHO,1,28,4,8,0.5,2,5,0.4,2,3,0.667,0,0,,0,2,2,5,1,0,0,2,10,10.3
Arron Afflalo,31-120,G,2/12/17,SAC,NOP,1,32,3,7,0.429,2,4,0.5,1,3,0.333,3,3,1,0,1,1,2,1,1,0,1,10,9.3
Ivica Zubac,19-325,C,2/6/17,LAL,NYK,0,17,5,9,0.556,5,9,0.556,0,0,,0,0,,2,5,7,0,1,3,0,3,10,10.5
Tyler Zeller,26-316,F-C,11/28/16,BOS,MIA,1,25,4,7,0.571,4,7,0.571,0,0,,2,2,1,3,4,7,2,0,1,1,4,10,9.5
Elfrid Payton,22-289,G,12/7/16,ORL,BOS,0,28,5,8,0.625,5,8,0.625,0,0,,0,2,0,1,3,4,4,1,0,2,3,10,7.8
Brandon Knight,24-347,G,11/13/16,PHO,GSW,0,25,3,8,0.375,2,5,0.4,1,3,0.333,3,4,0.75,0,2,2,3,1,0,1,3,10,6.7
Dirk Nowitzki,38-257,F,3/3/17,DAL,MEM,1,29,4,10,0.4,3,6,0.5,1,4,0.25,1,1,1,0,7,7,2,0,0,1,3,10,5.9
Jrue Holiday,26-175,G,12/4/16,NOP,OKC,1,36,4,12,0.333,4,7,0.571,0,5,0,2,2,1,1,4,5,6,2,0,3,4,10,6.7
Jaylen Brown,20-048,F,12/11/16,BOS,OKC,0,18,4,5,0.8,3,4,0.75,1,1,1,1,1,1,1,1,2,1,1,0,1,2,10,9
Devin Harris,34-016,G,3/15/17,DAL,WAS,0,18,3,5,0.6,1,3,0.333,2,2,1,2,2,1,0,1,1,1,1,0,1,2,10,7.9
Markieff Morris,27-117,F,12/28/16,WAS,IND,1,26,4,11,0.364,4,9,0.444,0,2,0,2,2,1,2,5,7,1,1,0,3,5,10,3.5
Isaiah Whitehead,22-016,G,3/24/17,BRK,WAS,0,18,4,5,0.8,4,5,0.8,0,0,,2,2,1,0,2,2,2,0,0,2,1,10,7.7
Nick Young,31-258,G-F,2/14/17,LAL,SAC,1,30,3,10,0.3,0,2,0,3,8,0.375,1,2,0.5,0,1,1,4,0,0,0,1,10,6.5
Zach Randolph,35-153,F,12/16/16,MEM,SAC,0,27,4,9,0.444,4,9,0.444,0,0,,2,2,1,3,6,9,5,0,0,1,4,10,10.1
Solomon Hill,25-302,F,1/14/17,NOP,CHI,1,36,3,8,0.375,1,2,0.5,2,6,0.333,2,4,0.5,0,6,6,2,0,0,1,5,10,5
Josh Richardson,23-205,G,4/8/17,MIA,WAS,1,37,2,6,0.333,0,3,0,2,3,0.667,4,4,1,0,1,1,3,5,2,1,1,10,14
E'Twaun Moore,27-280,G,12/4/16,NOP,OKC,1,23,5,11,0.455,5,9,0.556,0,2,0,0,0,,0,2,2,3,0,0,1,4,10,4.4
Nikola Jokic,21-271,C-F,11/16/16,DEN,PHO,0,19,3,4,0.75,3,4,0.75,0,0,,4,5,0.8,0,2,2,2,0,0,1,3,10,7.8
Thaddeus Young,28-227,F,2/3/17,IND,BRK,1,22,5,9,0.556,5,9,0.556,0,0,,0,0,,4,5,9,3,3,2,1,2,10,14.7
C.J. Miles,29-243,G-F,12/17/16,IND,DET,0,24,3,7,0.429,1,1,1,2,6,0.333,2,2,1,0,3,3,1,0,0,0,1,10,7.5
Will Barton,26-077,G,3/24/17,DEN,IND,0,24,4,11,0.364,4,8,0.5,0,3,0,2,2,1,0,4,4,2,1,0,0,1,10,7.1
Semaj Christon,24-154,G,4/4/17,OKC,MIL,0,21,4,6,0.667,4,5,0.8,0,1,0,2,2,1,1,6,7,3,0,1,1,0,10,11.7
Mirza Teletovic,31-129,F,1/25/17,MIL,PHI,0,19,3,9,0.333,0,1,0,3,8,0.375,1,2,0.5,0,1,1,3,0,0,1,3,10,4.7
Malcolm Brogdon,24-026,G,1/6/17,MIL,NYK,1,31,4,9,0.444,4,8,0.5,0,1,0,2,2,1,0,6,6,5,0,0,1,2,10,8.8
Jamal Murray,20-021,G,3/16/17,DEN,LAC,0,25,4,14,0.286,3,9,0.333,1,5,0.2,1,1,1,1,5,6,0,3,0,0,2,10,6.2
Cody Zeller,24-084,F-C,12/28/16,CHO,ORL,1,24,4,6,0.667,4,6,0.667,0,0,,2,2,1,3,2,5,2,1,0,1,0,10,11.5
Seth Curry,26-096,G,11/27/16,DAL,NOP,0,34,4,8,0.5,4,6,0.667,0,2,0,2,2,1,1,4,5,2,0,0,2,2,10,6.5
Nik Stauskas,23-084,G,12/30/16,PHI,DEN,1,29,2,7,0.286,0,2,0,2,5,0.4,4,4,1,0,0,0,5,1,0,1,3,10,8.2
Brandon Bass,31-345,F,4/10/17,LAC,HOU,0,12,4,5,0.8,4,5,0.8,0,0,,2,2,1,3,2,5,1,0,0,0,0,10,11.5
DeAndre' Bembry,22-213,F,2/2/17,ATL,HOU,0,21,5,6,0.833,5,5,1,0,1,0,0,0,,1,3,4,2,0,0,1,4,10,8.2
Tim Hardaway,24-257,G,11/28/16,ATL,GSW,0,14,3,8,0.375,2,2,1,1,6,0.167,3,4,0.75,0,1,1,0,1,0,0,1,10,6.1
Kentavious Caldwell-Pope,23-295,G,12/9/16,DET,MIN,1,31,3,12,0.25,1,6,0.167,2,6,0.333,2,2,1,0,1,1,7,2,0,2,0,10,8
J.J. Redick,32-232,G,2/11/17,LAC,CHO,1,24,3,11,0.273,1,3,0.333,2,8,0.25,2,2,1,1,3,4,2,0,1,0,3,10,6
Ryan Anderson,28-252,F,1/13/17,HOU,MEM,1,26,3,11,0.273,2,3,0.667,1,8,0.125,3,4,0.75,0,0,0,0,0,0,1,3,10,0.9
Courtney Lee,31-040,G,11/12/16,NYK,TOR,1,34,4,7,0.571,2,4,0.5,2,3,0.667,0,0,,0,5,5,1,0,1,3,4,10,5
Luis Scola,36-196,F,11/12/16,BRK,PHO,0,14,4,5,0.8,2,3,0.667,2,2,1,0,0,,0,5,5,0,0,1,1,1,10,8.9
Rajon Rondo,30-356,G,2/12/17,CHI,MIN,0,24,5,9,0.556,5,6,0.833,0,3,0,0,0,,0,3,3,6,1,0,5,3,10,5.6
Kemba Walker,26-279,G,2/11/17,CHO,LAC,1,42,4,17,0.235,3,8,0.375,1,9,0.111,1,2,0.5,1,3,4,4,2,1,2,2,10,3.6
Tyson Chandler,34-066,C,12/7/16,PHO,IND,1,32,5,6,0.833,5,6,0.833,0,0,,0,0,,3,7,10,2,2,0,2,4,10,11.8
Dewayne Dedmon,27-115,C,12/5/16,SAS,MIL,0,14,5,5,1,5,5,1,0,0,,0,1,0,4,2,6,0,0,1,1,2,10,10.4
Richard Jefferson,36-183,F,12/21/16,CLE,MIL,1,32,4,8,0.5,2,3,0.667,2,5,0.4,0,0,,0,0,0,4,0,1,0,5,10,7.5
Patrick McCaw,21-089,G,1/22/17,GSW,ORL,0,20,4,11,0.364,2,6,0.333,2,5,0.4,0,0,,1,0,1,1,0,0,1,0,10,4.3
Kosta Koufos,27-292,C,12/12/16,SAC,LAL,1,32,5,7,0.714,5,7,0.714,0,0,,0,0,,4,3,7,0,3,1,0,1,10,14.1
Kentavious Caldwell-Pope,23-267,G,11/11/16,DET,SAS,1,40,3,9,0.333,1,4,0.25,2,5,0.4,2,3,0.667,1,2,3,7,0,0,0,1,10,10.3
Jason Smith,30-303,F-C,12/30/16,WAS,BRK,0,18,5,7,0.714,5,7,0.714,0,0,,0,0,,3,5,8,1,0,2,1,6,10,9.4
Vince Carter,39-300,G-F,11/21/16,MEM,CHO,0,33,3,8,0.375,1,2,0.5,2,6,0.333,2,3,0.667,1,4,5,5,1,0,1,3,10,9.4
Robin Lopez,28-335,C,3/2/17,CHI,GSW,1,22,5,15,0.333,5,15,0.333,0,0,,0,0,,2,1,3,0,0,1,0,1,10,3.5
Lou Williams,30-070,G,1/5/17,LAL,POR,0,24,3,8,0.375,2,6,0.333,1,2,0.5,3,4,0.75,0,3,3,2,0,0,3,0,10,4.5
Timofey Mozgov,30-117,C,11/10/16,LAL,SAC,1,33,5,6,0.833,5,6,0.833,0,0,,0,0,,1,2,3,1,0,1,1,3,10,8.3
Jonas Valanciunas,24-257,C,1/18/17,TOR,PHI,1,30,5,11,0.455,5,11,0.455,0,0,,0,0,,5,10,15,1,0,0,0,3,10,10.3
Jordan Crawford,28-136,G,3/8/17,NOP,TOR,0,26,4,8,0.5,2,4,0.5,2,4,0.5,0,0,,0,3,3,3,0,0,1,1,10,7.6
Alex Abrines,23-146,G-F,12/25/16,OKC,MIN,0,21,3,9,0.333,0,2,0,3,7,0.429,1,1,1,0,2,2,0,1,0,0,3,10,5.3
JaMychal Green,26-180,F,12/18/16,MEM,UTA,1,32,5,11,0.455,5,8,0.625,0,3,0,0,0,,4,7,11,0,2,1,0,4,10,10.3
Aaron Gordon,21-061,F,11/16/16,ORL,NOP,0,26,4,11,0.364,3,9,0.333,1,2,0.5,1,3,0.333,0,4,4,3,1,1,1,1,10,6.7
Jameer Nelson,34-303,G,12/8/16,DEN,WAS,1,36,5,10,0.5,5,9,0.556,0,1,0,0,2,0,0,4,4,8,2,0,4,4,10,7.4
Kent Bazemore,27-201,G-F,1/18/17,ATL,DET,1,21,4,10,0.4,3,7,0.429,1,3,0.333,1,2,0.5,0,2,2,1,0,1,2,1,10,3.8
Ben McLemore,23-359,G,2/4/17,SAC,GSW,1,29,2,6,0.333,1,2,0.5,1,4,0.25,5,6,0.833,1,1,2,1,3,0,0,1,10,10.5
Thabo Sefolosha,32-253,G-F,1/10/17,ATL,BRK,1,27,5,10,0.5,5,8,0.625,0,2,0,0,0,,0,4,4,2,2,1,1,1,10,8.9
Matthew Dellavedova,26-052,G,10/30/16,MIL,DET,1,31,4,7,0.571,2,4,0.5,2,3,0.667,0,0,,1,1,2,5,0,0,2,0,10,9.2
Courtney Lee,31-177,G,3/29/17,NYK,MIA,1,31,4,9,0.444,3,8,0.375,1,1,1,1,1,1,0,2,2,1,2,1,0,1,10,8.9
Ian Mahinmi,30-143,C,3/28/17,WAS,LAL,0,18,3,4,0.75,3,4,0.75,0,0,,4,8,0.5,1,4,5,0,2,0,1,2,10,8.9
Bobby Portis,21-345,F,1/20/17,CHI,ATL,0,17,5,8,0.625,5,7,0.714,0,1,0,0,0,,1,6,7,1,0,0,0,1,10,9.2
Montrezl Harrell,22-353,F-C,1/13/17,HOU,MEM,1,24,5,9,0.556,5,9,0.556,0,0,,0,0,,1,4,5,2,2,0,0,2,10,10.2
Jonas Valanciunas,24-228,C,12/20/16,TOR,BRK,1,22,3,8,0.375,3,8,0.375,0,0,,4,4,1,3,11,14,0,0,1,0,1,10,11.3
Marcus Smart,23-009,G,3/15/17,BOS,MIN,0,26,5,10,0.5,5,6,0.833,0,4,0,0,0,,0,2,2,6,0,0,3,3,10,5.6
Marcus Morris,27-085,F,11/26/16,DET,OKC,1,35,5,15,0.333,5,10,0.5,0,5,0,0,2,0,1,4,5,2,0,0,2,3,10,0.8
Justin Hamilton,26-231,C,11/18/16,BRK,OKC,0,21,4,6,0.667,2,2,1,2,4,0.5,0,0,,0,2,2,0,0,0,0,5,10,6
Jerami Grant,22-305,F,1/11/17,OKC,MEM,0,18,4,6,0.667,3,4,0.75,1,2,0.5,1,1,1,1,3,4,0,0,0,1,1,10,7.6
Bismack Biyombo,24-133,C-F,1/8/17,ORL,LAL,1,26,4,6,0.667,4,6,0.667,0,0,,2,4,0.5,3,8,11,2,0,0,2,2,10,9.7
Aaron Gordon,21-079,F,12/4/16,ORL,DET,1,22,4,8,0.5,4,6,0.667,0,2,0,2,4,0.5,0,3,3,0,0,0,0,1,10,5.7
Monta Ellis,31-144,G,3/19/17,IND,TOR,0,25,4,11,0.364,4,8,0.5,0,3,0,2,3,0.667,0,1,1,3,3,0,1,0,10,7.9
Raymond Felton,32-183,G,12/26/16,LAC,DEN,0,31,5,14,0.357,5,11,0.455,0,3,0,0,0,,0,4,4,3,0,0,1,2,10,3.7
Lou Williams,30-063,G,12/29/16,LAL,DAL,0,21,3,7,0.429,3,5,0.6,0,2,0,4,5,0.8,0,1,1,3,0,0,4,2,10,3.5
Jeff Green,30-127,F,1/2/17,ORL,NYK,0,27,3,10,0.3,2,7,0.286,1,3,0.333,3,4,0.75,1,2,3,1,2,0,1,3,10,5.6
Derrick Williams,25-199,F,12/10/16,MIA,CHI,0,25,3,9,0.333,3,8,0.375,0,1,0,4,6,0.667,3,5,8,1,0,0,1,0,10,7.4
Luc Mbah a Moute,30-094,F,12/12/16,LAC,POR,1,22,3,5,0.6,1,3,0.333,2,2,1,2,2,1,0,2,2,0,1,0,0,2,10,8.5
Jeremy Lin,28-206,G,3/17/17,BRK,BOS,1,21,3,6,0.5,1,2,0.5,2,4,0.5,2,2,1,1,6,7,6,0,1,3,3,10,10.2
Justin Anderson,23-006,G,11/25/16,DAL,CLE,0,14,4,7,0.571,3,5,0.6,1,2,0.5,1,2,0.5,1,0,1,1,1,1,0,3,10,8.2
Aaron Gordon,21-206,F,4/10/17,ORL,CHI,1,29,4,6,0.667,4,6,0.667,0,0,,2,2,1,1,5,6,2,0,0,2,1,10,8.6
T.J. McConnell,24-270,G,12/20/16,PHI,NOP,0,17,5,8,0.625,5,7,0.714,0,1,0,0,0,,0,0,0,5,3,0,2,1,10,10.5
Tim Quarterman,22-167,G,4/12/17,POR,NOP,0,22,4,11,0.364,2,6,0.333,2,5,0.4,0,2,0,2,2,4,3,1,1,7,2,10,1.1
Nemanja Bjelica,28-196,F,11/21/16,MIN,BOS,0,10,3,5,0.6,2,3,0.667,1,2,0.5,3,4,0.75,0,1,1,0,1,0,1,1,10,7.2
Marvin Williams,30-226,F,1/31/17,CHO,POR,1,33,3,9,0.333,2,2,1,1,7,0.143,3,3,1,0,5,5,0,0,3,0,1,10,8.1
Mike Muscala,25-149,F-C,11/27/16,ATL,LAL,0,25,4,7,0.571,2,4,0.5,2,3,0.667,0,0,,0,5,5,0,0,2,0,2,10,8.8
Marquese Chriss,19-158,F,12/7/16,PHO,IND,1,19,3,6,0.5,1,2,0.5,2,4,0.5,2,2,1,0,3,3,0,2,0,1,2,10,8.1
John Henson,26-061,C-F,2/27/17,MIL,CLE,0,20,5,9,0.556,5,9,0.556,0,0,,0,0,,3,2,5,1,0,1,0,4,10,8.2
Andre Roberson,24-360,G-F,11/28/16,OKC,NYK,1,31,4,8,0.5,2,4,0.5,2,4,0.5,0,0,,1,2,3,1,1,2,0,4,10,8.8
Dario Saric,22-233,F,11/27/16,PHI,CLE,0,20,4,9,0.444,2,5,0.4,2,4,0.5,0,0,,1,3,4,3,0,1,4,3,10,4.5
Terrence Jones,24-354,F,12/28/16,NOP,LAC,0,23,4,12,0.333,4,11,0.364,0,1,0,2,5,0.4,3,2,5,2,1,0,0,2,10,6.3
Garrett Temple,30-338,G,4/11/17,SAC,PHO,1,27,4,7,0.571,2,5,0.4,2,2,1,0,0,,1,2,3,5,1,0,1,1,10,11.1
Maurice Harkless,23-302,F-G,3/9/17,POR,PHI,1,39,5,9,0.556,5,9,0.556,0,0,,0,2,0,4,5,9,2,1,1,3,1,10,8.9
Solomon Hill,25-287,F,12/30/16,NOP,NYK,1,28,4,6,0.667,2,2,1,2,4,0.5,0,0,,0,0,0,0,0,0,1,5,10,4.4
Ian Clark,25-364,G,3/6/17,GSW,ATL,0,10,3,4,0.75,1,2,0.5,2,2,1,2,2,1,0,0,0,0,1,0,0,0,10,9.4
Mason Plumlee,26-275,C-F,12/5/16,POR,CHI,1,23,4,9,0.444,4,9,0.444,0,0,,2,2,1,1,4,5,2,2,2,1,1,10,10.6
Skal Labissiere,20-348,F,3/1/17,SAC,BRK,1,15,4,5,0.8,4,5,0.8,0,0,,2,2,1,3,2,5,0,1,1,2,3,10,9.3
Paul Pierce,39-179,F-G,4/10/17,LAC,HOU,0,7,4,5,0.8,2,2,1,2,3,0.667,0,1,0,0,1,1,0,0,0,1,1,10,6.6
Brandon Knight,25-053,G,1/24/17,PHO,MIN,0,22,3,7,0.429,3,6,0.5,0,1,0,4,4,1,0,2,2,1,1,0,0,2,10,7.8
T.J. McConnell,24-318,G,2/6/17,PHI,DET,1,25,5,9,0.556,5,8,0.625,0,1,0,0,0,,1,6,7,2,1,0,1,0,10,9.6
Leandro Barbosa,34-009,G,12/7/16,PHO,IND,0,12,5,7,0.714,5,6,0.833,0,1,0,0,0,,0,1,1,0,1,1,0,1,10,8.7
Nikola Vucevic,26-055,C,12/18/16,ORL,TOR,0,25,5,12,0.417,5,12,0.417,0,0,,0,0,,5,4,9,1,0,0,1,2,10,7.2
Steven Adams,23-265,C,4/11/17,OKC,MIN,1,30,5,6,0.833,5,6,0.833,0,0,,0,0,,6,3,9,1,2,2,4,2,10,12.2
Maurice Harkless,23-265,F-G,1/31/17,POR,CHO,0,28,5,10,0.5,5,8,0.625,0,2,0,0,0,,3,2,5,3,0,0,0,1,10,9.4
Andre Drummond,23-243,C,4/10/17,DET,WAS,1,24,5,8,0.625,5,8,0.625,0,0,,0,0,,2,5,7,1,2,1,1,3,10,10.5
Spencer Hawes,28-328,C-F,3/22/17,MIL,SAC,0,18,3,4,0.75,1,1,1,2,3,0.667,2,3,0.667,1,2,3,2,0,2,0,0,10,12.1
Gerald Henderson,29-116,G,4/4/17,PHI,BRK,0,18,3,10,0.3,2,6,0.333,1,4,0.25,2,3,0.667,0,2,2,1,0,0,0,1,9,3.7
Austin Rivers,24-151,G,12/30/16,LAC,HOU,1,15,3,8,0.375,2,5,0.4,1,3,0.333,2,3,0.667,0,1,1,3,0,0,0,1,9,6.2
Marcus Thornton,29-169,G,11/21/16,WAS,PHO,0,21,3,9,0.333,0,4,0,3,5,0.6,0,0,,0,0,0,0,0,0,1,1,9,2.5
Malcolm Delaney,27-262,G,11/28/16,ATL,GSW,0,15,3,5,0.6,2,3,0.667,1,2,0.5,2,2,1,0,1,1,4,0,0,0,1,9,9.4
Randy Foye,33-097,G,12/30/16,BRK,WAS,0,27,2,7,0.286,1,3,0.333,1,4,0.25,4,4,1,0,2,2,1,0,0,2,1,9,3.8
Willie Cauley-Stein,23-130,F-C,12/26/16,SAC,PHI,0,12,4,7,0.571,4,7,0.571,0,0,,1,2,0.5,2,2,4,0,1,1,0,3,9,7.8
James Johnson,29-275,F,11/21/16,MIA,PHI,0,17,3,7,0.429,3,4,0.75,0,3,0,3,4,0.75,2,1,3,1,0,0,2,1,9,4.9
P.J. Tucker,31-212,F,12/3/16,PHO,GSW,1,28,4,11,0.364,3,6,0.5,1,5,0.2,0,0,,5,2,7,2,1,0,0,4,9,7.8
Nerlens Noel,22-341,C-F,3/17/17,DAL,PHI,0,19,4,7,0.571,4,7,0.571,0,0,,1,2,0.5,3,2,5,3,1,1,1,2,9,10
Davis Bertans,24-088,F,2/8/17,SAS,PHI,0,15,3,5,0.6,1,1,1,2,4,0.5,1,2,0.5,0,1,1,1,0,0,1,1,9,5.9
Tony Snell,25-076,G-F,1/25/17,MIL,PHI,1,31,3,6,0.5,1,1,1,2,5,0.4,1,2,0.5,0,3,3,1,1,0,0,2,9,7.4
Tyreke Evans,27-126,G-F,1/23/17,NOP,CLE,0,12,3,8,0.375,2,5,0.4,1,3,0.333,2,2,1,0,2,2,4,0,0,1,2,9,6.2
Brandon Ingram,19-058,F,10/30/16,LAL,OKC,0,21,3,10,0.3,3,7,0.429,0,3,0,3,4,0.75,1,4,5,2,1,0,1,1,9,5.7
Joe Ingles,29-082,F-G,12/23/16,UTA,TOR,0,29,2,6,0.333,0,2,0,2,4,0.5,3,3,1,0,2,2,7,4,0,2,4,9,11.5
Langston Galloway,25-063,G,2/10/17,NOP,MIN,0,25,3,4,0.75,0,0,,3,4,0.75,0,0,,0,4,4,2,0,0,0,1,9,9.6
Nick Young,31-235,G-F,1/22/17,LAL,DAL,1,27,3,9,0.333,2,4,0.5,1,5,0.2,2,2,1,0,2,2,1,0,0,0,0,9,5.2
Luol Deng,31-281,F,1/22/17,LAL,DAL,1,19,4,7,0.571,3,4,0.75,1,3,0.333,0,0,,0,2,2,0,0,2,0,0,9,7.7
Luke Babbitt,27-222,F,1/28/17,MIA,DET,1,13,3,3,1,0,0,,3,3,1,0,0,,1,2,3,0,0,0,1,3,9,7.2
Corey Brewer,31-014,F-G,3/19/17,LAL,CLE,0,19,4,8,0.5,4,6,0.667,0,2,0,1,1,1,2,7,9,0,1,0,0,3,9,8.3
Jamal Crawford,37-003,G,3/23/17,LAC,DAL,0,26,3,7,0.429,1,4,0.25,2,3,0.667,1,1,1,1,3,4,1,0,0,2,2,9,4.8
Timothe Luwawu-Cabarrot,21-269,F,2/2/17,PHI,SAS,0,30,3,10,0.3,2,7,0.286,1,3,0.333,2,2,1,1,1,2,1,0,1,3,1,9,2.2
Lou Williams,30-160,G,4/5/17,HOU,DEN,0,30,1,9,0.111,0,5,0,1,4,0.25,6,7,0.857,1,6,7,3,0,0,4,1,9,2.9
Khris Middleton,25-196,F-G,2/24/17,MIL,UTA,0,24,2,9,0.222,1,7,0.143,1,2,0.5,4,4,1,1,2,3,0,0,0,0,0,9,4.8
Brian Roberts,31-116,G,3/29/17,CHO,TOR,0,13,3,4,0.75,1,2,0.5,2,2,1,1,2,0.5,1,0,1,3,0,0,1,1,9,8.4
Patrick Patterson,27-359,F,3/8/17,TOR,NOP,0,24,3,4,0.75,1,1,1,2,3,0.667,1,2,0.5,0,1,1,0,0,0,1,1,9,5.9
James Johnson,29-271,F,11/17/16,MIA,MIL,0,30,4,9,0.444,3,5,0.6,1,4,0.25,0,2,0,2,8,10,3,1,2,1,0,9,10.8
Raymond Felton,32-188,G,12/31/16,LAC,OKC,0,32,4,9,0.444,3,7,0.429,1,2,0.5,0,0,,0,2,2,4,1,0,1,1,9,7.3
Austin Rivers,24-100,G,11/9/16,LAC,POR,0,30,3,10,0.3,1,5,0.2,2,5,0.4,1,1,1,0,4,4,5,0,0,0,2,9,7.1
Pau Gasol,36-115,F-C,10/29/16,SAS,NOP,1,22,3,6,0.5,2,5,0.4,1,1,1,2,2,1,1,7,8,5,0,0,1,0,9,11.3
Andre Roberson,25-108,G-F,3/22/17,OKC,PHI,1,24,4,10,0.4,4,8,0.5,0,2,0,1,2,0.5,2,2,4,0,2,2,0,1,9,8.2
Buddy Hield,22-329,G,11/10/16,NOP,MIL,0,16,3,7,0.429,0,1,0,3,6,0.5,0,0,,1,3,4,0,1,0,1,0,9,6.9
Draymond Green,26-244,F,11/3/16,GSW,OKC,1,29,2,9,0.222,2,7,0.286,0,2,0,5,6,0.833,4,6,10,5,1,4,4,3,9,9.8
Pau Gasol,36-273,F-C,4/5/17,SAS,LAL,0,18,2,8,0.25,1,5,0.2,1,3,0.333,4,5,0.8,0,8,8,2,0,1,2,0,9,6.3
Tim Hardaway,25-026,G,4/11/17,ATL,CHO,1,23,3,7,0.429,2,3,0.667,1,4,0.25,2,2,1,0,5,5,3,0,0,1,1,9,7.5
Paul Zipser,23-012,G-F,3/2/17,CHI,GSW,0,23,4,5,0.8,3,3,1,1,2,0.5,0,0,,0,4,4,1,1,0,0,4,9,8.4
Marcus Smart,23-033,G,4/8/17,BOS,CHO,0,34,2,8,0.25,1,3,0.333,1,5,0.2,4,4,1,0,4,4,6,0,2,1,1,9,9.6
Miles Plumlee,28-079,C-F,11/19/16,MIL,GSW,0,15,3,4,0.75,3,4,0.75,0,0,,3,3,1,5,0,5,3,0,0,0,4,9,11.4
Serge Ibaka,27-108,F-C,1/4/17,ORL,ATL,1,33,4,13,0.308,4,9,0.444,0,4,0,1,1,1,4,7,11,0,1,1,3,4,9,3.5
Giannis Antetokounmpo,22-057,F-G,2/1/17,MIL,UTA,1,39,2,10,0.2,2,8,0.25,0,2,0,5,6,0.833,2,4,6,4,1,0,3,3,9,4.6
Rodney McGruder,25-091,G,10/28/16,MIA,CHO,0,20,3,9,0.333,0,4,0,3,5,0.6,0,0,,1,1,2,1,0,1,0,2,9,5.5
Andre Roberson,25-027,G-F,12/31/16,OKC,LAC,1,31,3,11,0.273,2,4,0.5,1,7,0.143,2,2,1,1,2,3,2,2,2,1,1,9,7.2
Solomon Hill,26-006,F,3/24/17,NOP,HOU,1,36,3,8,0.375,0,1,0,3,7,0.429,0,0,,0,3,3,4,1,0,2,3,9,6.1
Dwight Howard,31-087,C,3/5/17,ATL,IND,1,35,2,3,0.667,2,3,0.667,0,0,,5,11,0.455,4,10,14,3,2,1,4,3,9,10.7
Willie Cauley-Stein,23-082,F-C,11/8/16,SAC,NOP,0,12,4,6,0.667,4,6,0.667,0,0,,1,3,0.333,0,3,3,0,0,2,2,5,9,3.9
Mike Muscala,25-216,F-C,2/2/17,ATL,HOU,0,20,4,7,0.571,4,4,1,0,3,0,1,2,0.5,2,6,8,0,0,2,0,3,9,8.7
Kent Bazemore,27-239,G-F,2/25/17,ATL,ORL,1,24,4,9,0.444,3,7,0.429,1,2,0.5,0,0,,1,3,4,0,0,0,3,2,9,2.1
Emmanuel Mudiay,20-296,G,12/26/16,DEN,LAC,1,18,3,7,0.429,1,2,0.5,2,5,0.4,1,2,0.5,0,2,2,0,2,0,4,3,9,2.3
Ben McLemore,24-004,G,2/15/17,SAC,GSW,1,33,3,10,0.3,0,4,0,3,6,0.5,0,0,,0,4,4,2,0,1,2,4,9,2.9
Andre Roberson,24-329,G-F,10/28/16,OKC,PHO,1,40,3,4,0.75,2,3,0.667,1,1,1,2,2,1,0,11,11,0,5,1,1,5,9,13.4
Darren Collison,29-140,G,1/10/17,SAC,DET,1,28,4,9,0.444,3,6,0.5,1,3,0.333,0,0,,0,0,0,4,0,0,1,0,9,6.1
Tristan Thompson,25-306,F-C,1/13/17,CLE,SAC,1,26,3,6,0.5,3,5,0.6,0,1,0,3,6,0.5,1,3,4,0,2,2,0,3,9,8.6
Bismack Biyombo,24-103,C-F,12/9/16,ORL,CHO,1,16,4,5,0.8,4,5,0.8,0,0,,1,3,0.333,1,2,3,0,0,0,2,4,9,4
Justin Hamilton,26-280,C,1/6/17,BRK,CLE,0,16,4,9,0.444,3,6,0.5,1,3,0.333,0,0,,4,2,6,0,1,1,1,2,9,7.6
Carmelo Anthony,32-304,F,3/29/17,NYK,MIA,1,29,4,12,0.333,3,7,0.429,1,5,0.2,0,0,,0,7,7,1,0,0,2,2,9,2.2
Marcin Gortat,32-305,C-F,12/18/16,WAS,LAC,1,39,4,8,0.5,4,8,0.5,0,0,,1,1,1,2,5,7,0,1,2,2,4,9,6.7
Nick Young,31-275,G-F,3/3/17,LAL,BOS,1,16,3,10,0.3,0,1,0,3,9,0.333,0,0,,0,0,0,0,1,0,1,0,9,3.2
Ron Baker,23-340,G,3/5/17,NYK,GSW,0,23,3,7,0.429,2,4,0.5,1,3,0.333,2,4,0.5,1,4,5,1,1,1,2,2,9,6
Anthony Brown,24-053,F-G,12/2/16,NOP,LAC,0,25,4,7,0.571,3,3,1,1,4,0.25,0,0,,1,2,3,1,0,0,0,2,9,6.9
T.J. McConnell,24-287,G,1/6/17,PHI,BOS,1,37,4,6,0.667,4,6,0.667,0,0,,1,2,0.5,0,4,4,17,1,0,2,2,9,17.3
Trey Lyles,21-061,F,1/5/17,UTA,TOR,0,12,3,6,0.5,0,2,0,3,4,0.75,0,0,,1,1,2,0,0,0,3,1,9,3.6
Robin Lopez,29-011,C,4/12/17,CHI,BRK,1,23,2,4,0.5,2,4,0.5,0,0,,5,6,0.833,2,6,8,1,0,1,1,2,9,9.4
Marcus Smart,22-303,G,1/3/17,BOS,UTA,0,28,3,5,0.6,2,4,0.5,1,1,1,2,2,1,1,0,1,3,1,0,3,3,9,6.3
Marcus Smart,22-260,G,11/21/16,BOS,MIN,0,31,3,9,0.333,0,3,0,3,6,0.5,0,0,,0,6,6,5,1,0,6,1,9,3.8
Allen Crabbe,24-223,G-F,11/18/16,POR,NOP,0,27,3,6,0.5,3,3,1,0,3,0,3,5,0.6,0,2,2,0,0,1,1,1,9,5.1
Nik Stauskas,23-161,G,3/17/17,PHI,DAL,0,26,3,10,0.3,0,2,0,3,8,0.375,0,0,,2,5,7,2,2,0,1,1,9,8.1
Robin Lopez,29-005,C,4/6/17,CHI,PHI,1,32,4,13,0.308,4,13,0.308,0,0,,1,2,0.5,3,4,7,2,1,3,3,1,9,5.5
Cory Joseph,25-097,G,11/25/16,TOR,MIL,0,27,4,11,0.364,3,8,0.375,1,3,0.333,0,0,,1,3,4,3,0,0,1,1,9,5.2
P.J. Tucker,31-295,F,2/24/17,TOR,BOS,0,29,2,5,0.4,1,4,0.25,1,1,1,4,6,0.667,3,7,10,1,3,0,0,1,9,13
Tony Parker,34-161,G,10/25/16,SAS,GSW,1,26,4,9,0.444,3,7,0.429,1,2,0.5,0,0,,0,3,3,4,0,0,2,4,9,4.4
Tyson Chandler,34-111,C,1/21/17,PHO,NYK,1,32,2,5,0.4,2,5,0.4,0,0,,5,5,1,4,12,16,0,1,0,0,0,9,13.7
Marvin Williams,30-237,F,2/11/17,CHO,LAC,1,33,4,6,0.667,3,3,1,1,3,0.333,0,0,,1,4,5,1,0,0,3,4,9,4.4
Monta Ellis,31-113,G,2/16/17,IND,WAS,0,31,4,7,0.571,4,6,0.667,0,1,0,1,2,0.5,0,3,3,7,0,0,0,0,9,11.1
Josh Richardson,23-092,G,12/16/16,MIA,LAC,0,30,3,11,0.273,3,8,0.375,0,3,0,3,3,1,0,1,1,2,0,1,0,4,9,3.3
Nerlens Noel,22-264,C-F,12/30/16,PHI,DEN,0,19,4,7,0.571,4,7,0.571,0,0,,1,4,0.25,1,1,2,0,0,1,0,3,9,5
Trevor Booker,29-059,F,1/23/17,BRK,SAS,1,19,4,7,0.571,4,5,0.8,0,2,0,1,1,1,0,4,4,0,0,0,1,0,9,5.9
Monta Ellis,31-014,G,11/9/16,IND,PHI,1,40,4,9,0.444,3,7,0.429,1,2,0.5,0,0,,0,5,5,3,1,0,6,3,9,1.7
Jonas Valanciunas,24-263,C,1/24/17,TOR,SAS,1,29,2,7,0.286,2,7,0.286,0,0,,5,6,0.833,3,10,13,2,1,2,4,5,9,7.4
J.J. Barea,32-257,G,3/10/17,DAL,BRK,0,14,3,6,0.5,2,3,0.667,1,3,0.333,2,2,1,0,1,1,3,0,0,3,1,9,5
Jeremy Lin,28-186,G,2/25/17,BRK,GSW,1,15,4,9,0.444,3,6,0.5,1,3,0.333,0,0,,0,0,0,2,1,0,1,2,9,4.9
Caris LeVert,22-149,G-F,1/21/17,BRK,CHO,0,18,2,4,0.5,2,2,1,0,2,0,5,6,0.833,0,1,1,4,2,0,1,0,9,10.7
Jason Terry,39-065,G,11/19/16,MIL,GSW,0,19,3,5,0.6,0,1,0,3,4,0.75,0,0,,0,2,2,3,1,0,1,1,9,9
Trevor Booker,29-015,F,12/10/16,BRK,SAS,1,27,4,6,0.667,4,5,0.8,0,1,0,1,1,1,0,4,4,2,0,0,2,0,9,7
Justin Hamilton,26-291,C,1/17/17,BRK,TOR,0,13,4,8,0.5,3,4,0.75,1,4,0.25,0,0,,2,3,5,1,0,0,1,0,9,7
Wesley Matthews,30-110,G,2/1/17,DAL,PHI,1,31,3,9,0.333,2,5,0.4,1,4,0.25,2,2,1,0,6,6,1,0,0,1,2,9,4.6
Kristaps Porzingis,21-160,F-C,1/9/17,NYK,NOP,1,24,3,13,0.231,3,9,0.333,0,4,0,3,4,0.75,0,4,4,1,0,2,2,2,9,1.2
Rodney McGruder,25-182,G,1/27/17,MIA,CHI,1,28,3,4,0.75,2,3,0.667,1,1,1,2,2,1,0,4,4,0,3,0,0,1,9,11.2
Deron Williams,32-280,G,4/2/17,CLE,IND,0,17,3,5,0.6,1,1,1,2,4,0.5,1,2,0.5,0,0,0,6,0,0,1,1,9,9.1
Jared Dudley,31-149,F-G,12/6/16,PHO,UTA,0,26,3,5,0.6,1,2,0.5,2,3,0.667,1,2,0.5,0,7,7,3,1,0,3,4,9,6.9
Chasson Randle,24-052,G,3/29/17,NYK,MIA,0,21,3,9,0.333,2,5,0.4,1,4,0.25,2,2,1,1,3,4,3,0,0,0,2,9,6.8
Manu Ginobili,39-173,G,1/17/17,SAS,MIN,0,20,3,5,0.6,1,1,1,2,4,0.5,1,1,1,0,2,2,2,1,0,1,4,9,7.1
Allen Crabbe,24-276,G-F,1/10/17,POR,LAL,0,26,4,8,0.5,3,5,0.6,1,3,0.333,0,0,,0,1,1,0,1,0,1,2,9,4.5
Kentavious Caldwell-Pope,23-274,G,11/18/16,DET,CLE,1,28,4,12,0.333,3,9,0.333,1,3,0.333,0,0,,0,1,1,1,0,0,0,1,9,2.8
Steven Adams,23-187,C,1/23/17,OKC,UTA,1,37,4,10,0.4,4,10,0.4,0,0,,1,2,0.5,3,3,6,1,0,4,2,2,9,6.9
Steven Adams,23-100,C,10/28/16,OKC,PHO,1,40,3,8,0.375,3,8,0.375,0,0,,3,3,1,6,4,10,0,1,0,6,2,9,4.2
Jon Leuer,27-330,F,4/9/17,DET,MEM,1,20,3,8,0.375,2,5,0.4,1,3,0.333,2,4,0.5,1,0,1,0,1,0,1,0,9,4.5
C.J. McCollum,25-201,G,4/8/17,POR,UTA,1,35,4,20,0.2,3,16,0.188,1,4,0.25,0,0,,1,2,3,5,0,1,0,0,9,2.1
Patty Mills,28-186,G,2/13/17,SAS,IND,0,18,3,8,0.375,0,2,0,3,6,0.5,0,0,,0,0,0,2,0,0,0,1,9,5.6
Kyle Anderson,23-159,F-G,2/26/17,SAS,LAL,0,14,4,8,0.5,3,7,0.429,1,1,1,0,0,,1,2,3,1,1,0,0,2,9,7.2
Arron Afflalo,31-016,G,10/31/16,SAC,ATL,1,25,3,3,1,3,3,1,0,0,,3,3,1,0,2,2,2,1,0,1,3,9,8.9
Troy Daniels,25-173,G,1/4/17,MEM,LAC,0,24,3,13,0.231,0,2,0,3,11,0.273,0,0,,0,2,2,0,1,0,0,6,9,0.3
P.J. Tucker,31-322,F,3/23/17,TOR,MIA,1,33,3,8,0.375,0,3,0,3,5,0.6,0,0,,2,5,7,3,1,0,1,3,9,8.4
Montrezl Harrell,22-351,F-C,1/11/17,HOU,MIN,1,20,2,4,0.5,2,4,0.5,0,0,,5,5,1,1,4,5,2,1,0,1,4,9,8.7
Jamal Crawford,36-297,G,1/11/17,LAC,ORL,0,25,3,5,0.6,3,4,0.75,0,1,0,3,3,1,0,0,0,4,1,0,5,1,9,5.1
Dennis Schroder,23-134,G,1/27/17,ATL,WAS,1,23,3,11,0.273,2,6,0.333,1,5,0.2,2,2,1,0,0,0,5,0,0,4,1,9,1.6
Rodney Hood,24-156,G-F,3/25/17,UTA,LAC,1,23,4,13,0.308,3,9,0.333,1,4,0.25,0,0,,0,4,4,0,2,0,0,1,9,4.3
Jamal Crawford,36-348,G,3/3/17,LAC,MIL,0,18,4,5,0.8,3,4,0.75,1,1,1,0,0,,0,1,1,0,0,0,5,1,9,2
Iman Shumpert,26-220,G,2/1/17,CLE,MIN,1,28,3,9,0.333,0,2,0,3,7,0.429,0,0,,1,6,7,1,2,2,1,1,9,9.1
Arron Afflalo,31-116,G,2/8/17,SAC,BOS,1,34,3,9,0.333,3,7,0.429,0,2,0,3,4,0.75,0,3,3,3,1,0,3,2,9,3.7
Andrew Harrison,22-064,G,12/31/16,MEM,SAC,0,19,4,6,0.667,3,3,1,1,3,0.333,0,0,,1,1,2,6,0,0,0,2,9,10.8
Matthew Dellavedova,26-084,G,12/1/16,MIL,BRK,1,24,3,6,0.5,0,2,0,3,4,0.75,0,0,,0,0,0,4,1,0,2,2,9,7
Jason Terry,39-141,G,2/3/17,MIL,DEN,0,26,3,4,0.75,0,0,,3,4,0.75,0,0,,0,2,2,1,0,2,1,1,9,8.7
Thaddeus Young,28-219,F,1/26/17,IND,MIN,1,31,4,10,0.4,4,9,0.444,0,1,0,1,2,0.5,2,3,5,1,3,0,0,3,9,8
Thon Maker,20-021,F-C,3/18/17,MIL,GSW,1,13,3,5,0.6,3,3,1,0,2,0,3,4,0.75,3,2,5,1,1,1,0,1,9,11
Tony Snell,25-002,G-F,11/12/16,MIL,MEM,1,26,3,8,0.375,0,1,0,3,7,0.429,0,0,,0,1,1,1,0,0,0,0,9,5.6
D'Angelo Russell,20-324,G,1/12/17,LAL,SAS,1,27,4,13,0.308,3,10,0.3,1,3,0.333,0,0,,0,1,1,3,1,0,1,3,9,2.7
Gary Harris,22-177,G,3/10/17,DEN,BOS,1,36,3,9,0.333,2,5,0.4,1,4,0.25,2,2,1,1,2,3,1,3,0,2,3,9,5.7
Corey Brewer,30-257,F-G,11/17/16,HOU,POR,0,18,4,8,0.5,4,7,0.571,0,1,0,1,1,1,1,2,3,0,1,0,0,2,9,6.5
DeAndre Jordan,28-133,C,12/1/16,LAC,CLE,1,30,4,8,0.5,4,8,0.5,0,0,,1,3,0.333,8,7,15,0,0,1,0,1,9,12.2
Karl-Anthony Towns,21-008,C-F,11/23/16,MIN,NOP,1,27,4,11,0.364,3,8,0.375,1,3,0.333,0,0,,3,8,11,3,1,2,3,3,9,7.7
Nerlens Noel,22-341,C-F,3/17/17,DAL,PHI,0,19,4,7,0.571,4,7,0.571,0,0,,1,2,0.5,3,2,5,3,1,1,1,2,9,10
Gorgui Dieng,27-060,C,3/19/17,MIN,NOP,1,35,3,4,0.75,3,4,0.75,0,0,,3,3,1,2,7,9,1,2,2,3,2,9,11.2
Eric Gordon,28-029,G,1/23/17,HOU,MIL,0,28,3,9,0.333,0,1,0,3,8,0.375,0,0,,0,2,2,3,0,0,4,2,9,1.8
Alex Len,23-295,C,4/7/17,PHO,OKC,1,21,3,9,0.333,3,9,0.333,0,0,,3,4,0.75,3,7,10,1,1,1,1,6,9,6.7
Marcus Smart,22-360,G,3/1/17,BOS,CLE,0,33,4,9,0.444,3,7,0.429,1,2,0.5,0,0,,0,2,2,8,0,1,1,3,9,9
Justise Winslow,20-220,F,11/1/16,MIA,SAC,1,41,3,15,0.2,1,10,0.1,2,5,0.4,1,2,0.5,1,2,3,7,1,0,2,3,9,3.3
Sergio Rodriguez,30-280,G,3/19/17,PHI,BOS,0,20,4,6,0.667,3,4,0.75,1,2,0.5,0,0,,1,2,3,7,1,0,2,3,9,10.4
Darren Collison,29-077,G,11/8/16,SAC,NOP,1,28,4,9,0.444,3,6,0.5,1,3,0.333,0,0,,1,0,1,4,2,0,3,1,9,6.4
Brandon Rush,31-117,G-F,11/1/16,MIN,MEM,0,19,3,6,0.5,1,3,0.333,2,3,0.667,1,2,0.5,0,1,1,1,0,1,2,0,9,5.3
Kyle O'Quinn,27-012,F-C,4/7/17,NYK,MEM,0,20,4,8,0.5,4,7,0.571,0,1,0,1,2,0.5,1,2,3,2,1,1,0,4,9,7.4
DeAndre Jordan,28-136,C,12/4/16,LAC,IND,1,35,3,3,1,3,3,1,0,0,,3,5,0.6,4,11,15,0,2,2,3,1,9,13.4
Shelvin Mack,26-189,G,10/28/16,UTA,LAL,0,23,4,8,0.5,4,7,0.571,0,1,0,1,2,0.5,0,4,4,1,1,0,1,2,9,5.7
Delon Wright,24-311,G,3/3/17,TOR,WAS,0,22,2,2,1,1,1,1,1,1,1,4,6,0.667,0,1,1,1,1,4,2,1,9,10
Garrett Temple,30-201,G,11/25/16,SAC,HOU,0,24,3,6,0.5,2,2,1,1,4,0.25,2,2,1,0,3,3,1,2,0,3,2,9,5.8
Jared Sullinger,24-324,F,1/22/17,TOR,PHO,0,12,3,6,0.5,2,4,0.5,1,2,0.5,2,2,1,0,3,3,0,2,0,0,0,9,8.9
Glenn Robinson,23-066,G-F,3/15/17,IND,CHO,0,16,4,5,0.8,3,3,1,1,2,0.5,0,0,,0,5,5,0,0,0,0,0,9,8.6
C.J. McCollum,25-046,G,11/4/16,POR,DAL,1,23,4,11,0.364,3,6,0.5,1,5,0.2,0,1,0,1,4,5,2,0,0,1,5,9,2.8
Solomon Hill,25-325,F,2/6/17,NOP,PHO,1,31,3,8,0.375,3,6,0.5,0,2,0,3,3,1,2,0,2,2,1,1,1,2,9,7.3
Jamal Crawford,36-229,G,11/4/16,LAC,MEM,0,24,3,12,0.25,2,9,0.222,1,3,0.333,2,2,1,0,3,3,2,0,0,1,2,9,2.3
Brandon Ingram,19-098,F,12/9/16,LAL,PHO,1,31,3,8,0.375,2,6,0.333,1,2,0.5,2,4,0.5,2,5,7,3,0,0,0,1,9,8.4
Tyler Johnson,24-210,G,12/3/16,MIA,POR,0,34,3,14,0.214,1,9,0.111,2,5,0.4,1,2,0.5,1,6,7,4,2,1,1,3,9,5.8
Mindaugas Kuzminskas,27-088,F,1/15/17,NYK,TOR,0,23,3,8,0.375,2,3,0.667,1,5,0.2,2,2,1,1,1,2,1,0,0,2,3,9,3.1
Nikola Mirotic,26-060,F,4/12/17,CHI,BRK,1,23,3,12,0.25,1,4,0.25,2,8,0.25,1,2,0.5,4,5,9,2,3,1,1,4,9,8.2
Jameer Nelson,34-273,G,11/8/16,DEN,MEM,0,23,3,5,0.6,2,3,0.667,1,2,0.5,2,2,1,0,1,1,4,0,0,3,1,9,6.4
Anthony Brown,24-056,F-G,12/5/16,NOP,MEM,0,29,4,10,0.4,3,6,0.5,1,4,0.25,0,0,,1,5,6,2,1,0,1,2,9,6.4
Monta Ellis,31-139,G,3/14/17,IND,NYK,0,25,4,10,0.4,4,9,0.444,0,1,0,1,1,1,0,3,3,3,3,0,1,3,9,7.4
Jason Smith,30-339,F-C,2/4/17,WAS,NOP,0,14,4,4,1,4,4,1,0,0,,1,2,0.5,1,4,5,0,0,1,0,3,9,8.8
Marcus Smart,22-298,G,12/29/16,BOS,CLE,0,31,3,7,0.429,2,2,1,1,5,0.2,2,2,1,0,1,1,5,2,0,1,4,9,8.5
Bobby Portis,22-048,F,3/30/17,CHI,CLE,0,15,4,7,0.571,3,5,0.6,1,2,0.5,0,0,,3,1,4,0,1,0,0,1,9,8.7
Richard Jefferson,36-261,F,3/9/17,CLE,DET,1,34,3,6,0.5,2,3,0.667,1,3,0.333,2,2,1,0,7,7,2,0,0,1,6,9,6.1
Juan Hernangomez,21-169,F,3/16/17,DEN,LAC,1,26,3,7,0.429,2,4,0.5,1,3,0.333,2,2,1,1,4,5,1,1,0,1,2,9,7.1
Kelly Olynyk,25-295,C-F,2/8/17,BOS,SAC,0,15,4,7,0.571,4,7,0.571,0,0,,1,2,0.5,3,5,8,2,0,1,0,3,9,9.8
Jeremy Lamb,24-309,G-F,4/4/17,CHO,WAS,0,12,3,6,0.5,3,5,0.6,0,1,0,3,4,0.75,2,3,5,0,1,0,0,2,9,8.1
Rodney Stuckey,30-309,G,2/24/17,IND,MEM,0,15,2,7,0.286,1,5,0.2,1,2,0.5,4,4,1,1,2,3,1,0,0,1,0,9,5.9
Ed Davis,27-163,F,11/15/16,POR,CHI,0,19,4,5,0.8,4,5,0.8,0,0,,1,3,0.333,4,5,9,0,0,0,2,5,9,6.6
C.J. Miles,29-194,G-F,10/29/16,IND,CHI,0,20,4,11,0.364,3,9,0.333,1,2,0.5,0,0,,0,1,1,2,1,2,0,2,9,6.2
Marquese Chriss,19-121,F,10/31/16,PHO,LAC,0,18,2,4,0.5,2,3,0.667,0,1,0,5,6,0.833,0,2,2,1,1,0,3,4,9,4.3
Corey Brewer,31-023,F-G,3/28/17,LAL,WAS,1,15,3,4,0.75,3,4,0.75,0,0,,3,4,0.75,0,2,2,0,0,1,1,1,9,6.9
Kentavious Caldwell-Pope,23-356,G,2/8/17,DET,LAL,1,28,2,7,0.286,1,3,0.333,1,4,0.25,4,5,0.8,1,2,3,3,2,0,0,2,9,9.1
Ersan Ilyasova,29-313,F,3/24/17,ATL,MIL,1,33,3,9,0.333,2,6,0.333,1,3,0.333,2,2,1,2,7,9,2,2,0,2,3,9,7.6
T.J. Warren,23-122,F,1/5/17,PHO,DAL,1,24,4,11,0.364,4,9,0.444,0,2,0,1,2,0.5,1,4,5,0,0,0,0,2,9,3.6
Myles Turner,20-222,F-C,11/1/16,IND,LAL,1,25,2,7,0.286,2,6,0.333,0,1,0,5,7,0.714,0,6,6,2,0,2,1,5,9,5.7
Jason Smith,31-008,F-C,3/10/17,WAS,SAC,0,24,4,4,1,3,3,1,1,1,1,0,0,,0,6,6,1,1,1,0,3,9,10.8
Brandon Knight,24-333,G,10/30/16,PHO,GSW,0,26,3,12,0.25,2,9,0.222,1,3,0.333,2,2,1,1,0,1,3,2,0,3,3,9,2.4
Gorgui Dieng,27-062,C,3/21/17,MIN,SAS,1,33,4,6,0.667,3,4,0.75,1,2,0.5,0,0,,2,2,4,2,0,0,3,6,9,4.4
Tristan Thompson,25-353,F-C,3/1/17,CLE,BOS,1,35,4,11,0.364,4,11,0.364,0,0,,1,4,0.25,6,7,13,2,0,0,0,1,9,9
Josh Richardson,23-178,G,3/12/17,MIA,IND,1,37,2,7,0.286,2,4,0.5,0,3,0,5,6,0.833,5,3,8,0,3,1,1,3,9,10.4
Justin Holiday,27-297,G,1/27/17,NYK,CHO,0,20,3,6,0.5,2,2,1,1,4,0.25,2,2,1,0,5,5,2,1,0,0,2,9,9.1
K.J. McDaniels,24-035,G-F,3/16/17,BRK,NYK,0,18,2,5,0.4,1,3,0.333,1,2,0.5,4,5,0.8,1,4,5,1,0,0,1,2,9,6.7
Brandon Jennings,27-110,G,1/11/17,NYK,PHI,0,24,4,6,0.667,3,5,0.6,1,1,1,0,0,,0,3,3,2,0,0,3,0,9,5.7
Jaylen Brown,20-002,F,10/26/16,BOS,BRK,0,19,3,4,0.75,3,4,0.75,0,0,,3,4,0.75,0,2,2,1,1,2,1,1,9,9.3
Joe Harris,25-054,G,10/31/16,BRK,CHI,0,23,4,8,0.5,3,3,1,1,5,0.2,0,1,0,0,2,2,1,1,0,1,3,9,4.7
Brandon Ingram,19-065,F,11/6/16,LAL,PHO,0,25,2,7,0.286,1,5,0.2,1,2,0.5,4,6,0.667,0,2,2,1,1,1,0,1,9,6.7
Josh Richardson,23-111,G,1/4/17,MIA,SAC,1,37,4,11,0.364,3,4,0.75,1,7,0.143,0,0,,0,8,8,4,2,0,3,1,9,6.7
Pierre Jackson,25-150,G,1/26/17,DAL,OKC,1,13,4,8,0.5,3,7,0.429,1,1,1,0,0,,1,1,2,4,0,0,0,1,9,8.4
Marreese Speights,29-130,C-F,12/12/16,LAC,POR,0,15,3,7,0.429,2,4,0.5,1,3,0.333,2,2,1,2,2,4,1,0,0,0,2,9,7.2
Jae Crowder,26-245,F,3/8/17,BOS,GSW,1,30,3,9,0.333,1,3,0.333,2,6,0.333,1,2,0.5,2,8,10,4,0,0,3,1,9,6.7
Marreese Speights,29-181,C-F,2/1/17,LAC,PHO,0,21,2,7,0.286,1,5,0.2,1,2,0.5,4,4,1,2,5,7,0,0,1,0,4,9,6.9
Vince Carter,39-297,G-F,11/18/16,MEM,DAL,0,24,4,11,0.364,3,6,0.5,1,5,0.2,0,0,,0,3,3,1,0,0,1,4,9,1.9
J.R. Smith,31-212,G-F,4/9/17,CLE,ATL,1,34,3,10,0.3,0,0,,3,10,0.3,0,0,,1,3,4,2,0,0,0,3,9,5
Nikola Jokic,21-278,C-F,11/23/16,DEN,UTA,0,23,4,6,0.667,4,6,0.667,0,0,,1,2,0.5,1,4,5,6,0,0,0,4,9,10.5
Gordon Hayward,26-353,F-G,3/11/17,UTA,OKC,1,21,3,9,0.333,2,7,0.286,1,2,0.5,2,3,0.667,1,2,3,0,1,0,2,1,9,3.4
Eric Gordon,27-355,G,12/14/16,HOU,SAC,0,26,3,12,0.25,0,3,0,3,9,0.333,0,0,,0,2,2,8,0,2,0,2,9,8.6
James Ennis,26-126,F,11/4/16,MEM,LAC,1,36,3,9,0.333,3,8,0.375,0,1,0,3,4,0.75,7,4,11,2,1,1,2,4,9,9.1
Wade Baldwin,21-014,G,4/12/17,MEM,DAL,0,18,3,8,0.375,3,7,0.429,0,1,0,3,3,1,1,3,4,0,2,0,4,2,9,3.4
James Ennis,26-273,F,3/31/17,MEM,DAL,1,33,4,9,0.444,3,6,0.5,1,3,0.333,0,1,0,1,6,7,2,0,0,1,3,9,5.6
Jodie Meeks,29-108,G,12/7/16,ORL,BOS,0,16,3,7,0.429,2,4,0.5,1,3,0.333,2,2,1,0,0,0,0,0,0,0,3,9,4.1
Kristaps Porzingis,21-186,F-C,2/4/17,NYK,CLE,1,29,3,10,0.3,2,7,0.286,1,3,0.333,2,5,0.4,1,7,8,2,1,3,2,5,9,5.3
Manu Ginobili,39-221,G,3/6/17,SAS,HOU,0,20,4,9,0.444,3,5,0.6,1,4,0.25,0,0,,2,1,3,2,1,0,1,1,9,7
Tony Allen,35-057,G-F,3/9/17,MEM,LAC,0,24,4,8,0.5,4,8,0.5,0,0,,1,2,0.5,0,2,2,4,1,0,0,2,9,8.2
Mike Muscala,25-118,F-C,10/27/16,ATL,WAS,0,26,3,6,0.5,2,4,0.5,1,2,0.5,2,2,1,1,3,4,1,2,3,0,2,9,11.6
Tomas Satoransky,25-089,G,1/27/17,WAS,ATL,0,18,4,5,0.8,3,4,0.75,1,1,1,0,0,,1,2,3,0,1,0,1,2,9,7.6
Tony Allen,34-317,G-F,11/23/16,MEM,PHI,1,23,4,10,0.4,4,10,0.4,0,0,,1,1,1,1,2,3,2,0,0,1,4,9,3.7
Marvin Williams,30-197,F,1/2/17,CHO,CHI,1,28,3,9,0.333,2,6,0.333,1,3,0.333,2,2,1,1,1,2,1,0,0,1,0,9,4.6
Mason Plumlee,26-341,C-F,2/9/17,POR,BOS,1,30,3,5,0.6,3,5,0.6,0,0,,3,6,0.5,3,4,7,4,0,2,3,0,9,10
James Johnson,30-041,F,4/2/17,MIA,DEN,0,29,4,8,0.5,3,6,0.5,1,2,0.5,0,0,,1,2,3,6,0,0,2,3,9,7.3
Luke Babbitt,27-240,F,2/15/17,MIA,HOU,1,17,3,4,0.75,0,0,,3,4,0.75,0,0,,0,0,0,1,0,1,1,1,9,7.4
Tim Hardaway,24-310,G,1/20/17,ATL,CHI,0,21,4,10,0.4,3,7,0.429,1,3,0.333,0,0,,0,3,3,3,3,0,2,0,9,7.6
Nene Hilario,34-120,F-C,1/11/17,HOU,MIN,0,15,4,6,0.667,3,5,0.6,1,1,1,0,0,,0,2,2,0,0,0,0,3,9,5.8
D.J. Augustin,29-091,G,2/9/17,ORL,PHI,0,24,3,5,0.6,1,2,0.5,2,3,0.667,1,2,0.5,0,3,3,3,0,0,0,0,9,9.3
Jusuf Nurkic,22-215,C,3/26/17,POR,LAL,1,25,4,15,0.267,4,15,0.267,0,0,,1,2,0.5,4,9,13,4,1,1,2,3,9,6.5
Alan Anderson,34-151,G-F,3/16/17,LAC,DEN,0,17,3,3,1,2,2,1,1,1,1,2,3,0.667,0,0,0,0,0,0,0,2,9,6.9
Willie Cauley-Stein,23-108,F-C,12/4/16,SAC,NYK,0,23,4,7,0.571,4,7,0.571,0,0,,1,3,0.333,3,1,4,0,1,0,0,4,9,6.7
Andre Drummond,23-131,C,12/19/16,DET,CHI,1,23,4,8,0.5,4,8,0.5,0,0,,1,2,0.5,2,2,4,0,1,0,0,0,9,7.6
Al Horford,30-180,C-F,11/30/16,BOS,DET,1,32,3,5,0.6,2,3,0.667,1,2,0.5,2,2,1,0,5,5,4,0,2,1,2,9,10.6
Jae Crowder,26-115,F,10/29/16,BOS,CHO,1,34,3,9,0.333,0,2,0,3,7,0.429,0,0,,0,9,9,4,3,3,3,5,9,9.5
JaMychal Green,26-258,F,3/6/17,MEM,BRK,0,26,3,5,0.6,2,4,0.5,1,1,1,2,2,1,2,7,9,0,0,0,1,3,9,8
P.J. Tucker,31-286,F,2/15/17,PHO,LAL,0,21,3,6,0.5,2,4,0.5,1,2,0.5,2,2,1,1,2,3,0,0,0,0,2,9,6.5
Willie Cauley-Stein,23-195,F-C,3/1/17,SAC,BRK,0,25,2,6,0.333,2,6,0.333,0,0,,5,6,0.833,2,3,5,0,3,0,3,4,9,5.9
Mason Plumlee,27-013,C-F,3/18/17,DEN,HOU,1,31,3,5,0.6,3,5,0.6,0,0,,3,4,0.75,1,8,9,3,2,2,2,3,9,11.7
Tony Allen,34-325,G-F,12/1/16,MEM,ORL,1,27,4,11,0.364,4,10,0.4,0,1,0,1,2,0.5,4,2,6,0,3,0,1,2,9,7.1
Nik Stauskas,23-031,G,11/7/16,PHI,UTA,0,22,3,6,0.5,2,3,0.667,1,3,0.333,2,2,1,1,2,3,1,0,0,2,3,9,4.8
Joe Young,24-133,G,11/7/16,IND,CHO,0,16,4,10,0.4,4,8,0.5,0,2,0,1,2,0.5,0,2,2,2,1,0,0,0,9,6.2
Vince Carter,40-056,G-F,3/23/17,MEM,SAS,1,25,3,10,0.3,0,2,0,3,8,0.375,0,0,,1,1,2,1,1,0,0,3,9,4.7
Nikola Mirotic,25-301,F,12/8/16,CHI,SAS,0,22,4,8,0.5,3,3,1,1,5,0.2,0,0,,0,6,6,2,2,0,3,3,9,6
Luis Scola,36-192,F,11/8/16,BRK,MIN,0,17,4,6,0.667,4,5,0.8,0,1,0,1,2,0.5,3,3,6,2,0,0,1,3,9,8.2
Tony Allen,35-026,G-F,2/6/17,MEM,SAS,1,21,4,6,0.667,4,6,0.667,0,0,,1,2,0.5,1,5,6,1,2,2,0,0,9,12.3
Sergio Rodriguez,30-226,G,1/24/17,PHI,LAC,0,20,4,12,0.333,3,7,0.429,1,5,0.2,0,0,,0,3,3,7,0,0,1,0,9,7
Chris Paul,31-183,G,11/5/16,LAC,SAS,1,29,4,11,0.364,4,10,0.4,0,1,0,1,1,1,1,7,8,10,2,0,1,2,9,12.9
Alex Len,23-274,C,3/17/17,PHO,ORL,1,28,3,12,0.25,3,12,0.25,0,0,,3,4,0.75,4,5,9,2,3,2,2,3,9,8.3
Shaun Livingston,31-091,G,12/11/16,GSW,MIN,0,19,4,5,0.8,4,5,0.8,0,0,,1,1,1,0,4,4,1,1,0,0,1,9,9.6
Ish Smith,28-174,G,12/26/16,DET,CLE,0,18,4,7,0.571,3,6,0.5,1,1,1,0,0,,0,2,2,5,2,1,1,2,9,10.7
Quincy Acy,26-099,F,1/13/17,BRK,TOR,0,5,3,3,1,2,2,1,1,1,1,2,2,1,1,1,2,0,0,0,0,0,9,9.1
Deron Williams,32-167,G,12/10/16,DAL,HOU,1,32,3,10,0.3,2,6,0.333,1,4,0.25,2,2,1,0,3,3,6,0,0,0,2,9,7.5
Jon Leuer,27-206,F,12/6/16,DET,CHI,0,23,3,6,0.5,3,5,0.6,0,1,0,3,4,0.75,1,4,5,1,1,0,0,2,9,8.4
Dante Cunningham,29-345,F,4/2/17,NOP,CHI,0,14,3,4,0.75,0,1,0,3,3,1,0,0,,0,1,1,0,1,0,0,1,9,8.3
Solomon Hill,25-331,F,2/12/17,NOP,SAC,1,34,3,5,0.6,0,0,,3,5,0.6,0,0,,0,2,2,0,0,0,1,3,9,5.1
J.J. Barea,32-282,G,4/4/17,DAL,SAC,0,15,3,7,0.429,0,1,0,3,6,0.5,0,0,,0,4,4,4,0,0,2,0,9,7.3
Aaron Brooks,31-312,G,11/21/16,IND,GSW,0,20,3,7,0.429,2,5,0.4,1,2,0.5,2,2,1,0,0,0,3,1,0,1,1,9,7
Wayne Ellington,29-141,G,3/19/17,MIA,POR,0,23,3,10,0.3,0,0,,3,10,0.3,0,0,,2,3,5,0,0,0,0,0,9,5.5
C.J. Miles,29-291,G-F,2/3/17,IND,BRK,1,30,3,10,0.3,0,2,0,3,8,0.375,0,0,,0,4,4,1,1,2,0,1,9,7.1
Jose Calderon,35-034,G,11/1/16,LAL,IND,0,17,3,4,0.75,2,2,1,1,2,0.5,2,2,1,0,2,2,2,1,0,3,1,9,7
Marcus Smart,23-018,G,3/24/17,BOS,PHO,0,31,1,13,0.077,0,4,0,1,9,0.111,6,6,1,1,2,3,6,2,0,1,4,9,5.2
Ish Smith,28-171,G,12/23/16,DET,GSW,0,18,4,7,0.571,3,6,0.5,1,1,1,0,1,0,0,1,1,3,1,0,2,1,9,6.3
Brandan Wright,29-146,F-C,2/28/17,MEM,PHO,0,17,4,6,0.667,4,6,0.667,0,0,,1,2,0.5,3,2,5,1,0,0,0,1,9,9
Trevor Ariza,31-180,F,12/27/16,HOU,DAL,1,30,3,5,0.6,0,1,0,3,4,0.75,0,0,,0,7,7,1,1,0,0,2,9,9.7
Andre Iguodala,33-039,G-F,3/8/17,GSW,BOS,0,29,4,6,0.667,3,4,0.75,1,2,0.5,0,0,,0,3,3,3,2,0,3,1,9,8
Jordan Farmar,29-341,G,11/5/16,SAC,MIL,0,25,3,10,0.3,0,2,0,3,8,0.375,0,0,,1,1,2,7,2,0,2,0,9,9.1
Allen Crabbe,24-214,G-F,11/9/16,POR,LAC,0,23,4,6,0.667,3,4,0.75,1,2,0.5,0,0,,0,2,2,1,0,0,1,0,9,6.7
Patrick McCaw,21-041,G,12/5/16,GSW,IND,0,15,3,8,0.375,0,2,0,3,6,0.5,0,0,,2,2,4,5,1,0,2,0,9,9.1
Amir Johnson,29-231,F,12/18/16,BOS,MIA,1,20,4,5,0.8,3,4,0.75,1,1,1,0,0,,2,2,4,2,0,0,1,3,9,8.3
Justin Hamilton,26-302,C,1/28/17,BRK,MIN,0,20,4,7,0.571,3,5,0.6,1,2,0.5,0,0,,1,6,7,0,0,1,1,2,9,7.1
Andre Roberson,25-017,G-F,12/21/16,OKC,NOP,1,29,4,7,0.571,3,4,0.75,1,3,0.333,0,0,,1,6,7,0,2,1,0,2,9,10.1
Wesley Matthews,30-025,G,11/8/16,DAL,LAL,1,38,4,10,0.4,3,6,0.5,1,4,0.25,0,0,,1,2,3,7,2,0,1,2,9,10
Elfrid Payton,22-275,G,11/23/16,ORL,PHO,1,31,3,11,0.273,3,10,0.3,0,1,0,3,5,0.6,3,3,6,7,1,0,3,2,9,6.8
Aaron Brooks,31-307,G,11/16/16,IND,CLE,0,11,4,7,0.571,3,3,1,1,4,0.25,0,0,,0,0,0,2,1,0,0,1,9,7.7
Jeff Teague,28-168,G,11/25/16,IND,BRK,1,24,4,8,0.5,4,7,0.571,0,1,0,1,1,1,1,8,9,8,3,0,4,0,9,12.7
Alex Len,23-156,C,11/19/16,PHO,PHI,1,25,4,7,0.571,4,7,0.571,0,0,,1,6,0.167,2,5,7,1,1,2,0,2,9,8.9
Jeff Teague,28-144,G,11/1/16,IND,LAL,1,33,4,15,0.267,3,8,0.375,1,7,0.143,0,2,0,1,5,6,6,2,0,3,2,9,3.9
Tobias Harris,24-126,F,11/18/16,DET,CLE,1,20,3,10,0.3,2,7,0.286,1,3,0.333,2,2,1,0,2,2,0,0,0,1,2,9,2
Marreese Speights,29-151,C-F,1/2/17,LAC,PHO,0,18,1,4,0.25,0,2,0,1,2,0.5,6,6,1,0,6,6,0,0,2,1,2,9,8
Brandon Ingram,19-106,F,12/17/16,LAL,CLE,1,41,4,10,0.4,3,5,0.6,1,5,0.2,0,0,,2,8,10,9,0,0,2,1,9,11.3
Joe Johnson,35-131,G-F,11/7/16,UTA,PHI,0,22,4,8,0.5,3,6,0.5,1,2,0.5,0,0,,2,3,5,1,0,0,0,0,9,8
Jamal Crawford,36-271,G,12/16/16,LAC,MIA,0,20,4,13,0.308,3,8,0.375,1,5,0.2,0,0,,0,3,3,3,0,0,2,0,9,2.5
Dante Cunningham,29-190,F,10/29/16,NOP,SAS,0,23,3,5,0.6,1,2,0.5,2,3,0.667,1,2,0.5,2,3,5,0,0,0,1,3,9,6.4
Kenneth Faried,27-125,F,3/24/17,DEN,IND,0,16,3,6,0.5,3,5,0.6,0,1,0,3,3,1,1,2,3,0,0,0,0,0,9,7.3
Luc Mbah a Moute,30-187,F,3/15/17,LAC,MIL,1,19,4,5,0.8,4,5,0.8,0,0,,1,1,1,0,1,1,2,0,0,1,2,9,7
Seth Curry,26-083,G,11/14/16,DAL,NYK,0,30,4,12,0.333,3,5,0.6,1,7,0.143,0,0,,2,3,5,3,1,0,1,0,9,6.6
Derrick Favors,25-182,F-C,1/13/17,UTA,DET,1,27,4,10,0.4,4,10,0.4,0,0,,1,3,0.333,2,7,9,1,1,1,0,1,9,8.3
Patrick Beverley,28-267,G,4/5/17,HOU,DEN,1,33,4,9,0.444,4,7,0.571,0,2,0,1,3,0.333,2,9,11,1,2,0,2,5,9,6.3
Matthew Dellavedova,26-149,G,2/4/17,MIL,PHO,1,22,4,5,0.8,3,4,0.75,1,1,1,0,0,,0,0,0,3,1,0,2,4,9,6.6
Marquese Chriss,19-214,F,2/1/17,PHO,LAC,1,28,3,15,0.2,2,9,0.222,1,6,0.167,2,2,1,3,2,5,1,4,0,0,2,9,6.3
Ricky Rubio,26-043,G,12/3/16,MIN,CHO,1,37,2,7,0.286,1,5,0.2,1,2,0.5,4,5,0.8,1,6,7,12,1,1,2,3,9,13.9
Jeff Green,30-192,F,3/8/17,ORL,CHI,0,19,4,10,0.4,3,6,0.5,1,4,0.25,0,0,,2,3,5,2,1,0,1,2,9,6.5
Tony Snell,25-035,G-F,12/15/16,MIL,CHI,1,31,4,10,0.4,3,8,0.375,1,2,0.5,0,0,,0,4,4,1,0,0,0,2,9,4.7
Yogi Ferrell,23-310,G,3/15/17,DAL,WAS,1,25,2,7,0.286,0,3,0,2,4,0.5,3,4,0.75,0,1,1,3,0,0,1,5,9,3.9
Manu Ginobili,39-216,G,3/1/17,SAS,IND,0,23,3,6,0.5,2,3,0.667,1,3,0.333,2,4,0.5,0,1,1,0,0,0,3,3,9,1.3
Dante Cunningham,29-214,F,11/22/16,NOP,ATL,1,25,4,7,0.571,3,6,0.5,1,1,1,0,0,,1,4,5,1,0,3,0,2,9,9.6
Derrick Favors,25-169,F-C,12/31/16,UTA,PHO,1,24,4,8,0.5,4,8,0.5,0,0,,1,4,0.25,2,6,8,3,0,1,2,0,9,7.8
Jordan McRae,25-261,G,12/14/16,CLE,MEM,0,16,3,9,0.333,3,6,0.5,0,3,0,3,3,1,0,1,1,0,0,0,0,1,9,3.8
J.R. Smith,31-070,G-F,11/18/16,CLE,DET,1,25,3,7,0.429,0,1,0,3,6,0.5,0,0,,0,1,1,2,2,1,1,0,9,8.7
Jonas Valanciunas,24-336,C,4/7/17,TOR,MIA,1,30,4,9,0.444,4,8,0.5,0,1,0,1,2,0.5,3,7,10,0,0,2,0,3,9,8.3
J.J. Barea,32-143,G,11/16/16,DAL,BOS,0,28,4,11,0.364,3,8,0.375,1,3,0.333,0,0,,0,2,2,6,1,0,1,0,9,7.7
Cameron Payne,22-179,G,2/3/17,OKC,MEM,0,19,4,7,0.571,3,5,0.6,1,2,0.5,0,0,,0,1,1,1,0,0,0,0,9,6.7
Marreese Speights,29-102,C-F,11/14/16,LAC,BRK,0,18,3,8,0.375,1,4,0.25,2,4,0.5,1,2,0.5,1,5,6,1,2,3,1,0,9,10.2
Sam Dekker,22-177,F,10/30/16,HOU,DAL,0,15,3,5,0.6,0,2,0,3,3,1,0,0,,0,1,1,0,0,0,0,1,9,6.6
Jerami Grant,22-255,F,11/22/16,OKC,LAL,0,23,4,5,0.8,3,3,1,1,2,0.5,0,0,,0,3,3,1,1,0,0,2,9,8.9
Tristan Thompson,25-304,F-C,1/11/17,CLE,POR,1,28,4,6,0.667,4,6,0.667,0,0,,1,2,0.5,5,5,10,2,0,1,3,2,9,9.3
Terry Rozier,23-014,G,3/31/17,BOS,ORL,0,19,4,8,0.5,3,6,0.5,1,2,0.5,0,0,,0,6,6,3,0,0,1,1,9,7.5
Jrue Holiday,26-173,G,12/2/16,NOP,LAC,1,28,4,12,0.333,3,9,0.333,1,3,0.333,0,0,,1,3,4,4,1,0,1,2,9,5.8
Skal Labissiere,21-011,F,3/29/17,SAC,UTA,1,33,4,8,0.5,4,8,0.5,0,0,,1,4,0.25,1,6,7,2,1,1,0,5,9,7.4
J.R. Smith,31-196,G-F,3/24/17,CLE,CHO,1,31,3,5,0.6,0,0,,3,5,0.6,0,0,,0,2,2,0,0,0,0,3,9,6.1
Jameer Nelson,34-260,G,10/26/16,DEN,NOP,0,20,4,8,0.5,3,4,0.75,1,4,0.25,0,0,,0,2,2,3,1,0,4,2,9,3.9
C.J. Watson,32-216,G,11/19/16,ORL,DAL,0,19,2,4,0.5,1,2,0.5,1,2,0.5,4,4,1,0,0,0,0,0,0,0,1,9,6.6
JaVale McGee,29-013,C,2/1/17,GSW,CHO,1,17,4,7,0.571,4,7,0.571,0,0,,1,1,1,1,3,4,0,0,4,1,1,9,8.7
Buddy Hield,22-326,G,11/7/16,NOP,GSW,0,28,4,10,0.4,3,5,0.6,1,5,0.2,0,0,,2,4,6,1,0,0,1,3,9,4.7
Robert Covington,25-354,F,12/2/16,PHI,ORL,1,23,3,9,0.333,0,2,0,3,7,0.429,0,0,,2,4,6,1,2,0,0,2,9,8.4
C.J. Miles,29-275,G-F,1/18/17,IND,SAC,0,21,3,8,0.375,1,2,0.5,2,6,0.333,1,3,0.333,1,1,2,0,1,0,0,3,9,4.6
Aaron Gordon,21-081,F,12/6/16,ORL,WAS,1,28,4,9,0.444,3,8,0.375,1,1,1,0,0,,0,5,5,2,1,2,0,0,9,9.6
Joakim Noah,31-260,C,11/11/16,NYK,BOS,1,22,4,5,0.8,4,5,0.8,0,0,,1,1,1,3,7,10,2,1,3,3,0,9,12.8
Kosta Koufos,27-338,C,1/27/17,SAC,IND,1,28,4,6,0.667,4,6,0.667,0,0,,1,4,0.25,2,10,12,0,0,0,1,3,9,7.4
Jaylen Brown,20-084,F,1/16/17,BOS,CHO,0,20,4,7,0.571,4,7,0.571,0,0,,1,1,1,0,2,2,2,0,0,0,2,9,6.9
Langston Galloway,25-065,G,2/12/17,NOP,SAC,0,25,3,8,0.375,0,2,0,3,6,0.5,0,1,0,0,0,0,1,0,0,0,3,9,3.7
Solomon Hill,25-254,F,11/27/16,NOP,DAL,1,42,4,6,0.667,3,3,1,1,3,0.333,0,0,,0,4,4,0,2,1,1,3,9,8.1
Andre Iguodala,32-324,G-F,12/17/16,GSW,POR,0,19,4,6,0.667,3,4,0.75,1,2,0.5,0,0,,0,3,3,1,0,0,1,0,9,7
Wesley Matthews,30-142,G,3/5/17,DAL,OKC,1,32,3,8,0.375,2,4,0.5,1,4,0.25,2,2,1,0,0,0,4,3,0,0,2,9,9.6
Dwight Powell,25-154,F-C,12/21/16,DAL,POR,0,24,1,2,0.5,1,2,0.5,0,0,,7,9,0.778,5,3,8,0,3,2,1,4,9,13.4
Caris LeVert,22-169,G-F,2/10/17,BRK,MIA,0,19,4,7,0.571,3,6,0.5,1,1,1,0,1,0,1,2,3,1,0,0,2,4,9,3.7
Frank Kaminsky,23-311,F-C,2/9/17,CHO,HOU,0,20,3,9,0.333,3,6,0.5,0,3,0,3,3,1,0,3,3,1,1,0,1,1,9,5.1
D.J. Augustin,29-022,G,12/2/16,ORL,PHI,1,22,3,6,0.5,0,2,0,3,4,0.75,0,0,,0,3,3,4,0,0,1,3,9,7.5
Deron Williams,32-272,G,3/25/17,CLE,WAS,0,20,3,4,0.75,2,3,0.667,1,1,1,2,2,1,0,0,0,4,1,0,3,3,9,7
Robert Covington,26-023,F,1/6/17,PHI,BOS,1,36,2,6,0.333,0,3,0,2,3,0.667,3,4,0.75,0,3,3,2,3,2,3,4,9,7.3
Tyler Ennis,22-084,G,11/16/16,HOU,OKC,0,11,4,5,0.8,3,4,0.75,1,1,1,0,0,,0,2,2,2,1,0,0,0,9,10.1
Jamal Murray,19-278,G,11/27/16,DEN,PHO,0,22,3,8,0.375,2,4,0.5,1,4,0.25,2,2,1,1,3,4,2,0,0,1,4,9,5
Ian Clark,25-355,G,2/25/17,GSW,BRK,0,19,4,8,0.5,3,4,0.75,1,4,0.25,0,0,,3,1,4,2,2,0,0,0,9,10.8
Richard Jefferson,36-249,F,2/25/17,CLE,CHI,1,31,3,4,0.75,2,2,1,1,2,0.5,2,2,1,0,3,3,2,0,0,0,0,9,9.7
Anthony Tolliver,31-291,F-C,3/19/17,SAC,SAS,0,19,3,4,0.75,1,2,0.5,2,2,1,1,2,0.5,1,2,3,2,0,1,0,1,9,10
Jonathon Simmons,27-056,G-F,11/9/16,SAS,HOU,0,21,3,4,0.75,3,4,0.75,0,0,,3,3,1,0,3,3,1,1,1,0,2,9,9.9
Mindaugas Kuzminskas,27-075,F,1/2/17,NYK,ORL,0,16,3,6,0.5,0,3,0,3,3,1,0,0,,0,1,1,0,0,1,1,3,9,4.8
Luol Deng,31-305,F,2/15/17,LAL,PHO,0,23,3,6,0.5,2,3,0.667,1,3,0.333,2,2,1,0,2,2,0,0,1,0,3,9,6.1
Greg Monroe,26-231,C-F,1/21/17,MIL,MIA,0,17,3,7,0.429,3,7,0.429,0,0,,3,4,0.75,3,3,6,0,0,0,2,1,9,5.5
Dragan Bender,19-143,F,4/9/17,PHO,DAL,0,35,4,10,0.4,3,4,0.75,1,6,0.167,0,0,,2,6,8,3,1,1,3,4,9,6
Derrick Williams,25-187,F,11/28/16,MIA,BOS,1,21,3,9,0.333,3,6,0.5,0,3,0,3,6,0.5,0,4,4,0,0,0,0,1,9,3.5
Andre Iguodala,33-055,G-F,3/24/17,GSW,SAC,0,27,4,7,0.571,4,6,0.667,0,1,0,1,2,0.5,0,1,1,3,0,0,0,1,9,7.3
Lance Thomas,28-324,F,3/14/17,NYK,IND,1,33,3,9,0.333,0,2,0,3,7,0.429,0,0,,2,5,7,1,0,0,1,2,9,5.7
Bismack Biyombo,24-093,C-F,11/29/16,ORL,SAS,1,34,3,11,0.273,3,11,0.273,0,0,,3,4,0.75,0,6,6,1,1,1,1,2,9,4.5
Kyle Korver,35-351,G-F,3/3/17,CLE,ATL,0,30,3,8,0.375,0,1,0,3,7,0.429,0,0,,0,2,2,3,1,1,2,2,9,6.2
Myles Turner,21-007,F-C,3/31/17,IND,TOR,1,39,4,7,0.571,3,6,0.5,1,1,1,0,1,0,3,6,9,2,1,4,1,4,9,11.8
Draymond Green,26-274,F,12/3/16,GSW,PHO,1,28,2,6,0.333,1,3,0.333,1,3,0.333,4,5,0.8,1,4,5,14,3,0,4,3,9,14.7
Domantas Sabonis,20-249,F,1/7/17,OKC,DEN,1,19,2,7,0.286,2,5,0.4,0,2,0,5,5,1,1,4,5,1,1,0,0,2,9,7.7
Zach LaVine,21-315,G,1/19/17,MIN,LAC,1,40,3,13,0.231,2,7,0.286,1,6,0.167,2,2,1,0,6,6,2,1,0,2,2,9,2.5
Ersan Ilyasova,29-300,F,3/11/17,ATL,MEM,0,18,2,5,0.4,1,3,0.333,1,2,0.5,4,4,1,0,2,2,2,1,0,1,6,9,5.9
Langston Galloway,24-334,G,11/7/16,NOP,GSW,0,21,3,8,0.375,2,6,0.333,1,2,0.5,2,3,0.667,1,1,2,4,2,0,1,0,9,9
Jabari Parker,21-257,F,11/27/16,MIL,ORL,1,29,3,8,0.375,2,6,0.333,1,2,0.5,2,3,0.667,1,6,7,4,0,0,2,1,9,7.1
Yogi Ferrell,23-265,G,1/29/17,DAL,SAS,1,36,3,9,0.333,2,5,0.4,1,4,0.25,2,2,1,2,0,2,7,2,0,0,3,9,11
Patrick Patterson,27-275,F,12/14/16,TOR,PHI,0,28,3,6,0.5,1,2,0.5,2,4,0.5,1,2,0.5,2,3,5,1,0,0,0,1,9,8.2
Darrell Arthur,29-017,F,4/11/17,DEN,DAL,0,17,3,9,0.333,0,2,0,3,7,0.429,0,0,,1,2,3,0,0,0,1,1,9,3.8
Justin Holiday,27-279,G,1/9/17,NYK,NOP,0,21,3,10,0.3,2,5,0.4,1,5,0.2,2,2,1,0,1,1,0,0,0,2,1,9,1.1
Thon Maker,20-046,F-C,4/12/17,MIL,BOS,1,27,3,8,0.375,3,6,0.5,0,2,0,3,3,1,3,3,6,3,0,3,3,2,9,8
Alex Len,23-174,C,12/7/16,PHO,IND,0,16,2,5,0.4,2,5,0.4,0,0,,5,5,1,1,1,2,0,0,2,2,6,9,4.3
Patrick McCaw,21-162,G,4/5/17,GSW,PHO,1,26,4,5,0.8,3,3,1,1,2,0.5,0,0,,0,5,5,4,3,0,1,2,9,12.6
Serge Ibaka,27-174,F-C,3/11/17,TOR,MIA,1,28,3,11,0.273,2,7,0.286,1,4,0.25,2,2,1,0,4,4,0,0,3,2,1,9,3.4
Meyers Leonard,25-015,C-F,3/14/17,POR,NOP,0,25,3,8,0.375,0,3,0,3,5,0.6,0,0,,1,6,7,3,0,0,1,4,9,6.6
George Hill,30-325,G,3/25/17,UTA,LAC,1,32,4,11,0.364,3,8,0.375,1,3,0.333,0,0,,0,1,1,1,0,0,4,2,9,-0.9
Ryan Anderson,28-247,F,1/8/17,HOU,TOR,1,32,2,8,0.25,1,3,0.333,1,5,0.2,4,4,1,2,2,4,0,1,0,0,2,9,6.4
J.J. Redick,32-209,G,1/19/17,LAC,MIN,1,31,4,11,0.364,3,8,0.375,1,3,0.333,0,0,,1,1,2,3,1,0,1,0,9,6
Timothe Luwawu-Cabarrot,21-273,F,2/6/17,PHI,DET,0,21,2,4,0.5,2,3,0.667,0,1,0,5,5,1,0,5,5,2,0,0,0,2,9,9.1
Will Barton,26-006,G,1/12/17,DEN,IND,0,24,3,10,0.3,2,8,0.25,1,2,0.5,2,2,1,3,4,7,3,1,0,0,1,9,9.2
Mike Muscala,25-150,F-C,11/28/16,ATL,GSW,0,20,4,5,0.8,3,3,1,1,2,0.5,0,1,0,2,2,4,1,1,0,1,2,9,8.6
Jordan Clarkson,24-215,G,1/8/17,LAL,ORL,0,29,3,9,0.333,2,4,0.5,1,5,0.2,2,2,1,0,4,4,4,1,0,0,0,9,8.9
Courtney Lee,31-073,G,12/15/16,NYK,GSW,1,33,4,11,0.364,4,8,0.5,0,3,0,1,2,0.5,0,4,4,3,0,1,0,1,9,6.1
Glenn Robinson,22-315,G-F,11/18/16,IND,PHO,0,25,4,6,0.667,4,6,0.667,0,0,,1,1,1,0,3,3,0,0,1,1,0,9,7
Josh Richardson,23-096,G,12/20/16,MIA,ORL,1,44,2,12,0.167,0,4,0,2,8,0.25,3,4,0.75,1,3,4,6,0,0,2,4,9,3.2
Ish Smith,28-187,G,1/8/17,DET,POR,0,21,4,6,0.667,3,5,0.6,1,1,1,0,0,,0,2,2,3,1,0,0,2,9,9.3
Devin Harris,34-041,G,4/9/17,DAL,PHO,0,9,3,5,0.6,0,0,,3,5,0.6,0,0,,0,1,1,1,0,0,1,1,9,6.3
Tim Frazier,26-045,G,12/16/16,NOP,HOU,0,25,3,8,0.375,1,5,0.2,2,3,0.667,1,1,1,2,2,4,5,0,0,0,1,9,9.7
Marquese Chriss,19-281,F,4/9/17,PHO,DAL,1,17,3,4,0.75,2,3,0.667,1,1,1,2,2,1,0,4,4,3,0,0,0,1,9,10.3
Dante Cunningham,29-242,F,12/20/16,NOP,PHI,0,19,3,6,0.5,0,2,0,3,4,0.75,0,0,,0,5,5,1,0,0,0,0,9,8.2
Arron Afflalo,31-116,G,2/8/17,SAC,BOS,1,34,3,9,0.333,3,7,0.429,0,2,0,3,4,0.75,0,3,3,3,1,0,3,2,9,3.7
DeAndre Jordan,28-200,C,2/6/17,LAC,TOR,1,25,4,6,0.667,4,6,0.667,0,0,,1,2,0.5,2,10,12,1,0,1,0,4,9,10.2
Andre Drummond,23-230,C,3/28/17,DET,MIA,1,34,4,7,0.571,4,7,0.571,0,0,,1,3,0.333,6,7,13,2,2,2,2,3,9,12.8
Justin Anderson,23-025,G,12/14/16,DAL,DET,0,13,3,7,0.429,1,4,0.25,2,3,0.667,1,2,0.5,0,5,5,0,0,0,1,2,9,4.6
Jrue Holiday,26-299,G,4/7/17,NOP,DEN,1,24,4,9,0.444,3,4,0.75,1,5,0.2,0,0,,0,3,3,7,1,0,2,2,9,8.3
Buddy Hield,22-360,G,12/11/16,NOP,PHO,1,13,3,7,0.429,1,3,0.333,2,4,0.5,1,2,0.5,0,1,1,0,0,0,0,0,9,5.2
Nene Hilario,34-124,F-C,1/15/17,HOU,BRK,0,14,4,6,0.667,4,6,0.667,0,0,,1,4,0.25,2,1,3,1,1,1,1,3,9,7.1
Robin Lopez,28-295,C,1/21/17,CHI,SAC,1,29,4,8,0.5,4,8,0.5,0,0,,1,2,0.5,4,4,8,2,0,1,0,3,9,9.5
J.J. Redick,32-234,G,2/13/17,LAC,UTA,1,25,3,10,0.3,1,3,0.333,2,7,0.286,1,1,1,0,2,2,1,1,0,2,2,9,2.7
Dante Exum,21-124,G,11/14/16,UTA,MEM,1,30,4,9,0.444,4,6,0.667,0,3,0,1,2,0.5,1,2,3,2,0,0,1,4,9,4
Corey Brewer,31-002,F-G,3/7/17,LAL,DAL,0,13,4,7,0.571,3,5,0.6,1,2,0.5,0,0,,0,2,2,0,1,1,0,1,9,7.6
Nick Young,31-252,G-F,2/8/17,LAL,DET,1,20,3,9,0.333,2,5,0.4,1,4,0.25,2,3,0.667,0,2,2,0,1,0,1,4,9,2.5
A.J. Hammons,24-228,C,4/12/17,DAL,MEM,0,12,3,4,0.75,3,4,0.75,0,0,,3,4,0.75,0,1,1,0,0,2,1,2,9,6.9
Quincy Acy,26-161,F,3/16/17,BRK,NYK,0,23,3,6,0.5,2,4,0.5,1,2,0.5,2,3,0.667,1,4,5,1,0,0,0,1,9,7.8
Marvin Williams,30-190,F,12/26/16,CHO,BRK,1,28,3,8,0.375,2,5,0.4,1,3,0.333,2,2,1,2,2,4,1,3,0,2,1,9,7.9
Trevor Booker,29-006,F,12/1/16,BRK,MIL,1,27,4,7,0.571,4,7,0.571,0,0,,1,1,1,5,3,8,2,2,0,3,4,9,8.9
Bismack Biyombo,24-116,C-F,12/22/16,ORL,NYK,1,27,3,6,0.5,3,6,0.5,0,0,,3,4,0.75,1,5,6,0,1,5,0,2,9,11.5
David Nwaba,24-071,G,3/26/17,LAL,POR,0,29,4,4,1,3,3,1,1,1,1,0,1,0,0,1,1,0,1,0,1,2,9,6.9
George Hill,30-264,G,1/23/17,UTA,OKC,1,32,2,10,0.2,2,6,0.333,0,4,0,5,6,0.833,0,2,2,3,1,1,2,3,9,3.6
Buddy Hield,23-021,G,1/7/17,NOP,BOS,1,24,3,9,0.333,0,4,0,3,5,0.6,0,0,,0,5,5,3,0,0,1,2,9,5.7
Nene Hilario,34-111,F-C,1/2/17,HOU,WAS,0,14,4,6,0.667,4,6,0.667,0,0,,1,4,0.25,1,2,3,1,1,1,0,0,9,8.9
Marcus Smart,22-313,G,1/13/17,BOS,ATL,1,37,2,13,0.154,1,9,0.111,1,4,0.25,4,6,0.667,2,0,2,4,4,0,2,3,9,4.9
Mindaugas Kuzminskas,27-133,F,3/1/17,NYK,ORL,0,15,2,7,0.286,1,4,0.25,1,3,0.333,4,4,1,3,4,7,2,0,0,1,1,9,8.2
JaMychal Green,26-221,F,1/28/17,MEM,UTA,1,26,3,7,0.429,2,4,0.5,1,3,0.333,2,2,1,3,1,4,2,0,0,0,1,9,8.7
Willie Reed,26-311,F-C,3/23/17,MIA,TOR,0,18,4,6,0.667,4,6,0.667,0,0,,1,2,0.5,0,1,1,1,1,1,1,4,9,6.1
Paul George,26-298,F,2/24/17,IND,MEM,1,34,3,12,0.25,2,7,0.286,1,5,0.2,2,2,1,1,8,9,4,1,0,4,2,9,3.9
Wesley Matthews,30-083,G,1/5/17,DAL,PHO,1,36,3,12,0.25,2,4,0.5,1,8,0.125,2,2,1,0,2,2,2,1,2,2,2,9,3.4
Sean Kilpatrick,27-081,G,3/28/17,BRK,PHI,0,12,4,7,0.571,3,4,0.75,1,3,0.333,0,0,,0,0,0,0,0,0,0,1,9,5.3
Marvin Williams,30-285,F,3/31/17,CHO,DEN,1,30,3,7,0.429,0,2,0,3,5,0.6,0,0,,1,7,8,1,4,3,0,2,9,14.1
Josh Richardson,23-194,G,3/28/17,MIA,DET,1,33,3,11,0.273,2,6,0.333,1,5,0.2,2,2,1,1,4,5,4,1,1,1,4,9,6.3
Brandon Ingram,19-132,F,1/12/17,LAL,SAS,0,32,3,7,0.429,2,4,0.5,1,3,0.333,2,4,0.5,0,2,2,1,0,1,1,2,9,4.7
Thaddeus Young,28-295,F,4/12/17,IND,ATL,1,36,4,8,0.5,4,8,0.5,0,0,,1,2,0.5,4,4,8,1,2,0,2,0,9,9.3
Alexis Ajinca,28-306,C,3/8/17,NOP,TOR,0,9,4,4,1,4,4,1,0,0,,1,1,1,1,1,2,0,0,0,0,2,9,8
Wayne Ellington,29-165,G,4/12/17,MIA,WAS,0,31,3,10,0.3,0,1,0,3,9,0.333,0,0,,0,7,7,1,0,0,0,0,9,6
D.J. Augustin,29-126,G,3/16/17,ORL,GSW,0,20,2,9,0.222,2,5,0.4,0,4,0,5,5,1,0,1,1,2,2,0,0,2,9,6.4
Lou Williams,30-128,G,3/4/17,HOU,MEM,0,21,3,8,0.375,2,2,1,1,6,0.167,2,2,1,0,1,1,2,1,1,1,4,9,5.4
Devin Booker,20-121,G,2/28/17,PHO,MEM,1,36,3,11,0.273,1,6,0.167,2,5,0.4,1,1,1,0,3,3,1,0,1,2,2,9,2
Justin Hamilton,26-217,C,11/4/16,BRK,CHO,0,20,4,7,0.571,3,3,1,1,4,0.25,0,0,,0,4,4,1,1,0,0,0,9,8.6
Zach Randolph,35-238,F,3/11/17,MEM,ATL,0,18,4,7,0.571,4,6,0.667,0,1,0,1,2,0.5,1,1,2,1,0,0,4,3,9,1.8
Bismack Biyombo,24-165,C-F,2/9/17,ORL,PHI,0,17,3,3,1,3,3,1,0,0,,3,4,0.75,1,7,8,2,0,2,1,0,9,12.3
Danny Green,29-193,G-F,1/1/17,SAS,ATL,1,31,3,8,0.375,0,0,,3,8,0.375,0,0,,0,6,6,2,0,0,0,4,9,6.2
Jerian Grant,24-085,G,1/2/17,CHI,CHO,0,27,4,10,0.4,3,8,0.375,1,2,0.5,0,0,,1,2,3,6,4,0,1,3,9,10.9
Chris Paul,31-194,G,11/16/16,LAC,MEM,1,34,3,11,0.273,2,7,0.286,1,4,0.25,2,4,0.5,0,2,2,6,5,0,2,4,9,7.9
Luol Deng,31-255,F,12/27/16,LAL,UTA,1,33,4,10,0.4,3,7,0.429,1,3,0.333,0,0,,1,8,9,2,1,1,1,2,9,8
Kris Dunn,23-010,G,3/28/17,MIN,IND,0,26,3,3,1,3,3,1,0,0,,3,4,0.75,0,2,2,1,4,3,1,2,9,13.3
Michael Carter-Williams,25-165,G,3/24/17,CHI,PHI,0,23,3,7,0.429,2,4,0.5,1,3,0.333,2,2,1,0,1,1,1,0,2,2,5,9,3.7
Marcus Smart,22-328,G,1/28/17,BOS,MIL,0,35,2,6,0.333,2,5,0.4,0,1,0,5,7,0.714,0,4,4,5,0,1,4,1,9,5.8
Jordan Clarkson,24-217,G,1/10/17,LAL,POR,0,23,3,9,0.333,1,4,0.25,2,5,0.4,1,1,1,0,1,1,1,2,0,0,2,9,6.1
Alexis Ajinca,28-213,C,12/5/16,NOP,MEM,0,21,4,6,0.667,4,5,0.8,0,1,0,1,1,1,1,5,6,0,0,2,0,3,9,8.8
Jake Layman,22-247,F,11/9/16,POR,LAC,0,16,4,8,0.5,3,3,1,1,5,0.2,0,0,,0,1,1,2,1,0,1,2,9,5.9
Anthony Morrow,31-091,G,12/27/16,OKC,MIA,1,20,3,7,0.429,2,2,1,1,5,0.2,2,2,1,0,0,0,1,0,0,0,0,9,6
Reggie Bullock,25-311,G-F,1/21/17,DET,WAS,1,35,3,8,0.375,0,0,,3,8,0.375,0,0,,0,5,5,1,0,0,1,4,9,4.2
Nicolas Batum,27-329,F-G,11/7/16,CHO,IND,1,30,2,6,0.333,1,4,0.25,1,2,0.5,4,4,1,0,6,6,4,3,0,1,1,9,11.8
Chasson Randle,24-063,G,4/9/17,NYK,TOR,0,15,1,3,0.333,0,0,,1,3,0.333,6,6,1,0,2,2,2,0,0,3,2,9,5.5
Elfrid Payton,22-321,G,1/8/17,ORL,LAL,1,19,4,11,0.364,3,9,0.333,1,2,0.5,0,0,,3,3,6,4,1,0,3,1,9,6.3
Jusuf Nurkic,22-165,C,2/4/17,DEN,SAS,0,24,4,8,0.5,4,8,0.5,0,0,,1,4,0.25,5,3,8,2,1,1,0,3,9,10.1
Jameer Nelson,34-348,G,1/22/17,DEN,MIN,1,28,4,9,0.444,4,6,0.667,0,3,0,1,2,0.5,0,2,2,2,0,0,4,3,9,0.7
Randy Foye,33-111,G,1/13/17,BRK,TOR,0,23,3,7,0.429,0,3,0,3,4,0.75,0,0,,1,2,3,7,0,0,1,1,9,10.1
Marvin Williams,30-187,F,12/23/16,CHO,CHI,1,24,3,7,0.429,2,4,0.5,1,3,0.333,2,2,1,0,2,2,1,2,1,2,1,9,6.9
Monta Ellis,31-040,G,12/5/16,IND,GSW,1,28,3,5,0.6,3,5,0.6,0,0,,3,3,1,0,1,1,2,2,0,3,3,9,6.2
Tim Hardaway,24-300,G,1/10/17,ATL,BRK,0,22,3,9,0.333,2,6,0.333,1,3,0.333,2,4,0.5,0,2,2,4,1,2,0,1,9,8.5
Kentavious Caldwell-Pope,24-021,G,3/11/17,DET,NYK,1,29,3,8,0.375,3,4,0.75,0,4,0,3,3,1,1,2,3,3,3,0,1,2,9,9.2
Leandro Barbosa,34-065,G,2/1/17,PHO,LAC,0,20,3,9,0.333,3,9,0.333,0,0,,3,4,0.75,1,2,3,1,0,0,1,2,9,3.7
Jeff Withey,27-024,C,3/31/17,UTA,WAS,0,10,3,6,0.5,3,6,0.5,0,0,,3,4,0.75,3,1,4,0,0,1,0,1,9,8.3
Larry Nance Jr.,24-084,F,3/26/17,LAL,POR,0,29,4,7,0.571,4,5,0.8,0,2,0,1,5,0.2,0,7,7,1,0,0,0,2,9,6.1
Sam Dekker,22-235,F,12/27/16,HOU,DAL,0,27,4,7,0.571,3,4,0.75,1,3,0.333,0,0,,3,8,11,3,3,0,1,1,9,13.9
Nicolas Batum,27-317,F-G,10/26/16,CHO,MIL,1,34,2,9,0.222,1,2,0.5,1,7,0.143,4,5,0.8,0,6,6,7,2,0,1,2,9,10
Victor Oladipo,24-194,G,11/14/16,OKC,DET,1,23,4,17,0.235,3,10,0.3,1,7,0.143,0,1,0,1,1,2,1,0,1,0,1,9,0.3
Victor Oladipo,24-318,G,3/18/17,OKC,SAC,1,31,4,15,0.267,3,10,0.3,1,5,0.2,0,0,,0,4,4,1,0,0,2,3,9,-1.2
Ty Lawson,28-358,G,10/26/16,SAC,PHO,1,36,3,9,0.333,2,5,0.4,1,4,0.25,2,2,1,3,3,6,7,2,1,2,2,9,11.7
Evan Turner,28-037,G,12/3/16,POR,MIA,0,28,3,10,0.3,3,8,0.375,0,2,0,3,5,0.6,1,5,6,6,3,1,0,1,9,12.1
Jameer Nelson,34-305,G,12/10/16,DEN,ORL,0,26,4,9,0.444,3,7,0.429,1,2,0.5,0,0,,0,2,2,3,0,0,1,1,9,5.6
Tobias Harris,24-206,F,2/6/17,DET,PHI,0,27,3,10,0.3,3,9,0.333,0,1,0,3,3,1,2,6,8,1,0,0,3,2,9,3.3
Marreese Speights,29-173,C-F,1/24/17,LAC,PHI,0,13,3,6,0.5,0,1,0,3,5,0.6,0,0,,0,1,1,0,0,0,2,2,9,3.5
Cory Joseph,25-087,G,11/15/16,TOR,CLE,0,18,4,7,0.571,4,6,0.667,0,1,0,1,2,0.5,0,1,1,2,0,0,0,1,9,6.6
Ish Smith,28-200,G,1/21/17,DET,WAS,0,16,4,8,0.5,4,8,0.5,0,0,,1,2,0.5,0,2,2,4,1,0,2,0,9,7
Montrezl Harrell,22-346,F-C,1/6/17,HOU,ORL,1,22,3,6,0.5,3,6,0.5,0,0,,3,6,0.5,1,3,4,1,1,1,2,2,9,6
Hassan Whiteside,27-171,C,12/1/16,MIA,UTA,1,36,4,11,0.364,4,11,0.364,0,0,,1,2,0.5,2,8,10,0,1,0,0,1,9,6.9
Kevin Love,28-201,F,3/27/17,CLE,SAS,1,27,4,12,0.333,3,6,0.5,1,6,0.167,0,0,,2,5,7,4,2,0,2,2,9,7.1
Justin Anderson,23-000,G,11/19/16,DAL,ORL,0,23,3,8,0.375,2,5,0.4,1,3,0.333,2,3,0.667,0,0,0,0,1,1,1,3,9,3.7
Wilson Chandler,29-336,F,4/11/17,DEN,DAL,1,15,3,6,0.5,2,4,0.5,1,2,0.5,2,4,0.5,1,4,5,0,0,0,0,0,9,7.1
Jordan Clarkson,24-150,G,11/4/16,LAL,GSW,0,29,4,13,0.308,3,10,0.3,1,3,0.333,0,0,,0,1,1,5,2,0,1,1,9,5.9
Tyler Ulis,21-075,G,3/21/17,PHO,MIA,1,42,4,11,0.364,4,10,0.4,0,1,0,1,3,0.333,0,3,3,6,1,0,5,2,9,2.4
T.J. McConnell,24-305,G,1/24/17,PHI,LAC,1,28,4,9,0.444,4,8,0.5,0,1,0,1,1,1,0,0,0,10,0,0,1,0,9,10.3
James Jones,36-052,F-G,11/25/16,CLE,DAL,0,6,3,3,1,0,0,,3,3,1,0,0,,0,0,0,0,0,0,0,0,9,8.1
Pascal Siakam,22-282,F,11/12/16,TOR,NYK,1,20,4,5,0.8,4,5,0.8,0,0,,1,1,1,0,2,2,0,1,0,1,2,9,6.9
Sergio Rodriguez,30-189,G,12/18/16,PHI,BRK,1,23,3,11,0.273,0,6,0,3,5,0.6,0,0,,1,1,2,5,1,0,2,3,9,4.8
Marcus Morris,27-130,F,1/10/17,DET,SAC,1,31,4,11,0.364,3,7,0.429,1,4,0.25,0,0,,1,2,3,1,2,0,2,5,9,2.9
Mason Plumlee,27-019,C-F,3/24/17,DEN,IND,0,16,2,4,0.5,2,4,0.5,0,0,,5,6,0.833,0,2,2,1,2,0,1,3,9,7.7
Jerami Grant,22-259,F,11/26/16,OKC,DET,0,26,4,8,0.5,3,5,0.6,1,3,0.333,0,0,,1,2,3,0,0,1,1,2,9,5.2
Ish Smith,28-120,G,11/2/16,DET,BRK,1,31,3,9,0.333,2,8,0.25,1,1,1,2,2,1,0,2,2,7,1,0,3,1,9,7
Gerald Henderson,29-093,G,3/12/17,PHI,LAL,1,25,3,7,0.429,2,5,0.4,1,2,0.5,2,3,0.667,0,2,2,1,0,1,1,4,9,4.3
Kyle Anderson,23-199,F-G,4/7/17,SAS,DAL,1,38,4,10,0.4,4,9,0.444,0,1,0,1,4,0.25,2,8,10,5,3,2,0,3,9,12.9
C.J. Watson,32-285,G,1/27/17,ORL,BOS,1,32,3,7,0.429,2,4,0.5,1,3,0.333,2,2,1,0,1,1,4,1,0,1,1,9,8
Monta Ellis,31-023,G,11/18/16,IND,PHO,1,34,2,10,0.2,2,9,0.222,0,1,0,5,5,1,1,2,3,4,2,1,2,2,9,6.8
Draymond Green,27-012,F,3/16/17,GSW,ORL,1,25,4,8,0.5,4,6,0.667,0,2,0,1,2,0.5,0,11,11,6,1,1,1,1,9,12.4
Thabo Sefolosha,32-299,G-F,2/25/17,ATL,ORL,0,19,4,9,0.444,3,6,0.5,1,3,0.333,0,0,,0,0,0,2,1,0,0,2,9,5.9
Andre Drummond,23-189,C,2/15/17,DET,DAL,1,19,4,8,0.5,4,8,0.5,0,0,,1,2,0.5,4,7,11,3,0,0,2,3,9,8.4
Shelvin Mack,26-249,G,12/27/16,UTA,LAL,1,33,4,8,0.5,4,5,0.8,0,3,0,1,3,0.333,0,1,1,3,0,0,4,1,9,2.2
Andre Iguodala,33-064,G-F,4/2/17,GSW,WAS,0,26,3,5,0.6,2,2,1,1,3,0.333,2,2,1,0,2,2,4,1,1,2,1,9,9.4
Terrence Jones,24-330,F,12/4/16,NOP,OKC,0,25,4,6,0.667,4,6,0.667,0,0,,1,2,0.5,1,6,7,0,0,1,2,2,9,6.4
Arron Afflalo,31-098,G,1/21/17,SAC,CHI,1,35,3,9,0.333,0,5,0,3,4,0.75,0,0,,1,0,1,4,1,1,0,4,9,7.5
Evan Fournier,24-093,G-F,1/30/17,ORL,MIN,0,23,4,11,0.364,3,7,0.429,1,4,0.25,0,0,,1,0,1,2,0,0,2,3,9,1.8
Andre Iguodala,32-348,G-F,1/10/17,GSW,MIA,0,29,4,6,0.667,3,4,0.75,1,2,0.5,0,0,,1,4,5,4,0,0,0,0,9,11.1
Denzel Valentine,23-047,G,1/2/17,CHI,CHO,0,18,3,6,0.5,0,1,0,3,5,0.6,0,0,,0,0,0,3,1,0,2,2,9,6.3
Jon Leuer,27-321,F,3/31/17,DET,MIL,1,31,3,9,0.333,3,9,0.333,0,0,,3,5,0.6,4,6,10,0,0,0,1,3,9,5.5
Rodney McGruder,25-125,G,12/1/16,MIA,UTA,1,36,2,4,0.5,1,2,0.5,1,2,0.5,4,4,1,1,4,5,2,0,1,0,2,9,10.2
Ben McLemore,24-055,G,4/7/17,SAC,LAL,0,26,3,6,0.5,1,2,0.5,2,4,0.5,1,1,1,0,3,3,2,0,0,3,3,9,4.1
Derrick Favors,25-233,F-C,3/5/17,UTA,SAC,1,26,4,5,0.8,4,5,0.8,0,0,,1,2,0.5,0,2,2,2,0,0,1,0,9,7.7
C.J. Watson,32-328,G,3/11/17,ORL,CLE,0,18,2,4,0.5,1,2,0.5,1,2,0.5,4,4,1,0,2,2,0,0,0,0,2,9,6.8
K.J. McDaniels,23-262,G-F,10/28/16,HOU,DAL,0,22,4,7,0.571,3,3,1,1,4,0.25,0,0,,1,1,2,0,2,0,2,1,9,6.3
Ramon Sessions,30-287,G,1/23/17,CHO,WAS,0,14,3,6,0.5,2,4,0.5,1,2,0.5,2,2,1,0,1,1,3,1,0,1,0,9,8.4
Sam Dekker,22-266,F,1/27/17,HOU,PHI,0,25,3,5,0.6,2,3,0.667,1,2,0.5,2,2,1,0,3,3,1,2,1,4,4,9,5.4
Aaron Gordon,21-056,F,11/11/16,ORL,UTA,0,25,4,9,0.444,4,8,0.5,0,1,0,1,2,0.5,1,6,7,1,2,2,0,1,9,10.1
Kentavious Caldwell-Pope,24-027,G,3/17/17,DET,TOR,1,36,4,13,0.308,3,4,0.75,1,9,0.111,0,0,,0,2,2,2,0,0,0,1,9,3.1
Cristiano Felicio,24-191,F-C,1/14/17,CHI,NOP,0,21,4,4,1,4,4,1,0,0,,1,2,0.5,3,4,7,0,0,0,0,3,9,9.5
Leandro Barbosa,34-061,G,1/28/17,PHO,DEN,0,16,4,6,0.667,3,5,0.6,1,1,1,0,0,,0,2,2,3,1,0,2,3,9,6.9
Michael Kidd-Gilchrist,23-124,F,1/28/17,CHO,SAC,1,19,3,5,0.6,3,5,0.6,0,0,,3,4,0.75,1,5,6,0,1,4,0,4,9,10.7
Austin Rivers,24-141,G,12/20/16,LAC,DEN,0,22,3,8,0.375,2,4,0.5,1,4,0.25,2,4,0.5,0,0,0,6,2,0,0,1,9,9.6
Ersan Ilyasova,29-299,F,3/10/17,ATL,TOR,0,25,3,7,0.429,1,3,0.333,2,4,0.5,1,2,0.5,0,6,6,2,0,0,1,5,9,5.1
Caris LeVert,22-167,G-F,2/8/17,BRK,WAS,0,26,2,6,0.333,1,3,0.333,1,3,0.333,4,6,0.667,1,4,5,0,2,1,1,1,9,8
Michael Kidd-Gilchrist,23-177,F,3/22/17,CHO,ORL,1,27,4,5,0.8,4,5,0.8,0,0,,1,1,1,2,2,4,0,2,1,0,0,9,11.8
Jamal Crawford,36-292,G,1/6/17,LAC,SAC,0,32,4,13,0.308,3,8,0.375,1,5,0.2,0,2,0,0,0,0,8,1,1,1,1,9,6.6
Marreese Speights,29-231,C-F,3/23/17,LAC,DAL,0,13,3,5,0.6,2,3,0.667,1,2,0.5,2,2,1,0,1,1,1,0,0,0,2,9,6.9
Myles Turner,20-235,F-C,11/14/16,IND,ORL,1,24,4,11,0.364,4,11,0.364,0,0,,1,1,1,0,7,7,0,0,0,2,3,9,1.8
Garrett Temple,30-176,G,10/31/16,SAC,ATL,0,25,4,8,0.5,3,6,0.5,1,2,0.5,0,0,,0,2,2,3,0,1,1,3,9,6.2
Tarik Black,25-007,C-F,11/29/16,LAL,NOP,0,24,4,6,0.667,4,6,0.667,0,0,,1,2,0.5,2,3,5,1,0,1,0,2,9,8.9
Cameron Payne,22-163,G,1/18/17,OKC,GSW,0,25,3,8,0.375,2,3,0.667,1,5,0.2,2,2,1,0,1,1,4,0,1,1,2,9,6.6
Marcus Smart,22-311,G,1/11/17,BOS,WAS,1,36,3,11,0.273,3,6,0.5,0,5,0,3,3,1,2,2,4,4,0,0,2,4,9,3.7
Bojan Bogdanovic,27-355,G-F,4/8/17,WAS,MIA,0,25,3,7,0.429,2,5,0.4,1,2,0.5,2,2,1,0,1,1,1,0,0,0,4,9,4.7
Jordan McRae,25-246,G,11/29/16,CLE,MIL,0,11,4,7,0.571,3,5,0.6,1,2,0.5,0,0,,2,1,3,0,0,0,0,1,9,7
Trey Lyles,21-030,F,12/5/16,UTA,LAL,0,25,4,10,0.4,3,7,0.429,1,3,0.333,0,0,,1,1,2,1,1,2,1,2,9,5.9
Caris LeVert,22-220,G-F,4/2/17,BRK,ATL,1,18,3,8,0.375,2,4,0.5,1,4,0.25,2,2,1,0,2,2,1,0,0,0,6,9,3.5
Ramon Sessions,30-236,G,12/3/16,CHO,MIN,0,16,2,5,0.4,2,3,0.667,0,2,0,5,6,0.833,0,0,0,2,1,0,2,1,9,5.9
Mirza Teletovic,31-049,F,11/6/16,MIL,DAL,0,23,3,9,0.333,0,2,0,3,7,0.429,0,0,,3,3,6,0,0,0,1,2,9,5.1
Tyler Ulis,21-054,G,2/28/17,PHO,MEM,0,17,3,6,0.5,2,5,0.4,1,1,1,2,2,1,0,0,0,7,1,0,0,3,9,10.7
Josh Richardson,23-192,G,3/26/17,MIA,BOS,1,37,3,10,0.3,2,7,0.286,1,3,0.333,2,2,1,0,1,1,5,2,2,2,2,9,7.6
Marc Gasol,31-348,C,1/11/17,MEM,OKC,1,36,4,12,0.333,4,10,0.4,0,2,0,1,3,0.333,1,6,7,7,2,3,0,3,9,11.7
Kyle Anderson,23-139,F-G,2/6/17,SAS,MEM,0,22,4,8,0.5,4,8,0.5,0,0,,1,4,0.25,2,3,5,0,1,0,1,0,9,6.1
Mindaugas Kuzminskas,27-105,F,2/1/17,NYK,BRK,0,17,4,10,0.4,3,8,0.375,1,2,0.5,0,0,,3,2,5,2,2,1,2,1,9,8
Aaron Brooks,31-303,G,11/12/16,IND,BOS,0,15,3,8,0.375,1,3,0.333,2,5,0.4,1,2,0.5,0,1,1,2,0,0,1,3,9,3.7
JaVale McGee,28-321,C,12/5/16,GSW,IND,0,15,4,8,0.5,4,7,0.571,0,1,0,1,2,0.5,5,3,8,1,0,2,0,1,9,10.7
C.J. Miles,29-331,G-F,3/15/17,IND,CHO,1,18,3,6,0.5,2,2,1,1,4,0.25,2,2,1,0,1,1,0,0,0,0,1,9,5.9
Andrew Harrison,22-136,G,3/13/17,MEM,MIL,0,21,2,6,0.333,1,5,0.2,1,1,1,4,5,0.8,0,1,1,5,0,0,1,4,9,6.4
Andre Roberson,24-329,G-F,10/28/16,OKC,PHO,1,40,3,4,0.75,2,3,0.667,1,1,1,2,2,1,0,11,11,0,5,1,1,5,9,13.4
Emmanuel Mudiay,21-033,G,4/7/17,DEN,NOP,0,18,3,5,0.6,1,2,0.5,2,3,0.667,1,2,0.5,1,1,2,4,1,0,1,2,9,9.3
Timofey Mozgov,30-164,C,12/27/16,LAL,UTA,1,26,3,8,0.375,3,8,0.375,0,0,,3,4,0.75,4,0,4,1,2,1,0,3,9,9.2
Tony Allen,34-322,G-F,11/28/16,MEM,CHO,1,21,4,8,0.5,4,8,0.5,0,0,,1,1,1,2,2,4,0,2,1,2,1,9,7.3
P.J. Tucker,31-220,F,12/11/16,PHO,NOP,1,42,3,11,0.273,0,5,0,3,6,0.5,0,0,,2,8,10,3,1,2,0,4,9,9.2
Kay Felder,21-304,G,1/27/17,CLE,BRK,0,17,4,7,0.571,3,5,0.6,1,2,0.5,0,0,,1,1,2,1,0,1,1,1,9,6.7
Jae Crowder,26-188,F,1/10/17,BOS,TOR,1,38,4,10,0.4,3,5,0.6,1,5,0.2,0,0,,0,2,2,1,1,0,2,1,9,3.5
David West,36-203,F,3/20/17,GSW,OKC,0,16,4,7,0.571,4,7,0.571,0,0,,1,2,0.5,0,6,6,1,1,2,1,2,9,8.4
Will Barton,26-028,G,2/3/17,DEN,MIL,0,25,3,10,0.3,2,6,0.333,1,4,0.25,2,4,0.5,0,2,2,4,2,0,3,0,9,4.8
Doug McDermott,25-058,F,3/2/17,OKC,POR,0,37,4,12,0.333,3,6,0.5,1,6,0.167,0,0,,1,3,4,1,0,0,0,3,9,3.3
David West,36-103,F,12/10/16,GSW,MEM,0,15,3,3,1,1,1,1,2,2,1,1,2,0.5,0,3,3,4,1,2,3,3,9,9.6
Julius Randle,21-338,F,11/1/16,LAL,IND,1,20,3,6,0.5,3,5,0.6,0,1,0,3,3,1,0,10,10,0,1,0,3,6,9,4.6
Gorgui Dieng,26-306,C,11/19/16,MIN,MEM,1,36,3,7,0.429,3,7,0.429,0,0,,3,6,0.5,2,9,11,1,0,1,2,3,9,6.4
Mirza Teletovic,31-074,F,12/1/16,MIL,BRK,0,19,3,8,0.375,0,0,,3,8,0.375,0,0,,0,7,7,0,0,0,2,1,9,4.3
Draymond Green,27-022,F,3/26/17,GSW,MEM,1,35,3,8,0.375,2,6,0.333,1,2,0.5,2,4,0.5,1,5,6,4,2,1,3,4,9,6.9
Langston Galloway,24-350,G,11/23/16,NOP,MIN,0,25,3,6,0.5,0,1,0,3,5,0.6,0,0,,1,3,4,2,2,0,1,3,9,8.8
Maurice Harkless,23-239,F-G,1/5/17,POR,LAL,1,29,4,6,0.667,3,4,0.75,1,2,0.5,0,0,,0,6,6,2,1,3,3,2,9,8.9
Sam Dekker,22-218,F,12/10/16,HOU,DAL,0,23,4,7,0.571,3,6,0.5,1,1,1,0,0,,1,3,4,2,0,0,3,2,9,4.9
Richaun Holmes,23-102,F-C,1/25/17,PHI,MIL,0,20,3,4,0.75,3,3,1,0,1,0,3,3,1,2,6,8,1,1,0,4,3,9,7.1
Shelvin Mack,26-221,G,11/29/16,UTA,HOU,0,20,4,5,0.8,3,3,1,1,2,0.5,0,0,,0,0,0,2,1,0,0,0,9,9.5
Terrence Jones,24-344,F,12/18/16,NOP,SAS,0,17,3,5,0.6,3,5,0.6,0,0,,3,6,0.5,1,1,2,0,1,2,0,2,9,8.1
Darrun Hilliard,23-237,G,12/6/16,DET,CHI,0,17,4,7,0.571,3,4,0.75,1,3,0.333,0,0,,0,0,0,0,2,0,0,2,9,6.9
Justin Hamilton,26-221,C,11/8/16,BRK,MIN,0,24,3,4,0.75,0,0,,3,4,0.75,0,0,,0,6,6,0,0,0,2,3,9,6
Courtney Lee,31-096,G,1/7/17,NYK,IND,1,28,3,9,0.333,2,6,0.333,1,3,0.333,2,2,1,0,4,4,1,2,0,1,1,9,6.4
Dewayne Dedmon,27-211,C,3/11/17,SAS,GSW,1,22,4,6,0.667,4,6,0.667,0,0,,1,1,1,1,6,7,0,0,2,3,2,9,6.5
Evan Fournier,24-109,G-F,2/15/17,ORL,SAS,1,34,3,11,0.273,2,6,0.333,1,5,0.2,2,3,0.667,0,5,5,5,1,0,4,4,9,2.5
Noah Vonleh,21-225,F,4/6/17,POR,MIN,1,23,2,3,0.667,2,3,0.667,0,0,,5,5,1,3,4,7,1,0,2,1,3,9,10.9
Justin Holiday,27-250,G,12/11/16,NYK,LAL,0,16,3,6,0.5,2,3,0.667,1,3,0.333,2,3,0.667,0,3,3,0,1,0,1,3,9,5.3
Andre Iguodala,32-274,G-F,10/28/16,GSW,NOP,0,30,4,7,0.571,3,4,0.75,1,3,0.333,0,0,,0,2,2,3,1,0,0,3,9,8.2
Jarell Martin,22-168,F,11/8/16,MEM,DEN,0,17,3,4,0.75,2,3,0.667,1,1,1,2,2,1,1,2,3,0,0,1,0,5,9,7.4
Tobias Harris,24-113,F,11/5/16,DET,DEN,1,34,4,11,0.364,4,8,0.5,0,3,0,1,1,1,0,4,4,0,0,2,3,2,9,1.7
Rodney Stuckey,30-325,G,3/12/17,IND,MIA,0,20,3,6,0.5,2,5,0.4,1,1,1,2,2,1,0,2,2,3,0,0,2,1,9,6.3
Jeff Teague,28-150,G,11/7/16,IND,CHO,1,19,3,8,0.375,2,5,0.4,1,3,0.333,2,2,1,1,0,1,6,0,1,4,1,9,5.8
Joel Embiid,22-273,C-F,12/14/16,PHI,TOR,1,27,3,6,0.5,3,4,0.75,0,2,0,3,5,0.6,1,5,6,5,1,2,4,5,9,7.3
Jason Smith,30-348,F-C,2/13/17,WAS,OKC,0,21,4,5,0.8,3,4,0.75,1,1,1,0,0,,3,3,6,1,0,1,3,3,9,7.3
Rudy Gobert,24-186,C,12/29/16,UTA,PHI,1,33,3,5,0.6,3,5,0.6,0,0,,3,11,0.273,2,11,13,2,2,2,1,1,9,11.6
Kyle Korver,36-021,G-F,4/7/17,CLE,ATL,0,25,2,6,0.333,0,0,,2,6,0.333,3,3,1,0,2,2,2,0,0,1,0,9,6.6
Victor Oladipo,24-182,G,11/2/16,OKC,LAC,1,33,3,11,0.273,2,6,0.333,1,5,0.2,2,3,0.667,0,5,5,1,0,0,0,2,9,3.5
Gerald Henderson,29-035,G,1/13/17,PHI,CHO,0,24,3,6,0.5,2,4,0.5,1,2,0.5,2,3,0.667,0,3,3,4,0,1,1,2,9,8.2
Thaddeus Young,28-169,F,12/7/16,IND,PHO,1,30,2,3,0.667,1,2,0.5,1,1,1,4,4,1,3,6,9,0,0,1,4,2,9,7.5
Trey Lyles,21-079,F,1/23/17,UTA,OKC,0,17,3,9,0.333,1,6,0.167,2,3,0.667,1,2,0.5,0,4,4,0,1,1,2,1,9,4
Justin Holiday,27-225,G,11/16/16,NYK,DET,0,24,3,7,0.429,2,4,0.5,1,3,0.333,2,2,1,2,3,5,0,0,1,0,1,9,7.9
Ed Davis,27-198,F,12/20/16,POR,SAC,0,19,4,4,1,4,4,1,0,0,,1,2,0.5,2,3,5,1,1,0,0,5,9,9.4
Willy Hernangomez,22-299,C,3/22/17,NYK,UTA,0,17,4,8,0.5,4,8,0.5,0,0,,1,2,0.5,4,7,11,1,2,0,2,3,9,9
Jared Dudley,31-112,F-G,10/30/16,PHO,GSW,1,27,3,7,0.429,1,3,0.333,2,4,0.5,1,2,0.5,1,1,2,3,3,1,2,4,9,8.1
Ricky Rubio,26-129,G,2/27/17,MIN,SAC,1,32,3,8,0.375,2,7,0.286,1,1,1,2,2,1,0,5,5,10,2,1,2,3,9,12.6
Otto Porter,23-171,F,11/21/16,WAS,PHO,1,23,3,7,0.429,3,4,0.75,0,3,0,3,4,0.75,2,7,9,2,2,0,1,1,9,10.4
Will Barton,26-059,G,3/6/17,DEN,SAC,0,27,3,9,0.333,1,3,0.333,2,6,0.333,1,2,0.5,1,1,2,2,1,0,1,4,9,4.3
Zach Randolph,35-203,F,2/4/17,MEM,MIN,1,31,3,15,0.2,3,12,0.25,0,3,0,3,5,0.6,4,6,10,2,1,1,1,6,9,3.2
Raymond Felton,32-221,G,2/2/17,LAC,GSW,1,33,3,6,0.5,3,5,0.6,0,1,0,3,4,0.75,1,3,4,5,1,1,2,2,9,9.6
Beno Udrih,34-192,G,1/13/17,DET,UTA,0,21,4,8,0.5,3,5,0.6,1,3,0.333,0,0,,0,1,1,7,0,0,3,1,9,6.8
Ramon Sessions,30-259,G,12/26/16,CHO,BRK,0,15,2,6,0.333,1,3,0.333,1,3,0.333,4,4,1,0,0,0,4,0,0,1,1,9,7
Kyle O'Quinn,26-286,F-C,1/6/17,NYK,MIL,0,26,4,9,0.444,4,9,0.444,0,0,,1,2,0.5,4,4,8,1,2,2,0,3,9,10.8
Luke Babbitt,27-279,F,3/26/17,MIA,BOS,1,19,3,8,0.375,0,1,0,3,7,0.429,0,0,,0,2,2,0,0,0,0,0,9,5.2
Nik Stauskas,23-173,G,3/29/17,PHI,ATL,0,36,3,10,0.3,1,4,0.25,2,6,0.333,1,2,0.5,1,4,5,7,3,0,2,2,9,9.8
Kyle Anderson,23-169,F-G,3/8/17,SAS,SAC,0,24,4,8,0.5,3,6,0.5,1,2,0.5,0,0,,1,3,4,4,3,1,0,1,9,12.7
Al-Farouq Aminu,26-172,F,3/12/17,POR,PHO,0,30,3,8,0.375,2,6,0.333,1,2,0.5,2,3,0.667,0,12,12,1,1,1,3,0,9,7.2
Austin Rivers,24-163,G,1/11/17,LAC,ORL,1,33,3,7,0.429,2,4,0.5,1,3,0.333,2,4,0.5,0,4,4,5,0,0,2,1,9,6.8
Caris LeVert,22-120,G-F,12/23/16,BRK,CLE,0,24,2,7,0.286,0,2,0,2,5,0.4,3,4,0.75,1,6,7,2,1,1,1,1,9,8.7
Taurean Waller-Prince,23-007,F,3/29/17,ATL,PHI,1,35,2,8,0.25,1,5,0.2,1,3,0.333,4,4,1,1,3,4,0,2,0,4,2,9,3
Anthony Tolliver,31-299,F-C,3/27/17,SAC,MEM,0,23,4,7,0.571,3,3,1,1,4,0.25,0,0,,1,4,5,2,0,1,1,2,9,7.9
P.J. Tucker,31-191,F,11/12/16,PHO,BRK,0,19,2,5,0.4,2,2,1,0,3,0,5,5,1,2,4,6,2,0,0,1,3,9,8.1
Nik Stauskas,23-155,G,3/11/17,PHI,LAC,0,28,3,10,0.3,1,4,0.25,2,6,0.333,1,3,0.333,0,3,3,3,1,0,1,4,9,3.8
C.J. Miles,29-357,G-F,4/10/17,IND,PHI,0,21,4,10,0.4,3,5,0.6,1,5,0.2,0,0,,0,4,4,0,0,0,1,1,9,3.4
Ian Clark,26-011,G,3/18/17,GSW,MIL,0,18,4,7,0.571,4,5,0.8,0,2,0,1,1,1,1,1,2,0,0,1,1,2,9,5.6
Frank Kaminsky,23-268,F-C,12/28/16,CHO,ORL,0,26,3,11,0.273,2,5,0.4,1,6,0.167,2,2,1,1,2,3,0,1,0,2,1,9,2.4
Aron Baynes,30-043,C,1/21/17,DET,WAS,0,16,3,4,0.75,3,4,0.75,0,0,,3,3,1,1,2,3,0,0,0,1,5,9,5.7
Frank Kaminsky,23-257,F-C,12/17/16,CHO,ATL,0,18,4,7,0.571,3,4,0.75,1,3,0.333,0,0,,0,2,2,4,1,0,1,2,9,8.3
Bobby Brown,32-172,G,3/15/17,HOU,LAL,0,6,3,4,0.75,0,0,,3,4,0.75,0,0,,0,0,0,1,0,0,0,1,9,7.7
Kelly Olynyk,25-341,C-F,3/26/17,BOS,MIA,0,14,4,7,0.571,3,6,0.5,1,1,1,0,0,,1,1,2,0,0,0,0,4,9,5.1
Anthony Tolliver,31-198,F-C,12/16/16,SAC,MEM,0,30,2,6,0.333,1,2,0.5,1,4,0.25,4,4,1,2,0,2,1,0,1,0,5,9,6.4
Joe Johnson,35-273,G-F,3/29/17,UTA,SAC,0,23,4,10,0.4,3,6,0.5,1,4,0.25,0,0,,0,3,3,3,2,1,1,1,9,7.9
Robert Covington,25-343,F,11/21/16,PHI,MIA,1,31,4,13,0.308,3,8,0.375,1,5,0.2,0,0,,5,4,9,1,3,0,1,5,9,6.9
Gerald Green,30-274,G-F,10/26/16,BOS,BRK,0,15,4,7,0.571,3,5,0.6,1,2,0.5,0,0,,1,4,5,2,0,0,1,1,9,7.6
Tyler Johnson,24-335,G,4/7/17,MIA,TOR,0,25,2,7,0.286,1,4,0.25,1,3,0.333,4,4,1,0,5,5,2,1,2,1,3,9,8
Wayne Ellington,29-086,G,1/23/17,MIA,GSW,0,33,3,12,0.25,1,4,0.25,2,8,0.25,1,1,1,0,2,2,3,4,0,1,2,9,6.7
DeAndre Liggins,28-317,G,2/11/17,CLE,DEN,1,22,3,4,0.75,2,2,1,1,2,0.5,2,2,1,0,5,5,5,3,1,0,0,9,16.1
Alec Burks,25-243,G,3/20/17,UTA,IND,0,16,2,4,0.5,2,4,0.5,0,0,,5,5,1,1,3,4,0,0,0,0,0,9,8.6
Dejounte Murray,20-095,G,12/23/16,SAS,POR,1,20,4,8,0.5,3,7,0.429,1,1,1,0,0,,1,2,3,1,1,0,3,1,9,4.6
Terry Rozier,23-007,G,3/24/17,BOS,PHO,0,15,4,7,0.571,3,3,1,1,4,0.25,0,0,,0,4,4,1,1,0,2,2,9,5.8
Ersan Ilyasova,29-315,F,3/26/17,ATL,BRK,1,32,3,14,0.214,3,9,0.333,0,5,0,3,4,0.75,7,11,18,1,0,0,2,3,9,5.7
Meyers Leonard,25-036,C-F,4/4/17,POR,UTA,0,24,4,6,0.667,3,3,1,1,3,0.333,0,0,,1,2,3,1,1,0,0,1,9,9
Brandon Bass,31-273,F,1/28/17,LAC,GSW,0,15,4,6,0.667,4,6,0.667,0,0,,1,2,0.5,2,3,5,2,0,0,1,0,9,8.7
Nik Stauskas,23-083,G,12/29/16,PHI,UTA,1,34,3,9,0.333,2,5,0.4,1,4,0.25,2,2,1,0,5,5,3,3,0,4,3,9,5.3
Dion Waiters,25-027,G,1/6/17,MIA,LAL,0,21,4,12,0.333,4,9,0.444,0,3,0,1,1,1,0,1,1,2,2,0,0,3,9,4.7
Tony Snell,25-035,G-F,12/15/16,MIL,CHI,1,31,4,10,0.4,3,8,0.375,1,2,0.5,0,0,,0,4,4,1,0,0,0,2,9,4.7
Tony Allen,34-330,G-F,12/6/16,MEM,PHI,1,27,4,7,0.571,4,7,0.571,0,0,,1,2,0.5,0,4,4,2,2,0,2,2,9,7.1
Marreese Speights,29-092,C-F,11/4/16,LAC,MEM,0,12,3,6,0.5,1,2,0.5,2,4,0.5,1,2,0.5,1,1,2,1,0,0,0,4,9,5.7
Jamal Crawford,37-006,G,3/26/17,LAC,SAC,0,28,2,12,0.167,1,7,0.143,1,5,0.2,4,5,0.8,0,1,1,2,0,0,0,1,9,2.3
Wesley Matthews,30-066,G,12/19/16,DAL,DEN,1,36,3,11,0.273,1,5,0.2,2,6,0.333,1,1,1,0,0,0,5,1,0,2,1,9,4.6
Jameer Nelson,34-357,G,1/31/17,DEN,LAL,1,37,4,15,0.267,3,13,0.231,1,2,0.5,0,0,,1,4,5,7,0,1,0,3,9,6.4
Ish Smith,28-127,G,11/9/16,DET,PHO,1,32,3,13,0.231,3,12,0.25,0,1,0,3,4,0.75,1,2,3,7,4,2,2,2,9,9.5
T.J. McConnell,25-012,G,4/6/17,PHI,CHI,1,33,4,12,0.333,4,9,0.444,0,3,0,1,1,1,2,4,6,8,3,0,5,1,9,8
Ian Mahinmi,30-125,C,3/10/17,WAS,SAC,0,22,4,5,0.8,4,5,0.8,0,0,,1,2,0.5,3,4,7,1,0,2,3,5,9,7.1
Patty Mills,28-228,G,3/27/17,SAS,CLE,0,18,4,6,0.667,3,3,1,1,3,0.333,0,0,,0,2,2,7,1,0,0,3,9,11.7
Nene Hilario,34-085,F-C,12/7/16,HOU,LAL,0,19,3,4,0.75,3,4,0.75,0,0,,3,6,0.5,3,5,8,2,1,0,0,3,9,11
Patrick Beverley,28-261,G,3/30/17,HOU,POR,1,33,2,6,0.333,2,3,0.667,0,3,0,5,5,1,3,5,8,3,0,0,2,5,9,7.3
DeMarre Carroll,30-215,F,2/27/17,TOR,NYK,1,30,3,8,0.375,2,4,0.5,1,4,0.25,2,2,1,1,4,5,2,0,0,2,3,9,4.7
Wesley Matthews,30-147,G,3/10/17,DAL,BRK,1,33,2,11,0.182,1,5,0.2,1,6,0.167,4,4,1,0,7,7,3,2,0,3,3,9,4.1
Amir Johnson,29-320,F,3/17/17,BOS,BRK,1,23,3,5,0.6,3,3,1,0,2,0,3,4,0.75,0,2,2,2,1,0,1,4,9,6.7
Arron Afflalo,31-108,G,1/31/17,SAC,HOU,1,27,3,9,0.333,2,5,0.4,1,4,0.25,2,3,0.667,0,1,1,1,0,1,1,1,9,3.8
Willie Cauley-Stein,23-176,F-C,2/10/17,SAC,ATL,0,16,4,6,0.667,4,6,0.667,0,0,,1,2,0.5,0,4,4,3,0,0,0,3,9,8.1
E'Twaun Moore,27-304,G,12/28/16,NOP,LAC,0,20,4,7,0.571,3,4,0.75,1,3,0.333,0,0,,0,3,3,1,0,2,0,0,9,8.7
Rodney Stuckey,30-232,G,12/9/16,IND,DAL,0,27,2,3,0.667,1,1,1,1,2,0.5,4,4,1,0,5,5,8,0,0,1,2,9,13
Mario Hezonja,22-042,F-G,4/8/17,ORL,IND,0,17,4,7,0.571,3,4,0.75,1,3,0.333,0,0,,0,1,1,1,0,0,0,2,9,5.9
Patrick Beverley,28-132,G,11/21/16,HOU,DET,1,23,4,7,0.571,3,5,0.6,1,2,0.5,0,0,,1,0,1,1,1,0,1,3,9,5.9
Tony Allen,34-342,G-F,12/18/16,MEM,UTA,1,34,4,7,0.571,4,7,0.571,0,0,,1,1,1,4,4,8,1,2,0,0,2,9,11.6
Tarik Black,25-107,C-F,3/9/17,LAL,PHO,1,14,3,3,1,3,3,1,0,0,,3,4,0.75,4,2,6,0,1,0,1,0,9,11.1
Ian Clark,25-283,G,12/15/16,GSW,NYK,0,11,4,7,0.571,3,6,0.5,1,1,1,0,0,,0,0,0,2,1,0,2,1,9,5.7
Joe Ingles,29-192,F-G,4/12/17,UTA,SAS,1,28,3,7,0.429,0,1,0,3,6,0.5,0,0,,0,2,2,3,1,0,3,3,9,4.8
Julius Randle,22-054,F,1/22/17,LAL,DAL,1,23,4,4,1,4,4,1,0,0,,1,2,0.5,0,6,6,4,1,0,3,3,9,8.8
JaMychal Green,26-250,F,2/26/17,MEM,DEN,1,28,1,3,0.333,0,0,,1,3,0.333,6,6,1,2,8,10,0,1,0,2,5,9,8.1
Rudy Gobert,24-214,C,1/26/17,UTA,LAL,1,38,3,6,0.5,3,6,0.5,0,0,,3,4,0.75,3,10,13,0,0,6,0,1,9,14.5
Shabazz Muhammad,24-149,F-G,4/11/17,MIN,OKC,0,15,3,6,0.5,3,4,0.75,0,2,0,3,4,0.75,0,1,1,1,0,1,1,1,9,5.9
Bismack Biyombo,24-126,C-F,1/1/17,ORL,IND,1,23,4,6,0.667,4,6,0.667,0,0,,1,1,1,2,4,6,1,0,0,1,3,9,7.5
C.J. Watson,32-330,G,3/13/17,ORL,SAC,0,18,4,8,0.5,3,4,0.75,1,4,0.25,0,0,,0,1,1,1,1,0,1,2,9,5.2
Nemanja Bjelica,28-213,F,12/8/16,MIN,TOR,0,13,3,5,0.6,1,1,1,2,4,0.5,1,2,0.5,0,4,4,0,1,0,1,0,9,7.5
JaVale McGee,29-009,C,1/28/17,GSW,LAC,0,10,4,5,0.8,4,5,0.8,0,0,,1,1,1,2,1,3,0,0,2,1,2,9,8.4
Draymond Green,26-306,F,1/4/17,GSW,POR,1,30,3,6,0.5,1,2,0.5,2,4,0.5,1,3,0.333,1,6,7,11,3,1,2,5,9,15.1
Derrick Williams,25-216,F,12/27/16,MIA,OKC,1,15,4,4,1,3,3,1,1,1,1,0,0,,0,2,2,0,1,0,1,0,9,8.4
Timothe Luwawu-Cabarrot,21-271,F,2/4/17,PHI,MIA,0,26,3,8,0.375,2,4,0.5,1,4,0.25,2,3,0.667,1,0,1,0,1,1,0,2,9,5.8
Corey Brewer,30-241,F-G,11/1/16,HOU,CLE,0,21,4,7,0.571,4,6,0.667,0,1,0,1,2,0.5,1,2,3,2,1,0,0,1,9,8.6
Ryan Anderson,28-336,F,4/7/17,HOU,DET,1,13,3,6,0.5,0,1,0,3,5,0.6,0,0,,0,3,3,0,0,1,0,0,9,7.6
Willy Hernangomez,22-179,C,11/22/16,NYK,POR,0,21,4,5,0.8,4,5,0.8,0,0,,1,1,1,0,4,4,0,0,0,4,3,9,3.1
David Lee,33-223,F,12/8/16,SAS,CHI,0,21,4,6,0.667,4,6,0.667,0,0,,1,2,0.5,2,2,4,2,0,1,1,2,9,8.3
Tarik Black,25-076,C-F,2/6/17,LAL,NYK,1,20,4,8,0.5,4,8,0.5,0,0,,1,2,0.5,6,4,10,0,1,0,0,3,9,9.8
Khris Middleton,25-235,F-G,4/4/17,MIL,OKC,1,24,4,11,0.364,3,8,0.375,1,3,0.333,0,0,,0,2,2,2,1,0,1,1,9,4.5
Tyreke Evans,27-191,G-F,3/29/17,SAC,UTA,1,25,4,12,0.333,3,7,0.429,1,5,0.2,0,0,,1,2,3,1,2,0,2,3,9,3
Matt Barnes,36-280,F,12/14/16,SAC,HOU,0,21,3,5,0.6,0,1,0,3,4,0.75,0,0,,0,2,2,1,1,0,0,1,9,8.6
James Jones,36-064,F-G,12/7/16,CLE,NYK,0,8,3,3,1,0,0,,3,3,1,0,0,,0,0,0,0,1,0,0,1,9,8.7
T.J. McConnell,24-287,G,1/6/17,PHI,BOS,1,37,4,6,0.667,4,6,0.667,0,0,,1,2,0.5,0,4,4,17,1,0,2,2,9,17.3
Willy Hernangomez,22-194,C,12/7/16,NYK,CLE,0,15,2,5,0.4,1,4,0.25,1,1,1,4,4,1,4,3,7,0,1,0,0,0,9,11
Andrew Harrison,22-091,G,1/27/17,MEM,POR,0,16,3,4,0.75,2,2,1,1,2,0.5,2,3,0.667,0,0,0,1,0,0,0,3,9,6.5
Juan Hernangomez,21-056,F,11/23/16,DEN,UTA,1,28,2,5,0.4,1,2,0.5,1,3,0.333,4,8,0.5,1,5,6,0,3,2,1,1,9,9.9
Chris Paul,31-177,G,10/30/16,LAC,UTA,1,29,3,8,0.375,2,5,0.4,1,3,0.333,2,2,1,0,3,3,9,3,0,3,1,9,11.4
Denzel Valentine,23-128,G,3/24/17,CHI,PHI,0,30,3,8,0.375,0,0,,3,8,0.375,0,0,,1,3,4,1,1,0,0,2,9,7.1
Cory Joseph,25-209,G,3/17/17,TOR,DET,1,36,3,10,0.3,2,5,0.4,1,5,0.2,2,2,1,0,7,7,6,0,1,3,4,9,5.6
JaMychal Green,26-188,F,12/26/16,MEM,ORL,1,30,3,6,0.5,1,1,1,2,5,0.4,1,2,0.5,0,2,2,1,0,2,2,3,9,5.1
Lance Thomas,28-260,F,1/9/17,NYK,NOP,0,19,2,5,0.4,0,3,0,2,2,1,3,4,0.75,1,0,1,0,0,0,0,3,9,5.4
Doug McDermott,25-091,F,4/4/17,OKC,MIL,0,22,4,9,0.444,4,6,0.667,0,3,0,1,2,0.5,0,1,1,2,0,1,0,0,9,6.3
Nik Stauskas,23-175,G,3/31/17,PHI,CLE,0,28,4,10,0.4,3,5,0.6,1,5,0.2,0,0,,0,4,4,6,1,0,2,3,9,6.8
Ricky Rubio,26-151,G,3/21/17,MIN,SAS,1,30,3,10,0.3,2,8,0.25,1,2,0.5,2,2,1,1,5,6,7,2,0,4,2,9,7.5
Mike Dunleavy,36-188,F-G,3/22/17,ATL,WAS,0,15,3,7,0.429,1,4,0.25,2,3,0.667,1,1,1,0,1,1,1,1,0,0,1,9,6.9
DeMarre Carroll,30-194,F,2/6/17,TOR,LAC,1,23,3,6,0.5,2,3,0.667,1,3,0.333,2,2,1,2,3,5,2,0,0,1,2,9,7.9
Tyson Chandler,34-078,C,12/19/16,PHO,MIN,1,32,2,2,1,2,2,1,0,0,,5,8,0.625,1,11,12,0,0,0,4,3,9,6
Brandon Ingram,19-103,F,12/14/16,LAL,BRK,0,26,3,9,0.333,3,7,0.429,0,2,0,3,6,0.5,0,1,1,1,0,0,0,0,9,3.7
Anthony Morrow,31-077,G,12/13/16,OKC,POR,0,20,4,11,0.364,3,6,0.5,1,5,0.2,0,0,,1,1,2,1,1,0,0,2,9,4.8
Shawn Long,24-063,C-F,4/2/17,PHI,TOR,0,18,3,5,0.6,1,2,0.5,2,3,0.667,1,2,0.5,3,2,5,1,1,2,1,3,9,9.9
Aaron Gordon,21-098,F,12/23/16,ORL,LAL,1,24,3,10,0.3,2,8,0.25,1,2,0.5,2,2,1,2,5,7,0,1,1,1,1,9,6.4
C.J. Watson,32-352,G,4/4/17,ORL,CLE,0,25,3,6,0.5,2,3,0.667,1,3,0.333,2,2,1,2,1,3,6,0,0,2,4,9,8.3
Dirk Nowitzki,38-136,F,11/2/16,DAL,UTA,1,29,4,14,0.286,4,9,0.444,0,5,0,1,1,1,1,4,5,0,1,0,1,3,9,1.5
Mason Plumlee,26-262,C-F,11/22/16,POR,NYK,1,28,4,5,0.8,4,5,0.8,0,0,,1,3,0.333,4,5,9,4,0,1,4,1,9,9.7
Justin Hamilton,26-228,C,11/15/16,BRK,LAL,0,24,3,6,0.5,2,2,1,1,4,0.25,2,2,1,0,6,6,0,1,0,1,1,9,7.4
Timothe Luwawu-Cabarrot,21-306,F,3/11/17,PHI,LAC,1,33,3,8,0.375,2,3,0.667,1,5,0.2,2,2,1,1,4,5,1,1,0,1,2,9,6.4
Derrick Jones,20-049,F,4/5/17,PHO,GSW,0,21,4,8,0.5,4,6,0.667,0,2,0,1,2,0.5,3,2,5,0,0,0,0,0,9,7.3
Danny Green,29-147,G-F,11/16/16,SAS,SAC,1,28,3,7,0.429,0,0,,3,7,0.429,0,0,,1,3,4,3,1,0,0,2,9,9.2
Marcus Smart,23-016,G,3/22/17,BOS,IND,0,23,3,7,0.429,1,3,0.333,2,4,0.5,1,1,1,0,2,2,1,1,0,3,3,9,3.4
Jerami Grant,22-288,F,12/25/16,OKC,MIN,0,28,3,5,0.6,2,3,0.667,1,2,0.5,2,2,1,0,4,4,1,1,1,1,2,9,8.5
Jodie Meeks,29-124,G,12/23/16,ORL,LAL,1,27,3,11,0.273,2,5,0.4,1,6,0.167,2,2,1,0,5,5,1,2,0,0,2,9,5.9
Kay Felder,21-281,G,1/4/17,CLE,CHI,0,16,3,11,0.273,3,9,0.333,0,2,0,3,3,1,0,5,5,1,0,0,0,2,9,3.9
Wilson Chandler,29-174,F,10/31/16,DEN,TOR,0,31,2,7,0.286,1,2,0.5,1,5,0.2,4,6,0.667,0,3,3,1,0,1,0,4,9,4.8
Pascal Siakam,22-320,F,12/20/16,TOR,BRK,1,28,3,3,1,3,3,1,0,0,,3,4,0.75,0,3,3,2,0,2,3,3,9,7.2
Glenn Robinson,22-359,G-F,1/1/17,IND,ORL,1,32,2,6,0.333,1,3,0.333,1,3,0.333,4,4,1,0,8,8,1,0,0,1,0,9,7.7
Jonathon Simmons,27-203,G-F,4/5/17,SAS,LAL,1,32,3,8,0.375,0,3,0,3,5,0.6,0,0,,0,1,1,4,1,0,3,1,9,5.3
Danny Green,29-169,G-F,12/8/16,SAS,CHI,1,26,3,8,0.375,0,0,,3,8,0.375,0,0,,0,1,1,1,3,0,1,3,9,6.4
Corey Brewer,30-312,F-G,1/11/17,HOU,MIN,0,27,4,9,0.444,3,7,0.429,1,2,0.5,0,0,,1,1,2,1,1,1,3,4,9,3.1
Taurean Waller-Prince,22-248,F,11/25/16,ATL,UTA,0,19,3,6,0.5,0,1,0,3,5,0.6,0,0,,0,4,4,3,0,0,1,3,9,7.1
P.J. Tucker,31-303,F,3/4/17,TOR,MIL,0,29,3,10,0.3,1,5,0.2,2,5,0.4,1,2,0.5,0,4,4,1,1,0,0,2,9,4.9
Troy Daniels,25-172,G,1/3/17,MEM,LAL,0,19,3,7,0.429,0,0,,3,7,0.429,0,0,,0,2,2,1,1,0,0,0,9,7.6
Raymond Felton,32-230,G,2/11/17,LAC,CHO,0,28,4,7,0.571,3,4,0.75,1,3,0.333,0,0,,0,7,7,5,0,1,1,0,9,11
Anthony Tolliver,31-256,F-C,2/12/17,SAC,NOP,0,24,3,9,0.333,0,2,0,3,7,0.429,0,0,,0,6,6,0,2,0,1,3,9,5.5
Monta Ellis,31-073,G,1/7/17,IND,NYK,0,21,2,5,0.4,1,3,0.333,1,2,0.5,4,4,1,0,2,2,2,0,0,2,0,9,6.3
DeAndre' Bembry,22-172,F,12/23/16,ATL,DEN,0,19,4,6,0.667,4,5,0.8,0,1,0,1,1,1,2,2,4,1,1,0,0,2,9,9.3
Lucas Nogueira,24-150,C,12/23/16,TOR,UTA,0,32,4,5,0.8,3,4,0.75,1,1,1,0,0,,2,4,6,1,2,1,1,2,9,11.3
Gerald Henderson,28-322,G,10/26/16,PHI,OKC,1,25,3,6,0.5,1,3,0.333,2,3,0.667,1,2,0.5,0,2,2,0,0,0,0,2,9,5.4
Bobby Portis,22-057,F,4/8/17,CHI,BRK,0,21,3,7,0.429,1,4,0.25,2,3,0.667,1,2,0.5,0,7,7,2,1,0,0,0,9,9.4
Jordan Clarkson,24-175,G,11/29/16,LAL,NOP,0,29,4,14,0.286,3,7,0.429,1,7,0.143,0,0,,0,3,3,2,1,0,2,1,9,1.7
A.J. Hammons,24-220,C,4/4/17,DAL,SAC,0,26,3,6,0.5,2,3,0.667,1,3,0.333,2,2,1,1,5,6,0,1,3,2,4,9,7.7
Lucas Nogueira,24-165,C,1/7/17,TOR,CHI,1,42,2,5,0.4,2,4,0.5,0,1,0,5,7,0.714,2,6,8,1,2,1,2,2,9,9.3
Reggie Jackson,26-303,G,2/13/17,DET,MIL,1,31,3,7,0.429,2,4,0.5,1,3,0.333,2,2,1,0,2,2,9,1,0,1,3,9,11
James Ennis,26-134,F,11/12/16,MEM,MIL,1,26,3,6,0.5,2,2,1,1,4,0.25,2,2,1,0,2,2,2,0,0,0,4,9,6.4
Patrick Beverley,28-271,G,4/9/17,HOU,SAC,1,29,4,6,0.667,3,4,0.75,1,2,0.5,0,3,0,0,3,3,4,1,0,1,4,9,7.3
Jerami Grant,22-253,F,11/20/16,OKC,IND,0,15,3,3,1,2,2,1,1,1,1,2,2,1,0,1,1,0,0,2,0,4,9,8.2
J.J. Barea,32-129,G,11/2/16,DAL,UTA,0,27,3,9,0.333,2,5,0.4,1,4,0.25,2,2,1,1,4,5,4,1,0,2,0,9,7.6
Dwight Powell,25-206,F-C,2/11/17,DAL,ORL,0,17,4,6,0.667,3,5,0.6,1,1,1,0,0,,2,1,3,2,1,0,0,1,9,10.1
Andrew Nicholson,26-333,F,11/5/16,WAS,ORL,0,10,4,10,0.4,4,9,0.444,0,1,0,1,1,1,3,1,4,0,1,0,1,2,9,5.2
Dahntay Jones,36-106,G-F,4/12/17,CLE,TOR,0,12,3,8,0.375,3,6,0.5,0,2,0,3,4,0.75,1,1,2,1,0,0,1,1,9,4.5
Alex Abrines,23-140,G-F,12/19/16,OKC,ATL,0,17,3,8,0.375,2,3,0.667,1,5,0.2,2,2,1,0,1,1,0,1,0,0,2,9,5.1
Justin Hamilton,27-003,C,4/4/17,BRK,PHI,0,12,3,6,0.5,2,4,0.5,1,2,0.5,2,2,1,0,0,0,2,0,0,0,2,9,6.6
Luis Scola,36-234,F,12/20/16,BRK,TOR,1,18,4,10,0.4,3,7,0.429,1,3,0.333,0,0,,4,1,5,0,0,0,1,2,9,4.9
Mason Plumlee,26-293,C-F,12/23/16,POR,SAS,1,15,4,6,0.667,4,6,0.667,0,0,,1,2,0.5,1,4,5,1,1,0,1,2,9,7.8
Matthew Dellavedova,26-156,G,2/11/17,MIL,IND,1,33,2,6,0.333,0,3,0,2,3,0.667,3,4,0.75,0,1,1,4,0,0,0,2,9,7.5
Pau Gasol,36-260,F-C,3/23/17,SAS,MEM,0,26,4,10,0.4,3,8,0.375,1,2,0.5,0,0,,1,3,4,0,1,1,2,2,9,4.1
Kentavious Caldwell-Pope,23-290,G,12/4/16,DET,ORL,1,34,4,12,0.333,3,6,0.5,1,6,0.167,0,0,,2,8,10,4,1,0,3,2,9,6
Brandon Ingram,19-112,F,12/23/16,LAL,ORL,1,23,3,9,0.333,3,7,0.429,0,2,0,3,3,1,1,2,3,2,0,0,1,4,9,4
Sam Dekker,22-244,F,1/5/17,HOU,OKC,0,16,3,4,0.75,2,2,1,1,2,0.5,2,2,1,1,1,2,1,1,0,0,1,9,9.7
Marquese Chriss,19-146,F,11/25/16,PHO,MIN,1,23,4,11,0.364,4,8,0.5,0,3,0,1,2,0.5,0,2,2,2,2,1,0,4,9,5.6
Otto Porter,23-198,F,12/18/16,WAS,LAC,1,33,3,7,0.429,3,5,0.6,0,2,0,3,4,0.75,2,2,4,2,3,0,0,1,9,10.9
Ramon Sessions,30-262,G,12/29/16,CHO,MIA,0,18,3,9,0.333,3,7,0.429,0,2,0,3,3,1,1,0,1,1,0,0,0,1,9,4.9
E'Twaun Moore,28-017,G,3/17/17,NOP,HOU,0,26,3,9,0.333,2,5,0.4,1,4,0.25,2,2,1,0,5,5,3,1,0,0,1,9,8.1
Taurean Waller-Prince,23-010,F,4/1/17,ATL,CHI,1,26,3,9,0.333,3,5,0.6,0,4,0,3,6,0.5,0,3,3,1,3,0,2,3,9,4.1
Justin Hamilton,26-304,C,1/30/17,BRK,MIA,0,17,4,5,0.8,3,3,1,1,2,0.5,0,0,,1,2,3,0,0,0,0,2,9,7.6
Andre Roberson,25-027,G-F,12/31/16,OKC,LAC,1,31,3,11,0.273,2,4,0.5,1,7,0.143,2,2,1,1,2,3,2,2,2,1,1,9,7.2
Andre Iguodala,32-298,G-F,11/21/16,GSW,IND,0,18,3,7,0.429,0,2,0,3,5,0.6,0,0,,0,0,0,4,1,0,0,2,9,8.3
Dario Saric,22-281,F,1/14/17,PHI,WAS,0,26,3,7,0.429,1,2,0.5,2,5,0.4,1,2,0.5,0,4,4,1,1,0,2,2,9,5
Bobby Portis,22-014,F,2/24/17,CHI,PHO,1,16,4,9,0.444,3,8,0.375,1,1,1,0,0,,2,5,7,1,0,0,0,2,9,7.1
Gerald Henderson,29-095,G,3/14/17,PHI,GSW,0,20,3,7,0.429,2,4,0.5,1,3,0.333,2,5,0.4,2,3,5,0,0,0,0,1,9,6
Brandon Jennings,27-191,G,4/2/17,WAS,GSW,0,23,3,8,0.375,2,5,0.4,1,3,0.333,2,2,1,1,6,7,3,0,0,1,4,9,6.6
Taj Gibson,31-134,F,11/5/16,CHI,IND,1,25,4,8,0.5,4,8,0.5,0,0,,1,1,1,5,5,10,1,1,2,2,1,9,10.7
Wesley Matthews,30-035,G,11/18/16,DAL,MEM,1,31,3,10,0.3,1,3,0.333,2,7,0.286,1,1,1,0,2,2,1,1,0,1,0,9,4.5
Brandan Wright,29-152,F-C,3/6/17,MEM,BRK,1,18,4,6,0.667,4,6,0.667,0,0,,1,1,1,0,4,4,1,0,0,0,3,9,7.1
Dario Saric,22-352,F,3/26/17,PHI,IND,1,28,3,15,0.2,2,9,0.222,1,6,0.167,2,2,1,1,9,10,1,0,0,4,3,9,-1.4
Jamal Murray,20-038,G,4/2/17,DEN,MIA,1,28,3,7,0.429,2,4,0.5,1,3,0.333,2,2,1,0,3,3,0,3,1,3,3,9,5.7
Domantas Sabonis,20-242,F,12/31/16,OKC,LAC,1,25,4,10,0.4,3,6,0.5,1,4,0.25,0,0,,2,2,4,2,0,2,1,0,9,7.4
Mike Miller,36-265,F-G,11/10/16,DEN,GSW,0,9,3,4,0.75,0,0,,3,4,0.75,0,0,,0,1,1,1,0,0,0,1,9,8
Andre Drummond,23-245,C,4/12/17,DET,ORL,1,25,4,9,0.444,4,9,0.444,0,0,,1,3,0.333,4,10,14,2,0,0,0,3,9,9.5
Marvin Williams,30-132,F,10/29/16,CHO,BOS,1,30,3,10,0.3,1,1,1,2,9,0.222,1,2,0.5,0,3,3,1,0,1,0,2,9,4.3
D'Angelo Russell,20-322,G,1/10/17,LAL,POR,1,30,4,14,0.286,4,7,0.571,0,7,0,1,4,0.25,0,8,8,6,3,1,2,3,9,6.7
Tony Snell,25-027,G-F,12/7/16,MIL,POR,1,29,2,5,0.4,0,0,,2,5,0.4,3,4,0.75,0,2,2,1,0,0,0,0,9,7.2
Timofey Mozgov,30-194,C,1/26/17,LAL,UTA,1,17,4,9,0.444,4,9,0.444,0,0,,1,2,0.5,2,7,9,1,1,1,1,2,9,8
Marreese Speights,29-163,C-F,1/14/17,LAC,LAL,0,15,3,4,0.75,1,1,1,2,3,0.667,1,1,1,0,2,2,0,0,1,0,5,9,6.7
Nik Stauskas,23-163,G,3/19/17,PHI,BOS,0,30,3,8,0.375,0,1,0,3,7,0.429,0,0,,0,6,6,4,1,2,3,2,9,7.8
Wilson Chandler,29-251,F,1/16/17,DEN,ORL,0,21,4,12,0.333,3,6,0.5,1,6,0.167,0,0,,3,5,8,3,1,0,2,4,9,5.3
Solomon Hill,25-262,F,12/5/16,NOP,MEM,1,47,2,6,0.333,2,4,0.5,0,2,0,5,5,1,2,5,7,5,1,0,3,3,9,8.8
Nikola Vucevic,26-074,C,1/6/17,ORL,HOU,0,28,4,15,0.267,3,14,0.214,1,1,1,0,0,,5,7,12,1,0,1,3,3,9,2.9
Troy Williams,21-331,F,11/25/16,MEM,MIA,0,20,4,8,0.5,3,7,0.429,1,1,1,0,2,0,1,5,6,0,1,1,1,2,9,6.3
Dragan Bender,19-136,F,4/2/17,PHO,HOU,0,14,4,9,0.444,3,6,0.5,1,3,0.333,0,2,0,3,4,7,0,0,1,1,3,9,5.3
Kevin Seraphin,27-071,F,2/16/17,IND,WAS,1,25,4,8,0.5,4,8,0.5,0,0,,1,2,0.5,2,3,5,1,0,0,2,2,9,4.8
Gerald Henderson,29-100,G,3/19/17,PHI,BOS,0,17,1,7,0.143,0,4,0,1,3,0.333,6,8,0.75,0,3,3,1,0,0,1,2,9,3.5
Langston Galloway,25-066,G,2/13/17,NOP,PHO,0,23,3,6,0.5,0,1,0,3,5,0.6,0,0,,0,2,2,0,0,1,1,0,9,6.3
Gorgui Dieng,26-302,C,11/15/16,MIN,CHO,1,33,3,6,0.5,3,5,0.6,0,1,0,3,3,1,3,8,11,3,0,1,5,2,9,7.5
Delon Wright,24-351,G,4/12/17,TOR,CLE,0,28,3,10,0.3,2,7,0.286,1,3,0.333,2,4,0.5,1,0,1,0,2,0,1,1,9,3.7
Shelvin Mack,26-203,G,11/11/16,UTA,ORL,0,26,3,9,0.333,2,6,0.333,1,3,0.333,2,2,1,1,5,6,2,2,0,3,3,9,5.3
Randy Foye,33-064,G,11/27/16,BRK,SAC,0,22,3,8,0.375,1,2,0.5,2,6,0.333,1,1,1,0,4,4,0,1,0,2,4,9,3.2
D'Angelo Russell,20-248,G,10/28/16,LAL,UTA,1,32,3,14,0.214,2,9,0.222,1,5,0.2,2,5,0.4,2,3,5,5,2,0,4,3,9,1.8
Bismack Biyombo,24-078,C-F,11/14/16,ORL,IND,0,21,4,4,1,4,4,1,0,0,,1,2,0.5,3,6,9,0,0,3,3,1,9,10
Luc Mbah a Moute,30-117,F,1/4/17,LAC,MEM,1,28,3,5,0.6,2,4,0.5,1,1,1,2,3,0.667,1,3,4,2,0,1,0,2,9,9.2
Jared Dudley,31-252,F-G,3/19/17,PHO,DET,0,22,4,7,0.571,3,4,0.75,1,3,0.333,0,0,,1,4,5,1,1,0,0,1,9,8.9
Emmanuel Mudiay,20-272,G,12/2/16,DEN,HOU,1,29,3,12,0.25,2,6,0.333,1,6,0.167,2,2,1,1,2,3,5,0,0,1,4,9,4
Trevor Booker,29-134,F,4/8/17,BRK,CHI,0,22,4,10,0.4,4,10,0.4,0,0,,1,1,1,1,3,4,0,2,0,1,1,9,5.8
Patrick Beverley,28-246,G,3/15/17,HOU,LAL,1,27,1,5,0.2,0,1,0,1,4,0.25,6,6,1,0,4,4,5,1,0,2,3,9,8.4
E'Twaun Moore,27-325,G,1/18/17,NOP,ORL,0,26,4,7,0.571,3,5,0.6,1,2,0.5,0,0,,0,1,1,2,0,1,0,2,9,7.3
Vince Carter,40-059,G-F,3/26/17,MEM,GSW,1,34,4,7,0.571,3,4,0.75,1,3,0.333,0,0,,1,2,3,2,1,0,1,2,9,7.6
Isaiah Whitehead,21-354,G,2/25/17,BRK,GSW,0,23,4,10,0.4,4,9,0.444,0,1,0,1,2,0.5,1,4,5,4,1,0,4,1,9,4.5
Ben McLemore,23-300,G,12/7/16,SAC,DAL,1,21,3,11,0.273,2,5,0.4,1,6,0.167,2,2,1,0,1,1,0,0,0,1,1,9,1.4
P.J. Tucker,31-324,F,3/25/17,TOR,DAL,1,34,3,8,0.375,2,2,1,1,6,0.167,2,2,1,1,8,9,3,4,0,1,1,9,12.4
Steven Adams,23-208,C,2/13/17,OKC,WAS,1,19,2,7,0.286,2,7,0.286,0,0,,5,6,0.833,7,4,11,0,1,1,3,2,9,8.5
Tyus Jones,20-257,G,1/22/17,MIN,DEN,0,19,3,8,0.375,2,7,0.286,1,1,1,2,3,0.667,0,0,0,4,1,1,1,2,9,6.9
Robert Covington,26-100,F,3/24/17,PHI,CHI,1,29,2,7,0.286,2,3,0.667,0,4,0,5,6,0.833,1,5,6,0,1,1,3,5,9,3.4
Troy Williams,21-334,F,11/28/16,MEM,CHO,1,31,4,9,0.444,4,7,0.571,0,2,0,1,3,0.333,0,2,2,3,2,0,2,1,9,5.8
George Hill,30-311,G,3/11/17,UTA,OKC,1,18,3,6,0.5,2,5,0.4,1,1,1,2,2,1,0,1,1,1,2,0,2,1,9,6.6
Danny Green,29-215,G-F,1/23/17,SAS,BRK,1,33,4,8,0.5,3,5,0.6,1,3,0.333,0,0,,0,2,2,1,2,0,1,1,9,6.9
Evan Turner,28-049,G,12/15/16,POR,DEN,0,25,3,11,0.273,3,10,0.3,0,1,0,3,4,0.75,2,3,5,2,3,1,3,1,9,6.1
Thaddeus Young,28-213,F,1/20/17,IND,LAL,1,33,3,9,0.333,2,6,0.333,1,3,0.333,2,2,1,2,6,8,3,5,1,0,0,9,14.9
Mike Muscala,25-274,F-C,4/1/17,ATL,CHI,0,18,3,4,0.75,0,1,0,3,3,1,0,0,,0,1,1,2,0,0,1,2,9,7.3
Andre Roberson,24-337,G-F,11/5/16,OKC,MIN,1,25,3,6,0.5,1,3,0.333,2,3,0.667,1,2,0.5,0,1,1,0,0,1,0,2,9,5.8
Andre Iguodala,33-000,G-F,1/28/17,GSW,LAC,0,24,3,6,0.5,2,3,0.667,1,3,0.333,2,2,1,0,6,6,5,1,0,0,0,9,12.3
Jerami Grant,22-310,F,1/16/17,OKC,LAC,1,34,3,4,0.75,0,1,0,3,3,1,0,0,,1,7,8,1,0,3,2,0,9,11
Gerald Henderson,29-040,G,1/18/17,PHI,TOR,0,26,2,3,0.667,1,2,0.5,1,1,1,4,5,0.8,0,2,2,0,0,0,1,1,9,6.5
Lance Thomas,28-305,F,2/23/17,NYK,CLE,0,31,3,7,0.429,2,5,0.4,1,2,0.5,2,2,1,2,3,5,2,1,1,0,3,9,9.5
Domantas Sabonis,20-284,F,2/11/17,OKC,GSW,1,26,3,7,0.429,3,6,0.5,0,1,0,3,4,0.75,1,3,4,3,1,1,1,0,9,9.3
Jeff Teague,28-302,G,4/8/17,IND,ORL,1,31,3,11,0.273,2,8,0.25,1,3,0.333,2,2,1,0,4,4,13,3,0,2,0,9,13.8
Courtney Lee,31-132,G,2/12/17,NYK,SAS,1,35,4,9,0.444,3,7,0.429,1,2,0.5,0,0,,1,4,5,5,1,0,2,1,9,8.3
Nik Stauskas,23-112,G,1/27/17,PHI,HOU,1,28,4,12,0.333,3,7,0.429,1,5,0.2,0,0,,0,2,2,3,0,0,0,4,9,3.3
Steven Adams,23-226,C,3/3/17,OKC,PHO,1,30,3,4,0.75,3,4,0.75,0,0,,3,6,0.5,3,7,10,1,1,1,2,6,9,8.4
Bobby Portis,21-271,F,11/7/16,CHI,ORL,0,17,3,4,0.75,3,4,0.75,0,0,,3,4,0.75,3,3,6,2,0,0,1,0,9,10.4
Dewayne Dedmon,27-135,C,12/25/16,SAS,CHI,0,15,4,5,0.8,4,5,0.8,0,0,,1,1,1,2,4,6,2,0,0,2,3,9,7.9
Julius Randle,21-339,F,11/2/16,LAL,ATL,1,28,3,7,0.429,3,6,0.5,0,1,0,3,4,0.75,2,4,6,2,1,1,2,4,9,7
Anthony Bennett,23-229,F,10/29/16,BRK,MIL,0,18,3,9,0.333,1,4,0.25,2,5,0.4,1,2,0.5,0,1,1,3,1,0,1,3,9,4.7
Marcus Thornton,29-153,G,11/5/16,WAS,ORL,0,17,4,8,0.5,3,5,0.6,1,3,0.333,0,0,,0,4,4,0,0,0,2,2,9,3.4
Jeff Teague,28-183,G,12/10/16,IND,POR,1,30,3,7,0.429,1,5,0.2,2,2,1,1,2,0.5,0,1,1,6,2,1,3,2,9,8.3
Dwight Powell,25-147,F-C,12/14/16,DAL,DET,0,20,4,6,0.667,4,6,0.667,0,0,,1,1,1,0,1,1,2,1,0,1,3,9,6.9
Patty Mills,28-199,G,2/26/17,SAS,LAL,0,17,4,8,0.5,3,4,0.75,1,4,0.25,0,0,,0,2,2,7,2,0,1,0,9,11.5
Montrezl Harrell,22-323,F-C,12/14/16,HOU,SAC,0,16,4,6,0.667,4,6,0.667,0,0,,1,2,0.5,0,4,4,1,1,2,0,0,9,10.3
Marcus Smart,22-264,G,11/25/16,BOS,SAS,0,27,3,9,0.333,3,6,0.5,0,3,0,3,3,1,3,1,4,10,1,0,1,3,9,12.1
Patrick Beverley,28-205,G,2/2/17,HOU,ATL,1,31,3,8,0.375,1,2,0.5,2,6,0.333,1,2,0.5,0,6,6,1,1,0,0,1,9,7.3
Meyers Leonard,25-005,C-F,3/4/17,POR,BRK,0,18,4,4,1,3,3,1,1,1,1,0,0,,1,2,3,1,0,0,0,1,9,9.4
James Michael McAdoo,24-076,F,3/21/17,GSW,DAL,0,5,1,1,1,1,1,1,0,0,,7,8,0.875,0,2,2,0,0,1,1,1,9,8.2
Yogi Ferrell,23-276,G,2/9/17,DAL,UTA,1,26,3,8,0.375,2,4,0.5,1,4,0.25,2,2,1,0,4,4,5,3,0,2,1,9,9.9
Glenn Robinson,23-008,G-F,1/16/17,IND,NOP,1,30,4,6,0.667,3,3,1,1,3,0.333,0,2,0,1,4,5,1,0,1,0,0,9,8.9
Timothe Luwawu-Cabarrot,21-291,F,2/24/17,PHI,WAS,0,18,2,3,0.667,1,1,1,1,2,0.5,4,4,1,0,0,0,1,0,0,3,5,9,3.4
Mason Plumlee,26-255,C-F,11/15/16,POR,CHI,1,22,3,7,0.429,3,7,0.429,0,0,,3,6,0.5,4,2,6,4,1,1,1,1,9,10.6
Jonas Jerebko,29-262,F,11/19/16,BOS,DET,0,18,3,4,0.75,0,1,0,3,3,1,0,0,,1,5,6,1,0,0,1,4,9,7.7
Joffrey Lauvergne,25-138,C-F,2/15/17,OKC,NYK,0,17,3,8,0.375,2,6,0.333,1,2,0.5,2,2,1,0,2,2,0,2,0,2,1,9,4.8
Luke Babbitt,27-250,F,2/25/17,MIA,IND,1,15,3,5,0.6,0,0,,3,5,0.6,0,0,,1,2,3,1,1,0,0,1,9,9.3
Mario Hezonja,21-256,F-G,11/7/16,ORL,CHI,0,21,4,13,0.308,3,7,0.429,1,6,0.167,0,0,,0,3,3,2,0,1,2,3,9,1.3
Gordon Hayward,26-241,F-G,11/19/16,UTA,HOU,1,39,4,13,0.308,3,9,0.333,1,4,0.25,0,1,0,0,7,7,5,0,0,2,2,9,3.9
Rodney Hood,24-039,G-F,11/28/16,UTA,MIN,1,32,4,12,0.333,3,7,0.429,1,5,0.2,0,0,,0,3,3,5,1,0,1,3,9,5.4
Cody Zeller,24-094,F-C,1/7/17,CHO,SAS,1,33,3,5,0.6,3,5,0.6,0,0,,3,4,0.75,3,6,9,1,1,2,2,2,9,10.5
Andrew Nicholson,26-324,F,10/27/16,WAS,ATL,0,19,3,6,0.5,2,4,0.5,1,2,0.5,2,2,1,2,5,7,0,1,1,1,1,9,9.2
Rodney Stuckey,30-291,G,2/6/17,IND,OKC,0,14,2,6,0.333,2,5,0.4,0,1,0,5,5,1,0,1,1,1,0,0,1,0,9,5.6
Ian Clark,25-296,G,12/28/16,GSW,TOR,0,16,3,7,0.429,2,5,0.4,1,2,0.5,2,2,1,4,1,5,0,0,0,1,1,9,7
Garrett Temple,30-255,G,1/18/17,SAC,IND,0,29,4,8,0.5,3,3,1,1,5,0.2,0,0,,1,3,4,3,0,0,1,4,9,6.1
Domantas Sabonis,20-297,F,2/24/17,OKC,LAL,1,23,4,7,0.571,3,5,0.6,1,2,0.5,0,1,0,0,3,3,2,0,2,0,0,9,9
Domantas Sabonis,20-332,F,3/31/17,OKC,SAS,1,33,3,5,0.6,3,3,1,0,2,0,3,4,0.75,0,4,4,0,1,0,2,2,9,5.7
DeAndre Jordan,28-144,C,12/12/16,LAC,POR,1,33,3,6,0.5,3,6,0.5,0,0,,3,4,0.75,6,6,12,1,3,3,1,3,9,15.2
Marcus Smart,22-251,G,11/12/16,BOS,IND,1,34,4,11,0.364,4,9,0.444,0,2,0,1,2,0.5,1,1,2,2,1,0,0,4,9,4.3
Jeff Teague,28-277,G,3/14/17,IND,NYK,1,32,4,15,0.267,3,9,0.333,1,6,0.167,0,1,0,1,8,9,6,0,0,7,0,9,0
J.J. Redick,32-290,G,4/10/17,LAC,HOU,1,28,4,12,0.333,3,6,0.5,1,6,0.167,0,0,,0,4,4,1,2,0,1,0,9,5.1
Kelly Oubre,21-105,F,3/24/17,WAS,BRK,0,24,4,9,0.444,3,6,0.5,1,3,0.333,0,0,,0,3,3,0,1,0,0,2,9,5.4
Dion Waiters,24-321,G,10/26/16,MIA,ORL,1,34,4,13,0.308,4,12,0.333,0,1,0,1,2,0.5,1,5,6,4,0,0,1,2,9,4.3
Kent Bazemore,27-173,G-F,12/21/16,ATL,MIN,1,33,3,9,0.333,2,7,0.286,1,2,0.5,2,4,0.5,0,4,4,1,0,4,0,1,9,7.4
Isaiah Canaan,25-195,G,12/2/16,CHI,CLE,0,28,4,8,0.5,3,3,1,1,5,0.2,0,0,,0,0,0,0,0,0,0,2,9,4.2
Garrett Temple,30-229,G,12/23/16,SAC,MIN,0,26,3,6,0.5,2,3,0.667,1,3,0.333,2,2,1,2,4,6,4,0,0,1,3,9,9.2
Roy Hibbert,29-340,C,11/15/16,CHO,MIN,0,12,4,5,0.8,4,5,0.8,0,0,,1,2,0.5,2,2,4,0,0,1,3,3,9,5.2
Trevor Ariza,31-132,F,11/9/16,HOU,SAS,1,41,4,8,0.5,3,3,1,1,5,0.2,0,0,,0,5,5,3,4,0,3,4,9,8
Jrue Holiday,26-211,G,1/9/17,NOP,NYK,1,25,3,8,0.375,2,5,0.4,1,3,0.333,2,3,0.667,0,4,4,7,1,0,2,1,9,8.9
Bismack Biyombo,24-108,C-F,12/14/16,ORL,LAC,1,34,4,7,0.571,4,7,0.571,0,0,,1,7,0.143,4,8,12,1,0,0,0,2,9,8.4
Emmanuel Mudiay,20-313,G,1/12/17,DEN,IND,1,22,3,7,0.429,1,2,0.5,2,5,0.4,1,2,0.5,0,2,2,7,2,1,2,3,9,9.9
Semaj Christon,24-010,G,11/11/16,OKC,LAC,0,20,3,7,0.429,2,6,0.333,1,1,1,2,2,1,0,0,0,4,0,0,1,1,9,6.7
Rudy Gobert,24-248,C,3/1/17,UTA,MIN,1,21,4,7,0.571,4,7,0.571,0,0,,1,2,0.5,4,4,8,0,0,2,3,3,9,6.5
Jeremy Lamb,24-219,G-F,1/4/17,CHO,OKC,0,12,3,4,0.75,2,3,0.667,1,1,1,2,3,0.667,0,1,1,3,1,1,0,1,9,10.7
Wesley Matthews,30-023,G,11/6/16,DAL,MIL,1,44,3,17,0.176,0,3,0,3,14,0.214,0,0,,0,1,1,1,3,0,2,3,9,-0.9
Gary Harris,22-200,G,4/2/17,DEN,MIA,1,37,3,10,0.3,3,5,0.6,0,5,0,3,4,0.75,1,2,3,2,2,0,1,1,9,6.1
Paul Millsap,31-357,F,2/1/17,ATL,MIA,1,24,4,12,0.333,4,9,0.444,0,3,0,1,1,1,2,5,7,2,2,0,1,1,9,7.1
Thaddeus Young,28-174,F,12/12/16,IND,CHO,1,30,4,10,0.4,3,8,0.375,1,2,0.5,0,0,,0,5,5,1,0,1,1,2,9,4.7
Sam Dekker,22-252,F,1/13/17,HOU,MEM,0,14,2,6,0.333,0,2,0,2,4,0.5,3,6,0.5,2,2,4,1,0,0,0,1,9,6.7
Mason Plumlee,26-335,C-F,2/3/17,POR,DAL,1,31,4,7,0.571,4,7,0.571,0,0,,1,2,0.5,4,5,9,0,1,1,1,2,9,9.5
Thabo Sefolosha,32-210,G-F,11/28/16,ATL,GSW,0,26,3,8,0.375,3,8,0.375,0,0,,3,4,0.75,0,5,5,2,2,1,1,3,9,7.6
Jason Terry,39-188,G,3/22/17,MIL,SAC,0,22,3,5,0.6,0,0,,3,5,0.6,0,0,,1,3,4,3,2,0,1,0,9,11.4
Mario Hezonja,22-016,F-G,3/13/17,ORL,SAC,0,19,4,7,0.571,3,6,0.5,1,1,1,0,0,,1,2,3,1,1,0,1,1,9,7.3
George Hill,30-316,G,3/16/17,UTA,CLE,1,31,3,10,0.3,2,5,0.4,1,5,0.2,2,3,0.667,0,2,2,2,1,0,1,2,9,4
Solomon Hill,25-320,F,2/1/17,NOP,DET,1,35,3,7,0.429,0,1,0,3,6,0.5,0,0,,0,4,4,1,0,0,1,3,9,5
DeAndre Jordan,28-196,C,2/2/17,LAC,GSW,1,25,2,2,1,2,2,1,0,0,,5,8,0.625,0,7,7,1,0,2,1,2,9,9.6
Dewayne Dedmon,27-079,C,10/30/16,SAS,MIA,0,16,2,5,0.4,2,5,0.4,0,0,,5,6,0.833,4,4,8,1,0,0,0,4,9,9
Rudy Gay,30-093,F,11/18/16,SAC,LAC,1,33,3,11,0.273,3,9,0.333,0,2,0,3,4,0.75,0,3,3,3,2,0,4,5,9,1.1
T.J. McConnell,24-229,G,11/9/16,PHI,IND,0,21,4,7,0.571,4,4,1,0,3,0,1,2,0.5,0,1,1,5,1,0,2,2,9,7.3
Nicolas Batum,27-331,F-G,11/9/16,CHO,UTA,1,34,3,10,0.3,3,5,0.6,0,5,0,3,5,0.6,0,2,2,5,1,0,1,5,9,4.5
Kelly Olynyk,25-232,C-F,12/7/16,BOS,ORL,0,20,4,8,0.5,4,5,0.8,0,3,0,1,1,1,1,3,4,2,1,0,0,1,9,8.6
Michael Beasley,27-315,F,11/19/16,MIL,GSW,0,20,4,9,0.444,3,8,0.375,1,1,1,0,2,0,2,1,3,0,0,0,0,1,9,4.8
Iman Shumpert,26-233,G,2/14/17,CLE,MIN,1,26,3,9,0.333,0,1,0,3,8,0.375,0,0,,0,0,0,1,0,0,1,2,9,2.8
Alex Len,23-201,C,1/3/17,PHO,MIA,0,16,4,7,0.571,4,7,0.571,0,0,,1,2,0.5,2,6,8,0,0,3,2,3,9,7.4
Iman Shumpert,26-159,G,12/2/16,CLE,CHI,0,19,4,6,0.667,3,4,0.75,1,2,0.5,0,0,,0,3,3,3,1,0,2,2,9,7.6
Deron Williams,32-154,G,11/27/16,DAL,NOP,1,20,3,10,0.3,3,6,0.5,0,4,0,3,3,1,0,2,2,4,0,0,5,4,9,0
Dante Exum,21-268,G,4/7/17,UTA,MIN,1,23,3,5,0.6,0,1,0,3,4,0.75,0,0,,0,2,2,3,0,0,2,1,9,7
Deron Williams,32-160,G,12/3/16,DAL,CHI,1,31,3,11,0.273,3,8,0.375,0,3,0,3,3,1,0,2,2,15,1,0,1,2,9,12.8
Rodney Hood,24-080,G-F,1/8/17,UTA,MEM,1,31,4,14,0.286,3,7,0.429,1,7,0.143,0,0,,0,3,3,2,0,0,1,2,9,1.3
Iman Shumpert,26-145,G,11/18/16,CLE,DET,0,17,3,5,0.6,1,2,0.5,2,3,0.667,1,1,1,0,0,0,2,0,0,0,2,9,7.3
J.J. Barea,32-272,G,3/25/17,DAL,TOR,0,18,3,8,0.375,1,4,0.25,2,4,0.5,1,2,0.5,0,1,1,3,0,0,2,2,9,3.8
Jonas Valanciunas,24-323,C,3/25/17,TOR,DAL,1,22,4,9,0.444,4,9,0.444,0,0,,1,1,1,3,3,6,1,1,0,0,2,9,8.2
Alex Len,23-188,C,12/21/16,PHO,HOU,0,24,4,5,0.8,4,5,0.8,0,0,,1,2,0.5,0,5,5,0,1,4,0,2,9,11.2
James Ennis,26-130,F,11/8/16,MEM,DEN,1,32,2,4,0.5,1,1,1,1,3,0.333,4,4,1,2,1,3,2,4,0,2,5,9,10.1
Andre Roberson,25-005,G-F,12/9/16,OKC,HOU,1,37,3,7,0.429,1,2,0.5,2,5,0.4,1,4,0.25,1,7,8,3,2,1,0,4,9,10.1
Jonas Jerebko,29-289,F,12/16/16,BOS,CHO,0,25,4,8,0.5,3,3,1,1,5,0.2,0,0,,1,2,3,3,2,0,0,3,9,9.2
Otto Porter,23-188,F,12/8/16,WAS,DEN,1,36,4,9,0.444,3,5,0.6,1,4,0.25,0,0,,0,5,5,1,3,1,3,3,9,6
Nene Hilario,34-174,F-C,3/6/17,HOU,SAS,0,19,4,6,0.667,4,6,0.667,0,0,,1,3,0.333,1,2,3,0,0,1,0,4,9,6
Andre Drummond,23-153,C,1/10/17,DET,SAC,1,35,4,5,0.8,4,5,0.8,0,0,,1,6,0.167,3,9,12,1,3,7,2,5,9,14.5
James Johnson,29-338,F,1/23/17,MIA,GSW,0,27,4,8,0.5,3,6,0.5,1,2,0.5,0,0,,1,1,2,4,0,2,1,4,9,7.6
Tim Hardaway,24-247,G,11/18/16,ATL,CHO,0,23,4,9,0.444,3,5,0.6,1,4,0.25,0,0,,0,3,3,0,0,0,0,0,9,5.2
Norman Powell,23-168,G,11/9/16,TOR,OKC,0,23,4,8,0.5,4,7,0.571,0,1,0,1,3,0.333,0,2,2,0,1,0,0,3,9,4.6
P.J. Tucker,31-334,F,4/4/17,TOR,IND,0,26,4,10,0.4,3,7,0.429,1,3,0.333,0,0,,2,3,5,1,1,0,1,4,9,5
Solomon Hill,25-241,F,11/14/16,NOP,BOS,0,32,2,5,0.4,1,1,1,1,4,0.25,4,4,1,1,6,7,1,1,0,2,5,9,6.5
Cristiano Felicio,24-154,F-C,12/8/16,CHI,SAS,0,18,3,5,0.6,3,5,0.6,0,0,,3,4,0.75,4,3,7,0,0,0,1,1,9,8.6
Jae Crowder,26-136,F,11/19/16,BOS,DET,1,27,3,9,0.333,2,5,0.4,1,4,0.25,2,2,1,0,4,4,0,1,1,2,0,9,4.8
C.J. Miles,29-231,G-F,12/5/16,IND,GSW,0,18,3,6,0.5,1,1,1,2,5,0.4,1,1,1,0,3,3,1,0,1,0,2,9,7.5
C.J. Miles,29-283,G-F,1/26/17,IND,MIN,1,29,3,5,0.6,0,1,0,3,4,0.75,0,0,,0,6,6,1,1,0,0,4,9,8.6
Paul Millsap,31-291,F,11/27/16,ATL,LAL,1,30,4,11,0.364,3,7,0.429,1,4,0.25,0,0,,1,4,5,3,0,0,2,2,9,4.1
Jahlil Okafor,21-049,C-F,2/2/17,PHI,SAS,1,25,4,12,0.333,4,12,0.333,0,0,,1,1,1,3,6,9,3,0,0,1,3,9,6
DeMarre Carroll,30-174,F,1/17/17,TOR,BRK,1,26,3,8,0.375,0,4,0,3,4,0.75,0,0,,2,1,3,1,2,0,0,5,9,7
Luke Babbitt,27-257,F,3/4/17,MIA,CLE,1,14,3,4,0.75,0,0,,3,4,0.75,0,0,,0,0,0,1,0,0,0,4,9,6.5
Nikola Jokic,21-305,C-F,12/20/16,DEN,LAC,1,21,4,7,0.571,4,5,0.8,0,2,0,1,2,0.5,2,4,6,1,0,1,2,3,9,6.1
Stanley Johnson,20-237,F,1/21/17,DET,WAS,0,16,4,4,1,3,3,1,1,1,1,0,0,,0,0,0,1,1,1,1,3,9,8
Rodney Hood,24-075,G-F,1/3/17,UTA,BOS,1,35,3,10,0.3,3,7,0.429,0,3,0,3,6,0.5,0,3,3,4,0,0,0,1,9,5.3
Sergio Rodriguez,30-162,G,11/21/16,PHI,MIA,1,20,4,4,1,3,3,1,1,1,1,0,0,,0,0,0,5,0,0,3,1,9,7.9
Brandon Jennings,27-114,G,1/15/17,NYK,TOR,0,24,2,8,0.25,1,4,0.25,1,4,0.25,4,4,1,0,2,2,7,1,0,2,2,9,7.9
Noah Vonleh,21-085,F,11/17/16,POR,HOU,0,16,3,5,0.6,2,3,0.667,1,2,0.5,2,2,1,0,3,3,0,0,2,0,0,9,9
Brandon Jennings,27-122,G,1/23/17,NYK,IND,0,29,2,5,0.4,1,3,0.333,1,2,0.5,4,4,1,0,2,2,6,1,0,2,3,9,8.9
Brandon Ingram,19-092,F,12/3/16,LAL,MEM,1,39,2,5,0.4,1,3,0.333,1,2,0.5,4,4,1,1,4,5,1,0,3,5,0,9,6
Jon Leuer,27-228,F,12/28/16,DET,MIL,1,29,4,11,0.364,3,9,0.333,1,2,0.5,0,0,,3,4,7,4,0,0,0,0,9,9
Hassan Whiteside,27-229,C,1/28/17,MIA,DET,1,29,4,9,0.444,4,9,0.444,0,0,,1,2,0.5,4,8,12,0,0,2,2,2,9,7.7
Wayne Ellington,29-030,G,11/28/16,MIA,BOS,0,27,4,9,0.444,3,4,0.75,1,5,0.2,0,0,,0,2,2,2,0,0,0,3,9,5.1
Allen Crabbe,24-214,G-F,11/9/16,POR,LAC,0,23,4,6,0.667,3,4,0.75,1,2,0.5,0,0,,0,2,2,1,0,0,1,0,9,6.7
Darrun Hilliard,23-226,G,11/25/16,DET,LAC,0,19,4,6,0.667,4,5,0.8,0,1,0,1,1,1,1,2,3,1,1,0,2,2,9,6.6
Tony Allen,34-347,G-F,12/23/16,MEM,HOU,1,29,3,5,0.6,2,4,0.5,1,1,1,2,4,0.5,2,2,4,2,2,1,1,1,9,10.6
Rajon Rondo,30-259,G,11/7/16,CHI,ORL,1,22,3,7,0.429,3,7,0.429,0,0,,3,6,0.5,1,2,3,6,1,1,1,1,9,9.9
Jerami Grant,22-292,F,12/29/16,OKC,MEM,0,24,2,4,0.5,2,4,0.5,0,0,,5,8,0.625,0,1,1,0,0,1,0,1,9,6.4
Nerlens Noel,22-264,C-F,12/30/16,PHI,DEN,0,19,4,7,0.571,4,7,0.571,0,0,,1,4,0.25,1,1,2,0,0,1,0,3,9,5
Caris LeVert,22-215,G-F,3/28/17,BRK,PHI,1,26,3,9,0.333,1,3,0.333,2,6,0.333,1,2,0.5,0,5,5,0,0,0,2,2,9,2.2
Kelly Olynyk,25-335,C-F,3/20/17,BOS,WAS,0,18,4,7,0.571,3,5,0.6,1,2,0.5,0,0,,4,7,11,1,0,1,3,5,9,7
C.J. Watson,32-276,G,1/18/17,ORL,NOP,0,19,3,5,0.6,1,2,0.5,2,3,0.667,1,1,1,1,2,3,0,0,0,3,2,9,4.2
Corey Brewer,30-343,F-G,2/11/17,HOU,PHO,0,27,4,8,0.5,3,5,0.6,1,3,0.333,0,0,,0,1,1,3,2,0,1,2,9,7.6
Ian Clark,25-271,G,12/3/16,GSW,PHO,0,16,3,4,0.75,3,3,1,0,1,0,3,4,0.75,0,1,1,3,0,0,0,1,9,9
Michael Carter-Williams,25-159,G,3/18/17,CHI,UTA,0,27,4,10,0.4,4,9,0.444,0,1,0,1,1,1,0,2,2,4,1,3,2,3,9,6.9
Ersan Ilyasova,29-181,F,11/12/16,PHI,ATL,0,24,4,12,0.333,3,7,0.429,1,5,0.2,0,0,,0,5,5,2,1,1,4,3,9,1.6
Chandler Parsons,28-113,F,2/15/17,MEM,NOP,1,19,3,6,0.5,2,2,1,1,4,0.25,2,2,1,0,1,1,1,1,0,0,3,9,6.8
Kelly Olynyk,25-332,C-F,3/17/17,BOS,BRK,0,19,4,6,0.667,4,5,0.8,0,1,0,1,2,0.5,1,5,6,3,0,2,2,2,9,8.9
Draymond Green,26-310,F,1/8/17,GSW,SAC,1,32,4,9,0.444,3,5,0.6,1,4,0.25,0,0,,1,6,7,10,2,2,4,5,9,11.2
Monta Ellis,31-100,G,2/3/17,IND,BRK,0,25,3,8,0.375,3,8,0.375,0,0,,3,5,0.6,0,6,6,2,2,0,2,1,9,6.6
Michael Kidd-Gilchrist,23-114,F,1/18/17,CHO,POR,1,31,3,7,0.429,3,7,0.429,0,0,,3,4,0.75,1,4,5,4,1,3,1,1,9,11.3
Patrick McCaw,21-132,G,3/6/17,GSW,ATL,1,27,3,6,0.5,0,2,0,3,4,0.75,0,0,,2,5,7,1,1,0,1,1,9,9.2
Corey Brewer,30-277,F-G,12/7/16,HOU,LAL,0,21,4,9,0.444,4,7,0.571,0,2,0,1,1,1,0,1,1,2,3,0,1,3,9,6.8
James Jones,36-190,F-G,4/12/17,CLE,TOR,0,36,3,16,0.188,2,4,0.5,1,12,0.083,2,3,0.667,1,4,5,2,0,1,1,2,9,0.8
Thomas Robinson,26-021,F,4/7/17,LAL,SAC,0,14,4,6,0.667,4,6,0.667,0,0,,1,4,0.25,2,3,5,0,0,0,1,1,9,6.1
Meyers Leonard,25-040,C-F,4/8/17,POR,UTA,1,30,3,8,0.375,0,0,,3,8,0.375,0,0,,1,4,5,1,0,0,0,4,9,5.6
Aaron Gordon,21-050,F,11/5/16,ORL,WAS,1,24,3,7,0.429,1,3,0.333,2,4,0.5,1,2,0.5,1,3,4,4,0,1,0,1,9,9.6
Jamal Murray,19-281,G,11/30/16,DEN,MIA,0,23,3,10,0.3,1,4,0.25,2,6,0.333,1,1,1,0,3,3,2,0,2,2,4,9,3.3
Nikola Mirotic,25-361,F,2/6/17,CHI,SAC,0,25,3,11,0.273,0,2,0,3,9,0.333,0,0,,0,3,3,0,0,0,1,0,9,2.4
Trevor Ariza,31-226,F,2/11/17,HOU,PHO,1,31,4,13,0.308,3,8,0.375,1,5,0.2,0,0,,1,8,9,1,3,0,1,3,9,6.1
Lance Thomas,28-224,F,12/4/16,NYK,SAC,0,17,2,8,0.25,0,4,0,2,4,0.5,3,4,0.75,0,3,3,0,0,0,3,3,9,0.5
Jamal Murray,20-001,G,2/24/17,DEN,BRK,0,26,3,14,0.214,1,9,0.111,2,5,0.4,1,2,0.5,0,2,2,1,1,0,1,1,9,0.9
DeMarre Carroll,30-164,F,1/7/17,TOR,CHI,1,41,3,8,0.375,1,1,1,2,7,0.286,1,2,0.5,0,2,2,2,1,0,0,5,9,5.2
Jusuf Nurkic,22-079,C,11/10/16,DEN,GSW,1,17,4,5,0.8,4,5,0.8,0,0,,1,2,0.5,1,2,3,0,1,1,4,2,9,4.9
Allen Crabbe,24-223,G-F,11/18/16,POR,NOP,0,27,3,6,0.5,3,3,1,0,3,0,3,5,0.6,0,2,2,0,0,1,1,1,9,5.1
Gerald Henderson,29-078,G,2/25/17,PHI,NYK,1,30,3,11,0.273,3,8,0.375,0,3,0,3,5,0.6,1,2,3,3,1,0,1,3,9,3.9
Sean Kilpatrick,27-063,G,3/10/17,BRK,DAL,0,24,3,11,0.273,2,3,0.667,1,8,0.125,2,2,1,0,2,2,5,2,0,3,4,9,4
Thomas Robinson,25-255,F,11/27/16,LAL,ATL,1,15,4,11,0.364,4,11,0.364,0,0,,1,2,0.5,5,3,8,0,0,0,1,1,9,5.5
Malcolm Delaney,27-246,G,11/12/16,ATL,PHI,0,17,3,8,0.375,3,7,0.429,0,1,0,3,3,1,2,1,3,6,0,0,1,0,9,9.5
J.J. Redick,32-272,G,3/23/17,LAC,DAL,1,28,2,9,0.222,1,4,0.25,1,5,0.2,4,4,1,0,1,1,2,1,0,1,1,9,4.8
Malcolm Delaney,27-310,G,1/15/17,ATL,MIL,0,26,4,7,0.571,3,4,0.75,1,3,0.333,0,0,,0,0,0,9,1,0,2,2,9,10.2
Trey Burke,24-076,G,1/27/17,WAS,ATL,0,19,4,7,0.571,3,4,0.75,1,3,0.333,0,0,,0,1,1,3,1,0,2,2,9,6.3
Alan Williams,24-055,F-C,3/24/17,PHO,BOS,0,24,3,9,0.333,3,9,0.333,0,0,,3,6,0.5,2,12,14,0,1,0,0,4,9,7.1
Wesley Matthews,30-085,G,1/7/17,DAL,ATL,1,33,3,12,0.25,0,5,0,3,7,0.429,0,0,,0,4,4,1,0,0,1,4,9,1.1
Sasha Vujacic,33-015,G,3/23/17,NYK,POR,0,16,3,6,0.5,2,5,0.4,1,1,1,2,2,1,0,1,1,0,0,0,1,2,9,4.5
D.J. Augustin,28-357,G,11/1/16,ORL,PHI,0,13,4,10,0.4,3,4,0.75,1,6,0.167,0,0,,0,0,0,1,0,0,0,0,9,4.3
Greg Monroe,26-290,C-F,3/21/17,MIL,POR,0,22,4,12,0.333,4,12,0.333,0,0,,1,2,0.5,6,3,9,2,1,1,1,3,9,7.8
Joe Harris,25-096,G,12/12/16,BRK,HOU,0,22,2,7,0.286,1,3,0.333,1,4,0.25,4,4,1,0,7,7,1,0,0,0,5,9,5.7
Dirk Nowitzki,38-290,F,4/5/17,DAL,LAC,1,28,4,11,0.364,3,8,0.375,1,3,0.333,0,0,,0,4,4,1,1,0,1,1,9,4.4
Doug McDermott,25-024,F,1/27/17,CHI,MIA,1,24,3,6,0.5,2,4,0.5,1,2,0.5,2,2,1,0,5,5,2,0,0,2,1,9,6.5
Kenneth Faried,26-342,F,10/26/16,DEN,NOP,0,28,3,9,0.333,3,8,0.375,0,1,0,3,6,0.5,6,8,14,1,2,2,3,1,9,10
Thomas Robinson,25-346,F,2/26/17,LAL,SAS,0,17,4,7,0.571,4,7,0.571,0,0,,1,2,0.5,4,4,8,0,4,0,2,0,9,11.3
Marreese Speights,29-144,C-F,12/26/16,LAC,DEN,0,15,3,7,0.429,1,3,0.333,2,4,0.5,1,2,0.5,0,2,2,1,0,1,0,1,9,6.5
Maurice Harkless,23-252,F-G,1/18/17,POR,CHO,1,27,4,10,0.4,3,6,0.5,1,4,0.25,0,0,,0,1,1,3,1,1,1,1,9,6.3
Myles Turner,21-005,F-C,3/29/17,IND,MEM,1,28,4,9,0.444,4,8,0.5,0,1,0,1,1,1,0,5,5,1,0,1,1,4,9,4.6
Jonas Jerebko,30-037,F,4/8/17,BOS,CHO,0,15,3,5,0.6,0,1,0,3,4,0.75,0,0,,0,2,2,3,0,0,0,1,9,9
Amir Johnson,29-238,F,12/25/16,BOS,NYK,1,24,3,6,0.5,3,6,0.5,0,0,,3,4,0.75,4,1,5,3,1,0,0,4,9,10.2
Eric Gordon,28-064,G,2/27/17,HOU,IND,0,26,3,11,0.273,2,6,0.333,1,5,0.2,2,4,0.5,1,0,1,2,0,0,1,2,9,2
Eric Gordon,27-316,G,11/5/16,HOU,ATL,1,30,3,11,0.273,3,7,0.429,0,4,0,3,4,0.75,0,2,2,2,0,3,2,3,9,3
Kevin Love,28-196,F,3/22/17,CLE,DEN,1,22,3,9,0.333,0,2,0,3,7,0.429,0,0,,1,6,7,1,2,1,0,1,9,9.4
Joffrey Lauvergne,25-044,C-F,11/13/16,OKC,ORL,0,15,3,4,0.75,0,1,0,3,3,1,0,0,,0,1,1,0,0,0,1,2,9,5.9
Al Jefferson,32-023,C-F,1/27/17,IND,SAC,0,12,4,9,0.444,4,9,0.444,0,0,,1,1,1,0,1,1,1,0,0,2,2,9,2.5
Jordan Crawford,28-163,G,4/4/17,NOP,DEN,0,17,4,9,0.444,4,6,0.667,0,3,0,1,1,1,0,0,0,1,0,0,2,2,9,2.2
Maurice Harkless,23-177,F-G,11/4/16,POR,DAL,1,32,4,8,0.5,3,5,0.6,1,3,0.333,0,0,,0,1,1,3,1,0,0,0,9,8.4
Emmanuel Mudiay,20-361,G,3/1/17,DEN,MIL,0,18,4,9,0.444,3,6,0.5,1,3,0.333,0,0,,0,4,4,1,0,0,1,0,9,5.2
Zaza Pachulia,33-028,C,3/10/17,GSW,MIN,1,26,4,4,1,4,4,1,0,0,,1,2,0.5,1,4,5,3,3,1,1,6,9,11.7
Courtney Lee,31-064,G,12/6/16,NYK,MIA,1,30,4,7,0.571,3,6,0.5,1,1,1,0,0,,1,6,7,1,0,0,2,1,9,6.5
Jae Crowder,26-243,F,3/6/17,BOS,LAC,1,35,3,13,0.231,2,6,0.333,1,7,0.143,2,2,1,0,8,8,2,0,0,0,3,9,3.7
Patrick McCaw,21-167,G,4/10/17,GSW,UTA,1,27,4,9,0.444,3,6,0.5,1,3,0.333,0,0,,0,0,0,0,0,0,0,2,9,3.5
Dante Cunningham,29-262,F,1/9/17,NOP,NYK,1,30,3,5,0.6,0,2,0,3,3,1,0,0,,1,2,3,0,1,0,0,1,9,8.6
Iman Shumpert,26-263,G,3/16/17,CLE,UTA,1,22,4,11,0.364,3,5,0.6,1,6,0.167,0,0,,0,3,3,0,0,0,0,1,9,3.4
Wayne Ellington,29-118,G,2/24/17,MIA,ATL,0,22,3,11,0.273,0,2,0,3,9,0.333,0,1,0,0,1,1,0,0,0,2,3,9,-0.8
Aaron Gordon,21-160,F,2/23/17,ORL,POR,1,29,4,9,0.444,4,7,0.571,0,2,0,1,2,0.5,5,4,9,2,0,2,0,1,9,11
Justin Holiday,27-311,G,2/10/17,NYK,DEN,0,20,3,8,0.375,0,0,,3,8,0.375,0,0,,0,2,2,2,2,0,1,0,9,7.6
Michael Kidd-Gilchrist,23-175,F,3/20/17,CHO,ATL,1,21,4,8,0.5,4,8,0.5,0,0,,1,2,0.5,1,1,2,3,3,0,0,0,9,10.7
Kyle Korver,35-265,G-F,12/7/16,ATL,MIA,0,34,3,9,0.333,1,3,0.333,2,6,0.333,1,1,1,0,3,3,5,0,0,1,3,9,6.1
Al-Farouq Aminu,26-121,F,1/20/17,POR,PHI,0,22,3,6,0.5,2,5,0.4,1,1,1,2,2,1,1,8,9,1,1,0,2,5,9,6.8
Richard Jefferson,36-179,F,12/17/16,CLE,LAL,0,18,4,7,0.571,3,5,0.6,1,2,0.5,0,0,,1,1,2,0,0,1,0,2,9,6.6
Wayne Ellington,29-130,G,3/8/17,MIA,CHO,0,22,3,10,0.3,0,2,0,3,8,0.375,0,0,,0,1,1,0,1,0,0,2,9,3.7
Ish Smith,28-260,G,3/22/17,DET,CHI,1,25,4,10,0.4,3,9,0.333,1,1,1,0,0,,0,1,1,7,3,0,2,4,9,8.2
Andre Drummond,23-156,C,1/13/17,DET,UTA,1,33,4,7,0.571,4,7,0.571,0,0,,1,4,0.25,2,17,19,1,1,0,1,3,9,10.5
Jodie Meeks,29-211,G,3/20/17,ORL,PHI,0,20,1,9,0.111,1,6,0.167,0,3,0,7,9,0.778,0,4,4,0,0,0,1,1,9,2.1
Tristan Thompson,26-012,F-C,3/25/17,CLE,WAS,1,27,4,4,1,4,4,1,0,0,,1,2,0.5,4,0,4,4,2,1,2,1,9,13.3
Cody Zeller,24-065,F-C,12/9/16,CHO,ORL,1,22,4,5,0.8,4,5,0.8,0,0,,1,2,0.5,4,3,7,1,1,0,1,1,9,10.7
Brandon Ingram,19-088,F,11/29/16,LAL,NOP,0,29,4,10,0.4,3,7,0.429,1,3,0.333,0,1,0,0,3,3,5,2,1,1,1,9,8.9
Nick Young,31-165,G-F,11/13/16,LAL,MIN,1,24,3,9,0.333,2,2,1,1,7,0.143,2,2,1,0,1,1,1,0,0,1,3,9,2.7
Jamal Murray,19-344,G,2/1/17,DEN,MEM,0,32,3,16,0.188,2,9,0.222,1,7,0.143,2,2,1,1,3,4,2,3,1,1,1,9,4.3
John Wall,26-127,G,1/11/17,WAS,BOS,1,39,4,21,0.19,4,16,0.25,0,5,0,1,2,0.5,3,4,7,11,3,1,1,2,9,8.4
Chandler Parsons,28-020,F,11/14/16,MEM,UTA,1,23,3,6,0.5,3,4,0.75,0,2,0,3,3,1,0,4,4,1,0,0,1,2,9,6.1
Marcus Morris,27-106,F,12/17/16,DET,IND,1,34,4,7,0.571,3,4,0.75,1,3,0.333,0,0,,0,1,1,1,1,0,1,3,9,5.5
Will Barton,26-057,G,3/4/17,DEN,CHO,0,31,3,11,0.273,2,7,0.286,1,4,0.25,2,2,1,1,3,4,4,0,1,1,5,9,4.6
Montrezl Harrell,22-329,F-C,12/20/16,HOU,SAS,0,22,4,7,0.571,4,7,0.571,0,0,,1,3,0.333,2,3,5,2,1,0,1,2,9,7.8
Gordon Hayward,26-307,F-G,1/24/17,UTA,DEN,1,35,2,10,0.2,0,7,0,2,3,0.667,3,3,1,1,5,6,3,0,0,3,1,9,3.7
Jordan Clarkson,24-252,G,2/14/17,LAL,SAC,0,28,4,8,0.5,4,7,0.571,0,1,0,1,2,0.5,1,6,7,2,1,1,3,3,9,6
Aaron Gordon,21-084,F,12/9/16,ORL,CHO,1,29,4,8,0.5,3,6,0.5,1,2,0.5,0,0,,2,1,3,2,2,0,1,1,9,8.7
Jerian Grant,24-093,G,1/10/17,CHI,WAS,1,25,2,5,0.4,1,4,0.25,1,1,1,4,4,1,0,2,2,6,1,0,5,1,9,6.7
Mike Muscala,25-193,F-C,1/10/17,ATL,BRK,0,23,3,6,0.5,2,4,0.5,1,2,0.5,2,2,1,0,4,4,0,1,2,0,3,9,8.4
Dirk Nowitzki,38-229,F,2/3/17,DAL,POR,1,32,3,9,0.333,0,4,0,3,5,0.6,0,0,,0,5,5,2,0,0,0,1,9,6.4
DeAndre Jordan,28-165,C,1/2/17,LAC,PHO,1,31,3,6,0.5,3,6,0.5,0,0,,3,8,0.375,7,13,20,2,0,3,3,3,9,12.1
Kay Felder,21-232,G,11/16/16,CLE,IND,0,13,2,4,0.5,2,4,0.5,0,0,,5,6,0.833,0,3,3,2,0,0,2,1,9,6.5
Tyler Ulis,20-319,G,11/19/16,PHO,PHI,0,22,3,7,0.429,3,7,0.429,0,0,,3,4,0.75,0,4,4,5,4,0,0,1,9,13.2
Justin Hamilton,26-306,C,2/1/17,BRK,NYK,0,19,3,4,0.75,2,3,0.667,1,1,1,2,2,1,2,1,3,0,0,2,1,0,9,9.5
Jameer Nelson,34-271,G,11/6/16,DEN,BOS,0,36,3,7,0.429,2,4,0.5,1,3,0.333,2,2,1,0,3,3,7,1,0,2,5,9,8.1
Jason Terry,39-085,G,12/9/16,MIL,ATL,0,20,3,5,0.6,0,0,,3,5,0.6,0,0,,1,3,4,2,0,0,1,1,9,8.3
Montrezl Harrell,22-296,F-C,11/17/16,HOU,POR,0,21,4,13,0.308,4,13,0.308,0,0,,1,1,1,4,5,9,3,0,0,2,2,9,5.1
Sergio Rodriguez,30-191,G,12/20/16,PHI,NOP,1,31,3,11,0.273,1,4,0.25,2,7,0.286,1,2,0.5,0,2,2,3,1,0,0,2,9,5
Marcus Thornton,29-160,G,11/12/16,WAS,CHI,0,23,4,14,0.286,4,10,0.4,0,4,0,1,1,1,2,2,4,1,1,0,0,0,9,4.5
Wayne Ellington,29-104,G,2/10/17,MIA,BRK,1,25,3,9,0.333,0,1,0,3,8,0.375,0,0,,0,4,4,2,1,0,0,2,9,6.7
Josh Richardson,23-098,G,12/22/16,MIA,LAL,1,37,4,11,0.364,3,8,0.375,1,3,0.333,0,0,,1,4,5,3,0,1,2,2,9,4.8
Cody Zeller,24-127,F-C,2/9/17,CHO,HOU,1,22,4,8,0.5,4,8,0.5,0,0,,1,1,1,2,2,4,1,2,0,3,3,9,5.5
Allen Crabbe,24-250,G-F,12/15/16,POR,DEN,0,28,2,6,0.333,1,3,0.333,1,3,0.333,4,4,1,1,3,4,0,0,0,1,5,9,4.2
Bismack Biyombo,24-069,C-F,11/5/16,ORL,WAS,0,24,4,6,0.667,4,6,0.667,0,0,,1,4,0.25,3,9,12,1,0,3,1,3,9,10.6
C.J. Miles,29-359,G-F,4/12/17,IND,ATL,0,21,3,8,0.375,0,1,0,3,7,0.429,0,0,,0,2,2,1,0,0,0,1,9,5.5
A.J. Hammons,24-074,C,11/9/16,DAL,GSW,0,6,3,5,0.6,2,4,0.5,1,1,1,2,2,1,2,1,3,0,0,0,0,1,9,8
Elfrid Payton,22-296,G,12/14/16,ORL,LAC,0,26,4,12,0.333,3,9,0.333,1,3,0.333,0,0,,0,3,3,9,2,1,1,4,9,9.5
Brandon Bass,31-299,F,2/23/17,LAC,GSW,0,13,3,5,0.6,3,5,0.6,0,0,,3,4,0.75,1,3,4,0,1,0,0,3,9,7.7
Henry Ellenson,20-086,F,4/9/17,DET,MEM,0,28,3,11,0.273,0,5,0,3,6,0.5,0,0,,2,7,9,2,0,0,3,1,9,4
Brook Lopez,28-330,C,2/25/17,BRK,GSW,1,31,3,13,0.231,1,7,0.143,2,6,0.333,1,4,0.25,0,4,4,5,1,1,4,3,9,1.1
Marco Belinelli,30-233,G-F,11/13/16,CHO,CLE,0,21,3,7,0.429,0,3,0,3,4,0.75,0,0,,0,1,1,1,1,0,0,1,9,6.9
Rajon Rondo,30-271,G,11/19/16,CHI,LAC,1,35,4,7,0.571,3,4,0.75,1,3,0.333,0,0,,4,6,10,8,2,0,3,3,9,13.7
P.J. Tucker,31-318,F,3/19/17,TOR,IND,0,26,4,9,0.444,3,5,0.6,1,4,0.25,0,0,,0,4,4,2,1,0,1,1,9,6.5
Justin Anderson,22-344,G,10/28/16,DAL,HOU,0,20,2,5,0.4,1,2,0.5,1,3,0.333,4,6,0.667,1,2,3,0,2,1,2,0,9,7.5
Gerald Henderson,28-359,G,12/2/16,PHI,ORL,1,22,4,7,0.571,3,6,0.5,1,1,1,0,0,,1,2,3,0,0,0,0,3,9,5.8
Spencer Dinwiddie,23-340,G,3/12/17,BRK,NYK,0,28,3,5,0.6,1,3,0.333,2,2,1,1,2,0.5,1,1,2,6,1,1,0,1,9,12.8
Bobby Portis,22-039,F,3/21/17,CHI,TOR,0,21,3,8,0.375,2,4,0.5,1,4,0.25,2,2,1,0,5,5,0,0,0,0,3,9,4.9
Jaylen Brown,20-096,F,1/28/17,BOS,MIL,1,28,3,9,0.333,2,6,0.333,1,3,0.333,2,2,1,1,7,8,1,2,1,1,3,9,7.9
JaVale McGee,29-064,C,3/24/17,GSW,SAC,0,12,3,5,0.6,3,5,0.6,0,0,,3,3,1,6,4,10,1,1,0,1,1,9,12.4
Alex Len,23-150,C,11/13/16,PHO,GSW,1,18,4,5,0.8,4,5,0.8,0,0,,1,1,1,1,5,6,3,0,0,3,5,9,6.4
Luc Mbah a Moute,30-202,F,3/30/17,LAC,PHO,1,32,3,5,0.6,1,3,0.333,2,2,1,1,2,0.5,0,1,1,0,1,0,2,0,9,5.6
Aaron Gordon,21-070,F,11/25/16,ORL,WAS,0,25,4,10,0.4,3,6,0.5,1,4,0.25,0,2,0,3,4,7,1,0,0,2,1,9,4.4
Pau Gasol,36-140,F-C,11/23/16,SAS,CHO,1,30,4,8,0.5,3,6,0.5,1,2,0.5,0,0,,1,7,8,5,3,1,0,0,9,15
Tarik Black,25-040,C-F,1/1/17,LAL,TOR,0,14,2,6,0.333,2,6,0.333,0,0,,5,5,1,3,6,9,0,0,0,0,3,9,8.3
Jameer Nelson,34-315,G,12/20/16,DEN,LAC,0,22,4,7,0.571,3,4,0.75,1,3,0.333,0,0,,0,1,1,6,0,0,3,4,9,5.6
Iman Shumpert,26-251,G,3/4/17,CLE,MIA,1,27,3,7,0.429,2,5,0.4,1,2,0.5,2,2,1,0,0,0,2,1,0,1,0,9,6.7
Mike Muscala,25-188,F-C,1/5/17,ATL,NOP,0,20,4,9,0.444,3,8,0.375,1,1,1,0,0,,4,2,6,0,1,1,0,1,9,9
Sasha Vujacic,33-023,G,3/31/17,NYK,MIA,1,36,4,12,0.333,3,7,0.429,1,5,0.2,0,0,,1,3,4,7,1,0,1,3,9,7.5
Terrence Ross,25-307,F-G,12/8/16,TOR,MIN,0,16,3,7,0.429,2,2,1,1,5,0.2,2,2,1,0,0,0,1,2,0,0,1,9,7.6
Marcus Smart,22-334,G,2/3/17,BOS,LAL,0,32,3,10,0.3,1,5,0.2,2,5,0.4,1,2,0.5,0,3,3,7,5,0,4,1,9,9.2
Danny Green,29-260,G-F,3/9/17,SAS,OKC,1,28,3,5,0.6,1,1,1,2,4,0.5,1,1,1,0,2,2,3,2,2,4,2,9,8
Isaiah Whitehead,22-018,G,3/26/17,BRK,ATL,0,26,4,7,0.571,4,6,0.667,0,1,0,1,2,0.5,1,1,2,3,3,1,1,1,9,10.7
Andrew Harrison,22-054,G,12/21/16,MEM,DET,0,27,1,1,1,0,0,,1,1,1,6,6,1,1,3,4,6,0,0,1,3,9,12.3
Allen Crabbe,24-255,G-F,12/20/16,POR,SAC,0,36,4,7,0.571,4,6,0.667,0,1,0,1,2,0.5,0,0,0,0,0,0,2,2,9,2.5
Wesley Johnson,29-196,F-G,1/23/17,LAC,ATL,0,19,4,7,0.571,3,5,0.6,1,2,0.5,0,0,,2,6,8,2,1,0,0,0,9,11.3
DeAndre Jordan,28-163,C,12/31/16,LAC,OKC,1,27,4,5,0.8,4,5,0.8,0,0,,1,2,0.5,3,8,11,2,0,3,3,4,9,10.1
Amir Johnson,29-336,F,4/2/17,BOS,NYK,1,20,4,5,0.8,3,4,0.75,1,1,1,0,0,,1,2,3,0,0,0,3,3,9,4.2
Amir Johnson,29-197,F,11/14/16,BOS,NOP,1,27,3,7,0.429,2,4,0.5,1,3,0.333,2,2,1,2,3,5,4,0,0,0,6,9,8
Nikola Jokic,21-261,C-F,11/6/16,DEN,BOS,1,22,4,5,0.8,4,4,1,0,1,0,1,1,1,0,5,5,2,1,1,1,2,9,9.9
Andre Drummond,23-129,C,12/17/16,DET,IND,1,35,4,11,0.364,4,11,0.364,0,0,,1,4,0.25,7,8,15,0,2,1,2,4,9,8.1
Dario Saric,22-363,F,4/6/17,PHI,CHI,1,22,3,8,0.375,2,5,0.4,1,3,0.333,2,4,0.5,1,9,10,1,1,1,2,0,9,7.6
Tony Snell,25-009,G-F,11/19/16,MIL,GSW,1,29,4,7,0.571,3,5,0.6,1,2,0.5,0,0,,0,6,6,1,0,0,2,3,9,5
P.J. Tucker,31-335,F,4/5/17,TOR,DET,0,28,3,4,0.75,0,0,,3,4,0.75,0,0,,0,5,5,1,1,0,1,0,9,9.6
Kyle O'Quinn,26-336,F-C,2/25/17,NYK,PHI,0,25,3,6,0.5,3,6,0.5,0,0,,3,4,0.75,3,2,5,5,5,2,1,3,9,16
Leandro Barbosa,33-338,G,10/31/16,PHO,LAC,0,13,4,5,0.8,3,3,1,1,2,0.5,0,0,,0,2,2,1,1,0,0,1,9,9
Cody Zeller,24-085,F-C,12/29/16,CHO,MIA,1,33,3,4,0.75,3,4,0.75,0,0,,3,6,0.5,2,5,7,2,1,1,2,3,9,9
Chandler Parsons,28-014,F,11/8/16,MEM,DEN,1,21,4,8,0.5,4,5,0.8,0,3,0,1,1,1,0,3,3,2,1,0,2,2,9,5.5
Andrew Harrison,22-002,G,10/30/16,MEM,WAS,0,30,3,8,0.375,2,4,0.5,1,4,0.25,2,3,0.667,1,0,1,3,0,0,0,5,9,5
Nicolas Brussino,24-034,G-F,4/5/17,DAL,LAC,0,9,3,7,0.429,1,3,0.333,2,4,0.5,1,1,1,2,2,4,1,0,1,1,0,9,7.7
Michael Kidd-Gilchrist,23-060,F,11/25/16,CHO,NYK,1,29,4,6,0.667,4,6,0.667,0,0,,1,2,0.5,0,2,2,1,0,1,2,2,9,5.2
Nicolas Batum,28-109,F-G,4/2/17,CHO,OKC,1,31,3,8,0.375,2,4,0.5,1,4,0.25,2,2,1,0,7,7,8,3,0,1,1,9,13.9
Evan Turner,28-060,G,12/26/16,POR,TOR,0,27,3,9,0.333,2,6,0.333,1,3,0.333,2,2,1,0,3,3,5,2,0,5,1,9,4.9
Evan Fournier,24-098,G-F,2/4/17,ORL,ATL,1,32,3,12,0.25,3,9,0.333,0,3,0,3,3,1,2,2,4,3,1,0,4,0,9,2.9
Nicolas Batum,28-022,F-G,1/5/17,CHO,DET,1,25,1,8,0.125,1,6,0.167,0,2,0,7,7,1,0,4,4,5,0,0,2,2,9,5.7
Brandon Rush,31-218,G-F,2/10/17,MIN,NOP,1,25,3,7,0.429,1,2,0.5,2,5,0.4,1,2,0.5,0,3,3,1,0,0,0,2,9,5.7
Rondae Hollis-Jefferson,21-348,F,12/16/16,BRK,ORL,0,19,3,3,1,3,3,1,0,0,,3,4,0.75,1,4,5,0,0,0,0,1,9,9.2
Jae Crowder,26-177,F,12/30/16,BOS,MIA,1,31,3,8,0.375,0,2,0,3,6,0.5,0,0,,0,2,2,6,1,0,1,1,9,9
Rodney McGruder,25-252,G,4/7/17,MIA,TOR,1,27,4,9,0.444,4,7,0.571,0,2,0,1,1,1,2,3,5,2,0,0,3,1,9,4.6
Steven Adams,23-258,C,4/4/17,OKC,MIL,1,24,4,7,0.571,4,7,0.571,0,0,,1,2,0.5,4,1,5,1,0,0,1,2,9,7.3
Domantas Sabonis,20-228,F,12/17/16,OKC,PHO,1,24,3,9,0.333,2,8,0.25,1,1,1,2,4,0.5,0,4,4,0,1,1,1,3,9,3.8
Derrick Williams,25-282,F,3/3/17,CLE,ATL,0,18,3,5,0.6,0,1,0,3,4,0.75,0,0,,0,1,1,1,1,1,1,1,9,8
Al-Farouq Aminu,26-186,F,3/26/17,POR,LAL,0,26,3,6,0.5,2,4,0.5,1,2,0.5,2,3,0.667,1,9,10,4,0,1,1,2,9,10.7
JaVale McGee,28-349,C,1/2/17,GSW,DEN,0,9,4,4,1,4,4,1,0,0,,1,3,0.333,1,3,4,0,1,0,0,0,9,9.6
Brandon Ingram,19-054,F,10/26/16,LAL,HOU,0,24,4,6,0.667,3,4,0.75,1,2,0.5,0,0,,0,3,3,0,0,0,1,0,9,6.3
Trey Lyles,21-033,F,12/8/16,UTA,GSW,0,23,4,13,0.308,3,7,0.429,1,6,0.167,0,0,,2,4,6,2,1,0,2,4,9,2.9
Mike Conley,29-071,G,12/21/16,MEM,DET,1,24,3,10,0.3,0,3,0,3,7,0.429,0,0,,0,5,5,4,2,0,1,4,9,6.9
Justin Anderson,23-084,G,2/11/17,DAL,ORL,0,17,3,5,0.6,3,3,1,0,2,0,3,4,0.75,0,3,3,1,1,0,3,0,9,5.9
Mirza Teletovic,31-093,F,12/20/16,MIL,CLE,0,19,4,9,0.444,3,4,0.75,1,5,0.2,0,0,,1,4,5,0,0,0,1,2,9,4.4
Cory Joseph,25-225,G,4/2/17,TOR,PHI,1,32,4,9,0.444,3,6,0.5,1,3,0.333,0,2,0,0,5,5,6,1,0,3,1,9,6.8
Manu Ginobili,39-099,G,11/4/16,SAS,UTA,0,14,4,7,0.571,3,6,0.5,1,1,1,0,0,,0,3,3,0,0,1,1,2,9,5.5
Caris LeVert,22-219,G-F,4/1/17,BRK,ORL,1,20,4,8,0.5,3,4,0.75,1,4,0.25,0,0,,0,3,3,0,0,0,0,1,9,5.5
Giannis Antetokounmpo,22-083,F-G,2/27/17,MIL,CLE,1,42,4,13,0.308,4,11,0.364,0,2,0,1,4,0.25,0,7,7,8,0,1,3,3,9,4.5
Kelly Olynyk,25-346,C-F,3/31/17,BOS,ORL,0,16,3,7,0.429,2,5,0.4,1,2,0.5,2,2,1,2,2,4,2,1,0,0,4,9,8.1
Marquese Chriss,19-248,F,3/7/17,PHO,WAS,1,26,3,5,0.6,1,3,0.333,2,2,1,1,2,0.5,2,3,5,0,1,1,1,6,9,6.9
Norman Powell,23-300,G,3/21/17,TOR,CHI,0,17,3,9,0.333,3,7,0.429,0,2,0,3,5,0.6,1,1,2,1,0,0,1,0,9,3.8
Marcin Gortat,32-297,C-F,12/10/16,WAS,MIL,1,35,4,8,0.5,4,8,0.5,0,0,,1,2,0.5,7,7,14,2,0,0,2,2,9,10.2
Tyson Chandler,34-035,C,11/6/16,PHO,LAL,1,30,4,4,1,4,4,1,0,0,,1,2,0.5,2,10,12,0,3,0,3,2,9,11
Otto Porter,23-192,F,12/12/16,WAS,MIA,1,37,4,7,0.571,3,4,0.75,1,3,0.333,0,1,0,0,4,4,0,0,0,1,2,9,4.7
Beno Udrih,34-130,G,11/12/16,DET,DEN,0,18,4,7,0.571,3,4,0.75,1,3,0.333,0,0,,0,0,0,5,0,0,0,0,9,9.2
Cody Zeller,24-187,F-C,4/10/17,CHO,MIL,1,27,3,8,0.375,3,8,0.375,0,0,,3,3,1,0,6,6,1,0,1,1,2,9,6
Elfrid Payton,23-001,G,2/23/17,ORL,POR,1,22,4,8,0.5,4,7,0.571,0,1,0,1,4,0.25,1,1,2,3,0,1,4,1,9,3.2
Devin Harris,33-352,G,2/13/17,DAL,BOS,0,19,2,6,0.333,1,3,0.333,1,3,0.333,4,5,0.8,0,1,1,0,0,0,1,0,9,4.5
Meyers Leonard,24-284,C-F,12/7/16,POR,MIL,0,15,3,6,0.5,0,1,0,3,5,0.6,0,0,,0,3,3,1,0,1,0,4,9,6.7
Kyle Korver,35-265,G-F,12/7/16,ATL,MIA,0,34,3,9,0.333,1,3,0.333,2,6,0.333,1,1,1,0,3,3,5,0,0,1,3,9,6.1
J.J. Redick,32-128,G,10/30/16,LAC,UTA,1,28,4,8,0.5,3,5,0.6,1,3,0.333,0,0,,0,0,0,0,2,0,0,2,9,6.2
Thabo Sefolosha,32-310,G-F,3/8/17,ATL,BRK,1,31,4,8,0.5,4,5,0.8,0,3,0,1,2,0.5,1,7,8,3,3,1,1,4,9,10.6
Tobias Harris,24-129,F,11/21/16,DET,HOU,1,21,4,8,0.5,4,7,0.571,0,1,0,1,1,1,1,1,2,1,0,0,2,4,9,3.1
Justin Hamilton,26-312,C,2/7/17,BRK,CHO,0,21,3,6,0.5,2,2,1,1,4,0.25,2,2,1,2,5,7,2,1,0,0,1,9,10.9
Wilson Chandler,29-261,F,1/26/17,DEN,PHO,0,31,2,6,0.333,1,5,0.2,1,1,1,4,5,0.8,3,6,9,5,0,0,0,2,9,11.8
Mirza Teletovic,31-106,F,1/2/17,MIL,OKC,0,16,3,7,0.429,1,2,0.5,2,5,0.4,1,1,1,0,2,2,2,0,0,0,1,9,6.9
Dion Waiters,24-325,G,10/30/16,MIA,SAS,1,33,3,9,0.333,1,6,0.167,2,3,0.667,1,2,0.5,0,2,2,3,1,1,6,3,9,0.7
Joe Johnson,35-141,G-F,11/17/16,UTA,CHI,0,22,3,4,0.75,2,2,1,1,2,0.5,2,2,1,0,5,5,2,0,0,1,1,9,8.9
Ersan Ilyasova,29-285,F,2/24/17,ATL,MIA,0,16,3,7,0.429,3,5,0.6,0,2,0,3,3,1,1,1,2,0,1,0,0,0,9,7.3
Al Horford,30-271,C-F,3/1/17,BOS,CLE,1,32,3,6,0.5,2,5,0.4,1,1,1,2,2,1,2,8,10,10,0,1,2,1,9,15.1
Kenneth Faried,27-097,F,2/24/17,DEN,BRK,1,16,3,4,0.75,3,4,0.75,0,0,,3,4,0.75,2,4,6,0,0,0,0,1,9,9.2
Kosta Koufos,28-022,C,3/18/17,SAC,OKC,1,23,3,8,0.375,3,8,0.375,0,0,,3,4,0.75,2,4,6,2,0,1,1,2,9,7.1
E'Twaun Moore,27-287,G,12/11/16,NOP,PHO,0,22,3,7,0.429,1,3,0.333,2,4,0.5,1,2,0.5,0,2,2,0,1,0,2,3,9,3.3
Zach Randolph,35-157,F,12/20/16,MEM,BOS,0,21,4,14,0.286,4,12,0.333,0,2,0,1,2,0.5,2,3,5,2,0,1,0,2,9,4
Isaiah Whitehead,21-293,G,12/26/16,BRK,CHO,0,16,4,7,0.571,3,5,0.6,1,2,0.5,0,0,,0,2,2,3,1,1,4,4,9,4.5
Jon Leuer,27-165,F,10/26/16,DET,TOR,0,23,3,8,0.375,2,6,0.333,1,2,0.5,2,2,1,1,8,9,0,1,0,1,3,9,6.5
Myles Turner,20-294,F-C,1/12/17,IND,DEN,1,21,4,13,0.308,3,12,0.25,1,1,1,0,0,,2,4,6,0,0,1,0,5,9,2.8
Justin Anderson,23-037,G,12/26/16,DAL,NOP,0,13,4,6,0.667,3,4,0.75,1,2,0.5,0,0,,1,1,2,0,0,1,1,0,9,7.1
Stanley Johnson,20-231,F,1/15/17,DET,LAL,0,34,4,9,0.444,3,6,0.5,1,3,0.333,0,0,,0,4,4,6,1,1,1,3,9,9.2
Nikola Mirotic,25-349,F,1/25/17,CHI,ATL,0,18,3,11,0.273,2,6,0.333,1,5,0.2,2,2,1,0,3,3,1,0,0,2,4,9,0.5
Ron Baker,24-005,G,4/4/17,NYK,CHI,1,37,4,7,0.571,3,5,0.6,1,2,0.5,0,1,0,0,3,3,6,1,1,4,3,9,6.9
Steven Adams,23-243,C,3/20/17,OKC,GSW,1,22,4,5,0.8,4,5,0.8,0,0,,1,4,0.25,1,0,1,0,0,0,2,1,9,4.2
Otto Porter,23-305,F,4/4/17,WAS,CHO,1,25,3,8,0.375,2,4,0.5,1,4,0.25,2,2,1,0,4,4,4,0,0,0,0,9,8.6
Jamal Murray,19-257,G,11/6/16,DEN,BOS,0,13,3,7,0.429,1,3,0.333,2,4,0.5,1,1,1,0,1,1,0,0,0,0,0,9,5.6
Chandler Parsons,28-075,F,1/8/17,MEM,UTA,1,16,3,4,0.75,1,1,1,2,3,0.667,1,1,1,0,1,1,1,0,0,0,1,9,8
Juan Hernangomez,21-196,F,4/12/17,DEN,OKC,1,35,4,17,0.235,3,8,0.375,1,9,0.111,0,0,,0,7,7,1,0,0,1,3,9,-0.7
Nene Hilario,34-211,F-C,4/12/17,HOU,MIN,0,17,4,7,0.571,4,7,0.571,0,0,,1,2,0.5,1,1,2,0,1,1,1,1,9,6.6
Patrick McCaw,21-123,G,2/25/17,GSW,BRK,1,25,3,7,0.429,2,2,1,1,5,0.2,2,2,1,0,4,4,1,0,2,0,1,9,8.2
Cory Joseph,25-205,G,3/13/17,TOR,DAL,1,26,4,10,0.4,3,6,0.5,1,4,0.25,0,0,,1,0,1,4,0,0,1,0,9,6.1
Justin Anderson,23-129,G,3/28/17,PHI,BRK,0,22,4,14,0.286,3,9,0.333,1,5,0.2,0,0,,2,5,7,1,0,2,1,2,9,4
Justin Harper,27-186,F,3/4/17,PHI,DET,0,23,4,10,0.4,3,5,0.6,1,5,0.2,0,0,,2,2,4,1,0,0,3,2,9,2.5
Shaun Livingston,31-115,G,1/4/17,GSW,POR,0,18,4,6,0.667,4,6,0.667,0,0,,1,1,1,1,3,4,1,0,0,2,0,9,6.7
Matthew Dellavedova,26-098,G,12/15/16,MIL,CHI,1,29,4,7,0.571,3,6,0.5,1,1,1,0,0,,1,0,1,9,0,0,2,1,9,10.3
Terry Rozier,22-347,G,2/27/17,BOS,ATL,0,20,4,9,0.444,3,7,0.429,1,2,0.5,0,0,,1,4,5,1,0,0,2,0,9,4.9
Jamal Murray,19-267,G,11/16/16,DEN,PHO,0,20,3,8,0.375,0,4,0,3,4,0.75,0,0,,0,1,1,1,0,0,0,1,9,5.2
Nicolas Batum,27-362,F-G,12/10/16,CHO,CLE,1,33,4,12,0.333,4,8,0.5,0,4,0,1,2,0.5,0,6,6,4,1,0,3,2,9,3.6
Ramon Sessions,30-268,G,1/4/17,CHO,OKC,0,15,3,5,0.6,2,3,0.667,1,2,0.5,2,3,0.667,0,2,2,3,0,0,1,0,9,8
Bojan Bogdanovic,27-357,G-F,4/10/17,WAS,DET,0,18,3,7,0.429,2,5,0.4,1,2,0.5,2,2,1,0,4,4,0,0,0,1,0,9,5.5
Al-Farouq Aminu,26-034,F,10/25/16,POR,UTA,1,28,3,6,0.5,1,3,0.333,2,3,0.667,1,1,1,0,4,4,1,1,0,1,0,9,7.9
Alan Williams,24-063,F-C,4/1/17,PHO,POR,0,16,4,7,0.571,4,7,0.571,0,0,,1,2,0.5,3,2,5,0,0,1,1,2,9,6.9
Tarik Black,25-001,C-F,11/23/16,LAL,GSW,0,15,2,9,0.222,2,8,0.25,0,1,0,5,6,0.833,1,4,5,0,1,0,0,4,9,4.4
Marquese Chriss,19-274,F,4/2/17,PHO,HOU,1,28,4,10,0.4,4,6,0.667,0,4,0,1,4,0.25,3,3,6,1,0,4,3,3,9,4.7
Matthew Dellavedova,26-139,G,1/25/17,MIL,PHI,1,29,4,10,0.4,3,8,0.375,1,2,0.5,0,0,,0,0,0,5,2,0,2,2,9,6.3
Nik Stauskas,23-145,G,3/1/17,PHI,MIA,0,26,3,12,0.25,2,9,0.222,1,3,0.333,2,3,0.667,0,2,2,0,1,0,1,2,9,1.2
Deron Williams,32-157,G,11/30/16,DAL,SAS,1,26,4,12,0.333,3,9,0.333,1,3,0.333,0,0,,1,7,8,5,0,0,2,4,9,4.9
Joffrey Lauvergne,25-074,C-F,12/13/16,OKC,POR,0,16,3,7,0.429,2,5,0.4,1,2,0.5,2,2,1,3,0,3,2,1,0,0,2,9,9
Aaron Gordon,21-068,F,11/23/16,ORL,PHO,0,20,4,11,0.364,3,8,0.375,1,3,0.333,0,0,,0,2,2,0,0,1,2,3,9,1
Danny Green,29-179,G-F,12/18/16,SAS,NOP,1,25,3,5,0.6,0,0,,3,5,0.6,0,0,,0,5,5,2,1,1,0,1,9,10.9
Kelly Olynyk,25-220,C-F,11/25/16,BOS,SAS,0,20,4,6,0.667,3,4,0.75,1,2,0.5,0,0,,1,0,1,1,3,0,0,0,9,10.8
Ramon Sessions,30-229,G,11/26/16,CHO,NYK,0,15,2,3,0.667,1,1,1,1,2,0.5,4,7,0.571,1,1,2,3,0,0,2,1,9,7.2
Raymond Felton,32-253,G,3/6/17,LAC,BOS,0,20,2,3,0.667,2,3,0.667,0,0,,5,5,1,0,3,3,5,2,2,1,0,9,14.5
JaVale McGee,28-329,C,12/13/16,GSW,NOP,1,16,4,5,0.8,4,5,0.8,0,0,,1,2,0.5,1,4,5,0,0,0,0,0,9,8.6
Rodney Hood,24-137,G-F,3/6/17,UTA,NOP,0,20,2,7,0.286,1,3,0.333,1,4,0.25,4,4,1,0,1,1,0,2,0,2,2,9,4.4
Kyle Korver,35-308,G-F,1/19/17,CLE,PHO,0,25,3,10,0.3,0,1,0,3,9,0.333,0,0,,0,5,5,0,2,0,2,1,9,4.3
Clint Capela,22-269,F-C,2/11/17,HOU,PHO,1,18,3,4,0.75,3,4,0.75,0,0,,3,4,0.75,2,3,5,2,0,1,1,2,9,9.6
Andre Drummond,23-083,C,11/1/16,DET,NYK,1,35,4,13,0.308,4,13,0.308,0,0,,1,6,0.167,2,11,13,2,2,1,1,1,9,6.9
Langston Galloway,25-038,G,1/16/17,NOP,IND,0,24,3,8,0.375,0,2,0,3,6,0.5,0,0,,0,4,4,0,1,0,1,2,9,5
Eric Gordon,27-334,G,11/23/16,HOU,TOR,0,28,4,13,0.308,3,5,0.6,1,8,0.125,0,0,,0,1,1,2,1,1,4,2,9,0.1
Mario Hezonja,21-254,F-G,11/5/16,ORL,WAS,0,26,4,9,0.444,4,5,0.8,0,4,0,1,2,0.5,0,2,2,2,1,0,0,0,9,6.9
Kosta Koufos,27-345,C,2/3/17,SAC,PHO,1,16,4,6,0.667,4,6,0.667,0,0,,1,1,1,1,4,5,0,0,0,0,1,9,7.9
Jordan McRae,25-233,G,11/16/16,CLE,IND,0,24,3,12,0.25,1,9,0.111,2,3,0.667,1,2,0.5,0,0,0,0,0,1,1,0,9,1.1
Tobias Harris,24-117,F,11/9/16,DET,PHO,1,32,3,12,0.25,2,10,0.2,1,2,0.5,2,2,1,0,3,3,2,1,2,2,1,9,4.1
Joe Ingles,29-097,F-G,1/7/17,UTA,MIN,0,24,3,6,0.5,2,2,1,1,4,0.25,2,2,1,1,1,2,4,4,0,1,0,9,12.8
Terrence Jones,25-005,F,1/14/17,NOP,CHI,1,34,4,6,0.667,4,6,0.667,0,0,,1,2,0.5,1,7,8,2,0,2,0,2,9,10.8
Jamal Crawford,36-346,G,3/1/17,LAC,HOU,0,16,4,8,0.5,3,5,0.6,1,3,0.333,0,0,,0,0,0,2,0,0,0,1,9,6
Corey Brewer,30-335,F-G,2/3/17,HOU,CHI,0,12,4,5,0.8,4,5,0.8,0,0,,1,2,0.5,1,1,2,0,1,0,1,1,9,7.3
Spencer Dinwiddie,23-277,G,1/8/17,BRK,PHI,0,25,3,5,0.6,3,5,0.6,0,0,,3,4,0.75,0,3,3,3,0,2,1,0,9,9.7
Darren Collison,29-125,G,12/26/16,SAC,PHI,1,28,4,10,0.4,3,7,0.429,1,3,0.333,0,0,,1,0,1,4,1,0,2,0,9,6.1
Cristiano Felicio,24-236,F-C,2/28/17,CHI,DEN,0,13,4,4,1,4,4,1,0,0,,1,2,0.5,2,1,3,0,0,0,1,2,9,7.3
Luke Babbitt,27-254,F,3/1/17,MIA,PHI,1,23,3,5,0.6,0,0,,3,5,0.6,0,0,,0,4,4,1,0,2,1,2,9,8.2
David Lee,33-240,F,12/25/16,SAS,CHI,0,16,4,5,0.8,4,5,0.8,0,0,,1,1,1,0,2,2,1,0,0,0,1,9,8
Wesley Matthews,30-136,G,2/27/17,DAL,MIA,1,34,1,4,0.25,0,2,0,1,2,0.5,6,6,1,0,4,4,1,2,0,5,2,9,4.7
Tyreke Evans,27-135,G-F,2/1/17,NOP,DET,0,18,3,7,0.429,3,5,0.6,0,2,0,3,4,0.75,0,0,0,1,0,0,1,0,9,4.6
Jose Calderon,35-060,G,11/27/16,LAL,ATL,1,13,4,5,0.8,4,5,0.8,0,0,,1,1,1,0,1,1,4,1,0,0,2,9,10.4
Austin Rivers,24-154,G,1/2/17,LAC,PHO,1,37,2,11,0.182,1,8,0.125,1,3,0.333,4,5,0.8,0,4,4,5,0,0,2,4,9,2.8
Matthew Dellavedova,26-127,G,1/13/17,MIL,MIA,0,18,1,5,0.2,0,4,0,1,1,1,6,6,1,0,2,2,8,1,0,2,2,9,10.3
Dennis Schroder,23-069,G,11/23/16,ATL,IND,1,25,3,11,0.273,2,8,0.25,1,3,0.333,2,2,1,1,2,3,2,0,0,4,1,9,0.8
J.R. Smith,31-084,G-F,12/2/16,CLE,CHI,1,33,3,8,0.375,0,0,,3,8,0.375,0,0,,0,2,2,2,1,0,1,3,9,5.4
Enes Kanter,24-317,C,4/2/17,OKC,CHO,0,17,4,9,0.444,4,9,0.444,0,0,,1,2,0.5,1,0,1,0,0,0,1,1,9,3.2
Joe Johnson,35-143,G-F,11/19/16,UTA,HOU,0,22,4,8,0.5,3,4,0.75,1,4,0.25,0,0,,0,3,3,3,1,0,0,0,9,9
Jamal Murray,19-256,G,11/5/16,DEN,DET,1,27,4,10,0.4,3,6,0.5,1,4,0.25,0,0,,0,1,1,2,1,0,4,0,9,2.3
Marc Gasol,31-301,C,11/25/16,MEM,MIA,1,26,4,11,0.364,4,9,0.444,0,2,0,1,2,0.5,0,1,1,2,0,5,0,1,9,7.3
Trevor Ariza,31-238,F,2/23/17,HOU,NOP,1,27,3,10,0.3,0,2,0,3,8,0.375,0,0,,1,6,7,2,1,1,1,1,9,7.4
Cody Zeller,24-063,F-C,12/7/16,CHO,DET,1,32,2,9,0.222,2,9,0.222,0,0,,5,7,0.714,1,5,6,0,0,1,0,3,9,4.4
Thaddeus Young,28-135,F,11/3/16,IND,MIL,1,28,4,8,0.5,4,7,0.571,0,1,0,1,2,0.5,1,3,4,0,1,0,2,1,9,4.8
Aaron Brooks,31-357,G,1/5/17,IND,BRK,0,17,4,7,0.571,3,4,0.75,1,3,0.333,0,0,,0,0,0,2,0,1,0,1,9,7.4
Rajon Rondo,30-257,G,11/5/16,CHI,IND,1,29,4,11,0.364,3,9,0.333,1,2,0.5,0,0,,0,1,1,5,1,0,4,1,9,3.3
Kosta Koufos,27-273,C,11/23/16,SAC,OKC,0,17,4,7,0.571,4,7,0.571,0,0,,1,1,1,4,6,10,0,1,0,0,4,9,9.7
E'Twaun Moore,27-339,G,2/1/17,NOP,DET,0,28,4,8,0.5,3,6,0.5,1,2,0.5,0,0,,0,2,2,3,1,0,0,2,9,7.9
Semaj Christon,24-040,G,12/11/16,OKC,BOS,0,21,3,3,1,2,2,1,1,1,1,2,4,0.5,0,0,0,2,2,0,0,0,9,10.7
Ben McLemore,23-286,G,11/23/16,SAC,OKC,0,17,4,10,0.4,3,7,0.429,1,3,0.333,0,0,,0,2,2,0,0,0,0,3,9,3
Dirk Nowitzki,38-232,F,2/6/17,DAL,DEN,1,24,4,8,0.5,4,7,0.571,0,1,0,1,2,0.5,0,6,6,0,3,0,1,4,9,6.8
Nikola Mirotic,25-303,F,12/10/16,CHI,MIA,0,22,4,6,0.667,3,3,1,1,3,0.333,0,0,,0,5,5,1,0,1,1,2,9,7.5
Courtney Lee,31-107,G,1/18/17,NYK,BOS,0,38,4,8,0.5,3,5,0.6,1,3,0.333,0,0,,2,6,8,7,0,1,0,2,9,13
Patrick Beverley,28-206,G,2/3/17,HOU,CHI,1,32,3,8,0.375,1,3,0.333,2,5,0.4,1,1,1,0,7,7,7,2,0,3,4,9,9
Thaddeus Young,28-150,F,11/18/16,IND,PHO,1,32,4,10,0.4,3,9,0.333,1,1,1,0,0,,3,2,5,2,2,1,0,2,9,9.6
C.J. Miles,29-315,G-F,2/27/17,IND,HOU,1,17,3,7,0.429,0,2,0,3,5,0.6,0,0,,0,1,1,0,0,0,0,2,9,4.8
Trey Burke,23-365,G,11/11/16,WAS,CLE,0,22,4,7,0.571,4,7,0.571,0,0,,1,1,1,0,2,2,3,0,0,0,0,9,8.4
Lance Stephenson,26-213,G-F,4/6/17,IND,MIL,0,23,3,6,0.5,2,4,0.5,1,2,0.5,2,2,1,0,1,1,5,1,0,3,0,9,7.8
Aron Baynes,30-081,C,2/28/17,DET,POR,0,23,3,4,0.75,3,4,0.75,0,0,,3,5,0.6,1,5,6,0,0,1,0,5,9,7.5
Lucas Nogueira,24-185,C,1/27/17,TOR,MIL,0,24,4,7,0.571,4,7,0.571,0,0,,1,1,1,4,1,5,0,1,5,3,2,9,9.5
Michael Beasley,27-306,F,11/10/16,MIL,NOP,0,12,3,6,0.5,2,5,0.4,1,1,1,2,2,1,0,4,4,2,0,0,0,1,9,8.2
Shabazz Muhammad,23-351,F-G,10/29/16,MIN,SAC,0,11,3,3,1,3,3,1,0,0,,3,3,1,0,1,1,1,0,0,0,0,9,9.1
Luke Babbitt,27-198,F,1/4/17,MIA,SAC,1,17,3,4,0.75,0,1,0,3,3,1,0,0,,0,4,4,0,0,0,2,3,9,5.4
Giannis Antetokounmpo,22-102,F-G,3/18/17,MIL,GSW,1,31,4,14,0.286,4,13,0.308,0,1,0,1,2,0.5,1,2,3,3,2,3,2,2,9,5.1
Justin Holiday,27-234,G,11/25/16,NYK,CHO,0,16,4,6,0.667,3,4,0.75,1,2,0.5,0,0,,0,1,1,1,1,0,1,1,9,7
Kay Felder,21-309,G,2/1/17,CLE,MIN,0,17,3,5,0.6,1,3,0.333,2,2,1,1,2,0.5,0,1,1,3,1,1,3,2,9,6.6
Brandan Wright,29-124,F-C,2/6/17,MEM,SAS,0,14,4,4,1,4,4,1,0,0,,1,2,0.5,2,1,3,0,0,3,0,3,9,10
Joe Harris,25-106,G,12/22/16,BRK,GSW,0,19,3,4,0.75,0,1,0,3,3,1,0,0,,0,3,3,1,0,0,2,2,9,6.2
T.J. McConnell,24-351,G,3/11/17,PHI,LAC,1,30,4,9,0.444,3,5,0.6,1,4,0.25,0,0,,0,1,1,10,2,0,0,3,9,12.4
Dirk Nowitzki,38-279,F,3/25/17,DAL,TOR,1,29,4,11,0.364,3,9,0.333,1,2,0.5,0,0,,1,4,5,0,0,0,1,4,9,2.2
Corey Brewer,30-256,F-G,11/16/16,HOU,OKC,0,17,4,6,0.667,3,4,0.75,1,2,0.5,0,0,,2,0,2,0,0,0,1,1,9,6.4
Nene Hilario,34-163,F-C,2/23/17,HOU,NOP,1,19,4,8,0.5,4,8,0.5,0,0,,1,3,0.333,1,2,3,0,2,1,1,3,9,6
Jaylen Brown,20-151,F,3/24/17,BOS,PHO,1,25,4,8,0.5,3,5,0.6,1,3,0.333,0,1,0,1,6,7,3,0,1,1,5,9,6.9
Joe Ingles,29-090,F-G,12/31/16,UTA,PHO,0,23,3,5,0.6,0,2,0,3,3,1,0,0,,0,0,0,0,0,0,3,0,9,3.7
Damjan Rudez,30-175,F,12/9/16,ORL,CHO,0,8,4,6,0.667,3,3,1,1,3,0.333,0,0,,0,2,2,0,0,0,0,1,9,6.6
Rodney Stuckey,30-223,G,11/30/16,IND,POR,0,24,2,6,0.333,2,5,0.4,0,1,0,5,6,0.833,0,1,1,2,1,0,2,0,9,5.9
Patrick Beverley,28-146,G,12/5/16,HOU,BOS,1,32,4,8,0.5,3,5,0.6,1,3,0.333,0,0,,1,4,5,4,1,0,1,1,9,9.3
Derrick Favors,25-174,F-C,1/5/17,UTA,TOR,1,26,4,10,0.4,4,10,0.4,0,0,,1,2,0.5,1,7,8,1,1,0,3,1,9,4.3
Thabo Sefolosha,32-315,G-F,3/13/17,ATL,SAS,1,27,3,8,0.375,3,7,0.429,0,1,0,3,4,0.75,1,4,5,3,1,0,1,1,9,7.8
Taj Gibson,31-199,F,1/9/17,CHI,OKC,1,20,4,8,0.5,4,8,0.5,0,0,,1,1,1,1,6,7,0,2,0,0,3,9,8.3
Ed Davis,27-173,F,11/25/16,POR,NOP,1,28,4,6,0.667,4,6,0.667,0,0,,1,1,1,2,4,6,0,1,1,0,4,9,9.1
Maurice Harkless,23-218,F-G,12/15/16,POR,DEN,1,36,3,7,0.429,2,4,0.5,1,3,0.333,2,2,1,1,2,3,1,1,1,2,5,9,5
Austin Rivers,24-143,G,12/22/16,LAC,SAS,0,25,2,9,0.222,1,6,0.167,1,3,0.333,3,4,0.75,0,0,0,0,1,0,0,2,8,2.3
Evan Turner,28-083,G,1/18/17,POR,CHO,0,20,4,8,0.5,4,6,0.667,0,2,0,0,0,,2,7,9,2,1,0,2,2,8,7.1
Doug McDermott,25-052,F,2/24/17,OKC,LAL,0,19,3,8,0.375,3,6,0.5,0,2,0,2,2,1,2,2,4,0,0,0,2,1,8,3.2
Ryan Kelly,26-003,F,4/12/17,ATL,IND,0,22,3,8,0.375,1,6,0.167,2,2,1,0,0,,1,2,3,0,0,0,1,0,8,3.9
Emmanuel Mudiay,21-015,G,3/20/17,DEN,HOU,0,10,2,4,0.5,0,1,0,2,3,0.667,2,2,1,0,1,1,0,0,0,1,2,8,4.5
Josh Richardson,23-060,G,11/14/16,MIA,SAS,1,28,4,9,0.444,4,7,0.571,0,2,0,0,0,,1,0,1,4,1,0,3,4,8,3.2
Kenneth Faried,27-004,F,11/23/16,DEN,UTA,1,22,3,7,0.429,3,7,0.429,0,0,,2,2,1,5,5,10,0,1,0,0,4,8,8.7
Pau Gasol,36-143,F-C,11/26/16,SAS,WAS,1,29,4,7,0.571,4,6,0.667,0,1,0,0,0,,2,8,10,2,1,1,2,3,8,8.4
Evan Turner,28-064,G,12/30/16,POR,SAS,0,28,3,11,0.273,3,10,0.3,0,1,0,2,2,1,0,4,4,3,1,0,0,2,8,5
Jason Terry,39-192,G,3/26/17,MIL,CHI,0,22,3,4,0.75,1,1,1,2,3,0.667,0,0,,0,2,2,1,0,0,2,1,8,5.3
Kyrie Irving,24-227,G,11/5/16,CLE,PHI,1,34,3,17,0.176,3,12,0.25,0,5,0,2,3,0.667,1,6,7,2,2,0,4,2,8,-2
Mario Hezonja,22-009,F-G,3/6/17,ORL,NYK,0,15,3,6,0.5,3,5,0.6,0,1,0,2,3,0.667,0,3,3,0,1,1,1,0,8,6.2
Terrence Ross,25-338,F-G,1/8/17,TOR,HOU,0,25,4,12,0.333,4,7,0.571,0,5,0,0,0,,0,2,2,1,1,0,1,2,8,1.7
Matthew Dellavedova,26-130,G,1/16/17,MIL,PHI,0,21,3,6,0.5,3,6,0.5,0,0,,2,2,1,0,1,1,4,1,0,1,0,8,8.1
Sean Kilpatrick,27-024,G,1/30/17,BRK,MIA,0,17,3,6,0.5,3,4,0.75,0,2,0,2,2,1,0,3,3,1,1,0,1,1,8,6.2
Rajon Rondo,31-014,G,3/8/17,CHI,ORL,0,28,3,7,0.429,1,4,0.25,2,3,0.667,0,0,,2,3,5,6,0,1,2,1,8,9.1
Gerald Green,30-285,G-F,11/6/16,BOS,DEN,0,10,3,4,0.75,1,1,1,2,3,0.667,0,0,,0,2,2,4,0,0,1,3,8,7.6
Shaun Livingston,31-097,G,12/17/16,GSW,POR,0,16,3,5,0.6,3,5,0.6,0,0,,2,2,1,0,2,2,1,1,0,1,0,8,7
P.J. Tucker,31-192,F,11/13/16,PHO,GSW,0,27,3,5,0.6,3,4,0.75,0,1,0,2,6,0.333,2,6,8,1,2,1,2,4,8,7.1
James Johnson,30-007,F,2/27/17,MIA,DAL,0,31,4,12,0.333,4,8,0.5,0,4,0,0,0,,1,4,5,2,1,1,0,3,8,5
Kentavious Caldwell-Pope,23-307,G,12/21/16,DET,MEM,1,31,3,10,0.3,1,5,0.2,2,5,0.4,0,0,,1,2,3,2,0,0,1,0,8,3.9
Mike Muscala,25-284,F-C,4/11/17,ATL,CHO,0,18,4,4,1,4,4,1,0,0,,0,0,,0,1,1,3,0,0,1,2,8,7.4
Joe Ingles,29-182,F-G,4/2/17,UTA,SAS,0,28,3,8,0.375,1,4,0.25,2,4,0.5,0,0,,0,4,4,4,2,0,3,4,8,5
Dorian Finney-Smith,23-205,F,11/25/16,DAL,CLE,0,22,3,9,0.333,1,4,0.25,2,5,0.4,0,0,,0,0,0,1,0,0,0,2,8,2.8
Davis Bertans,24-116,F,3/8/17,SAS,SAC,0,19,3,7,0.429,2,3,0.667,1,4,0.25,1,1,1,1,3,4,1,1,1,0,2,8,7.5
Monta Ellis,31-093,G,1/27/17,IND,SAC,0,16,3,3,1,2,2,1,1,1,1,1,1,1,0,0,0,1,0,1,1,1,8,7.1
Jerami Grant,22-267,F,12/4/16,OKC,NOP,0,14,3,6,0.5,2,4,0.5,1,2,0.5,1,1,1,0,2,2,0,0,0,0,3,8,4.4
Caris LeVert,22-210,G-F,3/23/17,BRK,PHO,1,20,3,6,0.5,2,3,0.667,1,3,0.333,1,3,0.333,1,2,3,3,0,0,2,2,8,4.8
Pau Gasol,36-243,F-C,3/6/17,SAS,HOU,0,17,3,12,0.25,2,10,0.2,1,2,0.5,1,2,0.5,0,6,6,1,0,1,0,0,8,3.6
Rodney McGruder,25-217,G,3/3/17,MIA,ORL,1,17,3,6,0.5,1,3,0.333,2,3,0.667,0,0,,0,1,1,0,0,0,0,1,8,4.9
Nikola Mirotic,25-278,F,11/15/16,CHI,POR,0,19,3,6,0.5,1,1,1,2,5,0.4,0,0,,0,8,8,0,0,0,1,0,8,6.4
Anthony Tolliver,31-304,F-C,4/1/17,SAC,MIN,0,28,4,10,0.4,4,7,0.571,0,3,0,0,1,0,0,4,4,3,0,3,1,3,8,5.4
Quincy Acy,26-120,F,2/3/17,BRK,IND,0,13,2,7,0.286,0,2,0,2,5,0.4,2,2,1,2,1,3,0,0,2,0,3,8,5.8
Jerami Grant,22-249,F,11/16/16,OKC,HOU,0,19,3,6,0.5,1,3,0.333,2,3,0.667,0,0,,0,3,3,1,0,1,0,0,8,7.3
Toney Douglas,30-336,G,2/15/17,MEM,NOP,0,23,4,9,0.444,4,6,0.667,0,3,0,0,1,0,1,7,8,3,2,0,0,2,8,9
Cody Zeller,24-177,F-C,3/31/17,CHO,DEN,1,31,3,7,0.429,3,7,0.429,0,0,,2,3,0.667,4,5,9,3,1,3,1,3,8,11.2
Cory Joseph,25-134,G,1/1/17,TOR,LAL,0,27,4,6,0.667,4,5,0.8,0,1,0,0,0,,0,1,1,7,0,1,3,1,8,7.9
Darren Collison,29-151,G,1/21/17,SAC,CHI,1,25,4,11,0.364,4,9,0.444,0,2,0,0,0,,2,1,3,2,0,0,0,2,8,4.2
Marreese Speights,29-132,C-F,12/14/16,LAC,ORL,0,13,3,7,0.429,1,5,0.2,2,2,1,0,0,,2,4,6,1,0,1,1,4,8,5.7
Anthony Davis,23-320,F-C,1/25/17,NOP,OKC,1,16,2,8,0.25,2,8,0.25,0,0,,4,6,0.667,0,5,5,0,0,1,2,2,8,1.8
JaMychal Green,26-146,F,11/14/16,MEM,UTA,1,27,2,6,0.333,2,6,0.333,0,0,,4,4,1,4,2,6,0,0,2,1,2,8,7.6
Sam Dekker,22-313,F,3/15/17,HOU,LAL,0,19,4,7,0.571,4,5,0.8,0,2,0,0,2,0,2,7,9,1,0,0,0,0,8,8.1
Juan Hernangomez,21-125,F,1/31/17,DEN,LAL,0,12,2,2,1,0,0,,2,2,1,2,2,1,1,1,2,0,0,0,0,1,8,8
Isaiah Canaan,25-188,G,11/25/16,CHI,PHI,0,26,2,9,0.222,0,2,0,2,7,0.286,2,2,1,0,5,5,1,1,0,2,1,8,3.3
Joffrey Lauvergne,25-092,C-F,12/31/16,OKC,LAC,0,16,2,4,0.5,2,3,0.667,0,1,0,4,5,0.8,0,3,3,1,0,0,1,6,8,3.8
Patrick McCaw,21-016,G,11/10/16,GSW,DEN,0,15,3,6,0.5,3,4,0.75,0,2,0,2,2,1,0,1,1,2,0,1,1,0,8,6.4
Jonas Jerebko,29-282,F,12/9/16,BOS,TOR,0,17,3,5,0.6,1,1,1,2,4,0.5,0,0,,2,1,3,0,0,0,0,2,8,6.6
Troy Daniels,25-264,G,4/5/17,MEM,OKC,0,14,3,5,0.6,1,1,1,2,4,0.5,0,0,,0,3,3,0,0,0,1,0,8,5.6
Spencer Hawes,28-278,C-F,1/31/17,CHO,POR,0,16,4,9,0.444,4,7,0.571,0,2,0,0,0,,1,3,4,2,0,0,0,1,8,5.9
Monta Ellis,31-162,G,4/6/17,IND,MIL,1,24,3,6,0.5,2,2,1,1,4,0.25,1,4,0.25,1,0,1,1,5,1,2,1,8,8.5
Terrence Ross,25-348,F-G,1/18/17,TOR,PHI,0,31,3,10,0.3,1,3,0.333,2,7,0.286,0,0,,0,6,6,0,0,0,1,1,8,2.6
Gorgui Dieng,26-295,C,11/8/16,MIN,BRK,1,19,3,4,0.75,3,4,0.75,0,0,,2,4,0.5,0,2,2,3,1,1,1,4,8,7.4
Otto Porter,23-201,F,12/21/16,WAS,CHI,1,12,3,5,0.6,1,1,1,2,4,0.5,0,0,,0,2,2,1,0,0,0,0,8,7
Evan Fournier,24-074,G-F,1/11/17,ORL,LAC,1,25,3,8,0.375,3,6,0.5,0,2,0,2,3,0.667,0,2,2,2,0,0,2,5,8,1.2
Enes Kanter,24-213,C,12/19/16,OKC,ATL,0,15,4,5,0.8,4,5,0.8,0,0,,0,0,,4,3,7,1,0,1,1,3,8,9
Brian Roberts,31-060,G,2/1/17,CHO,GSW,0,15,2,3,0.667,2,2,1,0,1,0,4,4,1,0,2,2,3,0,0,0,0,8,9.4
Josh Richardson,23-181,G,3/15/17,MIA,NOP,0,16,3,4,0.75,1,2,0.5,2,2,1,0,0,,2,0,2,2,0,0,1,0,8,8.2
Tyler Johnson,24-194,G,11/17/16,MIA,MIL,0,23,3,8,0.375,2,5,0.4,1,3,0.333,1,2,0.5,1,7,8,5,0,0,1,2,8,7.7
Ty Lawson,29-020,G,11/23/16,SAC,OKC,0,21,3,4,0.75,3,4,0.75,0,0,,2,2,1,1,3,4,4,1,0,2,3,8,8.6
JaMychal Green,26-201,F,1/8/17,MEM,UTA,1,32,3,5,0.6,2,3,0.667,1,2,0.5,1,2,0.5,1,5,6,0,1,1,1,6,8,5.8
Cory Joseph,25-217,G,3/25/17,TOR,DAL,1,36,4,11,0.364,4,9,0.444,0,2,0,0,0,,3,4,7,5,0,0,2,2,8,5.9
Jaylen Brown,20-133,F,3/6/17,BOS,LAC,1,26,3,5,0.6,2,3,0.667,1,2,0.5,1,1,1,1,4,5,4,1,1,1,4,8,9.5
Tim Frazier,26-026,G,11/27/16,NOP,DAL,1,31,3,9,0.333,3,7,0.429,0,2,0,2,2,1,1,1,2,3,3,0,4,4,8,3.4
Dirk Nowitzki,38-250,F,2/24/17,DAL,MIN,1,29,4,14,0.286,4,10,0.4,0,4,0,0,0,,1,6,7,3,2,2,1,2,8,6
Frank Kaminsky,23-221,F-C,11/11/16,CHO,TOR,0,18,3,9,0.333,1,5,0.2,2,4,0.5,0,0,,1,1,2,4,0,0,0,2,8,5.9
Marco Belinelli,31-001,G-F,3/26/17,CHO,PHO,0,21,3,7,0.429,3,6,0.5,0,1,0,2,2,1,0,2,2,0,0,0,0,0,8,4.9
Dante Exum,21-154,G,12/14/16,UTA,OKC,1,17,3,5,0.6,2,4,0.5,1,1,1,1,2,0.5,0,1,1,3,0,0,0,3,8,6.5
T.J. McConnell,24-321,G,2/9/17,PHI,ORL,1,30,4,10,0.4,4,8,0.5,0,2,0,0,0,,1,4,5,8,3,0,0,1,8,12.7
Brandon Ingram,19-084,F,11/25/16,LAL,GSW,1,39,3,18,0.167,3,14,0.214,0,4,0,2,2,1,1,8,9,2,2,1,3,1,8,0.4
Marco Belinelli,30-251,G-F,12/1/16,CHO,DAL,0,20,3,5,0.6,3,4,0.75,0,1,0,2,2,1,0,1,1,2,1,0,0,0,8,8.4
Arron Afflalo,31-011,G,10/26/16,SAC,PHO,1,26,2,7,0.286,0,5,0,2,2,1,2,2,1,0,3,3,0,1,0,0,3,8,4.6
Andre Roberson,24-331,G-F,10/30/16,OKC,LAL,1,30,4,7,0.571,4,4,1,0,3,0,0,2,0,0,5,5,3,1,1,0,0,8,9.2
Nerlens Noel,23-001,C-F,4/11/17,DAL,DEN,1,17,4,6,0.667,4,6,0.667,0,0,,0,1,0,2,3,5,0,1,1,1,1,8,7.6
Aaron Brooks,31-351,G,12/30/16,IND,CHI,0,13,3,5,0.6,1,1,1,2,4,0.5,0,0,,0,1,1,2,0,0,0,2,8,6.6
Marquese Chriss,19-180,F,12/29/16,PHO,TOR,1,19,3,6,0.5,2,3,0.667,1,3,0.333,1,2,0.5,1,1,2,0,0,0,0,3,8,4.4
Marreese Speights,29-134,C-F,12/16/16,LAC,MIA,0,13,2,6,0.333,2,4,0.5,0,2,0,4,4,1,1,5,6,0,0,0,1,4,8,4.2
Michael Kidd-Gilchrist,23-101,F,1/5/17,CHO,DET,1,27,2,5,0.4,2,5,0.4,0,0,,4,4,1,4,9,13,0,0,0,0,2,8,10
Langston Galloway,25-042,G,1/20/17,NOP,BRK,0,24,3,12,0.25,1,5,0.2,2,7,0.286,0,0,,2,2,4,1,1,0,0,2,8,3.7
Clint Capela,22-180,F-C,11/14/16,HOU,PHI,1,26,3,7,0.429,3,7,0.429,0,0,,2,3,0.667,3,10,13,1,0,5,0,0,8,13.2
LaMarcus Aldridge,31-260,F-C,4/5/17,SAS,LAL,1,16,4,11,0.364,4,11,0.364,0,0,,0,0,,3,3,6,1,2,1,0,0,8,8.3
Michael Kidd-Gilchrist,23-119,F,1/23/17,CHO,WAS,1,27,4,8,0.5,4,8,0.5,0,0,,0,1,0,1,6,7,1,0,1,1,3,8,5.3
Arron Afflalo,31-118,G,2/10/17,SAC,ATL,1,29,3,7,0.429,2,5,0.4,1,2,0.5,1,1,1,0,1,1,2,0,0,1,2,8,4.2
Sam Dekker,22-324,F,3/26/17,HOU,OKC,0,24,3,4,0.75,2,3,0.667,1,1,1,1,2,0.5,1,4,5,1,0,0,0,2,8,7.8
Brandan Wright,29-177,F-C,3/31/17,MEM,DAL,1,23,3,5,0.6,3,5,0.6,0,0,,2,2,1,1,3,4,0,0,2,1,1,8,7.3
James Michael McAdoo,24-037,F,2/10/17,GSW,MEM,0,11,4,4,1,4,4,1,0,0,,0,1,0,1,1,2,0,0,3,0,2,8,8.7
Rondae Hollis-Jefferson,21-316,F,11/14/16,BRK,LAC,1,21,2,3,0.667,2,3,0.667,0,0,,4,4,1,1,1,2,1,0,0,2,4,8,4.8
E'Twaun Moore,27-292,G,12/16/16,NOP,HOU,1,25,3,8,0.375,1,5,0.2,2,3,0.667,0,0,,0,3,3,0,1,1,1,0,8,5.2
Cameron Payne,22-161,G,1/16/17,OKC,LAC,0,21,4,9,0.444,4,5,0.8,0,4,0,0,0,,0,0,0,2,1,0,2,3,8,2.5
Leandro Barbosa,34-002,G,11/30/16,PHO,ATL,0,13,4,8,0.5,4,8,0.5,0,0,,0,0,,0,2,2,1,0,0,0,3,8,4.1
Devin Harris,33-364,G,2/25/17,DAL,NOP,0,22,3,9,0.333,3,6,0.5,0,3,0,2,5,0.4,0,5,5,4,3,0,3,1,8,5.6
Jeremy Lin,28-221,G,4/1/17,BRK,ORL,1,28,3,14,0.214,1,8,0.125,2,6,0.333,0,0,,0,4,4,8,2,1,2,4,8,5.3
Dewayne Dedmon,27-227,C,3/27/17,SAS,CLE,1,20,4,6,0.667,4,6,0.667,0,0,,0,0,,3,10,13,0,0,1,1,3,8,9
Boris Diaw,34-236,F-C,12/8/16,UTA,GSW,1,26,4,7,0.571,4,5,0.8,0,2,0,0,0,,3,1,4,3,0,0,4,1,8,4.8
Glenn Robinson,22-363,G-F,1/5/17,IND,BRK,1,25,3,5,0.6,3,3,1,0,2,0,2,3,0.667,2,4,6,1,1,0,1,1,8,8.2
J.J. Redick,32-250,G,3/1/17,LAC,HOU,1,31,3,9,0.333,1,4,0.25,2,5,0.4,0,0,,0,3,3,2,0,1,0,1,8,5.5
Andre Drummond,23-219,C,3/17/17,DET,TOR,1,36,4,10,0.4,4,10,0.4,0,0,,0,4,0,6,16,22,0,2,1,3,6,8,7.3
Kristaps Porzingis,21-205,F-C,2/23/17,NYK,CLE,1,16,4,10,0.4,4,6,0.667,0,4,0,0,0,,1,4,5,0,0,2,0,0,8,5.9
Jae Crowder,26-185,F,1/7/17,BOS,NOP,1,31,3,9,0.333,1,4,0.25,2,5,0.4,0,0,,1,5,6,2,1,0,0,1,8,7.1
Rashad Vaughn,20-157,G,1/20/17,MIL,ORL,0,10,3,6,0.5,1,3,0.333,2,3,0.667,0,0,,0,2,2,1,1,0,0,0,8,7.3
Andre Iguodala,32-350,G-F,1/12/17,GSW,DET,0,21,3,5,0.6,1,2,0.5,2,3,0.667,0,0,,0,0,0,2,0,0,0,3,8,5.9
Nemanja Bjelica,28-249,F,1/13/17,MIN,OKC,0,14,3,6,0.5,2,4,0.5,1,2,0.5,1,1,1,1,2,3,1,0,0,0,6,8,4.6
Timofey Mozgov,30-232,C,3/5/17,LAL,NOP,0,15,3,3,1,3,3,1,0,0,,2,2,1,2,3,5,1,0,1,2,4,8,7.2
Jason Smith,31-016,F-C,3/18/17,WAS,CHO,1,27,3,8,0.375,2,5,0.4,1,3,0.333,1,2,0.5,1,3,4,2,0,3,0,1,8,7.9
Greg Monroe,26-209,C-F,12/30/16,MIL,MIN,0,14,4,10,0.4,4,10,0.4,0,0,,0,0,,0,1,1,0,0,0,0,0,8,2.9
Al-Farouq Aminu,26-046,F,11/6/16,POR,MEM,1,34,3,10,0.3,2,6,0.333,1,4,0.25,1,2,0.5,1,3,4,2,1,0,3,0,8,2.8
Tobias Harris,24-149,F,12/11/16,DET,PHI,1,35,3,9,0.333,3,6,0.5,0,3,0,2,2,1,0,6,6,2,2,0,3,2,8,4.3
J.J. Redick,32-131,G,11/2/16,LAC,OKC,1,26,3,12,0.25,1,7,0.143,2,5,0.4,0,0,,0,4,4,0,0,0,3,0,8,-1
Khris Middleton,25-198,F-G,2/26/17,MIL,PHO,1,28,3,8,0.375,2,5,0.4,1,3,0.333,1,1,1,0,7,7,2,0,0,4,3,8,1.9
Mirza Teletovic,31-191,F,3/28/17,MIL,CHO,0,16,3,6,0.5,1,1,1,2,5,0.4,0,0,,0,5,5,1,0,1,1,3,8,5.7
Bryn Forbes,23-253,G,4/2/17,SAS,UTA,0,21,3,6,0.5,1,2,0.5,2,4,0.5,0,0,,0,2,2,3,0,0,0,1,8,7.3
Nikola Vucevic,26-158,C,3/31/17,ORL,BOS,1,27,4,13,0.308,4,13,0.308,0,0,,0,0,,3,4,7,2,1,0,0,3,8,5
Nerlens Noel,22-268,C-F,1/3/17,PHI,MIN,0,11,4,5,0.8,4,5,0.8,0,0,,0,0,,1,0,1,0,1,0,0,1,8,7.4
Luke Babbitt,27-226,F,2/1/17,MIA,ATL,1,19,3,5,0.6,1,1,1,2,4,0.5,0,0,,0,1,1,1,2,1,2,2,8,6.6
Trevor Booker,29-101,F,3/6/17,BRK,MEM,0,26,4,6,0.667,4,6,0.667,0,0,,0,1,0,3,6,9,1,1,1,3,2,8,7.5
George Hill,30-209,G,11/29/16,UTA,HOU,1,32,2,6,0.333,0,3,0,2,3,0.667,2,2,1,0,1,1,4,1,0,3,3,8,4.5
Dwight Powell,25-171,F-C,1/7/17,DAL,ATL,0,16,4,5,0.8,4,5,0.8,0,0,,0,0,,2,4,6,0,1,0,0,1,8,9.3
Josh McRoberts,29-294,F,12/18/16,MIA,BOS,1,16,3,5,0.6,1,2,0.5,2,3,0.667,0,0,,0,0,0,4,0,0,1,0,8,7.5
Trevor Booker,29-130,F,4/4/17,BRK,PHI,0,18,4,7,0.571,4,6,0.667,0,1,0,0,0,,0,5,5,2,0,0,0,1,8,7.2
Jonas Valanciunas,24-266,C,1/27/17,TOR,MIL,1,24,4,10,0.4,4,10,0.4,0,0,,0,0,,1,10,11,1,1,2,2,1,8,7
Patrick McCaw,21-126,G,2/28/17,GSW,WAS,0,24,2,2,1,1,1,1,1,1,1,3,4,0.75,0,2,2,1,0,0,1,1,8,6.9
Nik Stauskas,23-117,G,2/1/17,PHI,DAL,1,35,2,5,0.4,1,1,1,1,4,0.25,3,4,0.75,0,3,3,2,0,0,2,3,8,4
Anthony Tolliver,31-312,F-C,4/9/17,SAC,HOU,0,24,2,6,0.333,2,2,1,0,4,0,4,6,0.667,0,1,1,2,0,0,1,2,8,3.7
Tyler Johnson,24-275,G,2/6/17,MIA,MIN,0,22,3,9,0.333,2,6,0.333,1,3,0.333,1,2,0.5,1,1,2,1,0,0,1,2,8,2.4
Elfrid Payton,23-017,G,3/11/17,ORL,CLE,1,34,4,17,0.235,4,17,0.235,0,0,,0,0,,3,7,10,6,3,0,1,2,8,7.3
Dwight Powell,25-126,F-C,11/23/16,DAL,LAC,0,14,3,7,0.429,3,7,0.429,0,0,,2,2,1,1,3,4,1,0,0,1,1,8,5.2
Tyler Johnson,24-208,G,12/1/16,MIA,UTA,0,30,3,11,0.273,3,7,0.429,0,4,0,2,2,1,1,5,6,4,3,0,1,3,8,7.3
Ed Davis,27-219,F,1/10/17,POR,LAL,0,21,3,6,0.5,3,6,0.5,0,0,,2,2,1,3,5,8,0,1,0,0,3,8,8.4
Corey Brewer,30-296,F-G,12/26/16,HOU,PHO,0,18,3,3,1,2,2,1,1,1,1,1,1,1,0,0,0,1,1,0,0,0,8,8.8
Terrence Ross,25-280,F-G,11/11/16,TOR,CHO,0,20,3,4,0.75,3,3,1,0,1,0,2,2,1,0,0,0,1,1,0,0,0,8,8.1
Greg Monroe,26-174,C-F,11/25/16,MIL,TOR,0,19,4,8,0.5,4,8,0.5,0,0,,0,0,,4,6,10,1,0,0,1,3,8,7.1
Tony Snell,25-019,G-F,11/29/16,MIL,CLE,1,25,3,8,0.375,2,2,1,1,6,0.167,1,2,0.5,0,3,3,1,0,0,1,2,8,3
Serge Ibaka,27-198,F-C,4/4/17,TOR,IND,1,31,3,13,0.231,3,7,0.429,0,6,0,2,2,1,0,10,10,0,0,0,3,3,8,-1.1
Joe Harris,25-074,G,11/20/16,BRK,POR,0,27,2,7,0.286,2,4,0.5,0,3,0,4,4,1,0,4,4,3,0,0,2,1,8,4.8
Zaza Pachulia,32-267,C,11/3/16,GSW,OKC,1,23,4,4,1,4,4,1,0,0,,0,0,,6,4,10,5,2,3,1,3,8,17.6
Spencer Hawes,28-251,C-F,1/4/17,CHO,OKC,0,24,2,6,0.333,0,3,0,2,3,0.667,2,2,1,0,4,4,2,2,2,1,4,8,8
Ty Lawson,29-039,G,12/12/16,SAC,LAL,0,26,3,8,0.375,3,5,0.6,0,3,0,2,2,1,2,4,6,5,4,0,4,2,8,8.9
Marc Gasol,32-041,C,3/11/17,MEM,ATL,1,27,3,11,0.273,2,8,0.25,1,3,0.333,1,2,0.5,0,6,6,2,1,0,3,2,8,1.5
Otto Porter,23-154,F,11/4/16,WAS,ATL,1,38,4,7,0.571,4,4,1,0,3,0,0,0,,0,0,0,2,0,0,1,2,8,4.3
Tobias Harris,24-204,F,2/4/17,DET,IND,0,23,2,9,0.222,2,7,0.286,0,2,0,4,4,1,0,4,4,0,0,0,3,1,8,0.3
Jusuf Nurkic,22-082,C,11/13/16,DEN,POR,1,19,3,11,0.273,3,11,0.273,0,0,,2,4,0.5,4,5,9,1,0,1,2,2,8,3.6
Trey Lyles,21-015,F,11/20/16,UTA,DEN,1,21,3,8,0.375,1,4,0.25,2,4,0.5,0,0,,1,5,6,1,0,0,3,2,8,2.7
Marquese Chriss,19-253,F,3/12/17,PHO,POR,1,24,3,9,0.333,2,5,0.4,1,4,0.25,1,2,0.5,0,5,5,0,0,1,1,4,8,2.1
Taj Gibson,31-139,F,11/10/16,CHI,MIA,1,23,4,7,0.571,4,7,0.571,0,0,,0,0,,1,2,3,0,0,1,2,1,8,4.3
C.J. Watson,32-293,G,2/4/17,ORL,ATL,0,20,3,4,0.75,1,1,1,2,3,0.667,0,0,,0,2,2,3,1,0,0,2,8,9.3
Sam Dekker,22-250,F,1/11/17,HOU,MIN,0,22,3,9,0.333,1,4,0.25,2,5,0.4,0,0,,1,1,2,0,0,0,1,0,8,2.9
Andrew Harrison,22-096,G,2/1/17,MEM,DEN,0,21,2,6,0.333,0,3,0,2,3,0.667,2,4,0.5,0,0,0,6,2,0,0,3,8,8.8
Tim Hardaway,24-237,G,11/8/16,ATL,CLE,0,29,3,11,0.273,2,4,0.5,1,7,0.143,1,2,0.5,1,1,2,2,0,0,1,0,8,2.5
Tarik Black,25-059,C-F,1/20/17,LAL,IND,0,28,4,6,0.667,4,6,0.667,0,0,,0,1,0,6,7,13,3,2,0,1,2,8,13.6
Ish Smith,28-239,G,3/1/17,DET,NOP,0,19,4,8,0.5,4,5,0.8,0,3,0,0,0,,0,1,1,3,2,0,1,0,8,7.4
Patrick Patterson,27-354,F,3/3/17,TOR,WAS,0,28,2,8,0.25,0,3,0,2,5,0.4,2,2,1,2,5,7,2,0,1,3,1,8,4.8
John Henson,26-031,C-F,1/28/17,MIL,BOS,0,7,1,2,0.5,1,2,0.5,0,0,,6,8,0.75,1,0,1,1,0,0,1,2,8,5.8
Chasson Randle,23-365,G,2/4/17,PHI,MIA,0,12,1,4,0.25,1,1,1,0,3,0,6,6,1,0,0,0,1,0,0,0,1,8,5.9
P.J. Tucker,31-274,F,2/3/17,PHO,SAC,0,32,2,8,0.25,0,4,0,2,4,0.5,2,2,1,1,4,5,3,1,0,1,0,8,7.2
Marc Gasol,31-324,C,12/18/16,MEM,UTA,1,36,4,22,0.182,4,17,0.235,0,5,0,0,0,,2,5,7,4,1,0,3,2,8,-2.9
Nemanja Bjelica,28-187,F,11/12/16,MIN,LAC,0,18,3,6,0.5,1,3,0.333,2,3,0.667,0,0,,0,1,1,4,1,0,1,4,8,6.5
Justin Holiday,27-252,G,12/13/16,NYK,PHO,0,25,3,8,0.375,3,6,0.5,0,2,0,2,2,1,0,1,1,3,0,0,1,4,8,3.4
Justin Holiday,27-207,G,10/29/16,NYK,MEM,0,19,4,7,0.571,4,5,0.8,0,2,0,0,0,,0,0,0,1,0,1,0,3,8,4.9
Jusuf Nurkic,22-094,C,11/25/16,DEN,OKC,1,22,3,6,0.5,3,6,0.5,0,0,,2,2,1,1,6,7,3,1,1,1,1,8,9.9
Alex Abrines,23-111,G-F,11/20/16,OKC,IND,0,23,4,9,0.444,4,5,0.8,0,4,0,0,0,,0,0,0,1,1,0,1,0,8,4
Terry Rozier,22-363,G,3/15/17,BOS,MIN,0,14,3,7,0.429,1,3,0.333,2,4,0.5,0,0,,0,1,1,3,0,0,0,0,8,6.7
Michael Kidd-Gilchrist,23-173,F,3/18/17,CHO,WAS,1,27,4,8,0.5,4,8,0.5,0,0,,0,0,,1,3,4,0,2,4,0,4,8,8.8
Khris Middleton,25-239,F-G,4/8/17,MIL,PHI,1,33,3,11,0.273,3,10,0.3,0,1,0,2,2,1,2,6,8,2,3,0,2,2,8,6.3
Jon Leuer,27-223,F,12/23/16,DET,GSW,1,33,4,7,0.571,4,6,0.667,0,1,0,0,0,,1,6,7,2,1,0,0,3,8,8.4
Paul Zipser,23-020,G-F,3/10/17,CHI,HOU,0,20,3,9,0.333,1,3,0.333,2,6,0.333,0,0,,0,2,2,0,1,1,1,2,8,3.4
Thaddeus Young,28-220,F,1/27/17,IND,SAC,1,29,3,9,0.333,3,5,0.6,0,4,0,2,2,1,1,4,5,1,4,0,0,3,8,8.3
Dewayne Dedmon,27-233,C,4/2/17,SAS,UTA,1,23,4,4,1,4,4,1,0,0,,0,0,,1,4,5,1,2,3,1,2,8,11.7
Kenneth Faried,27-037,F,12/26/16,DEN,LAC,0,19,3,7,0.429,3,7,0.429,0,0,,2,2,1,5,5,10,1,1,1,0,2,8,10.9
Kyle O'Quinn,26-239,F-C,11/20/16,NYK,ATL,1,17,4,5,0.8,4,5,0.8,0,0,,0,0,,4,4,8,0,0,1,1,4,8,8.2
Raymond Felton,32-182,G,12/25/16,LAC,LAL,1,38,4,10,0.4,4,9,0.444,0,1,0,0,0,,4,6,10,6,2,2,2,3,8,11.6
Nene Hilario,34-117,F-C,1/8/17,HOU,TOR,1,13,4,5,0.8,4,5,0.8,0,0,,0,1,0,0,2,2,1,0,0,1,4,8,4.4
Wesley Matthews,30-031,G,11/14/16,DAL,NYK,1,34,3,9,0.333,1,4,0.25,2,5,0.4,0,0,,0,5,5,1,2,0,1,2,8,5.3
Nik Stauskas,23-074,G,12/20/16,PHI,NOP,0,23,2,8,0.25,0,3,0,2,5,0.4,2,2,1,0,5,5,0,0,1,2,1,8,3
Kevin Seraphin,27-029,F,1/5/17,IND,BRK,0,15,4,8,0.5,4,8,0.5,0,0,,0,0,,2,1,3,0,0,0,0,1,8,5.3
Raul Neto,24-205,G,12/10/16,UTA,SAC,0,11,3,5,0.6,1,3,0.333,2,2,1,0,0,,1,3,4,3,1,0,1,0,8,9.4
Joakim Noah,31-312,C,1/2/17,NYK,ORL,1,33,3,7,0.429,3,7,0.429,0,0,,2,4,0.5,5,5,10,2,2,2,1,1,8,11.9
Trevor Booker,29-109,F,3/14/17,BRK,OKC,0,18,3,8,0.375,1,6,0.167,2,2,1,0,0,,0,2,2,1,0,0,3,3,8,0.7
Delon Wright,24-333,G,3/25/17,TOR,DAL,0,24,3,7,0.429,2,4,0.5,1,3,0.333,1,2,0.5,1,2,3,4,1,1,4,3,8,4.5
David West,36-207,F,3/24/17,GSW,SAC,0,14,4,5,0.8,4,5,0.8,0,0,,0,0,,1,2,3,4,1,3,0,3,8,12.1
Devin Harris,33-325,G,1/17/17,DAL,CHI,0,18,1,7,0.143,1,5,0.2,0,2,0,6,6,1,2,0,2,3,1,2,2,2,8,6.6
Maurice Harkless,23-184,F-G,11/11/16,POR,SAC,1,36,3,9,0.333,1,5,0.2,2,4,0.5,0,0,,3,5,8,1,0,1,0,2,8,7.1
Salah Mejri,30-159,C,11/21/16,DAL,SAS,1,32,4,5,0.8,4,5,0.8,0,0,,0,0,,1,10,11,1,4,1,2,5,8,11.2
Tim Frazier,26-026,G,11/27/16,NOP,DAL,1,31,3,9,0.333,3,7,0.429,0,2,0,2,2,1,1,1,2,3,3,0,4,4,8,3.4
Isaiah Whitehead,21-268,G,12/1/16,BRK,MIL,1,31,3,8,0.375,3,6,0.5,0,2,0,2,2,1,0,0,0,4,2,1,2,4,8,5.5
Rudy Gobert,24-223,C,2/4/17,UTA,CHO,1,38,2,5,0.4,2,5,0.4,0,0,,4,8,0.5,6,9,15,2,2,3,1,3,8,13.9
Mike Dunleavy,36-162,F-G,2/24/17,ATL,MIA,0,16,2,2,1,1,1,1,1,1,1,3,4,0.75,0,2,2,1,0,0,0,0,8,8.3
Ryan Anderson,28-241,F,1/2/17,HOU,WAS,1,32,3,7,0.429,1,2,0.5,2,5,0.4,0,0,,1,3,4,2,1,1,1,3,8,6.8
Malcolm Delaney,28-007,G,3/18/17,ATL,POR,0,26,3,7,0.429,3,4,0.75,0,3,0,2,2,1,0,2,2,2,0,0,1,4,8,3.7
James Michael McAdoo,24-098,F,4/12/17,GSW,LAL,1,28,3,6,0.5,3,6,0.5,0,0,,2,2,1,2,3,5,1,4,2,1,2,8,11.6
Kosta Koufos,28-014,C,3/10/17,SAC,WAS,1,21,4,11,0.364,4,11,0.364,0,0,,0,0,,2,4,6,1,1,1,0,2,8,6.1
Terrence Ross,25-294,F-G,11/25/16,TOR,MIL,0,20,3,7,0.429,1,2,0.5,2,5,0.4,0,0,,1,0,1,1,1,0,1,1,8,5.3
Andrew Harrison,22-059,G,12/26/16,MEM,ORL,0,24,1,4,0.25,1,4,0.25,0,0,,6,8,0.75,0,4,4,2,0,0,0,4,8,5.8
Dario Saric,22-234,F,11/28/16,PHI,TOR,0,24,3,13,0.231,2,7,0.286,1,6,0.167,1,4,0.25,1,3,4,4,0,1,2,1,8,1.6
JaMychal Green,26-230,F,2/6/17,MEM,SAS,1,25,3,5,0.6,3,4,0.75,0,1,0,2,2,1,3,4,7,2,1,0,3,3,8,7.2
Willie Reed,26-305,F-C,3/17/17,MIA,MIN,0,15,3,4,0.75,3,3,1,0,1,0,2,4,0.5,2,2,4,0,0,0,0,4,8,6
Clint Capela,22-167,F-C,11/1/16,HOU,CLE,1,19,3,5,0.6,3,5,0.6,0,0,,2,3,0.667,1,3,4,1,0,1,1,3,8,6.1
Joe Harris,25-068,G,11/14/16,BRK,LAC,0,25,3,6,0.5,2,3,0.667,1,3,0.333,1,2,0.5,1,1,2,2,2,0,1,4,8,6.4
Mason Plumlee,27-006,C-F,3/11/17,DEN,SAC,0,21,3,3,1,3,3,1,0,0,,2,2,1,2,5,7,8,1,3,2,3,8,15.5
Darren Collison,29-200,G,3/11/17,SAC,DEN,1,24,4,5,0.8,4,5,0.8,0,0,,0,1,0,0,1,1,5,1,0,0,0,8,10.5
Danny Green,29-219,G-F,1/27/17,SAS,NOP,1,29,2,5,0.4,0,0,,2,5,0.4,2,2,1,0,3,3,2,3,0,1,2,8,8.8
Willy Hernangomez,22-233,C,1/15/17,NYK,TOR,0,21,3,7,0.429,3,6,0.5,0,1,0,2,3,0.667,5,9,14,0,0,1,3,2,8,7
Mike Muscala,25-187,F-C,1/4/17,ATL,ORL,0,22,3,3,1,1,1,1,2,2,1,0,0,,0,1,1,1,1,0,2,2,8,6.3
Al Horford,30-202,C-F,12/22/16,BOS,IND,1,33,3,12,0.25,3,9,0.333,0,3,0,2,2,1,3,8,11,1,0,1,1,2,8,4.9
Nik Stauskas,23-098,G,1/13/17,PHI,CHO,1,31,3,8,0.375,1,2,0.5,2,6,0.333,0,0,,1,3,4,1,0,0,1,4,8,3.3
Jarell Martin,22-203,F,12/13/16,MEM,CLE,0,19,3,4,0.75,3,4,0.75,0,0,,2,2,1,2,8,10,1,0,0,2,5,8,6.9
Brandon Ingram,19-215,F,4/5/17,LAL,SAS,1,10,3,4,0.75,3,4,0.75,0,0,,2,2,1,1,1,2,3,0,1,0,0,8,10.2
Brandon Ingram,19-089,F,11/30/16,LAL,CHI,1,41,1,9,0.111,1,7,0.143,0,2,0,6,8,0.75,0,3,3,3,2,1,1,3,8,4.8
Aaron Gordon,21-119,F,1/13/17,ORL,POR,1,36,2,5,0.4,2,5,0.4,0,0,,4,6,0.667,1,6,7,0,0,1,0,2,8,6.9
JaMychal Green,26-206,F,1/13/17,MEM,HOU,1,29,3,4,0.75,2,2,1,1,2,0.5,1,2,0.5,1,3,4,1,0,0,1,4,8,5.7
Rondae Hollis-Jefferson,21-342,F,12/10/16,BRK,SAS,0,19,3,9,0.333,3,8,0.375,0,1,0,2,2,1,1,6,7,1,1,1,1,1,8,6.4
Zach Randolph,35-250,F,3/23/17,MEM,SAS,0,28,2,7,0.286,2,6,0.333,0,1,0,4,6,0.667,1,6,7,2,0,0,1,2,8,5.2
Jamal Murray,19-301,G,12/20/16,DEN,LAC,0,27,3,9,0.333,1,1,1,2,8,0.25,0,1,0,2,3,5,5,0,1,0,0,8,9
Darren Collison,29-094,G,11/25/16,SAC,HOU,1,25,2,6,0.333,2,3,0.667,0,3,0,4,4,1,0,3,3,4,2,0,1,1,8,8.9
Willie Cauley-Stein,23-116,F-C,12/12/16,SAC,LAL,0,11,4,6,0.667,4,6,0.667,0,0,,0,0,,4,0,4,0,1,0,2,1,8,6.8
Ty Lawson,29-041,G,12/14/16,SAC,HOU,0,24,4,9,0.444,4,8,0.5,0,1,0,0,0,,0,0,0,7,3,0,3,1,8,7.8
Willie Reed,26-228,F-C,12/30/16,MIA,BOS,0,14,4,6,0.667,4,6,0.667,0,0,,0,0,,2,2,4,0,0,1,1,2,8,6.3
Aaron Gordon,21-076,F,12/1/16,ORL,MEM,1,21,3,6,0.5,3,3,1,0,3,0,2,4,0.5,0,3,3,2,0,1,0,0,8,7.2
Trevor Booker,29-057,F,1/21/17,BRK,CHO,1,27,4,7,0.571,4,6,0.667,0,1,0,0,0,,3,6,9,0,2,0,2,1,8,8.2
Kenneth Faried,26-350,F,11/3/16,DEN,MIN,0,19,4,4,1,4,4,1,0,0,,0,0,,1,4,5,1,1,1,2,2,8,8.3
P.J. Tucker,31-264,F,1/24/17,PHO,MIN,0,34,1,3,0.333,1,3,0.333,0,0,,6,8,0.75,0,6,6,6,4,1,0,0,8,16.2
Kris Humphries,31-361,F-C,2/1/17,ATL,MIA,0,16,3,4,0.75,2,3,0.667,1,1,1,1,2,0.5,0,3,3,0,1,1,0,1,8,8.2
Alex Len,23-264,C,3/7/17,PHO,WAS,1,22,3,4,0.75,3,4,0.75,0,0,,2,2,1,2,9,11,0,1,4,2,3,8,11.1
Malcolm Delaney,27-238,G,11/4/16,ATL,WAS,0,15,2,5,0.4,0,2,0,2,3,0.667,2,2,1,0,0,0,3,0,0,0,0,8,7.4
Luc Mbah a Moute,30-145,F,2/1/17,LAC,PHO,0,13,4,5,0.8,4,5,0.8,0,0,,0,0,,1,1,2,0,1,1,1,5,8,5.8
Luc Mbah a Moute,30-155,F,2/11/17,LAC,CHO,1,22,4,7,0.571,4,6,0.667,0,1,0,0,0,,0,0,0,0,2,0,0,1,8,6.3
James Michael McAdoo,24-016,F,1/20/17,GSW,HOU,0,12,3,3,1,3,3,1,0,0,,2,2,1,0,2,2,1,0,0,3,0,8,5.4
Jerami Grant,22-280,F,12/17/16,OKC,PHO,0,29,3,8,0.375,2,6,0.333,1,2,0.5,1,2,0.5,1,4,5,1,1,1,1,3,8,5.3
Nemanja Bjelica,28-247,F,1/11/17,MIN,HOU,0,21,2,7,0.286,2,3,0.667,0,4,0,4,4,1,2,5,7,0,1,0,3,3,8,3.6
Dirk Nowitzki,38-227,F,2/1/17,DAL,PHI,1,28,4,12,0.333,4,10,0.4,0,2,0,0,0,,0,5,5,3,1,0,1,1,8,4.4
Pau Gasol,36-118,F-C,11/1/16,SAS,UTA,1,27,4,8,0.5,4,7,0.571,0,1,0,0,0,,1,7,8,2,0,3,0,3,8,9.1
Omer Asik,30-126,C,11/7/16,NOP,GSW,1,14,3,6,0.5,3,6,0.5,0,0,,2,3,0.667,3,3,6,0,0,0,0,0,8,7.6
Brandon Rush,31-279,G-F,4/12/17,MIN,HOU,1,24,3,3,1,1,1,1,2,2,1,0,0,,1,1,2,2,0,0,2,0,8,7.5
Willie Cauley-Stein,23-180,F-C,2/14/17,SAC,LAL,0,15,3,5,0.6,3,5,0.6,0,0,,2,2,1,2,1,3,0,3,1,0,0,8,11.1
Marcin Gortat,33-046,C-F,4/4/17,WAS,CHO,1,25,4,6,0.667,4,6,0.667,0,0,,0,0,,1,4,5,2,0,2,0,0,8,10.1
Cody Zeller,24-154,F-C,3/8/17,CHO,MIA,1,42,4,8,0.5,4,8,0.5,0,0,,0,0,,2,2,4,2,0,2,1,4,8,6.2
Kyle O'Quinn,26-258,F-C,12/9/16,NYK,SAC,0,20,4,7,0.571,4,7,0.571,0,0,,0,0,,5,6,11,5,0,2,1,4,8,12.3
Trevor Ariza,31-125,F,11/2/16,HOU,NYK,1,30,3,10,0.3,2,5,0.4,1,5,0.2,1,2,0.5,0,4,4,3,4,0,0,1,8,8.7
Mario Hezonja,22-006,F-G,3/3/17,ORL,MIA,0,16,2,6,0.333,2,4,0.5,0,2,0,4,4,1,0,3,3,1,0,0,0,2,8,5.4
Maurice Harkless,23-293,F-G,2/28/17,POR,DET,1,37,4,8,0.5,4,7,0.571,0,1,0,0,2,0,3,7,10,2,0,1,2,6,8,5.1
Andre Roberson,25-089,G-F,3/3/17,OKC,PHO,1,31,3,5,0.6,2,2,1,1,3,0.333,1,2,0.5,1,2,3,0,1,2,2,2,8,6.2
Al-Farouq Aminu,26-096,F,12/26/16,POR,TOR,1,33,3,7,0.429,1,3,0.333,2,4,0.5,0,0,,0,8,8,3,0,1,0,2,8,8.7
Larry Nance Jr.,24-090,F,4/1/17,LAL,LAC,1,23,4,10,0.4,4,10,0.4,0,0,,0,0,,3,1,4,3,2,0,1,5,8,6.1
Bryn Forbes,23-256,G,4/5/17,SAS,LAL,0,24,3,10,0.3,1,3,0.333,2,7,0.286,0,0,,0,1,1,2,0,0,3,1,8,0.5
Garrett Temple,30-182,G,11/6/16,SAC,TOR,0,21,3,6,0.5,2,2,1,1,4,0.25,1,1,1,1,2,3,1,1,1,1,2,8,6.9
Steven Adams,23-169,C,1/5/17,OKC,HOU,1,29,2,6,0.333,2,6,0.333,0,0,,4,4,1,1,7,8,3,2,2,2,2,8,10.1
Cory Joseph,25-165,G,2/1/17,TOR,BOS,0,23,4,10,0.4,4,10,0.4,0,0,,0,1,0,0,1,1,4,0,0,1,5,8,2.3
Patrick Patterson,27-259,F,11/28/16,TOR,PHI,0,20,3,5,0.6,1,1,1,2,4,0.5,0,0,,0,2,2,1,2,0,0,1,8,8.6
Dario Saric,22-273,F,1/6/17,PHI,BOS,0,23,3,9,0.333,3,6,0.5,0,3,0,2,2,1,1,5,6,1,0,0,2,0,8,3.8
D.J. Augustin,29-026,G,12/6/16,ORL,WAS,1,20,2,5,0.4,1,2,0.5,1,3,0.333,3,5,0.6,0,1,1,2,1,0,0,0,8,7.2
Trevor Booker,28-336,F,10/26/16,BRK,BOS,1,24,4,5,0.8,4,4,1,0,1,0,0,0,,1,6,7,5,3,0,1,0,8,14.1
Channing Frye,33-314,C-F,3/27/17,CLE,SAS,0,22,4,7,0.571,4,4,1,0,3,0,0,0,,0,3,3,0,2,0,1,2,8,5.8
Matthew Dellavedova,26-069,G,11/16/16,MIL,ATL,1,27,3,9,0.333,1,4,0.25,2,5,0.4,0,0,,0,1,1,7,1,0,1,0,8,8.1
Ish Smith,28-207,G,1/28/17,DET,MIA,0,17,4,9,0.444,4,9,0.444,0,0,,0,0,,1,1,2,2,0,0,1,2,8,3.9
Evan Turner,28-019,G,11/15/16,POR,CHI,0,20,3,9,0.333,3,7,0.429,0,2,0,2,2,1,0,4,4,1,0,0,0,1,8,4.4
Taj Gibson,31-146,F,11/17/16,CHI,UTA,1,27,3,7,0.429,3,7,0.429,0,0,,2,2,1,4,5,9,0,0,1,2,2,8,6.5
Tarik Black,25-078,C-F,2/8/17,LAL,DET,1,19,4,9,0.444,4,9,0.444,0,0,,0,0,,3,7,10,3,0,1,2,3,8,7.1
Jordan Clarkson,24-179,G,12/3/16,LAL,MEM,0,28,4,16,0.25,4,14,0.286,0,2,0,0,0,,3,1,4,2,0,0,2,3,8,-1
JaVale McGee,28-346,C,12/30/16,GSW,DAL,0,11,4,4,1,4,4,1,0,0,,0,0,,0,1,1,0,0,0,0,1,8,6.7
Marvin Williams,30-208,F,1/13/17,CHO,PHI,1,28,2,6,0.333,0,2,0,2,4,0.5,2,2,1,1,2,3,0,1,0,4,1,8,2.5
Rondae Hollis-Jefferson,21-355,F,12/23/16,BRK,CLE,0,23,3,6,0.5,3,5,0.6,0,1,0,2,2,1,0,3,3,1,1,0,2,3,8,4.4
Michael Kidd-Gilchrist,23-138,F,2/11/17,CHO,LAC,1,32,4,8,0.5,4,8,0.5,0,0,,0,0,,1,6,7,1,2,0,0,4,8,7.6
Stanley Johnson,20-316,F,4/10/17,DET,WAS,0,22,3,9,0.333,1,6,0.167,2,3,0.667,0,0,,0,0,0,2,1,0,1,2,8,3.5
Willy Hernangomez,22-282,C,3/5/17,NYK,GSW,0,14,4,5,0.8,4,5,0.8,0,0,,0,0,,2,3,5,0,0,0,3,2,8,4.6
JaMychal Green,26-189,F,12/27/16,MEM,BOS,1,22,3,5,0.6,3,5,0.6,0,0,,2,2,1,1,5,6,1,2,2,1,2,8,10.2
Elfrid Payton,22-286,G,12/4/16,ORL,DET,0,23,4,9,0.444,4,7,0.571,0,2,0,0,3,0,2,2,4,3,0,0,0,0,8,6.2
Kris Dunn,22-222,G,10/26/16,MIN,MEM,0,15,4,6,0.667,4,5,0.8,0,1,0,0,0,,1,3,4,1,1,0,1,3,8,6.5
Omer Asik,30-157,C,12/8/16,NOP,PHI,0,20,3,4,0.75,3,4,0.75,0,0,,2,3,0.667,5,4,9,2,1,0,0,3,8,11.9
Patty Mills,28-082,G,11/1/16,SAS,UTA,0,15,4,8,0.5,4,4,1,0,4,0,0,0,,1,0,1,2,1,0,1,1,8,5.7
Marreese Speights,29-119,C-F,12/1/16,LAC,CLE,0,16,4,7,0.571,4,6,0.667,0,1,0,0,0,,1,3,4,0,0,1,1,4,8,4.4
Denzel Valentine,23-065,G,1/20/17,CHI,ATL,0,24,3,10,0.3,1,2,0.5,2,8,0.25,0,0,,1,5,6,1,3,2,2,2,8,6.7
Ben McLemore,23-313,G,12/20/16,SAC,POR,1,21,2,4,0.5,1,1,1,1,3,0.333,3,3,1,0,0,0,0,0,0,0,3,8,4.8
Arron Afflalo,31-107,G,1/30/17,SAC,PHI,1,36,3,9,0.333,1,2,0.5,2,7,0.286,0,0,,0,4,4,3,0,0,2,3,8,3
Caris LeVert,22-143,G-F,1/15/17,BRK,HOU,0,22,2,8,0.25,0,2,0,2,6,0.333,2,2,1,0,2,2,2,1,0,0,0,8,6.2
Robin Lopez,28-209,C,10/27/16,CHI,BOS,1,27,3,8,0.375,3,8,0.375,0,0,,2,4,0.5,6,2,8,1,0,0,1,2,8,6.5
Sergio Rodriguez,30-160,G,11/19/16,PHI,PHO,1,29,3,10,0.3,1,4,0.25,2,6,0.333,0,0,,0,8,8,11,2,0,4,0,8,10.3
Tony Allen,34-337,G-F,12/13/16,MEM,CLE,1,25,4,9,0.444,4,9,0.444,0,0,,0,1,0,0,1,1,1,3,0,1,3,8,4.7
Hassan Whiteside,27-177,C,12/7/16,MIA,ATL,1,36,4,12,0.333,4,12,0.333,0,0,,0,0,,3,9,12,0,0,1,4,5,8,0.7
Reggie Jackson,26-319,G,3/1/17,DET,NOP,1,29,4,16,0.25,4,13,0.308,0,3,0,0,0,,0,2,2,4,1,0,1,3,8,0.6
Dirk Nowitzki,38-253,F,2/27/17,DAL,MIA,1,26,2,9,0.222,1,7,0.143,1,2,0.5,3,3,1,1,11,12,1,0,1,0,1,8,7.5
Tristan Thompson,25-261,F-C,11/29/16,CLE,MIL,1,30,3,6,0.5,3,6,0.5,0,0,,2,4,0.5,2,3,5,2,2,3,1,2,8,10.2
Devin Harris,34-022,G,3/21/17,DAL,GSW,0,15,3,6,0.5,1,1,1,2,5,0.4,0,0,,0,1,1,2,0,0,0,0,8,6.7
Mike Dunleavy,36-148,F-G,2/10/17,ATL,SAC,0,12,3,5,0.6,1,2,0.5,2,3,0.667,0,0,,0,1,1,0,0,0,0,1,8,5.6
Joe Harris,25-081,G,11/27/16,BRK,SAC,0,19,3,8,0.375,1,3,0.333,2,5,0.4,0,0,,0,0,0,1,0,0,0,2,8,3.5
Nicolas Batum,28-033,F-G,1/16/17,CHO,BOS,1,37,2,11,0.182,2,7,0.286,0,4,0,4,5,0.8,1,9,10,10,1,2,4,0,8,9.5
Robert Covington,25-349,F,11/27/16,PHI,CLE,1,21,3,9,0.333,1,3,0.333,2,6,0.333,0,0,,1,5,6,0,1,0,0,2,8,5.3
Domantas Sabonis,20-178,F,10/28/16,OKC,PHO,1,17,4,6,0.667,4,6,0.667,0,0,,0,0,,0,4,4,0,0,0,1,3,8,4.4
Jusuf Nurkic,22-102,C,12/3/16,DEN,UTA,1,13,4,6,0.667,4,6,0.667,0,0,,0,0,,3,1,4,1,0,0,0,2,8,7.7
Ian Clark,25-241,G,11/3/16,GSW,OKC,0,19,3,5,0.6,2,3,0.667,1,2,0.5,1,1,1,0,3,3,0,0,0,0,0,8,6.6
Shabazz Napier,25-216,G,2/15/17,POR,UTA,0,12,3,5,0.6,2,3,0.667,1,2,0.5,1,2,0.5,0,1,1,2,0,0,1,0,8,6
John Henson,26-023,C-F,1/20/17,MIL,ORL,1,16,3,4,0.75,3,4,0.75,0,0,,2,2,1,1,4,5,2,0,1,2,2,8,7.6
Reggie Jackson,26-333,G,3/15/17,DET,UTA,1,20,4,11,0.364,4,10,0.4,0,1,0,0,0,,0,2,2,2,0,0,1,0,8,2.9
Pau Gasol,36-255,F-C,3/18/17,SAS,MEM,0,24,3,5,0.6,3,4,0.75,0,1,0,2,2,1,3,6,9,1,0,0,1,1,8,8.9
Axel Toupane,24-263,G-F,4/12/17,NOP,POR,0,21,4,4,1,4,4,1,0,0,,0,0,,0,1,1,0,1,0,0,4,8,6.5
Al Jefferson,32-033,C-F,2/6/17,IND,OKC,0,12,4,9,0.444,4,9,0.444,0,0,,0,0,,2,3,5,1,0,0,0,1,8,5.9
Garrett Temple,30-240,G,1/3/17,SAC,DEN,0,25,4,9,0.444,4,7,0.571,0,2,0,0,0,,2,3,5,5,2,1,1,0,8,10.8
Marcus Smart,22-327,G,1/27/17,BOS,ORL,0,23,3,7,0.429,1,4,0.25,2,3,0.667,0,0,,0,2,2,11,1,0,2,0,8,11.6
Alec Burks,25-239,G,3/16/17,UTA,CLE,0,21,3,9,0.333,3,8,0.375,0,1,0,2,2,1,0,4,4,1,0,0,2,1,8,2.4
Iman Shumpert,26-256,G,3/9/17,CLE,DET,1,35,3,8,0.375,1,3,0.333,2,5,0.4,0,0,,0,1,1,1,0,0,2,1,8,2.2
Seth Curry,26-139,G,1/9/17,DAL,MIN,0,30,3,6,0.5,1,3,0.333,2,3,0.667,0,0,,1,1,2,0,1,1,3,0,8,4.7
Gerald Green,30-334,G-F,12/25/16,BOS,NYK,0,12,3,6,0.5,1,3,0.333,2,3,0.667,0,0,,2,2,4,1,1,1,0,0,8,9.4
Michael Kidd-Gilchrist,23-136,F,2/9/17,CHO,HOU,1,35,4,9,0.444,4,9,0.444,0,0,,0,0,,4,5,9,4,1,2,0,1,8,12.4
Marcin Gortat,32-262,C-F,11/5/16,WAS,ORL,1,37,3,10,0.3,3,10,0.3,0,0,,2,4,0.5,4,10,14,2,1,0,2,3,8,6.4
Clint Capela,22-208,F-C,12/12/16,HOU,BRK,1,19,4,4,1,4,4,1,0,0,,0,4,0,0,6,6,2,0,0,0,4,8,6.8
Tarik Black,25-130,C-F,4/1/17,LAL,LAC,0,25,3,3,1,3,3,1,0,0,,2,2,1,1,4,5,1,1,1,1,3,8,9.2
Kyle O'Quinn,26-244,F-C,11/25/16,NYK,CHO,0,17,4,7,0.571,4,7,0.571,0,0,,0,0,,0,3,3,3,0,2,0,2,8,8.3
Sergio Rodriguez,30-229,G,1/27/17,PHI,HOU,0,20,3,7,0.429,1,2,0.5,2,5,0.4,0,1,0,0,0,0,2,2,0,2,1,8,4.9
Mike Conley,29-066,G,12/16/16,MEM,SAC,1,29,2,7,0.286,2,4,0.5,0,3,0,4,5,0.8,0,3,3,6,2,1,3,1,8,7.9
Brandon Bass,31-239,F,12/25/16,LAC,LAL,0,19,3,3,1,3,3,1,0,0,,2,2,1,0,4,4,2,1,0,1,0,8,9.7
Dirk Nowitzki,38-292,F,4/7/17,DAL,SAS,1,16,4,6,0.667,4,4,1,0,2,0,0,0,,0,3,3,1,0,3,1,2,8,7.3
Buddy Hield,22-335,G,11/16/16,NOP,ORL,0,20,3,7,0.429,2,4,0.5,1,3,0.333,1,1,1,0,5,5,5,0,0,2,2,8,6.5
Rudy Gobert,24-191,C,1/3/17,UTA,BOS,1,34,3,8,0.375,3,8,0.375,0,0,,2,2,1,5,8,13,0,0,1,1,1,8,8.8
Tarik Black,25-003,C-F,11/25/16,LAL,GSW,0,17,2,4,0.5,2,4,0.5,0,0,,4,4,1,4,1,5,1,1,0,0,1,8,10.4
Taj Gibson,31-187,F,12/28/16,CHI,BRK,1,29,4,7,0.571,4,7,0.571,0,0,,0,0,,1,2,3,0,2,1,1,3,8,6.5
Jabari Parker,21-270,F,12/10/16,MIL,WAS,1,24,3,8,0.375,2,5,0.4,1,3,0.333,1,2,0.5,0,4,4,0,0,0,3,4,8,-0.2
Shelvin Mack,26-199,G,11/7/16,UTA,PHI,1,29,3,6,0.5,1,4,0.25,2,2,1,0,0,,0,0,0,5,2,0,1,2,8,8.7
Kevin Seraphin,27-031,F,1/7/17,IND,NYK,0,19,4,6,0.667,4,6,0.667,0,0,,0,0,,1,4,5,2,0,0,2,4,8,5.1
T.J. McConnell,24-301,G,1/20/17,PHI,POR,1,31,4,8,0.5,4,8,0.5,0,0,,0,0,,1,3,4,5,0,0,2,3,8,5.9
Iman Shumpert,26-218,G,1/30/17,CLE,DAL,1,30,1,6,0.167,0,3,0,1,3,0.333,5,6,0.833,0,4,4,0,0,0,0,1,8,4.6
Allen Crabbe,24-295,G-F,1/29/17,POR,GSW,0,22,4,7,0.571,4,6,0.667,0,1,0,0,0,,0,0,0,1,2,0,1,4,8,4.8
Larry Nance Jr.,24-032,F,2/2/17,LAL,WAS,0,20,4,8,0.5,4,8,0.5,0,0,,0,0,,3,3,6,1,3,0,1,2,8,8.9
Montrezl Harrell,22-360,F-C,1/20/17,HOU,GSW,1,27,4,7,0.571,4,7,0.571,0,0,,0,0,,1,2,3,1,1,1,1,4,8,5.8
P.J. Tucker,31-316,F,3/17/17,TOR,DET,0,27,3,6,0.5,1,3,0.333,2,3,0.667,0,0,,1,8,9,2,3,0,0,1,8,12.1
Langston Galloway,25-100,G,3/19/17,SAC,SAS,0,23,4,8,0.5,4,7,0.571,0,1,0,0,0,,1,0,1,2,0,0,1,4,8,3.5
Tyler Ennis,22-195,G,3/7/17,LAL,DAL,0,17,4,8,0.5,4,6,0.667,0,2,0,0,0,,1,1,2,4,0,0,1,1,8,6.4
Joe Ingles,29-062,F-G,12/3/16,UTA,DEN,0,27,3,5,0.6,1,2,0.5,2,3,0.667,0,0,,0,3,3,4,1,0,1,1,8,9
Jason Terry,39-190,G,3/24/17,MIL,ATL,0,25,2,4,0.5,0,0,,2,4,0.5,2,2,1,0,1,1,1,1,2,0,1,8,9
Timofey Mozgov,30-182,C,1/14/17,LAL,LAC,1,21,4,6,0.667,4,6,0.667,0,0,,0,1,0,2,3,5,2,0,1,2,2,8,6.6
Clint Capela,22-195,F-C,11/29/16,HOU,UTA,1,28,4,6,0.667,4,6,0.667,0,0,,0,0,,2,4,6,1,1,1,0,3,8,9.2
Manu Ginobili,39-177,G,1/21/17,SAS,CLE,0,20,3,9,0.333,1,3,0.333,2,6,0.333,0,0,,1,1,2,3,0,0,1,4,8,3.4
James Ennis,26-211,F,1/28/17,MEM,UTA,1,23,3,4,0.75,2,2,1,1,2,0.5,1,2,0.5,0,4,4,1,0,0,2,5,8,3.9
Trey Lyles,21-006,F,11/11/16,UTA,ORL,0,21,3,7,0.429,1,2,0.5,2,5,0.4,0,0,,1,3,4,2,1,0,2,3,8,5.1
Norman Powell,23-207,G,12/18/16,TOR,ORL,0,8,4,6,0.667,4,4,1,0,2,0,0,0,,0,1,1,0,1,0,1,0,8,5.7
James Johnson,30-007,F,2/27/17,MIA,DAL,0,31,4,12,0.333,4,8,0.5,0,4,0,0,0,,1,4,5,2,1,1,0,3,8,5
Cristiano Felicio,24-171,F-C,12/25/16,CHI,SAS,0,18,2,4,0.5,2,4,0.5,0,0,,4,5,0.8,2,1,3,2,0,0,2,2,8,5.9
Zaza Pachulia,32-322,C,12/28/16,GSW,TOR,1,18,3,5,0.6,3,5,0.6,0,0,,2,2,1,2,1,3,3,0,0,1,3,8,7.3
D.J. Augustin,28-359,G,11/3/16,ORL,SAC,0,14,3,8,0.375,1,4,0.25,2,4,0.5,0,0,,0,0,0,5,0,0,3,0,8,4.1
Mason Plumlee,26-251,C-F,11/11/16,POR,SAC,1,35,3,5,0.6,3,5,0.6,0,0,,2,5,0.4,2,5,7,7,2,2,2,6,8,11.3
Tony Parker,34-318,G,3/31/17,SAS,OKC,1,23,4,11,0.364,4,9,0.444,0,2,0,0,2,0,0,1,1,2,0,0,3,2,8,-1
Marreese Speights,29-191,C-F,2/11/17,LAC,CHO,0,15,3,7,0.429,1,3,0.333,2,4,0.5,0,0,,1,3,4,2,1,1,1,3,8,6.8
Tony Allen,35-074,G-F,3/26/17,MEM,GSW,1,30,4,8,0.5,4,7,0.571,0,1,0,0,2,0,4,2,6,5,2,0,3,2,8,8.3
Kosta Koufos,27-365,C,2/23/17,SAC,DEN,1,21,4,7,0.571,4,7,0.571,0,0,,0,0,,1,5,6,0,0,2,0,1,8,7.9
Cory Joseph,25-069,G,10/28/16,TOR,CLE,0,21,4,7,0.571,4,7,0.571,0,0,,0,0,,0,1,1,1,1,0,3,0,8,3.7
Chris Paul,31-255,G,1/16/17,LAC,OKC,1,14,3,5,0.6,1,2,0.5,2,3,0.667,0,0,,0,3,3,6,1,0,3,0,8,8.8
Kosta Koufos,27-287,C,12/7/16,SAC,DAL,1,17,4,4,1,4,4,1,0,0,,0,0,,1,3,4,0,1,0,0,2,8,8.6
Ricky Rubio,26-040,G,11/30/16,MIN,NYK,1,38,2,5,0.4,2,3,0.667,0,2,0,4,4,1,0,2,2,6,3,0,2,2,8,10.3
Richaun Holmes,23-054,F-C,12/8/16,PHI,NOP,0,20,4,6,0.667,4,6,0.667,0,0,,0,2,0,0,7,7,1,0,2,0,4,8,7.2
Al Jefferson,32-038,C-F,2/11/17,IND,MIL,0,17,4,6,0.667,4,6,0.667,0,0,,0,0,,0,4,4,0,0,0,0,1,8,6.2
Malcolm Delaney,27-266,G,12/2/16,ATL,DET,0,19,2,4,0.5,2,4,0.5,0,0,,4,5,0.8,0,1,1,3,0,0,2,2,8,5.2
DeMarre Carroll,30-131,F,12/5/16,TOR,CLE,1,33,3,10,0.3,2,4,0.5,1,6,0.167,1,2,0.5,0,0,0,3,1,0,1,4,8,2.3
Al-Farouq Aminu,26-185,F,3/25/17,POR,MIN,0,27,4,5,0.8,4,5,0.8,0,0,,0,2,0,0,6,6,0,2,0,1,2,8,7.3
Julius Randle,22-057,F,1/25/17,LAL,POR,1,20,4,9,0.444,4,9,0.444,0,0,,0,1,0,1,4,5,1,0,0,2,2,8,2.7
Patty Mills,28-244,G,4/12/17,SAS,UTA,0,19,3,5,0.6,1,3,0.333,2,2,1,0,0,,0,2,2,5,1,0,1,1,8,9.4
Evan Fournier,23-365,G-F,10/28/16,ORL,DET,1,27,4,12,0.333,4,8,0.5,0,4,0,0,1,0,0,2,2,2,1,0,1,3,8,1.6
Patty Mills,28-093,G,11/12/16,SAS,HOU,0,21,3,8,0.375,1,2,0.5,2,6,0.333,0,0,,0,4,4,4,0,0,1,1,8,6.2
Manu Ginobili,39-187,G,1/31/17,SAS,OKC,0,21,3,6,0.5,2,3,0.667,1,3,0.333,1,3,0.333,0,2,2,4,1,1,1,2,8,7.5
Michael Beasley,28-023,F,2/1/17,MIL,UTA,0,17,2,7,0.286,1,3,0.333,1,4,0.25,3,6,0.5,1,2,3,0,0,2,2,1,8,3
Larry Nance Jr.,24-070,F,3/12/17,LAL,PHI,0,22,3,4,0.75,1,1,1,2,3,0.667,0,1,0,0,4,4,2,4,0,0,1,8,12.2
Ian Clark,25-266,G,11/28/16,GSW,ATL,0,11,3,6,0.5,1,1,1,2,5,0.4,0,0,,0,2,2,1,0,0,0,2,8,5.5
Lance Stephenson,26-215,G-F,4/8/17,IND,ORL,0,22,3,7,0.429,1,5,0.2,2,2,1,0,0,,0,6,6,3,0,1,3,1,8,5.5
Mario Hezonja,21-356,F-G,2/15/17,ORL,SAS,0,25,4,10,0.4,4,9,0.444,0,1,0,0,0,,0,1,1,1,1,1,0,1,8,4.9
Deron Williams,32-259,G,3/12/17,CLE,HOU,0,23,2,6,0.333,0,2,0,2,4,0.5,2,2,1,0,5,5,5,0,0,1,3,8,7.4
Roy Hibbert,30-025,C,1/5/17,CHO,DET,1,19,3,3,1,3,3,1,0,0,,2,2,1,2,4,6,1,0,3,0,4,8,10.9
Michael Beasley,27-331,F,12/5/16,MIL,SAS,0,14,3,3,1,3,3,1,0,0,,2,2,1,0,1,1,0,0,1,2,1,8,5.7
Jaylen Brown,20-003,F,10/27/16,BOS,CHI,0,20,4,7,0.571,4,6,0.667,0,1,0,0,0,,0,1,1,1,0,0,1,3,8,3.5
Bojan Bogdanovic,27-221,G-F,11/25/16,BRK,IND,1,26,3,10,0.3,1,5,0.2,2,5,0.4,0,0,,0,3,3,1,0,0,1,0,8,2.8
Jerami Grant,22-336,F,2/11/17,OKC,GSW,0,23,2,6,0.333,2,4,0.5,0,2,0,4,4,1,1,4,5,2,0,3,0,3,8,8.8
T.J. Warren,23-141,F,1/24/17,PHO,MIN,1,30,4,11,0.364,4,9,0.444,0,2,0,0,1,0,1,1,2,1,0,0,2,4,8,-0.4
Robin Lopez,29-000,C,4/1/17,CHI,ATL,1,36,4,9,0.444,4,9,0.444,0,0,,0,0,,1,3,4,1,0,0,2,2,8,2.8
Isaiah Canaan,25-180,G,11/17/16,CHI,UTA,0,26,4,9,0.444,4,8,0.5,0,1,0,0,0,,0,2,2,0,1,0,2,2,8,2.1
Dante Exum,21-233,G,3/3/17,UTA,BRK,0,16,2,5,0.4,1,2,0.5,1,3,0.333,3,3,1,0,2,2,2,1,0,3,5,8,3.3
Trevor Ariza,31-179,F,12/26/16,HOU,PHO,1,26,3,9,0.333,2,2,1,1,7,0.143,1,1,1,0,10,10,4,5,0,1,3,8,11.5
Jerian Grant,24-065,G,12/13/16,CHI,MIN,1,19,3,6,0.5,1,4,0.25,2,2,1,0,0,,0,3,3,1,1,0,0,1,8,7.2
J.J. Barea,32-285,G,4/7/17,DAL,SAS,0,11,2,6,0.333,0,1,0,2,5,0.4,2,2,1,0,2,2,8,0,0,1,0,8,9.8
Andre Drummond,23-240,C,4/7/17,DET,HOU,1,20,4,11,0.364,4,11,0.364,0,0,,0,2,0,5,4,9,1,1,0,1,3,8,5.3
Ivica Zubac,19-300,C,1/12/17,LAL,SAS,0,15,4,7,0.571,4,7,0.571,0,0,,0,0,,2,2,4,1,2,1,1,1,8,8.7
Tony Snell,25-069,G-F,1/18/17,MIL,HOU,1,32,3,6,0.5,1,3,0.333,2,3,0.667,0,0,,0,4,4,3,2,0,1,1,8,8.9
Zach Randolph,35-231,F,3/4/17,MEM,HOU,0,24,3,9,0.333,2,7,0.286,1,2,0.5,1,2,0.5,2,4,6,1,0,0,0,2,8,5
Jason Terry,39-142,G,2/4/17,MIL,PHO,0,19,2,3,0.667,0,0,,2,3,0.667,2,2,1,1,0,1,2,1,2,1,0,8,10.2
Mirza Teletovic,31-103,F,12/30/16,MIL,MIN,0,19,2,4,0.5,0,0,,2,4,0.5,2,2,1,0,3,3,1,0,1,2,1,8,5.9
Luke Babbitt,27-270,F,3/17/17,MIA,MIN,1,18,3,5,0.6,1,2,0.5,2,3,0.667,0,0,,0,2,2,0,0,0,2,1,8,3.9
David Lee,33-334,F,3/29/17,SAS,GSW,0,16,4,7,0.571,4,7,0.571,0,0,,0,0,,2,2,4,0,0,1,1,2,8,5.6
Patrick Patterson,27-300,F,1/8/17,TOR,HOU,0,22,3,5,0.6,1,3,0.333,2,2,1,0,0,,3,4,7,2,0,0,1,6,8,7
Juan Hernangomez,21-113,F,1/19/17,DEN,SAS,1,38,3,9,0.333,2,5,0.4,1,4,0.25,1,2,0.5,2,4,6,1,1,1,1,3,8,5.3
Nikola Mirotic,25-323,F,12/30/16,CHI,IND,0,27,3,14,0.214,1,3,0.333,2,11,0.182,0,0,,0,6,6,0,0,3,1,0,8,2.3
Mike Dunleavy,36-209,F-G,4/12/17,ATL,IND,0,17,2,6,0.333,1,2,0.5,1,4,0.25,3,3,1,0,3,3,1,0,0,1,0,8,5.2
Shaun Livingston,31-165,G,2/23/17,GSW,LAC,0,17,4,7,0.571,4,7,0.571,0,0,,0,0,,0,1,1,1,0,1,1,0,8,5.4
Gerald Green,30-338,G-F,12/29/16,BOS,CLE,0,16,3,6,0.5,1,2,0.5,2,4,0.5,0,0,,0,0,0,0,1,1,0,4,8,5.1
Jusuf Nurkic,22-187,C,2/26/17,POR,TOR,1,21,3,9,0.333,3,9,0.333,0,0,,2,3,0.667,1,3,4,2,1,0,1,4,8,3.9
Otto Porter,23-252,F,2/10/17,WAS,IND,1,25,3,7,0.429,2,3,0.667,1,4,0.25,1,1,1,1,3,4,1,2,0,1,5,8,5.6
Dario Saric,22-217,F,11/11/16,PHI,IND,1,29,3,6,0.5,2,4,0.5,1,2,0.5,1,1,1,0,5,5,2,3,0,4,1,8,6.5
Jon Leuer,27-171,F,11/1/16,DET,NYK,0,26,4,9,0.444,4,8,0.5,0,1,0,0,0,,3,3,6,0,1,1,0,1,8,7.6
Jabari Parker,21-306,F,1/15/17,MIL,ATL,1,33,4,9,0.444,4,6,0.667,0,3,0,0,0,,3,7,10,9,1,0,2,3,8,11.6
Channing Frye,33-214,C-F,12/17/16,CLE,LAL,0,14,3,3,1,1,1,1,2,2,1,0,0,,0,0,0,2,1,0,0,1,8,9.1
John Henson,25-364,C-F,12/26/16,MIL,WAS,1,25,4,7,0.571,4,7,0.571,0,0,,0,0,,0,3,3,1,0,0,1,3,8,4.1
T.J. Warren,23-149,F,2/1/17,PHO,LAC,1,29,3,6,0.5,3,6,0.5,0,0,,2,3,0.667,2,1,3,0,0,0,0,4,8,4.7
Joe Harris,25-089,G,12/5/16,BRK,WAS,0,28,2,5,0.4,1,3,0.333,1,2,0.5,3,4,0.75,0,5,5,1,1,0,2,3,8,4.9
Matt Barnes,36-256,F,11/20/16,SAC,TOR,1,36,3,10,0.3,1,4,0.25,2,6,0.333,0,0,,0,1,1,2,1,0,3,2,8,1.1
Rondae Hollis-Jefferson,22-024,F,1/27/17,BRK,CLE,1,25,3,9,0.333,2,6,0.333,1,3,0.333,1,2,0.5,0,3,3,4,2,0,1,1,8,6.8
Malcolm Brogdon,24-075,G,2/24/17,MIL,UTA,0,22,2,6,0.333,1,3,0.333,1,3,0.333,3,3,1,0,1,1,4,0,0,1,3,8,5.5
Marcus Georges-Hunt,23-009,G,4/6/17,ORL,BRK,0,20,2,4,0.5,1,3,0.333,1,1,1,3,4,0.75,1,6,7,0,1,0,1,3,8,6.9
D'Angelo Russell,20-357,G,2/14/17,LAL,SAC,1,23,3,9,0.333,1,6,0.167,2,3,0.667,0,0,,0,2,2,1,2,0,5,2,8,0.4
Kent Bazemore,27-184,G-F,1/1/17,ATL,SAS,1,19,3,10,0.3,2,8,0.25,1,2,0.5,1,4,0.25,1,1,2,0,2,0,0,3,8,2.8
Al Jefferson,32-022,C-F,1/26/17,IND,MIN,0,12,4,6,0.667,4,6,0.667,0,0,,0,0,,1,5,6,1,0,0,2,0,8,6.3
Willy Hernangomez,22-297,C,3/20/17,NYK,LAC,1,17,3,11,0.273,3,11,0.273,0,0,,2,2,1,5,4,9,0,0,0,1,0,8,5.2
Sergio Rodriguez,30-235,G,2/2/17,PHI,SAS,0,17,3,7,0.429,2,6,0.333,1,1,1,1,2,0.5,0,2,2,4,2,0,4,2,8,4.5
Jon Leuer,27-317,F,3/27/17,DET,NYK,0,25,4,8,0.5,4,6,0.667,0,2,0,0,0,,1,2,3,2,0,1,2,3,8,4.2
Ersan Ilyasova,29-302,F,3/13/17,ATL,SAS,0,23,3,7,0.429,2,5,0.4,1,2,0.5,1,1,1,1,4,5,2,2,1,3,2,8,6.5
Trey Lyles,21-095,F,2/8/17,UTA,NOP,0,14,3,7,0.429,1,3,0.333,2,4,0.5,0,0,,0,1,1,0,0,0,1,0,8,3.6
Anthony Bennett,23-281,F,12/20/16,BRK,TOR,0,21,2,8,0.25,1,4,0.25,1,4,0.25,3,4,0.75,4,6,10,1,1,1,1,0,8,8.8
Jameer Nelson,34-361,G,2/4/17,DEN,SAS,1,22,3,8,0.375,1,5,0.2,2,3,0.667,0,0,,1,2,3,3,0,0,1,0,8,6
Glenn Robinson,22-318,G-F,11/21/16,IND,GSW,1,37,3,14,0.214,1,9,0.111,2,5,0.4,0,0,,1,4,5,1,2,0,1,3,8,1.8
Maurice Harkless,23-319,F-G,3/26/17,POR,LAL,1,25,2,4,0.5,2,2,1,0,2,0,4,4,1,1,1,2,3,2,0,2,1,8,8.7
Al-Farouq Aminu,26-111,F,1/10/17,POR,LAL,1,29,3,6,0.5,2,4,0.5,1,2,0.5,1,2,0.5,2,13,15,4,0,3,2,1,8,12.4
Allen Crabbe,24-360,G-F,4/4/17,POR,UTA,0,26,4,7,0.571,4,5,0.8,0,2,0,0,1,0,0,2,2,1,2,2,0,1,8,8.6
JaVale McGee,28-336,C,12/20/16,GSW,UTA,0,15,4,14,0.286,4,13,0.308,0,1,0,0,0,,2,5,7,1,1,0,0,0,8,4.4
Larry Nance Jr.,23-317,F,11/13/16,LAL,MIN,0,22,4,5,0.8,4,4,1,0,1,0,0,0,,0,4,4,0,0,0,1,4,8,4.7
D.J. Augustin,29-086,G,2/4/17,ORL,ATL,0,28,2,8,0.25,0,2,0,2,6,0.333,2,2,1,0,1,1,3,1,1,1,2,8,5.5
Adreian Payne,25-272,F-C,11/17/16,MIN,PHI,0,13,2,5,0.4,2,3,0.667,0,2,0,4,6,0.667,0,1,1,1,2,3,0,4,8,8
Enes Kanter,24-180,C,11/16/16,OKC,HOU,0,15,3,6,0.5,3,6,0.5,0,0,,2,2,1,1,6,7,1,0,2,0,3,8,8.4
J.R. Smith,31-096,G-F,12/14/16,CLE,MEM,1,25,4,15,0.267,4,12,0.333,0,3,0,0,1,0,0,2,2,2,1,0,1,0,8,0.7
Channing Frye,33-270,C-F,2/11/17,CLE,DEN,0,11,3,4,0.75,1,1,1,2,3,0.667,0,0,,0,1,1,0,0,0,1,2,8,4.9
Mindaugas Kuzminskas,27-029,F,11/17/16,NYK,WAS,0,7,3,5,0.6,1,2,0.5,2,3,0.667,0,0,,0,1,1,1,1,0,1,1,8,6.3
Emmanuel Mudiay,20-303,G,1/2/17,DEN,GSW,1,31,4,11,0.364,4,8,0.5,0,3,0,0,0,,0,2,2,4,1,0,1,2,8,4.5
Joe Ingles,29-048,F-G,11/19/16,UTA,HOU,0,15,3,3,1,1,1,1,2,2,1,0,0,,0,1,1,2,0,0,1,3,8,6.6
Jamal Murray,20-041,G,4/5/17,DEN,HOU,0,26,3,13,0.231,3,7,0.429,0,6,0,2,2,1,1,2,3,4,2,1,0,0,8,6.9
P.J. Tucker,31-330,F,3/31/17,TOR,IND,0,27,3,8,0.375,1,5,0.2,2,3,0.667,0,0,,2,5,7,0,1,0,1,5,8,4.5
Jusuf Nurkic,22-096,C,11/27/16,DEN,PHO,1,16,4,7,0.571,4,7,0.571,0,0,,0,0,,1,5,6,2,0,0,2,3,8,5.1
Zaza Pachulia,32-335,C,1/10/17,GSW,MIA,1,24,3,5,0.6,3,5,0.6,0,0,,2,2,1,1,5,6,3,1,0,2,3,8,7.8
Kyle Korver,36-007,G-F,3/24/17,CLE,CHO,0,20,3,5,0.6,1,1,1,2,4,0.5,0,0,,0,1,1,1,0,1,1,2,8,5.6
Rodney McGruder,25-156,G,1/1/17,MIA,DET,1,33,3,8,0.375,2,5,0.4,1,3,0.333,1,1,1,1,3,4,1,1,0,2,2,8,4.1
Kent Bazemore,27-120,G-F,10/29/16,ATL,PHI,1,24,4,11,0.364,4,9,0.444,0,2,0,0,0,,0,4,4,2,1,0,3,1,8,2.1
Richaun Holmes,23-032,F-C,11/16/16,PHI,WAS,0,19,3,3,1,1,1,1,2,2,1,0,0,,2,1,3,2,3,0,0,3,8,12
Sam Dekker,22-256,F,1/17/17,HOU,MIA,0,25,3,8,0.375,2,5,0.4,1,3,0.333,1,2,0.5,5,2,7,2,0,0,0,0,8,8.7
Maurice Harkless,23-182,F-G,11/9/16,POR,LAC,1,22,3,5,0.6,1,1,1,2,4,0.5,0,0,,0,4,4,1,0,1,1,2,8,6.5
Gorgui Dieng,27-008,C,1/26/17,MIN,IND,1,34,3,6,0.5,3,6,0.5,0,0,,2,3,0.667,1,8,9,1,2,2,1,2,8,10
Luke Babbitt,27-286,F,4/2/17,MIA,DEN,1,13,3,4,0.75,1,1,1,2,3,0.667,0,0,,0,2,2,1,1,0,0,1,8,8.3
Taj Gibson,31-175,F,12/16/16,CHI,MIL,1,20,4,10,0.4,4,10,0.4,0,0,,0,0,,3,1,4,0,0,2,1,3,8,4.2
Jaylen Brown,20-021,F,11/14/16,BOS,NOP,0,17,3,5,0.6,3,5,0.6,0,0,,2,2,1,4,0,4,1,2,0,1,1,8,9.8
Malcolm Brogdon,23-350,G,11/25/16,MIL,TOR,0,19,3,5,0.6,1,3,0.333,2,2,1,0,0,,0,0,0,1,0,0,0,0,8,6.4
Aaron Brooks,31-294,G,11/3/16,IND,MIL,0,14,3,4,0.75,1,2,0.5,2,2,1,0,0,,0,0,0,5,1,0,4,5,8,4.9
Thaddeus Young,28-274,F,3/22/17,IND,BOS,1,25,4,7,0.571,4,6,0.667,0,1,0,0,0,,1,3,4,1,2,2,0,0,8,10.4
Patty Mills,28-185,G,2/12/17,SAS,NYK,0,20,3,8,0.375,1,3,0.333,2,5,0.4,0,0,,1,0,1,2,2,0,2,3,8,4.5
Sean Kilpatrick,26-349,G,12/20/16,BRK,TOR,1,23,3,10,0.3,3,6,0.5,0,4,0,2,2,1,0,1,1,0,3,0,2,1,8,3.1
Vince Carter,40-068,G-F,4/4/17,MEM,SAS,1,27,3,4,0.75,1,1,1,2,3,0.667,0,0,,0,2,2,2,0,0,2,1,8,6
Robin Lopez,28-220,C,11/7/16,CHI,ORL,1,24,4,7,0.571,4,7,0.571,0,0,,0,0,,3,4,7,0,0,1,0,2,8,7.9
Jimmy Butler,27-167,G-F,2/28/17,CHI,DEN,1,35,3,13,0.231,3,11,0.273,0,2,0,2,2,1,3,1,4,3,3,0,0,1,8,7.2
Montrezl Harrell,22-345,F-C,1/5/17,HOU,OKC,0,29,4,7,0.571,4,7,0.571,0,0,,0,3,0,2,6,8,3,0,0,1,4,8,6.2
Trey Burke,23-350,G,10/27/16,WAS,ATL,0,18,4,7,0.571,4,5,0.8,0,2,0,0,1,0,0,0,0,2,1,0,2,0,8,4.7
Devin Harris,34-024,G,3/23/17,DAL,LAC,0,18,2,5,0.4,0,1,0,2,4,0.5,2,2,1,0,3,3,4,2,0,0,4,8,9.4
Kristaps Porzingis,21-174,F-C,1/23/17,NYK,IND,1,25,3,11,0.273,1,5,0.2,2,6,0.333,0,0,,0,4,4,0,1,1,3,6,8,-1
D.J. Augustin,29-137,G,3/27/17,ORL,TOR,0,15,3,8,0.375,3,8,0.375,0,0,,2,2,1,1,2,3,1,0,0,2,1,8,3.2
Al-Farouq Aminu,26-114,F,1/13/17,POR,ORL,1,31,3,9,0.333,3,8,0.375,0,1,0,2,4,0.5,3,4,7,2,0,1,0,3,8,6.3
Lucas Nogueira,24-183,C,1/25/17,TOR,MEM,0,24,4,4,1,4,4,1,0,0,,0,2,0,4,4,8,0,1,1,2,3,8,8.5
Steven Adams,23-250,C,3/27/17,OKC,DAL,1,29,4,6,0.667,4,6,0.667,0,0,,0,0,,3,3,6,1,2,2,3,3,8,8.3
Luol Deng,31-221,F,11/23/16,LAL,GSW,1,26,3,9,0.333,3,8,0.375,0,1,0,2,2,1,2,5,7,2,0,0,0,1,8,6.8
Thabo Sefolosha,32-215,G-F,12/3/16,ATL,TOR,0,23,3,7,0.429,1,4,0.25,2,3,0.667,0,0,,1,3,4,1,0,1,2,0,8,5.3
Mario Hezonja,22-025,F-G,3/22/17,ORL,CHO,0,23,3,12,0.25,1,7,0.143,2,5,0.4,0,0,,1,6,7,2,0,0,0,0,8,4.7
Markieff Morris,27-087,F,11/28/16,WAS,SAC,1,44,2,12,0.167,2,10,0.2,0,2,0,4,4,1,2,3,5,4,1,0,6,5,8,-1.5
C.J. Miles,29-328,G-F,3/12/17,IND,MIA,1,30,3,8,0.375,2,3,0.667,1,5,0.2,1,1,1,0,5,5,0,0,0,0,3,8,3.9
Cole Aldrich,28-012,C,11/12/16,MIN,LAC,0,14,4,6,0.667,4,6,0.667,0,0,,0,0,,2,1,3,0,1,0,0,6,8,5.7
Buddy Hield,23-058,G,2/13/17,NOP,PHO,1,23,2,7,0.286,0,2,0,2,5,0.4,2,3,0.667,0,5,5,3,2,0,1,1,8,7.7
Mike Muscala,25-210,F-C,1/27/17,ATL,WAS,0,14,3,5,0.6,1,3,0.333,2,2,1,0,0,,1,1,2,2,0,2,0,1,8,9.1
Richard Jefferson,36-187,F,12/25/16,CLE,GSW,0,29,2,11,0.182,2,6,0.333,0,5,0,4,4,1,0,2,2,0,0,0,1,3,8,-0.5
Al Jefferson,32-063,C-F,3/8/17,IND,DET,0,18,4,10,0.4,4,10,0.4,0,0,,0,0,,1,4,5,2,0,0,0,3,8,4.7
Steven Adams,23-266,C,4/12/17,OKC,DEN,1,14,4,7,0.571,4,7,0.571,0,0,,0,0,,2,2,4,0,2,0,1,2,8,6.9
Corey Brewer,30-318,F-G,1/17/17,HOU,MIA,1,26,2,5,0.4,0,2,0,2,3,0.667,2,2,1,1,0,1,1,2,0,2,1,8,6.3
DeAndre Jordan,28-109,C,11/7/16,LAC,DET,1,27,4,5,0.8,4,5,0.8,0,0,,0,0,,0,10,10,1,0,1,4,1,8,6.1
Ivica Zubac,19-334,C,2/15/17,LAL,PHO,0,14,3,6,0.5,3,6,0.5,0,0,,2,4,0.5,2,2,4,0,0,0,1,4,8,3.6
Justise Winslow,20-267,F,12/18/16,MIA,BOS,0,32,2,3,0.667,2,3,0.667,0,0,,4,8,0.5,1,3,4,4,4,1,5,5,8,7.2
Marreese Speights,29-203,C-F,2/23/17,LAC,GSW,0,14,3,7,0.429,2,4,0.5,1,3,0.333,1,1,1,0,5,5,0,0,0,2,1,8,3.4
DeAndre Liggins,28-273,G,12/29/16,CLE,BOS,1,20,2,5,0.4,0,1,0,2,4,0.5,2,2,1,0,0,0,1,0,0,0,3,8,4.8
Randy Foye,33-136,G,2/7/17,BRK,CHO,1,21,2,4,0.5,1,2,0.5,1,2,0.5,3,3,1,0,5,5,3,0,0,3,2,8,5.8
JaVale McGee,28-309,C,11/23/16,GSW,LAL,0,10,3,4,0.75,3,4,0.75,0,0,,2,4,0.5,0,4,4,0,0,1,2,2,8,4.7
Dante Cunningham,29-252,F,12/30/16,NOP,NYK,1,35,3,7,0.429,1,3,0.333,2,4,0.5,0,0,,0,3,3,0,1,1,0,1,8,6.5
Richaun Holmes,23-027,F-C,11/11/16,PHI,IND,0,24,4,10,0.4,4,9,0.444,0,1,0,0,0,,4,8,12,0,1,1,1,2,8,7.7
Shaun Livingston,31-121,G,1/10/17,GSW,MIA,0,18,3,5,0.6,3,5,0.6,0,0,,2,4,0.5,0,0,0,1,0,0,0,3,8,4.4
Jason Terry,39-130,G,1/23/17,MIL,HOU,0,15,3,5,0.6,1,2,0.5,2,3,0.667,0,0,,1,0,1,2,3,0,0,0,8,10.8
David Lee,33-247,F,1/1/17,SAS,ATL,0,18,4,9,0.444,4,9,0.444,0,0,,0,0,,1,2,3,2,0,0,2,3,8,2.8
Justin Holiday,27-269,G,12/30/16,NYK,NOP,0,28,3,8,0.375,1,1,1,2,7,0.286,0,0,,1,6,7,4,0,1,0,2,8,8.8
John Henson,25-320,C-F,11/12/16,MIL,MEM,1,18,3,5,0.6,3,5,0.6,0,0,,2,2,1,0,7,7,1,0,1,0,3,8,8
Randy Foye,33-049,G,11/12/16,BRK,PHO,0,16,3,9,0.333,1,3,0.333,2,6,0.333,0,0,,0,3,3,3,1,0,0,3,8,5.7
Manu Ginobili,39-180,G,1/24/17,SAS,TOR,0,22,3,11,0.273,2,7,0.286,1,4,0.25,1,3,0.333,0,0,0,1,1,0,2,0,8,0.4
Brian Roberts,31-059,G,1/31/17,CHO,POR,0,6,2,3,0.667,0,1,0,2,2,1,2,2,1,0,1,1,1,0,0,0,1,8,7.3
Tarik Black,24-341,C-F,10/28/16,LAL,UTA,0,10,4,6,0.667,4,6,0.667,0,0,,0,0,,4,3,7,0,0,0,0,2,8,8.3
Marvin Williams,30-216,F,1/21/17,CHO,BRK,1,26,2,6,0.333,0,0,,2,6,0.333,2,2,1,0,6,6,1,0,1,2,3,8,4.6
Stanley Johnson,20-253,F,2/6/17,DET,PHI,0,24,3,9,0.333,3,7,0.429,0,2,0,2,3,0.667,2,6,8,1,1,0,3,2,8,3.6
Alex Len,23-132,C,10/26/16,PHO,SAC,0,24,3,6,0.5,3,6,0.5,0,0,,2,2,1,2,5,7,2,1,0,1,4,8,7.7
Briante Weber,24-081,G,3/20/17,CHO,ATL,0,19,4,5,0.8,4,5,0.8,0,0,,0,1,0,0,4,4,1,2,0,1,0,8,8.6
Tobias Harris,24-247,F,3/19/17,DET,PHO,1,34,2,10,0.2,1,7,0.143,1,3,0.333,3,4,0.75,0,4,4,0,0,1,1,3,8,1.1
Jeff Green,30-073,F,11/9/16,ORL,MIN,0,21,2,6,0.333,1,3,0.333,1,3,0.333,3,3,1,1,2,3,1,0,0,2,1,8,4.2
Jameer Nelson,35-055,G,4/5/17,DEN,HOU,1,32,3,9,0.333,1,3,0.333,2,6,0.333,0,0,,0,2,2,5,0,0,3,4,8,2.4
David Nwaba,24-073,G,3/28/17,LAL,WAS,0,23,4,5,0.8,4,5,0.8,0,0,,0,0,,2,6,8,1,3,1,3,0,8,10.7
Tyler Ennis,22-082,G,11/14/16,HOU,PHI,0,15,3,6,0.5,1,4,0.25,2,2,1,0,0,,0,0,0,1,1,0,2,2,8,3.9
Darrell Arthur,28-247,F,11/27/16,DEN,PHO,0,21,3,9,0.333,1,5,0.2,2,4,0.5,0,0,,0,1,1,2,0,0,0,2,8,3.8
Ben McLemore,23-309,G,12/16/16,SAC,MEM,1,16,3,7,0.429,2,4,0.5,1,3,0.333,1,1,1,0,0,0,0,2,0,1,1,8,4.9
Trey Burke,24-023,G,12/5/16,WAS,BRK,0,12,3,5,0.6,1,1,1,2,4,0.5,0,0,,0,0,0,2,0,0,0,1,8,6.7
Josh McRoberts,29-286,F,12/10/16,MIA,CHI,1,23,3,5,0.6,1,2,0.5,2,3,0.667,0,0,,1,4,5,1,1,0,1,2,8,7.5
J.J. Barea,32-276,G,3/29/17,DAL,NOP,0,19,4,7,0.571,4,5,0.8,0,2,0,0,0,,0,2,2,11,0,0,2,0,8,11
Jerami Grant,22-353,F,2/28/17,OKC,UTA,0,19,3,4,0.75,2,2,1,1,2,0.5,1,4,0.25,0,3,3,1,1,1,1,1,8,7.1
Jared Dudley,31-150,F-G,12/7/16,PHO,IND,0,25,3,11,0.273,1,4,0.25,2,7,0.286,0,0,,1,7,8,0,2,0,2,3,8,3.1
Alex Abrines,23-196,G-F,2/13/17,OKC,WAS,0,20,2,7,0.286,0,1,0,2,6,0.333,2,2,1,0,2,2,0,1,0,0,3,8,4.3
Rashad Vaughn,20-127,G,12/21/16,MIL,CLE,0,16,3,7,0.429,1,4,0.25,2,3,0.667,0,0,,0,1,1,1,0,0,1,1,8,3.9
DeAndre' Bembry,22-277,F,4/7/17,ATL,CLE,0,24,4,5,0.8,4,4,1,0,1,0,0,0,,0,5,5,3,1,0,3,2,8,6.9
Tim Frazier,26-101,G,2/10/17,NOP,MIN,0,20,2,6,0.333,2,6,0.333,0,0,,4,7,0.571,0,1,1,1,0,0,2,1,8,2
Dwight Powell,25-167,F-C,1/3/17,DAL,WAS,0,13,2,3,0.667,2,3,0.667,0,0,,4,5,0.8,0,3,3,1,1,0,1,2,8,7.1
Richard Jefferson,36-182,F,12/20/16,CLE,MIL,1,35,2,7,0.286,1,2,0.5,1,5,0.2,3,3,1,0,2,2,0,1,0,1,2,8,3.7
Joakim Noah,31-304,C,12/25/16,NYK,BOS,1,28,3,4,0.75,3,4,0.75,0,0,,2,3,0.667,5,7,12,2,0,0,0,4,8,11.4
Tyreke Evans,27-188,G-F,3/26/17,SAC,LAC,1,21,3,12,0.25,1,6,0.167,2,6,0.333,0,0,,0,4,4,1,0,0,1,2,8,0.9
Tarik Black,25-053,C-F,1/14/17,LAL,LAC,0,21,3,4,0.75,3,4,0.75,0,0,,2,3,0.667,1,5,6,0,0,1,2,4,8,5.3
Leandro Barbosa,34-017,G,12/15/16,PHO,SAS,0,17,4,9,0.444,4,9,0.444,0,0,,0,1,0,1,2,3,0,0,0,0,2,8,3.4
Terrence Ross,25-275,F-G,11/6/16,TOR,SAC,0,19,3,9,0.333,1,2,0.5,2,7,0.286,0,0,,0,2,2,0,2,0,3,1,8,2.1
Ty Lawson,29-125,G,3/8/17,SAC,SAS,0,24,3,7,0.429,3,6,0.5,0,1,0,2,2,1,0,1,1,3,0,0,1,1,8,5.3
Anthony Bennett,23-277,F,12/16/16,BRK,ORL,0,14,2,3,0.667,1,1,1,1,2,0.5,3,4,0.75,0,0,0,0,0,1,2,2,8,4.2
Mike Conley,29-038,G,11/18/16,MEM,DAL,1,29,2,7,0.286,1,4,0.25,1,3,0.333,3,3,1,0,4,4,3,1,2,2,2,8,6.8
Denzel Valentine,23-004,G,11/20/16,CHI,LAL,0,18,3,7,0.429,1,2,0.5,2,5,0.4,0,0,,0,2,2,0,1,0,1,3,8,3.7
T.J. McConnell,25-003,G,3/28/17,PHI,BRK,1,35,3,10,0.3,3,10,0.3,0,0,,2,2,1,0,2,2,10,3,1,3,2,8,9.7
Wesley Matthews,30-158,G,3/21/17,DAL,GSW,1,33,3,8,0.375,1,3,0.333,2,5,0.4,0,0,,1,2,3,4,2,0,2,0,8,7.7
Nerlens Noel,22-273,C-F,1/8/17,PHI,BRK,0,24,3,8,0.375,3,8,0.375,0,0,,2,2,1,2,2,4,0,3,0,0,1,8,8.2
Jae Crowder,26-247,F,3/10/17,BOS,DEN,1,33,2,6,0.333,0,1,0,2,5,0.4,2,2,1,0,3,3,4,3,0,1,2,8,9.5
Leandro Barbosa,34-088,G,2/24/17,PHO,CHI,0,16,3,7,0.429,2,3,0.667,1,4,0.25,1,1,1,0,3,3,3,0,1,0,2,8,7.2
Tony Allen,34-353,G-F,12/29/16,MEM,OKC,1,31,4,10,0.4,4,10,0.4,0,0,,0,0,,5,4,9,1,2,0,5,4,8,3.4
Iman Shumpert,26-128,G,11/1/16,CLE,HOU,0,26,3,4,0.75,1,1,1,2,3,0.667,0,0,,0,2,2,1,2,0,2,3,8,6.5
Trey Burke,24-014,G,11/26/16,WAS,SAS,0,9,4,7,0.571,4,6,0.667,0,1,0,0,0,,0,0,0,1,0,0,0,1,8,5
Shelvin Mack,26-253,G,12/31/16,UTA,PHO,0,26,3,8,0.375,1,6,0.167,2,2,1,0,0,,0,2,2,3,0,0,4,3,8,1.1
Georgios Papagiannis,19-269,C,3/29/17,SAC,UTA,0,20,4,7,0.571,4,7,0.571,0,0,,0,0,,0,3,3,2,0,0,1,4,8,4.4
Gerald Henderson,29-062,G,2/9/17,PHI,ORL,1,21,4,9,0.444,4,7,0.571,0,2,0,0,0,,0,1,1,0,0,1,0,0,8,4.3
Andre Roberson,25-097,G-F,3/11/17,OKC,UTA,1,32,3,4,0.75,2,2,1,1,2,0.5,1,4,0.25,0,3,3,0,2,1,1,1,8,7.4
JaVale McGee,29-076,C,4/5/17,GSW,PHO,0,15,2,3,0.667,2,3,0.667,0,0,,4,6,0.667,1,2,3,0,2,2,1,2,8,8.8
Dario Saric,22-259,F,12/23/16,PHI,PHO,0,27,3,10,0.3,1,5,0.2,2,5,0.4,0,0,,2,2,4,0,2,0,1,3,8,4
Amir Johnson,29-327,F,3/24/17,BOS,PHO,1,27,4,9,0.444,4,8,0.5,0,1,0,0,2,0,5,3,8,1,3,3,1,3,8,10.5
Nikola Vucevic,26-028,C,11/21/16,ORL,MIL,1,28,4,12,0.333,4,11,0.364,0,1,0,0,0,,3,8,11,2,0,1,3,3,8,3.6
Jared Sullinger,24-320,F,1/18/17,TOR,PHI,0,14,4,10,0.4,4,8,0.5,0,2,0,0,1,0,1,2,3,0,0,0,0,3,8,2.3
J.R. Smith,31-046,G-F,10/25/16,CLE,NYK,1,25,3,13,0.231,1,5,0.2,2,8,0.25,0,0,,0,3,3,2,1,0,0,1,8,3
Luc Mbah a Moute,30-071,F,11/19/16,LAC,CHI,1,26,3,6,0.5,1,3,0.333,2,3,0.667,0,0,,2,0,2,0,0,0,1,2,8,4.6
Bojan Bogdanovic,27-272,G-F,1/15/17,BRK,HOU,1,22,3,8,0.375,1,3,0.333,2,5,0.4,0,1,0,0,2,2,0,0,0,1,1,8,2.4
Brandon Ingram,19-179,F,2/28/17,LAL,CHO,1,42,3,10,0.3,2,5,0.4,1,5,0.2,1,4,0.25,0,5,5,3,1,0,1,2,8,3.8
Wayne Ellington,29-046,G,12/14/16,MIA,IND,1,21,3,10,0.3,1,2,0.5,2,8,0.25,0,0,,0,3,3,1,1,0,2,2,8,2
Al Horford,30-218,C-F,1/7/17,BOS,NOP,1,35,3,18,0.167,2,12,0.167,1,6,0.167,1,1,1,4,3,7,8,0,2,2,2,8,4.5
Greg Monroe,26-200,C-F,12/21/16,MIL,CLE,0,18,3,7,0.429,3,6,0.5,0,1,0,2,4,0.5,1,6,7,0,0,1,1,1,8,5.3
Marvin Williams,30-213,F,1/18/17,CHO,POR,1,24,3,9,0.333,1,5,0.2,2,4,0.5,0,0,,2,7,9,2,2,0,0,0,8,9.8
Montrezl Harrell,23-008,F-C,2/3/17,HOU,CHI,0,21,3,7,0.429,3,7,0.429,0,0,,2,2,1,3,2,5,1,0,0,0,1,8,7.3
Bobby Portis,22-033,F,3/15/17,CHI,MEM,1,20,4,9,0.444,4,7,0.571,0,2,0,0,0,,3,4,7,0,0,1,0,3,8,6.1
Mason Plumlee,27-033,C-F,4/7/17,DEN,NOP,0,27,3,6,0.5,3,6,0.5,0,0,,2,6,0.333,4,3,7,3,0,3,2,3,8,8.1
Seth Curry,26-208,G,3/19/17,DAL,BRK,1,31,3,9,0.333,3,4,0.75,0,5,0,2,2,1,0,1,1,1,0,0,1,0,8,2.9
Stephen Curry,28-276,G,12/15/16,GSW,NYK,1,34,3,14,0.214,1,6,0.167,2,8,0.25,0,0,,1,9,10,8,1,0,3,0,8,6.4
Arron Afflalo,31-147,G,3/11/17,SAC,DEN,1,23,3,9,0.333,1,5,0.2,2,4,0.5,0,0,,0,3,3,0,0,0,1,2,8,2
J.J. Redick,32-125,G,10/27/16,LAC,POR,1,30,3,8,0.375,2,3,0.667,1,5,0.2,1,2,0.5,0,3,3,1,0,0,2,2,8,2
Monta Ellis,31-122,G,2/25/17,IND,MIA,0,27,3,12,0.25,3,10,0.3,0,2,0,2,2,1,0,3,3,5,0,0,2,2,8,2.4
Rodney Stuckey,30-188,G,10/26/16,IND,DAL,0,22,3,6,0.5,2,4,0.5,1,2,0.5,1,3,0.333,0,3,3,1,0,0,2,0,8,3.8
Raymond Felton,32-177,G,12/20/16,LAC,DEN,0,19,4,7,0.571,4,5,0.8,0,2,0,0,0,,1,2,3,2,2,0,2,3,8,6.2
Patrick McCaw,21-100,G,2/2/17,GSW,LAC,1,28,3,7,0.429,1,2,0.5,2,5,0.4,0,2,0,0,1,1,6,2,0,1,3,8,7.8
Skal Labissiere,20-344,F,2/25/17,SAC,CHO,0,23,4,10,0.4,4,9,0.444,0,1,0,0,0,,3,10,13,1,1,0,1,1,8,8
Tyler Johnson,24-277,G,2/8/17,MIA,MIL,0,27,3,11,0.273,3,9,0.333,0,2,0,2,2,1,1,3,4,6,0,2,0,5,8,6.7
Dwight Powell,25-151,F-C,12/18/16,DAL,SAC,0,20,3,4,0.75,3,4,0.75,0,0,,2,2,1,2,4,6,1,1,0,0,0,8,10.7
Frank Kaminsky,23-249,F-C,12/9/16,CHO,ORL,0,27,1,7,0.143,0,3,0,1,4,0.25,5,6,0.833,2,7,9,4,0,1,0,0,8,10.1
Nene Hilario,34-206,F-C,4/7/17,HOU,DET,1,13,4,7,0.571,4,7,0.571,0,0,,0,2,0,3,3,6,2,0,0,0,1,8,7.9
Lucas Nogueira,24-135,C,12/8/16,TOR,MIN,0,19,4,5,0.8,4,5,0.8,0,0,,0,0,,4,5,9,1,0,3,1,1,8,11.8
Nik Stauskas,23-045,G,11/21/16,PHI,MIA,0,21,2,6,0.333,0,2,0,2,4,0.5,2,2,1,0,3,3,0,0,1,4,1,8,1.8
Sam Dekker,22-273,F,2/3/17,HOU,CHI,0,17,3,6,0.5,1,3,0.333,2,3,0.667,0,0,,0,2,2,2,0,0,0,3,8,5.8
Thaddeus Young,28-272,F,3/20/17,IND,UTA,1,32,4,8,0.5,4,8,0.5,0,0,,0,0,,4,4,8,4,1,0,2,3,8,8.6
Maurice Harkless,23-280,F-G,2/15/17,POR,UTA,1,25,3,5,0.6,2,4,0.5,1,1,1,1,1,1,0,4,4,2,2,0,0,2,8,9.5
Isaiah Canaan,25-172,G,11/9/16,CHI,ATL,0,22,3,9,0.333,1,4,0.25,2,5,0.4,0,0,,0,3,3,2,0,1,1,2,8,4.1
Andre Iguodala,32-346,G-F,1/8/17,GSW,SAC,0,29,3,6,0.5,2,5,0.4,1,1,1,1,2,0.5,2,5,7,5,1,0,0,0,8,12
Thabo Sefolosha,32-313,G-F,3/11/17,ATL,MEM,1,23,3,5,0.6,1,1,1,2,4,0.5,0,0,,0,4,4,2,1,0,3,3,8,5.1
Wesley Johnson,29-164,F-G,12/22/16,LAC,SAS,0,27,3,10,0.3,1,3,0.333,2,7,0.286,0,1,0,1,8,9,2,0,1,2,1,8,4.6
Marvin Williams,30-159,F,11/25/16,CHO,NYK,1,17,3,5,0.6,2,3,0.667,1,2,0.5,1,1,1,1,1,2,0,0,1,0,1,8,7
Willie Cauley-Stein,23-160,F-C,1/25/17,SAC,CLE,0,26,3,8,0.375,3,8,0.375,0,0,,2,2,1,3,7,10,0,1,1,0,2,8,8.7
Justin Anderson,22-346,G,10/30/16,DAL,HOU,0,17,3,8,0.375,2,6,0.333,1,2,0.5,1,1,1,1,2,3,0,2,0,0,2,8,6.1
David West,36-123,F,12/30/16,GSW,DAL,0,15,2,2,1,2,2,1,0,0,,4,4,1,0,2,2,4,1,0,1,2,8,10
Kyle Singler,28-343,F,4/12/17,OKC,DEN,1,26,3,6,0.5,3,4,0.75,0,2,0,2,4,0.5,0,6,6,1,1,1,0,1,8,8
Stanley Johnson,20-178,F,11/23/16,DET,MIA,0,20,3,4,0.75,2,2,1,1,2,0.5,1,1,1,1,3,4,1,0,1,0,1,8,9
Justin Holiday,27-351,G,3/22/17,NYK,UTA,0,19,3,6,0.5,1,1,1,2,5,0.4,0,0,,0,1,1,0,0,0,2,1,8,2.9
Richaun Holmes,23-155,F-C,3/19/17,PHI,BOS,0,29,4,6,0.667,4,5,0.8,0,1,0,0,0,,1,7,8,5,2,4,0,1,8,16.1
Lucas Nogueira,24-194,C,2/5/17,TOR,BRK,0,22,4,6,0.667,4,5,0.8,0,1,0,0,0,,1,4,5,0,3,1,1,2,8,9.2
Tony Allen,34-327,G-F,12/3/16,MEM,LAL,1,24,4,7,0.571,4,6,0.667,0,1,0,0,0,,3,6,9,3,2,0,3,5,8,7.7
Eric Bledsoe,26-343,G,11/16/16,PHO,DEN,1,34,2,4,0.5,2,3,0.667,0,1,0,4,6,0.667,1,2,3,5,3,0,6,3,8,5.8
Jordan McRae,25-268,G,12/21/16,CLE,MIL,0,18,3,6,0.5,2,5,0.4,1,1,1,1,3,0.333,0,3,3,0,1,0,2,2,8,3.3
Solomon Hill,25-237,F,11/10/16,NOP,MIL,0,31,4,6,0.667,4,4,1,0,2,0,0,0,,1,5,6,5,2,1,4,2,8,9
Richard Jefferson,36-253,F,3/1/17,CLE,BOS,0,18,3,7,0.429,2,4,0.5,1,3,0.333,1,1,1,1,3,4,2,0,1,1,2,8,6.2
Markieff Morris,27-210,F,3/31/17,WAS,UTA,1,34,2,13,0.154,2,12,0.167,0,1,0,4,4,1,2,5,7,0,0,0,1,4,8,0
Jerami Grant,22-331,F,2/6/17,OKC,IND,0,28,3,7,0.429,2,4,0.5,1,3,0.333,1,2,0.5,3,1,4,0,1,5,1,4,8,8.2
Frank Kaminsky,23-214,F-C,11/4/16,CHO,BRK,0,18,3,5,0.6,1,1,1,2,4,0.5,0,0,,0,4,4,3,0,0,1,3,8,6.8
Joffrey Lauvergne,25-086,C-F,12/25/16,OKC,MIN,0,18,3,4,0.75,1,2,0.5,2,2,1,0,0,,1,3,4,1,0,0,0,1,8,8.3
Jameer Nelson,34-318,G,12/23/16,DEN,ATL,0,21,3,6,0.5,2,3,0.667,1,3,0.333,1,2,0.5,1,0,1,2,1,0,1,2,8,5.9
Dion Waiters,25-031,G,1/10/17,MIA,GSW,1,38,4,17,0.235,4,12,0.333,0,5,0,0,0,,0,3,3,8,2,0,1,4,8,3.6
Aron Baynes,30-005,C,12/14/16,DET,DAL,0,20,3,5,0.6,3,5,0.6,0,0,,2,2,1,2,8,10,0,0,1,1,2,8,8.4
T.J. McConnell,24-268,G,12/18/16,PHI,BRK,0,25,4,9,0.444,4,8,0.5,0,1,0,0,0,,1,2,3,6,0,0,3,3,8,4.6
Mike Muscala,25-159,F-C,12/7/16,ATL,MIA,0,24,4,8,0.5,4,7,0.571,0,1,0,0,0,,0,3,3,0,0,2,2,1,8,3.9
DeMarre Carroll,30-091,F,10/26/16,TOR,DET,1,29,2,8,0.25,0,2,0,2,6,0.333,2,4,0.5,0,7,7,1,1,0,0,3,8,5
Cory Joseph,25-078,G,11/6/16,TOR,SAC,0,17,2,7,0.286,1,5,0.2,1,2,0.5,3,4,0.75,0,1,1,2,0,0,0,0,8,5.2
Justin Holiday,27-203,G,10/25/16,NYK,CLE,0,26,2,7,0.286,0,4,0,2,3,0.667,2,2,1,1,5,6,2,1,0,0,0,8,8.5
Jameer Nelson,35-023,G,3/4/17,DEN,CHO,1,29,3,9,0.333,1,3,0.333,2,6,0.333,0,0,,0,2,2,5,0,0,2,1,8,4.6
Dante Exum,21-236,G,3/6/17,UTA,NOP,1,25,3,11,0.273,2,6,0.333,1,5,0.2,1,2,0.5,1,3,4,2,0,0,3,1,8,0.7
Frank Kaminsky,24-004,F-C,4/8/17,CHO,BOS,0,27,4,10,0.4,4,7,0.571,0,3,0,0,0,,0,5,5,7,0,0,0,1,8,8.6
Iman Shumpert,26-253,G,3/6/17,CLE,MIA,1,26,3,9,0.333,2,7,0.286,1,2,0.5,1,2,0.5,0,3,3,1,0,0,0,1,8,3.7
Devin Booker,20-059,G,12/28/16,PHO,SAS,1,29,2,13,0.154,2,11,0.182,0,2,0,4,4,1,0,3,3,4,2,0,3,4,8,0.8
Alex Len,23-266,C,3/9/17,PHO,LAL,1,22,4,7,0.571,4,7,0.571,0,0,,0,0,,3,3,6,0,1,1,1,4,8,6.8
C.J. McCollum,25-051,G,11/9/16,POR,LAC,1,26,4,11,0.364,4,9,0.444,0,2,0,0,0,,1,3,4,0,1,0,2,3,8,1.3
Matthew Dellavedova,26-103,G,12/20/16,MIL,CLE,1,39,3,10,0.3,1,3,0.333,2,7,0.286,0,0,,1,2,3,5,1,0,4,3,8,2.8
Aron Baynes,30-054,C,2/1/17,DET,NOP,0,19,4,5,0.8,4,5,0.8,0,0,,0,0,,1,6,7,0,0,0,0,3,8,7.4
Dion Waiters,25-084,G,3/4/17,MIA,CLE,1,24,3,10,0.3,1,5,0.2,2,5,0.4,0,0,,0,1,1,2,1,0,1,2,8,3.1
Nick Young,31-270,G-F,2/26/17,LAL,SAS,1,23,3,8,0.375,2,4,0.5,1,4,0.25,1,1,1,0,0,0,0,0,0,1,1,8,2.2
Luol Deng,31-220,F,11/22/16,LAL,OKC,1,19,4,9,0.444,4,8,0.5,0,1,0,0,2,0,0,3,3,0,0,0,0,2,8,2.6
Al Jefferson,32-025,C-F,1/29/17,IND,HOU,0,10,4,5,0.8,4,5,0.8,0,0,,0,0,,0,0,0,1,1,0,0,4,8,6.2
Shabazz Muhammad,24-074,F-G,1/26/17,MIN,IND,0,20,2,5,0.4,2,5,0.4,0,0,,4,4,1,1,1,2,0,1,0,0,1,8,6.9
Nerlens Noel,22-347,C-F,3/23/17,DAL,LAC,1,33,4,8,0.5,4,8,0.5,0,0,,0,3,0,4,8,12,3,2,2,1,2,8,11.7
Tony Allen,35-019,G-F,1/30/17,MEM,PHO,1,19,4,9,0.444,4,8,0.5,0,1,0,0,0,,3,2,5,2,2,0,1,3,8,7.2
Jeremy Lamb,24-289,G-F,3/15/17,CHO,IND,1,29,3,9,0.333,3,8,0.375,0,1,0,2,2,1,1,6,7,2,0,0,1,2,8,5
Justin Hamilton,26-310,C,2/5/17,BRK,TOR,0,19,4,7,0.571,4,4,1,0,3,0,0,0,,2,4,6,1,1,2,0,1,8,10
Mindaugas Kuzminskas,27-152,F,3/20/17,NYK,LAC,0,18,2,6,0.333,1,2,0.5,1,4,0.25,3,3,1,2,2,4,3,1,0,3,3,8,5.5
Joe Harris,25-063,G,11/9/16,BRK,NYK,0,29,3,7,0.429,2,3,0.667,1,4,0.25,1,2,0.5,1,6,7,1,1,0,1,4,8,5.5
Robin Lopez,28-348,C,3/15/17,CHI,MEM,1,24,4,7,0.571,4,7,0.571,0,0,,0,0,,1,2,3,0,1,0,0,3,8,5.8
Joe Ingles,29-104,F-G,1/14/17,UTA,ORL,0,11,3,3,1,1,1,1,2,2,1,0,0,,0,1,1,1,0,0,1,1,8,6.7
Zach LaVine,21-328,G,2/1/17,MIN,CLE,1,37,4,18,0.222,4,12,0.333,0,6,0,0,0,,0,3,3,4,1,0,0,3,8,0.5
Timofey Mozgov,30-149,C,12/12/16,LAL,SAC,1,23,4,7,0.571,4,7,0.571,0,0,,0,0,,5,1,6,0,1,0,1,4,8,6.9
Garrett Temple,30-199,G,11/23/16,SAC,OKC,0,27,3,8,0.375,1,3,0.333,2,5,0.4,0,0,,1,2,3,1,2,0,0,4,8,6
Al Horford,30-266,C-F,2/24/17,BOS,TOR,1,30,3,5,0.6,3,5,0.6,0,0,,2,2,1,0,5,5,1,1,0,2,2,8,6.1
Frank Kaminsky,23-299,F-C,1/28/17,CHO,SAC,0,22,3,10,0.3,1,2,0.5,2,8,0.25,0,0,,0,4,4,6,0,1,0,1,8,7.9
Tristan Thompson,25-250,F-C,11/18/16,CLE,DET,1,30,3,8,0.375,3,7,0.429,0,1,0,2,2,1,1,13,14,2,0,4,0,1,8,12
Jeremy Lamb,24-255,G-F,2/9/17,CHO,HOU,0,11,3,8,0.375,2,5,0.4,1,3,0.333,1,1,1,0,3,3,1,0,0,3,1,8,1.8
Courtney Lee,31-126,G,2/6/17,NYK,LAL,1,25,3,6,0.5,1,2,0.5,2,4,0.5,0,0,,0,3,3,1,0,0,0,2,8,5.8
Seth Curry,26-073,G,11/4/16,DAL,POR,0,26,3,8,0.375,1,3,0.333,2,5,0.4,0,0,,1,2,3,1,1,0,1,2,8,4.8
Kris Dunn,22-260,G,12/3/16,MIN,CHO,0,16,3,5,0.6,2,4,0.5,1,1,1,1,2,0.5,1,1,2,6,1,1,1,2,8,10.4
Wayne Ellington,29-151,G,3/29/17,MIA,NYK,0,19,3,9,0.333,1,5,0.2,2,4,0.5,0,0,,1,1,2,1,0,0,0,1,8,4.2
Bismack Biyombo,24-185,C-F,3/1/17,ORL,NYK,0,21,3,6,0.5,3,6,0.5,0,0,,2,4,0.5,3,4,7,2,0,1,1,3,8,7.4
Dorian Finney-Smith,23-217,F,12/7/16,DAL,SAC,1,23,3,5,0.6,1,2,0.5,2,3,0.667,0,0,,0,3,3,2,1,1,4,4,8,4.1
Dorian Finney-Smith,23-224,F,12/14/16,DAL,DET,1,29,3,6,0.5,1,2,0.5,2,4,0.5,0,0,,2,3,5,1,1,0,2,2,8,6.2
Sean Kilpatrick,27-019,G,1/25/17,BRK,MIA,0,15,3,6,0.5,1,3,0.333,2,3,0.667,0,0,,0,1,1,0,0,0,0,0,8,5.3
Marcin Gortat,33-052,C-F,4/10/17,WAS,DET,1,21,4,8,0.5,4,8,0.5,0,0,,0,0,,4,4,8,5,0,0,1,1,8,10.1
D.J. Augustin,29-107,G,2/25/17,ORL,ATL,0,21,3,6,0.5,1,2,0.5,2,4,0.5,0,0,,0,0,0,2,0,0,0,0,8,6.4
Robin Lopez,28-215,C,11/2/16,CHI,BOS,1,14,3,6,0.5,3,6,0.5,0,0,,2,4,0.5,3,2,5,0,0,2,2,1,8,5.9
Seth Curry,26-174,G,2/13/17,DAL,BOS,1,33,3,9,0.333,1,4,0.25,2,5,0.4,0,0,,0,5,5,5,2,0,1,2,8,8.1
Willie Reed,26-248,F-C,1/19/17,MIA,DAL,0,13,3,3,1,3,3,1,0,0,,2,3,0.667,1,2,3,0,1,1,1,0,8,8.7
C.J. Watson,32-333,G,3/16/17,ORL,GSW,0,17,3,6,0.5,1,2,0.5,2,4,0.5,0,0,,0,2,2,2,1,0,3,3,8,3.8
Tony Parker,34-217,G,12/20/16,SAS,HOU,1,24,3,7,0.429,2,6,0.333,1,1,1,1,2,0.5,1,1,2,1,1,0,0,0,8,6.6
JaVale McGee,29-027,C,2/15/17,GSW,SAC,1,18,4,5,0.8,4,5,0.8,0,0,,0,0,,1,9,10,1,0,0,0,2,8,9.4
Bismack Biyombo,24-117,C-F,12/23/16,ORL,LAL,1,28,4,8,0.5,4,8,0.5,0,0,,0,3,0,1,8,9,1,0,3,0,1,8,8.3
DeAndre Jordan,28-107,C,11/5/16,LAC,SAS,1,30,4,8,0.5,4,8,0.5,0,0,,0,0,,1,7,8,1,0,3,0,3,8,8.4
Markieff Morris,27-076,F,11/17/16,WAS,NYK,1,35,4,11,0.364,4,9,0.444,0,2,0,0,0,,1,7,8,2,1,0,3,4,8,2.5
Gorgui Dieng,27-023,C,2/10/17,MIN,NOP,1,34,3,8,0.375,2,7,0.286,1,1,1,1,2,0.5,3,5,8,1,3,0,1,4,8,7.9
Dirk Nowitzki,38-225,F,1/30/17,DAL,CLE,1,24,3,4,0.75,1,2,0.5,2,2,1,0,0,,0,6,6,1,1,0,2,1,8,7.5
Ramon Sessions,30-245,G,12/12/16,CHO,IND,0,13,2,4,0.5,1,2,0.5,1,2,0.5,3,4,0.75,0,0,0,2,0,0,0,0,8,7
Markieff Morris,27-087,F,11/28/16,WAS,SAC,1,44,2,12,0.167,2,10,0.2,0,2,0,4,4,1,2,3,5,4,1,0,6,5,8,-1.5
Sam Dekker,22-295,F,2/25/17,HOU,MIN,0,16,3,4,0.75,2,2,1,1,2,0.5,1,2,0.5,2,0,2,0,1,1,0,1,8,8.7
Jeremy Lamb,24-196,G-F,12/12/16,CHO,IND,0,14,2,6,0.333,2,3,0.667,0,3,0,4,4,1,0,5,5,0,0,0,1,1,8,4.7
Kristaps Porzingis,21-135,F-C,12/15/16,NYK,GSW,1,35,4,13,0.308,4,11,0.364,0,2,0,0,2,0,2,3,5,0,0,0,2,2,8,-0.8
Manu Ginobili,39-116,G,11/21/16,SAS,DAL,0,25,2,6,0.333,0,1,0,2,5,0.4,2,2,1,1,3,4,3,3,0,2,1,8,8.9
Kyle O'Quinn,26-284,F-C,1/4/17,NYK,MIL,0,15,4,8,0.5,4,8,0.5,0,0,,0,0,,2,0,2,1,0,0,0,1,8,5.7
Buddy Hield,22-354,G,12/5/16,NOP,MEM,1,24,3,8,0.375,1,3,0.333,2,5,0.4,0,0,,0,3,3,1,1,0,0,2,8,5.4
Doug McDermott,25-011,F,1/14/17,CHI,NOP,0,20,3,9,0.333,1,3,0.333,2,6,0.333,0,0,,2,5,7,0,1,0,0,0,8,6.8
Zaza Pachulia,32-280,C,11/16/16,GSW,TOR,1,16,2,3,0.667,2,3,0.667,0,0,,4,4,1,0,1,1,2,0,0,1,4,8,5.8
Nikola Mirotic,25-261,F,10/29/16,CHI,IND,0,26,3,9,0.333,2,5,0.4,1,4,0.25,1,1,1,1,2,3,2,0,1,0,0,8,6.3
Chris Paul,31-203,G,11/25/16,LAC,DET,1,33,2,9,0.222,1,5,0.2,1,4,0.25,3,3,1,0,3,3,14,1,0,5,4,8,7.6
Tyus Jones,20-318,G,3/24/17,MIN,LAL,0,22,3,3,1,3,3,1,0,0,,2,2,1,0,1,1,2,3,0,3,3,8,7.6
Joe Ingles,29-030,F-G,11/1/16,UTA,SAS,0,19,3,4,0.75,1,1,1,2,3,0.667,0,0,,0,1,1,0,1,0,0,3,8,6.5
Nemanja Bjelica,28-268,F,2/1/17,MIN,CLE,0,20,4,7,0.571,4,6,0.667,0,1,0,0,2,0,2,2,4,0,3,0,2,3,8,5.7
D.J. Augustin,29-115,G,3/5/17,ORL,WAS,0,18,3,4,0.75,1,1,1,2,3,0.667,0,0,,0,1,1,4,0,0,0,0,8,9.5
Klay Thompson,27-044,G,3/24/17,GSW,SAC,1,30,3,14,0.214,1,7,0.143,2,7,0.286,0,0,,0,4,4,0,0,1,1,2,8,-0.5
Andre Roberson,24-350,G-F,11/18/16,OKC,BRK,1,26,4,9,0.444,4,7,0.571,0,2,0,0,2,0,3,3,6,2,3,0,0,6,8,7.5
DeAndre Jordan,28-104,C,11/2/16,LAC,OKC,1,32,4,4,1,4,4,1,0,0,,0,3,0,0,6,6,0,0,3,2,3,8,6.3
Denzel Valentine,23-114,G,3/10/17,CHI,HOU,0,23,3,8,0.375,1,2,0.5,2,6,0.333,0,0,,0,5,5,4,1,0,1,1,8,7.5
Courtney Lee,31-191,G,4/12/17,NYK,PHI,1,20,2,5,0.4,1,2,0.5,1,3,0.333,3,5,0.6,0,0,0,0,0,0,0,1,8,4.1
Otto Porter,23-290,F,3/20/17,WAS,BOS,1,21,4,8,0.5,4,5,0.8,0,3,0,0,0,,2,1,3,2,0,0,0,3,8,5.9
Mirza Teletovic,31-044,F,11/1/16,MIL,NOP,0,13,3,7,0.429,1,1,1,2,6,0.333,0,0,,0,0,0,1,0,0,0,0,8,5
Andre Iguodala,33-026,G-F,2/23/17,GSW,LAC,0,30,2,6,0.333,2,4,0.5,0,2,0,4,4,1,1,5,6,4,1,1,4,3,8,6.1
Tristan Thompson,25-364,F-C,3/12/17,CLE,HOU,1,33,4,4,1,4,4,1,0,0,,0,0,,4,4,8,1,0,3,1,4,8,11
Trevor Booker,29-002,F,11/27/16,BRK,SAC,1,26,4,8,0.5,4,8,0.5,0,0,,0,0,,1,7,8,5,1,0,1,4,8,8.7
Allen Crabbe,24-245,G-F,12/10/16,POR,IND,0,26,3,4,0.75,1,2,0.5,2,2,1,0,0,,0,5,5,3,1,0,1,4,8,8.4
Metta World Peace,37-147,F,4/9/17,LAL,MIN,0,11,3,8,0.375,1,3,0.333,2,5,0.4,0,0,,0,1,1,1,1,0,0,0,8,5.6
Jason Smith,30-364,F-C,3/1/17,WAS,TOR,0,10,4,4,1,4,4,1,0,0,,0,0,,0,5,5,2,1,0,0,1,8,10.3
Dante Cunningham,29-315,F,3/3/17,NOP,SAS,0,21,3,6,0.5,2,4,0.5,1,2,0.5,1,2,0.5,0,1,1,0,0,0,1,2,8,3.1
Willie Cauley-Stein,23-102,F-C,11/28/16,SAC,WAS,0,14,3,4,0.75,3,4,0.75,0,0,,2,3,0.667,0,2,2,0,1,1,0,3,8,7.1
Shawn Long,24-049,C-F,3/19/17,PHI,BOS,0,7,3,4,0.75,3,4,0.75,0,0,,2,4,0.5,3,1,4,0,0,0,0,5,8,6
Kelly Oubre,21-025,F,1/3/17,WAS,DAL,0,25,3,5,0.6,1,1,1,2,4,0.5,0,0,,0,3,3,2,0,0,0,3,8,6.8
Jerami Grant,22-338,F,2/13/17,OKC,WAS,0,25,3,12,0.25,2,8,0.25,1,4,0.25,1,4,0.25,2,5,7,4,2,1,1,1,8,6.6
Mirza Teletovic,31-189,F,3/26/17,MIL,CHI,0,15,3,6,0.5,1,2,0.5,2,4,0.5,0,0,,1,1,2,1,1,0,0,0,8,7.7
Tyreke Evans,27-123,G-F,1/20/17,NOP,BRK,0,13,2,10,0.2,2,6,0.333,0,4,0,4,6,0.667,3,1,4,0,2,0,1,2,8,3.6
Steven Adams,23-123,C,11/20/16,OKC,IND,1,34,3,7,0.429,3,7,0.429,0,0,,2,2,1,4,4,8,0,1,0,4,5,8,3.3
Draymond Green,26-238,F,10/28/16,GSW,NOP,1,34,3,10,0.3,2,8,0.25,1,2,0.5,1,2,0.5,4,7,11,7,2,0,3,5,8,8.6
Jeremy Lamb,24-282,G-F,3/8/17,CHO,MIA,0,25,4,7,0.571,4,7,0.571,0,0,,0,0,,0,4,4,1,0,1,1,3,8,5.1
Vince Carter,39-307,G-F,11/28/16,MEM,CHO,0,20,2,9,0.222,1,3,0.333,1,6,0.167,3,4,0.75,0,2,2,1,3,0,3,2,8,2.6
Juan Hernangomez,21-135,F,2/10/17,DEN,NYK,0,16,3,6,0.5,1,2,0.5,2,4,0.5,0,0,,0,1,1,1,1,1,0,1,8,7.3
DeAndre Jordan,28-191,C,1/28/17,LAC,GSW,1,23,4,4,1,4,4,1,0,0,,0,3,0,2,3,5,3,0,0,1,0,8,9
Salah Mejri,30-142,C,11/4/16,DAL,POR,0,13,4,4,1,4,4,1,0,0,,0,0,,0,6,6,0,0,0,0,3,8,7.4
Justin Hamilton,27-011,C,4/12/17,BRK,CHI,1,30,4,11,0.364,4,7,0.571,0,4,0,0,0,,2,7,9,4,1,0,1,0,8,8.2
Kelly Oubre,20-365,F,12/8/16,WAS,DEN,0,25,4,9,0.444,4,7,0.571,0,2,0,0,0,,2,3,5,2,2,0,0,4,8,7.4
Jared Dudley,31-160,F-G,12/17/16,PHO,OKC,0,17,3,4,0.75,2,2,1,1,2,0.5,1,1,1,0,3,3,1,0,0,2,2,8,5.2
Andre Roberson,25-104,G-F,3/18/17,OKC,SAC,1,33,4,6,0.667,4,5,0.8,0,1,0,0,0,,4,2,6,2,0,1,0,2,8,10.1
Emmanuel Mudiay,20-306,G,1/5/17,DEN,SAS,1,28,4,10,0.4,4,7,0.571,0,3,0,0,0,,0,1,1,5,0,1,2,0,8,5.1
Terry Rozier,22-224,G,10/27/16,BOS,CHI,0,23,3,7,0.429,1,2,0.5,2,5,0.4,0,0,,0,4,4,4,2,0,0,1,8,9.9
Noah Vonleh,21-209,F,3/21/17,POR,MIL,1,28,2,4,0.5,2,4,0.5,0,0,,4,5,0.8,4,4,8,1,1,0,0,1,8,10.9
Kent Bazemore,27-155,G-F,12/3/16,ATL,TOR,1,26,3,12,0.25,3,7,0.429,0,5,0,2,4,0.5,1,1,2,2,0,0,3,3,8,-1.8
Andre Roberson,25-067,G-F,2/9/17,OKC,CLE,1,41,4,8,0.5,4,7,0.571,0,1,0,0,1,0,2,5,7,1,1,2,1,3,8,7.4
Darrun Hilliard,23-364,G,4/12/17,DET,ORL,0,13,3,7,0.429,3,5,0.6,0,2,0,2,2,1,0,0,0,1,0,0,2,2,8,2.2
Brook Lopez,28-339,C,3/6/17,BRK,MEM,1,32,3,6,0.5,3,5,0.6,0,1,0,2,2,1,0,4,4,2,1,0,3,2,8,4.8
Ish Smith,28-157,G,12/9/16,DET,MIN,0,15,3,5,0.6,1,3,0.333,2,2,1,0,0,,0,1,1,6,2,0,0,2,8,11.4
Jonas Jerebko,29-315,F,1/11/17,BOS,WAS,0,22,3,5,0.6,2,2,1,1,3,0.333,1,2,0.5,2,4,6,1,0,1,2,1,8,6.9
Myles Turner,21-009,F-C,4/2/17,IND,CLE,1,47,3,8,0.375,3,7,0.429,0,1,0,2,2,1,0,3,3,2,1,1,0,1,8,7.2
Richard Jefferson,36-161,F,11/29/16,CLE,MIL,0,12,2,4,0.5,0,1,0,2,3,0.667,2,2,1,0,2,2,0,0,0,1,0,8,5.6
Luc Mbah a Moute,30-127,F,1/14/17,LAC,LAL,1,21,3,6,0.5,3,6,0.5,0,0,,2,2,1,2,2,4,1,0,0,0,4,8,6.1
Kevin Seraphin,26-350,F,11/21/16,IND,GSW,0,22,4,11,0.364,4,11,0.364,0,0,,0,0,,6,8,14,0,0,0,0,2,8,7.7
Kevin Seraphin,27-084,F,3/1/17,IND,SAS,0,15,4,4,1,4,4,1,0,0,,0,0,,2,1,3,1,2,0,2,4,8,7.6
Jodie Meeks,29-230,G,4/8/17,ORL,IND,0,14,2,7,0.286,0,2,0,2,5,0.4,2,3,0.667,0,3,3,1,0,0,0,0,8,5.1
Nick Young,31-228,G-F,1/15/17,LAL,DET,1,26,2,8,0.25,1,1,1,1,7,0.143,3,3,1,2,5,7,1,0,0,0,3,8,5.6
Justin Hamilton,26-210,C,10/28/16,BRK,IND,0,28,3,8,0.375,2,2,1,1,6,0.167,1,1,1,2,5,7,1,0,1,1,3,8,5.7
Rodney Hood,24-047,G-F,12/6/16,UTA,PHO,1,12,3,6,0.5,1,4,0.25,2,2,1,0,0,,0,0,0,2,1,0,0,2,8,6.6
Norman Powell,23-277,G,2/26/17,TOR,POR,0,12,3,6,0.5,3,5,0.6,0,1,0,2,2,1,0,4,4,1,0,0,1,1,8,5.5
Taurean Waller-Prince,22-239,F,11/16/16,ATL,MIL,0,19,2,5,0.4,2,2,1,0,3,0,4,4,1,0,5,5,1,1,2,2,2,8,7.1
Tony Snell,25-040,G-F,12/20/16,MIL,CLE,1,41,3,7,0.429,1,2,0.5,2,5,0.4,0,0,,0,6,6,4,0,2,1,1,8,8.9
James Ennis,26-121,F,10/30/16,MEM,WAS,1,34,3,10,0.3,2,5,0.4,1,5,0.2,1,3,0.333,4,8,12,2,0,0,2,3,8,4.8
Terrence Ross,25-290,F-G,11/21/16,TOR,LAC,0,26,4,6,0.667,4,6,0.667,0,0,,0,0,,0,3,3,0,1,0,1,5,8,4.3
James Michael McAdoo,24-091,F,4/5/17,GSW,PHO,1,22,3,8,0.375,3,8,0.375,0,0,,2,2,1,2,2,4,0,1,1,0,2,8,6.5
Damian Lillard,26-117,G,11/9/16,POR,LAC,1,28,1,10,0.1,1,6,0.167,0,4,0,6,6,1,0,1,1,1,0,0,3,3,8,-1.8
Dario Saric,22-357,F,3/31/17,PHI,CLE,1,26,3,12,0.25,2,5,0.4,1,7,0.143,1,2,0.5,0,4,4,4,0,0,4,4,8,-1.2
Raymond Felton,32-131,G,11/4/16,LAC,MEM,0,18,3,6,0.5,1,3,0.333,2,3,0.667,0,0,,1,1,2,3,0,0,0,2,8,7.3
Salah Mejri,30-289,C,3/31/17,DAL,MEM,0,12,3,4,0.75,3,4,0.75,0,0,,2,4,0.5,2,2,4,0,0,1,0,4,8,6.7
Sergio Rodriguez,30-246,G,2/13/17,PHI,CHO,0,12,3,5,0.6,1,2,0.5,2,3,0.667,0,0,,0,0,0,3,0,0,2,3,8,4.6
David West,36-219,F,4/5/17,GSW,PHO,0,15,3,4,0.75,3,4,0.75,0,0,,2,2,1,2,0,2,2,1,1,3,2,8,7.1
Larry Nance Jr.,24-065,F,3/7/17,LAL,DAL,0,21,4,6,0.667,4,5,0.8,0,1,0,0,0,,0,3,3,0,1,1,0,1,8,7.6
Pau Gasol,36-121,F-C,11/4/16,SAS,UTA,1,23,4,9,0.444,4,9,0.444,0,0,,0,0,,1,5,6,2,0,2,1,0,8,7.3
Robin Lopez,28-298,C,1/24/17,CHI,ORL,1,27,4,5,0.8,4,5,0.8,0,0,,0,0,,1,3,4,0,0,1,1,3,8,6.2
Channing Frye,33-299,C-F,3/12/17,CLE,HOU,0,14,3,4,0.75,1,1,1,2,3,0.667,0,0,,0,4,4,0,1,0,1,0,8,7.6
Rodney McGruder,25-255,G,4/10/17,MIA,CLE,1,28,3,9,0.333,1,5,0.2,2,4,0.5,0,2,0,1,3,4,2,1,0,2,2,8,3.3
Marcelo Huertas,33-259,G,2/8/17,LAL,DET,0,12,3,8,0.375,2,5,0.4,1,3,0.333,1,1,1,1,2,3,2,0,0,1,1,8,4.9
Joe Johnson,35-190,G-F,1/5/17,UTA,TOR,0,20,3,6,0.5,3,5,0.6,0,1,0,2,2,1,0,3,3,2,0,0,1,2,8,5.5
JaVale McGee,29-058,C,3/18/17,GSW,MIL,0,12,4,4,1,4,4,1,0,0,,0,0,,1,3,4,0,0,1,0,0,8,9.1
Tony Allen,35-066,G-F,3/18/17,MEM,SAS,1,31,3,10,0.3,2,7,0.286,1,3,0.333,1,2,0.5,3,4,7,0,0,2,0,4,8,4.9
Randy Foye,33-072,G,12/5/16,BRK,WAS,0,15,3,7,0.429,1,3,0.333,2,4,0.5,0,0,,0,4,4,1,1,0,4,0,8,3.2
Maurice Harkless,23-235,F-G,1/1/17,POR,MIN,1,33,3,7,0.429,3,5,0.6,0,2,0,2,3,0.667,1,4,5,1,2,2,0,2,8,9.1
Mario Hezonja,22-046,F-G,4/12/17,ORL,DET,0,23,3,7,0.429,1,4,0.25,2,3,0.667,0,0,,1,10,11,1,2,0,1,2,8,8.9
Richard Jefferson,36-220,F,1/27/17,CLE,BRK,0,25,3,6,0.5,2,2,1,1,4,0.25,1,2,0.5,0,1,1,2,0,0,1,4,8,3.7
Kris Dunn,22-355,G,3/8/17,MIN,LAC,0,15,3,5,0.6,1,3,0.333,2,2,1,0,0,,0,1,1,2,1,1,0,5,8,7.1
Channing Frye,33-178,C-F,11/11/16,CLE,WAS,0,14,3,8,0.375,1,4,0.25,2,4,0.5,0,0,,0,0,0,1,0,1,1,0,8,4
Avery Bradley,26-137,G,4/12/17,BOS,MIL,1,31,4,9,0.444,4,6,0.667,0,3,0,0,0,,0,2,2,1,1,0,0,1,8,5.2
Tony Snell,25-147,G-F,4/6/17,MIL,IND,1,29,3,8,0.375,1,6,0.167,2,2,1,0,0,,0,1,1,0,1,0,2,3,8,1.7
Kenneth Faried,26-357,F,11/10/16,DEN,GSW,0,30,4,9,0.444,4,9,0.444,0,0,,0,0,,6,5,11,1,2,0,1,1,8,10.3
Joe Ingles,29-036,F-G,11/7/16,UTA,PHI,0,21,3,8,0.375,3,7,0.429,0,1,0,2,3,0.667,1,2,3,2,3,1,1,1,8,8.2
Brandon Bass,31-244,F,12/30/16,LAC,HOU,0,14,3,5,0.6,3,5,0.6,0,0,,2,3,0.667,1,0,1,0,1,0,3,1,8,3.6
Marcin Gortat,32-310,C-F,12/23/16,WAS,MIL,1,26,4,8,0.5,4,8,0.5,0,0,,0,0,,1,5,6,3,0,0,1,3,8,6.1
Andre Roberson,25-112,G-F,3/26/17,OKC,HOU,1,33,4,12,0.333,4,11,0.364,0,1,0,0,1,0,2,5,7,1,4,1,1,5,8,6.1
Tim Frazier,26-101,G,2/10/17,NOP,MIN,0,20,2,6,0.333,2,6,0.333,0,0,,4,7,0.571,0,1,1,1,0,0,2,1,8,2
Ryan Anderson,28-315,F,3/17/17,HOU,NOP,1,28,3,10,0.3,1,3,0.333,2,7,0.286,0,0,,1,1,2,0,1,0,0,3,8,3
Dwyane Wade,35-057,G,3/15/17,CHI,MEM,1,23,3,11,0.273,2,9,0.222,1,2,0.5,1,2,0.5,0,3,3,4,0,0,2,0,8,2.8
Noah Vonleh,21-154,F,1/25/17,POR,LAL,1,20,4,6,0.667,4,6,0.667,0,0,,0,0,,4,6,10,0,0,0,1,2,8,8.2
Ian Clark,25-345,G,2/15/17,GSW,SAC,0,17,3,6,0.5,1,3,0.333,2,3,0.667,0,0,,0,1,1,1,0,0,0,1,8,5.6
Malcolm Brogdon,24-100,G,3/21/17,MIL,POR,1,26,4,6,0.667,4,4,1,0,2,0,0,0,,1,6,7,4,1,0,1,3,8,9.5
Richaun Holmes,23-142,F-C,3/6/17,PHI,MIL,1,22,3,9,0.333,3,8,0.375,0,1,0,2,2,1,5,4,9,0,0,0,1,4,8,5
Taurean Waller-Prince,22-294,F,1/10/17,ATL,BRK,0,20,2,6,0.333,0,2,0,2,4,0.5,2,2,1,2,4,6,1,1,2,2,0,8,8.3
Boban Marjanovic,28-238,C,4/10/17,DET,WAS,0,20,4,8,0.5,4,8,0.5,0,0,,0,0,,3,5,8,0,1,0,2,3,8,5.4
Glenn Robinson,22-365,G-F,1/7/17,IND,NYK,1,27,3,7,0.429,1,3,0.333,2,4,0.5,0,0,,0,6,6,0,0,0,1,2,8,4.3
Michael Kidd-Gilchrist,23-116,F,1/20/17,CHO,TOR,1,31,4,9,0.444,4,9,0.444,0,0,,0,0,,3,8,11,1,1,1,0,1,8,9.8
Channing Frye,33-210,C-F,12/13/16,CLE,MEM,0,15,2,6,0.333,1,2,0.5,1,4,0.25,3,3,1,0,1,1,1,0,0,1,2,8,3.8
John Henson,26-105,C-F,4/12/17,MIL,BOS,1,14,4,6,0.667,4,6,0.667,0,0,,0,0,,1,2,3,1,0,0,0,1,8,7
Kosta Koufos,27-270,C,11/20/16,SAC,TOR,0,26,3,6,0.5,3,6,0.5,0,0,,2,5,0.4,0,6,6,0,1,3,1,1,8,7.3
Skal Labissiere,21-004,F,3/22/17,SAC,MIL,1,31,4,8,0.5,4,7,0.571,0,1,0,0,0,,3,5,8,1,2,0,0,3,8,9.1
Jonathon Simmons,27-206,G-F,4/8/17,SAS,LAC,1,26,3,6,0.5,3,4,0.75,0,2,0,2,2,1,0,4,4,4,0,0,0,2,8,8.2
Harrison Barnes,24-305,F,3/31/17,DAL,MEM,1,38,4,10,0.4,4,9,0.444,0,1,0,0,0,,1,3,4,1,2,0,0,2,8,6.1
Cameron Payne,22-174,G,1/29/17,OKC,CLE,0,20,3,11,0.273,1,8,0.125,2,3,0.667,0,0,,0,4,4,2,2,1,1,2,8,5
Wesley Matthews,30-170,G,4/2/17,DAL,MIL,1,34,3,10,0.3,1,1,1,2,9,0.222,0,0,,0,1,1,6,0,0,1,2,8,4.9
Tristan Thompson,26-011,F-C,3/24/17,CLE,CHO,1,27,3,4,0.75,3,4,0.75,0,0,,2,2,1,2,5,7,0,0,0,0,3,8,8.1
Patty Mills,28-173,G,1/31/17,SAS,OKC,0,16,2,4,0.5,0,2,0,2,2,1,2,2,1,0,0,0,1,1,0,1,2,8,5.9
Nikola Jokic,21-273,C-F,11/18/16,DEN,TOR,0,27,4,8,0.5,4,6,0.667,0,2,0,0,0,,2,10,12,4,0,1,3,3,8,7.7
Willie Reed,26-321,F-C,4/2/17,MIA,DEN,0,15,4,7,0.571,4,7,0.571,0,0,,0,0,,2,5,7,0,1,1,1,2,8,7.5
Mindaugas Kuzminskas,27-138,F,3/6/17,NYK,ORL,0,16,3,5,0.6,2,4,0.5,1,1,1,1,1,1,0,1,1,1,1,0,0,2,8,6.9
Malcolm Brogdon,24-017,G,12/28/16,MIL,DET,0,28,4,6,0.667,4,5,0.8,0,1,0,0,0,,0,1,1,8,1,0,2,1,8,9.9
Jon Leuer,27-204,F,12/4/16,DET,ORL,0,26,3,7,0.429,2,3,0.667,1,4,0.25,1,2,0.5,0,6,6,1,1,1,1,1,8,6.7
Langston Galloway,24-356,G,11/29/16,NOP,LAL,0,17,3,9,0.333,1,3,0.333,2,6,0.333,0,0,,0,1,1,2,1,0,0,2,8,4.8
Kris Dunn,22-276,G,12/19/16,MIN,PHO,0,11,3,6,0.5,2,5,0.4,1,1,1,1,1,1,0,3,3,1,1,2,3,1,8,5.6
Andre Roberson,24-357,G-F,11/25/16,OKC,DEN,1,35,4,6,0.667,4,4,1,0,2,0,0,1,0,1,1,2,1,1,0,0,3,8,6.5
Dario Saric,22-285,F,1/18/17,PHI,TOR,0,24,3,9,0.333,2,6,0.333,1,3,0.333,1,2,0.5,2,7,9,1,0,2,3,1,8,4.7
Taurean Waller-Prince,22-361,F,3/18/17,ATL,POR,0,31,2,9,0.222,2,6,0.333,0,3,0,4,5,0.8,1,5,6,2,0,3,1,1,8,6.4
Aaron Brooks,31-292,G,11/1/16,IND,LAL,0,16,3,7,0.429,2,4,0.5,1,3,0.333,1,2,0.5,1,0,1,2,0,1,0,1,8,6.3
Aaron Gordon,21-150,F,2/13/17,ORL,MIA,1,29,3,6,0.5,3,5,0.6,0,1,0,2,4,0.5,1,5,6,3,2,1,5,3,8,5
Rajon Rondo,31-016,G,3/10/17,CHI,HOU,0,17,3,5,0.6,1,1,1,2,4,0.5,0,0,,0,2,2,2,1,0,1,2,8,6.9
DeMarre Carroll,30-093,F,10/28/16,TOR,CLE,1,36,2,7,0.286,0,3,0,2,4,0.5,2,2,1,2,4,6,2,2,2,0,4,8,9.7
Evan Turner,28-149,G,3/25/17,POR,MIN,0,21,4,5,0.8,4,5,0.8,0,0,,0,0,,0,2,2,2,0,0,2,3,8,4.9
Taj Gibson,31-285,F,4/5/17,OKC,MEM,1,26,4,10,0.4,4,10,0.4,0,0,,0,0,,3,4,7,0,1,0,1,2,8,5.1
Otto Porter,23-213,F,1/2/17,WAS,HOU,1,33,4,12,0.333,4,7,0.571,0,5,0,0,0,,0,3,3,1,1,1,0,3,8,3.3
Isaiah Canaan,25-178,G,11/15/16,CHI,POR,0,24,2,6,0.333,1,2,0.5,1,4,0.25,3,3,1,0,1,1,0,0,0,0,3,8,3.7
C.J. Miles,29-335,G-F,3/19/17,IND,TOR,1,23,3,9,0.333,1,3,0.333,2,6,0.333,0,0,,0,1,1,1,0,1,0,3,8,3.4
Joe Harris,25-135,G,1/20/17,BRK,NOP,1,13,3,5,0.6,1,3,0.333,2,2,1,0,0,,0,2,2,3,0,0,0,0,8,8.4
Elfrid Payton,22-273,G,11/21/16,ORL,MIL,1,35,4,9,0.444,4,6,0.667,0,3,0,0,2,0,0,8,8,7,3,0,1,2,8,11
Mike Miller,37-051,F-G,4/11/17,DEN,DAL,0,29,3,4,0.75,1,1,1,2,3,0.667,0,0,,0,7,7,6,1,0,3,2,8,9.9
Tony Snell,25-061,G-F,1/10/17,MIL,SAS,1,31,3,6,0.5,1,1,1,2,5,0.4,0,0,,0,1,1,3,1,0,0,0,8,8.4
Nicolas Batum,27-343,F-G,11/21/16,CHO,MEM,1,34,1,7,0.143,0,0,,1,7,0.143,5,6,0.833,0,4,4,5,1,0,3,1,8,5.4
Rodney Stuckey,30-213,G,11/20/16,IND,OKC,0,17,3,9,0.333,2,7,0.286,1,2,0.5,1,4,0.25,1,1,2,1,1,0,1,0,8,3.4
Marc Gasol,31-278,C,11/2/16,MEM,NOP,1,38,3,18,0.167,2,13,0.154,1,5,0.2,1,2,0.5,1,10,11,6,2,3,3,0,8,5.2
Trevor Ariza,31-267,F,3/24/17,HOU,NOP,1,34,3,10,0.3,3,6,0.5,0,4,0,2,2,1,0,9,9,0,0,0,0,4,8,3.3
Joe Harris,25-171,G,2/25/17,BRK,GSW,1,27,3,7,0.429,1,3,0.333,2,4,0.5,0,0,,0,1,1,1,2,2,2,1,8,6.3
Denzel Valentine,23-108,G,3/4/17,CHI,LAC,0,14,3,5,0.6,1,1,1,2,4,0.5,0,0,,0,3,3,0,0,0,1,0,8,5.6
Tim Frazier,26-034,G,12/5/16,NOP,MEM,1,39,3,10,0.3,3,7,0.429,0,3,0,2,2,1,1,3,4,9,3,0,4,2,8,8.3
Nik Stauskas,23-118,G,2/2/17,PHI,SAS,1,28,2,10,0.2,0,5,0,2,5,0.4,2,2,1,1,3,4,1,1,1,1,3,8,3.6
T.J. Warren,23-129,F,1/12/17,PHO,DAL,1,28,4,11,0.364,4,9,0.444,0,2,0,0,0,,1,1,2,3,0,0,0,5,8,3
John Henson,26-079,C-F,3/17/17,MIL,LAL,0,19,3,6,0.5,3,6,0.5,0,0,,2,4,0.5,5,4,9,1,0,4,0,4,8,10.8
Maurice Harkless,23-272,F-G,2/7/17,POR,DAL,0,22,2,9,0.222,1,7,0.143,1,2,0.5,3,6,0.5,5,2,7,0,0,1,1,1,8,4.7
Spencer Hawes,28-205,C-F,11/19/16,CHO,NOP,0,21,4,6,0.667,4,4,1,0,2,0,0,0,,0,6,6,4,0,1,3,2,8,6.9
Skal Labissiere,20-357,F,3/10/17,SAC,WAS,0,14,4,6,0.667,4,6,0.667,0,0,,0,0,,0,5,5,0,1,0,2,1,8,5.5
Langston Galloway,25-099,G,3/18/17,SAC,OKC,0,20,3,7,0.429,3,6,0.5,0,1,0,2,2,1,0,1,1,0,2,0,0,3,8,5.4
Malcolm Brogdon,24-066,G,2/15/17,MIL,BRK,0,16,1,3,0.333,0,2,0,1,1,1,5,6,0.833,0,2,2,4,1,0,3,1,8,6.9
D'Angelo Russell,20-271,G,11/20/16,LAL,CHI,1,23,3,11,0.273,1,2,0.5,2,9,0.222,0,0,,0,3,3,7,2,0,2,3,8,6.1
Jonathan Gibson,29-017,G,11/25/16,DAL,CLE,0,14,2,3,0.667,0,0,,2,3,0.667,2,2,1,0,1,1,2,0,0,1,0,8,7.4
Nikola Jokic,22-035,C-F,3/26/17,DEN,NOP,1,18,4,14,0.286,4,11,0.364,0,3,0,0,0,,3,10,13,2,0,0,0,3,8,5.1
Harrison Barnes,24-257,F,2/11/17,DAL,ORL,1,30,4,13,0.308,4,12,0.333,0,1,0,0,0,,3,1,4,2,0,0,1,2,8,2.5
Kentavious Caldwell-Pope,24-034,G,3/24/17,DET,ORL,1,21,2,11,0.182,2,7,0.286,0,4,0,4,5,0.8,0,1,1,2,0,0,1,0,8,1.4
Richaun Holmes,23-133,F-C,2/25/17,PHI,NYK,0,16,3,4,0.75,2,3,0.667,1,1,1,1,2,0.5,1,1,2,0,1,2,0,3,8,8.2
Andrew Bogut,32-005,C,12/3/16,DAL,CHI,1,22,4,4,1,4,4,1,0,0,,0,0,,1,10,11,1,2,0,2,6,8,8.8
Andrew Harrison,22-166,G,4/12/17,MEM,DAL,0,25,2,6,0.333,2,3,0.667,0,3,0,4,6,0.667,1,3,4,1,1,2,0,4,8,6.9
Mason Plumlee,26-280,C-F,12/10/16,POR,IND,1,26,3,4,0.75,3,4,0.75,0,0,,2,2,1,1,8,9,2,0,0,4,4,8,5.3
Marvin Williams,30-252,F,2/26/17,CHO,LAC,1,39,2,6,0.333,1,3,0.333,1,3,0.333,3,4,0.75,0,6,6,1,0,0,0,5,8,4.7
Malachi Richardson,21-026,G,1/31/17,SAC,HOU,0,19,3,10,0.3,2,6,0.333,1,4,0.25,1,2,0.5,1,2,3,0,0,0,2,2,8,0.3
Joe Johnson,35-213,G-F,1/28/17,UTA,MEM,0,27,3,7,0.429,1,3,0.333,2,4,0.5,0,0,,0,2,2,1,0,1,0,0,8,6.3
Jason Smith,31-022,F-C,3/24/17,WAS,BRK,0,25,3,7,0.429,1,3,0.333,2,4,0.5,0,0,,0,5,5,1,0,0,0,2,8,5.7
Andrew Harrison,22-146,G,3/23/17,MEM,SAS,0,16,3,7,0.429,2,5,0.4,1,2,0.5,1,2,0.5,0,3,3,3,1,0,1,2,8,6.1
Randy Foye,33-160,G,3/3/17,BRK,UTA,1,13,3,5,0.6,1,1,1,2,4,0.5,0,0,,1,1,2,0,1,0,1,0,8,6.7
E'Twaun Moore,27-316,G,1/9/17,NOP,NYK,0,24,4,7,0.571,4,6,0.667,0,1,0,0,0,,1,0,1,3,0,0,0,2,8,6.7
Deron Williams,32-186,G,12/29/16,DAL,LAL,1,33,3,6,0.5,2,3,0.667,1,3,0.333,1,1,1,0,1,1,11,2,0,6,6,8,6.6
Taurean Waller-Prince,22-342,F,2/27/17,ATL,BOS,0,30,3,9,0.333,3,8,0.375,0,1,0,2,2,1,5,7,12,3,2,1,1,2,8,11.5
Marcus Morris,27-194,F,3/15/17,DET,UTA,1,33,3,15,0.2,3,10,0.3,0,5,0,2,2,1,0,1,1,2,1,0,1,2,8,-0.4
Bryn Forbes,23-231,G,3/11/17,SAS,GSW,0,25,3,7,0.429,1,2,0.5,2,5,0.4,0,0,,0,1,1,0,0,0,1,1,8,3.2
Thaddeus Young,28-211,F,1/18/17,IND,SAC,1,24,4,11,0.364,4,9,0.444,0,2,0,0,0,,1,3,4,1,3,2,1,3,8,6.4
Maurice Harkless,23-226,F-G,12/23/16,POR,SAS,1,34,4,8,0.5,4,6,0.667,0,2,0,0,4,0,1,1,2,1,1,1,1,4,8,3.2
Jason Smith,31-020,F-C,3/22/17,WAS,ATL,0,15,3,7,0.429,2,4,0.5,1,3,0.333,1,1,1,0,3,3,1,0,2,1,2,8,5.5
Sam Dekker,22-254,F,1/15/17,HOU,BRK,0,17,4,5,0.8,4,4,1,0,1,0,0,1,0,0,1,1,3,1,0,0,4,8,7.5
Robin Lopez,29-001,C,4/2/17,CHI,NOP,1,26,3,7,0.429,3,7,0.429,0,0,,2,4,0.5,1,3,4,0,0,0,0,1,8,4.7
Mason Plumlee,26-300,C-F,12/30/16,POR,SAS,1,27,1,4,0.25,1,4,0.25,0,0,,6,8,0.75,0,5,5,6,0,1,0,1,8,10.8
Domantas Sabonis,20-317,F,3/16/17,OKC,TOR,0,19,3,7,0.429,2,6,0.333,1,1,1,1,2,0.5,0,6,6,2,0,0,1,6,8,3.7
Nemanja Bjelica,28-306,F,3/11/17,MIN,MIL,0,32,4,8,0.5,4,8,0.5,0,0,,0,0,,3,2,5,3,0,1,1,4,8,6.9
Kyle O'Quinn,27-009,F-C,4/4/17,NYK,CHI,0,27,4,6,0.667,4,6,0.667,0,0,,0,0,,5,8,13,5,0,5,2,2,8,15.5
JaVale McGee,29-025,C,2/13/17,GSW,DEN,1,16,4,6,0.667,4,6,0.667,0,0,,0,0,,0,7,7,0,0,1,2,1,8,5.8
Jeff Green,30-083,F,11/19/16,ORL,DAL,1,22,4,7,0.571,4,6,0.667,0,1,0,0,0,,0,3,3,2,1,0,1,3,8,5.8
Larry Nance Jr.,24-044,F,2/14/17,LAL,SAC,0,24,4,6,0.667,4,5,0.8,0,1,0,0,2,0,2,4,6,3,3,1,3,4,8,8.4
Serge Ibaka,27-146,F-C,2/11/17,ORL,DAL,1,25,4,10,0.4,4,9,0.444,0,1,0,0,0,,1,3,4,2,1,2,2,0,8,6
Taj Gibson,31-131,F,11/2/16,CHI,BOS,1,26,3,12,0.25,3,12,0.25,0,0,,2,3,0.667,5,4,9,3,2,2,4,2,8,5.8
Langston Galloway,25-105,G,3/24/17,SAC,GSW,0,25,3,8,0.375,1,5,0.2,2,3,0.667,0,0,,0,2,2,0,0,0,2,1,8,1.8
Shelvin Mack,26-256,G,1/3/17,UTA,BOS,1,26,3,10,0.3,3,9,0.333,0,1,0,2,2,1,0,1,1,4,1,0,0,2,8,5.5
Spencer Hawes,28-345,C-F,4/8/17,MIL,PHI,0,10,3,5,0.6,3,3,1,0,2,0,2,2,1,0,2,2,0,0,0,0,1,8,5.9
Justin Holiday,27-211,G,11/2/16,NYK,HOU,0,18,3,10,0.3,1,6,0.167,2,4,0.5,0,0,,0,2,2,2,1,0,3,3,8,1
Dorian Finney-Smith,23-203,F,11/23/16,DAL,LAC,0,25,3,7,0.429,1,3,0.333,2,4,0.5,0,0,,1,1,2,3,1,1,0,2,8,8.3
Mirza Teletovic,31-184,F,3/21/17,MIL,POR,0,18,3,8,0.375,1,3,0.333,2,5,0.4,0,0,,0,4,4,1,0,0,0,3,8,4.3
Greg Monroe,26-159,C-F,11/10/16,MIL,NOP,0,20,3,5,0.6,3,5,0.6,0,0,,2,2,1,1,2,3,2,1,0,1,1,8,8
Iman Shumpert,26-194,G,1/6/17,CLE,BRK,0,30,2,3,0.667,2,2,1,0,1,0,4,4,1,0,1,1,2,1,0,0,1,8,9
Paul Zipser,23-027,G-F,3/17/17,CHI,WAS,1,28,4,11,0.364,4,8,0.5,0,3,0,0,0,,2,5,7,2,0,0,2,4,8,2.6
Jon Leuer,27-184,F,11/14/16,DET,OKC,0,29,3,8,0.375,3,7,0.429,0,1,0,2,3,0.667,1,8,9,4,0,1,1,3,8,7.6
Willy Hernangomez,22-264,C,2/15/17,NYK,OKC,1,32,3,6,0.5,3,6,0.5,0,0,,2,2,1,3,7,10,1,2,3,1,3,8,11.8
Jon Leuer,27-304,F,3/14/17,DET,CLE,0,22,3,6,0.5,3,6,0.5,0,0,,2,2,1,2,5,7,1,0,0,0,2,8,7.8
Andre Drummond,23-216,C,3/14/17,DET,CLE,1,27,4,12,0.333,4,11,0.364,0,1,0,0,0,,5,9,14,1,0,0,1,2,8,6.3
Meyers Leonard,24-290,C-F,12/13/16,POR,OKC,0,22,3,5,0.6,1,2,0.5,2,3,0.667,0,0,,0,4,4,0,0,2,0,4,8,6.7
E'Twaun Moore,27-312,G,1/5/17,NOP,ATL,0,27,3,11,0.273,1,5,0.2,2,6,0.333,0,0,,1,1,2,0,0,1,1,4,8,0.6
Thabo Sefolosha,32-221,G-F,12/9/16,ATL,MIL,1,29,3,9,0.333,3,5,0.6,0,4,0,2,2,1,0,6,6,4,2,2,1,0,8,9.9
Shabazz Muhammad,24-034,F-G,12/17/16,MIN,HOU,0,17,3,7,0.429,3,6,0.5,0,1,0,2,4,0.5,2,4,6,1,0,1,2,0,8,5.5
Jamal Crawford,36-356,G,3/11/17,LAC,PHI,0,31,2,13,0.154,2,9,0.222,0,4,0,4,4,1,0,0,0,2,1,0,0,0,8,2.1
Courtney Lee,31-067,G,12/9/16,NYK,SAC,1,33,3,7,0.429,1,4,0.25,2,3,0.667,0,1,0,1,3,4,1,0,0,0,2,8,5.4
Domantas Sabonis,20-197,F,11/16/16,OKC,HOU,1,28,4,5,0.8,4,4,1,0,1,0,0,0,,1,2,3,3,0,0,2,1,8,7.1
Nikola Jokic,21-258,C-F,11/3/16,DEN,MIN,1,14,3,3,1,3,3,1,0,0,,2,4,0.5,1,2,3,5,0,0,1,3,8,8.9
Rajon Rondo,31-008,G,3/2/17,CHI,GSW,0,13,3,5,0.6,3,4,0.75,0,1,0,2,3,0.667,0,3,3,3,0,0,4,3,8,3.1
T.J. McConnell,24-313,G,2/1/17,PHI,DAL,1,29,3,6,0.5,3,6,0.5,0,0,,2,2,1,0,4,4,4,1,0,2,0,8,8
Demetrius Jackson,22-060,G,11/6/16,BOS,DEN,0,11,2,3,0.667,1,2,0.5,1,1,1,3,4,0.75,2,1,3,2,0,0,0,0,8,9.4
Beno Udrih,34-274,G,4/5/17,DET,TOR,0,18,3,7,0.429,3,7,0.429,0,0,,2,2,1,0,3,3,8,0,0,1,1,8,9.4
Doug McDermott,24-347,F,12/15/16,CHI,MIL,0,28,3,6,0.5,1,4,0.25,2,2,1,0,0,,1,4,5,1,0,0,2,2,8,4.8
Amir Johnson,29-339,F,4/5/17,BOS,CLE,1,14,4,4,1,4,4,1,0,0,,0,0,,1,2,3,1,1,0,0,2,8,9
Dante Exum,21-243,G,3/13/17,UTA,LAC,0,14,2,3,0.667,0,1,0,2,2,1,2,2,1,0,3,3,2,0,0,0,1,8,8.6
Derrick Favors,25-228,F-C,2/28/17,UTA,OKC,1,27,4,9,0.444,4,9,0.444,0,0,,0,2,0,2,3,5,2,0,0,0,1,8,5.8
Wayne Ellington,29-153,G,3/31/17,MIA,NYK,0,22,3,10,0.3,1,3,0.333,2,7,0.286,0,0,,0,2,2,0,0,0,0,0,8,2.8
Tony Allen,35-071,G-F,3/23/17,MEM,SAS,1,29,4,9,0.444,4,7,0.571,0,2,0,0,0,,1,3,4,2,2,1,0,3,8,7.8
Nick Young,31-223,G-F,1/10/17,LAL,POR,1,28,2,9,0.222,0,4,0,2,5,0.4,2,3,0.667,0,0,0,1,1,1,0,1,8,4.1
Monta Ellis,31-107,G,2/10/17,IND,WAS,0,28,4,9,0.444,4,6,0.667,0,3,0,0,0,,0,1,1,8,0,0,0,4,8,7.6
Bryn Forbes,23-185,G,1/24/17,SAS,TOR,0,12,3,4,0.75,1,1,1,2,3,0.667,0,0,,0,1,1,0,0,0,0,2,8,5.9
Rodney McGruder,25-158,G,1/3/17,MIA,PHO,1,33,3,10,0.3,1,5,0.2,2,5,0.4,0,0,,3,2,5,1,0,0,0,5,8,3.6
Timothe Luwawu-Cabarrot,21-301,F,3/6/17,PHI,MIL,0,18,3,7,0.429,3,5,0.6,0,2,0,2,2,1,0,1,1,1,1,0,2,2,8,3.5
Vince Carter,39-361,G-F,1/21/17,MEM,HOU,0,20,1,6,0.167,1,3,0.333,0,3,0,6,6,1,1,2,3,2,0,0,0,3,8,5.7
Isaiah Canaan,25-182,G,11/19/16,CHI,LAC,0,17,2,5,0.4,1,1,1,1,4,0.25,3,4,0.75,0,0,0,2,0,0,0,4,8,4.7
Trevor Booker,29-121,F,3/26/17,BRK,ATL,0,18,3,6,0.5,3,6,0.5,0,0,,2,2,1,1,6,7,2,0,1,3,4,8,5
Mason Plumlee,26-309,C-F,1/8/17,POR,DET,1,40,4,12,0.333,4,11,0.364,0,1,0,0,2,0,6,4,10,12,1,3,3,3,8,13.1
Patty Mills,28-222,G,3/21/17,SAS,MIN,0,21,3,5,0.6,1,1,1,2,4,0.5,0,0,,1,1,2,3,0,0,2,1,8,6.4
Kyle Anderson,23-204,F-G,4/12/17,SAS,UTA,0,16,3,7,0.429,2,5,0.4,1,2,0.5,1,1,1,0,2,2,2,1,0,0,3,8,6.1
Gerald Henderson,29-059,G,2/6/17,PHI,DET,0,18,3,7,0.429,3,5,0.6,0,2,0,2,2,1,0,1,1,0,0,0,1,1,8,3.2
Norman Powell,23-287,G,3/8/17,TOR,NOP,0,21,3,5,0.6,1,2,0.5,2,3,0.667,0,0,,0,3,3,5,0,0,1,1,8,8.7
C.J. Miles,29-256,G-F,12/30/16,IND,CHI,0,22,3,7,0.429,2,5,0.4,1,2,0.5,1,1,1,0,3,3,0,0,0,0,3,8,4
Andre Drummond,23-224,C,3/22/17,DET,CHI,1,26,4,12,0.333,4,12,0.333,0,0,,0,4,0,8,9,17,0,0,1,1,4,8,6
Donatas Motiejunas,26-200,F-C,4/8/17,NOP,GSW,0,19,3,7,0.429,2,5,0.4,1,2,0.5,1,2,0.5,0,1,1,2,0,1,0,1,8,5.9
Glenn Robinson,22-304,G-F,11/7/16,IND,CHO,0,13,3,7,0.429,2,3,0.667,1,4,0.25,1,3,0.333,1,1,2,0,2,0,0,0,8,6.5
JaMychal Green,26-225,F,2/1/17,MEM,DEN,1,26,4,9,0.444,4,8,0.5,0,1,0,0,0,,3,5,8,1,0,0,0,4,8,6
Meyers Leonard,25-027,C-F,3/26/17,POR,LAL,0,20,3,7,0.429,1,4,0.25,2,3,0.667,0,0,,1,3,4,2,0,0,0,1,8,6.9
Tyler Ulis,21-065,G,3/11/17,PHO,DAL,0,28,4,11,0.364,4,9,0.444,0,2,0,0,0,,0,3,3,5,1,1,0,1,8,7.6
David West,36-142,F,1/18/17,GSW,OKC,0,11,4,5,0.8,4,5,0.8,0,0,,0,0,,0,1,1,3,1,0,0,0,8,9.5
Taj Gibson,31-289,F,4/9/17,OKC,DEN,1,18,3,9,0.333,3,9,0.333,0,0,,2,2,1,1,2,3,0,0,0,2,1,8,1.8
Nick Young,31-175,G-F,11/23/16,LAL,GSW,1,19,3,8,0.375,1,5,0.2,2,3,0.667,0,0,,0,1,1,1,0,0,0,1,8,4.2
Nene Hilario,34-075,F-C,11/27/16,HOU,POR,0,15,4,7,0.571,4,7,0.571,0,0,,0,0,,0,3,3,1,0,2,1,4,8,5.1
Vince Carter,40-037,G-F,3/4/17,MEM,HOU,0,24,3,9,0.333,1,5,0.2,2,4,0.5,0,0,,0,2,2,2,1,1,1,2,8,4.8
Marreese Speights,29-217,C-F,3/9/17,LAC,MEM,0,19,3,6,0.5,1,1,1,2,5,0.4,0,0,,1,2,3,0,0,1,2,3,8,3.8
Matthew Dellavedova,26-080,G,11/27/16,MIL,ORL,1,31,3,13,0.231,1,6,0.167,2,7,0.286,0,0,,0,1,1,8,1,0,1,2,8,5.2
Darrell Arthur,28-252,F,12/2/16,DEN,HOU,0,9,4,4,1,4,4,1,0,0,,0,0,,2,2,4,1,0,1,1,2,8,8.4
Gorgui Dieng,26-317,C,11/30/16,MIN,NYK,1,33,2,6,0.333,2,6,0.333,0,0,,4,6,0.667,4,4,8,2,1,0,2,4,8,6.6
Kelly Olynyk,25-236,C-F,12/11/16,BOS,OKC,0,22,2,9,0.222,1,2,0.5,1,7,0.143,3,4,0.75,2,6,8,2,2,0,1,3,8,6.5
Tyson Chandler,34-090,C,12/31/16,PHO,UTA,1,24,4,5,0.8,4,5,0.8,0,0,,0,1,0,3,8,11,0,0,0,1,4,8,7.6
Bojan Bogdanovic,27-353,G-F,4/6/17,WAS,NYK,0,31,2,9,0.222,0,1,0,2,8,0.25,2,2,1,0,6,6,1,0,0,2,2,8,2.2
Jakob Poeltl,21-176,C,4/9/17,TOR,NYK,0,14,4,4,1,4,4,1,0,0,,0,0,,1,6,7,0,0,0,1,2,8,7.5
Montrezl Harrell,22-311,F-C,12/2/16,HOU,DEN,0,20,4,6,0.667,4,6,0.667,0,0,,0,0,,0,3,3,0,0,2,1,1,8,6.3
Tomas Satoransky,25-020,G,11/19/16,WAS,MIA,0,25,3,5,0.6,3,5,0.6,0,0,,2,3,0.667,0,2,2,4,0,0,0,4,8,7.1
Mason Plumlee,27-005,C-F,3/10/17,DEN,BOS,0,20,4,4,1,4,4,1,0,0,,0,0,,3,2,5,4,0,1,1,2,8,11.2
Derrick Favors,25-195,F-C,1/26/17,UTA,LAL,1,22,3,9,0.333,3,9,0.333,0,0,,2,2,1,2,4,6,3,0,0,1,2,8,5.8
Jonas Valanciunas,24-247,C,1/8/17,TOR,HOU,1,23,4,4,1,4,4,1,0,0,,0,0,,0,5,5,0,0,1,1,3,8,6.8
Spencer Dinwiddie,23-324,G,2/24/17,BRK,DEN,0,23,3,7,0.429,3,6,0.5,0,1,0,2,3,0.667,0,4,4,5,2,0,0,3,8,9.4
Clint Capela,22-316,F-C,3/30/17,HOU,POR,1,25,3,6,0.5,3,6,0.5,0,0,,2,2,1,3,4,7,0,1,2,0,3,8,9.5
Sergio Rodriguez,30-173,G,12/2/16,PHI,ORL,1,25,3,9,0.333,2,7,0.286,1,2,0.5,1,1,1,0,3,3,7,0,1,2,0,8,7.4
Jameer Nelson,35-029,G,3/10/17,DEN,BOS,1,31,4,9,0.444,4,7,0.571,0,2,0,0,1,0,0,5,5,5,1,0,1,1,8,7.5
Thabo Sefolosha,32-247,G-F,1/4/17,ATL,ORL,1,28,4,9,0.444,4,8,0.5,0,1,0,0,0,,0,5,5,1,1,0,0,2,8,5.7
JaMychal Green,26-248,F,2/24/17,MEM,IND,1,32,3,7,0.429,2,5,0.4,1,2,0.5,1,2,0.5,3,4,7,1,0,0,1,1,8,6.5
Justin Hamilton,26-329,C,2/24/17,BRK,DEN,0,21,3,6,0.5,2,3,0.667,1,3,0.333,1,2,0.5,2,5,7,2,1,2,1,3,8,9.1
Kelly Olynyk,25-262,C-F,1/6/17,BOS,PHI,0,18,2,7,0.286,1,3,0.333,1,4,0.25,3,4,0.75,1,3,4,5,0,0,1,5,8,5.6
Kent Bazemore,27-145,G-F,11/23/16,ATL,IND,1,26,3,13,0.231,3,10,0.3,0,3,0,2,2,1,0,4,4,1,4,1,4,2,8,1.9
Harrison Barnes,24-312,F,4/7/17,DAL,SAS,1,18,3,6,0.5,2,5,0.4,1,1,1,1,2,0.5,0,1,1,1,0,0,1,0,8,4.6
Pascal Siakam,23-067,F,4/12/17,TOR,CLE,0,28,4,8,0.5,4,7,0.571,0,1,0,0,0,,2,8,10,0,1,0,1,3,8,6.6
Joe Johnson,35-262,G-F,3/18/17,UTA,CHI,1,33,3,12,0.25,3,10,0.3,0,2,0,2,2,1,3,3,6,2,0,1,1,0,8,4.9
Andre Roberson,25-036,G-F,1/9/17,OKC,CHI,1,33,3,5,0.6,1,1,1,2,4,0.5,0,0,,0,2,2,2,1,1,1,1,8,8
Nikola Mirotic,26-049,F,4/1/17,CHI,ATL,1,31,2,8,0.25,0,5,0,2,3,0.667,2,2,1,1,8,9,5,2,0,1,1,8,10.4
Amir Johnson,29-215,F,12/2/16,BOS,SAC,1,15,3,3,1,3,3,1,0,0,,2,2,1,2,0,2,3,1,1,0,3,8,11.1
Pascal Siakam,22-288,F,11/18/16,TOR,DEN,1,23,4,6,0.667,4,6,0.667,0,0,,0,0,,1,3,4,0,1,0,0,2,8,7.2
Montrezl Harrell,22-316,F-C,12/7/16,HOU,LAL,0,9,4,6,0.667,4,6,0.667,0,0,,0,0,,1,0,1,0,1,0,1,1,8,5.7
Brandon Ingram,19-074,F,11/15/16,LAL,BRK,0,24,2,5,0.4,2,4,0.5,0,1,0,4,4,1,0,3,3,0,0,2,1,1,8,6.2
C.J. Miles,29-294,G-F,2/6/17,IND,OKC,1,20,3,10,0.3,2,3,0.667,1,7,0.143,1,1,1,0,3,3,0,0,0,0,3,8,1.9
Tomas Satoransky,25-006,G,11/5/16,WAS,ORL,1,32,4,7,0.571,4,7,0.571,0,0,,0,1,0,0,2,2,3,1,0,1,3,8,5.8
Langston Galloway,25-096,G,3/15/17,SAC,PHO,0,26,3,5,0.6,1,1,1,2,4,0.5,0,0,,0,2,2,2,1,0,3,1,8,5.3
Tony Snell,25-051,G-F,12/31/16,MIL,CHI,1,24,2,3,0.667,0,1,0,2,2,1,2,2,1,0,0,0,1,1,0,1,1,8,7
Zaza Pachulia,33-020,C,3/2/17,GSW,CHI,1,14,4,7,0.571,4,7,0.571,0,0,,0,0,,2,3,5,0,1,0,0,1,8,7.6
Jamal Murray,19-317,G,1/5/17,DEN,SAS,0,23,3,8,0.375,2,4,0.5,1,4,0.25,1,1,1,2,0,2,0,0,0,0,1,8,4.6
James Ennis,26-220,F,2/6/17,MEM,SAS,0,19,3,5,0.6,3,4,0.75,0,1,0,2,2,1,3,2,5,2,0,0,1,1,8,8.4
Robin Lopez,28-319,C,2/14/17,CHI,TOR,1,21,4,12,0.333,4,12,0.333,0,0,,0,0,,2,4,6,0,0,2,3,1,8,1.8
Derrick Jones,20-015,F,3/2/17,PHO,CHO,0,22,3,4,0.75,3,4,0.75,0,0,,2,2,1,0,0,0,0,2,2,0,2,8,9
Taurean Waller-Prince,22-246,F,11/23/16,ATL,IND,0,16,3,4,0.75,2,2,1,1,2,0.5,1,2,0.5,1,3,4,0,1,1,1,3,8,7.1
Markieff Morris,27-210,F,3/31/17,WAS,UTA,1,34,2,13,0.154,2,12,0.167,0,1,0,4,4,1,2,5,7,0,0,0,1,4,8,0
Joe Johnson,35-164,G-F,12/10/16,UTA,SAC,0,25,4,9,0.444,4,6,0.667,0,3,0,0,0,,1,3,4,3,1,1,1,2,8,6.9
Rudy Gobert,24-134,C,11/7/16,UTA,PHI,1,20,3,4,0.75,3,4,0.75,0,0,,2,5,0.4,0,6,6,0,1,3,2,6,8,5.7
Thomas Robinson,25-280,F,12/22/16,LAL,MIA,0,18,3,4,0.75,3,4,0.75,0,0,,2,2,1,5,7,12,2,0,1,1,2,8,12.3
Aron Baynes,30-056,C,2/3/17,DET,MIN,0,19,3,7,0.429,3,7,0.429,0,0,,2,2,1,5,1,6,0,0,0,1,3,8,5.9
Doug McDermott,24-342,F,12/10/16,CHI,MIA,0,26,3,9,0.333,3,7,0.429,0,2,0,2,2,1,0,1,1,0,1,0,1,1,8,2.8
Yogi Ferrell,23-314,G,3/19/17,DAL,BRK,1,22,2,5,0.4,2,4,0.5,0,1,0,4,4,1,0,2,2,5,3,1,1,3,8,10.9
Mindaugas Kuzminskas,27-169,F,4/6/17,NYK,WAS,0,17,4,10,0.4,4,8,0.5,0,2,0,0,0,,2,1,3,2,0,0,1,0,8,4.7
Kenneth Faried,26-359,F,11/12/16,DEN,DET,1,21,4,9,0.444,4,8,0.5,0,1,0,0,2,0,5,3,8,1,0,2,1,1,8,7.6
Andrew Nicholson,26-327,F,10/30/16,WAS,MEM,0,25,4,9,0.444,4,6,0.667,0,3,0,0,1,0,1,2,3,0,2,0,1,4,8,3.6
Sergio Rodriguez,30-270,G,3/9/17,PHI,POR,0,22,3,9,0.333,2,5,0.4,1,4,0.25,1,2,0.5,0,1,1,6,0,0,0,3,8,5.8
Zaza Pachulia,33-051,C,4/2/17,GSW,WAS,1,14,3,5,0.6,3,5,0.6,0,0,,2,2,1,1,4,5,1,1,0,1,2,8,7.5
Damjan Rudez,30-221,F,1/24/17,ORL,CHI,0,13,3,5,0.6,1,1,1,2,4,0.5,0,0,,0,1,1,0,0,0,1,2,8,4.2
Zach Randolph,35-243,F,3/16/17,MEM,ATL,0,18,4,13,0.308,4,12,0.333,0,1,0,0,0,,2,3,5,1,0,0,1,1,8,2.1
Chasson Randle,23-362,G,2/1/17,PHI,DAL,0,12,3,5,0.6,2,2,1,1,3,0.333,1,1,1,0,2,2,2,1,1,1,3,8,7.2
Ty Lawson,29-079,G,1/21/17,SAC,CHI,0,23,2,7,0.286,2,7,0.286,0,0,,4,5,0.8,1,2,3,6,1,0,3,2,8,6.2
Aron Baynes,30-105,C,3/24/17,DET,ORL,0,16,4,8,0.5,4,8,0.5,0,0,,0,0,,4,3,7,0,0,1,1,4,8,5.8
Matt Barnes,36-242,F,11/6/16,SAC,TOR,0,30,2,7,0.286,2,4,0.5,0,3,0,4,5,0.8,3,7,10,1,1,0,2,5,8,5.4
Sheldon McClellan,24-009,G,12/30/16,WAS,BRK,1,24,2,6,0.333,1,4,0.25,1,2,0.5,3,3,1,0,1,1,2,1,0,1,1,8,5.9
Klay Thompson,26-306,G,12/10/16,GSW,MEM,1,31,4,14,0.286,4,11,0.364,0,3,0,0,0,,0,1,1,0,1,0,0,1,8,0.7
Timofey Mozgov,30-127,C,11/20/16,LAL,CHI,1,21,4,7,0.571,4,7,0.571,0,0,,0,0,,1,1,2,1,4,0,1,1,8,9
Buddy Hield,23-053,G,2/8/17,NOP,UTA,1,19,3,7,0.429,1,1,1,2,6,0.333,0,0,,0,2,2,0,1,0,0,3,8,4.7
Wade Baldwin,20-217,G,11/1/16,MEM,MIN,1,23,2,8,0.25,2,4,0.5,0,4,0,4,4,1,1,2,3,1,3,0,5,1,8,2.8
Tyler Ulis,21-009,G,1/14/17,PHO,SAS,0,14,4,6,0.667,4,6,0.667,0,0,,0,0,,0,0,0,0,0,0,1,2,8,3.6
C.J. Miles,29-303,G-F,2/15/17,IND,CLE,0,19,2,3,0.667,1,1,1,1,2,0.5,3,3,1,0,2,2,0,0,0,1,2,8,5.5
Glenn Robinson,23-004,G-F,1/12/17,IND,DEN,1,27,4,10,0.4,4,8,0.5,0,2,0,0,0,,4,0,4,0,0,1,0,0,8,6.1
Garrett Temple,30-196,G,11/20/16,SAC,TOR,0,19,2,4,0.5,0,0,,2,4,0.5,2,2,1,0,3,3,1,1,1,0,1,8,8.9
Marco Belinelli,30-348,G-F,3/8/17,CHO,MIA,0,27,2,8,0.25,1,5,0.2,1,3,0.333,3,3,1,0,1,1,2,1,0,0,0,8,5.9
Sam Dekker,22-268,F,1/29/17,HOU,IND,0,26,4,6,0.667,4,4,1,0,2,0,0,0,,1,2,3,1,0,2,1,1,8,7.4
Willy Hernangomez,22-202,C,12/15/16,NYK,GSW,0,21,4,8,0.5,4,8,0.5,0,0,,0,2,0,1,9,10,2,0,1,0,0,8,8.7
Jaylen Brown,20-100,F,2/1/17,BOS,TOR,1,23,2,6,0.333,2,5,0.4,0,1,0,4,6,0.667,1,0,1,0,1,0,0,2,8,4.7
Rondae Hollis-Jefferson,22-022,F,1/25/17,BRK,MIA,0,24,3,5,0.6,3,4,0.75,0,1,0,2,2,1,0,5,5,1,0,2,1,2,8,7.5
Richard Jefferson,36-206,F,1/13/17,CLE,SAC,0,21,2,3,0.667,1,1,1,1,2,0.5,3,5,0.6,1,2,3,2,0,0,1,2,8,6.8
Jon Leuer,27-236,F,1/5/17,DET,CHO,1,22,3,6,0.5,1,3,0.333,2,3,0.667,0,0,,1,5,6,1,0,0,1,4,8,5.3
Kyrie Irving,25-004,G,3/27/17,CLE,SAS,1,26,4,13,0.308,4,11,0.364,0,2,0,0,1,0,0,3,3,2,0,0,3,2,8,-1.4
David Lee,33-217,F,12/2/16,SAS,WAS,0,17,3,6,0.5,3,6,0.5,0,0,,2,4,0.5,3,4,7,2,0,0,1,1,8,7.5
Bobby Portis,22-053,F,4/4/17,CHI,NYK,0,17,4,8,0.5,4,7,0.571,0,1,0,0,0,,2,1,3,0,0,0,1,2,8,3.9
T.J. Warren,23-072,F,11/16/16,PHO,DEN,1,18,2,11,0.182,0,7,0,2,4,0.5,2,2,1,0,1,1,0,2,0,1,2,8,1.6
Ryan Anderson,28-224,F,12/16/16,HOU,NOP,1,27,3,11,0.273,1,3,0.333,2,8,0.25,0,0,,0,3,3,0,0,0,0,1,8,2
Nerlens Noel,22-362,C-F,4/7/17,DAL,SAS,1,14,4,6,0.667,4,6,0.667,0,0,,0,0,,2,7,9,0,0,0,0,1,8,8.5
Jamal Murray,19-324,G,1/12/17,DEN,IND,0,11,3,6,0.5,3,3,1,0,3,0,2,2,1,1,0,1,2,1,0,2,0,8,6.1
C.J. Miles,29-191,G-F,10/26/16,IND,DAL,0,13,3,6,0.5,1,3,0.333,2,3,0.667,0,0,,0,0,0,1,2,0,0,1,8,7.3
Luis Scola,36-272,F,1/27/17,BRK,CLE,0,25,2,5,0.4,0,0,,2,5,0.4,2,2,1,2,5,7,4,2,0,3,4,8,8.4
Mirza Teletovic,31-041,F,10/29/16,MIL,BRK,0,16,2,4,0.5,0,1,0,2,3,0.667,2,2,1,0,2,2,2,0,0,0,3,8,6.8
Patrick McCaw,21-087,G,1/20/17,GSW,HOU,0,3,3,3,1,1,1,1,2,2,1,0,0,,0,0,0,0,0,0,0,0,8,7.1
Amir Johnson,29-318,F,3/15/17,BOS,MIN,1,26,3,3,1,3,3,1,0,0,,2,3,0.667,1,3,4,3,0,2,0,2,8,11
Joe Harris,25-154,G,2/8/17,BRK,WAS,0,19,3,5,0.6,1,2,0.5,2,3,0.667,0,0,,0,2,2,0,0,0,1,0,8,5.3
K.J. McDaniels,24-038,G-F,3/19/17,BRK,DAL,0,15,3,6,0.5,1,2,0.5,2,4,0.5,0,0,,0,1,1,1,0,0,1,2,8,4.2
Kosta Koufos,27-246,C,10/27/16,SAC,SAS,1,24,4,7,0.571,4,7,0.571,0,0,,0,0,,2,5,7,3,1,0,3,2,8,6.9
Jonas Jerebko,29-328,F,1/24/17,BOS,WAS,0,18,4,5,0.8,4,4,1,0,1,0,0,0,,2,3,5,0,0,1,0,2,8,8.3
Thaddeus Young,28-251,F,2/27/17,IND,HOU,1,23,4,10,0.4,4,10,0.4,0,0,,0,2,0,1,4,5,1,1,0,1,1,8,4
Pascal Siakam,22-302,F,12/2/16,TOR,LAL,1,24,4,5,0.8,4,4,1,0,1,0,0,0,,2,5,7,1,1,1,1,2,8,9.6
Victor Oladipo,24-208,G,11/28/16,OKC,NYK,1,31,4,11,0.364,4,7,0.571,0,4,0,0,0,,0,4,4,4,1,1,0,2,8,6.8
Tony Parker,34-265,G,2/6/17,SAS,MEM,1,29,3,7,0.429,3,7,0.429,0,0,,2,2,1,0,2,2,2,1,0,2,1,8,4.9
C.J. Miles,29-208,G-F,11/12/16,IND,BOS,1,32,3,10,0.3,1,3,0.333,2,7,0.286,0,0,,0,3,3,0,1,2,1,5,8,2.5
Giannis Antetokounmpo,22-069,F-G,2/13/17,MIL,DET,1,37,2,9,0.222,2,7,0.286,0,2,0,4,4,1,0,4,4,6,1,1,1,2,8,7.8
Kevin Seraphin,27-126,F,4/12/17,IND,ATL,0,15,3,8,0.375,3,8,0.375,0,0,,2,2,1,0,2,2,0,0,0,2,2,8,1.4
DeMarre Carroll,30-112,F,11/16/16,TOR,GSW,1,24,3,7,0.429,1,2,0.5,2,5,0.4,0,0,,0,3,3,2,1,0,1,1,8,6.2
Daniel Ochefu,23-118,C,4/12/17,WAS,MIA,0,17,4,6,0.667,4,6,0.667,0,0,,0,0,,2,1,3,1,1,0,0,1,8,8.4
Troy Williams,21-342,F,12/6/16,MEM,PHI,1,31,4,6,0.667,4,4,1,0,2,0,0,0,,1,2,3,1,2,1,0,4,8,8.5
Dorian Finney-Smith,23-329,F,3/29/17,DAL,NOP,0,14,3,4,0.75,1,1,1,2,3,0.667,0,0,,0,3,3,0,0,1,0,1,8,7.6
Darrell Arthur,28-307,F,1/26/17,DEN,PHO,0,15,3,5,0.6,1,2,0.5,2,3,0.667,0,0,,0,2,2,0,0,0,0,4,8,4.7
Kyle Korver,35-277,G-F,12/19/16,ATL,OKC,1,35,3,6,0.5,1,2,0.5,2,4,0.5,0,0,,0,2,2,6,0,0,0,4,8,8.2
Tristan Thompson,25-301,F-C,1/8/17,CLE,PHO,1,28,2,4,0.5,2,4,0.5,0,0,,4,4,1,4,6,10,1,0,0,1,3,8,9.1
Carmelo Anthony,32-192,F,12/7/16,NYK,CLE,1,24,4,9,0.444,4,7,0.571,0,2,0,0,0,,1,3,4,2,0,1,3,4,8,2.4
Caris LeVert,22-213,G-F,3/26/17,BRK,ATL,1,26,4,9,0.444,4,7,0.571,0,2,0,0,0,,2,3,5,1,0,0,2,1,8,3.9
Ty Lawson,29-135,G,3/18/17,SAC,OKC,0,22,3,6,0.5,3,5,0.6,0,1,0,2,5,0.4,1,0,1,6,0,0,1,2,8,6.9
Amir Johnson,29-243,F,12/30/16,BOS,MIA,1,23,2,3,0.667,2,3,0.667,0,0,,4,6,0.667,2,3,5,4,0,0,2,1,8,8.6
Chandler Parsons,28-094,F,1/27/17,MEM,POR,1,21,2,6,0.333,0,2,0,2,4,0.5,2,2,1,0,2,2,2,0,0,0,1,8,6.2
Quinn Cook,24-015,G,4/7/17,NOP,DEN,0,24,4,9,0.444,4,8,0.5,0,1,0,0,0,,0,1,1,4,0,0,1,1,8,5
Tyson Chandler,34-028,C,10/30/16,PHO,GSW,1,28,3,5,0.6,3,5,0.6,0,0,,2,4,0.5,3,15,18,1,0,0,2,3,8,9
Garrett Temple,30-252,G,1/15/17,SAC,OKC,1,24,3,6,0.5,3,4,0.75,0,2,0,2,2,1,0,4,4,3,0,0,0,2,8,7.5
Omri Casspi,28-158,F,11/27/16,SAC,BRK,0,18,3,3,1,1,1,1,2,2,1,0,0,,0,5,5,0,0,0,0,0,8,8.6
Andre Iguodala,33-041,G-F,3/10/17,GSW,MIN,0,32,4,6,0.667,4,5,0.8,0,1,0,0,0,,2,0,2,1,1,0,0,0,8,8.5
D.J. Augustin,29-029,G,12/9/16,ORL,CHO,1,19,3,10,0.3,1,3,0.333,2,7,0.286,0,0,,0,2,2,1,2,0,0,2,8,4.7
Markieff Morris,27-184,F,3/5/17,WAS,ORL,1,31,3,9,0.333,3,8,0.375,0,1,0,2,2,1,1,1,2,2,2,1,1,4,8,5.4
Joe Johnson,35-170,G-F,12/16/16,UTA,DAL,0,21,3,7,0.429,3,5,0.6,0,2,0,2,2,1,1,4,5,1,0,0,0,1,8,6.5
Robin Lopez,28-249,C,12/6/16,CHI,DET,1,33,3,5,0.6,3,5,0.6,0,0,,2,6,0.333,3,5,8,1,0,3,3,1,8,7.1
Zaza Pachulia,33-059,C,4/10/17,GSW,UTA,1,25,3,5,0.6,3,5,0.6,0,0,,2,2,1,3,3,6,3,0,1,4,3,8,6.3
Willy Hernangomez,22-225,C,1/7/17,NYK,IND,0,18,3,9,0.333,2,6,0.333,1,3,0.333,1,1,1,0,4,4,0,0,2,1,0,8,4.5
Jared Dudley,31-254,F-G,3/21/17,PHO,MIA,0,19,3,6,0.5,2,2,1,1,4,0.25,1,3,0.333,0,8,8,2,0,0,2,3,8,4.8
Julius Randle,21-349,F,11/12/16,LAL,NOP,1,28,4,11,0.364,4,11,0.364,0,0,,0,0,,2,9,11,8,2,2,1,3,8,12.8
Aaron Gordon,21-128,F,1/22/17,ORL,GSW,1,34,4,14,0.286,4,8,0.5,0,6,0,0,0,,1,2,3,5,1,1,1,3,8,4.1
Juan Hernangomez,21-154,F,3/1/17,DEN,MIL,0,14,2,3,0.667,1,1,1,1,2,0.5,3,3,1,1,2,3,0,0,0,2,2,8,5.2
Derrick Williams,25-276,F,2/25/17,CLE,CHI,0,23,3,7,0.429,3,5,0.6,0,2,0,2,4,0.5,0,4,4,2,0,0,0,0,8,6.1
Austin Rivers,24-087,G,10/27/16,LAC,POR,0,26,4,8,0.5,4,5,0.8,0,3,0,0,0,,0,4,4,2,1,0,0,2,8,6.8
Zach LaVine,21-302,G,1/6/17,MIN,WAS,1,37,3,14,0.214,1,8,0.125,2,6,0.333,0,0,,0,5,5,3,0,0,1,3,8,0.8
Ramon Sessions,30-234,G,12/1/16,CHO,DAL,0,15,3,3,1,3,3,1,0,0,,2,2,1,0,0,0,3,0,0,0,1,8,8.8
Matt Barnes,36-310,F,1/13/17,SAC,CLE,0,18,4,8,0.5,4,4,1,0,4,0,0,0,,1,4,5,0,0,0,1,3,8,3.7
Kenneth Faried,27-134,F,4/2/17,DEN,MIA,1,23,4,9,0.444,4,9,0.444,0,0,,0,0,,1,2,3,2,2,1,0,2,8,7.9
Hollis Thompson,25-332,G-F,3/1/17,NOP,DET,1,40,2,7,0.286,1,3,0.333,1,4,0.25,3,3,1,0,8,8,2,1,0,0,2,8,7.9
Jason Smith,30-322,F-C,1/18/17,WAS,MEM,0,20,3,8,0.375,3,6,0.5,0,2,0,2,2,1,1,2,3,0,2,1,0,4,8,6
John Henson,25-343,C-F,12/5/16,MIL,SAS,1,26,1,3,0.333,1,3,0.333,0,0,,6,8,0.75,0,5,5,1,1,3,3,3,8,6.6
Anthony Bennett,23-256,F,11/25/16,BRK,IND,0,10,3,5,0.6,3,3,1,0,2,0,2,3,0.667,2,2,4,0,0,0,0,0,8,7.3
Brandon Knight,25-015,G,12/17/16,PHO,OKC,0,20,3,10,0.3,2,8,0.25,1,2,0.5,1,1,1,0,1,1,2,0,0,1,3,8,1.7
Allen Crabbe,24-329,G-F,3/4/17,POR,BRK,0,19,2,3,0.667,1,1,1,1,2,0.5,3,4,0.75,0,3,3,1,0,0,0,1,8,7.5
Larry Nance Jr.,23-326,F,11/22/16,LAL,OKC,0,27,4,7,0.571,4,7,0.571,0,0,,0,0,,1,3,4,2,2,1,0,0,8,10.4
Kyle Anderson,23-126,F-G,1/24/17,SAS,TOR,1,32,2,6,0.333,2,6,0.333,0,0,,4,4,1,2,5,7,4,0,1,1,1,8,9.6
Marvin Williams,30-192,F,12/28/16,CHO,ORL,1,22,3,7,0.429,1,3,0.333,2,4,0.5,0,0,,1,5,6,1,1,1,0,1,8,8.5
Marquese Chriss,19-239,F,2/26/17,PHO,MIL,1,16,4,8,0.5,4,7,0.571,0,1,0,0,3,0,1,0,1,1,1,0,1,4,8,2.6
Greg Monroe,26-251,C-F,2/10/17,MIL,LAL,0,19,3,6,0.5,3,6,0.5,0,0,,2,2,1,0,1,1,3,1,0,2,4,8,4.8
Lou Williams,30-066,G,1/1/17,LAL,TOR,0,17,3,11,0.273,1,7,0.143,2,4,0.5,0,2,0,0,0,0,1,0,0,0,1,8,1
David Lee,33-249,F,1/3/17,SAS,TOR,0,15,4,6,0.667,4,6,0.667,0,0,,0,0,,2,2,4,1,1,1,0,0,8,9.8
Arron Afflalo,31-067,G,12/21/16,SAC,UTA,0,27,3,8,0.375,1,4,0.25,2,4,0.5,0,0,,1,3,4,3,0,0,2,4,8,3.7
Luc Mbah a Moute,30-071,F,11/19/16,LAC,CHI,1,26,3,6,0.5,1,3,0.333,2,3,0.667,0,0,,2,0,2,0,0,0,1,2,8,4.6
Denzel Valentine,23-137,G,4/2/17,CHI,NOP,0,26,3,6,0.5,1,2,0.5,2,4,0.5,0,0,,1,2,3,1,1,1,2,3,8,5.5
Nick Young,31-153,G-F,11/1/16,LAL,IND,1,21,3,6,0.5,1,2,0.5,2,4,0.5,0,0,,0,4,4,0,0,0,0,3,8,5
Iman Shumpert,26-250,G,3/3/17,CLE,ATL,1,28,2,7,0.286,0,1,0,2,6,0.333,2,2,1,1,2,3,1,0,0,1,2,8,4.1
Jaylen Brown,20-153,F,3/26/17,BOS,MIA,0,16,4,5,0.8,4,4,1,0,1,0,0,0,,0,2,2,2,1,0,0,2,8,8.3
Jahlil Okafor,20-316,C-F,10/26/16,PHI,OKC,0,16,4,10,0.4,4,10,0.4,0,0,,0,0,,1,2,3,0,0,1,3,2,8,0.8
J.R. Smith,31-075,G-F,11/23/16,CLE,POR,1,27,3,3,1,1,1,1,2,2,1,0,0,,1,1,2,0,0,0,1,3,8,5.9
Andre Iguodala,32-329,G-F,12/22/16,GSW,BRK,0,25,3,6,0.5,1,1,1,2,5,0.4,0,0,,1,5,6,1,2,1,1,0,8,9.6
Ian Mahinmi,30-148,C,4/2/17,WAS,GSW,0,21,4,4,1,4,4,1,0,0,,0,0,,0,2,2,3,1,0,1,4,8,7.9
Jodie Meeks,29-136,G,1/4/17,ORL,ATL,1,24,4,8,0.5,4,7,0.571,0,1,0,0,0,,0,2,2,1,2,0,0,3,8,6.1
James Johnson,30-012,F,3/4/17,MIA,CLE,0,18,3,5,0.6,2,3,0.667,1,2,0.5,1,1,1,1,3,4,4,1,1,2,1,8,9.4
Doug McDermott,24-311,F,11/9/16,CHI,ATL,0,19,4,6,0.667,4,5,0.8,0,1,0,0,0,,0,1,1,0,0,0,0,3,8,4.5
Brandon Bass,31-277,F,2/1/17,LAC,PHO,0,6,3,3,1,3,3,1,0,0,,2,2,1,0,1,1,0,0,0,0,0,8,7.4
Dennis Schroder,23-208,G,4/11/17,ATL,CHO,1,25,3,5,0.6,3,5,0.6,0,0,,2,2,1,0,3,3,9,1,0,3,2,8,10.1
Nikola Vucevic,26-103,C,2/4/17,ORL,ATL,1,24,4,10,0.4,4,10,0.4,0,0,,0,0,,0,7,7,2,2,0,0,3,8,6.9
Serge Ibaka,27-087,F-C,12/14/16,ORL,LAC,1,31,3,10,0.3,2,5,0.4,1,5,0.2,1,2,0.5,2,6,8,2,0,0,0,3,8,5.2
Boban Marjanovic,28-148,C,1/10/17,DET,SAC,0,10,3,7,0.429,3,7,0.429,0,0,,2,2,1,1,3,4,0,0,0,0,0,8,5.9
Montrezl Harrell,23-016,F-C,2/11/17,HOU,PHO,0,18,2,6,0.333,2,6,0.333,0,0,,4,5,0.8,2,3,5,2,0,0,1,1,8,6.5
Clint Capela,22-298,F-C,3/12/17,HOU,CLE,1,26,4,8,0.5,4,8,0.5,0,0,,0,2,0,4,7,11,1,1,1,0,3,8,9.3
Cristiano Felicio,24-194,F-C,1/17/17,CHI,DAL,0,12,3,3,1,3,3,1,0,0,,2,2,1,1,0,1,1,1,0,0,4,8,7.9
Thomas Robinson,25-287,F,12/29/16,LAL,DAL,0,19,4,5,0.8,4,5,0.8,0,0,,0,0,,4,6,10,0,1,1,2,3,8,9.2
Rondae Hollis-Jefferson,21-311,F,11/9/16,BRK,NYK,1,29,1,4,0.25,1,2,0.5,0,2,0,6,6,1,0,5,5,4,0,1,3,1,8,7.2
Alec Burks,25-226,G,3/3/17,UTA,BRK,0,23,3,11,0.273,1,8,0.125,2,3,0.667,0,0,,2,4,6,0,1,0,0,2,8,4.3
Shaun Livingston,31-139,G,1/28/17,GSW,LAC,0,16,4,6,0.667,4,6,0.667,0,0,,0,0,,0,2,2,1,1,1,0,1,8,8
Ben McLemore,24-043,G,3/26/17,SAC,LAC,0,20,2,5,0.4,2,3,0.667,0,2,0,4,5,0.8,0,2,2,2,0,0,1,2,8,5.1
Garrett Temple,30-258,G,1/21/17,SAC,CHI,1,30,3,9,0.333,2,5,0.4,1,4,0.25,1,2,0.5,0,3,3,3,2,1,2,5,8,4.2
P.J. Tucker,31-256,F,1/16/17,PHO,UTA,0,27,4,6,0.667,4,5,0.8,0,1,0,0,0,,2,11,13,0,2,0,0,3,8,10.9
Cameron Payne,22-152,G,1/7/17,OKC,DEN,0,13,3,4,0.75,1,1,1,2,3,0.667,0,0,,0,2,2,1,0,0,1,1,8,6.3
Shaun Livingston,31-194,G,3/24/17,GSW,SAC,0,19,4,4,1,4,4,1,0,0,,0,0,,0,0,0,1,1,0,0,1,8,8.1
Dwight Powell,25-145,F-C,12/12/16,DAL,DEN,0,22,4,5,0.8,4,5,0.8,0,0,,0,0,,1,0,1,1,0,0,1,1,8,6.1
Michael Kidd-Gilchrist,23-190,F,4/4/17,CHO,WAS,1,26,3,5,0.6,3,5,0.6,0,0,,2,2,1,2,1,3,1,0,0,1,2,8,6.3
David West,36-070,F,11/7/16,GSW,NOP,0,14,3,5,0.6,3,5,0.6,0,0,,2,2,1,3,1,4,2,3,0,1,1,8,11.1
Jerami Grant,23-021,F,4/2/17,OKC,CHO,0,23,3,3,1,1,1,1,2,2,1,0,0,,1,2,3,1,0,1,1,3,8,7.6
Nik Stauskas,23-109,G,1/24/17,PHI,LAC,1,24,3,5,0.6,1,2,0.5,2,3,0.667,0,0,,0,1,1,2,1,0,1,2,8,6.6
Aaron Gordon,21-043,F,10/29/16,ORL,CLE,1,26,3,7,0.429,2,4,0.5,1,3,0.333,1,2,0.5,0,3,3,2,3,1,2,3,8,6.7
Austin Rivers,24-091,G,10/31/16,LAC,PHO,0,24,4,9,0.444,4,9,0.444,0,0,,0,0,,0,0,0,1,0,0,2,0,8,2
Jaylen Brown,20-092,F,1/24/17,BOS,WAS,0,24,3,6,0.5,2,4,0.5,1,2,0.5,1,1,1,0,5,5,1,0,0,2,2,8,4.4
Timothe Luwawu-Cabarrot,21-321,F,3/26/17,PHI,IND,1,21,3,9,0.333,1,3,0.333,2,6,0.333,0,0,,0,2,2,2,0,0,2,3,8,1.7
Justin Holiday,27-226,G,11/17/16,NYK,WAS,0,23,2,3,0.667,1,1,1,1,2,0.5,3,4,0.75,0,4,4,0,1,0,1,2,8,6.7
Nikola Mirotic,26-038,F,3/21/17,CHI,TOR,1,26,3,9,0.333,1,2,0.5,2,7,0.286,0,2,0,0,2,2,2,0,0,2,2,8,1.3
Nemanja Bjelica,28-231,F,12/26/16,MIN,ATL,0,25,3,9,0.333,3,4,0.75,0,5,0,2,2,1,1,4,5,3,2,0,3,4,8,4.3
Ron Baker,23-355,G,3/20/17,NYK,LAC,0,20,3,5,0.6,1,3,0.333,2,2,1,0,0,,0,3,3,2,2,0,1,2,8,8.2
Troy Daniels,25-268,G,4/9/17,MEM,DET,0,14,3,9,0.333,1,5,0.2,2,4,0.5,0,0,,0,0,0,0,0,0,0,1,8,2.5
Evan Turner,28-092,G,1/27/17,POR,MEM,1,31,3,9,0.333,1,6,0.167,2,3,0.667,0,0,,0,2,2,8,0,0,1,4,8,6.5
Ivica Zubac,19-350,C,3/3/17,LAL,BOS,0,23,4,8,0.5,4,8,0.5,0,0,,0,2,0,0,1,1,3,2,2,0,2,8,8.2
Mindaugas Kuzminskas,27-108,F,2/4/17,NYK,CLE,0,19,2,6,0.333,1,2,0.5,1,4,0.25,3,4,0.75,1,5,6,0,1,0,0,0,8,7.4
Jonathon Simmons,27-202,G-F,4/4/17,SAS,MEM,1,27,4,8,0.5,4,7,0.571,0,1,0,0,0,,1,1,2,4,1,0,3,3,8,4.6
C.J. Miles,29-262,G-F,1/5/17,IND,BRK,0,18,3,6,0.5,1,2,0.5,2,4,0.5,0,0,,0,2,2,0,0,0,1,1,8,4.2
Rodney McGruder,25-109,G,11/15/16,MIA,ATL,1,37,4,11,0.364,4,8,0.5,0,3,0,0,0,,3,1,4,3,2,0,0,3,8,7.2
Arron Afflalo,31-039,G,11/23/16,SAC,OKC,1,30,3,7,0.429,3,6,0.5,0,1,0,2,2,1,0,1,1,4,0,0,0,1,8,7
T.J. McConnell,24-292,G,1/11/17,PHI,NYK,1,34,4,6,0.667,4,6,0.667,0,0,,0,0,,2,4,6,7,2,0,2,1,8,12.5
Raymond Felton,32-199,G,1/11/17,LAC,ORL,0,17,4,6,0.667,4,5,0.8,0,1,0,0,0,,0,3,3,0,0,1,2,3,8,3.8
Jonas Jerebko,30-001,F,3/3/17,BOS,LAL,0,16,3,3,1,1,1,1,2,2,1,0,0,,0,4,4,0,0,0,2,2,8,5.5
Trevor Booker,29-048,F,1/12/17,BRK,NOP,1,30,4,9,0.444,4,8,0.5,0,1,0,0,2,0,3,9,12,4,1,1,0,4,8,10.2
Stanley Johnson,20-228,F,1/12/17,DET,GSW,0,38,3,5,0.6,1,2,0.5,2,3,0.667,0,0,,0,2,2,3,0,1,0,2,8,8.3
Tyson Chandler,34-024,C,10/26/16,PHO,SAC,1,23,4,5,0.8,4,5,0.8,0,0,,0,2,0,3,7,10,0,0,0,1,4,8,6.9
Nikola Mirotic,26-021,F,3/4/17,CHI,LAC,0,27,4,9,0.444,4,5,0.8,0,4,0,0,0,,1,6,7,2,3,0,1,2,8,8.4
Zaza Pachulia,33-015,C,2/25/17,GSW,BRK,1,20,3,5,0.6,3,5,0.6,0,0,,2,3,0.667,1,8,9,3,0,1,1,5,8,8.2
Marcus Thornton,29-184,G,12/6/16,WAS,ORL,0,18,4,7,0.571,4,5,0.8,0,2,0,0,0,,2,4,6,3,1,0,1,2,8,8.6
Frank Kaminsky,23-294,F-C,1/23/17,CHO,WAS,0,20,3,10,0.3,1,7,0.143,2,3,0.667,0,0,,1,3,4,1,0,0,1,1,8,3.1
Kevin Seraphin,26-327,F,10/29/16,IND,CHI,0,12,4,6,0.667,4,6,0.667,0,0,,0,0,,1,3,4,2,2,1,0,2,8,10.3
Hassan Whiteside,27-199,C,12/29/16,MIA,CHO,1,35,4,7,0.571,4,7,0.571,0,0,,0,0,,0,10,10,0,0,2,4,2,8,4.3
JaMychal Green,26-163,F,12/1/16,MEM,ORL,1,27,3,4,0.75,2,3,0.667,1,1,1,1,2,0.5,0,7,7,3,2,0,0,5,8,10.2
Tim Frazier,26-034,G,12/5/16,NOP,MEM,1,39,3,10,0.3,3,7,0.429,0,3,0,2,2,1,1,3,4,9,3,0,4,2,8,8.3
Solomon Hill,25-265,F,12/8/16,NOP,PHI,1,38,3,7,0.429,2,4,0.5,1,3,0.333,1,2,0.5,1,3,4,3,0,0,3,2,8,3.8
Dirk Nowitzki,38-281,F,3/27/17,DAL,OKC,1,25,3,9,0.333,2,6,0.333,1,3,0.333,1,2,0.5,0,8,8,2,0,1,3,3,8,2.8
Cody Zeller,24-182,F-C,4/5/17,CHO,MIA,1,30,4,12,0.333,4,12,0.333,0,0,,0,0,,0,4,4,3,0,1,0,3,8,4
Doug McDermott,24-345,F,12/13/16,CHI,MIN,0,27,4,8,0.5,4,7,0.571,0,1,0,0,0,,1,2,3,0,0,0,0,3,8,4.1
Jeremy Lamb,24-201,G-F,12/17/16,CHO,ATL,0,16,4,7,0.571,4,6,0.667,0,1,0,0,1,0,1,4,5,0,0,1,1,2,8,5.1
Willy Hernangomez,22-243,C,1/25/17,NYK,DAL,0,24,4,9,0.444,4,9,0.444,0,0,,0,0,,6,10,16,0,3,0,0,2,8,12.7
Brandon Rush,31-237,G-F,3/1/17,MIN,UTA,1,24,3,5,0.6,1,2,0.5,2,3,0.667,0,0,,1,1,2,1,0,1,0,3,8,6.9
Domantas Sabonis,20-282,F,2/9/17,OKC,CLE,1,21,4,9,0.444,4,8,0.5,0,1,0,0,0,,0,2,2,0,0,0,1,4,8,1.3
Archie Goodwin,22-089,G,11/14/16,NOP,BOS,0,15,1,4,0.25,1,3,0.333,0,1,0,6,6,1,0,0,0,1,0,0,0,1,8,5.9
Corey Brewer,31-038,F-G,4/12/17,LAL,GSW,0,18,4,8,0.5,4,8,0.5,0,0,,0,0,,0,2,2,2,4,0,1,4,8,7.4
Taj Gibson,31-271,F,3/22/17,OKC,PHI,1,13,4,8,0.5,4,8,0.5,0,0,,0,0,,2,1,3,1,0,0,2,0,8,4.4
Jonathon Simmons,27-154,G-F,2/15/17,SAS,ORL,0,21,2,7,0.286,2,3,0.667,0,4,0,4,4,1,0,5,5,0,0,0,0,2,8,4.6
Patrick Patterson,28-005,F,3/19/17,TOR,IND,0,19,2,3,0.667,0,0,,2,3,0.667,2,2,1,0,1,1,2,1,0,0,0,8,9.4
Derrick Jones,20-013,F,2/28/17,PHO,MEM,0,10,4,4,1,4,4,1,0,0,,0,0,,0,2,2,0,0,0,0,4,8,5.8
Dennis Schroder,23-184,G,3/18/17,ATL,POR,1,28,2,14,0.143,1,12,0.083,1,2,0.5,3,4,0.75,0,3,3,7,4,0,2,1,8,6
Noah Vonleh,21-150,F,1/21/17,POR,BOS,1,17,4,8,0.5,4,8,0.5,0,0,,0,0,,4,2,6,0,3,0,2,6,8,6
Stanley Johnson,20-201,F,12/16/16,DET,WAS,0,17,4,5,0.8,4,4,1,0,1,0,0,1,0,0,1,1,1,0,0,1,2,8,4.9
Joel Bolomboy,23-042,F,3/11/17,UTA,OKC,0,15,4,7,0.571,4,6,0.667,0,1,0,0,0,,0,1,1,1,0,0,1,0,8,4.7
Kent Bazemore,27-220,G-F,2/6/17,ATL,UTA,1,29,2,8,0.25,1,5,0.2,1,3,0.333,3,4,0.75,0,1,1,1,3,0,1,0,8,5.8
Taurean Waller-Prince,22-330,F,2/15/17,ATL,LAC,0,25,3,8,0.375,2,4,0.5,1,4,0.25,1,1,1,1,4,5,0,0,0,3,2,8,1.7
Joe Johnson,35-225,G-F,2/9/17,UTA,DAL,0,26,3,8,0.375,1,2,0.5,2,6,0.333,0,0,,0,0,0,4,2,0,4,1,8,4
Nick Young,31-147,G-F,10/26/16,LAL,HOU,1,27,3,12,0.25,1,3,0.333,2,9,0.222,0,0,,0,3,3,1,0,1,0,5,8,1.1
Willie Reed,26-208,F-C,12/10/16,MIA,CHI,0,15,4,5,0.8,4,5,0.8,0,0,,0,2,0,4,3,7,1,0,1,0,2,8,9.6
Glenn Robinson,22-361,G-F,1/3/17,IND,DET,1,28,3,5,0.6,1,2,0.5,2,3,0.667,0,0,,0,2,2,2,0,2,0,1,8,8.7
Cody Zeller,24-055,F-C,11/29/16,CHO,DET,1,28,4,6,0.667,4,6,0.667,0,0,,0,0,,2,8,10,0,1,1,2,3,8,7.7
Enes Kanter,24-173,C,11/9/16,OKC,TOR,0,19,3,3,1,3,3,1,0,0,,2,2,1,0,0,0,0,0,0,3,3,8,2.9
Joffrey Lauvergne,25-036,C-F,11/5/16,OKC,MIN,0,23,4,9,0.444,4,8,0.5,0,1,0,0,0,,2,2,4,0,0,0,1,4,8,2.7
Cody Zeller,24-166,F-C,3/20/17,CHO,ATL,1,22,4,6,0.667,4,6,0.667,0,0,,0,2,0,2,3,5,0,2,0,0,5,8,6.9
Stanley Johnson,20-284,F,3/9/17,DET,CLE,0,18,3,6,0.5,3,3,1,0,3,0,2,3,0.667,0,5,5,1,1,0,1,3,8,5.6
Isaiah Whitehead,21-241,G,11/4/16,BRK,CHO,1,23,4,9,0.444,4,6,0.667,0,3,0,0,0,,1,1,2,3,2,2,3,5,8,4.8
Justin Anderson,23-140,G,4/8/17,PHI,MIL,1,29,2,12,0.167,2,6,0.333,0,6,0,4,6,0.667,3,3,6,2,0,0,1,2,8,2.2
Nicolas Batum,27-351,F-G,11/29/16,CHO,DET,1,30,3,11,0.273,1,6,0.167,2,5,0.4,0,0,,1,10,11,5,0,0,2,1,8,6.3
Jameer Nelson,35-015,G,2/24/17,DEN,BRK,1,22,3,5,0.6,1,1,1,2,4,0.5,0,0,,0,1,1,6,2,0,0,3,8,11
Andre Iguodala,33-014,G-F,2/11/17,GSW,OKC,0,28,3,8,0.375,2,4,0.5,1,4,0.25,1,2,0.5,1,4,5,3,0,0,1,1,8,5.8
Elfrid Payton,23-016,G,3/10/17,ORL,CHO,1,27,4,8,0.5,4,8,0.5,0,0,,0,0,,0,2,2,12,1,1,3,1,8,11.3
Nik Stauskas,23-183,G,4/8/17,PHI,MIL,0,28,3,10,0.3,1,4,0.25,2,6,0.333,0,0,,0,3,3,2,0,0,0,1,8,4.1
Andre Roberson,25-052,G-F,1/25/17,OKC,NOP,1,28,4,4,1,4,4,1,0,0,,0,0,,1,3,4,1,1,3,0,0,8,12.2
Victor Oladipo,24-335,G,4/4/17,OKC,MIL,1,25,2,7,0.286,1,2,0.5,1,5,0.2,3,4,0.75,0,2,2,4,1,0,2,1,8,5.5
Alex Len,23-283,C,3/26/17,PHO,CHO,1,22,3,5,0.6,3,5,0.6,0,0,,2,2,1,0,3,3,0,0,1,0,2,8,6.5
Andre Iguodala,32-295,G-F,11/18/16,GSW,BOS,0,22,4,7,0.571,4,6,0.667,0,1,0,0,1,0,1,5,6,2,0,0,0,1,8,7.5
Arron Afflalo,31-144,G,3/8/17,SAC,SAS,1,27,3,8,0.375,3,8,0.375,0,0,,2,2,1,0,4,4,1,1,0,1,1,8,5.1
Josh Richardson,23-170,G,3/4/17,MIA,CLE,0,25,4,9,0.444,4,7,0.571,0,2,0,0,0,,1,6,7,3,0,1,0,1,8,8.2
Joakim Noah,31-292,C,12/13/16,NYK,PHO,1,22,3,5,0.6,3,5,0.6,0,0,,2,7,0.286,2,6,8,3,1,1,4,3,8,5.5
Clint Capela,22-168,F-C,11/2/16,HOU,NYK,1,21,4,6,0.667,4,6,0.667,0,0,,0,3,0,5,1,6,1,1,1,1,3,8,8.2
Tristan Thompson,25-358,F-C,3/6/17,CLE,MIA,1,36,3,3,1,3,3,1,0,0,,2,4,0.5,4,9,13,1,0,2,2,3,8,10.7
Jason Terry,39-176,G,3/10/17,MIL,IND,0,26,3,5,0.6,2,3,0.667,1,2,0.5,1,2,0.5,0,3,3,1,3,0,0,3,8,8.7
Raul Neto,24-226,G,12/31/16,UTA,PHO,0,14,3,6,0.5,3,4,0.75,0,2,0,2,2,1,0,1,1,1,1,0,0,2,8,6.2
Tony Snell,25-032,G-F,12/12/16,MIL,TOR,1,29,3,6,0.5,1,1,1,2,5,0.4,0,0,,0,5,5,4,0,0,0,1,8,8.9
Shabazz Napier,25-156,G,12/17/16,POR,GSW,0,12,3,6,0.5,2,4,0.5,1,2,0.5,1,1,1,0,1,1,2,1,0,1,0,8,6.7
Amir Johnson,29-178,F,10/26/16,BOS,BRK,1,20,4,6,0.667,4,6,0.667,0,0,,0,1,0,4,3,7,2,1,0,4,2,8,6.3
D.J. Augustin,29-015,G,11/25/16,ORL,WAS,0,26,3,9,0.333,2,4,0.5,1,5,0.2,1,1,1,0,0,0,4,0,0,2,3,8,2.5
Alex Len,23-262,C,3/5/17,PHO,BOS,1,13,3,7,0.429,3,7,0.429,0,0,,2,3,0.667,1,1,2,1,0,0,0,3,8,4.4
Jonathon Simmons,27-188,G-F,3/21/17,SAS,MIN,0,16,3,6,0.5,1,3,0.333,2,3,0.667,0,0,,1,3,4,0,0,0,0,1,8,6.2
Rudy Gobert,24-126,C,10/30/16,UTA,LAC,1,26,3,4,0.75,3,4,0.75,0,0,,2,2,1,2,7,9,3,0,2,4,3,8,8.2
Al-Farouq Aminu,26-046,F,11/6/16,POR,MEM,1,34,3,10,0.3,2,6,0.333,1,4,0.25,1,2,0.5,1,3,4,2,1,0,3,0,8,2.8
Miles Plumlee,28-059,C-F,10/30/16,MIL,DET,1,17,4,6,0.667,4,6,0.667,0,0,,0,0,,2,3,5,3,1,0,2,2,8,8
Raymond Felton,32-180,G,12/23/16,LAC,DAL,1,34,3,11,0.273,2,8,0.25,1,3,0.333,1,1,1,0,4,4,2,1,0,2,2,8,2.3
Willy Hernangomez,22-276,C,2/27/17,NYK,TOR,1,34,4,6,0.667,4,6,0.667,0,0,,0,0,,4,5,9,2,1,0,2,4,8,8.5
Bradley Beal,23-205,G,1/19/17,WAS,NYK,1,38,4,13,0.308,4,6,0.667,0,7,0,0,0,,1,1,2,5,1,0,5,1,8,0.6
Alex Len,23-190,C,12/23/16,PHO,PHI,0,18,3,4,0.75,3,4,0.75,0,0,,2,2,1,2,5,7,2,0,1,3,5,8,6.4
Mario Hezonja,21-328,F-G,1/18/17,ORL,NOP,0,18,3,5,0.6,1,3,0.333,2,2,1,0,0,,1,4,5,1,0,0,2,1,8,5.9
Leandro Barbosa,34-092,G,2/28/17,PHO,MEM,0,15,3,5,0.6,3,4,0.75,0,1,0,2,2,1,0,1,1,0,0,0,4,2,8,1.2
Blake Griffin,27-362,F,3/13/17,LAC,UTA,1,37,3,8,0.375,2,6,0.333,1,2,0.5,1,2,0.5,1,8,9,5,0,0,0,2,8,9
Marreese Speights,29-214,C-F,3/6/17,LAC,BOS,0,15,3,6,0.5,2,2,1,1,4,0.25,1,2,0.5,2,6,8,0,0,0,1,3,8,5.6
Salah Mejri,30-285,C,3/27/17,DAL,OKC,0,17,3,4,0.75,3,4,0.75,0,0,,2,3,0.667,1,4,5,1,0,0,0,3,8,7.4
Rajon Rondo,30-342,G,1/29/17,CHI,PHI,0,21,2,9,0.222,1,7,0.143,1,2,0.5,3,4,0.75,0,5,5,10,0,1,0,0,8,11.3
Darrell Arthur,28-243,F,11/23/16,DEN,UTA,0,16,3,8,0.375,1,3,0.333,2,5,0.4,0,0,,1,0,1,0,0,0,0,1,8,3.9
Taj Gibson,31-133,F,11/4/16,CHI,NYK,1,31,4,7,0.571,4,7,0.571,0,0,,0,2,0,4,2,6,1,1,1,1,3,8,7.5
Gary Harris,22-143,G,2/4/17,DEN,SAS,1,25,4,9,0.444,4,8,0.5,0,1,0,0,0,,1,3,4,3,2,0,0,0,8,9
Dennis Schroder,23-102,G,12/26/16,ATL,MIN,1,23,4,10,0.4,4,8,0.5,0,2,0,0,0,,1,1,2,4,1,0,2,4,8,3.8
Tony Snell,25-114,G-F,3/4/17,MIL,TOR,1,30,3,11,0.273,1,3,0.333,2,8,0.25,0,0,,0,2,2,0,1,0,2,2,8,0.3
Greg Monroe,26-304,C-F,4/4/17,MIL,OKC,0,16,4,6,0.667,4,6,0.667,0,0,,0,0,,3,2,5,0,0,0,3,3,8,3.9
P.J. Tucker,31-320,F,3/21/17,TOR,CHI,0,33,3,6,0.5,1,2,0.5,2,4,0.5,0,0,,2,10,12,1,1,0,1,4,8,8.5
Dario Saric,22-270,F,1/3/17,PHI,MIN,0,24,3,8,0.375,3,5,0.6,0,3,0,2,2,1,2,5,7,1,2,1,3,1,8,6.5
Jason Terry,39-169,G,3/3/17,MIL,LAC,0,25,3,4,0.75,1,1,1,2,3,0.667,0,0,,0,1,1,2,2,0,0,0,8,10.1
Brandon Bass,31-234,F,12/20/16,LAC,DEN,0,11,3,3,1,3,3,1,0,0,,2,2,1,1,0,1,1,0,0,1,0,8,7.5
Rodney Hood,24-036,G-F,11/25/16,UTA,ATL,1,28,3,9,0.333,1,4,0.25,2,5,0.4,0,0,,1,3,4,1,0,0,1,1,8,3.8
Ty Lawson,28-363,G,10/31/16,SAC,ATL,1,23,3,5,0.6,2,4,0.5,1,1,1,1,2,0.5,1,1,2,6,3,0,1,3,8,11.3
Timofey Mozgov,30-106,C,10/30/16,LAL,OKC,1,24,4,5,0.8,4,5,0.8,0,0,,0,0,,3,2,5,1,0,1,3,1,8,6.8
Paul Millsap,32-005,F,2/15/17,ATL,LAC,1,30,3,12,0.25,2,8,0.25,1,4,0.25,1,2,0.5,1,1,2,1,2,0,2,3,8,0.9
Michael Kidd-Gilchrist,23-194,F,4/8/17,CHO,BOS,1,24,2,7,0.286,2,7,0.286,0,0,,4,5,0.8,1,3,4,1,0,1,1,3,8,4.3
Channing Frye,33-183,C-F,11/16/16,CLE,IND,0,27,3,9,0.333,1,1,1,2,8,0.25,0,0,,0,5,5,2,0,2,4,2,8,2.4
Trevor Booker,29-070,F,2/3/17,BRK,IND,0,21,3,8,0.375,3,8,0.375,0,0,,2,2,1,3,4,7,4,1,0,2,1,8,8.3
Marquese Chriss,19-277,F,4/5/17,PHO,GSW,1,25,4,10,0.4,4,7,0.571,0,3,0,0,0,,2,9,11,4,1,1,2,3,8,8
Joe Ingles,29-028,F-G,10/30/16,UTA,LAC,0,20,3,7,0.429,1,4,0.25,2,3,0.667,0,0,,1,6,7,3,1,0,1,2,8,8.1
Robert Covington,26-080,F,3/4/17,PHI,DET,1,25,3,10,0.3,1,5,0.2,2,5,0.4,0,0,,0,4,4,3,0,1,3,0,8,3.2
Shaun Livingston,31-146,G,2/4/17,GSW,SAC,0,17,3,4,0.75,3,4,0.75,0,0,,2,2,1,0,2,2,0,0,1,0,0,8,7.7
J.J. Redick,32-189,G,12/30/16,LAC,HOU,1,25,3,9,0.333,1,3,0.333,2,6,0.333,0,0,,1,0,1,1,0,0,1,3,8,2.1
Cory Joseph,25-100,G,11/28/16,TOR,PHI,0,24,4,10,0.4,4,9,0.444,0,1,0,0,0,,0,4,4,2,1,0,1,3,8,4
Derrick Favors,25-190,F-C,1/21/17,UTA,IND,1,24,3,7,0.429,3,7,0.429,0,0,,2,4,0.5,2,5,7,3,1,1,3,1,8,6.8
Austin Rivers,24-095,G,11/4/16,LAC,MEM,0,23,2,9,0.222,1,5,0.2,1,4,0.25,3,5,0.6,0,3,3,0,2,0,0,2,8,3.8
Jordan Mickey,22-120,F,11/6/16,BOS,DEN,0,19,4,4,1,4,4,1,0,0,,0,1,0,0,2,2,1,0,0,1,2,8,5.9
Trevor Ariza,31-207,F,1/23/17,HOU,MIL,1,40,2,7,0.286,0,2,0,2,5,0.4,2,2,1,0,5,5,5,4,1,1,2,8,11.8
Aron Baynes,29-356,C,11/29/16,DET,CHO,0,23,3,7,0.429,3,7,0.429,0,0,,2,2,1,3,5,8,0,0,0,2,3,8,4.7
Solomon Hill,25-308,F,1/20/17,NOP,BRK,1,23,4,6,0.667,4,6,0.667,0,0,,0,0,,0,0,0,1,0,1,0,1,8,6.4
Marreese Speights,29-100,C-F,11/12/16,LAC,MIN,0,14,3,7,0.429,1,1,1,2,6,0.333,0,0,,1,2,3,0,0,0,0,2,8,4.8
JaVale McGee,28-312,C,11/26/16,GSW,MIN,0,11,4,5,0.8,4,5,0.8,0,0,,0,0,,2,3,5,1,0,1,2,1,8,7.4
Seth Curry,26-066,G,10/28/16,DAL,HOU,0,20,3,6,0.5,2,2,1,1,4,0.25,1,1,1,0,0,0,1,0,0,0,4,8,4.1
Tomas Satoransky,25-012,G,11/11/16,WAS,CLE,0,20,3,7,0.429,3,7,0.429,0,0,,2,2,1,1,1,2,2,1,0,1,0,8,6.7
Thabo Sefolosha,32-187,G-F,11/5/16,ATL,HOU,0,24,4,8,0.5,4,7,0.571,0,1,0,0,0,,3,1,4,1,3,1,1,0,8,9.8
Kyle Korver,35-329,G-F,2/9/17,CLE,OKC,0,26,3,3,1,1,1,1,2,2,1,0,0,,0,1,1,0,1,1,2,2,8,6.3
Jerian Grant,24-090,G,1/7/17,CHI,TOR,0,22,2,3,0.667,2,2,1,0,1,0,4,4,1,1,2,3,3,0,0,0,4,8,8.5
Robert Covington,26-057,F,2/9/17,PHI,ORL,1,36,3,12,0.25,3,9,0.333,0,3,0,2,4,0.5,5,4,9,2,2,1,1,3,8,6.6
Terrence Jones,24-339,F,12/13/16,NOP,GSW,0,21,4,6,0.667,4,5,0.8,0,1,0,0,0,,1,9,10,0,1,2,1,0,8,10.2
Iman Shumpert,26-174,G,12/17/16,CLE,LAL,0,29,3,9,0.333,2,3,0.667,1,6,0.167,1,1,1,2,2,4,1,0,0,1,4,8,3
Tony Snell,25-109,G-F,2/27/17,MIL,CLE,1,33,2,6,0.333,0,1,0,2,5,0.4,2,2,1,0,3,3,0,1,1,0,2,8,6.4
Tarik Black,24-348,C-F,11/4/16,LAL,GSW,0,15,4,6,0.667,4,6,0.667,0,0,,0,0,,1,4,5,0,0,0,2,3,8,4.1
Beno Udrih,34-137,G,11/19/16,DET,BOS,0,15,3,5,0.6,3,5,0.6,0,0,,2,2,1,0,2,2,4,0,0,0,0,8,9.1
Archie Goodwin,22-227,G,4/1/17,BRK,ORL,0,16,2,4,0.5,2,3,0.667,0,1,0,4,4,1,0,0,0,2,1,1,0,1,8,8.7
Tristan Thompson,25-351,F-C,2/27/17,CLE,MIL,1,34,2,4,0.5,2,4,0.5,0,0,,4,6,0.667,1,7,8,1,0,1,3,1,8,6
Matthew Dellavedova,26-088,G,12/5/16,MIL,SAS,1,32,3,8,0.375,2,5,0.4,1,3,0.333,1,1,1,0,0,0,2,0,0,1,2,8,3.2
Marcin Gortat,32-341,C-F,1/23/17,WAS,CHO,1,29,4,5,0.8,4,5,0.8,0,0,,0,0,,2,5,7,1,1,1,1,3,8,9.2
Lance Stephenson,26-051,G-F,10/26/16,NOP,DEN,0,26,4,7,0.571,4,7,0.571,0,0,,0,0,,1,2,3,3,1,0,2,2,8,6.3
Joe Johnson,35-125,G-F,11/1/16,UTA,SAS,1,34,3,8,0.375,1,3,0.333,2,5,0.4,0,0,,0,3,3,5,1,0,1,2,8,7.2
Tobias Harris,24-258,F,3/30/17,DET,BRK,0,25,2,9,0.222,1,6,0.167,1,3,0.333,3,4,0.75,2,4,6,3,1,1,2,2,8,5.7
Evan Turner,28-101,G,2/5/17,POR,OKC,1,26,4,11,0.364,4,10,0.4,0,1,0,0,0,,1,2,3,2,1,0,2,3,8,2.4
Kelly Olynyk,25-358,C-F,4/12/17,BOS,MIL,0,23,3,9,0.333,1,6,0.167,2,3,0.667,0,0,,0,4,4,6,0,0,1,5,8,5.3
Randy Foye,33-181,G,3/24/17,BRK,WAS,1,26,3,6,0.5,3,5,0.6,0,1,0,2,2,1,0,1,1,4,2,1,2,2,8,8
Anthony Morrow,31-057,G,11/23/16,OKC,SAC,0,19,2,8,0.25,1,6,0.167,1,2,0.5,3,3,1,0,0,0,0,0,0,0,1,8,2.8
Shaun Livingston,31-129,G,1/18/17,GSW,OKC,0,20,4,8,0.5,4,8,0.5,0,0,,0,0,,1,0,1,1,0,0,1,0,8,4.4
Nemanja Bjelica,28-198,F,11/23/16,MIN,NOP,0,20,2,6,0.333,1,2,0.5,1,4,0.25,3,4,0.75,1,5,6,2,2,0,2,3,8,6.6
Justin Anderson,23-113,G,3/12/17,PHI,LAL,0,21,3,6,0.5,1,3,0.333,2,3,0.667,0,0,,1,1,2,1,0,0,0,1,8,6.3
DeAndre Jordan,28-118,C,11/16/16,LAC,MEM,1,35,4,5,0.8,4,5,0.8,0,0,,0,2,0,4,10,14,1,1,2,1,3,8,12
Michael Kidd-Gilchrist,23-166,F,3/11/17,CHO,NOP,1,36,3,5,0.6,3,5,0.6,0,0,,2,2,1,1,5,6,4,1,0,0,1,8,11.3
Ricky Rubio,26-059,G,12/19/16,MIN,PHO,1,37,1,5,0.2,1,3,0.333,0,2,0,6,6,1,0,3,3,12,2,0,3,2,8,12.4
Danny Green,29-140,G-F,11/9/16,SAS,HOU,1,26,3,9,0.333,1,1,1,2,8,0.25,0,0,,0,3,3,2,4,1,1,2,8,8.1
Patty Mills,28-104,G,11/23/16,SAS,CHO,0,19,2,4,0.5,1,1,1,1,3,0.333,3,3,1,1,1,2,4,1,0,1,3,8,8.6
Jerian Grant,24-126,G,2/12/17,CHI,MIN,1,20,3,5,0.6,1,2,0.5,2,3,0.667,0,0,,0,1,1,3,0,1,0,2,8,8
Shabazz Napier,25-169,G,12/30/16,POR,SAS,0,16,4,10,0.4,4,5,0.8,0,5,0,0,0,,0,0,0,2,1,1,2,0,8,3.7
Wesley Matthews,30-124,G,2/15/17,DAL,DET,1,37,4,13,0.308,4,6,0.667,0,7,0,0,0,,0,2,2,3,2,0,0,1,8,4.8
DeMarre Carroll,30-144,F,12/18/16,TOR,ORL,1,21,3,4,0.75,3,3,1,0,1,0,2,5,0.4,0,3,3,0,0,0,0,2,8,5.3
Otto Porter,23-162,F,11/12/16,WAS,CHI,1,29,3,12,0.25,2,9,0.222,1,3,0.333,1,3,0.333,1,3,4,1,0,2,2,5,8,-0.3
Terrence Ross,26-039,F-G,3/16/17,ORL,GSW,1,25,3,6,0.5,2,4,0.5,1,2,0.5,1,2,0.5,0,1,1,0,0,1,1,3,8,3.4
Tyus Jones,20-186,G,11/12/16,MIN,LAC,0,8,2,3,0.667,0,0,,2,3,0.667,2,2,1,0,2,2,1,0,0,0,4,8,6.4
Darren Collison,29-120,G,12/21/16,SAC,UTA,1,22,4,9,0.444,4,8,0.5,0,1,0,0,0,,0,1,1,1,0,0,1,1,8,2.9
Dewayne Dedmon,27-209,C,3/9/17,SAS,OKC,1,19,3,6,0.5,3,6,0.5,0,0,,2,2,1,3,5,8,1,0,0,2,2,8,6.5
Luke Babbitt,27-229,F,2/4/17,MIA,PHI,1,25,2,5,0.4,0,1,0,2,4,0.5,2,2,1,0,1,1,1,0,0,1,4,8,3.7
Jerami Grant,22-323,F,1/29/17,OKC,CLE,0,25,3,8,0.375,1,3,0.333,2,5,0.4,0,0,,1,3,4,1,1,1,0,4,8,6
Clint Capela,22-317,F-C,3/31/17,HOU,GSW,1,26,4,13,0.308,4,13,0.308,0,0,,0,2,0,7,6,13,4,1,0,3,1,8,6.8
Matthew Dellavedova,26-183,G,3/10/17,MIL,IND,1,24,2,7,0.286,1,5,0.2,1,2,0.5,3,3,1,0,0,0,3,0,0,3,1,8,2.6
Timofey Mozgov,30-119,C,11/12/16,LAL,NOP,1,21,4,4,1,4,4,1,0,0,,0,0,,1,4,5,1,0,1,3,2,8,6.3
Derrick Favors,25-271,F-C,4/12/17,UTA,SAS,0,21,4,8,0.5,4,8,0.5,0,0,,0,0,,0,5,5,3,3,0,4,0,8,6.6
Matt Barnes,36-287,F,12/21/16,SAC,UTA,1,27,3,7,0.429,1,4,0.25,2,3,0.667,0,1,0,2,1,3,1,1,0,0,2,8,6.5
Bobby Portis,22-028,F,3/10/17,CHI,HOU,1,20,3,9,0.333,3,7,0.429,0,2,0,2,2,1,0,6,6,0,1,0,2,3,8,2.5
Andrew Wiggins,21-315,F-G,1/3/17,MIN,PHI,1,37,2,15,0.133,2,12,0.167,0,3,0,4,4,1,0,4,4,3,1,0,4,2,8,-2.2
Andre Roberson,25-050,G-F,1/23/17,OKC,UTA,1,31,4,6,0.667,4,4,1,0,2,0,0,0,,1,10,11,2,0,0,0,3,8,9.3
Brandon Bass,31-193,F,11/9/16,LAC,POR,0,9,2,3,0.667,2,3,0.667,0,0,,4,4,1,1,1,2,0,0,0,0,2,8,6.9
Buddy Hield,22-317,G,10/29/16,NOP,SAS,0,18,3,10,0.3,3,7,0.429,0,3,0,2,2,1,1,4,5,0,2,0,1,1,8,4.7
Luis Scola,36-237,F,12/23/16,BRK,CLE,0,15,3,5,0.6,2,4,0.5,1,1,1,1,1,1,2,3,5,1,0,0,0,1,8,8.3
Jameer Nelson,35-030,G,3/11/17,DEN,SAC,1,33,3,8,0.375,2,5,0.4,1,3,0.333,1,2,0.5,0,2,2,4,0,1,1,1,8,5.9
Zach Randolph,35-242,F,3/15/17,MEM,CHI,0,25,4,14,0.286,4,14,0.286,0,0,,0,0,,4,5,9,3,0,0,0,1,8,5.8
John Henson,26-019,C-F,1/16/17,MIL,PHI,1,26,3,8,0.375,3,8,0.375,0,0,,2,2,1,2,3,5,4,0,1,0,3,8,8.2
Marcus Thornton,29-208,G,12/30/16,WAS,BRK,0,21,3,6,0.5,1,4,0.25,2,2,1,0,0,,1,2,3,5,1,1,2,3,8,8.3
Sasha Vujacic,32-307,G,1/9/17,NYK,NOP,0,10,2,5,0.4,1,3,0.333,1,2,0.5,3,3,1,0,0,0,1,1,0,1,0,8,6
Shabazz Muhammad,23-354,F-G,11/1/16,MIN,MEM,0,19,2,6,0.333,2,6,0.333,0,0,,4,4,1,2,2,4,1,0,0,0,0,8,7.3
Isaiah Whitehead,22-008,G,3/16/17,BRK,NYK,0,21,4,6,0.667,4,4,1,0,2,0,0,0,,1,0,1,1,0,0,2,1,8,4.4
Tyson Chandler,34-104,C,1/14/17,PHO,SAS,1,31,4,7,0.571,4,7,0.571,0,0,,0,0,,8,7,15,1,1,0,2,3,8,10.9
Dante Cunningham,29-339,F,3/27/17,NOP,UTA,1,39,2,6,0.333,0,2,0,2,4,0.5,2,2,1,0,4,4,0,0,0,0,4,8,4.2
Justin Hamilton,26-266,C,12/23/16,BRK,CLE,1,19,3,8,0.375,3,5,0.6,0,3,0,2,2,1,1,5,6,0,0,1,2,2,8,3.7
Evan Fournier,24-076,G-F,1/13/17,ORL,POR,1,30,3,10,0.3,2,7,0.286,1,3,0.333,1,2,0.5,1,0,1,4,2,0,1,1,8,5.9
Serge Ibaka,27-080,F-C,12/7/16,ORL,BOS,1,25,3,10,0.3,1,6,0.167,2,4,0.5,0,0,,3,5,8,0,1,1,1,3,8,5.3
Jason Terry,39-165,G,2/27/17,MIL,CLE,0,22,3,5,0.6,1,2,0.5,2,3,0.667,0,0,,0,2,2,0,0,0,0,2,8,5.5
Joe Johnson,35-287,G-F,4/12/17,UTA,SAS,0,17,3,6,0.5,2,3,0.667,1,3,0.333,1,2,0.5,0,0,0,3,0,0,0,0,8,6.7
Rondae Hollis-Jefferson,21-322,F,11/20/16,BRK,POR,1,25,4,11,0.364,4,9,0.444,0,2,0,0,0,,1,2,3,4,1,1,1,4,8,5.1
Clint Capela,22-212,F-C,12/16/16,HOU,NOP,1,22,4,6,0.667,4,6,0.667,0,0,,0,2,0,2,9,11,0,0,2,2,6,8,5.7
Tim Hardaway,24-360,G,3/11/17,ATL,MEM,0,21,3,5,0.6,1,2,0.5,2,3,0.667,0,0,,1,2,3,1,1,0,0,1,8,8.3
Elfrid Payton,22-291,G,12/9/16,ORL,CHO,0,23,4,13,0.308,4,10,0.4,0,3,0,0,0,,2,2,4,6,0,1,3,1,8,4
Tyson Chandler,34-136,C,2/15/17,PHO,LAL,1,21,3,5,0.6,3,5,0.6,0,0,,2,2,1,1,7,8,0,2,1,0,1,8,10.8
Nick Young,31-225,G-F,1/12/17,LAL,SAS,1,14,3,6,0.5,1,2,0.5,2,4,0.5,0,0,,0,0,0,1,0,0,0,2,8,4.9
Devin Harris,33-363,G,2/24/17,DAL,MIN,0,17,3,5,0.6,1,2,0.5,2,3,0.667,0,0,,0,0,0,3,0,0,1,1,8,6.4
Trey Lyles,21-098,F,2/11/17,UTA,BOS,0,22,3,11,0.273,2,6,0.333,1,5,0.2,1,1,1,3,3,6,1,0,0,1,3,8,3
Lucas Nogueira,24-195,C,2/6/17,TOR,LAC,0,26,3,6,0.5,3,6,0.5,0,0,,2,2,1,1,5,6,2,3,0,1,4,8,9
Manu Ginobili,39-091,G,10/27/16,SAS,SAC,0,19,3,9,0.333,1,3,0.333,2,6,0.333,0,0,,0,3,3,5,0,1,1,2,8,6.2
Dion Waiters,25-029,G,1/8/17,MIA,LAC,0,15,2,7,0.286,1,5,0.2,1,2,0.5,3,4,0.75,0,2,2,0,0,0,1,2,8,2.3
Jrue Holiday,26-304,G,4/12/17,NOP,POR,1,16,4,11,0.364,4,9,0.444,0,2,0,0,0,,1,2,3,5,0,0,1,0,8,5.7
Jeff Teague,28-278,G,3/15/17,IND,CHO,1,30,3,8,0.375,1,3,0.333,2,5,0.4,0,0,,0,8,8,11,0,0,4,0,8,9.7
Will Barton,26-061,G,3/8/17,DEN,WAS,0,26,3,9,0.333,2,5,0.4,1,4,0.25,1,3,0.333,1,1,2,5,1,0,1,0,8,6.6
Malcolm Brogdon,23-320,G,10/26/16,MIL,CHO,0,21,3,9,0.333,3,6,0.5,0,3,0,2,2,1,0,6,6,5,0,0,0,2,8,7.4
Larry Nance Jr.,23-333,F,11/29/16,LAL,NOP,0,20,4,7,0.571,4,6,0.667,0,1,0,0,0,,1,4,5,3,1,1,0,3,8,9.2
Marco Belinelli,30-251,G-F,12/1/16,CHO,DAL,0,20,3,5,0.6,3,4,0.75,0,1,0,2,2,1,0,1,1,2,1,0,0,0,8,8.4
James Ennis,26-201,F,1/18/17,MEM,WAS,0,28,3,10,0.3,3,6,0.5,0,4,0,2,2,1,4,2,6,1,2,0,1,3,8,6.1
C.J. Miles,29-313,G-F,2/25/17,IND,MIA,1,27,3,4,0.75,1,1,1,2,3,0.667,0,0,,0,5,5,0,0,0,0,1,8,7.5
Bojan Bogdanovic,27-259,G-F,1/2/17,BRK,UTA,1,25,4,7,0.571,4,6,0.667,0,1,0,0,0,,0,3,3,1,0,0,0,2,8,5.5
Sheldon McClellan,24-018,G,1/8/17,WAS,MIL,0,12,3,5,0.6,2,3,0.667,1,2,0.5,1,1,1,0,3,3,0,2,0,0,0,8,8.6
Buddy Hield,23-072,G,2/27/17,SAC,MIN,0,27,3,8,0.375,2,3,0.667,1,5,0.2,1,2,0.5,0,5,5,0,1,0,4,1,8,1.3
Patty Mills,28-090,G,11/9/16,SAS,HOU,1,34,3,8,0.375,3,4,0.75,0,4,0,2,2,1,2,1,3,10,0,0,0,1,8,11.9
Kenneth Faried,27-129,F,3/28/17,DEN,POR,0,18,4,8,0.5,4,8,0.5,0,0,,0,0,,6,8,14,0,1,1,1,3,8,10.1
Bobby Portis,22-026,F,3/8/17,CHI,ORL,1,19,4,6,0.667,4,5,0.8,0,1,0,0,0,,0,3,3,0,0,0,1,2,8,4.5
Donatas Motiejunas,26-203,F-C,4/11/17,NOP,LAL,0,24,2,7,0.286,2,6,0.333,0,1,0,4,4,1,1,3,4,3,0,1,2,1,8,5.9
Jeff Green,30-179,F,2/23/17,ORL,POR,0,18,1,3,0.333,1,1,1,0,2,0,6,8,0.75,0,4,4,4,1,0,0,1,8,10.1
Nemanja Bjelica,28-192,F,11/17/16,MIN,PHI,0,15,3,7,0.429,2,3,0.667,1,4,0.25,1,1,1,1,3,4,1,1,0,0,1,8,7.2
Nerlens Noel,22-245,C-F,12/11/16,PHI,DET,0,10,3,5,0.6,3,5,0.6,0,0,,2,2,1,0,0,0,0,1,0,0,1,8,6.3
Andre Drummond,23-100,C,11/18/16,DET,CLE,1,27,4,12,0.333,4,12,0.333,0,0,,0,0,,3,7,10,2,1,1,2,0,8,6.5
DeAndre Liggins,28-314,G,2/8/17,CLE,IND,1,16,3,4,0.75,2,2,1,1,2,0.5,1,1,1,0,0,0,1,3,0,0,0,8,10.1
Kelly Oubre,20-344,F,11/17/16,WAS,NYK,0,23,3,6,0.5,1,2,0.5,2,4,0.5,0,0,,0,3,3,1,0,0,1,2,8,4.8
Thabo Sefolosha,32-264,G-F,1/21/17,ATL,PHI,1,32,3,6,0.5,3,6,0.5,0,0,,2,3,0.667,1,3,4,1,1,0,0,2,8,7.1
Meyers Leonard,24-277,C-F,11/30/16,POR,IND,0,23,3,9,0.333,1,2,0.5,2,7,0.286,0,0,,1,2,3,0,0,0,0,2,8,3.4
Sean Kilpatrick,26-362,G,1/2/17,BRK,UTA,1,28,2,7,0.286,1,4,0.25,1,3,0.333,3,3,1,0,4,4,1,0,0,2,2,8,3
Taj Gibson,31-164,F,12/5/16,CHI,POR,1,27,4,6,0.667,4,6,0.667,0,0,,0,1,0,1,5,6,1,0,2,2,2,8,6.5
Amir Johnson,29-199,F,11/16/16,BOS,DAL,1,29,3,4,0.75,3,4,0.75,0,0,,2,2,1,3,3,6,4,2,0,1,2,8,12.4
Joakim Noah,31-314,C,1/4/17,NYK,MIL,1,31,4,7,0.571,4,7,0.571,0,0,,0,2,0,7,9,16,2,0,1,0,5,8,11.6
Justin Anderson,23-123,G,3/22/17,PHI,OKC,0,19,3,9,0.333,3,7,0.429,0,2,0,2,2,1,2,2,4,2,0,0,1,2,8,4.5
Kris Dunn,22-266,G,12/9/16,MIN,DET,0,20,4,10,0.4,4,6,0.667,0,4,0,0,0,,1,4,5,0,1,0,0,2,8,4.7
Luol Deng,31-213,F,11/15/16,LAL,BRK,1,21,2,6,0.333,2,5,0.4,0,1,0,4,6,0.667,3,2,5,0,0,0,0,1,8,6.1
Al Jefferson,31-348,C-F,12/17/16,IND,DET,0,17,3,10,0.3,3,10,0.3,0,0,,2,4,0.5,2,7,9,1,1,0,0,2,8,5.8
Michael Beasley,28-025,F,2/3/17,MIL,DEN,0,14,3,7,0.429,3,6,0.5,0,1,0,2,4,0.5,1,2,3,0,0,1,1,2,8,3.7
Tristan Thompson,25-287,F-C,12/25/16,CLE,GSW,1,28,2,5,0.4,2,5,0.4,0,0,,4,6,0.667,6,2,8,0,1,0,0,2,8,9.5
Solomon Hill,26-024,F,4/11/17,NOP,LAL,1,27,3,8,0.375,2,5,0.4,1,3,0.333,1,2,0.5,0,5,5,0,1,0,1,3,8,3.5
Robin Lopez,28-269,C,12/26/16,CHI,IND,1,32,4,8,0.5,4,8,0.5,0,0,,0,1,0,5,7,12,0,2,1,3,3,8,7.7
Taurean Waller-Prince,23-020,F,4/11/17,ATL,CHO,1,23,4,7,0.571,4,5,0.8,0,2,0,0,1,0,0,1,1,1,1,0,0,1,8,5.9
Avery Bradley,26-120,G,3/26/17,BOS,MIA,1,31,4,11,0.364,4,7,0.571,0,4,0,0,0,,0,1,1,2,0,0,2,1,8,1.2
Hassan Whiteside,27-179,C,12/9/16,MIA,CLE,1,28,4,10,0.4,4,10,0.4,0,0,,0,0,,6,6,12,0,0,0,4,3,8,3.4
Thomas Robinson,25-299,F,1/10/17,LAL,POR,0,16,4,6,0.667,4,6,0.667,0,0,,0,0,,1,1,2,2,0,1,1,2,8,6.7
Jon Leuer,27-181,F,11/11/16,DET,SAS,0,28,3,8,0.375,3,3,1,0,5,0,2,2,1,0,3,3,0,0,1,1,1,8,3.8
Kelly Oubre,21-124,F,4/12/17,WAS,MIA,1,28,4,12,0.333,4,10,0.4,0,2,0,0,0,,1,2,3,1,3,0,0,1,8,5.8
Luke Babbitt,27-183,F,12/20/16,MIA,ORL,0,15,2,4,0.5,0,1,0,2,3,0.667,2,2,1,0,2,2,0,0,1,0,1,8,6.9
Brandan Wright,29-155,F-C,3/9/17,MEM,LAC,1,15,4,6,0.667,4,6,0.667,0,0,,0,1,0,0,2,2,2,2,0,0,2,8,8.2
Ty Lawson,29-112,G,2/23/17,SAC,DEN,1,31,4,10,0.4,4,9,0.444,0,1,0,0,0,,3,1,4,6,2,0,2,3,8,8
Cody Zeller,24-174,F-C,3/28/17,CHO,MIL,1,29,3,3,1,3,3,1,0,0,,2,2,1,0,1,1,0,2,1,1,0,8,9.1
Noah Vonleh,21-214,F,3/26/17,POR,LAL,1,26,4,8,0.5,4,8,0.5,0,0,,0,0,,2,12,14,0,0,0,1,0,8,8
Jonas Valanciunas,24-237,C,12/29/16,TOR,PHO,1,19,2,4,0.5,2,4,0.5,0,0,,4,4,1,3,7,10,0,1,0,3,3,8,7
Sean Kilpatrick,27-065,G,3/12/17,BRK,NYK,0,25,1,9,0.111,1,3,0.333,0,6,0,6,6,1,0,8,8,2,0,0,0,2,8,5.1
Nicolas Batum,28-094,F-G,3/18/17,CHO,WAS,1,27,4,9,0.444,4,6,0.667,0,3,0,0,0,,1,9,10,5,0,0,3,2,8,6.4
Nikola Jokic,21-277,C-F,11/22/16,DEN,CHI,0,18,3,5,0.6,3,5,0.6,0,0,,2,2,1,3,5,8,3,1,1,0,1,8,12.7
Serge Ibaka,27-054,F-C,11/11/16,ORL,UTA,1,31,3,12,0.25,1,8,0.125,2,4,0.5,0,0,,2,6,8,0,0,1,4,1,8,0.3
Kevin Love,28-204,F,3/30/17,CLE,CHI,1,21,3,10,0.3,3,9,0.333,0,1,0,2,2,1,3,7,10,4,0,2,1,6,8,7.2
Kent Bazemore,27-284,G-F,4/11/17,ATL,CHO,0,18,3,6,0.5,1,2,0.5,2,4,0.5,0,0,,0,3,3,3,0,1,2,1,8,6.3
Meyers Leonard,24-324,C-F,1/16/17,POR,WAS,0,22,4,7,0.571,4,6,0.667,0,1,0,0,0,,2,2,4,1,0,0,0,1,8,7
Willie Cauley-Stein,23-202,F-C,3/8/17,SAC,SAS,0,27,4,7,0.571,4,7,0.571,0,0,,0,0,,1,2,3,1,0,1,0,5,8,5.4
Gordon Hayward,26-239,F-G,11/17/16,UTA,CHI,1,41,3,15,0.2,3,12,0.25,0,3,0,2,3,0.667,1,11,12,3,2,0,2,2,8,3.6
Sam Dekker,22-293,F,2/23/17,HOU,NOP,0,20,3,5,0.6,1,2,0.5,2,3,0.667,0,0,,1,3,4,1,0,0,0,2,8,7.2
Cody Zeller,24-068,F-C,12/12/16,CHO,IND,1,31,4,9,0.444,4,9,0.444,0,0,,0,0,,1,6,7,1,0,2,1,3,8,5.7
Manu Ginobili,39-104,G,11/9/16,SAS,HOU,0,21,1,7,0.143,1,5,0.2,0,2,0,6,6,1,0,1,1,3,2,0,1,2,8,6.1
David Lee,33-245,F,12/30/16,SAS,POR,0,16,4,4,1,4,4,1,0,0,,0,0,,2,2,4,1,1,0,3,0,8,7.5
Hassan Whiteside,27-242,C,2/10/17,MIA,BRK,1,25,3,10,0.3,3,10,0.3,0,0,,2,2,1,3,6,9,0,1,4,1,4,8,7.3
James Ennis,26-187,F,1/4/17,MEM,LAC,1,32,3,7,0.429,3,7,0.429,0,0,,2,2,1,2,4,6,2,3,1,0,4,8,10.4
Elfrid Payton,22-355,G,2/11/17,ORL,DAL,0,20,4,9,0.444,4,7,0.571,0,2,0,0,0,,0,2,2,0,0,0,2,4,8,0.3
Lavoy Allen,28-046,F-C,3/22/17,IND,BOS,0,22,4,6,0.667,4,6,0.667,0,0,,0,0,,9,5,14,2,0,0,0,2,8,13.8
Malcolm Delaney,27-277,G,12/13/16,ATL,ORL,0,14,2,4,0.5,2,3,0.667,0,1,0,4,4,1,0,1,1,3,0,0,2,2,8,5.6
Kyle Anderson,23-052,F-G,11/11/16,SAS,DET,1,24,3,6,0.5,2,4,0.5,1,2,0.5,1,2,0.5,3,3,6,3,0,0,0,0,8,9.7
P.J. Tucker,31-339,F,4/9/17,TOR,NYK,0,27,2,5,0.4,0,0,,2,5,0.4,2,2,1,0,7,7,1,1,0,0,3,8,7.9
Steven Adams,23-156,C,12/23/16,OKC,BOS,1,29,4,6,0.667,4,6,0.667,0,0,,0,2,0,3,8,11,3,2,1,1,0,8,12.9
Jamal Crawford,36-307,G,1/21/17,LAC,DEN,0,25,3,13,0.231,3,9,0.333,0,4,0,2,2,1,0,2,2,7,1,0,2,1,8,4.2
Emmanuel Mudiay,20-253,G,11/13/16,DEN,POR,1,30,3,16,0.188,2,10,0.2,1,6,0.167,1,2,0.5,0,2,2,0,0,0,2,2,8,-4.6
Spencer Hawes,28-215,C-F,11/29/16,CHO,DET,0,17,3,5,0.6,1,3,0.333,2,2,1,0,0,,0,2,2,0,1,0,3,1,8,3.9
Kyle Anderson,23-093,F-G,12/22/16,SAS,LAC,0,13,4,5,0.8,4,5,0.8,0,0,,0,0,,1,6,7,1,5,1,1,2,8,13.2
Andre Roberson,25-040,G-F,1/13/17,OKC,MIN,1,32,3,6,0.5,3,6,0.5,0,0,,2,2,1,0,2,2,1,5,2,0,3,8,11.5
Hollis Thompson,25-216,G-F,11/5/16,PHI,CLE,0,20,3,6,0.5,1,1,1,2,5,0.4,0,0,,0,2,2,1,0,0,1,3,8,4.1
David Lee,33-336,F,3/31/17,SAS,OKC,0,21,4,7,0.571,4,7,0.571,0,0,,0,0,,5,3,8,3,2,0,3,2,8,9.4
Terrence Ross,26-036,F-G,3/13/17,ORL,SAC,1,29,3,7,0.429,1,2,0.5,2,5,0.4,0,0,,0,2,2,4,0,0,0,1,8,7.3
Dwyane Wade,34-349,G,12/31/16,CHI,MIL,1,25,3,13,0.231,2,9,0.222,1,4,0.25,1,2,0.5,1,4,5,5,1,1,3,2,8,3
Andre Roberson,25-038,G-F,1/11/17,OKC,MEM,1,31,3,5,0.6,2,2,1,1,3,0.333,1,2,0.5,1,7,8,0,0,1,1,1,8,7.4
Gary Harris,22-113,G,1/5/17,DEN,SAS,1,26,3,11,0.273,2,7,0.286,1,4,0.25,1,2,0.5,1,0,1,5,1,0,1,1,8,4.9
Nicolas Brussino,23-326,G-F,1/22/17,DAL,LAL,0,12,3,4,0.75,1,1,1,2,3,0.667,0,0,,0,2,2,0,0,0,0,0,8,7
Marquese Chriss,19-168,F,12/17/16,PHO,OKC,1,24,3,11,0.273,2,9,0.222,1,2,0.5,1,2,0.5,3,5,8,1,0,1,3,2,8,2.3
David West,36-224,F,4/10/17,GSW,UTA,0,17,4,9,0.444,4,9,0.444,0,0,,0,0,,1,2,3,2,0,0,2,1,8,3.6
Jaylen Brown,20-128,F,3/1/17,BOS,CLE,0,23,3,7,0.429,2,3,0.667,1,4,0.25,1,1,1,1,5,6,0,0,1,3,2,8,3.4
Myles Turner,20-349,F-C,3/8/17,IND,DET,1,25,3,6,0.5,3,6,0.5,0,0,,2,2,1,0,5,5,5,1,2,0,2,8,11.6
Gorgui Dieng,26-292,C,11/5/16,MIN,OKC,1,27,4,8,0.5,4,8,0.5,0,0,,0,0,,2,6,8,0,0,4,3,4,8,5.4
Dante Cunningham,29-199,F,11/7/16,NOP,GSW,0,26,3,5,0.6,1,2,0.5,2,3,0.667,0,0,,1,0,1,1,0,1,1,3,8,5.6
Eric Gordon,28-075,G,3/10/17,HOU,CHI,0,23,3,14,0.214,1,4,0.25,2,10,0.2,0,0,,0,1,1,2,1,1,0,2,8,2
Jamal Murray,20-036,G,3/31/17,DEN,CHO,0,29,3,9,0.333,1,2,0.5,2,7,0.286,0,0,,0,4,4,3,1,0,1,1,8,5.8
Marreese Speights,29-224,C-F,3/16/17,LAC,DEN,1,15,3,6,0.5,1,2,0.5,2,4,0.5,0,0,,1,5,6,1,0,0,1,4,8,5.3
Ramon Sessions,30-228,G,11/25/16,CHO,NYK,0,25,4,9,0.444,4,7,0.571,0,2,0,0,1,0,0,3,3,3,1,0,0,2,8,6.1
Al-Farouq Aminu,26-185,F,3/25/17,POR,MIN,0,27,4,5,0.8,4,5,0.8,0,0,,0,2,0,0,6,6,0,2,0,1,2,8,7.3
Alex Len,23-293,C,4/5/17,PHO,GSW,1,12,3,6,0.5,3,6,0.5,0,0,,2,3,0.667,2,2,4,0,0,0,1,3,8,4.4
Richaun Holmes,23-160,F-C,3/24/17,PHI,CHI,1,29,4,10,0.4,4,8,0.5,0,2,0,0,0,,1,2,3,0,0,1,1,4,8,2
Jon Leuer,27-259,F,1/28/17,DET,MIA,1,24,4,5,0.8,4,4,1,0,1,0,0,1,0,1,0,1,1,0,0,0,3,8,5.9
Ricky Rubio,26-086,G,1/15/17,MIN,DAL,1,36,2,9,0.222,2,7,0.286,0,2,0,4,6,0.667,1,4,5,10,2,0,4,2,8,7.8
Alec Burks,25-178,G,1/14/17,UTA,ORL,0,15,3,5,0.6,2,4,0.5,1,1,1,1,3,0.333,2,4,6,1,1,0,1,1,8,7.8
Jared Dudley,31-152,F-G,12/9/16,PHO,LAL,0,30,3,8,0.375,1,4,0.25,2,4,0.5,0,0,,0,3,3,2,0,0,1,5,8,2.9
Trey Burke,24-034,G,12/16/16,WAS,DET,0,15,2,4,0.5,1,2,0.5,1,2,0.5,3,4,0.75,0,0,0,2,1,0,2,4,8,4.4
Tony Parker,34-205,G,12/8/16,SAS,CHI,1,24,4,10,0.4,4,9,0.444,0,1,0,0,0,,0,1,1,5,0,0,3,2,8,2.6
David West,36-194,F,3/11/17,GSW,SAS,0,15,3,8,0.375,3,8,0.375,0,0,,2,2,1,1,2,3,3,2,1,1,1,8,8.3
Robin Lopez,28-259,C,12/16/16,CHI,MIL,1,28,3,10,0.3,3,10,0.3,0,0,,2,2,1,6,1,7,1,0,1,3,0,8,5.1
Shabazz Muhammad,24-036,F-G,12/19/16,MIN,PHO,0,21,3,8,0.375,3,7,0.429,0,1,0,2,2,1,1,1,2,2,0,0,1,2,8,4.2
Taj Gibson,31-197,F,1/7/17,CHI,TOR,1,20,3,7,0.429,3,7,0.429,0,0,,2,2,1,2,4,6,1,0,0,1,4,8,5
Manu Ginobili,39-096,G,11/1/16,SAS,UTA,0,23,1,5,0.2,0,2,0,1,3,0.333,5,5,1,0,1,1,3,1,0,3,0,8,5.3
Jusuf Nurkic,22-104,C,12/5/16,DEN,PHI,1,24,4,8,0.5,4,8,0.5,0,0,,0,2,0,6,4,10,1,2,3,2,4,8,9.8
James Ennis,26-191,F,1/8/17,MEM,UTA,0,27,2,3,0.667,1,1,1,1,2,0.5,3,3,1,0,5,5,1,1,0,1,2,8,8.1
Draymond Green,26-334,F,2/1/17,GSW,CHO,1,31,3,10,0.3,1,3,0.333,2,7,0.286,0,0,,0,10,10,5,1,4,1,1,8,11.1
Matt Barnes,36-317,F,1/20/17,SAC,MEM,0,18,3,9,0.333,2,5,0.4,1,4,0.25,1,1,1,0,1,1,2,0,0,0,2,8,3.8
Isaiah Whitehead,21-281,G,12/14/16,BRK,LAL,1,24,3,4,0.75,3,4,0.75,0,0,,2,2,1,1,1,2,2,1,0,1,6,8,6.4
Timofey Mozgov,30-104,C,10/28/16,LAL,UTA,1,23,1,4,0.25,1,4,0.25,0,0,,6,7,0.857,1,5,6,1,1,2,1,5,8,7.5
Glenn Robinson,22-309,G-F,11/12/16,IND,BOS,0,26,4,11,0.364,4,7,0.571,0,4,0,0,0,,1,5,6,2,0,2,0,0,8,6.9
Ricky Rubio,26-051,G,12/11/16,MIN,GSW,1,32,3,10,0.3,3,5,0.6,0,5,0,2,2,1,3,2,5,6,1,0,3,3,8,5.9
Malcolm Delaney,27-315,G,1/20/17,ATL,CHI,0,18,2,5,0.4,1,3,0.333,1,2,0.5,3,4,0.75,1,1,2,1,2,0,2,1,8,6.2
Jeff Withey,26-359,C,3/1/17,UTA,MIN,0,10,4,6,0.667,4,6,0.667,0,0,,0,0,,2,1,3,2,0,1,0,3,8,8
Julius Randle,22-021,F,12/20/16,LAL,CHO,1,31,4,12,0.333,4,12,0.333,0,0,,0,0,,1,5,6,4,0,5,3,5,8,4.7
Michael Carter-Williams,25-127,G,2/14/17,CHI,TOR,1,29,2,2,1,2,2,1,0,0,,4,6,0.667,0,5,5,3,1,1,1,5,8,8.9
Matthew Dellavedova,26-201,G,3/28/17,MIL,CHO,0,19,3,5,0.6,1,1,1,2,4,0.5,0,0,,0,2,2,3,0,0,4,4,8,2.8
David Lee,33-229,F,12/14/16,SAS,BOS,1,30,3,5,0.6,3,5,0.6,0,0,,2,3,0.667,2,8,10,3,1,0,1,3,8,10
C.J. McCollum,25-176,G,3/14/17,POR,NOP,1,30,4,12,0.333,4,9,0.444,0,3,0,0,0,,0,3,3,2,0,0,0,2,8,2.7
Matthew Dellavedova,26-109,G,12/26/16,MIL,WAS,1,30,1,9,0.111,1,4,0.25,0,5,0,6,8,0.75,1,2,3,11,2,0,1,4,8,9.7
Luke Babbitt,27-128,F,10/26/16,MIA,ORL,1,19,3,10,0.3,1,4,0.25,2,6,0.333,0,0,,0,1,1,2,0,0,0,1,8,3.5
Taj Gibson,31-222,F,2/1/17,CHI,OKC,1,22,3,5,0.6,2,4,0.5,1,1,1,1,1,1,0,8,8,0,0,1,1,1,8,7.4
Nemanja Bjelica,28-258,F,1/22/17,MIN,DEN,0,19,3,5,0.6,3,4,0.75,0,1,0,2,2,1,2,2,4,1,0,0,1,4,8,5.8
Pascal Siakam,22-274,F,11/4/16,TOR,MIA,1,16,4,6,0.667,4,6,0.667,0,0,,0,0,,1,2,3,0,0,0,1,0,8,5.7
Kent Bazemore,27-150,G-F,11/28/16,ATL,GSW,1,28,4,15,0.267,4,9,0.444,0,6,0,0,0,,2,5,7,1,2,1,2,5,8,1.4
Randy Foye,33-158,G,3/1/17,BRK,SAC,1,14,2,2,1,0,0,,2,2,1,2,2,1,0,1,1,1,0,0,0,3,8,7.2
Malcolm Delaney,27-232,G,10/29/16,ATL,PHI,0,20,3,6,0.5,2,5,0.4,1,1,1,1,2,0.5,0,2,2,4,1,0,0,1,8,8.6
Trevor Ariza,31-244,F,3/1/17,HOU,LAC,1,33,3,7,0.429,1,1,1,2,6,0.333,0,1,0,0,7,7,2,0,1,2,0,8,6.1
Juan Hernangomez,21-046,F,11/13/16,DEN,POR,0,16,2,3,0.667,1,1,1,1,2,0.5,3,4,0.75,1,5,6,1,0,0,0,2,8,8.4
Marreese Speights,29-088,C-F,10/31/16,LAC,PHO,0,13,2,6,0.333,2,3,0.667,0,3,0,4,4,1,2,3,5,0,1,0,2,4,8,4.3
Kyle Anderson,23-148,F-G,2/15/17,SAS,ORL,0,15,3,6,0.5,2,3,0.667,1,3,0.333,1,1,1,1,5,6,1,0,0,0,1,8,7.5
Luc Mbah a Moute,30-127,F,1/14/17,LAC,LAL,1,21,3,6,0.5,3,6,0.5,0,0,,2,2,1,2,2,4,1,0,0,0,4,8,6.1
Thaddeus Young,28-196,F,1/3/17,IND,DET,1,33,4,8,0.5,4,5,0.8,0,3,0,0,0,,1,4,5,4,2,0,1,1,8,9.3
Sergio Rodriguez,30-248,G,2/15/17,PHI,BOS,0,20,3,7,0.429,1,4,0.25,2,3,0.667,0,0,,0,3,3,5,0,0,2,1,8,6.3
Tyler Ennis,22-200,G,3/12/17,LAL,PHI,0,16,3,5,0.6,2,3,0.667,1,2,0.5,1,1,1,0,0,0,2,1,0,2,5,8,4.1
Bismack Biyombo,24-215,C-F,3/31/17,ORL,BOS,0,21,2,3,0.667,2,3,0.667,0,0,,4,4,1,1,7,8,2,0,0,0,4,8,9.3
Kent Bazemore,27-218,G-F,2/4/17,ATL,ORL,1,27,4,6,0.667,4,4,1,0,2,0,0,0,,1,2,3,3,2,0,2,1,8,8.4
Victor Oladipo,24-340,G,4/9/17,OKC,DEN,1,33,3,15,0.2,3,9,0.333,0,6,0,2,2,1,0,6,6,2,0,0,3,1,8,-1.5
Brian Roberts,31-072,G,2/13/17,CHO,PHI,0,10,2,3,0.667,0,1,0,2,2,1,2,2,1,0,0,0,2,0,0,2,0,8,6.1
Michael Kidd-Gilchrist,23-191,F,4/5/17,CHO,MIA,1,28,3,5,0.6,3,5,0.6,0,0,,2,2,1,0,5,5,1,1,2,1,3,8,8.1
Tony Allen,34-358,G-F,1/3/17,MEM,LAL,1,24,3,4,0.75,2,3,0.667,1,1,1,1,2,0.5,1,3,4,2,1,0,3,0,8,7
Trevor Booker,29-077,F,2/10/17,BRK,MIA,0,25,4,7,0.571,4,7,0.571,0,0,,0,0,,2,8,10,1,0,0,3,1,8,5.8
Spencer Hawes,28-188,C-F,11/2/16,CHO,PHI,0,15,3,3,1,3,3,1,0,0,,2,2,1,0,0,0,2,0,1,2,0,8,7.2
Corey Brewer,30-297,F-G,12/27/16,HOU,DAL,1,20,3,6,0.5,1,3,0.333,2,3,0.667,0,0,,0,3,3,1,1,0,1,1,8,6.2
Willie Cauley-Stein,23-178,F-C,2/12/17,SAC,NOP,0,18,3,6,0.5,3,6,0.5,0,0,,2,2,1,0,4,4,1,0,0,1,1,8,5.5
Trevor Ariza,31-260,F,3/17/17,HOU,NOP,1,30,3,9,0.333,1,2,0.5,2,7,0.286,0,0,,0,8,8,0,1,0,1,1,8,4.9
Aron Baynes,29-363,C,12/6/16,DET,CHI,0,23,3,6,0.5,3,6,0.5,0,0,,2,2,1,3,6,9,1,2,1,1,2,8,10.5
C.J. Miles,29-258,G-F,1/1/17,IND,ORL,0,16,4,8,0.5,4,4,1,0,4,0,0,0,,0,0,0,2,0,0,0,2,8,4.6
Willy Hernangomez,22-185,C,11/28/16,NYK,OKC,0,14,3,5,0.6,3,5,0.6,0,0,,2,2,1,1,1,2,3,2,0,0,2,8,10
Nik Stauskas,23-088,G,1/3/17,PHI,MIN,1,32,3,9,0.333,1,4,0.25,2,5,0.4,0,0,,0,3,3,2,0,0,1,1,8,3.8
Ty Lawson,29-068,G,1/10/17,SAC,DET,0,24,2,9,0.222,1,7,0.143,1,2,0.5,3,4,0.75,0,1,1,2,0,0,4,1,8,-0.6
Willy Hernangomez,22-312,C,4/4/17,NYK,CHI,1,21,4,11,0.364,4,11,0.364,0,0,,0,0,,4,5,9,3,0,0,1,4,8,5.7
Michael Beasley,27-352,F,12/26/16,MIL,WAS,0,18,4,11,0.364,4,10,0.4,0,1,0,0,0,,1,3,4,1,2,0,0,4,8,4.6
Pascal Siakam,22-285,F,11/15/16,TOR,CLE,1,16,4,5,0.8,4,5,0.8,0,0,,0,0,,2,1,3,2,0,3,1,5,8,8.3
Willy Hernangomez,22-183,C,11/26/16,NYK,CHO,0,17,4,5,0.8,4,5,0.8,0,0,,0,0,,3,5,8,1,0,1,3,4,8,6.5
DeMarre Carroll,30-237,F,3/21/17,TOR,CHI,1,17,2,5,0.4,0,1,0,2,4,0.5,2,2,1,0,1,1,3,1,1,0,3,8,8.2
Sam Dekker,22-329,F,3/31/17,HOU,GSW,0,19,3,6,0.5,1,3,0.333,2,3,0.667,0,0,,2,3,5,1,0,0,0,0,8,8
Nick Young,31-194,G-F,12/12/16,LAL,SAC,1,26,3,10,0.3,1,3,0.333,2,7,0.286,0,0,,0,2,2,1,1,0,2,1,8,2.1
Alexis Ajinca,28-224,C,12/16/16,NOP,HOU,1,22,2,7,0.286,2,7,0.286,0,0,,4,5,0.8,2,6,8,1,1,2,3,4,8,5.2
Nikola Jokic,21-308,C-F,12/23/16,DEN,ATL,1,19,3,4,0.75,2,3,0.667,1,1,1,1,2,0.5,1,6,7,6,0,3,5,6,8,7.4
Manu Ginobili,39-246,G,3/31/17,SAS,OKC,0,27,3,7,0.429,1,3,0.333,2,4,0.5,0,1,0,0,4,4,8,0,1,1,3,8,9.2
Dwyane Wade,35-054,G,3/12/17,CHI,BOS,1,26,4,11,0.364,4,9,0.444,0,2,0,0,0,,1,2,3,0,2,0,1,1,8,3.8
Nene Hilario,34-155,F-C,2/15/17,HOU,MIA,0,20,2,5,0.4,2,4,0.5,0,1,0,4,7,0.571,5,4,9,1,1,0,0,3,8,9.3
Ish Smith,28-244,G,3/6/17,DET,CHI,0,18,4,9,0.444,4,8,0.5,0,1,0,0,0,,1,1,2,7,1,0,0,1,8,9.8
Marvin Williams,30-199,F,1/4/17,CHO,OKC,1,27,3,9,0.333,2,6,0.333,1,3,0.333,1,1,1,2,6,8,1,0,3,1,1,8,7.5
Timofey Mozgov,30-183,C,1/15/17,LAL,DET,1,22,4,7,0.571,4,7,0.571,0,0,,0,0,,0,3,3,0,0,1,2,0,8,4.3
Channing Frye,33-253,C-F,1/25/17,CLE,SAC,0,19,3,6,0.5,1,1,1,2,5,0.4,0,0,,0,2,2,0,0,1,2,1,8,3.9
Jakob Poeltl,21-171,C,4/4/17,TOR,IND,0,12,3,3,1,3,3,1,0,0,,2,3,0.667,1,2,3,0,1,2,0,0,8,10.4
Luis Scola,36-179,F,10/26/16,BRK,BOS,0,22,3,8,0.375,2,3,0.667,1,5,0.2,1,2,0.5,0,1,1,3,0,0,2,3,8,2.4
Channing Frye,33-249,C-F,1/21/17,CLE,SAS,0,17,2,8,0.25,2,6,0.333,0,2,0,4,5,0.8,1,3,4,0,0,0,1,0,8,3.4
Al-Farouq Aminu,26-096,F,12/26/16,POR,TOR,1,33,3,7,0.429,1,3,0.333,2,4,0.5,0,0,,0,8,8,3,0,1,0,2,8,8.7
Dwight Howard,31-088,C,3/6/17,ATL,GSW,1,29,3,4,0.75,3,4,0.75,0,0,,2,6,0.333,5,14,19,0,0,1,5,5,8,6.2
Ron Baker,24-013,G,4/12/17,NYK,PHI,1,29,3,6,0.5,2,3,0.667,1,3,0.333,1,2,0.5,0,1,1,4,0,0,2,1,8,5.3
Alex Len,23-184,C,12/17/16,PHO,OKC,0,14,3,6,0.5,3,6,0.5,0,0,,2,3,0.667,5,2,7,0,1,1,1,4,8,7.8
DeAndre Jordan,28-129,C,11/27/16,LAC,IND,1,32,2,3,0.667,2,3,0.667,0,0,,4,7,0.571,2,12,14,0,1,3,1,3,8,11.4
Joe Ingles,29-132,F-G,2/11/17,UTA,BOS,1,30,3,10,0.3,3,5,0.6,0,5,0,2,2,1,0,3,3,3,3,0,1,4,8,5.6
Domantas Sabonis,20-308,F,3/7/17,OKC,POR,1,21,3,7,0.429,3,6,0.5,0,1,0,2,2,1,1,3,4,0,0,0,1,1,8,4.5
Ty Lawson,29-029,G,12/2/16,SAC,BOS,0,21,3,8,0.375,3,6,0.5,0,2,0,2,2,1,3,0,3,4,1,1,2,1,8,7.8
Gary Harris,22-134,G,1/26/17,DEN,PHO,1,28,2,9,0.222,0,5,0,2,4,0.5,2,2,1,1,0,1,1,1,2,3,1,8,2.9
Joakim Noah,31-316,C,1/6/17,NYK,MIL,1,20,4,6,0.667,4,6,0.667,0,0,,0,0,,5,4,9,1,0,0,4,6,8,4.4
David Lee,33-225,F,12/10/16,SAS,BRK,0,19,3,5,0.6,3,5,0.6,0,0,,2,2,1,2,6,8,2,0,0,0,1,8,9.9
Richard Jefferson,36-222,F,1/29/17,CLE,OKC,0,31,4,5,0.8,4,4,1,0,1,0,0,0,,0,4,4,0,1,0,0,3,8,7.1
Nik Stauskas,23-120,G,2/4/17,PHI,MIA,1,40,2,11,0.182,2,7,0.286,0,4,0,4,4,1,0,4,4,6,2,0,2,3,8,5.3
Tony Parker,34-285,G,2/26/17,SAS,LAL,1,20,4,5,0.8,4,5,0.8,0,0,,0,0,,0,3,3,9,0,0,0,0,8,13.3
Kent Bazemore,27-227,G-F,2/13/17,ATL,POR,1,37,2,7,0.286,2,5,0.4,0,2,0,4,7,0.571,1,5,6,6,1,3,3,5,8,7.2
Ian Clark,25-290,G,12/22/16,GSW,BRK,0,15,4,6,0.667,4,5,0.8,0,1,0,0,0,,0,0,0,1,1,0,0,1,8,6.7
Doug McDermott,24-340,F,12/8/16,CHI,SAS,0,26,2,6,0.333,1,2,0.5,1,4,0.25,3,3,1,1,3,4,3,0,0,3,1,8,4.9
Wade Baldwin,20-247,G,12/1/16,MEM,ORL,0,18,3,7,0.429,3,6,0.5,0,1,0,2,2,1,1,3,4,2,0,0,0,1,8,6.9
Willy Hernangomez,22-168,C,11/11/16,NYK,BOS,0,24,4,13,0.308,4,13,0.308,0,0,,0,0,,6,6,12,3,2,1,5,5,8,4.3
Chandler Parsons,28-106,F,2/8/17,MEM,PHO,1,24,3,7,0.429,1,4,0.25,2,3,0.667,0,2,0,0,3,3,7,0,2,2,2,8,7.9
Shawn Long,24-073,C-F,4/12/17,PHI,NYK,0,17,4,13,0.308,4,11,0.364,0,2,0,0,0,,8,1,9,0,1,0,1,5,8,4.4
Michael Kidd-Gilchrist,23-128,F,2/1/17,CHO,GSW,1,23,4,11,0.364,4,11,0.364,0,0,,0,0,,1,8,9,1,0,0,1,1,8,4.3
DeMarre Carroll,30-162,F,1/5/17,TOR,UTA,1,39,3,6,0.5,1,2,0.5,2,4,0.5,0,0,,1,3,4,0,2,0,0,3,8,7.4
Gorgui Dieng,27-075,C,4/3/17,MIN,POR,1,39,3,8,0.375,3,8,0.375,0,0,,2,2,1,3,5,8,3,0,2,0,4,8,9.1
Tyler Zeller,26-347,F-C,12/29/16,BOS,CLE,0,10,3,4,0.75,3,4,0.75,0,0,,2,2,1,0,0,0,0,0,0,0,0,8,6.4
D.J. Augustin,29-113,G,3/3/17,ORL,MIA,0,21,2,8,0.25,0,3,0,2,5,0.4,2,2,1,1,2,3,2,0,0,2,1,8,3.5
Garrett Temple,30-311,G,3/15/17,SAC,PHO,0,27,2,7,0.286,0,4,0,2,3,0.667,2,2,1,0,4,4,4,0,1,2,5,8,4.6
Ty Lawson,29-055,G,12/28/16,SAC,POR,0,29,2,8,0.25,1,4,0.25,1,4,0.25,3,4,0.75,1,0,1,1,1,0,1,1,8,3.8
Marcin Gortat,33-035,C-F,3/24/17,WAS,BRK,1,18,4,8,0.5,4,8,0.5,0,0,,0,0,,4,5,9,0,0,0,3,2,8,4.5
Shelvin Mack,26-225,G,12/3/16,UTA,DEN,0,26,3,9,0.333,3,8,0.375,0,1,0,2,2,1,0,1,1,4,2,0,1,1,8,6.6
John Henson,26-072,C-F,3/10/17,MIL,IND,0,21,4,5,0.8,4,5,0.8,0,0,,0,0,,3,4,7,0,1,4,1,1,8,11.8
Trevor Booker,29-019,F,12/14/16,BRK,LAL,1,29,3,8,0.375,2,7,0.286,1,1,1,1,5,0.2,5,13,18,2,0,1,3,4,8,6.9
Nene Hilario,34-045,F-C,10/28/16,HOU,DAL,0,19,0,2,0,0,2,0,0,0,,8,12,0.667,0,3,3,2,1,0,2,1,8,5.9
D.J. Augustin,29-139,G,3/29/17,ORL,OKC,0,15,2,5,0.4,2,3,0.667,0,2,0,4,4,1,0,2,2,2,1,0,3,1,8,4.9
Draymond Green,27-014,F,3/18/17,GSW,MIL,1,30,2,6,0.333,2,6,0.333,0,0,,4,4,1,2,5,7,10,1,0,4,1,8,11.1
Tobias Harris,24-226,F,2/26/17,DET,BOS,0,33,2,8,0.25,1,3,0.333,1,5,0.2,3,6,0.5,1,1,2,2,1,1,2,5,8,2.1
Jonas Valanciunas,24-319,C,3/21/17,TOR,CHI,1,25,4,6,0.667,4,6,0.667,0,0,,0,0,,1,4,5,0,0,0,2,3,8,4.1
James Michael McAdoo,24-021,F,1/25/17,GSW,CHO,0,20,3,4,0.75,3,4,0.75,0,0,,2,2,1,1,6,7,1,1,2,1,2,8,10.2
Matt Barnes,37-027,F,4/5/17,GSW,PHO,0,29,3,9,0.333,2,5,0.4,1,4,0.25,1,2,0.5,1,7,8,1,2,0,0,1,8,7.6
Dorian Finney-Smith,23-266,F,1/25/17,DAL,NYK,1,31,3,5,0.6,1,2,0.5,2,3,0.667,0,0,,0,5,5,0,1,0,0,3,8,7
Darren Collison,29-160,G,1/30/17,SAC,PHI,1,24,3,7,0.429,3,6,0.5,0,1,0,2,2,1,0,0,0,2,1,0,1,1,8,5.3
Juan Hernangomez,21-126,F,2/1/17,DEN,MEM,0,15,3,5,0.6,2,4,0.5,1,1,1,1,1,1,1,3,4,1,0,0,1,1,8,6.6
Nikola Mirotic,26-050,F,4/2/17,CHI,NOP,1,17,3,9,0.333,1,4,0.25,2,5,0.4,0,0,,0,4,4,0,0,3,1,1,8,4.8
Briante Weber,24-076,G,3/15/17,CHO,IND,0,20,4,7,0.571,4,6,0.667,0,1,0,0,0,,1,4,5,2,2,0,1,4,8,7.4
Deron Williams,32-282,G,4/4/17,CLE,ORL,0,20,2,6,0.333,2,5,0.4,0,1,0,4,4,1,0,1,1,3,0,0,1,1,8,5.6
Alec Burks,25-224,G,3/1/17,UTA,MIN,0,28,3,11,0.273,3,10,0.3,0,1,0,2,2,1,1,6,7,2,0,0,1,4,8,2.8
Nene Hilario,34-178,F-C,3/10/17,HOU,CHI,0,19,4,8,0.5,4,7,0.571,0,1,0,0,0,,1,5,6,2,1,0,0,2,8,7.8
T.J. McConnell,24-302,G,1/21/17,PHI,ATL,1,37,3,7,0.429,3,7,0.429,0,0,,2,2,1,1,5,6,11,3,0,4,3,8,12
Dwight Powell,25-143,F-C,12/10/16,DAL,HOU,0,26,4,4,1,4,4,1,0,0,,0,0,,1,5,6,2,2,0,1,1,8,11
DeAndre Liggins,29-012,G,4/12/17,DAL,MEM,0,25,3,6,0.5,3,5,0.6,0,1,0,2,3,0.667,3,4,7,0,2,0,0,3,8,8.7
Derrick Favors,25-110,F-C,11/2/16,UTA,DAL,1,23,3,8,0.375,3,8,0.375,0,0,,2,4,0.5,0,1,1,0,0,0,0,3,8,1.9
Alexis Ajinca,28-216,C,12/8/16,NOP,PHI,1,14,4,6,0.667,4,6,0.667,0,0,,0,0,,1,3,4,0,0,0,0,4,8,5.4
Joffrey Lauvergne,25-034,C-F,11/3/16,OKC,GSW,0,19,3,5,0.6,2,3,0.667,1,2,0.5,1,2,0.5,4,3,7,2,2,0,1,2,8,10.6
Mason Plumlee,26-319,C-F,1/18/17,POR,CHO,1,30,3,6,0.5,3,6,0.5,0,0,,2,2,1,3,7,10,1,0,3,1,2,8,10.2
Troy Daniels,25-165,G,12/27/16,MEM,BOS,0,20,3,10,0.3,1,2,0.5,2,8,0.25,0,0,,0,0,0,0,0,0,0,1,8,1.8
Derrick Favors,25-165,F-C,12/27/16,UTA,LAL,1,22,2,5,0.4,2,5,0.4,0,0,,4,4,1,4,2,6,1,1,0,1,3,8,8.2
Willy Hernangomez,22-255,C,2/6/17,NYK,LAL,0,24,3,9,0.333,3,9,0.333,0,0,,2,2,1,3,10,13,1,2,1,1,4,8,8.8
LaMarcus Aldridge,31-164,F-C,12/30/16,SAS,POR,1,29,2,3,0.667,2,3,0.667,0,0,,4,4,1,1,5,6,1,0,1,3,3,8,6.1
Larry Nance Jr.,24-061,F,3/3/17,LAL,BOS,0,20,4,6,0.667,4,6,0.667,0,0,,0,0,,1,3,4,4,2,1,1,2,8,10.7
Michael Carter-Williams,25-114,G,2/1/17,CHI,OKC,0,6,3,4,0.75,3,3,1,0,1,0,2,2,1,0,2,2,1,0,0,0,0,8,7.7
Davis Bertans,24-121,F,3/13/17,SAS,ATL,0,14,3,6,0.5,1,1,1,2,5,0.4,0,0,,0,1,1,1,0,1,1,2,8,4.9
Ty Lawson,29-127,G,3/10/17,SAC,WAS,0,20,2,5,0.4,2,4,0.5,0,1,0,4,4,1,0,0,0,6,2,0,2,3,8,8.3
Trevor Booker,29-053,F,1/17/17,BRK,TOR,1,22,4,8,0.5,4,7,0.571,0,1,0,0,0,,2,5,7,2,0,1,0,3,8,7.8
Nikola Vucevic,26-166,C,4/8/17,ORL,IND,1,31,4,12,0.333,4,11,0.364,0,1,0,0,0,,0,10,10,5,3,1,1,2,8,9.6
DeMarre Carroll,30-188,F,1/31/17,TOR,NOP,1,37,3,10,0.3,3,7,0.429,0,3,0,2,2,1,2,6,8,2,2,0,2,1,8,6.4
Marcin Gortat,33-028,C-F,3/17/17,WAS,CHI,1,22,4,9,0.444,4,9,0.444,0,0,,0,0,,1,7,8,1,0,0,0,1,8,6.4
Will Barton,26-079,G,3/26/17,DEN,NOP,0,21,3,9,0.333,3,8,0.375,0,1,0,2,2,1,0,2,2,4,0,0,1,0,8,5.3
David Lee,33-184,F,10/30/16,SAS,MIA,1,25,3,7,0.429,3,7,0.429,0,0,,2,2,1,4,7,11,0,1,0,0,4,8,8.6
Jae Crowder,26-270,F,4/2/17,BOS,NYK,1,28,2,7,0.286,1,3,0.333,1,4,0.25,3,5,0.6,0,5,5,0,1,0,2,1,8,3.2
Aron Baynes,29-322,C,10/26/16,DET,TOR,0,15,3,4,0.75,3,4,0.75,0,0,,2,2,1,1,2,3,0,0,0,0,5,8,5.7
Jerian Grant,24-027,G,11/5/16,CHI,IND,0,12,2,7,0.286,1,4,0.25,1,3,0.333,3,3,1,0,2,2,2,2,1,0,0,8,8.6
T.J. Warren,23-212,F,4/5/17,PHO,GSW,1,24,4,8,0.5,4,8,0.5,0,0,,0,0,,1,1,2,3,1,0,2,1,8,5.7
Clint Capela,22-208,F-C,12/12/16,HOU,BRK,1,19,4,4,1,4,4,1,0,0,,0,4,0,0,6,6,2,0,0,0,4,8,6.8
Ron Baker,23-305,G,1/29/17,NYK,ATL,0,16,3,4,0.75,1,1,1,2,3,0.667,0,0,,0,1,1,2,0,0,1,0,8,7.1
Clint Capela,22-316,F-C,3/30/17,HOU,POR,1,25,3,6,0.5,3,6,0.5,0,0,,2,2,1,3,4,7,0,1,2,0,3,8,9.5
Marreese Speights,29-182,C-F,2/2/17,LAC,GSW,0,17,2,7,0.286,1,4,0.25,1,3,0.333,3,3,1,2,4,6,3,0,0,0,2,8,7.8
Wesley Johnson,29-119,F-G,11/7/16,LAC,DET,0,18,3,8,0.375,1,3,0.333,2,5,0.4,0,0,,1,4,5,0,0,1,1,2,8,4.4
Bismack Biyombo,24-112,C-F,12/18/16,ORL,TOR,1,27,3,5,0.6,3,5,0.6,0,0,,2,2,1,2,10,12,1,1,3,4,1,8,9.5
Cory Joseph,25-176,G,2/12/17,TOR,DET,0,19,3,8,0.375,2,6,0.333,1,2,0.5,1,2,0.5,0,2,2,1,0,0,2,1,8,2.1
Marvin Williams,30-152,F,11/18/16,CHO,ATL,1,28,3,9,0.333,1,4,0.25,2,5,0.4,0,0,,2,9,11,3,0,0,1,3,8,6.9
Kyle Singler,28-340,F,4/9/17,OKC,DEN,0,34,4,8,0.5,4,4,1,0,4,0,0,0,,2,2,4,3,3,1,0,3,8,10.6
Domantas Sabonis,20-267,F,1/25/17,OKC,NOP,1,28,4,7,0.571,4,5,0.8,0,2,0,0,1,0,1,5,6,0,0,0,1,4,8,3.9
Eric Bledsoe,26-339,G,11/12/16,PHO,BRK,1,30,1,8,0.125,0,5,0,1,3,0.333,5,7,0.714,2,6,8,8,3,0,3,2,8,10
Nerlens Noel,22-297,C-F,2/1/17,PHI,DAL,0,17,4,8,0.5,4,8,0.5,0,0,,0,0,,1,2,3,1,1,0,1,2,8,5.2
Maurice Harkless,23-224,F-G,12/21/16,POR,DAL,1,30,3,9,0.333,3,5,0.6,0,4,0,2,2,1,2,6,8,1,1,1,1,6,8,5.1
Nemanja Bjelica,28-203,F,11/28/16,MIN,UTA,0,26,2,6,0.333,1,3,0.333,1,3,0.333,3,3,1,1,5,6,1,1,0,2,0,8,6.5
Matthew Dellavedova,26-210,G,4/6/17,MIL,IND,1,21,3,8,0.375,1,3,0.333,2,5,0.4,0,0,,1,3,4,2,0,0,4,1,8,2.2
Dante Exum,21-194,G,1/23/17,UTA,OKC,0,14,3,6,0.5,2,2,1,1,4,0.25,1,1,1,0,1,1,2,1,0,0,1,8,7.3
Taurean Waller-Prince,22-339,F,2/24/17,ATL,MIA,0,16,3,7,0.429,3,7,0.429,0,0,,2,2,1,0,4,4,1,1,0,2,2,8,4.4
Julius Randle,22-003,F,12/2/16,LAL,TOR,1,22,4,8,0.5,4,8,0.5,0,0,,0,0,,2,6,8,2,0,1,5,3,8,3.1
Jon Leuer,27-196,F,11/26/16,DET,OKC,0,22,4,7,0.571,4,4,1,0,3,0,0,0,,0,3,3,0,0,0,1,2,8,3.8
T.J. McConnell,25-001,G,3/26/17,PHI,IND,1,24,4,5,0.8,4,5,0.8,0,0,,0,0,,0,3,3,7,1,0,1,1,8,11.5
Jason Terry,39-111,G,1/4/17,MIL,NYK,0,28,3,5,0.6,1,1,1,2,4,0.5,0,0,,1,2,3,0,2,0,0,1,8,8.6
Mirza Teletovic,31-192,F,3/29/17,MIL,BOS,0,22,3,8,0.375,1,1,1,2,7,0.286,0,0,,0,2,2,1,0,0,0,1,8,4.5
Rodney Stuckey,30-286,G,2/1/17,IND,ORL,0,14,2,6,0.333,2,6,0.333,0,0,,4,6,0.667,0,1,1,1,1,0,3,2,8,2
Willie Cauley-Stein,23-220,F-C,3/26/17,SAC,LAC,1,33,4,6,0.667,4,6,0.667,0,0,,0,0,,1,13,14,1,2,1,2,3,8,10.2
Dorian Finney-Smith,23-313,F,3/13/17,DAL,TOR,0,18,3,4,0.75,1,2,0.5,2,2,1,0,0,,0,0,0,0,0,0,0,2,8,5.6
Paul George,26-275,F,2/1/17,IND,ORL,1,33,3,14,0.214,2,8,0.25,1,6,0.167,1,1,1,1,6,7,3,0,0,5,2,8,-1.8
Marcus Thornton,29-208,G,12/30/16,WAS,BRK,0,21,3,6,0.5,1,4,0.25,2,2,1,0,0,,1,2,3,5,1,1,2,3,8,8.3
Mike Muscala,25-215,F-C,2/1/17,ATL,MIA,0,14,3,5,0.6,1,2,0.5,2,3,0.667,0,0,,1,0,1,0,1,0,2,2,8,4.6
Zaza Pachulia,33-036,C,3/18/17,GSW,MIL,1,12,3,5,0.6,3,5,0.6,0,0,,2,4,0.5,0,4,4,2,1,0,2,3,8,5.3
Dwight Howard,30-350,C,11/22/16,ATL,NOP,1,19,4,6,0.667,4,6,0.667,0,0,,0,0,,2,4,6,0,1,3,2,3,8,7.9
Amir Johnson,29-311,F,3/8/17,BOS,GSW,1,20,4,4,1,4,4,1,0,0,,0,0,,0,5,5,0,1,0,1,1,8,7.9
Tony Allen,35-046,G-F,2/26/17,MEM,DEN,1,28,3,8,0.375,3,7,0.429,0,1,0,2,2,1,4,3,7,0,5,1,4,4,8,7.4
Timofey Mozgov,30-132,C,11/25/16,LAL,GSW,1,20,3,6,0.5,3,6,0.5,0,0,,2,4,0.5,1,3,4,1,0,0,1,1,8,5.1
Sam Dekker,22-238,F,12/30/16,HOU,LAC,0,19,4,8,0.5,4,4,1,0,4,0,0,0,,1,1,2,1,0,0,0,0,8,5.7
Greg Monroe,26-244,C-F,2/3/17,MIL,DEN,0,13,3,6,0.5,3,6,0.5,0,0,,2,4,0.5,1,1,2,1,0,0,0,1,8,5.5
Jahlil Okafor,20-319,C-F,10/29/16,PHI,ATL,0,15,2,7,0.286,2,7,0.286,0,0,,4,4,1,1,3,4,1,1,0,0,1,8,6.8
Ish Smith,28-169,G,12/21/16,DET,MEM,0,22,3,7,0.429,3,6,0.5,0,1,0,2,4,0.5,1,3,4,3,0,0,3,2,8,3.4
Marreese Speights,29-195,C-F,2/15/17,LAC,ATL,0,12,4,8,0.5,4,4,1,0,4,0,0,0,,0,0,0,1,0,0,3,5,8,-0.3
Timofey Mozgov,30-178,C,1/10/17,LAL,POR,1,20,4,8,0.5,4,8,0.5,0,0,,0,0,,1,1,2,0,0,1,2,3,8,2.5
Trevor Booker,29-098,F,3/3/17,BRK,UTA,0,25,3,9,0.333,3,7,0.429,0,2,0,2,2,1,3,8,11,1,0,1,1,3,8,6.6
Gorgui Dieng,27-056,C,3/15/17,MIN,BOS,1,31,3,7,0.429,3,6,0.5,0,1,0,2,2,1,4,5,9,4,0,0,2,4,8,7.8
Tyler Ulis,21-056,G,3/2/17,PHO,CHO,0,23,3,7,0.429,3,7,0.429,0,0,,2,2,1,0,1,1,8,2,0,1,0,8,11.2
Kosta Koufos,27-331,C,1/20/17,SAC,MEM,1,24,3,5,0.6,3,5,0.6,0,0,,2,2,1,0,2,2,0,2,2,1,3,8,7.5
Thon Maker,19-337,F-C,1/27/17,MIL,TOR,0,8,3,5,0.6,3,5,0.6,0,0,,2,2,1,2,0,2,0,0,1,1,3,8,5.6
Skal Labissiere,20-232,F,11/5/16,SAC,MIL,0,15,3,5,0.6,3,5,0.6,0,0,,2,3,0.667,3,0,3,0,0,0,0,0,8,7.4
JaVale McGee,28-359,C,1/12/17,GSW,DET,0,8,4,5,0.8,4,5,0.8,0,0,,0,0,,3,3,6,0,0,1,0,2,8,9
Denzel Valentine,23-126,G,3/22/17,CHI,DET,0,22,3,9,0.333,1,5,0.2,2,4,0.5,0,0,,1,3,4,2,1,0,3,3,8,2.7
Ty Lawson,28-361,G,10/29/16,SAC,MIN,1,34,3,10,0.3,1,5,0.2,2,5,0.4,0,0,,0,1,1,5,3,0,2,2,8,6.2
Marcus Smart,23-013,G,3/19/17,BOS,PHI,1,35,3,12,0.25,3,9,0.333,0,3,0,2,2,1,2,4,6,8,2,0,3,1,8,7.6
Steven Adams,23-196,C,2/1/17,OKC,CHI,1,29,3,7,0.429,3,7,0.429,0,0,,2,2,1,3,3,6,0,0,0,1,1,8,5.9
P.J. Tucker,31-307,F,3/8/17,TOR,NOP,1,38,4,7,0.571,4,5,0.8,0,2,0,0,0,,0,6,6,2,0,1,2,3,8,5.4
Marcin Gortat,33-026,C-F,3/15/17,WAS,DAL,1,25,4,10,0.4,4,10,0.4,0,0,,0,2,0,3,7,10,0,0,0,1,2,8,4.2
Austin Rivers,24-214,G,3/3/17,LAC,MIL,0,27,2,6,0.333,2,5,0.4,0,1,0,4,6,0.667,0,2,2,1,0,0,4,3,8,-0.1
Patrick Beverley,28-182,G,1/10/17,HOU,CHO,1,32,2,10,0.2,0,2,0,2,8,0.25,2,2,1,1,7,8,5,0,0,2,4,8,4.5
J.R. Smith,31-049,G-F,10/28/16,CLE,TOR,1,34,3,8,0.375,1,1,1,2,7,0.286,0,0,,0,0,0,0,3,0,1,0,8,5.6
Isaiah Canaan,25-175,G,11/12/16,CHI,WAS,0,27,3,7,0.429,2,2,1,1,5,0.2,1,1,1,0,2,2,0,0,0,0,2,8,4.1
Seth Curry,26-075,G,11/6/16,DAL,MIL,0,25,3,7,0.429,2,3,0.667,1,4,0.25,0,0,,0,0,0,2,0,0,1,0,7,3.7
Michael Beasley,28-007,F,1/16/17,MIL,PHI,0,26,2,5,0.4,2,5,0.4,0,0,,3,4,0.75,2,4,6,2,0,0,2,3,7,4.7
Taurean Waller-Prince,23-018,F,4/9/17,ATL,CLE,1,25,2,6,0.333,0,2,0,2,4,0.5,1,2,0.5,0,0,0,3,0,1,1,2,7,4.2
Lucas Nogueira,24-103,C,11/6/16,TOR,SAC,0,21,3,3,1,3,3,1,0,0,,1,2,0.5,3,2,5,0,1,1,1,3,7,7.9
Dirk Nowitzki,38-191,F,12/27/16,DAL,HOU,1,15,2,8,0.25,2,8,0.25,0,0,,3,4,0.75,1,2,3,0,0,0,1,0,7,2.1
Kyle O'Quinn,26-315,F-C,2/4/17,NYK,CLE,0,13,3,6,0.5,3,6,0.5,0,0,,1,2,0.5,2,2,4,1,0,0,0,0,7,6.3
Jordan McRae,25-235,G,11/18/16,CLE,DET,0,15,2,7,0.286,1,6,0.167,1,1,1,2,2,1,0,2,2,3,0,0,1,1,7,4.2
Shabazz Muhammad,23-361,F-G,11/8/16,MIN,BRK,0,24,3,12,0.25,2,8,0.25,1,4,0.25,0,0,,2,2,4,0,0,0,1,3,7,-0.4
Thabo Sefolosha,32-194,G-F,11/12/16,ATL,PHI,0,18,3,7,0.429,2,4,0.5,1,3,0.333,0,0,,0,2,2,1,2,0,1,1,7,5.2
DeAndre Liggins,28-283,G,1/8/17,CLE,PHO,1,25,3,4,0.75,2,3,0.667,1,1,1,0,0,,0,1,1,1,4,2,2,1,7,9.4
Trevor Booker,29-061,F,1/25/17,BRK,MIA,1,24,2,4,0.5,2,4,0.5,0,0,,3,4,0.75,2,4,6,1,0,1,1,1,7,7.2
Iman Shumpert,26-132,G,11/5/16,CLE,PHI,0,26,3,4,0.75,2,2,1,1,2,0.5,0,0,,1,2,3,3,1,0,1,1,7,8.4
Marvin Williams,30-131,F,10/28/16,CHO,MIA,1,34,3,6,0.5,2,4,0.5,1,2,0.5,0,0,,0,11,11,1,2,1,1,1,7,9.3
Thomas Robinson,25-281,F,12/23/16,LAL,ORL,0,19,3,5,0.6,3,5,0.6,0,0,,1,2,0.5,5,6,11,1,0,1,1,1,7,9.6
Jaylen Brown,20-046,F,12/9/16,BOS,TOR,0,22,3,6,0.5,2,5,0.4,1,1,1,0,0,,0,3,3,0,0,1,0,1,7,5.2
Stanley Johnson,20-270,F,2/23/17,DET,CHO,0,16,3,5,0.6,2,2,1,1,3,0.333,0,0,,0,2,2,1,2,0,0,3,7,6.8
Vince Carter,40-048,G-F,3/15/17,MEM,CHI,1,29,3,7,0.429,2,3,0.667,1,4,0.25,0,0,,1,2,3,2,0,1,1,1,7,5.3
Ryan Anderson,28-192,F,11/14/16,HOU,PHI,1,30,3,11,0.273,2,5,0.4,1,6,0.167,0,0,,3,4,7,2,0,0,1,1,7,3.8
Leandro Barbosa,34-104,G,3/12/17,PHO,POR,0,18,3,6,0.5,3,5,0.6,0,1,0,1,1,1,0,0,0,1,0,0,0,3,7,3.5
Myles Turner,20-363,F-C,3/22/17,IND,BOS,1,29,3,7,0.429,2,6,0.333,1,1,1,0,2,0,2,7,9,4,2,2,1,4,7,9.6
Leandro Barbosa,33-337,G,10/30/16,PHO,GSW,0,15,3,6,0.5,3,6,0.5,0,0,,1,2,0.5,1,2,3,2,0,0,0,0,7,6.3
Dante Cunningham,29-200,F,11/8/16,NOP,SAC,0,23,3,5,0.6,2,3,0.667,1,2,0.5,0,1,0,0,4,4,1,0,1,1,2,7,5.1
Jonas Valanciunas,24-236,C,12/28/16,TOR,GSW,1,21,2,5,0.4,2,5,0.4,0,0,,3,3,1,2,3,5,0,0,1,0,3,7,6.1
Aron Baynes,29-326,C,10/30/16,DET,MIL,0,11,2,4,0.5,2,4,0.5,0,0,,3,4,0.75,2,5,7,0,0,0,2,1,7,5.1
Marco Belinelli,30-353,G-F,3/13/17,CHO,CHI,0,22,2,7,0.286,2,5,0.4,0,2,0,3,3,1,1,2,3,3,0,0,0,0,7,6.3
Quincy Acy,26-113,F,1/27/17,BRK,CLE,0,18,3,4,0.75,2,3,0.667,1,1,1,0,0,,0,5,5,0,0,1,1,2,7,5.8
Tony Snell,25-136,G-F,3/26/17,MIL,CHI,1,32,3,8,0.375,2,4,0.5,1,4,0.25,0,0,,0,1,1,1,1,0,0,0,7,4.6
Dante Exum,21-208,G,2/6/17,UTA,ATL,0,14,3,5,0.6,3,4,0.75,0,1,0,1,2,0.5,0,2,2,0,0,0,2,3,7,1.7
Jeremy Lin,28-192,G,3/3/17,BRK,UTA,1,16,3,7,0.429,2,5,0.4,1,2,0.5,0,0,,0,3,3,2,0,0,3,5,7,0.6
Beno Udrih,34-134,G,11/16/16,DET,NYK,0,13,3,7,0.429,3,5,0.6,0,2,0,1,1,1,0,0,0,1,0,0,0,0,7,4
Troy Williams,21-339,F,12/3/16,MEM,LAL,1,35,3,8,0.375,2,5,0.4,1,3,0.333,0,0,,1,5,6,2,3,0,3,1,7,5.8
Al Horford,30-258,C-F,2/16/17,BOS,CHI,1,27,3,10,0.3,2,5,0.4,1,5,0.2,0,0,,0,2,2,3,0,1,0,1,7,4.2
P.J. Tucker,31-254,F,1/14/17,PHO,SAS,0,30,2,7,0.286,1,2,0.5,1,5,0.2,2,2,1,0,5,5,2,4,0,1,3,7,7.6
Domantas Sabonis,20-255,F,1/13/17,OKC,MIN,1,21,3,11,0.273,3,8,0.375,0,3,0,1,3,0.333,1,5,6,0,0,0,0,2,7,1.1
Josh Richardson,23-099,G,12/23/16,MIA,NOP,1,33,2,10,0.2,1,5,0.2,1,5,0.2,2,2,1,0,1,1,3,1,0,2,4,7,0.6
Raymond Felton,32-196,G,1/8/17,LAC,MIA,1,37,3,11,0.273,2,5,0.4,1,6,0.167,0,0,,1,6,7,5,2,0,1,3,7,6.3
Matt Barnes,36-315,F,1/18/17,SAC,IND,0,20,2,7,0.286,1,3,0.333,1,4,0.25,2,2,1,2,2,4,4,0,0,2,1,7,5.3
Stanley Johnson,20-273,F,2/26/17,DET,BOS,0,12,2,2,1,1,1,1,1,1,1,2,2,1,0,2,2,1,2,0,0,1,7,9.3
Anthony Brown,24-109,F-G,1/27/17,ORL,BOS,0,12,3,7,0.429,2,4,0.5,1,3,0.333,0,0,,0,4,4,2,0,0,1,1,7,4.5
Dewayne Dedmon,27-165,C,1/24/17,SAS,TOR,0,19,2,3,0.667,2,3,0.667,0,0,,3,4,0.75,2,2,4,2,0,0,1,2,7,6.9
Seth Curry,26-113,G,12/14/16,DAL,DET,0,23,3,8,0.375,2,7,0.286,1,1,1,0,0,,0,0,0,2,2,0,0,3,7,4.8
Terrence Jones,24-304,F,11/8/16,NOP,SAC,0,26,3,6,0.5,3,6,0.5,0,0,,1,2,0.5,1,4,5,1,3,2,1,3,7,8.4
Dante Exum,21-263,G,4/2/17,UTA,SAS,1,27,3,7,0.429,2,5,0.4,1,2,0.5,0,0,,1,2,3,2,0,1,0,4,7,5.1
Cory Joseph,25-143,G,1/10/17,TOR,BOS,0,24,2,5,0.4,1,3,0.333,1,2,0.5,2,2,1,0,1,1,2,0,0,0,3,7,4.8
Nemanja Bjelica,28-282,F,2/15/17,MIN,DEN,0,29,3,5,0.6,2,4,0.5,1,1,1,0,0,,2,3,5,1,0,1,0,5,7,6.4
Iman Shumpert,26-271,G,3/24/17,CLE,CHO,0,25,3,8,0.375,2,3,0.667,1,5,0.2,0,0,,0,2,2,1,1,2,1,4,7,3.7
Chandler Parsons,28-067,F,12/31/16,MEM,SAC,1,16,3,7,0.429,2,3,0.667,1,4,0.25,0,0,,0,1,1,2,1,0,0,1,7,5.6
Luc Mbah a Moute,30-104,F,12/22/16,LAC,SAS,1,15,3,5,0.6,2,4,0.5,1,1,1,0,0,,0,1,1,0,0,1,0,2,7,4.9
Tarik Black,25-080,C-F,2/10/17,LAL,MIL,1,20,3,5,0.6,3,5,0.6,0,0,,1,2,0.5,1,3,4,3,1,2,3,1,7,7
Tarik Black,25-084,C-F,2/14/17,LAL,SAC,1,21,3,5,0.6,2,4,0.5,1,1,1,0,0,,2,1,3,1,1,0,1,6,7,4.7
Solomon Hill,26-013,F,3/31/17,NOP,SAC,1,30,3,7,0.429,2,3,0.667,1,4,0.25,0,0,,0,1,1,3,2,1,1,1,7,7
Mirza Teletovic,31-076,F,12/3/16,MIL,BRK,0,15,2,6,0.333,0,0,,2,6,0.333,1,2,0.5,0,3,3,2,0,0,1,1,7,4.1
Kelly Oubre,21-007,F,12/16/16,WAS,DET,0,34,1,6,0.167,1,3,0.333,0,3,0,5,6,0.833,0,6,6,0,1,0,0,3,7,4.4
Kosta Koufos,27-332,C,1/21/17,SAC,CHI,1,25,3,4,0.75,3,4,0.75,0,0,,1,1,1,1,5,6,1,1,1,0,3,7,8.8
Marreese Speights,29-120,C-F,12/2/16,LAC,NOP,0,14,3,5,0.6,3,5,0.6,0,0,,1,2,0.5,3,2,5,1,1,0,0,2,7,7.9
Joe Ingles,29-033,F-G,11/4/16,UTA,SAS,0,21,2,5,0.4,1,1,1,1,4,0.25,2,4,0.5,0,1,1,1,2,0,3,3,7,2.3
Rodney McGruder,25-151,G,12/27/16,MIA,OKC,1,36,3,5,0.6,2,3,0.667,1,2,0.5,0,0,,1,0,1,1,0,0,0,2,7,5.3
Bobby Portis,22-015,F,2/25/17,CHI,CLE,1,19,2,6,0.333,1,3,0.333,1,3,0.333,2,2,1,1,2,3,1,0,0,0,0,7,5.6
Andre Roberson,25-100,G-F,3/14/17,OKC,BRK,1,20,2,4,0.5,1,1,1,1,3,0.333,2,4,0.5,2,1,3,1,0,1,0,5,7,5.3
Wesley Johnson,29-168,F-G,12/26/16,LAC,DEN,1,20,2,5,0.4,1,1,1,1,4,0.25,2,4,0.5,0,2,2,4,0,2,0,5,7,6.3
Richard Jefferson,36-288,F,4/5/17,CLE,BOS,0,10,3,3,1,2,2,1,1,1,1,0,0,,0,0,0,0,1,0,0,0,7,7.1
Jeff Green,30-059,F,10/26/16,ORL,MIA,0,25,2,7,0.286,2,5,0.4,0,2,0,3,4,0.75,1,2,3,1,0,0,1,1,7,3.1
Isaiah Whitehead,21-360,G,3/3/17,BRK,UTA,0,25,3,12,0.25,2,8,0.25,1,4,0.25,0,0,,1,3,4,1,1,0,1,1,7,1.7
Rodney McGruder,25-218,G,3/4/17,MIA,CLE,1,20,2,4,0.5,1,1,1,1,3,0.333,2,3,0.667,1,1,2,2,0,0,0,1,7,6.6
Tony Snell,25-000,G-F,11/10/16,MIL,NOP,1,33,2,6,0.333,1,2,0.5,1,4,0.25,2,2,1,1,3,4,1,0,0,1,2,7,4.1
Ricky Rubio,26-048,G,12/8/16,MIN,TOR,1,29,2,7,0.286,0,1,0,2,6,0.333,1,1,1,1,2,3,3,0,0,1,5,7,3.3
Kelly Olynyk,25-230,C-F,12/5/16,BOS,HOU,0,15,3,6,0.5,2,4,0.5,1,2,0.5,0,0,,1,4,5,2,1,0,1,2,7,6.5
Nikola Vucevic,26-046,C,12/9/16,ORL,CHO,0,23,3,10,0.3,3,10,0.3,0,0,,1,2,0.5,0,5,5,2,1,0,0,3,7,3.5
JaVale McGee,28-307,C,11/21/16,GSW,IND,0,14,3,4,0.75,3,4,0.75,0,0,,1,4,0.25,1,4,5,0,0,3,2,3,7,5
Taj Gibson,31-214,F,1/24/17,CHI,ORL,1,29,2,6,0.333,2,5,0.4,0,1,0,3,6,0.5,0,6,6,1,1,1,1,3,7,4.4
Jordan Clarkson,24-299,G,4/2/17,LAL,MEM,1,35,3,12,0.25,2,7,0.286,1,5,0.2,0,0,,1,2,3,4,0,0,2,1,7,1.5
Joffrey Lauvergne,25-051,C-F,11/20/16,OKC,IND,0,26,3,5,0.6,2,2,1,1,3,0.333,0,1,0,2,5,7,2,0,1,0,1,7,8.9
Nik Stauskas,23-026,G,11/2/16,PHI,CHO,0,31,2,6,0.333,1,3,0.333,1,3,0.333,2,2,1,0,4,4,2,0,0,2,0,7,4.2
Trey Burke,24-036,G,12/18/16,WAS,LAC,0,17,2,3,0.667,0,1,0,2,2,1,1,2,0.5,0,0,0,1,0,0,1,2,7,4.2
Tony Snell,25-072,G-F,1/21/17,MIL,MIA,1,25,2,2,1,1,1,1,1,1,1,2,2,1,0,2,2,1,0,0,1,3,7,5.5
Marquese Chriss,19-172,F,12/21/16,PHO,HOU,1,16,3,7,0.429,2,3,0.667,1,4,0.25,0,0,,1,2,3,0,0,0,0,2,7,3.8
Michael Carter-Williams,25-162,G,3/21/17,CHI,TOR,0,13,2,6,0.333,1,4,0.25,1,2,0.5,2,2,1,0,0,0,3,1,2,1,3,7,5.9
Jordan Crawford,28-145,G,3/17/17,NOP,HOU,0,19,3,10,0.3,2,6,0.333,1,4,0.25,0,1,0,1,4,5,3,0,0,2,4,7,1.2
Salah Mejri,30-180,C,12/12/16,DAL,DEN,1,22,3,3,1,3,3,1,0,0,,1,2,0.5,4,4,8,1,1,4,1,2,7,12.4
Aaron Gordon,21-144,F,2/7/17,ORL,HOU,1,19,3,5,0.6,2,2,1,1,3,0.333,0,0,,1,1,2,4,0,0,1,1,7,7.1
Gorgui Dieng,26-320,C,12/3/16,MIN,CHO,1,31,3,11,0.273,2,9,0.222,1,2,0.5,0,0,,2,6,8,1,0,2,1,4,7,3.2
Brandon Rush,31-240,G-F,3/4/17,MIN,SAS,1,32,3,5,0.6,2,3,0.667,1,2,0.5,0,0,,0,6,6,1,0,1,0,1,7,7.5
Joe Johnson,35-211,G-F,1/26/17,UTA,LAL,0,16,3,4,0.75,3,3,1,0,1,0,1,1,1,0,2,2,0,0,0,0,2,7,5.2
Victor Oladipo,24-338,G,4/7/17,OKC,PHO,1,27,3,8,0.375,3,6,0.5,0,2,0,1,5,0.2,1,2,3,3,0,0,1,4,7,1.8
Jerian Grant,24-138,G,2/24/17,CHI,PHO,0,13,2,3,0.667,1,1,1,1,2,0.5,2,5,0.4,1,2,3,1,2,0,0,3,7,7.3
Kentavious Caldwell-Pope,23-361,G,2/13/17,DET,MIL,1,33,2,10,0.2,1,6,0.167,1,4,0.25,2,2,1,1,2,3,3,0,0,4,1,7,-0.2
Ty Lawson,28-359,G,10/27/16,SAC,SAS,1,36,3,7,0.429,3,5,0.6,0,2,0,1,2,0.5,1,3,4,9,1,0,1,1,7,10.4
Timothe Luwawu-Cabarrot,21-268,F,2/1/17,PHI,DAL,1,23,3,5,0.6,2,3,0.667,1,2,0.5,0,0,,0,4,4,2,0,0,2,5,7,3.3
David Lee,33-230,F,12/15/16,SAS,PHO,0,19,3,7,0.429,3,7,0.429,0,0,,1,1,1,1,7,8,0,0,0,4,0,7,2.1
Rondae Hollis-Jefferson,22-018,F,1/21/17,BRK,CHO,0,21,3,6,0.5,3,3,1,0,3,0,1,3,0.333,0,4,4,2,1,0,2,1,7,4.4
Justin Holiday,27-352,G,3/23/17,NYK,POR,0,22,3,8,0.375,3,6,0.5,0,2,0,1,1,1,0,1,1,3,1,0,1,3,7,3.8
Kent Bazemore,27-250,G-F,3/8/17,ATL,BRK,1,23,3,13,0.231,2,11,0.182,1,2,0.5,0,2,0,2,3,5,2,0,2,2,3,7,0.2
Jahlil Okafor,21-056,C-F,2/9/17,PHI,ORL,1,22,3,8,0.375,3,8,0.375,0,0,,1,2,0.5,0,2,2,0,0,1,3,1,7,0.1
Terrence Ross,26-007,F-G,2/12/17,TOR,DET,0,18,3,6,0.5,2,4,0.5,1,2,0.5,0,0,,0,3,3,2,0,0,0,4,7,4.7
Austin Rivers,24-146,G,12/25/16,LAC,LAL,0,25,3,10,0.3,2,7,0.286,1,3,0.333,0,0,,1,1,2,1,2,0,2,4,7,1.3
Domantas Sabonis,20-190,F,11/9/16,OKC,TOR,1,28,3,6,0.5,2,3,0.667,1,3,0.333,0,0,,0,1,1,4,1,0,0,2,7,7.3
Darrun Hilliard,23-219,G,11/18/16,DET,CLE,0,20,1,6,0.167,0,4,0,1,2,0.5,4,6,0.667,0,1,1,3,0,0,0,4,7,3.2
DeAndre Jordan,28-101,C,10/30/16,LAC,UTA,1,28,3,10,0.3,3,10,0.3,0,0,,1,2,0.5,6,10,16,0,0,1,1,1,7,7.3
Jordan McRae,25-242,G,11/25/16,CLE,DAL,0,14,3,7,0.429,3,5,0.6,0,2,0,1,1,1,0,2,2,0,0,0,0,2,7,3.1
Domantas Sabonis,20-257,F,1/15/17,OKC,SAC,1,28,3,8,0.375,3,4,0.75,0,4,0,1,2,0.5,0,3,3,1,0,0,1,5,7,0.8
Kyle Korver,35-260,G-F,12/2/16,ATL,DET,1,34,2,8,0.25,2,5,0.4,0,3,0,3,4,0.75,0,2,2,0,1,0,0,0,7,3.4
Jerami Grant,22-242,F,11/9/16,OKC,TOR,0,12,2,3,0.667,1,1,1,1,2,0.5,2,2,1,0,2,2,0,0,1,1,2,7,5.2
Greg Monroe,26-194,C-F,12/15/16,MIL,CHI,0,22,3,7,0.429,3,7,0.429,0,0,,1,1,1,0,5,5,3,2,1,0,1,7,9.2
Andrew Harrison,22-132,G,3/9/17,MEM,LAC,1,14,2,5,0.4,1,2,0.5,1,3,0.333,2,2,1,0,0,0,4,0,0,0,2,7,6.3
P.J. Tucker,31-198,F,11/19/16,PHO,PHI,1,31,1,3,0.333,0,1,0,1,2,0.5,4,4,1,1,6,7,2,0,0,0,1,7,8.8
Joakim Noah,31-326,C,1/16/17,NYK,ATL,1,33,2,3,0.667,2,3,0.667,0,0,,3,5,0.6,7,10,17,3,1,2,1,5,7,14.3
Marquese Chriss,19-116,F,10/26/16,PHO,SAC,0,22,3,7,0.429,3,7,0.429,0,0,,1,2,0.5,2,2,4,2,0,1,4,3,7,1.8
Tristan Thompson,25-276,F-C,12/14/16,CLE,MEM,1,28,2,5,0.4,2,5,0.4,0,0,,3,6,0.5,4,7,11,0,1,0,0,1,7,8.6
Jaylen Brown,20-042,F,12/5/16,BOS,HOU,0,19,3,6,0.5,2,4,0.5,1,2,0.5,0,0,,0,1,1,0,0,0,0,2,7,3.5
Tyson Chandler,34-124,C,2/3/17,PHO,SAC,1,32,1,1,1,1,1,1,0,0,,5,5,1,0,12,12,0,1,0,2,3,7,8.1
Raul Neto,24-296,G,3/11/17,UTA,OKC,0,13,3,4,0.75,3,4,0.75,0,0,,1,1,1,0,0,0,2,2,0,0,0,7,8.8
Garrett Temple,30-265,G,1/28/17,SAC,CHO,1,24,2,7,0.286,1,4,0.25,1,3,0.333,2,4,0.5,0,1,1,1,1,0,0,2,7,3.3
Tyler Ennis,22-125,G,12/27/16,HOU,DAL,0,18,3,5,0.6,2,4,0.5,1,1,1,0,0,,0,2,2,2,0,0,3,4,7,2.1
Arron Afflalo,31-032,G,11/16/16,SAC,SAS,1,22,3,8,0.375,2,5,0.4,1,3,0.333,0,0,,1,1,2,1,0,0,0,2,7,3.5
Marcus Morris,27-096,F,12/7/16,DET,CHO,1,34,3,10,0.3,2,7,0.286,1,3,0.333,0,0,,2,8,10,2,0,1,1,1,7,5.7
Jared Dudley,31-263,F-G,3/30/17,PHO,LAC,0,25,3,7,0.429,2,3,0.667,1,4,0.25,0,0,,1,6,7,0,0,0,1,5,7,2.8
Anthony Tolliver,31-216,F-C,1/3/17,SAC,DEN,0,25,2,4,0.5,1,1,1,1,3,0.333,2,2,1,0,3,3,1,0,0,1,1,7,5.2
Solomon Hill,25-323,F,2/4/17,NOP,WAS,1,27,3,6,0.5,2,3,0.667,1,3,0.333,0,0,,1,4,5,1,1,1,2,2,7,5.5
Justise Winslow,20-233,F,11/14/16,MIA,SAS,1,35,3,11,0.273,3,10,0.3,0,1,0,1,2,0.5,2,1,3,5,1,0,0,2,7,5.5
Rajon Rondo,30-298,G,12/16/16,CHI,MIL,1,26,3,9,0.333,2,6,0.333,1,3,0.333,0,2,0,1,3,4,4,1,0,3,2,7,2.7
Devin Harris,34-039,G,4/7/17,DAL,SAS,0,8,3,3,1,2,2,1,1,1,1,0,0,,0,2,2,0,1,0,0,1,7,7.3
Kelly Olynyk,25-290,C-F,2/3/17,BOS,LAL,0,16,3,8,0.375,3,5,0.6,0,3,0,1,2,0.5,2,7,9,2,0,0,1,2,7,5.3
Jarell Martin,22-193,F,12/3/16,MEM,LAL,0,20,1,3,0.333,0,1,0,1,2,0.5,4,4,1,0,2,2,0,0,0,0,2,7,5.1
Markieff Morris,27-066,F,11/7/16,WAS,HOU,1,33,3,14,0.214,2,12,0.167,1,2,0.5,0,0,,4,5,9,0,1,0,2,1,7,1.3
Timothe Luwawu-Cabarrot,21-211,F,12/6/16,PHI,MEM,0,16,3,6,0.5,2,4,0.5,1,2,0.5,0,2,0,0,2,2,0,0,0,2,4,7,0.2
Seth Curry,26-092,G,11/23/16,DAL,LAC,1,29,3,7,0.429,3,5,0.6,0,2,0,1,1,1,0,1,1,1,1,0,1,2,7,3.5
Lance Thomas,28-255,F,1/4/17,NYK,MIL,1,38,3,8,0.375,2,6,0.333,1,2,0.5,0,0,,1,3,4,2,3,0,0,4,7,7
Jusuf Nurkic,22-135,C,1/5/17,DEN,SAS,0,21,3,4,0.75,3,4,0.75,0,0,,1,2,0.5,1,5,6,0,0,0,1,4,7,4.6
Anthony Bennett,23-245,F,11/14/16,BRK,LAC,0,26,2,8,0.25,1,3,0.333,1,5,0.2,2,2,1,1,8,9,1,0,0,1,0,7,5
Jrue Holiday,26-164,G,11/23/16,NOP,MIN,0,22,2,8,0.25,2,6,0.333,0,2,0,3,4,0.75,0,1,1,8,1,1,2,4,7,5.8
Robin Lopez,28-301,C,1/27/17,CHI,MIA,1,18,3,6,0.5,3,6,0.5,0,0,,1,1,1,1,1,2,1,0,0,1,0,7,4.7
Terrence Ross,25-328,F-G,12/29/16,TOR,PHO,0,30,3,11,0.273,2,4,0.5,1,7,0.143,0,0,,0,4,4,1,4,1,1,2,7,5.3
Okaro White,24-179,F,2/8/17,MIA,MIL,0,17,2,3,0.667,1,1,1,1,2,0.5,2,2,1,1,4,5,1,0,0,0,2,7,7.5
Jameer Nelson,34-278,G,11/13/16,DEN,POR,0,33,3,8,0.375,2,4,0.5,1,4,0.25,0,0,,1,3,4,2,1,0,2,4,7,3
Brandon Bass,31-322,F,3/18/17,LAC,CLE,0,7,3,3,1,3,3,1,0,0,,1,1,1,0,2,2,0,0,0,1,0,7,5.7
Terrence Jones,24-293,F,10/28/16,NOP,GSW,0,13,3,5,0.6,3,4,0.75,0,1,0,1,2,0.5,1,1,2,2,0,0,0,1,7,6.3
James Ennis,26-268,F,3/26/17,MEM,GSW,0,30,3,6,0.5,3,4,0.75,0,2,0,1,1,1,2,6,8,1,2,0,0,3,7,8.7
Patrick Beverley,28-201,G,1/29/17,HOU,IND,1,33,2,8,0.25,1,4,0.25,1,4,0.25,2,2,1,1,3,4,5,1,1,2,5,7,5
Marquese Chriss,19-118,F,10/28/16,PHO,OKC,0,11,3,5,0.6,3,3,1,0,2,0,1,2,0.5,1,3,4,0,1,1,1,3,7,5.4
Al Horford,30-296,C-F,3/26/17,BOS,MIA,1,31,2,6,0.333,2,6,0.333,0,0,,3,4,0.75,3,7,10,8,2,1,1,0,7,14.7
Reggie Jackson,26-294,G,2/4/17,DET,IND,1,27,3,11,0.273,2,8,0.25,1,3,0.333,0,0,,1,2,3,5,0,0,2,3,7,2.1
Jerami Grant,22-351,F,2/26/17,OKC,NOP,0,21,2,3,0.667,2,2,1,0,1,0,3,3,1,0,3,3,1,1,0,1,3,7,6.1
Al Jefferson,31-296,C-F,10/26/16,IND,DAL,0,11,3,6,0.5,3,6,0.5,0,0,,1,1,1,1,5,6,0,0,1,1,1,7,5.5
Caris LeVert,22-222,G-F,4/4/17,BRK,PHI,1,19,3,5,0.6,2,2,1,1,3,0.333,0,0,,0,4,4,7,1,1,2,1,7,10.1
Kent Bazemore,27-118,G-F,10/27/16,ATL,WAS,1,26,1,7,0.143,0,3,0,1,4,0.25,4,4,1,0,3,3,1,1,0,4,4,7,-0.5
Vince Carter,40-011,G-F,2/6/17,MEM,SAS,0,24,3,9,0.333,2,4,0.5,1,5,0.2,0,1,0,1,5,6,2,0,4,2,2,7,5.1
Jeff Teague,28-227,G,1/23/17,IND,NYK,1,36,3,9,0.333,2,6,0.333,1,3,0.333,0,2,0,0,4,4,7,0,0,3,4,7,2.6
Anthony Tolliver,31-247,F-C,2/3/17,SAC,PHO,0,26,2,9,0.222,1,4,0.25,1,5,0.2,2,4,0.5,1,5,6,0,0,1,2,3,7,0.4
Malachi Richardson,20-344,G,12/14/16,SAC,HOU,0,12,2,5,0.4,1,2,0.5,1,3,0.333,2,2,1,0,3,3,2,1,0,0,1,7,7.2
Jordan Clarkson,24-298,G,4/1/17,LAL,LAC,1,31,3,12,0.25,2,7,0.286,1,5,0.2,0,0,,0,0,0,3,0,0,0,3,7,0.7
Corey Brewer,30-263,F-G,11/23/16,HOU,TOR,0,10,3,5,0.6,2,2,1,1,3,0.333,0,0,,0,3,3,0,0,1,1,1,7,4.9
Kyle O'Quinn,27-005,F-C,3/31/17,NYK,MIA,0,19,2,3,0.667,2,3,0.667,0,0,,3,3,1,1,3,4,3,0,2,1,2,7,9
Juan Hernangomez,21-131,F,2/6/17,DEN,DAL,0,18,3,5,0.6,3,4,0.75,0,1,0,1,1,1,3,6,9,0,1,1,2,0,7,8.3
Joe Johnson,35-157,G-F,12/3/16,UTA,DEN,0,17,3,6,0.5,2,4,0.5,1,2,0.5,0,0,,1,1,2,3,0,0,1,1,7,5.7
James Ennis,26-189,F,1/6/17,MEM,GSW,0,20,3,8,0.375,2,5,0.4,1,3,0.333,0,0,,1,4,5,1,2,0,2,4,7,3.6
Mario Hezonja,21-337,F-G,1/27/17,ORL,BOS,0,23,3,8,0.375,2,4,0.5,1,4,0.25,0,0,,0,3,3,5,0,1,0,2,7,6.9
Luol Deng,31-290,F,1/31/17,LAL,DEN,1,31,3,9,0.333,2,6,0.333,1,3,0.333,0,0,,0,4,4,1,1,2,3,0,7,3.2
Matt Barnes,36-246,F,11/10/16,SAC,LAL,0,29,3,8,0.375,2,4,0.5,1,4,0.25,0,0,,2,3,5,1,2,2,2,3,7,5.8
Trevor Booker,29-128,F,4/2/17,BRK,ATL,0,22,3,10,0.3,2,6,0.333,1,4,0.25,0,0,,2,5,7,1,3,0,1,5,7,4.8
Mike Muscala,25-229,F-C,2/15/17,ATL,LAC,0,11,3,4,0.75,3,4,0.75,0,0,,1,1,1,0,2,2,0,0,0,0,0,7,6
Kent Bazemore,27-216,G-F,2/2/17,ATL,HOU,1,31,3,7,0.429,2,4,0.5,1,3,0.333,0,0,,0,3,3,6,2,0,2,0,7,8.4
Marco Belinelli,30-215,G-F,10/26/16,CHO,MIL,0,26,3,8,0.375,3,6,0.5,0,2,0,1,1,1,0,4,4,1,0,0,0,1,7,4.1
D.J. Augustin,28-361,G,11/5/16,ORL,WAS,0,20,3,8,0.375,2,4,0.5,1,4,0.25,0,0,,0,0,0,5,2,0,1,0,7,7.1
Paul Zipser,23-047,G-F,4/6/17,CHI,PHI,1,24,3,8,0.375,2,5,0.4,1,3,0.333,0,0,,1,2,3,0,1,0,0,3,7,3.7
Marcus Smart,22-292,G,12/23/16,BOS,OKC,0,24,3,10,0.3,2,8,0.25,1,2,0.5,0,0,,1,2,3,4,1,1,3,4,7,2.4
Ish Smith,28-178,G,12/30/16,DET,ATL,0,25,3,7,0.429,2,3,0.667,1,4,0.25,0,0,,1,3,4,3,1,0,1,3,7,5.8
Paul Millsap,31-320,F,12/26/16,ATL,MIN,1,25,2,13,0.154,2,10,0.2,0,3,0,3,4,0.75,2,3,5,0,1,0,2,3,7,-1.6
Rodney McGruder,25-142,G,12/18/16,MIA,BOS,1,30,2,3,0.667,1,2,0.5,1,1,1,2,2,1,1,4,5,3,0,0,0,2,7,8.9
Cristiano Felicio,24-161,F-C,12/15/16,CHI,MIL,0,21,3,4,0.75,3,4,0.75,0,0,,1,2,0.5,2,4,6,0,1,0,0,0,7,8.6
David Lee,33-215,F,11/30/16,SAS,DAL,0,22,3,6,0.5,3,6,0.5,0,0,,1,2,0.5,0,5,5,0,0,1,1,2,7,4
Joe Ingles,29-064,F-G,12/5/16,UTA,LAL,0,12,2,3,0.667,1,2,0.5,1,1,1,2,3,0.667,0,2,2,1,1,0,1,0,7,6.6
Fred VanVleet,23-036,G,4/2/17,TOR,PHI,0,12,3,6,0.5,2,4,0.5,1,2,0.5,0,0,,0,1,1,0,1,0,1,2,7,3.5
Jamal Crawford,36-353,G,3/8/17,LAC,MIN,0,24,2,9,0.222,2,6,0.333,0,3,0,3,3,1,1,0,1,0,3,0,3,2,7,1.4
Michael Kidd-Gilchrist,23-131,F,2/4/17,CHO,UTA,1,29,3,6,0.5,3,6,0.5,0,0,,1,2,0.5,0,6,6,1,2,0,0,3,7,6.9
Thaddeus Young,28-177,F,12/15/16,IND,NOP,1,36,3,8,0.375,3,7,0.429,0,1,0,1,2,0.5,1,8,9,1,2,0,4,2,7,3.2
Cameron Payne,22-177,G,2/1/17,OKC,CHI,0,19,3,10,0.3,2,8,0.25,1,2,0.5,0,0,,0,0,0,5,1,0,0,1,7,5.3
Austin Rivers,24-191,G,2/8/17,LAC,NYK,1,36,3,10,0.3,2,7,0.286,1,3,0.333,0,1,0,0,4,4,10,1,0,5,3,7,3.8
John Henson,25-350,C-F,12/12/16,MIL,TOR,1,14,3,5,0.6,3,5,0.6,0,0,,1,1,1,0,2,2,0,0,3,0,2,7,6.6
James Ennis,26-213,F,1/30/17,MEM,PHO,0,26,2,3,0.667,1,1,1,1,2,0.5,2,2,1,1,2,3,1,1,0,2,2,7,5.9
Ryan Anderson,28-304,F,3/6/17,HOU,SAS,1,25,3,6,0.5,2,2,1,1,4,0.25,0,0,,1,1,2,0,0,0,0,1,7,4.6
Jerian Grant,24-117,G,2/3/17,CHI,HOU,1,17,2,4,0.5,1,1,1,1,3,0.333,2,2,1,0,0,0,2,0,0,1,0,7,5.4
Jeff Green,30-059,F,10/26/16,ORL,MIA,0,25,2,7,0.286,2,5,0.4,0,2,0,3,4,0.75,1,2,3,1,0,0,1,1,7,3.1
Jonathan Gibson,29-029,G,12/7/16,DAL,SAC,0,28,3,12,0.25,2,7,0.286,1,5,0.2,0,0,,0,2,2,0,1,0,1,2,7,-0.4
Solomon Hill,25-329,F,2/10/17,NOP,MIN,1,37,2,8,0.25,1,2,0.5,1,6,0.167,2,2,1,1,5,6,7,1,1,2,2,7,8.2
Nicolas Brussino,24-031,G-F,4/2/17,DAL,MIL,0,17,2,4,0.5,1,2,0.5,1,2,0.5,2,2,1,1,2,3,1,0,0,0,2,7,6.2
Willie Reed,26-261,F-C,2/1/17,MIA,ATL,0,18,3,5,0.6,3,5,0.6,0,0,,1,2,0.5,1,3,4,0,1,0,1,1,7,5.5
Marquese Chriss,19-269,F,3/28/17,PHO,ATL,1,19,2,11,0.182,1,6,0.167,1,5,0.2,2,4,0.5,2,1,3,1,0,1,2,5,7,-1.6
Norman Powell,23-218,G,12/29/16,TOR,PHO,0,22,2,7,0.286,1,5,0.2,1,2,0.5,2,2,1,0,5,5,1,1,1,2,2,7,4
DeAndre Jordan,28-116,C,11/14/16,LAC,BRK,1,25,3,6,0.5,3,6,0.5,0,0,,1,2,0.5,5,9,14,0,1,1,3,1,7,8.1
Arron Afflalo,31-021,G,11/5/16,SAC,MIL,1,23,2,10,0.2,1,7,0.143,1,3,0.333,2,2,1,1,1,2,0,0,0,0,3,7,0.6
Austin Rivers,24-217,G,3/6/17,LAC,BOS,0,32,2,4,0.5,1,3,0.333,1,1,1,2,2,1,0,3,3,3,0,0,3,4,7,3.4
Seth Curry,26-145,G,1/15/17,DAL,MIN,1,32,2,9,0.222,1,5,0.2,1,4,0.25,2,2,1,1,2,3,0,3,0,1,0,7,4.8
Jared Dudley,31-236,F-G,3/3/17,PHO,OKC,0,26,3,4,0.75,2,2,1,1,2,0.5,0,0,,0,5,5,5,0,1,2,5,7,7.1
Sam Dekker,22-245,F,1/6/17,HOU,ORL,0,18,3,5,0.6,2,3,0.667,1,2,0.5,0,0,,4,4,8,1,1,0,1,1,7,9
Shelvin Mack,26-220,G,11/28/16,UTA,MIN,0,14,3,4,0.75,2,3,0.667,1,1,1,0,0,,0,1,1,0,1,0,2,2,7,3.9
Evan Turner,28-013,G,11/9/16,POR,LAC,0,20,3,8,0.375,3,6,0.5,0,2,0,1,1,1,3,3,6,2,0,0,0,4,7,5.4
Al-Farouq Aminu,26-119,F,1/18/17,POR,CHO,1,30,2,7,0.286,1,2,0.5,1,5,0.2,2,2,1,1,6,7,2,2,2,2,1,7,7.8
Taj Gibson,31-249,F,2/28/17,OKC,UTA,0,26,2,4,0.5,2,4,0.5,0,0,,3,4,0.75,1,2,3,2,0,2,1,3,7,6.5
Danny Green,29-221,G-F,1/29/17,SAS,DAL,1,31,3,6,0.5,2,2,1,1,4,0.25,0,0,,0,4,4,5,0,2,0,3,7,8.9
Frank Kaminsky,23-287,F-C,1/16/17,CHO,BOS,0,19,3,6,0.5,2,4,0.5,1,2,0.5,0,0,,0,1,1,2,0,0,0,1,7,5.3
David Nwaba,24-048,G,3/3/17,LAL,BOS,0,20,2,2,1,2,2,1,0,0,,3,4,0.75,0,2,2,0,0,1,0,3,7,6.1
Ersan Ilyasova,29-326,F,4/6/17,ATL,BOS,1,27,2,8,0.25,1,5,0.2,1,3,0.333,2,2,1,3,4,7,4,0,1,1,5,7,6
Spencer Dinwiddie,23-305,G,2/5/17,BRK,TOR,0,21,1,2,0.5,0,1,0,1,1,1,4,4,1,0,0,0,3,1,1,2,1,7,7.4
Mason Plumlee,26-332,C-F,1/31/17,POR,CHO,1,23,2,3,0.667,2,3,0.667,0,0,,3,6,0.5,3,8,11,2,2,0,3,0,7,9.4
Tarik Black,25-005,C-F,11/27/16,LAL,ATL,0,28,3,7,0.429,3,7,0.429,0,0,,1,1,1,2,6,8,1,2,2,1,1,7,9.2
Kenneth Faried,27-139,F,4/7/17,DEN,NOP,1,17,3,5,0.6,3,5,0.6,0,0,,1,3,0.333,1,5,6,1,1,0,2,2,7,5
Courtney Lee,31-042,G,11/14/16,NYK,DAL,1,32,3,7,0.429,2,4,0.5,1,3,0.333,0,0,,0,2,2,2,1,0,1,1,7,4.9
Jakob Poeltl,21-013,C,10/28/16,TOR,CLE,0,11,3,5,0.6,3,5,0.6,0,0,,1,1,1,4,3,7,0,0,0,0,1,7,8
Jamal Crawford,36-305,G,1/19/17,LAC,MIN,0,25,3,14,0.214,3,10,0.3,0,4,0,1,2,0.5,3,5,8,3,0,1,1,2,7,2.6
Robert Covington,26-031,F,1/14/17,PHI,WAS,1,22,2,6,0.333,1,2,0.5,1,4,0.25,2,2,1,0,4,4,1,0,0,1,0,7,4.5
Courtney Lee,31-029,G,11/1/16,NYK,DET,1,29,3,7,0.429,2,4,0.5,1,3,0.333,0,0,,0,2,2,2,0,0,2,2,7,2.5
Brook Lopez,28-208,C,10/26/16,BRK,BOS,1,21,1,7,0.143,0,5,0,1,2,0.5,4,4,1,2,3,5,0,0,0,2,1,7,2.4
Terrence Ross,25-269,F-G,10/31/16,TOR,DEN,0,15,2,5,0.4,1,2,0.5,1,3,0.333,2,2,1,0,2,2,0,1,0,0,2,7,5.1
Steven Adams,23-193,C,1/29/17,OKC,CLE,1,27,3,4,0.75,3,4,0.75,0,0,,1,1,1,2,8,10,1,0,1,4,3,7,5.4
Kelly Oubre,21-082,F,3/1/17,WAS,TOR,0,24,2,7,0.286,1,3,0.333,1,4,0.25,2,2,1,0,3,3,2,0,1,4,3,7,0.7
Spencer Hawes,28-217,C-F,12/1/16,CHO,DAL,0,13,3,3,1,3,3,1,0,0,,1,1,1,0,3,3,1,1,1,0,1,7,9
Darrell Arthur,28-302,F,1/21/17,DEN,LAC,0,13,3,5,0.6,2,2,1,1,3,0.333,0,0,,0,2,2,0,1,0,0,0,7,6.3
Luc Mbah a Moute,30-063,F,11/11/16,LAC,OKC,1,31,3,6,0.5,2,4,0.5,1,2,0.5,0,0,,2,4,6,0,2,1,1,2,7,7.5
Jae Crowder,26-225,F,2/16/17,BOS,CHI,1,33,3,8,0.375,3,4,0.75,0,4,0,1,2,0.5,2,1,3,0,0,0,1,3,7,1.7
Ed Davis,27-190,F,12/12/16,POR,LAC,0,14,0,1,0,0,1,0,0,0,,7,8,0.875,2,3,5,0,1,0,1,2,7,7.4
Marcus Morris,27-073,F,11/14/16,DET,OKC,1,30,3,12,0.25,2,9,0.222,1,3,0.333,0,0,,1,5,6,5,0,0,0,1,7,5.1
Lucas Nogueira,24-203,C,2/14/17,TOR,CHI,0,25,3,4,0.75,3,4,0.75,0,0,,1,3,0.333,0,3,3,0,1,0,4,3,7,1.3
Tarik Black,25-013,C-F,12/5/16,LAL,UTA,0,12,3,5,0.6,3,5,0.6,0,0,,1,2,0.5,4,1,5,0,2,0,1,2,7,7.6
Wesley Matthews,30-148,G,3/11/17,DAL,PHO,1,35,1,6,0.167,0,2,0,1,4,0.25,4,4,1,3,4,7,3,1,0,1,5,7,6.6
Andrew Harrison,22-026,G,11/23/16,MEM,PHI,0,42,2,6,0.333,1,2,0.5,1,4,0.25,2,2,1,0,4,4,6,4,1,2,5,7,9.7
DeAndre Jordan,28-171,C,1/8/17,LAC,MIA,1,34,2,4,0.5,2,4,0.5,0,0,,3,8,0.375,2,16,18,0,0,1,1,2,7,8.1
Jonathon Simmons,27-127,G-F,1/19/17,SAS,DEN,0,14,3,9,0.333,3,8,0.375,0,1,0,1,2,0.5,0,4,4,1,1,0,1,0,7,3.4
DeAndre' Bembry,22-282,F,4/12/17,ATL,IND,1,32,3,6,0.5,2,4,0.5,1,2,0.5,0,0,,2,5,7,2,1,1,2,3,7,6.8
P.J. Tucker,31-326,F,3/27/17,TOR,ORL,1,33,3,5,0.6,2,3,0.667,1,2,0.5,0,0,,0,5,5,1,3,1,0,2,7,9.8
Patrick Beverley,28-193,G,1/21/17,HOU,MEM,1,30,3,10,0.3,2,5,0.4,1,5,0.2,0,0,,0,7,7,4,1,0,1,3,7,4.9
Malcolm Delaney,27-254,G,11/20/16,ATL,NYK,0,21,1,4,0.25,1,3,0.333,0,1,0,5,5,1,0,4,4,1,1,0,4,1,7,3.1
Meyers Leonard,24-269,C-F,11/22/16,POR,NYK,0,19,2,9,0.222,1,2,0.5,1,7,0.143,2,2,1,0,1,1,1,1,0,0,3,7,2.3
Tony Snell,25-017,G-F,11/27/16,MIL,ORL,1,35,3,7,0.429,3,3,1,0,4,0,1,2,0.5,0,8,8,0,1,0,0,1,7,5.9
James Ennis,26-222,F,2/8/17,MEM,PHO,0,22,2,3,0.667,1,1,1,1,2,0.5,2,3,0.667,1,3,4,0,0,2,1,2,7,6.5
Shabazz Muhammad,24-038,F-G,12/21/16,MIN,ATL,0,19,3,10,0.3,2,7,0.286,1,3,0.333,0,0,,3,2,5,0,1,0,1,0,7,3.9
Spencer Dinwiddie,23-271,G,1/2/17,BRK,UTA,0,13,3,6,0.5,3,4,0.75,0,2,0,1,3,0.333,0,1,1,4,1,0,1,0,7,6.3
Tim Frazier,26-125,G,3/6/17,NOP,UTA,0,29,2,4,0.5,1,2,0.5,1,2,0.5,2,4,0.5,1,3,4,3,0,0,1,2,7,6.1
Jonas Jerebko,29-314,F,1/10/17,BOS,TOR,0,17,2,3,0.667,1,2,0.5,1,1,1,2,2,1,0,2,2,1,1,0,0,3,7,6.8
Gorgui Dieng,27-052,C,3/11/17,MIN,MIL,1,24,2,4,0.5,2,4,0.5,0,0,,3,3,1,2,4,6,0,0,1,0,1,7,7.9
Rodney McGruder,25-231,G,3/17/17,MIA,MIN,1,20,3,8,0.375,2,3,0.667,1,5,0.2,0,0,,2,1,3,2,1,0,0,1,7,6.3
Dwight Powell,25-244,F-C,3/21/17,DAL,GSW,0,8,3,5,0.6,3,3,1,0,2,0,1,2,0.5,1,0,1,0,0,0,0,5,7,3
John Henson,25-306,C-F,10/29/16,MIL,BRK,0,21,3,6,0.5,3,6,0.5,0,0,,1,2,0.5,2,10,12,3,2,2,1,3,7,11.3
Iman Shumpert,26-259,G,3/12/17,CLE,HOU,1,30,2,9,0.222,1,3,0.333,1,6,0.167,2,2,1,0,5,5,2,0,2,1,2,7,4
Jonas Jerebko,29-268,F,11/25/16,BOS,SAS,0,11,3,4,0.75,2,3,0.667,1,1,1,0,0,,0,3,3,0,0,0,0,0,7,6.3
Kris Humphries,31-349,F-C,1/20/17,ATL,CHI,0,20,3,6,0.5,2,4,0.5,1,2,0.5,0,0,,3,6,9,2,1,1,0,4,7,9.4
Jaylen Brown,20-005,F,10/29/16,BOS,CHO,0,13,3,6,0.5,3,6,0.5,0,0,,1,1,1,1,0,1,0,0,0,0,1,7,4.3
Andrew Wiggins,21-270,F-G,11/19/16,MIN,MEM,1,32,2,11,0.182,2,8,0.25,0,3,0,3,4,0.75,0,4,4,1,0,1,5,1,7,-3.1
Courtney Lee,31-121,G,2/1/17,NYK,BRK,1,28,3,7,0.429,3,5,0.6,0,2,0,1,2,0.5,2,2,4,2,2,0,0,2,7,7.5
Jordan Clarkson,24-156,G,11/10/16,LAL,SAC,0,22,3,7,0.429,2,4,0.5,1,3,0.333,0,0,,0,3,3,5,1,0,3,2,7,4.9
Ben McLemore,24-049,G,4/1/17,SAC,MIN,1,18,3,4,0.75,3,4,0.75,0,0,,1,2,0.5,2,1,3,0,0,0,4,5,7,0.7
Alec Burks,25-184,G,1/20/17,UTA,DAL,0,12,1,3,0.333,0,0,,1,3,0.333,4,6,0.667,0,2,2,0,0,0,0,1,7,4.7
D'Angelo Russell,20-264,G,11/13/16,LAL,MIN,1,26,3,10,0.3,2,5,0.4,1,5,0.2,0,1,0,0,4,4,4,3,0,3,3,7,3.6
Gorgui Dieng,27-049,C,3/8/17,MIN,LAC,1,39,3,6,0.5,3,6,0.5,0,0,,1,2,0.5,3,6,9,2,4,2,1,3,7,12.1
Joakim Noah,31-265,C,11/16/16,NYK,DET,1,25,3,7,0.429,3,7,0.429,0,0,,1,6,0.167,7,8,15,3,1,3,1,2,7,12
Kris Humphries,32-002,F-C,2/8/17,ATL,DEN,0,13,3,4,0.75,2,2,1,1,2,0.5,0,0,,0,4,4,1,0,0,0,3,7,6.1
Shaun Livingston,31-117,G,1/6/17,GSW,MEM,0,16,3,4,0.75,3,4,0.75,0,0,,1,2,0.5,0,2,2,2,1,0,3,2,7,4.2
Jason Smith,30-318,F-C,1/14/17,WAS,PHI,0,13,3,6,0.5,2,5,0.4,1,1,1,0,0,,2,2,4,1,0,1,1,5,7,4.4
Rakeem Christmas,25-101,F,3/12/17,IND,MIA,0,18,3,5,0.6,3,5,0.6,0,0,,1,2,0.5,3,2,5,0,0,0,0,2,7,6.2
Allen Crabbe,24-279,G-F,1/13/17,POR,ORL,1,33,3,10,0.3,2,5,0.4,1,5,0.2,0,0,,0,3,3,2,1,0,1,1,7,3.1
Norris Cole,28-140,G,3/2/17,OKC,POR,0,11,2,5,0.4,1,4,0.25,1,1,1,2,2,1,0,1,1,2,1,0,0,0,7,7
Bismack Biyombo,24-223,C-F,4/8/17,ORL,IND,0,17,3,3,1,3,3,1,0,0,,1,4,0.25,1,3,4,1,1,0,1,2,7,6.4
Nik Stauskas,23-106,G,1/21/17,PHI,ATL,1,35,3,11,0.273,2,7,0.286,1,4,0.25,0,0,,0,6,6,3,0,1,1,1,7,3.7
Isaiah Whitehead,21-303,G,1/5/17,BRK,IND,1,13,3,7,0.429,2,5,0.4,1,2,0.5,0,0,,0,2,2,1,0,1,1,3,7,3.1
P.J. Tucker,31-281,F,2/10/17,PHO,CHI,0,34,2,5,0.4,1,2,0.5,1,3,0.333,2,2,1,1,6,7,2,3,0,1,2,7,9.4
Isaiah Whitehead,21-318,G,1/20/17,BRK,NOP,0,29,3,8,0.375,3,6,0.5,0,2,0,1,2,0.5,1,2,3,2,2,1,2,3,7,4.4
Dante Cunningham,29-329,F,3/17/17,NOP,HOU,1,39,3,5,0.6,3,3,1,0,2,0,1,2,0.5,3,6,9,1,1,1,2,1,7,8.2
Brandon Knight,24-329,G,10/26/16,PHO,SAC,0,26,1,8,0.125,1,5,0.2,0,3,0,5,6,0.833,0,1,1,5,0,0,2,1,7,2.8
Aaron Gordon,21-093,F,12/18/16,ORL,TOR,1,20,3,9,0.333,2,5,0.4,1,4,0.25,0,0,,0,1,1,0,0,0,1,2,7,0.4
D.J. Augustin,29-105,G,2/23/17,ORL,POR,0,26,2,7,0.286,1,6,0.167,1,1,1,2,2,1,0,0,0,2,1,0,2,2,7,2.5
Corey Brewer,30-326,F-G,1/25/17,HOU,BOS,0,24,3,4,0.75,3,4,0.75,0,0,,1,2,0.5,0,2,2,1,1,0,2,2,7,4.5
Aaron Gordon,21-135,F,1/29/17,ORL,TOR,1,26,3,8,0.375,2,5,0.4,1,3,0.333,0,0,,2,1,3,1,0,0,0,4,7,3.4
Sean Kilpatrick,27-040,G,2/15/17,BRK,MIL,0,19,3,9,0.333,2,4,0.5,1,5,0.2,0,0,,0,1,1,2,0,0,1,2,7,1.8
Luis Scola,36-260,F,1/15/17,BRK,HOU,0,8,2,3,0.667,1,1,1,1,2,0.5,2,2,1,0,4,4,0,1,0,1,2,7,6.1
Tony Parker,34-178,G,11/11/16,SAS,DET,1,21,3,11,0.273,3,9,0.333,0,2,0,1,2,0.5,0,2,2,4,0,0,0,2,7,2.7
Devin Harris,33-282,G,12/5/16,DAL,CHO,0,18,2,4,0.5,1,1,1,1,3,0.333,2,2,1,0,3,3,2,2,0,1,2,7,7.5
Mike Dunleavy,36-206,F-G,4/9/17,ATL,CLE,0,15,2,5,0.4,1,3,0.333,1,2,0.5,2,3,0.667,0,0,0,2,1,0,0,3,7,5.1
Luol Deng,31-244,F,12/16/16,LAL,PHI,1,32,3,8,0.375,2,3,0.667,1,5,0.2,0,0,,1,5,6,3,1,0,0,0,7,7.9
Anthony Tolliver,31-243,F-C,1/30/17,SAC,PHI,0,21,2,4,0.5,0,1,0,2,3,0.667,1,2,0.5,1,3,4,1,1,0,1,2,7,6.1
Marco Belinelli,30-259,G-F,12/9/16,CHO,ORL,0,21,3,6,0.5,3,5,0.6,0,1,0,1,1,1,0,3,3,1,0,0,0,1,7,5.2
Joe Ingles,29-116,F-G,1/26/17,UTA,LAL,0,26,2,4,0.5,1,1,1,1,3,0.333,2,2,1,1,3,4,2,3,0,1,1,7,9.6
Rodney McGruder,25-168,G,1/13/17,MIA,MIL,1,20,3,5,0.6,2,2,1,1,3,0.333,0,0,,0,0,0,2,0,0,0,3,7,4.9
Michael Beasley,27-295,F,10/30/16,MIL,DET,0,16,3,5,0.6,3,3,1,0,2,0,1,2,0.5,0,1,1,2,2,0,2,3,7,4.8
John Henson,25-337,C-F,11/29/16,MIL,CLE,1,21,3,7,0.429,3,7,0.429,0,0,,1,1,1,4,5,9,2,0,2,0,1,7,10
Patrick Patterson,27-321,F,1/29/17,TOR,ORL,1,29,2,4,0.5,1,2,0.5,1,2,0.5,2,3,0.667,3,7,10,1,0,1,1,1,7,8.8
Jeff Green,30-167,F,2/11/17,ORL,DAL,0,15,3,8,0.375,3,6,0.5,0,2,0,1,1,1,1,2,3,1,0,0,0,1,7,4.2
Tyreke Evans,27-095,G-F,12/23/16,NOP,MIA,0,15,1,7,0.143,0,5,0,1,2,0.5,4,4,1,0,5,5,5,1,0,1,2,7,6.7
Bojan Bogdanovic,27-208,G-F,11/12/16,BRK,PHO,1,31,2,6,0.333,1,2,0.5,1,4,0.25,2,3,0.667,0,5,5,2,0,0,2,0,7,4.1
Marcus Morris,27-077,F,11/18/16,DET,CLE,1,31,3,11,0.273,2,7,0.286,1,4,0.25,0,0,,1,2,3,4,1,0,0,0,7,5.6
Nikola Mirotic,25-321,F,12/28/16,CHI,BRK,0,25,1,7,0.143,0,3,0,1,4,0.25,4,4,1,1,3,4,0,0,3,3,4,7,1.6
Jeff Teague,28-264,G,3/1/17,IND,SAS,1,31,2,6,0.333,1,4,0.25,1,2,0.5,2,3,0.667,1,4,5,9,1,0,1,1,7,11
DeAndre Jordan,28-186,C,1/23/17,LAC,ATL,1,35,1,1,1,1,1,1,0,0,,5,8,0.625,3,9,12,4,0,3,0,2,7,14.4
Willy Hernangomez,22-177,C,11/20/16,NYK,ATL,0,29,3,4,0.75,3,4,0.75,0,0,,1,3,0.333,2,6,8,1,0,0,3,3,7,4.3
Anthony Davis,23-362,F-C,3/8/17,NOP,TOR,1,17,2,4,0.5,2,4,0.5,0,0,,3,5,0.6,0,4,4,1,0,0,1,1,7,4.7
Brandon Bass,31-268,F,1/23/17,LAC,ATL,0,15,1,2,0.5,1,2,0.5,0,0,,5,5,1,1,3,4,0,0,1,1,2,7,6.5
Marcus Thornton,29-211,G,1/2/17,WAS,HOU,0,18,3,8,0.375,2,5,0.4,1,3,0.333,0,0,,0,3,3,0,1,0,1,2,7,2.7
Malcolm Delaney,27-287,G,12/23/16,ATL,DEN,0,30,3,8,0.375,2,5,0.4,1,3,0.333,0,0,,1,1,2,3,0,0,1,3,7,3.5
Matthew Dellavedova,26-074,G,11/21/16,MIL,ORL,1,27,3,7,0.429,2,2,1,1,5,0.2,0,0,,0,1,1,4,1,0,6,4,7,-0.2
Shaun Livingston,31-201,G,3/31/17,GSW,HOU,0,21,3,4,0.75,3,4,0.75,0,0,,1,2,0.5,0,3,3,2,0,0,0,2,7,6.5
E'Twaun Moore,28-021,G,3/21/17,NOP,MEM,0,25,3,7,0.429,2,4,0.5,1,3,0.333,0,0,,0,0,0,1,1,0,2,2,7,2.2
Darrell Arthur,28-346,F,3/6/17,DEN,SAC,0,17,2,8,0.25,1,5,0.2,1,3,0.333,2,2,1,0,4,4,3,2,0,0,1,7,7.1
Tyus Jones,20-302,G,3/8/17,MIN,LAC,0,18,3,4,0.75,2,2,1,1,2,0.5,0,0,,0,2,2,3,0,0,1,1,7,6.7
Skal Labissiere,20-358,F,3/11/17,SAC,DEN,0,20,3,7,0.429,3,7,0.429,0,0,,1,5,0.2,2,3,5,1,0,0,2,2,7,1.9
Alec Burks,25-201,G,2/6/17,UTA,ATL,0,21,3,5,0.6,2,2,1,1,3,0.333,0,0,,0,1,1,4,0,1,0,0,7,8.5
Hollis Thompson,25-252,G-F,12/11/16,PHI,DET,0,15,3,5,0.6,2,2,1,1,3,0.333,0,0,,1,1,2,0,0,1,0,0,7,6.4
Joffrey Lauvergne,25-159,C-F,3/8/17,CHI,ORL,0,29,2,6,0.333,1,3,0.333,1,3,0.333,2,4,0.5,2,6,8,4,0,0,0,1,7,8.4
Aaron Gordon,21-088,F,12/13/16,ORL,ATL,1,18,3,6,0.5,2,3,0.667,1,3,0.333,0,0,,0,3,3,2,0,1,1,4,7,4.4
Rondae Hollis-Jefferson,21-350,F,12/18/16,BRK,PHI,0,19,3,5,0.6,3,4,0.75,0,1,0,1,4,0.25,1,4,5,1,1,1,3,3,7,3.6
Manu Ginobili,39-100,G,11/5/16,SAS,LAC,0,13,2,6,0.333,1,3,0.333,1,3,0.333,2,2,1,0,4,4,1,0,0,1,1,7,4.1
Tyler Ennis,22-203,G,3/15/17,LAL,HOU,0,9,3,4,0.75,3,3,1,0,1,0,1,1,1,1,0,1,1,0,0,0,1,7,6.4
Darrell Arthur,28-255,F,12/5/16,DEN,PHI,0,23,2,5,0.4,1,2,0.5,1,3,0.333,2,2,1,1,6,7,2,1,1,2,2,7,7.1
Corey Brewer,31-008,F-G,3/13/17,LAL,DEN,0,17,3,8,0.375,3,8,0.375,0,0,,1,2,0.5,2,2,4,1,2,0,1,1,7,5.5
Lance Thomas,28-201,F,11/11/16,NYK,BOS,0,20,3,7,0.429,2,4,0.5,1,3,0.333,0,0,,1,4,5,1,1,1,1,1,7,6.2
Luc Mbah a Moute,30-204,F,4/1/17,LAC,LAL,1,22,3,5,0.6,2,4,0.5,1,1,1,0,0,,0,1,1,0,0,2,0,3,7,5.2
Kyle O'Quinn,27-014,F-C,4/9/17,NYK,TOR,0,17,3,7,0.429,3,7,0.429,0,0,,1,1,1,0,2,2,0,0,0,1,0,7,2.9
Al-Farouq Aminu,26-132,F,1/31/17,POR,CHO,0,28,3,8,0.375,2,4,0.5,1,4,0.25,0,0,,1,9,10,3,1,0,2,2,7,6.3
Matt Barnes,36-284,F,12/18/16,SAC,DAL,0,25,3,7,0.429,2,3,0.667,1,4,0.25,0,0,,1,2,3,0,1,0,0,3,7,4.4
Ian Clark,25-321,G,1/22/17,GSW,ORL,0,14,3,8,0.375,2,4,0.5,1,4,0.25,0,0,,1,2,3,2,0,0,2,0,7,3.3
Nick Collison,36-052,F,12/17/16,OKC,PHO,0,6,3,3,1,3,3,1,0,0,,1,2,0.5,1,1,2,0,0,0,0,1,7,6.3
Jerami Grant,22-277,F,12/14/16,OKC,UTA,1,22,2,6,0.333,1,5,0.2,1,1,1,2,2,1,0,2,2,1,0,0,0,2,7,4.1
Rodney McGruder,25-225,G,3/11/17,MIA,TOR,1,26,3,5,0.6,2,2,1,1,3,0.333,0,2,0,0,1,1,1,0,0,1,1,7,3.5
Tim Hardaway,24-227,G,10/29/16,ATL,PHI,0,19,3,11,0.273,2,5,0.4,1,6,0.167,0,1,0,0,3,3,1,1,0,0,0,7,2.7
Vince Carter,40-060,G-F,3/27/17,MEM,SAC,1,28,2,7,0.286,1,4,0.25,1,3,0.333,2,2,1,2,2,4,0,0,1,0,2,7,4.8
Meyers Leonard,24-312,C-F,1/4/17,POR,GSW,0,11,1,2,0.5,1,2,0.5,0,0,,5,6,0.833,0,1,1,0,1,1,1,1,7,6.2
Jonas Valanciunas,24-294,C,2/24/17,TOR,BOS,1,18,3,4,0.75,3,4,0.75,0,0,,1,3,0.333,3,3,6,0,0,1,0,1,7,7.9
Sam Dekker,22-217,F,12/9/16,HOU,OKC,0,15,3,5,0.6,3,3,1,0,2,0,1,4,0.25,0,1,1,1,1,0,0,0,7,5.5
Yogi Ferrell,23-330,G,4/4/17,DAL,SAC,1,25,3,9,0.333,2,3,0.667,1,6,0.167,0,0,,0,0,0,5,0,1,3,1,7,2.7
Michael Carter-Williams,25-156,G,3/15/17,CHI,MEM,0,13,3,8,0.375,2,7,0.286,1,1,1,0,0,,1,1,2,1,2,1,0,3,7,5.8
Sheldon McClellan,24-000,G,12/21/16,WAS,CHI,0,19,2,3,0.667,2,3,0.667,0,0,,3,4,0.75,0,2,2,1,0,1,0,1,7,6.9
Marreese Speights,29-244,C-F,4/5/17,LAC,DAL,0,15,3,9,0.333,2,5,0.4,1,4,0.25,0,0,,2,7,9,0,0,0,2,4,7,1.8
Brandan Wright,29-167,F-C,3/21/17,MEM,NOP,0,20,3,3,1,3,3,1,0,0,,1,2,0.5,0,2,2,0,1,1,0,3,7,6.8
Seth Curry,26-109,G,12/10/16,DAL,HOU,0,26,3,5,0.6,2,3,0.667,1,2,0.5,0,0,,0,3,3,3,1,0,0,1,7,8.3
Jonathon Simmons,27-125,G-F,1/17/17,SAS,MIN,0,12,1,1,1,1,1,1,0,0,,5,6,0.833,0,0,0,1,1,0,0,2,7,7.2
Josh Huestis,25-044,F,2/1/17,OKC,CHI,0,7,3,4,0.75,2,2,1,1,2,0.5,0,0,,2,2,4,1,0,1,0,0,7,8.8
Myles Turner,20-244,F-C,11/23/16,IND,ATL,1,35,2,5,0.4,1,4,0.25,1,1,1,2,2,1,1,8,9,1,3,2,2,2,7,9.7
P.J. Tucker,31-243,F,1/3/17,PHO,MIA,0,32,3,5,0.6,3,3,1,0,2,0,1,1,1,2,4,6,4,0,0,1,2,7,8.3
Patrick Beverley,28-199,G,1/27/17,HOU,PHI,1,33,2,5,0.4,1,2,0.5,1,3,0.333,2,2,1,0,3,3,6,0,0,3,5,7,4.4
Bismack Biyombo,24-194,C-F,3/10/17,ORL,CHO,1,29,3,3,1,3,3,1,0,0,,1,8,0.125,2,8,10,1,0,1,0,3,7,7.3
Meyers Leonard,25-044,C-F,4/12/17,POR,NOP,1,36,3,11,0.273,2,7,0.286,1,4,0.25,0,0,,0,9,9,1,0,1,1,4,7,2
David Lee,33-346,F,4/10/17,SAS,POR,0,28,2,6,0.333,2,6,0.333,0,0,,3,6,0.5,5,3,8,2,0,2,2,0,7,7.6
Jason Smith,30-301,F-C,12/28/16,WAS,IND,0,18,3,4,0.75,2,3,0.667,1,1,1,0,2,0,3,4,7,1,0,0,1,3,7,6.4
Tyler Ulis,21-061,G,3/7/17,PHO,WAS,0,22,3,8,0.375,3,7,0.429,0,1,0,1,2,0.5,0,2,2,5,1,0,1,1,7,5.9
Thomas Robinson,26-023,F,4/9/17,LAL,MIN,0,18,3,6,0.5,3,6,0.5,0,0,,1,1,1,0,7,7,1,0,0,3,3,7,2.6
David Lee,33-277,F,1/31/17,SAS,OKC,0,26,3,7,0.429,3,7,0.429,0,0,,1,2,0.5,2,5,7,0,0,1,2,2,7,3.7
Willie Reed,26-314,F-C,3/26/17,MIA,BOS,0,18,3,3,1,3,3,1,0,0,,1,2,0.5,0,6,6,0,0,0,0,3,7,6.3
Luke Babbitt,27-197,F,1/3/17,MIA,PHO,1,23,3,11,0.273,2,7,0.286,1,4,0.25,0,2,0,0,5,5,0,0,0,0,2,7,0.4
Devin Harris,33-333,G,1/25/17,DAL,NYK,0,22,2,8,0.25,1,5,0.2,1,3,0.333,2,4,0.5,0,4,4,2,1,0,1,1,7,3.6
Boban Marjanovic,28-084,C,11/7/16,DET,LAC,0,8,1,4,0.25,1,4,0.25,0,0,,5,5,1,2,0,2,0,0,0,0,1,7,5.6
Aron Baynes,30-108,C,3/27/17,DET,NYK,0,22,2,4,0.5,2,4,0.5,0,0,,3,4,0.75,3,5,8,1,0,1,1,2,7,7.8
Bojan Bogdanovic,27-351,G-F,4/4/17,WAS,CHO,0,12,3,6,0.5,2,3,0.667,1,3,0.333,0,0,,1,1,2,1,0,0,2,0,7,3.7
Montrezl Harrell,22-318,F-C,12/9/16,HOU,OKC,0,13,3,4,0.75,3,4,0.75,0,0,,1,3,0.333,1,1,2,0,1,0,1,4,7,4
David Nwaba,24-064,G,3/19/17,LAL,CLE,0,22,3,5,0.6,3,5,0.6,0,0,,1,2,0.5,1,4,5,0,1,0,0,3,7,6
Malcolm Brogdon,23-331,G,11/6/16,MIL,DAL,0,20,2,7,0.286,2,5,0.4,0,2,0,3,4,0.75,0,1,1,0,2,0,1,3,7,2.6
Trevor Ariza,31-211,F,1/27/17,HOU,PHI,1,41,1,6,0.167,0,0,,1,6,0.167,4,4,1,0,5,5,2,4,0,2,3,7,6.9
Spencer Hawes,28-334,C-F,3/28/17,MIL,CHO,0,11,3,5,0.6,2,3,0.667,1,2,0.5,0,1,0,1,2,3,2,0,0,1,2,7,5.2
Corey Brewer,30-261,F-G,11/21/16,HOU,DET,0,13,2,3,0.667,1,1,1,1,2,0.5,2,4,0.5,0,1,1,0,0,0,0,1,7,4.8
Justin Holiday,27-231,G,11/22/16,NYK,POR,0,19,3,4,0.75,2,3,0.667,1,1,1,0,0,,0,5,5,4,0,0,1,2,7,7.9
Ricky Rubio,26-022,G,11/12/16,MIN,LAC,1,24,2,5,0.4,1,3,0.333,1,2,0.5,2,4,0.5,5,1,6,6,1,0,3,3,7,8.3
Devin Booker,20-000,G,10/30/16,PHO,GSW,1,28,3,12,0.25,2,8,0.25,1,4,0.25,0,0,,0,0,0,2,0,1,2,0,7,-0.1
Quincy Acy,26-149,F,3/4/17,BRK,POR,0,17,2,4,0.5,0,0,,2,4,0.5,1,2,0.5,0,1,1,0,0,0,1,3,7,2.7
Luc Mbah a Moute,30-086,F,12/4/16,LAC,IND,1,27,3,5,0.6,2,3,0.667,1,2,0.5,0,0,,3,1,4,1,0,2,3,1,7,5.8
Kyle O'Quinn,26-223,F-C,11/4/16,NYK,CHI,0,13,3,7,0.429,3,7,0.429,0,0,,1,2,0.5,2,1,3,1,3,0,0,0,7,8.3
Tim Hardaway,24-278,G,12/19/16,ATL,OKC,0,22,3,7,0.429,2,4,0.5,1,3,0.333,0,0,,0,2,2,1,1,0,3,4,7,1
Ron Baker,23-357,G,3/22/17,NYK,UTA,0,21,2,5,0.4,1,4,0.25,1,1,1,2,2,1,0,2,2,2,0,0,1,2,7,4.5
Lucas Nogueira,24-189,C,1/31/17,TOR,NOP,0,22,3,4,0.75,3,4,0.75,0,0,,1,2,0.5,4,4,8,0,1,2,0,4,7,9.8
Alex Abrines,23-161,G-F,1/9/17,OKC,CHI,0,19,3,6,0.5,2,3,0.667,1,3,0.333,0,0,,0,2,2,2,0,1,1,0,7,5.7
DeAndre Jordan,28-157,C,12/25/16,LAC,LAL,1,28,3,4,0.75,3,4,0.75,0,0,,1,4,0.25,1,9,10,6,0,0,4,1,7,7.4
Jerian Grant,24-107,G,1/24/17,CHI,ORL,1,20,1,4,0.25,0,0,,1,4,0.25,4,5,0.8,0,3,3,0,0,0,3,2,7,1.3
Marquese Chriss,19-224,F,2/11/17,PHO,HOU,1,32,3,11,0.273,3,7,0.429,0,4,0,1,1,1,2,4,6,3,0,0,1,3,7,3
Chandler Parsons,28-082,F,1/15/17,MEM,CHI,1,19,2,6,0.333,1,3,0.333,1,3,0.333,2,2,1,0,1,1,4,0,0,0,3,7,5.5
Deron Williams,32-230,G,2/11/17,DAL,ORL,1,16,3,6,0.5,2,3,0.667,1,3,0.333,0,0,,0,0,0,4,3,0,1,1,7,8.4
Mike Muscala,25-275,F-C,4/2/17,ATL,BRK,0,12,3,4,0.75,2,3,0.667,1,1,1,0,0,,1,2,3,0,0,0,0,0,7,6.7
Archie Goodwin,22-087,G,11/12/16,NOP,LAL,0,10,1,1,1,0,0,,1,1,1,4,4,1,0,0,0,0,0,0,0,0,7,6.7
Wilson Chandler,29-332,F,4/7/17,DEN,NOP,0,29,3,6,0.5,2,2,1,1,4,0.25,0,0,,0,7,7,2,2,0,0,4,7,7.9
Domantas Sabonis,20-201,F,11/20/16,OKC,IND,1,20,3,10,0.3,2,5,0.4,1,5,0.2,0,0,,3,3,6,0,2,0,2,2,7,3.4
Marco Belinelli,30-297,G-F,1/16/17,CHO,BOS,0,18,3,7,0.429,2,3,0.667,1,4,0.25,0,0,,0,1,1,3,0,0,0,1,7,5.3
Ian Clark,26-024,G,3/31/17,GSW,HOU,0,16,3,6,0.5,2,2,1,1,4,0.25,0,0,,0,2,2,0,0,0,1,0,7,3.6
Michael Kidd-Gilchrist,23-157,F,3/2/17,CHO,PHO,1,29,3,7,0.429,3,7,0.429,0,0,,1,2,0.5,5,3,8,1,6,0,3,4,7,9.4
T.J. McConnell,24-306,G,1/25/17,PHI,MIL,1,30,3,5,0.6,2,4,0.5,1,1,1,0,0,,0,3,3,13,3,0,3,1,7,14.3
P.J. Tucker,31-216,F,12/7/16,PHO,IND,1,34,3,12,0.25,2,7,0.286,1,5,0.2,0,0,,2,2,4,1,1,0,1,2,7,1.7
Garrett Temple,30-314,G,3/18/17,SAC,OKC,1,28,2,8,0.25,1,2,0.5,1,6,0.167,2,2,1,1,2,3,4,3,0,2,2,7,6.5
Andrew Harrison,22-085,G,1/21/17,MEM,HOU,0,15,2,5,0.4,1,1,1,1,4,0.25,2,2,1,0,0,0,0,0,0,0,3,7,3.1
Jonathan Gibson,29-013,G,11/21/16,DAL,SAS,0,16,2,6,0.333,2,4,0.5,0,2,0,3,4,0.75,1,0,1,2,1,0,0,1,7,5.9
Tobias Harris,24-159,F,12/21/16,DET,MEM,1,27,3,7,0.429,2,5,0.4,1,2,0.5,0,0,,0,6,6,3,1,1,2,0,7,6.9
Malcolm Brogdon,24-005,G,12/16/16,MIL,CHI,0,27,3,8,0.375,2,4,0.5,1,4,0.25,0,0,,0,2,2,1,0,0,2,1,7,1.5
Otto Porter,23-307,F,4/6/17,WAS,NYK,1,22,2,7,0.286,1,4,0.25,1,3,0.333,2,2,1,5,4,9,0,0,0,0,2,7,6.8
Alec Burks,25-228,G,3/5/17,UTA,SAC,0,15,3,6,0.5,3,4,0.75,0,2,0,1,1,1,1,2,3,1,2,0,3,1,7,4.6
Joffrey Lauvergne,25-128,C-F,2/5/17,OKC,POR,0,17,3,6,0.5,2,4,0.5,1,2,0.5,0,0,,4,5,9,2,0,0,2,4,7,6.1
Gerald Henderson,29-112,G,3/31/17,PHI,CLE,0,19,3,7,0.429,2,4,0.5,1,3,0.333,0,0,,0,4,4,3,0,0,0,1,7,6.2
Mario Hezonja,21-352,F-G,2/11/17,ORL,DAL,1,35,3,11,0.273,2,5,0.4,1,6,0.167,0,0,,0,6,6,2,2,1,3,1,7,3
Andre Iguodala,33-045,G-F,3/14/17,GSW,PHI,0,33,3,8,0.375,2,7,0.286,1,1,1,0,0,,0,1,1,3,0,0,0,3,7,3.8
Josh Richardson,23-169,G,3/3/17,MIA,ORL,0,24,1,3,0.333,0,1,0,1,2,0.5,4,4,1,1,3,4,0,0,0,1,3,7,4.7
Gorgui Dieng,27-028,C,2/15/17,MIN,DEN,1,28,3,9,0.333,2,7,0.286,1,2,0.5,0,0,,1,4,5,2,2,0,0,3,7,6
Boban Marjanovic,28-219,C,3/22/17,DET,CHI,0,8,3,3,1,3,3,1,0,0,,1,2,0.5,0,2,2,0,0,0,0,0,7,6.3
Spencer Dinwiddie,23-360,G,4/1/17,BRK,ORL,0,20,3,5,0.6,3,3,1,0,2,0,1,1,1,1,2,3,1,2,1,0,2,7,8.6
Vince Carter,39-302,G-F,11/23/16,MEM,PHI,0,39,3,11,0.273,2,5,0.4,1,6,0.167,0,1,0,0,2,2,0,0,1,1,3,7,-0.8
Richard Jefferson,36-232,F,2/8/17,CLE,IND,0,22,1,3,0.333,0,0,,1,3,0.333,4,4,1,1,1,2,1,0,1,0,3,7,6.5
Richard Jefferson,36-197,F,1/4/17,CLE,CHI,0,29,2,7,0.286,0,2,0,2,5,0.4,1,2,0.5,1,0,1,0,0,0,0,1,7,2.8
Aron Baynes,30-111,C,3/30/17,DET,BRK,0,19,3,7,0.429,3,7,0.429,0,0,,1,2,0.5,2,2,4,2,0,1,1,1,7,5.6
Wesley Matthews,30-021,G,11/4/16,DAL,POR,1,29,1,6,0.167,0,4,0,1,2,0.5,4,5,0.8,0,0,0,1,0,0,3,5,7,-1.5
Seth Curry,26-206,G,3/17/17,DAL,PHI,1,17,2,4,0.5,1,2,0.5,1,2,0.5,2,2,1,0,1,1,1,0,0,1,1,7,4.6
Juan Hernangomez,21-161,F,3/8/17,DEN,WAS,1,29,3,4,0.75,3,4,0.75,0,0,,1,3,0.333,1,9,10,1,2,1,2,2,7,8.6
Isaiah Whitehead,21-277,G,12/10/16,BRK,SAS,1,23,3,9,0.333,2,5,0.4,1,4,0.25,0,0,,0,0,0,2,1,0,3,3,7,0.1
Trey Burke,24-090,G,2/10/17,WAS,IND,0,14,3,9,0.333,2,7,0.286,1,2,0.5,0,0,,0,0,0,5,1,0,0,0,7,6.4
Jrue Holiday,26-197,G,12/26/16,NOP,DAL,1,36,2,11,0.182,2,10,0.2,0,1,0,3,4,0.75,0,3,3,11,1,0,1,2,7,7.5
Stanley Johnson,20-244,F,1/28/17,DET,MIA,0,16,3,4,0.75,2,3,0.667,1,1,1,0,1,0,0,1,1,0,0,1,0,2,7,5.2
Marcus Morris,27-082,F,11/23/16,DET,MIA,1,26,2,8,0.25,2,7,0.286,0,1,0,3,4,0.75,0,1,1,6,1,1,1,2,7,6.2
Richaun Holmes,23-025,F-C,11/9/16,PHI,IND,0,28,3,4,0.75,2,2,1,1,2,0.5,0,4,0,0,6,6,0,2,2,1,3,7,6.8
Courtney Lee,31-175,G,3/27/17,NYK,DET,1,33,3,6,0.5,2,4,0.5,1,2,0.5,0,0,,0,7,7,3,2,1,2,3,7,7.7
Jusuf Nurkic,22-200,C,3/11/17,POR,WAS,1,28,2,8,0.25,2,8,0.25,0,0,,3,4,0.75,2,5,7,2,1,3,5,5,7,2.2
Lavoy Allen,28-034,F-C,3/10/17,IND,MIL,0,15,3,5,0.6,3,5,0.6,0,0,,1,1,1,2,1,3,1,0,0,1,0,7,6.1
D.J. Augustin,29-048,G,12/28/16,ORL,CHO,1,16,2,5,0.4,1,2,0.5,1,3,0.333,2,2,1,0,0,0,3,0,0,3,1,7,3
Justin Hamilton,26-225,C,11/12/16,BRK,PHO,0,26,2,2,1,1,1,1,1,1,1,2,3,0.667,0,3,3,0,2,1,1,1,7,8.2
Dorian Finney-Smith,23-335,F,4/4/17,DAL,SAC,0,23,3,8,0.375,2,4,0.5,1,4,0.25,0,0,,1,0,1,0,3,2,1,1,7,6.3
Patty Mills,28-110,G,11/29/16,SAS,ORL,0,19,2,5,0.4,1,2,0.5,1,3,0.333,2,2,1,0,2,2,2,1,0,2,2,7,4.5
Julius Randle,22-049,F,1/17/17,LAL,DEN,1,25,2,8,0.25,2,8,0.25,0,0,,3,3,1,3,4,7,7,1,0,5,4,7,4.8
Mike Muscala,25-155,F-C,12/3/16,ATL,TOR,1,24,3,7,0.429,2,4,0.5,1,3,0.333,0,0,,2,2,4,2,2,1,3,1,7,6
Salah Mejri,30-184,C,12/16/16,DAL,UTA,1,21,3,3,1,3,3,1,0,0,,1,1,1,2,3,5,1,0,0,0,5,7,7.1
Seth Curry,26-128,G,12/29/16,DAL,LAL,0,25,3,6,0.5,2,5,0.4,1,1,1,0,0,,0,1,1,1,3,0,1,4,7,5.4
Richard Jefferson,36-271,F,3/19/17,CLE,LAL,0,29,3,4,0.75,3,3,1,0,1,0,1,2,0.5,0,5,5,1,1,0,0,3,7,7
Gerald Green,31-013,G-F,2/8/17,BOS,SAC,0,13,2,7,0.286,1,5,0.2,1,2,0.5,2,4,0.5,1,1,2,1,0,0,1,1,7,2.4
Joe Johnson,35-168,G-F,12/14/16,UTA,OKC,0,21,3,7,0.429,2,5,0.4,1,2,0.5,0,0,,0,4,4,2,0,0,0,1,7,5.5
D.J. Augustin,29-062,G,1/11/17,ORL,LAC,0,27,2,9,0.222,2,6,0.333,0,3,0,3,3,1,1,1,2,3,0,0,0,1,7,4.2
Mirza Teletovic,31-064,F,11/21/16,MIL,ORL,0,13,2,6,0.333,1,1,1,1,5,0.2,2,4,0.5,0,5,5,0,1,0,0,3,7,4.1
Jeff Teague,28-203,G,12/30/16,IND,CHI,1,35,2,13,0.154,2,11,0.182,0,2,0,3,4,0.75,0,5,5,17,2,0,3,1,7,10.3
Allen Crabbe,24-337,G-F,3/12/17,POR,PHO,0,34,3,8,0.375,2,4,0.5,1,4,0.25,0,0,,0,5,5,2,1,0,2,5,7,2.5
Marcin Gortat,33-024,C-F,3/13/17,WAS,MIN,1,23,3,5,0.6,3,5,0.6,0,0,,1,1,1,1,3,4,0,0,1,1,2,7,5.2
Shelvin Mack,26-196,G,11/4/16,UTA,SAS,0,21,2,8,0.25,1,6,0.167,1,2,0.5,2,2,1,0,1,1,2,1,0,2,2,7,2.1
Matt Barnes,36-282,F,12/16/16,SAC,MEM,0,29,2,8,0.25,2,4,0.5,0,4,0,3,6,0.5,2,8,10,3,0,1,2,0,7,5.6
Marcus Thornton,29-186,G,12/8/16,WAS,DEN,0,11,3,6,0.5,2,4,0.5,1,2,0.5,0,0,,0,3,3,1,0,0,0,1,7,5.2
Corey Brewer,31-037,F-G,4/11/17,LAL,NOP,0,24,3,6,0.5,3,6,0.5,0,0,,1,2,0.5,2,3,5,5,2,0,1,2,7,9.6
George Hill,30-273,G,2/1/17,UTA,MIL,1,34,3,9,0.333,2,6,0.333,1,3,0.333,0,0,,0,2,2,4,1,0,1,1,7,4.9
Justise Winslow,20-276,F,12/27/16,MIA,OKC,1,35,2,10,0.2,2,8,0.25,0,2,0,3,3,1,0,3,3,5,2,1,3,3,7,3.7
Elfrid Payton,22-292,G,12/10/16,ORL,DEN,0,27,3,10,0.3,3,7,0.429,0,3,0,1,3,0.333,0,4,4,5,0,0,4,0,7,1.1
Dorian Finney-Smith,23-343,F,4/12/17,DAL,MEM,1,31,3,9,0.333,2,4,0.5,1,5,0.2,0,0,,0,5,5,5,1,0,1,2,7,6.1
Terrence Jones,24-315,F,11/19/16,NOP,CHO,0,20,2,8,0.25,2,6,0.333,0,2,0,3,4,0.75,0,4,4,1,1,1,1,3,7,3.2
Justin Holiday,27-259,G,12/20/16,NYK,IND,0,21,3,5,0.6,2,3,0.667,1,2,0.5,0,0,,0,4,4,3,0,0,1,2,7,6.2
Corey Brewer,30-301,F-G,12/31/16,HOU,NYK,1,29,3,6,0.5,2,3,0.667,1,3,0.333,0,0,,1,3,4,1,0,0,2,5,7,2.3
Jamal Crawford,36-244,G,11/19/16,LAC,CHI,0,27,3,9,0.333,2,4,0.5,1,5,0.2,0,0,,0,1,1,0,0,0,2,1,7,-0.2
Nikola Mirotic,25-280,F,11/17/16,CHI,UTA,0,21,3,6,0.5,2,3,0.667,1,3,0.333,0,0,,0,3,3,1,2,1,1,1,7,6.9
Thon Maker,20-009,F-C,3/6/17,MIL,PHI,1,15,2,7,0.286,1,3,0.333,1,4,0.25,2,2,1,1,2,3,0,0,1,0,4,7,3.3
Brandon Bass,31-278,F,2/2/17,LAC,GSW,0,16,3,5,0.6,3,5,0.6,0,0,,1,1,1,0,2,2,0,0,0,1,2,7,3.5
Sasha Vujacic,33-030,G,4/7/17,NYK,MEM,0,21,2,8,0.25,0,1,0,2,7,0.286,1,2,0.5,2,3,5,3,0,0,0,2,7,5.4
Dario Saric,22-254,F,12/18/16,PHI,BRK,0,25,3,10,0.3,2,5,0.4,1,5,0.2,0,0,,2,6,8,2,0,0,1,1,7,4.4
Davis Bertans,24-004,F,11/16/16,SAS,SAC,0,17,2,5,0.4,0,0,,2,5,0.4,1,2,0.5,1,1,2,3,0,2,0,3,7,7.2
Malcolm Brogdon,24-054,G,2/3/17,MIL,DEN,0,24,3,7,0.429,3,5,0.6,0,2,0,1,1,1,0,1,1,2,2,1,2,1,7,5.3
Mindaugas Kuzminskas,27-006,F,10/25/16,NYK,CLE,0,9,3,5,0.6,2,2,1,1,3,0.333,0,0,,0,1,1,0,0,0,0,0,7,5
Seth Curry,26-064,G,10/26/16,DAL,IND,0,16,3,4,0.75,2,2,1,1,2,0.5,0,0,,0,3,3,1,3,1,0,6,7,8.3
Ty Lawson,29-093,G,2/4/17,SAC,GSW,0,20,3,7,0.429,2,4,0.5,1,3,0.333,0,0,,0,1,1,4,2,0,4,2,7,3.6
Tony Snell,25-011,G-F,11/21/16,MIL,ORL,1,25,3,7,0.429,2,3,0.667,1,4,0.25,0,0,,0,2,2,1,1,1,0,0,7,6.3
Stanley Johnson,20-199,F,12/14/16,DET,DAL,0,15,1,4,0.25,0,2,0,1,2,0.5,4,4,1,1,1,2,1,0,0,1,3,7,4.1
Wesley Matthews,30-177,G,4/9/17,DAL,PHO,1,19,3,10,0.3,2,2,1,1,8,0.125,0,0,,0,1,1,2,0,0,1,1,7,1.5
Channing Frye,33-268,C-F,2/9/17,CLE,OKC,0,15,2,6,0.333,1,2,0.5,1,4,0.25,2,2,1,0,6,6,1,0,1,0,0,7,6.8
Kyle Anderson,23-086,F-G,12/15/16,SAS,PHO,0,16,1,1,1,1,1,1,0,0,,5,6,0.833,0,1,1,1,0,0,1,0,7,6.3
JaMychal Green,26-131,F,10/30/16,MEM,WAS,1,39,3,6,0.5,2,3,0.667,1,3,0.333,0,0,,2,4,6,1,2,0,1,5,7,6.3
Will Barton,25-319,G,11/20/16,DEN,UTA,1,19,3,9,0.333,2,6,0.333,1,3,0.333,0,1,0,1,2,3,1,0,0,0,2,7,2.7
Solomon Hill,25-231,F,11/4/16,NOP,PHO,1,30,2,5,0.4,1,3,0.333,1,2,0.5,2,4,0.5,1,4,5,3,1,2,0,4,7,8.3
Jared Dudley,31-132,F-G,11/19/16,PHO,PHI,0,23,3,7,0.429,2,3,0.667,1,4,0.25,0,0,,2,1,3,1,1,0,0,3,7,5.5
Mike Muscala,25-124,F-C,11/2/16,ATL,LAL,0,15,3,3,1,2,2,1,1,1,1,0,0,,3,2,5,3,0,0,1,1,7,9.5
Justin Holiday,27-264,G,12/25/16,NYK,BOS,0,14,1,3,0.333,0,1,0,1,2,0.5,4,4,1,0,1,1,0,0,0,2,1,7,3.2
Kentavious Caldwell-Pope,23-293,G,12/7/16,DET,CHO,1,37,3,9,0.333,2,5,0.4,1,4,0.25,0,0,,1,3,4,6,1,0,0,3,7,7.5
Aron Baynes,30-085,C,3/4/17,DET,PHI,0,9,2,2,1,2,2,1,0,0,,3,4,0.75,1,1,2,0,0,1,0,0,7,7.7
Terrence Jones,24-298,F,11/2/16,NOP,MEM,0,28,3,8,0.375,2,5,0.4,1,3,0.333,0,0,,2,8,10,2,0,2,4,1,7,4.8
Matt Barnes,37-011,F,3/20/17,GSW,OKC,0,19,2,4,0.5,2,2,1,0,2,0,3,4,0.75,0,1,1,2,1,0,0,5,7,5.3
J.J. Barea,32-195,G,1/7/17,DAL,ATL,0,17,3,8,0.375,2,4,0.5,1,4,0.25,0,0,,0,4,4,7,0,0,1,1,7,7.3
Mindaugas Kuzminskas,27-094,F,1/21/17,NYK,PHO,0,18,3,7,0.429,2,4,0.5,1,3,0.333,0,0,,0,1,1,0,1,0,1,2,7,2.8
Jose Calderon,35-114,G,1/20/17,LAL,IND,0,19,3,7,0.429,2,3,0.667,1,4,0.25,0,0,,1,0,1,6,1,0,0,3,7,8
DeAndre Jordan,28-247,C,3/25/17,LAC,UTA,1,26,3,5,0.6,3,5,0.6,0,0,,1,3,0.333,6,9,15,1,0,1,0,4,7,10.6
Kelly Olynyk,25-241,C-F,12/16/16,BOS,CHO,0,18,2,5,0.4,0,2,0,2,3,0.667,1,2,0.5,0,3,3,2,2,2,0,1,7,9.2
John Henson,25-324,C-F,11/16/16,MIL,ATL,1,20,2,5,0.4,2,5,0.4,0,0,,3,4,0.75,3,4,7,2,0,0,2,3,7,5.4
Brandon Rush,31-223,G-F,2/15/17,MIN,DEN,1,24,3,6,0.5,2,4,0.5,1,2,0.5,0,0,,0,2,2,1,2,1,1,1,7,6.6
Brian Roberts,31-123,G,4/5/17,CHO,MIA,0,14,3,5,0.6,2,4,0.5,1,1,1,0,0,,1,1,2,0,0,1,1,1,7,5
Kent Bazemore,27-168,G-F,12/16/16,ATL,TOR,0,22,3,6,0.5,2,4,0.5,1,2,0.5,0,2,0,2,3,5,1,0,1,0,1,7,6.5
Justin Holiday,27-274,G,1/4/17,NYK,MIL,0,10,3,6,0.5,2,4,0.5,1,2,0.5,0,0,,1,2,3,1,0,0,2,1,7,3.6
Gordon Hayward,26-327,F-G,2/13/17,UTA,LAC,1,29,2,12,0.167,1,6,0.167,1,6,0.167,2,2,1,0,5,5,0,0,0,0,0,7,0.9
Alec Burks,25-208,G,2/13/17,UTA,LAC,0,22,3,8,0.375,2,6,0.333,1,2,0.5,0,0,,0,2,2,1,1,0,3,1,7,1.5
Mike Dunleavy,36-134,F-G,1/27/17,ATL,WAS,0,21,3,8,0.375,2,3,0.667,1,5,0.2,0,0,,1,2,3,3,1,0,1,1,7,5.6
Juan Hernangomez,21-149,F,2/24/17,DEN,BRK,0,8,3,5,0.6,2,3,0.667,1,2,0.5,0,0,,1,3,4,0,2,0,1,0,7,7.3
Marcus Morris,27-075,F,11/16/16,DET,NYK,1,37,3,9,0.333,2,6,0.333,1,3,0.333,0,0,,0,3,3,2,1,0,1,2,7,3.4
Justin Hamilton,26-242,C,11/29/16,BRK,LAC,0,25,2,6,0.333,1,3,0.333,1,3,0.333,2,4,0.5,0,4,4,2,0,2,0,1,7,6.4
Luol Deng,31-204,F,11/6/16,LAL,PHO,1,21,2,5,0.4,0,1,0,2,4,0.5,1,2,0.5,0,7,7,0,1,0,0,2,7,6.2
Nikola Jokic,22-051,C-F,4/11/17,DEN,DAL,1,20,3,6,0.5,2,3,0.667,1,3,0.333,0,0,,1,7,8,4,0,0,1,2,7,7.8
Malachi Richardson,21-032,G,2/6/17,SAC,CHI,0,8,2,5,0.4,2,3,0.667,0,2,0,3,3,1,0,0,0,0,0,0,2,3,7,1.1
Mason Plumlee,26-314,C-F,1/13/17,POR,ORL,1,28,2,7,0.286,2,7,0.286,0,0,,3,4,0.75,2,5,7,5,2,3,1,2,7,11.2
Manu Ginobili,39-183,G,1/27/17,SAS,NOP,0,15,3,7,0.429,2,6,0.333,1,1,1,0,0,,0,0,0,4,1,0,1,0,7,6.1
Dwight Powell,25-107,F-C,11/4/16,DAL,POR,0,23,2,3,0.667,2,3,0.667,0,0,,3,4,0.75,2,6,8,3,3,1,0,2,7,13.5
Darren Collison,29-221,G,4/1/17,SAC,MIN,1,26,2,7,0.286,2,7,0.286,0,0,,3,4,0.75,0,0,0,7,1,0,4,1,7,4
Nik Stauskas,23-158,G,3/14/17,PHI,GSW,0,26,2,6,0.333,1,2,0.5,1,4,0.25,2,2,1,1,2,3,2,0,0,2,1,7,3.9
Pascal Siakam,23-040,F,3/16/17,TOR,OKC,0,6,3,3,1,2,2,1,1,1,1,0,0,,0,0,0,0,0,1,0,0,7,6.8
Cristiano Felicio,24-240,F-C,3/4/17,CHI,LAC,0,15,3,5,0.6,3,5,0.6,0,0,,1,2,0.5,4,1,5,2,1,0,3,3,7,5.6
C.J. Watson,32-327,G,3/10/17,ORL,CHO,0,23,3,8,0.375,2,4,0.5,1,4,0.25,0,0,,1,2,3,2,0,0,0,3,7,4.1
Jerian Grant,24-142,G,2/28/17,CHI,DEN,1,12,2,2,1,1,1,1,1,1,1,2,2,1,0,0,0,1,0,0,0,0,7,7.1
Michael Carter-Williams,25-180,G,4/8/17,CHI,BRK,0,21,2,10,0.2,1,8,0.125,1,2,0.5,2,2,1,0,2,2,0,2,1,0,2,7,3.3
Bismack Biyombo,24-225,C-F,4/10/17,ORL,CHI,0,17,2,4,0.5,2,4,0.5,0,0,,3,3,1,1,6,7,0,2,2,1,3,7,8.7
Michael Carter-Williams,25-019,G,10/29/16,CHI,IND,0,23,2,8,0.25,2,7,0.286,0,1,0,3,4,0.75,0,1,1,5,1,2,4,2,7,3.2
Jose Calderon,35-063,G,11/30/16,LAL,CHI,1,17,3,4,0.75,3,4,0.75,0,0,,1,1,1,0,0,0,1,0,0,3,0,7,3.1
Terry Rozier,22-302,G,1/13/17,BOS,ATL,0,23,3,5,0.6,3,4,0.75,0,1,0,1,2,0.5,1,3,4,0,1,1,0,1,7,7.2
James Johnson,29-336,F,1/21/17,MIA,MIL,0,34,3,12,0.25,3,8,0.375,0,4,0,1,1,1,1,2,3,6,1,0,2,5,7,2.3
Tarik Black,24-354,C-F,11/10/16,LAL,SAC,0,11,3,4,0.75,3,4,0.75,0,0,,1,2,0.5,1,3,4,1,0,0,1,2,7,5.5
Shabazz Muhammad,24-093,F-G,2/14/17,MIN,CLE,0,15,2,5,0.4,2,3,0.667,0,2,0,3,5,0.6,0,1,1,1,1,0,0,0,7,5.5
Brian Roberts,31-126,G,4/8/17,CHO,BOS,0,12,2,5,0.4,2,5,0.4,0,0,,3,3,1,0,0,0,0,0,0,0,0,7,4.3
Tony Allen,35-077,G-F,3/29/17,MEM,IND,1,34,2,10,0.2,2,10,0.2,0,0,,3,4,0.75,5,3,8,4,0,0,1,2,7,5.8
Marquese Chriss,19-160,F,12/9/16,PHO,LAL,1,8,3,5,0.6,2,2,1,1,3,0.333,0,0,,0,1,1,0,0,0,0,3,7,3.8
Kyle Korver,35-260,G-F,12/2/16,ATL,DET,1,34,2,8,0.25,2,5,0.4,0,3,0,3,4,0.75,0,2,2,0,1,0,0,0,7,3.4
Ian Mahinmi,30-123,C,3/8/17,WAS,DEN,0,15,3,3,1,3,3,1,0,0,,1,2,0.5,1,3,4,2,1,0,1,0,7,8.7
Kris Dunn,22-232,G,11/5/16,MIN,OKC,1,28,2,8,0.25,2,8,0.25,0,0,,3,6,0.5,2,2,4,3,1,0,1,4,7,3.5
Anthony Bennett,23-231,F,10/31/16,BRK,CHI,0,12,2,7,0.286,1,2,0.5,1,5,0.2,2,2,1,0,1,1,0,1,0,0,0,7,4.2
David West,36-183,F,2/28/17,GSW,WAS,0,13,3,5,0.6,3,5,0.6,0,0,,1,2,0.5,0,3,3,2,1,1,1,3,7,6.1
Julius Randle,22-104,F,3/13/17,LAL,DEN,1,24,3,8,0.375,2,6,0.333,1,2,0.5,0,0,,2,6,8,2,0,1,2,2,7,5.1
Derrick Williams,25-262,F,2/11/17,CLE,DEN,0,21,2,3,0.667,1,1,1,1,2,0.5,2,2,1,0,1,1,0,0,0,1,0,7,5
Zaza Pachulia,32-317,C,12/23/16,GSW,DET,1,19,2,2,1,2,2,1,0,0,,3,3,1,3,5,8,0,1,0,2,1,7,8.6
Matt Barnes,37-009,F,3/18/17,GSW,MIL,0,24,2,4,0.5,0,0,,2,4,0.5,1,2,0.5,0,10,10,3,0,0,0,2,7,8.9
Robert Covington,25-336,F,11/14/16,PHI,HOU,1,14,1,7,0.143,0,1,0,1,6,0.167,4,4,1,0,1,1,0,0,0,0,4,7,1.2
Jamal Murray,19-263,G,11/12/16,DEN,DET,0,20,3,6,0.5,2,3,0.667,1,3,0.333,0,0,,0,1,1,0,1,0,0,1,7,4.9
Marreese Speights,29-193,C-F,2/13/17,LAC,UTA,0,15,2,7,0.286,1,3,0.333,1,4,0.25,2,2,1,0,7,7,0,0,1,2,2,7,2.9
Marcus Thornton,29-186,G,12/8/16,WAS,DEN,0,11,3,6,0.5,2,4,0.5,1,2,0.5,0,0,,0,3,3,1,0,0,0,1,7,5.2
Tyreke Evans,27-108,G-F,1/5/17,NOP,ATL,0,13,3,6,0.5,2,4,0.5,1,2,0.5,0,0,,0,2,2,3,0,0,2,0,7,4.7
Austin Rivers,24-118,G,11/27/16,LAC,IND,0,25,2,5,0.4,1,3,0.333,1,2,0.5,2,3,0.667,0,1,1,1,3,0,3,0,7,4.9
Nicolas Brussino,24-036,G-F,4/7/17,DAL,SAS,0,24,3,8,0.375,2,6,0.333,1,2,0.5,0,0,,0,1,1,2,0,0,2,2,7,1.5
Rajon Rondo,30-305,G,12/23/16,CHI,CHO,1,33,3,10,0.3,2,7,0.286,1,3,0.333,0,0,,2,7,9,10,2,0,5,1,7,8.3
Eric Gordon,28-023,G,1/17/17,HOU,MIA,0,30,3,17,0.176,2,7,0.286,1,10,0.1,0,0,,0,1,1,1,0,1,3,0,7,-5
Caris LeVert,22-195,G-F,3/8/17,BRK,ATL,1,24,3,6,0.5,2,2,1,1,4,0.25,0,0,,0,3,3,2,1,0,0,1,7,6.9
Luol Deng,31-296,F,2/6/17,LAL,NYK,0,24,1,6,0.167,1,2,0.5,0,4,0,5,5,1,0,3,3,1,1,1,0,2,7,5.7
Timothe Luwawu-Cabarrot,21-296,F,3/1/17,PHI,MIA,0,24,1,5,0.2,1,4,0.25,0,1,0,5,6,0.833,0,4,4,1,1,1,2,3,7,3.9
Pierre Jackson,25-120,G,12/27/16,DAL,HOU,0,11,2,5,0.4,1,3,0.333,1,2,0.5,2,2,1,0,1,1,2,0,0,2,0,7,4
Raymond Felton,32-156,G,11/29/16,LAC,BRK,0,14,3,6,0.5,2,3,0.667,1,3,0.333,0,0,,0,2,2,1,2,0,1,3,7,5.1
Jarell Martin,22-161,F,11/1/16,MEM,MIN,1,26,3,7,0.429,3,5,0.6,0,2,0,1,3,0.333,0,3,3,0,0,0,2,3,7,0.2
Elfrid Payton,22-359,G,2/15/17,ORL,SAS,0,30,3,8,0.375,2,6,0.333,1,2,0.5,0,0,,1,2,3,3,0,0,3,2,7,2.2
Georgios Papagiannis,19-264,C,3/24/17,SAC,GSW,0,27,3,6,0.5,3,5,0.6,0,1,0,1,1,1,2,2,4,1,0,1,3,2,7,3.6
Lou Williams,30-167,G,4/12/17,HOU,MIN,0,25,1,11,0.091,0,4,0,1,7,0.143,4,4,1,0,5,5,4,1,0,2,0,7,3
Thomas Robinson,25-295,F,1/6/17,LAL,MIA,0,17,3,5,0.6,3,5,0.6,0,0,,1,6,0.167,3,6,9,1,2,0,2,4,7,5.7
Gorgui Dieng,27-042,C,3/1/17,MIN,UTA,1,23,2,6,0.333,2,6,0.333,0,0,,3,4,0.75,0,6,6,1,1,2,0,0,7,8.1
Aaron Gordon,21-187,F,3/22/17,ORL,CHO,1,29,3,8,0.375,2,4,0.5,1,4,0.25,0,0,,0,3,3,2,0,0,2,2,7,2.1
Otto Porter,23-301,F,3/31/17,WAS,UTA,1,24,3,7,0.429,2,5,0.4,1,2,0.5,0,0,,2,2,4,0,1,0,0,3,7,5.1
Tim Frazier,26-080,G,1/20/17,NOP,BRK,0,12,3,6,0.5,3,4,0.75,0,2,0,1,2,0.5,0,0,0,3,0,0,1,2,7,3.9
Ian Clark,25-275,G,12/7/16,GSW,LAC,0,13,3,7,0.429,3,5,0.6,0,2,0,1,1,1,0,3,3,1,0,0,0,2,7,4.1
Kristaps Porzingis,21-162,F-C,1/11/17,NYK,PHI,1,28,3,10,0.3,2,4,0.5,1,6,0.167,0,0,,0,2,2,2,1,2,1,4,7,3
Allen Crabbe,24-243,G-F,12/8/16,POR,MEM,0,31,2,9,0.222,1,5,0.2,1,4,0.25,2,3,0.667,0,5,5,0,0,0,0,0,7,2.6
Monta Ellis,31-012,G,11/7/16,IND,CHO,1,17,3,4,0.75,2,2,1,1,2,0.5,0,0,,0,0,0,0,0,0,2,5,7,1.4
Evan Turner,28-029,G,11/25/16,POR,NOP,0,25,3,11,0.273,2,6,0.333,1,5,0.2,0,0,,1,3,4,4,0,0,0,0,7,4.9
Jeff Teague,28-170,G,11/27/16,IND,LAC,1,24,3,8,0.375,2,5,0.4,1,3,0.333,0,0,,0,2,2,10,2,1,1,5,7,9.9
Noah Vonleh,21-200,F,3/12/17,POR,PHO,1,23,2,5,0.4,2,5,0.4,0,0,,3,5,0.6,4,3,7,1,1,0,0,2,7,8.1
Sean Kilpatrick,26-308,G,11/9/16,BRK,NYK,1,28,2,9,0.222,1,5,0.2,1,4,0.25,2,4,0.5,0,4,4,5,0,0,4,3,7,0.2
Jose Calderon,35-191,G,4/7/17,ATL,CLE,1,25,3,8,0.375,2,5,0.4,1,3,0.333,0,0,,1,3,4,7,0,0,2,1,7,6.7
Anthony Bennett,23-264,F,12/3/16,BRK,MIL,1,23,3,6,0.5,3,3,1,0,3,0,1,2,0.5,4,10,14,1,0,0,1,4,7,7.5
Aaron Gordon,21-138,F,2/1/17,ORL,IND,1,32,3,8,0.375,3,4,0.75,0,4,0,1,3,0.333,0,0,0,1,1,1,1,1,7,2.8
Tobias Harris,24-271,F,4/12/17,DET,ORL,0,30,3,11,0.273,2,7,0.286,1,4,0.25,0,4,0,3,3,6,2,2,0,0,1,7,4.9
Nerlens Noel,22-300,C-F,2/4/17,PHI,MIA,1,20,2,6,0.333,2,6,0.333,0,0,,3,4,0.75,1,6,7,2,2,0,1,2,7,7.3
Joe Johnson,35-177,G-F,12/23/16,UTA,TOR,0,16,3,7,0.429,2,5,0.4,1,2,0.5,0,0,,0,0,0,0,0,0,1,0,7,2.3
Nik Stauskas,23-170,G,3/26/17,PHI,IND,0,27,2,8,0.25,0,2,0,2,6,0.333,1,2,0.5,0,2,2,1,0,1,2,2,7,1
Timothe Luwawu-Cabarrot,21-260,F,1/24/17,PHI,LAC,0,13,2,2,1,1,1,1,1,1,1,2,2,1,0,1,1,2,0,0,0,1,7,7.7
Will Barton,26-063,G,3/10/17,DEN,BOS,0,20,3,7,0.429,2,4,0.5,1,3,0.333,0,0,,0,3,3,4,0,1,1,1,7,6.3
Joffrey Lauvergne,25-129,C-F,2/6/17,OKC,IND,0,20,3,5,0.6,3,4,0.75,0,1,0,1,2,0.5,2,4,6,0,0,0,2,0,7,4.9
Ersan Ilyasova,29-201,F,12/2/16,PHI,ORL,1,17,2,9,0.222,1,4,0.25,1,5,0.2,2,4,0.5,1,1,2,1,0,1,0,1,7,2.7
Yogi Ferrell,23-300,G,3/5/17,DAL,OKC,1,32,3,8,0.375,2,5,0.4,1,3,0.333,0,0,,0,2,2,3,0,0,0,2,7,4.5
Wesley Johnson,29-149,F-G,12/7/16,LAC,GSW,0,15,1,4,0.25,0,2,0,1,2,0.5,4,4,1,2,2,4,1,0,0,2,2,7,4.5
Courtney Lee,31-105,G,1/16/17,NYK,ATL,0,21,3,7,0.429,2,3,0.667,1,4,0.25,0,0,,0,2,2,1,0,0,1,0,7,3.6
Dwight Powell,25-102,F-C,10/30/16,DAL,HOU,0,12,3,7,0.429,2,5,0.4,1,2,0.5,0,0,,0,2,2,1,1,0,0,0,7,5.6
Boris Diaw,34-238,F-C,12/10/16,UTA,SAC,1,17,3,4,0.75,2,3,0.667,1,1,1,0,0,,0,1,1,1,0,0,4,1,7,2
Ish Smith,28-154,G,12/6/16,DET,CHI,0,30,2,11,0.182,2,9,0.222,0,2,0,3,4,0.75,1,4,5,10,0,0,0,3,7,7.4
Tomas Satoransky,25-017,G,11/16/16,WAS,PHI,0,23,3,4,0.75,3,3,1,0,1,0,1,4,0.25,1,0,1,3,0,0,2,4,7,3.4
Austin Rivers,24-137,G,12/16/16,LAC,MIA,1,34,2,6,0.333,0,2,0,2,4,0.5,1,2,0.5,0,1,1,1,0,0,1,5,7,1.2
Michael Beasley,27-354,F,12/28/16,MIL,DET,0,22,3,8,0.375,3,8,0.375,0,0,,1,2,0.5,0,3,3,3,1,2,0,0,7,7.6
Andrew Wiggins,21-256,F-G,11/5/16,MIN,OKC,1,27,3,13,0.231,3,12,0.25,0,1,0,1,2,0.5,1,2,3,1,1,1,3,2,7,-1.4
Joe Johnson,35-187,G-F,1/2/17,UTA,BRK,0,21,3,6,0.5,2,3,0.667,1,3,0.333,0,0,,0,4,4,0,0,0,0,1,7,4.8
Vince Carter,39-365,G-F,1/25/17,MEM,TOR,0,30,2,4,0.5,2,3,0.667,0,1,0,3,4,0.75,0,3,3,3,0,1,0,3,7,7.1
Jonas Jerebko,29-271,F,11/28/16,BOS,MIA,0,21,3,3,1,2,2,1,1,1,1,0,0,,1,3,4,0,0,0,0,1,7,7.3
Thon Maker,20-038,F-C,4/4/17,MIL,OKC,1,24,2,8,0.25,2,6,0.333,0,2,0,3,5,0.6,2,5,7,0,1,0,1,3,7,3.1
Jake Layman,22-255,F,11/17/16,POR,HOU,0,17,1,4,0.25,0,1,0,1,3,0.333,4,5,0.8,0,2,2,0,0,0,1,3,7,2.6
Jared Dudley,31-250,F-G,3/17/17,PHO,ORL,0,26,3,9,0.333,2,3,0.667,1,6,0.167,0,0,,1,5,6,0,0,0,1,3,7,1.9
Shabazz Muhammad,24-067,F-G,1/19/17,MIN,LAC,0,18,2,5,0.4,1,4,0.25,1,1,1,2,4,0.5,1,3,4,0,0,0,0,0,7,5.1
Mike Dunleavy,36-140,F-G,2/2/17,ATL,HOU,0,22,2,4,0.5,0,0,,2,4,0.5,1,2,0.5,0,1,1,2,1,0,0,2,7,6.5
Brandon Knight,25-027,G,12/29/16,PHO,TOR,0,9,3,5,0.6,2,4,0.5,1,1,1,0,0,,0,2,2,0,1,0,2,3,7,3.1
Dorian Finney-Smith,23-189,F,11/9/16,DAL,GSW,1,35,2,5,0.4,1,1,1,1,4,0.25,2,4,0.5,1,2,3,0,1,0,1,3,7,3.6
Bismack Biyombo,24-204,C-F,3/20/17,ORL,PHI,0,16,3,5,0.6,3,5,0.6,0,0,,1,1,1,2,4,6,0,0,1,0,3,7,6.8
Joffrey Lauvergne,25-072,C-F,12/11/16,OKC,BOS,0,21,3,10,0.3,3,7,0.429,0,3,0,1,4,0.25,2,5,7,2,1,0,1,0,7,4.3
Quincy Acy,26-111,F,1/25/17,BRK,MIA,0,6,2,3,0.667,1,2,0.5,1,1,1,2,2,1,0,0,0,0,0,0,1,1,7,4.3
Willy Hernangomez,22-320,C,4/12/17,NYK,PHI,1,18,1,2,0.5,1,2,0.5,0,0,,5,6,0.833,3,7,10,3,0,0,2,0,7,9.9
Juan Hernangomez,21-045,F,11/12/16,DEN,DET,0,20,3,5,0.6,2,3,0.667,1,2,0.5,0,0,,1,3,4,2,0,0,0,1,7,7.3
Brian Roberts,31-128,G,4/10/17,CHO,MIL,1,27,3,10,0.3,2,7,0.286,1,3,0.333,0,0,,0,2,2,1,1,0,3,0,7,0.5
Taurean Waller-Prince,23-000,F,3/22/17,ATL,WAS,0,28,3,8,0.375,2,4,0.5,1,4,0.25,0,0,,1,3,4,2,1,1,1,2,7,5.5
Davis Bertans,24-018,F,11/30/16,SAS,DAL,0,15,2,2,1,1,1,1,1,1,1,2,2,1,0,0,0,0,0,0,0,1,7,6
Dante Cunningham,29-278,F,1/25/17,NOP,OKC,0,25,3,5,0.6,2,3,0.667,1,2,0.5,0,0,,1,5,6,0,0,3,0,1,7,8.6
JaMychal Green,26-182,F,12/20/16,MEM,BOS,1,31,2,5,0.4,2,4,0.5,0,1,0,3,4,0.75,4,8,12,1,1,0,1,4,7,8.2
Jamal Crawford,37-012,G,4/1/17,LAC,LAL,0,22,2,7,0.286,1,4,0.25,1,3,0.333,2,2,1,0,1,1,3,1,0,2,0,7,4.3
Jason Smith,30-279,F-C,12/6/16,WAS,ORL,0,10,3,5,0.6,2,4,0.5,1,1,1,0,0,,0,2,2,0,0,0,0,1,7,4.9
Isaiah Whitehead,21-308,G,1/10/17,BRK,ATL,1,26,3,8,0.375,2,7,0.286,1,1,1,0,0,,1,1,2,3,0,2,1,3,7,4.9
Dragan Bender,19-044,F,12/31/16,PHO,UTA,0,21,2,4,0.5,0,0,,2,4,0.5,1,3,0.333,0,1,1,0,0,1,2,2,7,2.4
Wesley Matthews,30-133,G,2/24/17,DAL,MIN,1,37,2,9,0.222,1,4,0.25,1,5,0.2,2,2,1,1,4,5,3,0,1,1,4,7,3.6
Paul Pierce,39-156,F-G,3/18/17,LAC,CLE,0,14,3,3,1,2,2,1,1,1,1,0,0,,1,5,6,3,0,1,2,1,7,8.7
Matthew Dellavedova,26-063,G,11/10/16,MIL,NOP,1,29,2,7,0.286,2,5,0.4,0,2,0,3,5,0.6,1,4,5,12,0,0,2,1,7,10
Joe Johnson,35-123,G-F,10/30/16,UTA,LAC,1,25,3,9,0.333,2,7,0.286,1,2,0.5,0,0,,0,1,1,3,2,0,0,0,7,6.3
Michael Beasley,28-081,F,3/31/17,MIL,DET,0,7,3,4,0.75,3,4,0.75,0,0,,1,1,1,2,2,4,0,1,0,0,1,7,8
Al-Farouq Aminu,26-106,F,1/5/17,POR,LAL,1,35,3,8,0.375,2,5,0.4,1,3,0.333,0,0,,1,10,11,4,2,1,0,1,7,11.4
Michael Beasley,27-361,F,1/4/17,MIL,NYK,0,10,2,3,0.667,1,2,0.5,1,1,1,2,2,1,0,0,0,0,0,1,1,3,7,4.2
D.J. Augustin,29-118,G,3/8/17,ORL,CHI,0,12,3,6,0.5,2,2,1,1,4,0.25,0,0,,0,0,0,0,0,0,0,1,7,3.6
Garrett Temple,30-327,G,3/31/17,SAC,NOP,0,28,3,11,0.273,2,7,0.286,1,4,0.25,0,0,,1,2,3,2,2,1,2,2,7,3.1
Brandon Jennings,27-032,G,10/25/16,NYK,CLE,0,21,1,7,0.143,1,3,0.333,0,4,0,5,6,0.833,1,2,3,5,0,0,1,2,7,5.1
Frank Kaminsky,23-256,F-C,12/16/16,CHO,BOS,0,20,3,10,0.3,2,5,0.4,1,5,0.2,0,0,,2,3,5,0,1,1,0,1,7,4.8
Andre Drummond,23-233,C,3/31/17,DET,MIL,1,31,3,6,0.5,3,6,0.5,0,0,,1,4,0.25,2,11,13,2,2,2,2,5,7,8.3
Gerald Green,30-365,G-F,1/25/17,BOS,HOU,0,16,3,5,0.6,2,2,1,1,3,0.333,0,0,,0,4,4,0,0,0,1,3,7,3.7
Jose Calderon,35-056,G,11/23/16,LAL,GSW,1,20,3,7,0.429,2,4,0.5,1,3,0.333,0,0,,2,2,4,6,0,0,2,1,7,7.1
Dwight Howard,30-336,C,11/8/16,ATL,CLE,1,27,3,5,0.6,3,5,0.6,0,0,,1,4,0.25,2,15,17,2,0,3,3,4,7,8.3
Devin Harris,33-337,G,1/29/17,DAL,SAS,0,19,2,6,0.333,1,3,0.333,1,3,0.333,2,2,1,0,1,1,2,1,0,1,2,7,4.5
Ramon Sessions,30-238,G,12/5/16,CHO,DAL,0,13,0,1,0,0,1,0,0,0,,7,7,1,0,1,1,2,0,0,1,2,7,6.2
Pat Connaughton,23-322,G,11/23/16,POR,CLE,0,4,3,3,1,2,2,1,1,1,1,0,0,,0,1,1,0,0,0,0,0,7,6.4
Marquese Chriss,19-120,F,10/30/16,PHO,GSW,0,14,3,6,0.5,2,5,0.4,1,1,1,0,0,,1,3,4,0,2,0,1,3,7,5.4
James Ennis,26-271,F,3/29/17,MEM,IND,1,32,3,9,0.333,3,6,0.5,0,3,0,1,1,1,2,8,10,2,2,0,2,6,7,4.7
John Henson,25-327,C-F,11/19/16,MIL,GSW,1,18,3,3,1,3,3,1,0,0,,1,2,0.5,0,6,6,0,1,0,1,4,7,5.9
Joe Harris,25-072,G,11/18/16,BRK,OKC,0,20,2,3,0.667,1,2,0.5,1,1,1,2,4,0.5,0,1,1,2,0,0,0,0,7,6.6
Andre Roberson,25-009,G-F,12/13/16,OKC,POR,1,31,3,7,0.429,2,4,0.5,1,3,0.333,0,0,,1,2,3,1,2,1,2,1,7,5.6
Tarik Black,25-047,C-F,1/8/17,LAL,ORL,0,12,3,5,0.6,3,5,0.6,0,0,,1,1,1,0,3,3,0,1,0,1,4,7,4
Robin Lopez,28-248,C,12/5/16,CHI,POR,1,33,2,6,0.333,2,6,0.333,0,0,,3,4,0.75,7,7,14,2,0,2,1,0,7,12
Sasha Vujacic,33-035,G,4/12/17,NYK,PHI,0,21,2,9,0.222,0,4,0,2,5,0.4,1,2,0.5,2,0,2,6,0,0,2,2,7,3.9
Michael Kidd-Gilchrist,23-033,F,10/29/16,CHO,BOS,1,25,2,5,0.4,2,5,0.4,0,0,,3,4,0.75,1,3,4,0,1,0,0,1,7,6.1
Ian Clark,26-022,G,3/29/17,GSW,SAS,0,14,3,5,0.6,2,4,0.5,1,1,1,0,0,,0,0,0,1,0,0,1,0,7,4.4
Jon Leuer,27-305,F,3/15/17,DET,UTA,1,30,3,8,0.375,2,7,0.286,1,1,1,0,0,,1,4,5,1,0,1,1,1,7,4.5
Arron Afflalo,31-092,G,1/15/17,SAC,OKC,0,18,2,5,0.4,1,4,0.25,1,1,1,2,2,1,0,3,3,0,0,1,4,1,7,1.5
Paul Zipser,22-329,G-F,1/12/17,CHI,NYK,1,34,2,6,0.333,1,3,0.333,1,3,0.333,2,2,1,0,5,5,2,0,0,0,1,7,6.1
Derrick Favors,25-234,F-C,3/6/17,UTA,NOP,1,32,3,10,0.3,3,10,0.3,0,0,,1,2,0.5,1,3,4,1,1,0,1,0,7,3.1
Aaron Brooks,31-305,G,11/14/16,IND,ORL,0,17,2,9,0.222,1,6,0.167,1,3,0.333,2,2,1,0,0,0,4,1,0,0,1,7,4.9
Marcus Morris,27-152,F,2/1/17,DET,NOP,1,34,3,9,0.333,2,5,0.4,1,4,0.25,0,0,,1,3,4,4,0,0,1,1,7,4.9
Kemba Walker,26-311,G,3/15/17,CHO,IND,1,30,3,11,0.273,3,8,0.375,0,3,0,1,1,1,0,1,1,4,0,0,2,0,7,1.6
Joe Harris,25-170,G,2/24/17,BRK,DEN,0,24,2,7,0.286,0,2,0,2,5,0.4,1,2,0.5,1,4,5,0,0,1,2,1,7,2.7
Allen Crabbe,24-261,G-F,12/26/16,POR,TOR,1,35,3,11,0.273,3,8,0.375,0,3,0,1,2,0.5,0,5,5,0,1,0,0,2,7,1.8
Kentavious Caldwell-Pope,23-322,G,1/5/17,DET,CHO,1,33,3,12,0.25,2,8,0.25,1,4,0.25,0,0,,0,2,2,3,1,0,1,1,7,2.1
Montrezl Harrell,22-314,F-C,12/5/16,HOU,BOS,0,19,3,5,0.6,3,5,0.6,0,0,,1,1,1,1,1,2,0,0,1,1,2,7,4.6
Marquese Chriss,19-139,F,11/18/16,PHO,IND,1,16,3,7,0.429,3,6,0.5,0,1,0,1,2,0.5,0,1,1,0,0,3,1,4,7,2.7
DeMarre Carroll,30-219,F,3/3/17,TOR,WAS,1,26,3,7,0.429,2,2,1,1,5,0.2,0,0,,1,4,5,3,2,0,0,3,7,8.1
Buddy Hield,22-362,G,12/13/16,NOP,GSW,1,18,3,7,0.429,2,4,0.5,1,3,0.333,0,0,,0,3,3,1,0,1,0,1,7,5.2
Otto Porter,23-266,F,2/24/17,WAS,PHI,1,36,3,9,0.333,2,4,0.5,1,5,0.2,0,0,,2,2,4,0,5,0,0,3,7,7.7
Alexis Ajinca,28-315,C,3/17/17,NOP,HOU,0,10,3,4,0.75,3,4,0.75,0,0,,1,1,1,2,2,4,0,0,0,0,3,7,6.2
Trey Lyles,21-088,F,2/1/17,UTA,MIL,0,15,3,6,0.5,2,4,0.5,1,2,0.5,0,0,,0,3,3,1,0,0,0,4,7,4
Ricky Rubio,26-057,G,12/17/16,MIN,HOU,1,41,2,7,0.286,1,5,0.2,1,2,0.5,2,2,1,2,6,8,7,4,0,3,1,7,11.6
DeMarre Carroll,30-186,F,1/29/17,TOR,ORL,1,17,3,8,0.375,3,3,1,0,5,0,1,2,0.5,0,2,2,0,1,0,2,0,7,1.8
DeAndre Jordan,28-252,C,3/30/17,LAC,PHO,1,35,3,6,0.5,3,6,0.5,0,0,,1,4,0.25,6,11,17,2,0,3,2,3,7,10.6
Dario Saric,22-252,F,12/16/16,PHI,LAL,0,20,2,8,0.25,1,4,0.25,1,4,0.25,2,2,1,2,1,3,0,0,0,1,1,7,2.5
Michael Kidd-Gilchrist,23-053,F,11/18/16,CHO,ATL,1,35,3,10,0.3,3,10,0.3,0,0,,1,1,1,2,3,5,3,1,0,1,3,7,4.4
Jamal Murray,19-349,G,2/6/17,DEN,DAL,0,19,3,9,0.333,2,7,0.286,1,2,0.5,0,0,,0,3,3,4,0,3,1,1,7,6.3
Nicolas Laprovittola,26-304,G,11/30/16,SAS,DAL,1,19,3,6,0.5,2,3,0.667,1,3,0.333,0,0,,0,1,1,0,0,0,1,2,7,2.5
Jose Calderon,35-058,G,11/25/16,LAL,GSW,1,28,3,6,0.5,2,3,0.667,1,3,0.333,0,0,,1,0,1,6,1,1,4,4,7,5
Malcolm Brogdon,24-038,G,1/18/17,MIL,HOU,1,35,3,12,0.25,2,8,0.25,1,4,0.25,0,0,,6,3,9,8,1,0,3,1,7,8.1
Quincy Acy,26-166,F,3/21/17,BRK,DET,0,23,2,4,0.5,1,2,0.5,1,2,0.5,2,2,1,1,3,4,1,0,0,0,2,7,6.5
Denzel Valentine,23-104,G,2/28/17,CHI,DEN,0,27,3,7,0.429,2,2,1,1,5,0.2,0,0,,0,7,7,1,0,0,3,3,7,1.9
Taj Gibson,31-258,F,3/9/17,OKC,SAS,1,22,3,7,0.429,3,7,0.429,0,0,,1,2,0.5,0,3,3,0,0,1,2,3,7,1.3
DeMarre Carroll,30-239,F,3/23/17,TOR,MIA,1,21,2,5,0.4,2,2,1,0,3,0,3,4,0.75,0,0,0,0,3,0,1,2,7,5.1
Thomas Robinson,26-019,F,4/5/17,LAL,SAS,0,19,3,8,0.375,3,8,0.375,0,0,,1,2,0.5,2,5,7,0,2,0,2,3,7,3.9
Jason Terry,39-049,G,11/3/16,MIL,IND,0,18,2,3,0.667,1,1,1,1,2,0.5,2,2,1,0,0,0,0,0,0,1,2,7,3.9
Rodney McGruder,25-127,G,12/3/16,MIA,POR,1,39,3,9,0.333,2,5,0.4,1,4,0.25,0,0,,1,3,4,2,0,0,1,2,7,3.1
Marcus Morris,27-207,F,3/28/17,DET,MIA,1,28,3,10,0.3,2,7,0.286,1,3,0.333,0,0,,1,3,4,2,0,0,1,6,7,0.8
Hollis Thompson,25-329,G-F,2/26/17,NOP,OKC,1,31,2,4,0.5,0,1,0,2,3,0.667,1,2,0.5,0,3,3,0,0,0,1,2,7,3.7
JaMychal Green,26-214,F,1/21/17,MEM,HOU,1,30,3,6,0.5,2,5,0.4,1,1,1,0,0,,6,3,9,2,2,0,2,2,7,9.7
Richard Jefferson,36-295,F,4/12/17,CLE,TOR,0,26,1,4,0.25,0,1,0,1,3,0.333,4,5,0.8,0,6,6,2,1,0,1,1,7,7
Jordan McRae,25-273,G,12/26/16,CLE,DET,0,6,1,2,0.5,0,1,0,1,1,1,4,4,1,0,2,2,1,0,0,1,1,7,5.9
Draymond Green,26-281,F,12/10/16,GSW,MEM,1,26,3,7,0.429,3,6,0.5,0,1,0,1,3,0.333,4,3,7,1,2,0,4,4,7,3.3
Taj Gibson,31-211,F,1/21/17,CHI,SAC,1,29,3,9,0.333,3,9,0.333,0,0,,1,2,0.5,0,3,3,0,1,2,1,2,7,3
Meyers Leonard,25-001,C-F,2/28/17,POR,DET,0,18,3,6,0.5,2,3,0.667,1,3,0.333,0,0,,0,4,4,3,0,1,2,2,7,5.2
Jonathon Simmons,27-139,G-F,1/31/17,SAS,OKC,0,19,3,9,0.333,3,9,0.333,0,0,,1,4,0.25,2,4,6,1,3,1,1,2,7,5.9
Randy Foye,33-051,G,11/14/16,BRK,LAC,0,29,1,4,0.25,0,1,0,1,3,0.333,4,5,0.8,0,4,4,4,0,0,2,3,7,5
Iman Shumpert,26-180,G,12/23/16,CLE,BRK,0,18,3,9,0.333,2,4,0.5,1,5,0.2,0,0,,0,3,3,1,0,0,1,1,7,2.1
Greg Monroe,26-230,C-F,1/20/17,MIL,ORL,0,14,2,7,0.286,2,7,0.286,0,0,,3,6,0.5,4,1,5,1,1,0,0,2,7,5.7
Richaun Holmes,23-028,F-C,11/12/16,PHI,ATL,0,20,2,8,0.25,2,7,0.286,0,1,0,3,4,0.75,2,3,5,2,1,0,0,1,7,6.1
Devin Harris,34-036,G,4/4/17,DAL,SAC,0,15,3,5,0.6,2,2,1,1,3,0.333,0,0,,0,0,0,2,0,0,0,2,7,5.3
T.J. McConnell,24-354,G,3/14/17,PHI,GSW,1,31,3,7,0.429,3,7,0.429,0,0,,1,2,0.5,0,7,7,10,2,0,4,3,7,8.8
Wesley Johnson,29-209,F-G,2/5/17,LAC,BOS,0,11,3,4,0.75,2,2,1,1,2,0.5,0,0,,0,2,2,0,0,0,1,0,7,5
Kelly Olynyk,25-318,C-F,3/3/17,BOS,LAL,0,14,3,9,0.333,3,5,0.6,0,4,0,1,1,1,1,1,2,1,0,0,1,3,7,1.4
John Henson,26-000,C-F,12/28/16,MIL,DET,1,19,2,4,0.5,2,4,0.5,0,0,,3,4,0.75,0,2,2,1,0,2,0,3,7,6.1
Nemanja Bjelica,28-271,F,2/4/17,MIN,MEM,0,14,3,4,0.75,2,3,0.667,1,1,1,0,0,,0,4,4,2,0,0,3,3,7,3.8
Trey Lyles,21-093,F,2/6/17,UTA,ATL,0,11,3,7,0.429,2,4,0.5,1,3,0.333,0,0,,0,4,4,0,0,0,1,2,7,2.7
Marcus Thornton,29-211,G,1/2/17,WAS,HOU,0,18,3,8,0.375,2,5,0.4,1,3,0.333,0,0,,0,3,3,0,1,0,1,2,7,2.7
Nikola Jokic,21-280,C-F,11/25/16,DEN,OKC,0,29,3,7,0.429,2,5,0.4,1,2,0.5,0,0,,3,3,6,5,0,2,3,5,7,6.2
Anthony Tolliver,31-277,F-C,3/5/17,SAC,UTA,0,27,3,4,0.75,2,2,1,1,2,0.5,0,0,,0,3,3,2,1,1,0,1,7,9
Kris Humphries,32-050,F-C,3/28/17,ATL,PHO,0,10,0,3,0,0,3,0,0,0,,7,8,0.875,2,3,5,2,0,0,1,2,7,6.4
Donatas Motiejunas,26-145,F-C,2/12/17,NOP,SAC,0,22,2,6,0.333,2,3,0.667,0,3,0,3,4,0.75,1,7,8,2,1,1,3,2,7,5.3
Michael Beasley,27-302,F,11/6/16,MIL,DAL,0,10,3,4,0.75,2,3,0.667,1,1,1,0,0,,0,3,3,0,1,0,0,2,7,6.5
Steven Adams,23-252,C,3/29/17,OKC,ORL,1,29,3,5,0.6,3,5,0.6,0,0,,1,5,0.2,3,6,9,0,0,2,1,1,7,7
Al-Farouq Aminu,26-137,F,2/5/17,POR,OKC,0,32,1,8,0.125,0,5,0,1,3,0.333,4,4,1,2,5,7,1,2,1,1,2,7,6.3
Marcus Smart,22-325,G,1/25/17,BOS,HOU,0,31,2,5,0.4,1,4,0.25,1,1,1,2,2,1,2,2,4,6,3,0,3,2,7,9.7
Aaron Gordon,21-046,F,11/1/16,ORL,PHI,1,32,3,10,0.3,3,6,0.5,0,4,0,1,1,1,1,1,2,4,3,0,2,1,7,5.6
Jeff Green,30-167,F,2/11/17,ORL,DAL,0,15,3,8,0.375,3,6,0.5,0,2,0,1,1,1,1,2,3,1,0,0,0,1,7,4.2
Rudy Gobert,24-136,C,11/9/16,UTA,CHO,1,30,2,4,0.5,2,4,0.5,0,0,,3,4,0.75,5,6,11,1,1,3,2,3,7,10.5
Ian Mahinmi,30-133,C,3/18/17,WAS,CHO,0,21,2,5,0.4,2,5,0.4,0,0,,3,4,0.75,2,5,7,1,0,0,0,3,7,6.3
Zaza Pachulia,32-337,C,1/12/17,GSW,DET,1,24,3,6,0.5,3,6,0.5,0,0,,1,2,0.5,0,5,5,1,2,1,2,2,7,5.7
Jeremy Lin,28-185,G,2/24/17,BRK,DEN,1,15,2,3,0.667,1,2,0.5,1,1,1,2,2,1,0,2,2,5,0,0,1,2,7,8
Lucas Nogueira,24-168,C,1/10/17,TOR,BOS,0,21,3,4,0.75,3,3,1,0,1,0,1,2,0.5,2,1,3,2,1,2,2,2,7,7.7
Andrew Harrison,22-068,G,1/4/17,MEM,LAC,0,20,2,2,1,1,1,1,1,1,1,2,4,0.5,0,5,5,7,0,0,0,2,7,11.2
Terry Rozier,22-230,G,11/2/16,BOS,CHI,0,13,3,6,0.5,2,4,0.5,1,2,0.5,0,1,0,0,2,2,0,0,0,0,1,7,3.8
Josh McRoberts,29-288,F,12/12/16,MIA,WAS,1,18,3,8,0.375,2,5,0.4,1,3,0.333,0,0,,3,5,8,5,0,0,1,1,7,8.3
Dwight Powell,25-233,F-C,3/10/17,DAL,BRK,0,20,1,2,0.5,1,2,0.5,0,0,,5,6,0.833,1,7,8,1,0,0,1,3,7,6.9
Trevor Booker,29-125,F,3/30/17,BRK,DET,0,18,3,8,0.375,2,7,0.286,1,1,1,0,0,,1,3,4,1,0,1,4,1,7,1.2
Kyle O'Quinn,27-011,F-C,4/6/17,NYK,WAS,0,17,2,4,0.5,2,4,0.5,0,0,,3,4,0.75,2,4,6,1,0,2,1,4,7,6.7
Willie Reed,26-296,F-C,3/8/17,MIA,CHO,0,13,3,5,0.6,3,5,0.6,0,0,,1,4,0.25,2,4,6,1,0,0,0,1,7,6.4
Marreese Speights,29-095,C-F,11/7/16,LAC,DET,0,19,1,6,0.167,1,3,0.333,0,3,0,5,5,1,0,4,4,1,0,0,0,6,7,2.7
Luis Scola,36-250,F,1/5/17,BRK,IND,0,25,3,7,0.429,2,4,0.5,1,3,0.333,0,0,,1,2,3,2,0,0,1,3,7,3.8
Alex Len,23-153,C,11/16/16,PHO,DEN,0,21,2,4,0.5,2,4,0.5,0,0,,3,4,0.75,0,4,4,0,0,1,1,5,7,3.5
Yogi Ferrell,23-292,G,2/25/17,DAL,NOP,1,29,3,9,0.333,2,4,0.5,1,5,0.2,0,0,,2,3,5,7,0,0,1,2,7,7.3
Steven Adams,23-200,C,2/5/17,OKC,POR,1,38,3,11,0.273,3,11,0.273,0,0,,1,4,0.25,9,4,13,1,2,0,2,2,7,6.7
Alexis Ajinca,28-219,C,12/11/16,NOP,PHO,1,12,3,5,0.6,3,5,0.6,0,0,,1,2,0.5,1,4,5,0,2,0,1,2,7,6.4
Emmanuel Mudiay,20-270,G,11/30/16,DEN,MIA,1,36,3,11,0.273,3,9,0.333,0,2,0,1,3,0.333,2,6,8,7,0,1,4,0,7,4.5
Matt Barnes,36-312,F,1/15/17,SAC,OKC,0,27,3,6,0.5,2,4,0.5,1,2,0.5,0,0,,4,4,8,3,1,0,2,5,7,7.1
Julius Randle,21-334,F,10/28/16,LAL,UTA,1,27,3,7,0.429,2,6,0.333,1,1,1,0,0,,1,3,4,1,0,2,2,4,7,3.4
Jrue Holiday,26-269,G,3/8/17,NOP,TOR,1,32,3,9,0.333,2,5,0.4,1,4,0.25,0,0,,0,0,0,6,3,0,3,1,7,5.7
E'Twaun Moore,27-314,G,1/7/17,NOP,BOS,0,29,3,8,0.375,3,4,0.75,0,4,0,1,1,1,2,0,2,1,0,1,2,1,7,3
Alex Len,23-210,C,1/12/17,PHO,DAL,0,10,3,4,0.75,3,4,0.75,0,0,,1,2,0.5,0,3,3,0,0,1,1,0,7,5.6
Malcolm Brogdon,24-064,G,2/13/17,MIL,DET,0,21,2,6,0.333,2,6,0.333,0,0,,3,3,1,1,0,1,5,1,0,0,1,7,8.4
Okaro White,24-168,F,1/28/17,MIA,DET,0,19,2,3,0.667,1,1,1,1,2,0.5,2,2,1,0,2,2,0,0,0,0,2,7,5.5
Raymond Felton,32-277,G,3/30/17,LAC,PHO,0,16,3,7,0.429,2,4,0.5,1,3,0.333,0,0,,0,2,2,3,0,0,1,3,7,3.8
Jonathon Simmons,27-083,G-F,12/6/16,SAS,MIN,0,18,3,8,0.375,2,7,0.286,1,1,1,0,0,,0,2,2,0,0,2,0,3,7,3.4
Skal Labissiere,21-025,F,4/12/17,SAC,LAC,1,33,3,7,0.429,3,6,0.5,0,1,0,1,2,0.5,0,3,3,1,0,0,1,3,7,2.3
Trevor Ariza,31-215,F,1/31/17,HOU,SAC,1,27,2,6,0.333,1,2,0.5,1,4,0.25,2,2,1,0,9,9,4,1,0,0,0,7,10.1
Monta Ellis,31-021,G,11/16/16,IND,CLE,1,35,3,6,0.5,2,3,0.667,1,3,0.333,0,0,,1,5,6,4,1,5,1,2,7,11.7
Reggie Bullock,26-020,G-F,4/5/17,DET,TOR,1,23,3,5,0.6,2,3,0.667,1,2,0.5,0,0,,1,1,2,1,1,0,1,1,7,6
Pau Gasol,36-165,F-C,12/18/16,SAS,NOP,1,24,3,7,0.429,3,7,0.429,0,0,,1,4,0.25,5,9,14,4,0,2,1,1,7,11.1
Raymond Felton,32-129,G,11/2/16,LAC,OKC,0,16,3,5,0.6,2,4,0.5,1,1,1,0,0,,0,2,2,1,1,0,1,1,7,5.6
JaMychal Green,26-275,F,3/23/17,MEM,SAS,1,21,3,3,1,2,2,1,1,1,1,0,0,,2,4,6,1,0,0,0,2,7,8.6
Dante Exum,21-271,G,4/10/17,UTA,GSW,1,36,3,14,0.214,2,7,0.286,1,7,0.143,0,0,,3,3,6,2,2,0,2,4,7,1.2
Rondae Hollis-Jefferson,21-360,F,12/28/16,BRK,CHI,0,18,2,7,0.286,2,7,0.286,0,0,,3,5,0.6,0,1,1,1,2,0,2,3,7,1.9
Maurice Harkless,23-213,F-G,12/10/16,POR,IND,1,31,3,7,0.429,2,3,0.667,1,4,0.25,0,0,,1,0,1,0,1,0,1,2,7,3.2
Marvin Williams,30-276,F,3/22/17,CHO,ORL,1,33,3,7,0.429,2,4,0.5,1,3,0.333,0,0,,1,9,10,2,0,0,0,1,7,7.7
Ian Clark,25-298,G,12/30/16,GSW,DAL,0,24,3,8,0.375,3,5,0.6,0,3,0,1,2,0.5,1,1,2,1,1,0,1,0,7,3.9
Alan Anderson,34-055,G-F,12/10/16,LAC,NOP,0,19,3,6,0.5,2,4,0.5,1,2,0.5,0,0,,0,1,1,1,1,0,2,1,7,3.6
Sheldon McClellan,23-311,G,10/27/16,WAS,ATL,0,4,3,4,0.75,2,2,1,1,2,0.5,0,0,,0,0,0,0,2,0,0,0,7,7.4
Trey Burke,24-088,G,2/8/17,WAS,BRK,0,14,3,6,0.5,2,4,0.5,1,2,0.5,0,0,,0,0,0,2,0,0,1,1,7,4
Thon Maker,19-351,F-C,2/10/17,MIL,LAL,1,17,3,6,0.5,2,2,1,1,4,0.25,0,0,,1,5,6,1,0,0,0,5,7,4.9
Dante Exum,21-146,G,12/6/16,UTA,PHO,1,17,3,5,0.6,2,3,0.667,1,2,0.5,0,0,,0,3,3,1,0,1,2,5,7,3
Montrezl Harrell,23-005,F-C,1/31/17,HOU,SAC,0,15,3,3,1,3,3,1,0,0,,1,2,0.5,1,2,3,3,0,0,0,3,7,7.9
Marcin Gortat,33-016,C-F,3/5/17,WAS,ORL,1,22,1,3,0.333,1,3,0.333,0,0,,5,6,0.833,4,7,11,1,1,0,3,3,7,7.3
Trey Burke,24-070,G,1/21/17,WAS,DET,0,9,3,5,0.6,2,4,0.5,1,1,1,0,0,,1,1,2,2,0,0,1,3,7,4.9
Justin Anderson,23-100,G,2/27/17,PHI,GSW,0,10,3,5,0.6,3,3,1,0,2,0,1,1,1,2,2,4,0,1,0,1,3,7,5.5
Brandon Knight,25-009,G,12/11/16,PHO,NOP,0,16,3,6,0.5,3,5,0.6,0,1,0,1,2,0.5,0,2,2,2,1,0,1,1,7,5.2
Jodie Meeks,29-105,G,12/4/16,ORL,DET,0,16,3,8,0.375,3,5,0.6,0,3,0,1,1,1,1,0,1,2,1,0,0,1,7,5.3
E'Twaun Moore,27-258,G,11/12/16,NOP,LAL,1,24,3,10,0.3,2,8,0.25,1,2,0.5,0,0,,2,1,3,0,1,0,0,0,7,3.9
Rondae Hollis-Jefferson,22-005,F,1/8/17,BRK,PHI,0,23,3,5,0.6,3,5,0.6,0,0,,1,2,0.5,0,4,4,1,2,0,3,3,7,4
Anthony Tolliver,31-200,F-C,12/18/16,SAC,DAL,0,23,2,6,0.333,1,2,0.5,1,4,0.25,2,2,1,1,6,7,1,0,2,1,1,7,6.8
C.J. Watson,32-282,G,1/24/17,ORL,CHI,0,23,3,6,0.5,3,5,0.6,0,1,0,1,2,0.5,1,2,3,6,0,0,1,2,7,7.3
Jamal Murray,19-309,G,12/28/16,DEN,MIN,0,13,3,5,0.6,2,2,1,1,3,0.333,0,0,,0,1,1,0,3,1,0,3,7,7.5
Ryan Anderson,28-228,F,12/20/16,HOU,SAS,1,37,2,8,0.25,1,5,0.2,1,3,0.333,2,2,1,2,4,6,2,1,0,1,3,7,5
Rondae Hollis-Jefferson,21-333,F,12/1/16,BRK,MIL,0,17,3,7,0.429,3,6,0.5,0,1,0,1,2,0.5,0,2,2,1,1,2,1,3,7,4.4
Sean Kilpatrick,26-347,G,12/18/16,BRK,PHI,1,26,2,5,0.4,2,3,0.667,0,2,0,3,4,0.75,0,4,4,3,1,0,2,1,7,5.8
Marquese Chriss,19-142,F,11/21/16,PHO,WAS,1,16,3,8,0.375,2,6,0.333,1,2,0.5,0,0,,2,1,3,0,0,1,2,3,7,1.8
Cameron Payne,22-216,G,3/12/17,CHI,BOS,0,20,3,7,0.429,2,3,0.667,1,4,0.25,0,0,,0,2,2,3,2,0,5,3,7,1.8
Yogi Ferrell,23-338,G,4/12/17,DAL,MEM,1,28,2,9,0.222,1,5,0.2,1,4,0.25,2,3,0.667,0,1,1,5,1,1,2,3,7,3.4
Kelly Olynyk,25-290,C-F,2/3/17,BOS,LAL,0,16,3,8,0.375,3,5,0.6,0,3,0,1,2,0.5,2,7,9,2,0,0,1,2,7,5.3
DeMarre Carroll,30-098,F,11/2/16,TOR,WAS,1,22,2,7,0.286,1,2,0.5,1,5,0.2,2,4,0.5,0,1,1,0,2,1,1,1,7,3.7
Wade Baldwin,20-211,G,10/26/16,MEM,MIN,0,25,3,8,0.375,2,6,0.333,1,2,0.5,0,0,,2,3,5,6,3,3,1,2,7,12.4
Darrell Arthur,28-318,F,2/6/17,DEN,DAL,0,22,3,8,0.375,2,3,0.667,1,5,0.2,0,0,,0,3,3,2,1,3,1,2,7,6.2
Malachi Richardson,20-361,G,12/31/16,SAC,MEM,0,10,2,4,0.5,1,1,1,1,3,0.333,2,2,1,0,1,1,0,0,0,0,0,7,5.3
Luke Babbitt,27-192,F,12/29/16,MIA,CHO,1,21,3,5,0.6,2,2,1,1,3,0.333,0,0,,0,3,3,1,0,2,0,2,7,6.9
Tim Frazier,26-037,G,12/8/16,NOP,PHI,1,29,3,7,0.429,2,4,0.5,1,3,0.333,0,0,,2,4,6,6,0,0,3,3,7,5.9
Kyle Anderson,23-114,F-G,1/12/17,SAS,LAL,0,16,2,3,0.667,1,2,0.5,1,1,1,2,2,1,0,2,2,0,0,0,1,1,7,4.9
Marreese Speights,29-234,C-F,3/26/17,LAC,SAC,0,13,3,6,0.5,2,3,0.667,1,3,0.333,0,0,,1,3,4,0,1,0,0,3,7,5.4
Nemanja Bjelica,28-266,F,1/30/17,MIN,ORL,0,24,3,4,0.75,3,4,0.75,0,0,,1,2,0.5,1,3,4,1,0,2,0,2,7,7.9
Wade Baldwin,20-249,G,12/3/16,MEM,LAL,0,20,2,7,0.286,2,6,0.333,0,1,0,3,4,0.75,0,2,2,9,3,1,2,2,7,10.3
Jamal Crawford,36-283,G,12/28/16,LAC,NOP,0,29,3,15,0.2,3,12,0.25,0,3,0,1,1,1,0,0,0,3,0,0,1,1,7,-1.6
Cory Joseph,25-107,G,12/5/16,TOR,CLE,0,13,3,4,0.75,2,3,0.667,1,1,1,0,0,,0,0,0,2,1,0,0,3,7,6.6
Nick Collison,36-147,F,3/22/17,OKC,PHI,0,8,3,3,1,3,3,1,0,0,,1,1,1,2,3,5,2,0,1,0,3,7,9.3
Marco Belinelli,30-309,G-F,1/28/17,CHO,SAC,0,28,3,10,0.3,2,3,0.667,1,7,0.143,0,0,,0,1,1,1,2,0,1,3,7,2
Darren Collison,29-113,G,12/14/16,SAC,HOU,1,29,2,10,0.2,2,8,0.25,0,2,0,3,3,1,0,4,4,9,0,0,4,1,7,3.9
Tristan Thompson,26-018,F-C,3/31/17,CLE,PHI,1,29,3,7,0.429,3,7,0.429,0,0,,1,2,0.5,7,4,11,0,0,1,0,1,7,9.3
Arron Afflalo,31-012,G,10/27/16,SAC,SAS,1,36,3,9,0.333,2,6,0.333,1,3,0.333,0,0,,0,4,4,1,1,0,0,1,7,4.4
Trevor Ariza,31-165,F,12/12/16,HOU,BRK,1,37,3,8,0.375,3,4,0.75,0,4,0,1,3,0.333,0,4,4,2,3,2,1,3,7,6.6
Rajon Rondo,31-036,G,3/30/17,CHI,CLE,1,36,3,13,0.231,3,13,0.231,0,0,,1,4,0.25,3,6,9,15,2,1,2,2,7,12.2
Ed Davis,27-255,F,2/15/17,POR,UTA,1,19,3,5,0.6,3,5,0.6,0,0,,1,2,0.5,3,2,5,0,0,0,1,1,7,5.6
Ian Mahinmi,30-113,C,2/26/17,WAS,UTA,0,16,2,3,0.667,2,3,0.667,0,0,,3,3,1,2,0,2,1,2,0,2,2,7,7
Sam Dekker,22-302,F,3/4/17,HOU,MEM,0,18,3,4,0.75,2,3,0.667,1,1,1,0,0,,1,2,3,2,0,0,0,0,7,8.1
Nicolas Batum,28-003,F-G,12/17/16,CHO,ATL,1,32,3,13,0.231,3,11,0.273,0,2,0,1,2,0.5,0,3,3,4,4,0,0,2,7,5.6
Boris Diaw,34-226,F-C,11/28/16,UTA,MIN,1,29,3,3,1,2,2,1,1,1,1,0,0,,1,1,2,5,2,0,2,3,7,9.4
Draymond Green,26-325,F,1/23/17,GSW,MIA,1,39,3,8,0.375,3,5,0.6,0,3,0,1,4,0.25,1,2,3,7,1,1,2,3,7,6.1
Draymond Green,27-017,F,3/21/17,GSW,DAL,1,28,2,6,0.333,1,2,0.5,1,4,0.25,2,2,1,0,7,7,8,0,0,2,3,7,8.1
Justin Holiday,27-248,G,12/9/16,NYK,SAC,0,15,3,6,0.5,2,4,0.5,1,2,0.5,0,0,,1,2,3,1,0,0,0,1,7,5.6
Jerami Grant,23-008,F,3/20/17,OKC,GSW,0,15,3,4,0.75,3,4,0.75,0,0,,1,4,0.25,0,1,1,0,0,0,0,0,7,4.5
Kyle O'Quinn,26-342,F-C,3/3/17,NYK,PHI,0,17,2,4,0.5,2,4,0.5,0,0,,3,4,0.75,2,2,4,0,0,1,1,4,7,4.7
Trevor Ariza,31-162,F,12/9/16,HOU,OKC,1,34,2,7,0.286,1,2,0.5,1,5,0.2,2,2,1,3,5,8,3,1,0,0,0,7,9.6
Tony Snell,25-111,G-F,3/1/17,MIL,DEN,1,31,3,8,0.375,2,3,0.667,1,5,0.2,0,0,,0,1,1,2,0,0,0,3,7,3.1
Jerian Grant,24-148,G,3/6/17,CHI,DET,1,23,3,8,0.375,2,4,0.5,1,4,0.25,0,0,,0,3,3,8,1,0,0,0,7,10.1
Jimmy Butler,27-093,G-F,12/16/16,CHI,MIL,1,30,3,14,0.214,2,9,0.222,1,5,0.2,0,0,,2,5,7,6,1,0,1,3,7,4.3
Cristiano Felicio,24-114,F-C,10/29/16,CHI,IND,0,20,3,5,0.6,3,5,0.6,0,0,,1,2,0.5,3,5,8,0,0,0,1,2,7,6.1
DeMarre Carroll,30-254,F,4/7/17,TOR,MIA,1,22,2,4,0.5,0,1,0,2,3,0.667,1,2,0.5,0,1,1,0,1,0,1,2,7,4.1
Jerami Grant,22-263,F,11/30/16,OKC,WAS,0,24,1,3,0.333,0,0,,1,3,0.333,4,8,0.5,2,2,4,1,1,0,1,4,7,4.8
Terrence Jones,25-009,F,1/18/17,NOP,ORL,0,18,3,6,0.5,2,4,0.5,1,2,0.5,0,0,,0,5,5,3,1,1,0,1,7,8.9
Mason Plumlee,26-260,C-F,11/20/16,POR,BRK,1,24,3,6,0.5,3,6,0.5,0,0,,1,3,0.333,2,6,8,4,1,2,2,3,7,8.4
Wayne Ellington,29-119,G,2/25/17,MIA,IND,0,21,2,5,0.4,0,0,,2,5,0.4,1,1,1,0,4,4,0,0,0,2,0,7,3.5
Devin Harris,34-026,G,3/25/17,DAL,TOR,0,18,3,5,0.6,3,3,1,0,2,0,1,1,1,0,1,1,3,2,0,2,2,7,6.3
Jonas Valanciunas,24-314,C,3/16/17,TOR,OKC,1,17,3,7,0.429,3,7,0.429,0,0,,1,1,1,2,3,5,0,0,2,1,3,7,4.8
Jeff Green,30-181,F,2/25/17,ORL,ATL,0,22,1,4,0.25,0,1,0,1,3,0.333,4,4,1,1,3,4,0,1,0,1,3,7,5
James Ennis,26-265,F,3/23/17,MEM,SAS,0,18,3,3,1,2,2,1,1,1,1,0,0,,0,5,5,0,0,0,0,1,7,7.2
Montrezl Harrell,22-336,F-C,12/27/16,HOU,DAL,0,26,3,7,0.429,3,7,0.429,0,0,,1,2,0.5,2,0,2,1,0,1,0,2,7,4.9
Semaj Christon,24-043,G,12/14/16,OKC,UTA,0,23,3,9,0.333,2,6,0.333,1,3,0.333,0,0,,1,2,3,2,0,0,1,2,7,2.8
Caris LeVert,22-191,G-F,3/4/17,BRK,POR,1,24,3,7,0.429,3,5,0.6,0,2,0,1,2,0.5,0,2,2,6,2,0,1,2,7,7.9
Mason Plumlee,26-317,C-F,1/16/17,POR,WAS,1,21,2,7,0.286,2,7,0.286,0,0,,3,3,1,2,3,5,3,1,2,2,2,7,6.9
Jose Calderon,35-195,G,4/11/17,ATL,CHO,0,17,3,4,0.75,2,2,1,1,2,0.5,0,0,,0,1,1,3,0,0,1,2,7,6
Jaylen Brown,20-164,F,4/6/17,BOS,ATL,0,17,2,5,0.4,1,3,0.333,1,2,0.5,2,2,1,0,1,1,3,0,0,2,3,7,3.5
Jerian Grant,24-164,G,3/22/17,CHI,DET,0,15,2,4,0.5,1,1,1,1,3,0.333,2,2,1,0,1,1,1,0,1,0,1,7,6.3
Steven Adams,23-137,C,12/4/16,OKC,NOP,1,9,3,3,1,3,3,1,0,0,,1,1,1,0,3,3,0,1,0,0,0,7,8
Andrew Harrison,22-150,G,3/27/17,MEM,SAC,0,27,3,7,0.429,2,5,0.4,1,2,0.5,0,0,,0,4,4,2,0,0,1,4,7,3.3
DeMarre Carroll,30-184,F,1/27/17,TOR,MIL,1,32,2,9,0.222,1,3,0.333,1,6,0.167,2,3,0.667,0,3,3,2,0,2,1,3,7,2.6
Reggie Jackson,26-234,G,12/6/16,DET,CHI,1,18,2,9,0.222,1,8,0.125,1,1,1,2,3,0.667,0,3,3,7,2,0,2,3,7,5.7
Tony Snell,25-125,G-F,3/15/17,MIL,LAC,1,31,3,9,0.333,2,2,1,1,7,0.143,0,0,,0,3,3,0,1,0,0,1,7,3.4
Buddy Hield,23-088,G,3/15/17,SAC,PHO,1,21,3,7,0.429,2,4,0.5,1,3,0.333,0,0,,0,2,2,0,0,1,2,3,7,1.4
Anthony Tolliver,31-226,F-C,1/13/17,SAC,CLE,1,34,3,10,0.3,2,6,0.333,1,4,0.25,0,0,,3,4,7,0,2,0,1,3,7,4.3
Austin Rivers,24-102,G,11/11/16,LAC,OKC,0,18,2,5,0.4,2,3,0.667,0,2,0,3,7,0.429,1,0,1,0,1,0,0,4,7,2.8
James Ennis,26-128,F,11/6/16,MEM,POR,0,35,3,8,0.375,2,4,0.5,1,4,0.25,0,0,,0,3,3,0,0,0,1,4,7,0.9
Tony Allen,35-051,G-F,3/3/17,MEM,DAL,1,22,3,6,0.5,2,4,0.5,1,2,0.5,0,0,,0,2,2,0,1,0,1,0,7,4.6
Anthony Morrow,31-135,G,2/9/17,OKC,CLE,0,8,3,7,0.429,2,2,1,1,5,0.2,0,0,,0,2,2,0,0,0,0,0,7,3.9
Stanley Johnson,20-255,F,2/8/17,DET,LAL,0,18,2,3,0.667,2,2,1,0,1,0,3,3,1,0,2,2,3,0,1,2,2,7,6.3
Josh Huestis,25-114,F,4/12/17,OKC,DEN,0,24,3,7,0.429,2,5,0.4,1,2,0.5,0,1,0,2,3,5,2,0,3,0,0,7,8.7
Alex Abrines,23-104,G-F,11/13/16,OKC,ORL,0,19,3,7,0.429,2,3,0.667,1,4,0.25,0,0,,0,3,3,0,0,0,1,3,7,2
Michael Beasley,28-033,F,2/11/17,MIL,IND,1,26,3,8,0.375,2,7,0.286,1,1,1,0,0,,3,3,6,3,0,0,2,1,7,5.3
Dante Exum,21-245,G,3/15/17,UTA,DET,0,23,3,4,0.75,2,3,0.667,1,1,1,0,0,,0,3,3,4,1,0,1,4,7,7.5
Thabo Sefolosha,32-248,G-F,1/5/17,ATL,NOP,1,32,3,6,0.5,2,4,0.5,1,2,0.5,0,0,,1,5,6,5,1,3,2,2,7,10
Mario Hezonja,22-044,F-G,4/10/17,ORL,CHI,0,32,2,9,0.222,0,3,0,2,6,0.333,1,2,0.5,0,0,0,1,2,0,0,0,7,3.8
Ramon Sessions,30-226,G,11/23/16,CHO,SAS,0,16,3,4,0.75,2,3,0.667,1,1,1,0,0,,0,0,0,4,1,0,0,0,7,9.2
Trey Lyles,21-082,F,1/26/17,UTA,LAL,0,19,2,7,0.286,1,4,0.25,1,3,0.333,2,2,1,0,3,3,1,0,0,1,1,7,3.1
Dwight Howard,31-095,C,3/13/17,ATL,SAS,1,30,2,5,0.4,2,5,0.4,0,0,,3,10,0.3,2,11,13,1,1,0,1,1,7,6.5
Rudy Gay,30-117,F,12/12/16,SAC,LAL,1,14,2,6,0.333,2,3,0.667,0,3,0,3,3,1,0,5,5,2,2,1,0,0,7,9.2
Aron Baynes,29-353,C,11/26/16,DET,OKC,0,12,1,2,0.5,1,2,0.5,0,0,,5,6,0.833,2,2,4,1,0,1,2,3,7,5.8
Langston Galloway,25-007,G,12/16/16,NOP,HOU,0,21,3,10,0.3,2,5,0.4,1,5,0.2,0,1,0,1,0,1,3,0,0,0,2,7,2.8
Deron Williams,32-195,G,1/7/17,DAL,ATL,1,28,3,12,0.25,3,7,0.429,0,5,0,1,1,1,2,5,7,4,0,0,4,3,7,0.3
Jordan Clarkson,24-183,G,12/7/16,LAL,HOU,1,35,3,13,0.231,2,8,0.25,1,5,0.2,0,0,,0,2,2,2,0,0,1,0,7,0.1
Patrick Beverley,28-136,G,11/25/16,HOU,SAC,1,31,2,5,0.4,0,1,0,2,4,0.5,1,2,0.5,3,4,7,6,2,0,1,3,7,11.2
Garrett Temple,30-267,G,1/30/17,SAC,PHI,1,35,3,6,0.5,2,3,0.667,1,3,0.333,0,1,0,1,0,1,5,2,0,2,5,7,5.8
David West,36-084,F,11/21/16,GSW,IND,0,15,2,5,0.4,2,5,0.4,0,0,,3,3,1,0,4,4,2,1,1,4,2,7,3.8
Courtney Lee,31-100,G,1/11/17,NYK,PHI,1,27,3,7,0.429,3,4,0.75,0,3,0,1,1,1,1,1,2,4,0,0,1,2,7,5.3
K.J. McDaniels,23-341,G-F,1/15/17,HOU,BRK,0,6,2,2,1,1,1,1,1,1,1,2,2,1,0,1,1,0,0,0,0,3,7,5.5
Jeff Withey,27-022,C,3/29/17,UTA,SAC,0,14,3,3,1,3,3,1,0,0,,1,1,1,0,3,3,1,2,0,1,3,7,7.5
Tony Parker,34-255,G,1/27/17,SAS,NOP,1,22,2,7,0.286,2,6,0.333,0,1,0,3,4,0.75,0,1,1,3,0,1,2,1,7,3.2
Will Barton,25-365,G,1/5/17,DEN,SAS,0,15,2,6,0.333,2,5,0.4,0,1,0,3,3,1,0,1,1,2,3,0,1,1,7,6.9
JaMychal Green,26-223,F,1/30/17,MEM,PHO,1,28,2,7,0.286,0,3,0,2,4,0.5,1,2,0.5,3,5,8,1,1,0,0,4,7,6.2
P.J. Tucker,31-179,F,10/31/16,PHO,LAC,0,27,3,6,0.5,2,4,0.5,1,2,0.5,0,0,,1,5,6,0,2,0,2,2,7,5.4
Domantas Sabonis,20-225,F,12/14/16,OKC,UTA,1,16,3,6,0.5,2,4,0.5,1,2,0.5,0,0,,0,4,4,2,0,0,0,0,7,6.6
D.J. Augustin,28-351,G,10/26/16,ORL,MIA,0,17,2,3,0.667,2,2,1,0,1,0,3,3,1,0,1,1,1,0,0,1,2,7,4.9
Boris Diaw,34-333,F-C,3/15/17,UTA,DET,0,19,3,8,0.375,2,6,0.333,1,2,0.5,0,0,,1,1,2,3,0,0,0,0,7,5.7
Zaza Pachulia,32-297,C,12/3/16,GSW,PHO,1,15,3,5,0.6,3,5,0.6,0,0,,1,3,0.333,0,3,3,1,3,0,3,1,7,5.1
Marcin Gortat,32-299,C-F,12/12/16,WAS,MIA,1,32,3,5,0.6,3,5,0.6,0,0,,1,2,0.5,5,6,11,3,1,0,3,3,7,8.5
Tim Hardaway,24-256,G,11/27/16,ATL,LAL,0,13,3,6,0.5,2,3,0.667,1,3,0.333,0,1,0,1,0,1,0,0,1,1,1,7,3.6
Jakob Poeltl,21-179,C,4/12/17,TOR,CLE,0,23,3,3,1,3,3,1,0,0,,1,2,0.5,2,3,5,2,0,1,0,5,7,8.1
Ersan Ilyasova,29-288,F,2/27/17,ATL,BOS,0,17,2,8,0.25,1,3,0.333,1,5,0.2,2,2,1,1,3,4,1,0,1,1,3,7,3
Ramon Sessions,30-243,G,12/10/16,CHO,CLE,0,18,2,6,0.333,1,4,0.25,1,2,0.5,2,4,0.5,0,2,2,1,1,0,1,3,7,2.9
Tyus Jones,20-244,G,1/9/17,MIN,DAL,0,11,3,3,1,2,2,1,1,1,1,0,0,,1,0,1,0,1,0,0,1,7,7.4
Greg Monroe,26-161,C-F,11/12/16,MIL,MEM,0,21,2,3,0.667,2,3,0.667,0,0,,3,4,0.75,1,6,7,3,2,0,2,3,7,8.7
Patrick Beverley,28-248,G,3/17/17,HOU,NOP,1,31,2,9,0.222,1,5,0.2,1,4,0.25,2,2,1,2,5,7,1,0,0,1,5,7,2.1
Nemanja Bjelica,28-239,F,1/3/17,MIN,PHI,0,23,2,6,0.333,1,2,0.5,1,4,0.25,2,2,1,0,3,3,0,1,0,0,2,7,4.7
Serge Ibaka,27-199,F-C,4/5/17,TOR,DET,1,32,2,9,0.222,1,3,0.333,1,6,0.167,2,2,1,1,6,7,0,0,1,1,0,7,3.7
Kelly Olynyk,25-352,C-F,4/6/17,BOS,ATL,0,24,2,8,0.25,2,3,0.667,0,5,0,3,4,0.75,0,8,8,0,0,0,0,2,7,3.4
Aaron Gordon,21-054,F,11/9/16,ORL,MIN,1,31,2,9,0.222,2,6,0.333,0,3,0,3,4,0.75,1,3,4,0,0,1,1,2,7,1.6
Marcus Smart,22-362,G,3/3/17,BOS,LAL,0,28,1,7,0.143,1,4,0.25,0,3,0,5,5,1,0,5,5,4,4,0,5,1,7,5.4
Derrick Favors,25-154,F-C,12/16/16,UTA,DAL,0,14,2,3,0.667,2,3,0.667,0,0,,3,4,0.75,1,1,2,0,0,1,1,2,7,5.2
Reggie Jackson,26-247,G,12/19/16,DET,CHI,1,24,2,5,0.4,2,4,0.5,0,1,0,3,4,0.75,0,1,1,3,2,0,2,2,7,5.5
Courtney Lee,31-058,G,11/30/16,NYK,MIN,1,8,3,3,1,2,2,1,1,1,1,0,0,,0,1,1,3,0,0,0,1,7,8.1
Jae Crowder,26-252,F,3/15/17,BOS,MIN,1,28,1,8,0.125,0,3,0,1,5,0.2,4,4,1,2,2,4,0,0,1,1,4,7,1.9
Cody Zeller,24-024,F-C,10/29/16,CHO,BOS,1,21,2,4,0.5,2,4,0.5,0,0,,3,6,0.5,1,8,9,1,0,2,1,3,7,6.8
Nicolas Laprovittola,26-272,G,10/29/16,SAS,NOP,0,22,2,5,0.4,2,2,1,0,3,0,3,3,1,0,4,4,4,0,0,1,2,7,6.5
Dewayne Dedmon,27-176,C,2/4/17,SAS,DEN,1,14,3,3,1,3,3,1,0,0,,1,2,0.5,2,1,3,0,0,0,1,2,7,5.6
Isaiah Whitehead,22-013,G,3/21/17,BRK,DET,0,28,2,9,0.222,2,9,0.222,0,0,,3,4,0.75,2,2,4,2,0,1,0,2,7,4.4
Marcin Gortat,32-326,C-F,1/8/17,WAS,MIL,1,37,2,5,0.4,2,5,0.4,0,0,,3,4,0.75,2,10,12,0,0,1,3,2,7,5.2
Josh McRoberts,29-282,F,12/6/16,MIA,NYK,1,29,2,6,0.333,1,4,0.25,1,2,0.5,2,2,1,3,5,8,5,0,0,2,3,7,7.5
DeAndre Jordan,28-155,C,12/23/16,LAC,DAL,1,34,3,7,0.429,3,7,0.429,0,0,,1,4,0.25,3,14,17,0,1,2,4,3,7,5.6
Solomon Hill,26-011,F,3/29/17,NOP,DAL,1,36,2,7,0.286,0,2,0,2,5,0.4,1,2,0.5,1,3,4,1,0,0,1,3,7,2.6
Kenneth Faried,26-345,F,10/29/16,DEN,POR,0,30,2,4,0.5,2,4,0.5,0,0,,3,4,0.75,3,6,9,2,2,2,2,3,7,10.1
Jonas Jerebko,29-362,F,2/27/17,BOS,ATL,0,19,2,2,1,1,1,1,1,1,1,2,2,1,0,3,3,2,1,0,0,1,7,9.3
Marcus Morris,27-190,F,3/11/17,DET,NYK,1,34,3,10,0.3,2,6,0.333,1,4,0.25,0,0,,1,4,5,2,0,1,0,1,7,4.8
Leandro Barbosa,34-079,G,2/15/17,PHO,LAL,0,10,3,4,0.75,3,4,0.75,0,0,,1,1,1,0,0,0,2,0,1,1,0,7,6.5
Omri Casspi,28-163,F,12/2/16,SAC,BOS,0,27,2,9,0.222,1,7,0.143,1,2,0.5,2,3,0.667,3,2,5,1,0,1,0,1,7,4.8
Luke Babbitt,27-195,F,1/1/17,MIA,DET,1,17,3,5,0.6,2,4,0.5,1,1,1,0,0,,0,3,3,1,0,0,0,5,7,4.3
Luc Mbah a Moute,30-070,F,11/18/16,LAC,SAC,1,26,3,4,0.75,3,3,1,0,1,0,1,4,0.25,0,1,1,1,0,1,1,1,7,4.5
Sean Kilpatrick,27-011,G,1/17/17,BRK,TOR,0,26,1,7,0.143,0,4,0,1,3,0.333,4,4,1,0,1,1,3,0,0,1,2,7,3.1
Semaj Christon,24-046,G,12/17/16,OKC,PHO,0,22,3,7,0.429,3,5,0.6,0,2,0,1,1,1,0,5,5,1,1,0,1,3,7,4.3
Nicolas Laprovittola,26-306,G,12/2/16,SAS,WAS,1,20,2,5,0.4,1,2,0.5,1,3,0.333,2,2,1,0,1,1,3,2,0,2,3,7,5.5
Tristan Thompson,25-237,F-C,11/5/16,CLE,PHI,1,30,3,6,0.5,3,6,0.5,0,0,,1,2,0.5,6,7,13,0,0,2,0,2,7,10.5
Josh Richardson,23-053,G,11/7/16,MIA,OKC,0,25,3,8,0.375,2,4,0.5,1,4,0.25,0,0,,2,2,4,0,0,0,1,3,7,2.4
Ricky Rubio,26-031,G,11/21/16,MIN,BOS,1,38,1,7,0.143,0,3,0,1,4,0.25,4,4,1,4,4,8,9,1,0,0,3,7,12.6
Ivica Zubac,20-006,C,3/24/17,LAL,MIN,1,21,3,7,0.429,3,7,0.429,0,0,,1,1,1,0,3,3,3,1,0,4,3,7,2.1
Iman Shumpert,26-182,G,12/25/16,CLE,GSW,0,29,1,9,0.111,0,4,0,1,5,0.2,4,4,1,3,2,5,2,1,1,1,3,7,4.7
Jerami Grant,22-349,F,2/24/17,OKC,LAL,0,20,3,3,1,3,3,1,0,0,,1,1,1,0,2,2,0,1,1,0,1,7,8
Dwyane Wade,35-085,G,4/12/17,CHI,BRK,1,22,3,9,0.333,3,9,0.333,0,0,,1,2,0.5,0,2,2,4,0,0,6,1,7,-1.5
Noah Vonleh,21-183,F,2/23/17,POR,ORL,1,16,3,3,1,3,3,1,0,0,,1,2,0.5,1,3,4,0,0,1,3,1,7,4.6
Reggie Jackson,26-272,G,1/13/17,DET,UTA,1,27,3,11,0.273,2,10,0.2,1,1,1,0,1,0,0,1,1,2,1,0,3,2,7,-1
Courtney Lee,31-078,G,12/20/16,NYK,IND,1,37,2,7,0.286,1,4,0.25,1,3,0.333,2,2,1,1,3,4,1,1,0,1,1,7,4.8
Andre Roberson,25-095,G-F,3/9/17,OKC,SAS,1,27,3,4,0.75,3,3,1,0,1,0,1,2,0.5,2,3,5,1,2,1,1,2,7,8.9
Willie Cauley-Stein,23-223,F-C,3/29/17,SAC,UTA,1,29,3,9,0.333,3,9,0.333,0,0,,1,2,0.5,0,8,8,1,1,0,1,0,7,4.6
Tarik Black,25-138,C-F,4/9/17,LAL,MIN,0,17,2,3,0.667,2,3,0.667,0,0,,3,3,1,0,2,2,0,2,3,0,2,7,9.6
Chandler Parsons,28-129,F,3/3/17,MEM,DAL,1,24,3,11,0.273,2,7,0.286,1,4,0.25,0,0,,0,4,4,0,0,0,1,3,7,-0.5
Joel Anthony,34-241,C,4/7/17,SAS,DAL,0,30,2,2,1,2,2,1,0,0,,3,6,0.5,1,8,9,1,0,2,1,1,7,9
Bojan Bogdanovic,27-238,G-F,12/12/16,BRK,HOU,1,22,3,8,0.375,2,5,0.4,1,3,0.333,0,1,0,0,1,1,1,1,0,0,3,7,3
Solomon Hill,25-317,F,1/29/17,NOP,WAS,1,39,2,9,0.222,0,2,0,2,7,0.286,1,2,0.5,1,2,3,2,3,1,0,2,7,6.7
Reggie Bullock,25-303,G-F,1/13/17,DET,UTA,0,26,3,6,0.5,3,5,0.6,0,1,0,1,1,1,0,2,2,3,2,0,1,0,7,7.7
Wayne Ellington,29-139,G,3/17/17,MIA,MIN,0,18,3,8,0.375,2,2,1,1,6,0.167,0,0,,0,2,2,1,0,0,0,0,7,3.9
Chris McCullough,21-294,F,11/25/16,BRK,IND,0,7,3,4,0.75,3,4,0.75,0,0,,1,1,1,1,2,3,0,0,0,0,0,7,6.7
Jared Dudley,31-233,F-G,2/28/17,PHO,MEM,0,15,2,4,0.5,1,1,1,1,3,0.333,2,2,1,0,1,1,1,0,1,1,2,7,4.9
Luis Scola,36-217,F,12/3/16,BRK,MIL,0,11,3,4,0.75,3,3,1,0,1,0,1,1,1,2,1,3,0,0,1,0,1,7,7.4
James Michael McAdoo,24-042,F,2/15/17,GSW,SAC,0,14,3,6,0.5,3,6,0.5,0,0,,1,2,0.5,0,2,2,0,0,1,0,0,7,4.9
C.J. Miles,29-340,G-F,3/24/17,IND,DEN,1,18,2,8,0.25,1,4,0.25,1,4,0.25,2,2,1,1,1,2,1,0,0,0,6,7,1.5
Nikola Vucevic,26-004,C,10/28/16,ORL,DET,1,26,3,12,0.25,3,12,0.25,0,0,,1,2,0.5,4,10,14,3,1,0,1,0,7,7.3
Kenneth Faried,26-365,F,11/18/16,DEN,TOR,1,24,3,4,0.75,3,4,0.75,0,0,,1,1,1,1,10,11,2,2,2,2,3,7,10.7
Paul Zipser,23-051,G-F,4/10/17,CHI,ORL,0,26,3,8,0.375,2,5,0.4,1,3,0.333,0,0,,0,8,8,3,1,0,1,2,7,6.3
James Ennis,26-258,F,3/16/17,MEM,ATL,0,20,2,6,0.333,1,3,0.333,1,3,0.333,2,2,1,0,1,1,1,0,1,0,3,7,4.1
David West,36-082,F,11/19/16,GSW,MIL,0,12,3,4,0.75,3,4,0.75,0,0,,1,2,0.5,4,3,7,3,0,1,1,3,7,9.3
Markieff Morris,27-177,F,2/26/17,WAS,UTA,1,29,3,11,0.273,3,9,0.333,0,2,0,1,1,1,0,4,4,1,3,0,2,6,7,1
Vince Carter,39-304,G-F,11/25/16,MEM,MIA,0,16,2,7,0.286,1,3,0.333,1,4,0.25,2,2,1,1,4,5,0,1,0,1,3,7,3.6
Marcus Smart,22-241,G,11/2/16,BOS,CHI,0,34,2,8,0.25,1,2,0.5,1,6,0.167,2,4,0.5,0,5,5,5,1,1,6,1,7,1.7
Kris Humphries,31-350,F-C,1/21/17,ATL,PHI,0,16,2,4,0.5,2,4,0.5,0,0,,3,4,0.75,1,8,9,0,0,0,0,2,7,6.9
C.J. Watson,32-226,G,11/29/16,ORL,SAS,0,17,3,3,1,2,2,1,1,1,1,0,0,,0,1,1,3,0,0,1,2,7,6.7
Hollis Thompson,25-247,G-F,12/6/16,PHI,MEM,0,23,2,6,0.333,0,2,0,2,4,0.5,1,2,0.5,0,1,1,2,0,1,1,2,7,3.8
Isaiah Whitehead,21-342,G,2/13/17,BRK,MEM,0,17,3,5,0.6,2,3,0.667,1,2,0.5,0,0,,0,0,0,2,2,0,1,3,7,5.9
David West,36-218,F,4/4/17,GSW,MIN,0,15,3,4,0.75,3,4,0.75,0,0,,1,1,1,1,3,4,6,0,1,2,0,7,9.9
James Ennis,26-143,F,11/21/16,MEM,CHO,1,13,3,4,0.75,2,2,1,1,2,0.5,0,0,,0,0,0,2,0,0,1,1,7,5.4
Ben McLemore,23-316,G,12/23/16,SAC,MIN,1,16,2,4,0.5,1,1,1,1,3,0.333,2,3,0.667,0,3,3,0,0,0,0,2,7,4.7
Amir Johnson,29-288,F,2/13/17,BOS,DAL,1,21,3,4,0.75,2,3,0.667,1,1,1,0,0,,2,5,7,5,0,1,1,3,7,10.3
Anthony Brown,24-050,F-G,11/29/16,NOP,LAL,0,22,3,5,0.6,2,3,0.667,1,2,0.5,0,0,,2,4,6,2,2,0,1,4,7,8.1
Jonathon Simmons,27-208,G-F,4/10/17,SAS,POR,0,12,3,6,0.5,3,6,0.5,0,0,,1,3,0.333,0,0,0,1,0,0,0,1,7,3.5
Bojan Bogdanovic,27-359,G-F,4/12/17,WAS,MIA,0,19,3,8,0.375,2,6,0.333,1,2,0.5,0,0,,1,0,1,1,0,0,0,1,7,3.6
Udonis Haslem,36-209,F-C,1/4/17,MIA,SAC,0,18,2,3,0.667,2,3,0.667,0,0,,3,4,0.75,1,2,3,2,0,1,2,4,7,5.1
Tyson Chandler,34-088,C,12/29/16,PHO,TOR,1,27,3,4,0.75,3,4,0.75,0,0,,1,3,0.333,4,9,13,1,2,1,2,2,7,10.7
Miles Plumlee,28-141,C-F,1/20/17,MIL,ORL,0,16,2,5,0.4,2,5,0.4,0,0,,3,7,0.429,0,0,0,0,0,1,0,1,7,3
Devin Harris,34-006,G,3/5/17,DAL,OKC,0,18,2,5,0.4,1,3,0.333,1,2,0.5,2,2,1,0,2,2,7,1,0,1,1,7,9.4
Tyler Zeller,27-071,F-C,3/29/17,BOS,MIL,0,8,3,5,0.6,3,5,0.6,0,0,,1,1,1,1,1,2,1,0,0,0,2,7,5.6
Rodney McGruder,25-136,G,12/12/16,MIA,WAS,1,30,3,5,0.6,2,3,0.667,1,2,0.5,0,0,,1,2,3,1,0,0,1,4,7,4.1
D.J. Augustin,29-040,G,12/20/16,ORL,MIA,1,26,2,9,0.222,1,5,0.2,1,4,0.25,2,3,0.667,0,1,1,6,0,0,1,2,7,3.8
Mindaugas Kuzminskas,27-100,F,1/27/17,NYK,CHO,0,18,3,7,0.429,3,6,0.5,0,1,0,1,1,1,2,2,4,2,1,0,2,1,7,5.3
Hassan Whiteside,27-226,C,1/25/17,MIA,BRK,1,21,3,10,0.3,3,10,0.3,0,0,,1,2,0.5,0,1,1,1,0,1,1,2,7,0.7
Randy Foye,33-068,G,12/1/16,BRK,MIL,0,23,2,7,0.286,1,3,0.333,1,4,0.25,2,2,1,0,6,6,1,0,3,2,1,7,5.1
Maurice Harkless,23-171,F-G,10/29/16,POR,DEN,1,32,2,6,0.333,0,3,0,2,3,0.667,1,2,0.5,0,3,3,0,0,0,1,6,7,0.7
Sasha Vujacic,32-313,G,1/15/17,NYK,TOR,0,7,2,3,0.667,0,0,,2,3,0.667,1,2,0.5,0,1,1,2,1,0,0,1,7,7.6
Kosta Koufos,27-317,C,1/6/17,SAC,LAC,0,12,3,4,0.75,3,4,0.75,0,0,,1,2,0.5,1,2,3,0,0,1,0,3,7,5.8
Raymond Felton,32-158,G,12/1/16,LAC,CLE,0,19,3,7,0.429,2,5,0.4,1,2,0.5,0,0,,0,3,3,1,0,1,0,3,7,4.4
Chris Paul,31-306,G,3/8/17,LAC,MIN,1,32,3,9,0.333,2,5,0.4,1,4,0.25,0,1,0,1,2,3,10,1,0,3,2,7,7
Tyler Ennis,22-201,G,3/13/17,LAL,DEN,0,20,2,6,0.333,2,5,0.4,0,1,0,3,3,1,2,1,3,2,0,0,1,3,7,4.5
Lou Williams,30-003,G,10/30/16,LAL,OKC,0,20,2,7,0.286,2,5,0.4,0,2,0,3,4,0.75,0,1,1,2,1,0,2,1,7,2.8
Jahlil Okafor,20-338,C-F,11/17/16,PHI,MIN,0,22,2,5,0.4,2,5,0.4,0,0,,3,4,0.75,0,2,2,0,0,0,1,2,7,2.7
Marquese Chriss,19-226,F,2/13/17,PHO,NOP,1,16,3,9,0.333,3,6,0.5,0,3,0,1,2,0.5,2,1,3,0,2,0,1,4,7,2.6
Meyers Leonard,25-033,C-F,4/1/17,POR,PHO,1,22,1,5,0.2,0,1,0,1,4,0.25,4,4,1,0,4,4,0,1,0,0,4,7,4.5
Brandon Bass,31-347,F,4/12/17,LAC,SAC,0,9,1,2,0.5,1,2,0.5,0,0,,5,6,0.833,0,1,1,0,0,0,0,1,7,5.5
Vince Carter,40-008,G-F,2/3/17,MEM,OKC,0,19,3,6,0.5,2,2,1,1,4,0.25,0,0,,0,0,0,3,0,1,0,1,7,6.4
Marco Belinelli,30-285,G-F,1/4/17,CHO,OKC,0,15,1,4,0.25,1,3,0.333,0,1,0,5,6,0.833,0,2,2,1,0,0,0,1,7,5.1
Dante Cunningham,29-267,F,1/14/17,NOP,CHI,0,19,3,7,0.429,2,3,0.667,1,4,0.25,0,0,,1,4,5,1,0,0,0,3,7,4.7
Meyers Leonard,24-294,C-F,12/17/16,POR,GSW,0,17,2,6,0.333,1,3,0.333,1,3,0.333,2,2,1,0,1,1,0,1,1,1,3,7,3.4
Marco Belinelli,31-008,G-F,4/2/17,CHO,OKC,0,17,2,5,0.4,2,3,0.667,0,2,0,3,3,1,0,4,4,2,1,0,2,2,7,5.1
Luc Mbah a Moute,30-188,F,3/16/17,LAC,DEN,1,20,3,9,0.333,2,8,0.25,1,1,1,0,0,,2,4,6,1,0,1,0,2,7,5.1
Jarell Martin,22-208,F,12/18/16,MEM,UTA,0,13,3,7,0.429,3,6,0.5,0,1,0,1,1,1,2,1,3,0,0,0,0,2,7,4.2
James Johnson,29-302,F,12/18/16,MIA,BOS,0,19,3,4,0.75,2,3,0.667,1,1,1,0,0,,0,2,2,2,1,0,5,2,7,2.6
Justin Holiday,27-343,G,3/14/17,NYK,IND,0,20,3,5,0.6,2,3,0.667,1,2,0.5,0,0,,1,1,2,0,0,0,0,0,7,5.7
Jonas Valanciunas,24-299,C,3/1/17,TOR,WAS,1,21,3,12,0.25,3,12,0.25,0,0,,1,1,1,7,4,11,1,0,0,1,2,7,4.8
Stanley Johnson,20-234,F,1/18/17,DET,ATL,0,32,3,5,0.6,2,4,0.5,1,1,1,0,0,,2,2,4,3,3,0,3,2,7,8
James Johnson,29-268,F,11/14/16,MIA,SAS,0,18,2,4,0.5,1,2,0.5,1,2,0.5,2,2,1,2,3,5,0,1,2,1,5,7,6.7
Otto Porter,23-186,F,12/6/16,WAS,ORL,1,27,3,4,0.75,2,2,1,1,2,0.5,0,0,,1,2,3,0,0,0,1,4,7,4.1
Ed Davis,27-175,F,11/27/16,POR,HOU,1,22,3,3,1,3,3,1,0,0,,1,2,0.5,1,2,3,1,0,0,0,3,7,6.5
Wayne Ellington,29-155,G,4/2/17,MIA,DEN,0,13,3,8,0.375,2,3,0.667,1,5,0.2,0,0,,0,1,1,0,0,0,0,2,7,2.1
Doug McDermott,25-014,F,1/17/17,CHI,DAL,0,22,3,10,0.3,2,6,0.333,1,4,0.25,0,0,,0,6,6,2,0,0,0,4,7,2.8
Paul Pierce,39-068,F-G,12/20/16,LAC,DEN,1,18,2,6,0.333,0,1,0,2,5,0.4,1,2,0.5,0,1,1,0,0,0,2,3,7,0.3
Raymond Felton,32-225,G,2/6/17,LAC,TOR,1,36,3,9,0.333,2,6,0.333,1,3,0.333,0,0,,0,6,6,6,1,0,2,1,7,6.5
Doug McDermott,25-006,F,1/9/17,CHI,OKC,0,25,2,6,0.333,1,4,0.25,1,2,0.5,2,2,1,0,2,2,0,0,0,0,0,7,4.2
Gerald Henderson,28-334,G,11/7/16,PHI,UTA,1,24,3,8,0.375,2,6,0.333,1,2,0.5,0,0,,0,3,3,0,1,0,1,2,7,2.7
Larry Nance Jr.,24-096,F,4/7/17,LAL,SAC,1,28,2,5,0.4,2,4,0.5,0,1,0,3,4,0.75,4,7,11,2,3,0,1,3,7,11
Beno Udrih,34-147,G,11/29/16,DET,CHO,0,20,3,5,0.6,2,4,0.5,1,1,1,0,0,,0,1,1,7,1,0,2,2,7,8.1
Anthony Morrow,31-127,G,2/1/17,OKC,CHI,0,24,3,11,0.273,2,5,0.4,1,6,0.167,0,0,,1,0,1,1,0,0,0,3,7,0.7
Garrett Temple,30-192,G,11/16/16,SAC,SAS,0,18,3,4,0.75,2,3,0.667,1,1,1,0,0,,0,4,4,2,0,0,2,1,7,5.6
John Henson,25-345,C-F,12/7/16,MIL,POR,1,25,2,4,0.5,2,4,0.5,0,0,,3,6,0.5,2,4,6,0,0,2,0,1,7,7.4
Hollis Thompson,25-228,G-F,11/17/16,PHI,MIN,0,20,2,6,0.333,1,3,0.333,1,3,0.333,2,2,1,1,2,3,0,0,0,0,1,7,4.5
Victor Oladipo,24-275,G,2/3/17,OKC,MEM,1,35,3,14,0.214,2,9,0.222,1,5,0.2,0,0,,0,3,3,3,2,0,0,4,7,1.8
Tyreke Evans,27-087,G-F,12/15/16,NOP,IND,0,11,2,3,0.667,1,1,1,1,2,0.5,2,2,1,0,3,3,2,0,0,2,2,7,5.2
Luc Mbah a Moute,30-170,F,2/26/17,LAC,CHO,1,35,3,6,0.5,2,5,0.4,1,1,1,0,0,,0,0,0,0,4,1,0,3,7,7.5
Maurice Ndour,24-227,F,1/31/17,NYK,WAS,0,8,3,5,0.6,2,3,0.667,1,2,0.5,0,0,,1,1,2,0,0,0,0,0,7,5.7
Wayne Ellington,29-042,G,12/10/16,MIA,CHI,1,25,3,7,0.429,2,4,0.5,1,3,0.333,0,0,,1,2,3,2,0,0,0,3,7,4.8
Marco Belinelli,30-342,G-F,3/2/17,CHO,PHO,0,24,2,7,0.286,2,4,0.5,0,3,0,3,3,1,0,0,0,1,0,0,3,1,7,0.2
Jonas Jerebko,29-331,F,1/27/17,BOS,ORL,1,27,2,6,0.333,1,3,0.333,1,3,0.333,2,2,1,1,7,8,4,1,1,2,3,7,7.7
Garrett Temple,30-306,G,3/10/17,SAC,WAS,0,30,2,6,0.333,0,4,0,2,2,1,1,2,0.5,0,0,0,5,0,0,0,2,7,5.9
Jarell Eddie,25-149,G-F,3/28/17,PHO,ATL,0,18,2,9,0.222,0,1,0,2,8,0.25,1,2,0.5,0,2,2,0,0,0,0,0,7,1.7
Dwight Powell,25-186,F-C,1/22/17,DAL,LAL,0,19,2,4,0.5,1,2,0.5,1,2,0.5,2,2,1,3,4,7,3,3,1,0,4,7,12.5
Jamal Crawford,36-243,G,11/18/16,LAC,SAC,0,26,2,8,0.25,0,4,0,2,4,0.5,1,1,1,0,2,2,1,0,0,1,1,7,2.1
Marquese Chriss,19-151,F,11/30/16,PHO,ATL,1,13,2,4,0.5,1,1,1,1,3,0.333,2,2,1,0,2,2,0,1,0,0,0,7,6.6
Kyle Wiltjer,24-055,F,12/14/16,HOU,SAC,0,6,2,2,1,0,0,,2,2,1,1,2,0.5,2,0,2,0,0,0,0,0,7,7.4
Jared Dudley,31-211,F-G,2/6/17,PHO,NOP,0,21,3,6,0.5,2,4,0.5,1,2,0.5,0,0,,0,6,6,4,0,1,0,2,7,8.5
JaMychal Green,26-185,F,12/23/16,MEM,HOU,1,27,1,3,0.333,0,2,0,1,1,1,4,4,1,3,2,5,0,0,0,0,4,7,6.4
Derrick Jones,20-037,F,3/24/17,PHO,BOS,1,32,2,3,0.667,2,3,0.667,0,0,,3,4,0.75,2,2,4,0,1,0,0,6,7,5.9
Delon Wright,24-335,G,3/27/17,TOR,ORL,0,18,3,6,0.5,2,4,0.5,1,2,0.5,0,0,,0,1,1,3,3,2,1,2,7,9
Joe Ingles,29-134,F-G,2/13/17,UTA,LAC,1,22,2,4,0.5,1,2,0.5,1,2,0.5,2,2,1,0,4,4,0,0,0,3,2,7,2.4
Isaiah Whitehead,21-337,G,2/8/17,BRK,WAS,0,21,2,6,0.333,1,4,0.25,1,2,0.5,2,2,1,0,2,2,2,0,0,2,2,7,2.8
Omri Casspi,28-293,F,4/11/17,MIN,OKC,0,17,3,4,0.75,2,3,0.667,1,1,1,0,2,0,1,2,3,1,3,0,1,1,7,8.2
C.J. Miles,29-326,G-F,3/10/17,IND,MIL,1,26,3,7,0.429,2,2,1,1,5,0.2,0,0,,0,2,2,0,0,1,0,2,7,3.8
Lou Williams,30-144,G,3/20/17,HOU,DEN,0,17,2,6,0.333,2,4,0.5,0,2,0,3,4,0.75,0,3,3,2,0,0,1,1,7,4.1
Rodney Hood,24-077,G-F,1/5/17,UTA,TOR,1,35,3,10,0.3,2,5,0.4,1,5,0.2,0,0,,0,2,2,3,0,1,0,1,7,4.2
Bobby Brown,32-118,G,1/20/17,HOU,GSW,0,3,3,4,0.75,2,2,1,1,2,0.5,0,0,,0,0,0,0,0,0,0,0,7,5.4
Brandon Jennings,27-153,G,2/23/17,NYK,CLE,0,14,2,9,0.222,1,5,0.2,1,4,0.25,2,2,1,1,1,2,3,1,1,1,5,7,3.3
Joe Ingles,29-093,F-G,1/3/17,UTA,BOS,0,26,2,6,0.333,1,2,0.5,1,4,0.25,2,2,1,1,4,5,4,1,0,2,3,7,6.1
Myles Turner,21-011,F-C,4/4/17,IND,TOR,1,36,2,9,0.222,1,6,0.167,1,3,0.333,2,2,1,2,4,6,0,0,0,1,3,7,1.9
Davis Bertans,24-084,F,2/4/17,SAS,DEN,0,19,3,4,0.75,2,3,0.667,1,1,1,0,0,,1,2,3,1,1,1,1,1,7,7.7
Rudy Gobert,24-160,C,12/3/16,UTA,DEN,1,37,3,4,0.75,3,4,0.75,0,0,,1,2,0.5,3,8,11,1,1,2,1,3,7,10.4
Mindaugas Kuzminskas,27-079,F,1/6/17,NYK,MIL,0,13,3,5,0.6,2,2,1,1,3,0.333,0,0,,0,1,1,1,0,0,1,0,7,4.7
Willie Reed,26-165,F-C,10/28/16,MIA,CHO,0,21,2,3,0.667,2,3,0.667,0,0,,3,4,0.75,2,1,3,0,0,0,1,2,7,5.2
Zach Randolph,35-212,F,2/13/17,MEM,BRK,0,19,2,8,0.25,2,7,0.286,0,1,0,3,4,0.75,1,2,3,1,1,0,2,1,7,2.4
Serge Ibaka,27-050,F-C,11/7/16,ORL,CHI,1,26,3,6,0.5,2,4,0.5,1,2,0.5,0,0,,0,7,7,3,1,1,2,3,7,6.7
Tim Frazier,26-133,G,3/14/17,NOP,POR,0,24,2,6,0.333,1,4,0.25,1,2,0.5,2,2,1,0,5,5,7,1,0,0,3,7,9.8
Tyler Zeller,26-300,F-C,11/12/16,BOS,IND,0,16,3,6,0.5,3,6,0.5,0,0,,1,2,0.5,4,2,6,0,0,1,0,0,7,7.7
Solomon Hill,25-345,F,2/26/17,NOP,OKC,1,31,1,3,0.333,0,0,,1,3,0.333,4,4,1,1,3,4,0,2,0,0,3,7,7.7
Malcolm Delaney,27-300,G,1/5/17,ATL,NOP,0,20,2,6,0.333,2,4,0.5,0,2,0,3,3,1,0,3,3,8,3,0,3,0,7,10.1
Jae Crowder,26-156,F,12/9/16,BOS,TOR,1,33,2,11,0.182,1,5,0.2,1,6,0.167,2,2,1,2,4,6,3,1,0,0,1,7,5.4
Rodney McGruder,25-180,G,1/25/17,MIA,BRK,1,23,3,6,0.5,2,4,0.5,1,2,0.5,0,0,,1,4,5,1,0,0,0,2,7,5.8
Alex Abrines,23-159,G-F,1/7/17,OKC,DEN,0,20,1,4,0.25,0,1,0,1,3,0.333,4,4,1,0,2,2,3,1,0,0,3,7,7.1
C.J. Watson,32-304,G,2/15/17,ORL,SAS,1,12,3,4,0.75,2,3,0.667,1,1,1,0,0,,0,0,0,0,2,0,1,2,7,5.6
JaVale McGee,29-010,C,1/29/17,GSW,POR,0,9,3,3,1,3,3,1,0,0,,1,3,0.333,1,2,3,0,1,2,0,1,7,8.6
Jon Leuer,27-167,F,10/28/16,DET,ORL,0,28,3,7,0.429,2,5,0.4,1,2,0.5,0,0,,2,7,9,2,0,2,1,1,7,8.2
Jeff Green,30-195,F,3/11/17,ORL,CLE,0,18,3,7,0.429,3,6,0.5,0,1,0,1,1,1,0,3,3,2,0,0,1,1,7,4.2
Joe Ingles,29-065,F-G,12/6/16,UTA,PHO,0,21,2,4,0.5,1,1,1,1,3,0.333,2,2,1,0,3,3,1,0,0,1,1,7,5.2
Marcus Smart,22-272,G,12/3/16,BOS,PHI,0,32,2,6,0.333,2,2,1,0,4,0,3,4,0.75,0,3,3,3,1,0,1,2,7,5.4
Kent Bazemore,27-252,G-F,3/10/17,ATL,TOR,1,28,3,8,0.375,2,4,0.5,1,4,0.25,0,2,0,1,6,7,1,2,2,2,2,7,5.6
Anthony Morrow,31-131,G,2/5/17,OKC,POR,0,19,3,7,0.429,2,5,0.4,1,2,0.5,0,0,,0,0,0,1,2,0,0,0,7,6
Jeremy Lamb,24-207,G-F,12/23/16,CHO,CHI,0,17,2,6,0.333,2,4,0.5,0,2,0,3,3,1,0,3,3,0,0,0,0,1,7,4.1
Justin Holiday,27-302,G,2/1/17,NYK,BRK,0,28,2,4,0.5,1,1,1,1,3,0.333,2,2,1,0,4,4,4,3,1,0,0,7,12.7
JaVale McGee,29-037,C,2/25/17,GSW,BRK,0,12,3,10,0.3,3,10,0.3,0,0,,1,3,0.333,6,3,9,0,0,1,0,0,7,6.2
Troy Daniels,25-232,G,3/4/17,MEM,HOU,0,11,3,6,0.5,2,2,1,1,4,0.25,0,0,,0,0,0,0,0,0,0,3,7,2.8
Mario Hezonja,22-014,F-G,3/11/17,ORL,CLE,0,15,2,5,0.4,1,2,0.5,1,3,0.333,2,2,1,0,2,2,0,0,0,0,2,7,4.1
Justin Holiday,27-356,G,3/27/17,NYK,DET,0,14,3,6,0.5,2,2,1,1,4,0.25,0,0,,0,2,2,1,1,0,1,0,7,5.3
Matt Barnes,36-263,F,11/27/16,SAC,BRK,0,19,3,5,0.6,2,2,1,1,3,0.333,0,0,,1,3,4,6,0,1,2,2,7,8.4
Paul Zipser,22-349,G-F,2/1/17,CHI,OKC,0,24,2,5,0.4,1,2,0.5,1,3,0.333,2,3,0.667,0,5,5,2,0,0,1,2,7,5
DeAndre Jordan,28-209,C,2/15/17,LAC,ATL,1,29,3,4,0.75,3,4,0.75,0,0,,1,2,0.5,3,13,16,1,2,0,2,2,7,10.9
Chasson Randle,24-043,G,3/20/17,NYK,LAC,0,11,2,3,0.667,2,3,0.667,0,0,,3,4,0.75,1,0,1,3,0,0,1,3,7,5.9
Isaiah Whitehead,21-344,G,2/15/17,BRK,MIL,0,18,3,5,0.6,3,4,0.75,0,1,0,1,1,1,1,1,2,2,0,0,3,2,7,3.3
Allen Crabbe,24-227,G-F,11/22/16,POR,NYK,0,23,1,7,0.143,0,4,0,1,3,0.333,4,5,0.8,1,2,3,0,0,0,0,1,7,3
Kyle Korver,35-275,G-F,12/17/16,ATL,CHO,0,20,3,8,0.375,2,3,0.667,1,5,0.2,0,0,,0,4,4,2,0,0,0,0,7,5.2
Sergio Rodriguez,30-146,G,11/5/16,PHI,CLE,1,31,3,9,0.333,2,4,0.5,1,5,0.2,0,0,,0,6,6,11,2,0,3,1,7,10
Ron Baker,23-347,G,3/12/17,NYK,BRK,0,17,2,3,0.667,2,2,1,0,1,0,3,4,0.75,0,2,2,3,1,0,2,1,7,6.6
Jason Smith,30-314,F-C,1/10/17,WAS,CHI,0,23,3,7,0.429,2,5,0.4,1,2,0.5,0,0,,3,3,6,0,0,3,3,2,7,4.6
Al Jefferson,32-017,C-F,1/21/17,IND,UTA,0,14,3,4,0.75,3,4,0.75,0,0,,1,1,1,0,4,4,0,1,1,1,3,7,6.1
P.J. Tucker,31-197,F,11/18/16,PHO,IND,0,39,3,12,0.25,3,8,0.375,0,4,0,1,2,0.5,5,5,10,0,2,0,0,1,7,6
Trey Lyles,21-002,F,11/7/16,UTA,PHI,0,31,2,9,0.222,1,6,0.167,1,3,0.333,2,2,1,0,1,1,3,1,1,1,2,7,3.8
Mario Hezonja,21-332,F-G,1/22/17,ORL,GSW,0,21,3,11,0.273,2,4,0.5,1,7,0.143,0,1,0,1,4,5,0,2,0,2,3,7,0.8
Marreese Speights,29-155,C-F,1/6/17,LAC,SAC,0,11,2,11,0.182,1,6,0.167,1,5,0.2,2,2,1,4,7,11,1,0,0,0,2,7,4.9
Al-Farouq Aminu,26-130,F,1/29/17,POR,GSW,0,34,3,10,0.3,2,5,0.4,1,5,0.2,0,0,,1,8,9,4,2,0,2,2,7,6.3
Sergio Rodriguez,30-157,G,11/16/16,PHI,WAS,1,28,2,4,0.5,2,3,0.667,0,1,0,3,4,0.75,0,4,4,12,0,0,3,1,7,10.8
Shabazz Muhammad,24-061,F-G,1/13/17,MIN,OKC,0,23,3,6,0.5,2,4,0.5,1,2,0.5,0,0,,0,1,1,0,0,0,1,0,7,3.3
Cody Zeller,24-161,F-C,3/15/17,CHO,IND,1,27,3,8,0.375,3,8,0.375,0,0,,1,1,1,0,4,4,1,3,1,1,2,7,6.4
Beno Udrih,34-123,G,11/5/16,DET,DEN,0,20,3,6,0.5,2,4,0.5,1,2,0.5,0,0,,0,3,3,6,0,0,2,0,7,7.1
Okaro White,24-228,F,3/29/17,MIA,NYK,0,20,3,3,1,2,2,1,1,1,1,0,0,,1,4,5,0,0,0,1,2,7,6.2
Jeff Green,30-195,F,3/11/17,ORL,CLE,0,18,3,7,0.429,3,6,0.5,0,1,0,1,1,1,0,3,3,2,0,0,1,1,7,4.2
Timofey Mozgov,30-173,C,1/5/17,LAL,POR,1,11,3,5,0.6,3,5,0.6,0,0,,1,1,1,0,5,5,0,0,0,0,2,7,5.4
Rodney Stuckey,30-228,G,12/5/16,IND,GSW,0,20,1,3,0.333,0,2,0,1,1,1,4,4,1,1,2,3,1,1,0,0,1,7,7.9
Mason Plumlee,26-246,C-F,11/6/16,POR,MEM,1,24,2,3,0.667,2,3,0.667,0,0,,3,6,0.5,1,5,6,3,2,0,3,4,7,6.2
Marcin Gortat,33-044,C-F,4/2/17,WAS,GSW,1,16,3,5,0.6,3,5,0.6,0,0,,1,2,0.5,1,2,3,0,0,1,1,3,7,4.1
Jonas Jerebko,29-249,F,11/6/16,BOS,DEN,0,18,3,6,0.5,2,4,0.5,1,2,0.5,0,0,,3,0,3,0,1,1,1,3,7,5.6
Sergio Rodriguez,30-164,G,11/23/16,PHI,MEM,1,21,3,9,0.333,2,6,0.333,1,3,0.333,0,0,,0,0,0,5,0,0,1,0,7,4.4
Pau Gasol,36-278,F-C,4/10/17,SAS,POR,0,18,2,10,0.2,1,9,0.111,1,1,1,2,2,1,1,12,13,1,0,1,0,1,7,6.1
Spencer Dinwiddie,23-361,G,4/2/17,BRK,ATL,0,22,1,4,0.25,0,2,0,1,2,0.5,4,5,0.8,0,2,2,0,2,1,0,1,7,7.1
Toney Douglas,30-325,G,2/4/17,MEM,MIN,0,22,2,4,0.5,2,3,0.667,0,1,0,3,4,0.75,0,7,7,1,0,0,0,4,7,5.8
Mirza Teletovic,31-206,F,4/12/17,MIL,BOS,0,28,2,8,0.25,1,3,0.333,1,5,0.2,2,2,1,0,3,3,2,0,0,0,4,7,2.9
Jonas Jerebko,29-329,F,1/25/17,BOS,HOU,1,23,3,3,1,2,2,1,1,1,1,0,0,,3,4,7,1,0,1,1,5,7,7.8
Steven Adams,23-128,C,11/25/16,OKC,DEN,1,30,3,7,0.429,3,7,0.429,0,0,,1,2,0.5,1,5,6,1,2,0,1,5,7,4.8
Dorian Finney-Smith,23-263,F,1/22/17,DAL,LAL,0,34,1,4,0.25,0,0,,1,4,0.25,4,4,1,3,4,7,0,1,0,1,1,7,7.5
Jeremy Lamb,24-247,G-F,2/1/17,CHO,GSW,0,24,3,11,0.273,3,8,0.375,0,3,0,1,2,0.5,0,7,7,1,0,0,1,2,7,1.1
Justin Hamilton,26-349,C,3/16/17,BRK,NYK,0,18,2,4,0.5,1,1,1,1,3,0.333,2,2,1,3,3,6,0,0,0,1,4,7,5.4
D.J. Augustin,29-019,G,11/29/16,ORL,SAS,1,25,2,6,0.333,1,3,0.333,1,3,0.333,2,2,1,1,3,4,5,2,0,1,0,7,9.7
Monta Ellis,31-158,G,4/2/17,IND,CLE,1,36,3,8,0.375,2,6,0.333,1,2,0.5,0,0,,2,4,6,3,0,0,0,2,7,6.5
Jameer Nelson,34-300,G,12/5/16,DEN,PHI,0,30,3,8,0.375,3,5,0.6,0,3,0,1,2,0.5,1,4,5,4,5,0,1,3,7,9.7
Evan Fournier,24-119,G-F,2/25/17,ORL,ATL,1,34,2,11,0.182,1,4,0.25,1,7,0.143,2,2,1,0,4,4,1,2,0,2,4,7,0.4
Kent Bazemore,27-154,G-F,12/2/16,ATL,DET,1,18,3,11,0.273,2,8,0.25,1,3,0.333,0,0,,1,1,2,1,1,0,0,0,7,3.2
Derrick Williams,25-266,F,2/15/17,CLE,IND,0,27,2,7,0.286,0,2,0,2,5,0.4,1,2,0.5,0,5,5,2,0,0,0,0,7,5.4
Marreese Speights,29-226,C-F,3/18/17,LAC,CLE,0,15,3,4,0.75,2,3,0.667,1,1,1,0,0,,0,8,8,2,0,1,1,1,7,8.5
Larry Nance Jr.,24-100,F,4/11/17,LAL,NOP,1,31,2,7,0.286,1,5,0.2,1,2,0.5,2,2,1,0,8,8,2,1,0,0,1,7,7.3
Joe Harris,25-117,G,1/2/17,BRK,UTA,0,22,3,5,0.6,2,2,1,1,3,0.333,0,0,,1,0,1,1,0,0,2,2,7,3.3
Robert Covington,26-090,F,3/14/17,PHI,GSW,1,32,1,8,0.125,0,4,0,1,4,0.25,4,4,1,2,7,9,3,2,2,1,3,7,8.6
Doug McDermott,24-360,F,12/28/16,CHI,BRK,0,30,2,6,0.333,2,4,0.5,0,2,0,3,3,1,1,3,4,0,0,0,1,1,7,3.8
Marcus Smart,23-025,G,3/31/17,BOS,ORL,0,31,1,6,0.167,0,2,0,1,4,0.25,4,4,1,0,2,2,6,0,2,1,2,7,7.6
Quincy Acy,26-101,F,1/15/17,BRK,HOU,0,20,2,6,0.333,1,4,0.25,1,2,0.5,2,2,1,3,1,4,0,0,2,0,3,7,6.2
Alonzo Gee,29-180,G,11/25/16,DEN,OKC,0,27,2,8,0.25,2,5,0.4,0,3,0,3,5,0.6,1,2,3,3,4,0,0,1,7,8.4
Pau Gasol,36-113,F-C,10/27/16,SAS,SAC,1,21,3,7,0.429,2,6,0.333,1,1,1,0,0,,0,6,6,1,1,1,3,2,7,3.7
Jason Terry,39-162,G,2/24/17,MIL,UTA,0,20,2,4,0.5,0,0,,2,4,0.5,1,2,0.5,0,0,0,0,0,0,2,2,7,1.8
Cristiano Felicio,24-220,F-C,2/12/17,CHI,MIN,0,24,3,7,0.429,3,7,0.429,0,0,,1,2,0.5,1,3,4,0,0,0,1,4,7,1.9
Jaylen Brown,20-051,F,12/14/16,BOS,SAS,0,11,2,3,0.667,2,3,0.667,0,0,,3,4,0.75,1,1,2,0,1,1,2,1,7,5.6
Malik Beasley,20-067,G,2/1/17,DEN,MEM,0,6,2,2,1,1,1,1,1,1,1,2,2,1,0,0,0,1,1,0,1,0,7,7.1
Andre Roberson,24-341,G-F,11/9/16,OKC,TOR,1,23,3,7,0.429,2,5,0.4,1,2,0.5,0,0,,0,1,1,0,0,1,1,2,7,2.5
Dewayne Dedmon,27-160,C,1/19/17,SAS,DEN,0,19,3,5,0.6,3,5,0.6,0,0,,1,1,1,0,4,4,1,2,0,0,4,7,7
Alex Abrines,23-107,G-F,11/16/16,OKC,HOU,0,15,2,4,0.5,0,1,0,2,3,0.667,1,1,1,0,0,0,1,1,0,0,0,7,6.7
Marquese Chriss,19-129,F,11/8/16,PHO,POR,1,20,3,7,0.429,3,6,0.5,0,1,0,1,2,0.5,2,2,4,0,0,1,1,4,7,3
Hollis Thompson,25-270,G-F,12/29/16,PHI,UTA,0,21,3,6,0.5,2,4,0.5,1,2,0.5,0,0,,0,1,1,1,0,0,0,0,7,5
Sean Kilpatrick,26-359,G,12/30/16,BRK,WAS,1,23,2,6,0.333,2,5,0.4,0,1,0,3,3,1,0,2,2,0,1,0,4,4,7,-0.4
Justin Anderson,22-342,G,10/26/16,DAL,IND,0,19,3,9,0.333,2,3,0.667,1,6,0.167,0,0,,1,4,5,2,0,1,0,2,7,5.1
Spencer Dinwiddie,23-275,G,1/6/17,BRK,CLE,1,18,2,3,0.667,2,3,0.667,0,0,,3,3,1,0,5,5,2,0,0,2,5,7,4.6
Joakim Noah,31-321,C,1/11/17,NYK,PHI,1,20,3,6,0.5,3,6,0.5,0,0,,1,1,1,3,3,6,0,2,1,0,4,7,8.1
Patrick Beverley,28-218,G,2/15/17,HOU,MIA,1,13,2,5,0.4,2,5,0.4,0,0,,3,4,0.75,0,0,0,2,0,0,1,1,7,3.9
Danny Green,29-152,G-F,11/21/16,SAS,DAL,1,29,1,4,0.25,1,1,1,0,3,0,5,6,0.833,0,3,3,4,0,0,0,3,7,6.7
Patrick Patterson,27-269,F,12/8/16,TOR,MIN,0,30,2,10,0.2,0,2,0,2,8,0.25,1,4,0.25,1,4,5,2,0,0,0,1,7,2.5
Dorian Finney-Smith,23-261,F,1/20/17,DAL,UTA,0,14,3,4,0.75,2,3,0.667,1,1,1,0,0,,1,1,2,0,1,0,0,1,7,7
Tony Parker,34-192,G,11/25/16,SAS,BOS,1,24,3,7,0.429,3,7,0.429,0,0,,1,1,1,0,2,2,4,1,0,2,2,7,4.9
Raymond Felton,32-139,G,11/12/16,LAC,MIN,0,13,3,3,1,2,2,1,1,1,1,0,0,,1,1,2,0,0,0,2,1,7,4.7
Joe Harris,25-069,G,11/15/16,BRK,LAL,0,29,3,9,0.333,2,2,1,1,7,0.143,0,0,,0,3,3,1,1,0,1,4,7,1.9
Robert Covington,25-360,F,12/8/16,PHI,NOP,1,31,3,9,0.333,2,4,0.5,1,5,0.2,0,0,,2,5,7,1,1,1,2,1,7,4.8
Brandon Ingram,19-079,F,11/20/16,LAL,CHI,0,20,3,6,0.5,3,6,0.5,0,0,,1,2,0.5,1,3,4,3,0,0,1,2,7,5.5
Chasson Randle,24-029,G,3/6/17,NYK,ORL,0,26,2,7,0.286,2,6,0.333,0,1,0,3,3,1,1,4,5,5,0,0,0,1,7,7.9
Josh Richardson,23-167,G,3/1/17,MIA,PHI,0,24,3,8,0.375,2,5,0.4,1,3,0.333,0,0,,0,6,6,5,1,1,1,2,7,7.8
Sergio Rodriguez,30-152,G,11/11/16,PHI,IND,1,34,3,7,0.429,2,3,0.667,1,4,0.25,0,0,,1,1,2,9,0,0,4,4,7,5
Tyreke Evans,27-146,G-F,2/12/17,NOP,SAC,0,15,2,6,0.333,2,5,0.4,0,1,0,3,4,0.75,0,3,3,1,2,0,1,2,7,5
Marreese Speights,29-251,C-F,4/12/17,LAC,SAC,0,17,3,8,0.375,2,3,0.667,1,5,0.2,0,0,,1,3,4,1,0,0,3,4,7,0.3
Jerami Grant,22-312,F,1/18/17,OKC,GSW,1,29,2,8,0.25,2,6,0.333,0,2,0,3,4,0.75,1,0,1,1,1,2,0,4,7,4
Deron Williams,32-213,G,1/25/17,DAL,NYK,1,16,3,6,0.5,2,4,0.5,1,2,0.5,0,0,,0,0,0,7,0,0,0,0,7,8.9
Jeremy Lamb,24-215,G-F,12/31/16,CHO,CLE,0,18,3,5,0.6,2,2,1,1,3,0.333,0,0,,0,2,2,4,1,1,0,1,7,9.4
Matthew Dellavedova,26-202,G,3/29/17,MIL,BOS,0,19,2,5,0.4,2,4,0.5,0,1,0,3,3,1,0,1,1,5,0,0,2,5,7,4.1
Jeremy Lamb,24-271,G-F,2/25/17,CHO,SAC,0,18,3,8,0.375,2,4,0.5,1,4,0.25,0,0,,0,4,4,1,1,0,0,0,7,5.5
D.J. Augustin,29-021,G,12/1/16,ORL,MEM,1,19,2,6,0.333,0,3,0,2,3,0.667,1,2,0.5,0,1,1,2,1,0,3,4,7,1.3
Okaro White,24-170,F,1/30/17,MIA,BRK,0,14,2,4,0.5,1,1,1,1,3,0.333,2,2,1,1,1,2,0,0,0,0,1,7,5.6
Bobby Portis,21-334,F,1/9/17,CHI,OKC,0,10,3,7,0.429,2,4,0.5,1,3,0.333,0,0,,2,0,2,0,1,0,1,0,7,4.7
Marcin Gortat,32-336,C-F,1/18/17,WAS,MEM,1,36,3,5,0.6,3,5,0.6,0,0,,1,2,0.5,3,8,11,1,0,0,0,5,7,7.5
DeAndre' Bembry,22-175,F,12/26/16,ATL,MIN,0,17,3,4,0.75,3,4,0.75,0,0,,1,3,0.333,0,3,3,0,0,0,2,3,7,2.3
Pau Gasol,36-245,F-C,3/8/17,SAS,SAC,0,16,2,5,0.4,2,5,0.4,0,0,,3,4,0.75,1,3,4,2,0,0,0,1,7,6.5
Ramon Sessions,30-232,G,11/29/16,CHO,DET,0,13,2,4,0.5,2,4,0.5,0,0,,3,4,0.75,0,1,1,3,0,0,1,1,7,5.6
Draymond Green,26-356,F,2/23/17,GSW,LAC,1,23,2,4,0.5,1,3,0.333,1,1,1,2,2,1,0,6,6,4,2,0,6,5,7,3.6
Nene Hilario,34-043,F-C,10/26/16,HOU,LAL,0,22,3,5,0.6,3,5,0.6,0,0,,1,4,0.25,2,1,3,3,2,0,1,3,7,7.1
Quincy Acy,26-153,F,3/8/17,BRK,ATL,0,22,2,6,0.333,1,2,0.5,1,4,0.25,2,2,1,0,7,7,1,1,3,2,3,7,6.3
Brandon Ingram,19-086,F,11/27/16,LAL,ATL,0,29,3,10,0.3,2,8,0.25,1,2,0.5,0,0,,0,8,8,0,0,0,1,3,7,1.4
Justin Anderson,23-074,G,2/1/17,DAL,PHI,0,5,3,4,0.75,2,2,1,1,2,0.5,0,0,,1,3,4,0,0,0,1,0,7,6
Adreian Payne,25-270,F-C,11/15/16,MIN,CHO,0,11,2,6,0.333,2,5,0.4,0,1,0,3,3,1,3,0,3,1,0,0,1,4,7,3.8
Carmelo Anthony,32-216,F,12/31/16,NYK,HOU,1,19,3,11,0.273,3,9,0.333,0,2,0,1,2,0.5,1,0,1,3,0,0,1,3,7,0.7
Marcus Smart,23-020,G,3/26/17,BOS,MIA,0,30,1,5,0.2,0,2,0,1,3,0.333,4,4,1,1,2,3,9,1,0,2,3,7,9.3
Luol Deng,31-193,F,10/26/16,LAL,HOU,1,28,3,9,0.333,2,5,0.4,1,4,0.25,0,0,,2,3,5,1,1,0,1,0,7,4.9
Wayne Ellington,29-095,G,2/1/17,MIA,ATL,0,26,2,11,0.182,1,5,0.2,1,6,0.167,2,2,1,0,2,2,3,0,0,0,2,7,2
Zach Randolph,35-145,F,12/8/16,MEM,POR,0,17,2,10,0.2,2,9,0.222,0,1,0,3,6,0.5,4,5,9,2,0,0,1,4,7,2.7
Reggie Jackson,26-339,G,3/21/17,DET,BRK,1,20,3,9,0.333,2,7,0.286,1,2,0.5,0,0,,1,1,2,2,0,0,1,2,7,2.5
Caris LeVert,22-217,G-F,3/30/17,BRK,DET,1,25,3,9,0.333,2,8,0.25,1,1,1,0,0,,0,7,7,4,1,0,0,2,7,7
Kemba Walker,26-269,G,2/1/17,CHO,GSW,1,25,1,5,0.2,1,2,0.5,0,3,0,5,5,1,0,1,1,5,0,0,3,1,7,4.3
Ramon Sessions,30-201,G,10/29/16,CHO,BOS,0,18,2,4,0.5,1,3,0.333,1,1,1,2,2,1,0,3,3,3,1,0,0,3,7,7.8
Robin Lopez,28-308,C,2/3/17,CHI,HOU,1,41,3,8,0.375,3,8,0.375,0,0,,1,2,0.5,4,7,11,2,0,2,0,2,7,9.1
Devin Harris,34-008,G,3/7/17,DAL,LAL,0,13,2,4,0.5,1,2,0.5,1,2,0.5,2,2,1,0,0,0,4,1,0,1,4,7,6.2
Omri Casspi,28-156,F,11/25/16,SAC,HOU,0,28,3,7,0.429,3,5,0.6,0,2,0,1,2,0.5,0,4,4,5,0,0,1,2,7,5.8
Bismack Biyombo,24-107,C-F,12/13/16,ORL,ATL,1,33,3,4,0.75,3,4,0.75,0,0,,1,2,0.5,1,8,9,2,0,3,1,2,7,9.8
Ty Lawson,29-136,G,3/19/17,SAC,SAS,0,21,3,8,0.375,3,7,0.429,0,1,0,1,1,1,0,2,2,6,2,1,1,2,7,8.3
Marquese Chriss,19-244,F,3/3/17,PHO,OKC,1,26,3,8,0.375,2,4,0.5,1,4,0.25,0,0,,0,2,2,1,2,1,0,2,7,5.8
Adreian Payne,26-044,F-C,4/4/17,MIN,GSW,0,14,3,8,0.375,2,5,0.4,1,3,0.333,0,0,,1,4,5,1,1,1,0,2,7,6.1
Jerami Grant,22-303,F,1/9/17,OKC,CHI,0,16,3,6,0.5,2,3,0.667,1,3,0.333,0,0,,0,2,2,1,0,2,0,2,7,5.9
Tim Hardaway,24-266,G,12/7/16,ATL,MIA,1,22,3,9,0.333,2,6,0.333,1,3,0.333,0,0,,0,0,0,2,1,0,2,3,7,1.1
Rondae Hollis-Jefferson,22-057,F,3/1/17,BRK,SAC,1,19,1,5,0.2,0,3,0,1,2,0.5,4,6,0.667,0,2,2,1,2,0,0,1,7,6
Cory Joseph,25-215,G,3/23/17,TOR,MIA,1,29,3,8,0.375,2,5,0.4,1,3,0.333,0,0,,0,4,4,1,1,0,4,3,7,0.3
Marvin Williams,30-296,F,4/11/17,CHO,ATL,1,13,2,9,0.222,1,5,0.2,1,4,0.25,2,2,1,3,3,6,0,2,0,1,1,7,5.1
Spencer Dinwiddie,23-307,G,2/7/17,BRK,CHO,1,23,2,5,0.4,1,2,0.5,1,3,0.333,2,2,1,0,0,0,4,1,0,0,1,7,7.7
Caris LeVert,22-109,G-F,12/12/16,BRK,HOU,0,15,2,5,0.4,0,1,0,2,4,0.5,1,2,0.5,1,1,2,0,0,0,0,1,7,4.5
Tony Snell,25-059,G-F,1/8/17,MIL,WAS,1,34,3,6,0.5,2,3,0.667,1,3,0.333,0,0,,0,2,2,0,0,0,0,2,7,3.8
Malcolm Delaney,27-341,G,2/15/17,ATL,LAC,0,17,2,4,0.5,2,4,0.5,0,0,,3,3,1,0,1,1,1,1,0,1,2,7,5.2
Reggie Bullock,25-313,G-F,1/23/17,DET,SAC,0,11,3,6,0.5,2,2,1,1,4,0.25,0,0,,0,4,4,1,0,0,0,0,7,5.9
Stanley Johnson,20-204,F,12/19/16,DET,CHI,0,24,3,9,0.333,2,5,0.4,1,4,0.25,0,0,,2,2,4,3,2,0,1,2,7,6.2
Nick Young,31-246,G-F,2/2/17,LAL,WAS,1,24,3,10,0.3,2,2,1,1,8,0.125,0,0,,0,1,1,0,0,0,0,3,7,0.3
Davis Bertans,24-151,F,4/12/17,SAS,UTA,0,12,2,5,0.4,0,0,,2,5,0.4,1,1,1,0,1,1,0,1,0,1,1,7,4.2
Terrence Ross,25-337,F-G,1/7/17,TOR,CHI,0,25,3,10,0.3,2,3,0.667,1,7,0.143,0,0,,0,3,3,1,2,0,0,3,7,3.6
Tristan Thompson,25-288,F-C,12/26/16,CLE,DET,1,26,2,4,0.5,2,4,0.5,0,0,,3,4,0.75,4,6,10,1,0,1,1,4,7,8
Cheick Diallo,20-207,F,4/8/17,NOP,GSW,0,26,3,6,0.5,3,6,0.5,0,0,,1,2,0.5,2,7,9,0,0,0,2,0,7,5.1
Derrick Williams,25-180,F,11/21/16,MIA,PHI,1,19,2,6,0.333,1,4,0.25,1,2,0.5,2,4,0.5,1,0,1,0,0,0,0,0,7,3.5
Dante Exum,21-114,G,11/4/16,UTA,SAS,0,29,3,9,0.333,2,6,0.333,1,3,0.333,0,0,,1,6,7,2,0,0,1,1,7,4.4
Dante Exum,21-263,G,4/2/17,UTA,SAS,1,27,3,7,0.429,2,5,0.4,1,2,0.5,0,0,,1,2,3,2,0,1,0,4,7,5.1
Nerlens Noel,22-353,C-F,3/29/17,DAL,NOP,1,23,3,9,0.333,3,9,0.333,0,0,,1,1,1,2,4,6,0,1,1,0,4,7,4.6
Marcin Gortat,33-039,C-F,3/28/17,WAS,LAL,1,22,3,4,0.75,3,4,0.75,0,0,,1,4,0.25,5,6,11,1,1,1,0,0,7,11.9
Michael Carter-Williams,25-158,G,3/17/17,CHI,WAS,0,15,2,4,0.5,1,3,0.333,1,1,1,2,4,0.5,0,1,1,1,0,1,6,3,7,-1.3
Trey Lyles,21-046,F,12/21/16,UTA,SAC,0,16,3,8,0.375,2,4,0.5,1,4,0.25,0,0,,1,2,3,0,1,1,2,2,7,2.8
Terry Rozier,22-302,G,1/13/17,BOS,ATL,0,23,3,5,0.6,3,4,0.75,0,1,0,1,2,0.5,1,3,4,0,1,1,0,1,7,7.2
Norman Powell,23-201,G,12/12/16,TOR,MIL,0,8,3,4,0.75,2,3,0.667,1,1,1,0,0,,0,0,0,0,0,0,0,0,7,5.4
Trey Lyles,20-360,F,10/30/16,UTA,LAC,0,19,3,8,0.375,2,4,0.5,1,4,0.25,0,0,,2,3,5,1,0,0,1,3,7,3.4
Iman Shumpert,26-282,G,4/4/17,CLE,ORL,0,19,2,2,1,1,1,1,1,1,1,2,2,1,0,0,0,1,1,0,2,2,7,5.3
Lavoy Allen,28-063,F-C,4/8/17,IND,ORL,0,5,3,4,0.75,3,4,0.75,0,0,,1,1,1,2,2,4,0,0,0,0,0,7,7.4
Frank Kaminsky,23-276,F-C,1/5/17,CHO,DET,0,20,3,6,0.5,2,4,0.5,1,2,0.5,0,0,,0,4,4,0,0,0,0,2,7,4.4
David West,36-188,F,3/5/17,GSW,NYK,0,11,3,4,0.75,3,4,0.75,0,0,,1,2,0.5,1,0,1,0,0,0,1,2,7,3.9
Mario Hezonja,21-348,F-G,2/7/17,ORL,HOU,0,15,3,6,0.5,2,4,0.5,1,2,0.5,0,0,,0,2,2,0,1,0,3,3,7,1.4
Wayne Ellington,29-076,G,1/13/17,MIA,MIL,0,14,3,7,0.429,2,4,0.5,1,3,0.333,0,0,,2,1,3,1,0,0,0,0,7,5.7
Shabazz Muhammad,24-144,F-G,4/6/17,MIN,POR,0,12,3,7,0.429,2,5,0.4,1,2,0.5,0,0,,0,0,0,0,0,0,0,1,7,2.9
Jonas Valanciunas,24-256,C,1/17/17,TOR,BRK,1,29,3,7,0.429,3,7,0.429,0,0,,1,2,0.5,1,9,10,0,1,0,2,3,7,4.1
Dante Cunningham,29-208,F,11/16/16,NOP,ORL,1,33,3,9,0.333,2,7,0.286,1,2,0.5,0,0,,3,6,9,0,2,1,2,0,7,6.5
Gerald Henderson,29-030,G,1/8/17,PHI,BRK,0,21,3,7,0.429,3,7,0.429,0,0,,1,1,1,0,1,1,1,0,0,0,2,7,3.5
Brandon Bass,31-242,F,12/28/16,LAC,NOP,0,13,3,6,0.5,3,6,0.5,0,0,,1,1,1,1,3,4,1,0,0,0,0,7,6.3
Manu Ginobili,39-230,G,3/15/17,SAS,POR,0,20,2,5,0.4,1,3,0.333,1,2,0.5,2,4,0.5,0,1,1,6,2,0,3,4,7,5.4
Jared Dudley,31-244,F-G,3/11/17,PHO,DAL,0,22,2,5,0.4,0,0,,2,5,0.4,1,2,0.5,0,1,1,0,2,0,1,0,7,5.2
T.J. McConnell,24-337,G,2/25/17,PHI,NYK,1,33,3,4,0.75,2,3,0.667,1,1,1,0,0,,1,3,4,7,1,0,0,2,7,12.1
Terry Rozier,22-242,G,11/14/16,BOS,NOP,0,13,3,7,0.429,2,3,0.667,1,4,0.25,0,0,,1,1,2,0,0,0,0,2,7,3.5
Terrence Ross,25-352,F-G,1/22/17,TOR,PHO,0,25,2,9,0.222,1,3,0.333,1,6,0.167,2,2,1,1,1,2,2,0,1,0,1,7,4.2
T.J. McConnell,24-225,G,11/5/16,PHI,CLE,0,17,3,5,0.6,3,5,0.6,0,0,,0,0,,1,2,3,3,0,0,1,1,6,5.7
Tim Frazier,26-162,G,4/12/17,NOP,POR,1,27,1,8,0.125,0,3,0,1,5,0.2,3,4,0.75,1,1,2,8,1,0,1,2,6,6.2
Juan Hernangomez,21-164,F,3/11/17,DEN,SAC,0,5,2,3,0.667,0,0,,2,3,0.667,0,0,,0,1,1,0,0,0,0,1,6,4.6
Ron Baker,23-364,G,3/29/17,NYK,MIA,1,40,2,12,0.167,2,7,0.286,0,5,0,2,3,0.667,2,3,5,3,0,0,3,3,6,-1.8
Marcin Gortat,33-040,C-F,3/29/17,WAS,LAC,1,19,3,7,0.429,3,7,0.429,0,0,,0,0,,4,0,4,3,1,0,1,0,6,7.2
D.J. Augustin,29-004,G,11/14/16,ORL,IND,0,16,2,5,0.4,1,2,0.5,1,3,0.333,1,2,0.5,0,0,0,1,0,0,1,1,6,2.2
Brandon Rush,31-274,G-F,4/7/17,MIN,UTA,1,28,2,3,0.667,0,0,,2,3,0.667,0,0,,0,2,2,2,1,0,2,2,6,4.9
Denzel Valentine,23-090,G,2/14/17,CHI,TOR,0,15,2,3,0.667,0,0,,2,3,0.667,0,0,,0,2,2,1,0,0,1,1,6,4.6
Jerian Grant,24-139,G,2/25/17,CHI,CLE,1,16,2,4,0.5,0,1,0,2,3,0.667,0,0,,0,3,3,2,0,0,0,0,6,6.3
Ian Mahinmi,30-156,C,4/10/17,WAS,DET,0,22,3,5,0.6,3,5,0.6,0,0,,0,0,,1,10,11,3,2,2,2,4,6,9.3
Reggie Bullock,25-325,G-F,2/4/17,DET,IND,0,9,2,3,0.667,0,0,,2,3,0.667,0,0,,0,2,2,0,0,0,0,1,6,4.9
Ian Clark,25-281,G,12/13/16,GSW,NOP,0,13,2,6,0.333,0,2,0,2,4,0.5,0,0,,0,2,2,0,0,0,0,1,6,2.8
T.J. McConnell,24-237,G,11/17/16,PHI,MIN,0,24,3,4,0.75,3,4,0.75,0,0,,0,0,,1,5,6,7,2,0,1,1,6,12.1
Beno Udrih,34-117,G,10/30/16,DET,MIL,0,17,3,5,0.6,3,5,0.6,0,0,,0,0,,0,3,3,6,0,0,5,2,6,3
Marquese Chriss,19-201,F,1/19/17,PHO,CLE,1,22,3,7,0.429,3,7,0.429,0,0,,0,0,,2,2,4,1,1,0,0,3,6,4.8
Shabazz Napier,25-167,G,12/28/16,POR,SAC,0,13,2,5,0.4,0,1,0,2,4,0.5,0,0,,0,2,2,0,0,0,0,3,6,2.7
T.J. McConnell,24-248,G,11/28/16,PHI,TOR,0,20,2,3,0.667,2,3,0.667,0,0,,2,2,1,0,2,2,4,2,1,1,4,6,8.2
Willie Cauley-Stein,23-106,F-C,12/2/16,SAC,BOS,0,12,3,5,0.6,3,5,0.6,0,0,,0,0,,0,1,1,0,0,0,0,0,6,4
Mario Hezonja,22-027,F-G,3/24/17,ORL,DET,0,28,2,6,0.333,2,4,0.5,0,2,0,2,3,0.667,0,4,4,6,0,0,1,0,6,6.6
Justin Anderson,23-134,G,4/2/17,PHI,TOR,1,24,2,4,0.5,1,2,0.5,1,2,0.5,1,2,0.5,3,0,3,3,2,0,0,2,6,9
Danny Green,29-166,G-F,12/5/16,SAS,MIL,1,19,2,6,0.333,0,1,0,2,5,0.4,0,0,,0,1,1,1,0,0,2,0,6,1.6
Dante Cunningham,29-250,F,12/28/16,NOP,LAC,1,32,2,6,0.333,0,1,0,2,5,0.4,0,0,,1,8,9,3,1,1,1,1,6,8.1
Wilson Chandler,29-186,F,11/12/16,DEN,DET,0,30,3,12,0.25,3,9,0.333,0,3,0,0,0,,2,8,10,2,1,0,2,1,6,2.6
Beno Udrih,34-119,G,11/1/16,DET,NYK,0,16,3,9,0.333,3,9,0.333,0,0,,0,0,,0,1,1,1,0,0,2,3,6,-1.3
Wesley Matthews,30-175,G,4/7/17,DAL,SAS,1,16,3,5,0.6,3,5,0.6,0,0,,0,0,,0,4,4,5,0,0,0,0,6,8.4
Jeff Teague,28-251,G,2/16/17,IND,WAS,1,27,3,7,0.429,3,4,0.75,0,3,0,0,0,,0,6,6,5,0,0,3,0,6,4.6
Tarik Black,25-141,C-F,4/12/17,LAL,GSW,0,14,2,2,1,2,2,1,0,0,,2,2,1,2,1,3,0,0,0,1,3,6,4.9
Dante Cunningham,29-317,F,3/5/17,NOP,LAL,0,24,2,6,0.333,1,2,0.5,1,4,0.25,1,2,0.5,2,2,4,0,1,0,1,0,6,4.2
Anderson Varejao,34-056,F-C,11/23/16,GSW,LAL,0,9,1,1,1,1,1,1,0,0,,4,4,1,2,1,3,2,0,1,1,2,6,7.7
Jonathon Simmons,27-076,G-F,11/29/16,SAS,ORL,0,18,3,8,0.375,3,6,0.5,0,2,0,0,0,,0,3,3,1,2,0,2,2,6,2.4
Cory Joseph,25-179,G,2/15/17,TOR,CHO,0,25,2,6,0.333,0,4,0,2,2,1,0,0,,1,1,2,2,0,0,1,0,6,4
Ian Clark,26-029,G,4/5/17,GSW,PHO,0,20,2,6,0.333,2,4,0.5,0,2,0,2,2,1,0,2,2,1,0,1,2,2,6,1.8
Allen Crabbe,24-310,G-F,2/13/17,POR,ATL,0,31,2,5,0.4,1,3,0.333,1,2,0.5,1,2,0.5,0,3,3,2,1,0,1,3,6,4
Willie Reed,26-199,F-C,12/1/16,MIA,UTA,0,12,3,5,0.6,3,5,0.6,0,0,,0,0,,2,2,4,0,0,0,0,1,6,5.3
Brandon Jennings,27-074,G,12/6/16,NYK,MIA,0,24,2,8,0.25,1,4,0.25,1,4,0.25,1,2,0.5,0,1,1,9,1,0,4,0,6,4.4
Toney Douglas,30-355,G,3/6/17,MEM,BRK,0,23,3,7,0.429,3,4,0.75,0,3,0,0,0,,0,0,0,4,1,0,2,5,6,2.1
Roy Hibbert,29-360,C,12/5/16,CHO,DAL,0,22,2,3,0.667,2,3,0.667,0,0,,2,2,1,2,3,5,0,0,1,0,3,6,6.5
Timofey Mozgov,30-108,C,11/1/16,LAL,IND,1,19,3,7,0.429,3,6,0.5,0,1,0,0,0,,3,2,5,0,0,0,1,2,6,3.2
Evan Turner,28-041,G,12/7/16,POR,MIL,0,23,2,8,0.25,2,6,0.333,0,2,0,2,2,1,0,4,4,3,1,0,1,2,6,3.7
Jahlil Okafor,21-097,C-F,3/22/17,PHI,OKC,1,17,3,6,0.5,3,6,0.5,0,0,,0,0,,0,2,2,2,0,0,0,0,6,5
D.J. Augustin,29-059,G,1/8/17,ORL,LAL,0,28,1,6,0.167,0,1,0,1,5,0.2,3,4,0.75,0,5,5,8,0,0,1,2,6,7.1
Jeff Green,30-157,F,2/1/17,ORL,IND,0,16,2,7,0.286,2,5,0.4,0,2,0,2,2,1,0,1,1,0,1,0,0,1,6,2.8
Jonas Jerebko,29-245,F,11/2/16,BOS,CHI,0,22,2,5,0.4,2,5,0.4,0,0,,2,2,1,1,5,6,2,1,0,0,4,6,6.3
Jeff Withey,27-015,C,3/22/17,UTA,NYK,0,10,2,3,0.667,2,3,0.667,0,0,,2,2,1,3,0,3,0,1,2,0,1,6,8.8
Cody Zeller,24-148,F-C,3/2/17,CHO,PHO,0,24,3,5,0.6,3,5,0.6,0,0,,0,0,,3,5,8,3,2,0,1,3,6,9.2
Brandon Ingram,19-123,F,1/3/17,LAL,MEM,0,25,2,4,0.5,2,4,0.5,0,0,,2,6,0.333,0,3,3,2,0,1,1,2,6,3.6
Garrett Temple,30-323,G,3/27/17,SAC,MEM,1,34,2,10,0.2,0,2,0,2,8,0.25,0,0,,0,4,4,3,1,1,2,2,6,2
Kenneth Faried,26-347,F,10/31/16,DEN,TOR,0,15,1,3,0.333,1,3,0.333,0,0,,4,4,1,1,4,5,0,0,1,0,0,6,6.9
Jakob Poeltl,21-022,C,11/6/16,TOR,SAC,1,18,3,4,0.75,3,4,0.75,0,0,,0,0,,2,2,4,2,0,0,0,6,6,5.4
Dorian Finney-Smith,23-311,F,3/11/17,DAL,PHO,0,14,2,3,0.667,0,1,0,2,2,1,0,0,,1,4,5,1,0,0,1,0,6,6.3
Anthony Tolliver,31-203,F-C,12/21/16,SAC,UTA,0,30,2,3,0.667,0,0,,2,3,0.667,0,0,,2,5,7,0,1,0,0,0,6,8.6
Kentavious Caldwell-Pope,24-016,G,3/6/17,DET,CHI,1,36,2,9,0.222,0,3,0,2,6,0.333,0,0,,2,3,5,1,1,0,0,2,6,3.7
Terry Rozier,23-019,G,4/5/17,BOS,CLE,0,9,2,5,0.4,1,2,0.5,1,3,0.333,1,2,0.5,0,0,0,0,0,0,0,1,6,2.5
Kyle Korver,35-334,G-F,2/14/17,CLE,MIN,0,27,2,5,0.4,0,0,,2,5,0.4,0,0,,0,5,5,1,1,1,1,2,6,5.4
Joakim Noah,31-247,C,10/29/16,NYK,MEM,1,22,2,2,1,2,2,1,0,0,,2,6,0.333,1,9,10,7,0,1,4,6,6,6.4
Brandon Bass,31-213,F,11/29/16,LAC,BRK,0,12,3,4,0.75,3,4,0.75,0,0,,0,0,,0,2,2,0,0,0,1,2,6,3.2
Nikola Vucevic,26-012,C,11/5/16,ORL,WAS,1,26,3,6,0.5,3,6,0.5,0,0,,0,2,0,2,7,9,1,0,1,0,1,6,6.7
Al Jefferson,31-319,C-F,11/18/16,IND,PHO,0,6,3,4,0.75,3,4,0.75,0,0,,0,0,,1,1,2,0,0,1,0,0,6,6.1
Al Jefferson,32-042,C-F,2/15/17,IND,CLE,0,13,3,7,0.429,3,7,0.429,0,0,,0,0,,2,4,6,4,0,0,0,3,6,6.5
Kenneth Faried,27-041,F,12/30/16,DEN,PHI,0,12,1,3,0.333,1,3,0.333,0,0,,4,4,1,2,4,6,0,1,0,0,2,6,7.1
Joe Ingles,29-145,F-G,2/24/17,UTA,MIL,0,26,2,8,0.25,0,4,0,2,4,0.5,0,0,,1,6,7,5,0,0,0,2,6,6.4
Robin Lopez,28-266,C,12/23/16,CHI,CHO,1,33,3,8,0.375,3,8,0.375,0,0,,0,0,,4,5,9,1,0,2,0,4,6,6.4
Trevor Ariza,31-281,F,4/7/17,HOU,DET,1,35,1,11,0.091,0,3,0,1,8,0.125,3,4,0.75,1,6,7,3,1,0,1,1,6,2.5
Channing Frye,33-161,C-F,10/25/16,CLE,NYK,0,14,2,6,0.333,0,1,0,2,5,0.4,0,0,,2,2,4,0,1,1,1,4,6,3.7
Ramon Sessions,30-250,G,12/17/16,CHO,ATL,0,14,2,4,0.5,2,3,0.667,0,1,0,2,2,1,0,3,3,3,1,0,2,0,6,6
Nikola Mirotic,25-270,F,11/7/16,CHI,ORL,0,21,2,9,0.222,1,3,0.333,1,6,0.167,1,2,0.5,1,3,4,0,0,0,1,0,6,0.7
Kyle Anderson,23-107,F-G,1/5/17,SAS,DEN,0,8,3,4,0.75,3,4,0.75,0,0,,0,0,,0,1,1,1,1,0,0,0,6,6.4
Danny Green,29-199,G-F,1/7/17,SAS,CHO,1,21,2,6,0.333,0,2,0,2,4,0.5,0,0,,1,3,4,4,1,1,1,0,6,7.7
Tyson Chandler,34-085,C,12/26/16,PHO,HOU,1,20,3,6,0.5,3,6,0.5,0,0,,0,0,,5,3,8,0,0,0,1,2,6,5.6
Isaiah Whitehead,22-024,G,4/1/17,BRK,ORL,0,26,3,4,0.75,3,3,1,0,1,0,0,0,,1,0,1,5,1,0,0,1,6,9.2
Sam Dekker,22-285,F,2/15/17,HOU,MIA,0,21,3,6,0.5,3,3,1,0,3,0,0,0,,2,1,3,0,1,0,0,0,6,5.7
Larry Nance Jr.,23-348,F,12/14/16,LAL,BRK,0,22,3,3,1,3,3,1,0,0,,0,0,,1,3,4,2,1,3,0,2,6,10.4
Tarik Black,25-010,C-F,12/2/16,LAL,TOR,0,20,2,8,0.25,2,8,0.25,0,0,,2,3,0.667,6,0,6,2,0,0,1,3,6,4.2
Manu Ginobili,39-109,G,11/14/16,SAS,MIA,0,17,2,5,0.4,0,3,0,2,2,1,0,0,,0,3,3,2,0,0,2,1,6,3.2
Tarik Black,25-054,C-F,1/15/17,LAL,DET,0,11,2,2,1,2,2,1,0,0,,2,3,0.667,0,2,2,0,0,0,0,3,6,4.4
Sam Dekker,22-179,F,11/1/16,HOU,CLE,0,14,3,8,0.375,3,5,0.6,0,3,0,0,0,,1,2,3,1,0,0,0,1,6,3.2
Sergio Rodriguez,30-283,G,3/22/17,PHI,OKC,0,26,3,5,0.6,3,4,0.75,0,1,0,0,0,,0,1,1,4,1,0,1,0,6,6.8
Lance Thomas,28-199,F,11/9/16,NYK,BRK,0,10,3,5,0.6,3,4,0.75,0,1,0,0,0,,0,1,1,0,1,0,0,1,6,4.6
David West,36-079,F,11/16/16,GSW,TOR,0,16,3,4,0.75,3,4,0.75,0,0,,0,0,,0,2,2,1,1,1,0,1,6,7
Devin Harris,34-034,G,4/2/17,DAL,MIL,0,23,1,5,0.2,1,3,0.333,0,2,0,4,4,1,0,3,3,3,2,0,1,3,6,5.7
Jeremy Lamb,24-261,G-F,2/15/17,CHO,TOR,0,11,3,5,0.6,3,4,0.75,0,1,0,0,0,,0,2,2,0,0,0,0,4,6,2.7
Patrick Patterson,27-237,F,11/6/16,TOR,SAC,0,31,1,6,0.167,1,4,0.25,0,2,0,4,5,0.8,2,7,9,2,1,2,1,5,6,6.1
Emmanuel Mudiay,20-245,G,11/5/16,DEN,DET,1,24,0,7,0,0,5,0,0,2,0,6,7,0.857,0,2,2,3,1,0,4,2,6,-0.4
Amir Johnson,29-332,F,3/29/17,BOS,MIL,1,21,3,5,0.6,3,5,0.6,0,0,,0,0,,1,2,3,2,0,2,1,2,6,6
Wade Baldwin,21-011,G,4/9/17,MEM,DET,0,12,3,8,0.375,3,8,0.375,0,0,,0,0,,1,0,1,1,1,0,0,0,6,4
Jonas Jerebko,29-336,F,2/1/17,BOS,TOR,0,19,2,7,0.286,0,2,0,2,5,0.4,0,0,,0,3,3,2,0,1,0,1,6,4.5
Kyle O'Quinn,26-269,F-C,12/20/16,NYK,IND,0,17,3,6,0.5,3,6,0.5,0,0,,0,0,,1,5,6,1,2,1,1,3,6,6.4
Jakob Poeltl,21-147,C,3/11/17,TOR,MIA,0,19,3,8,0.375,3,8,0.375,0,0,,0,2,0,6,3,9,0,0,0,0,3,6,4.7
Montrezl Harrell,22-361,F-C,1/21/17,HOU,MEM,1,16,3,6,0.5,3,5,0.6,0,1,0,0,0,,2,0,2,2,0,0,2,1,6,3.4
Darrun Hilliard,23-362,G,4/10/17,DET,WAS,0,16,3,6,0.5,3,5,0.6,0,1,0,0,0,,0,1,1,4,1,0,2,2,6,4.3
Justin Holiday,27-229,G,11/20/16,NYK,ATL,0,19,2,8,0.25,0,3,0,2,5,0.4,0,0,,0,2,2,0,1,0,1,1,6,1.4
Terry Rozier,22-316,G,1/27/17,BOS,ORL,0,20,2,5,0.4,2,2,1,0,3,0,2,2,1,1,1,2,2,1,0,0,0,6,6.7
Jon Leuer,27-261,F,1/30/17,DET,BOS,1,26,1,5,0.2,1,3,0.333,0,2,0,4,4,1,2,4,6,3,0,2,0,3,6,7.8
Devin Harris,34-037,G,4/5/17,DAL,LAC,0,22,1,6,0.167,0,1,0,1,5,0.2,3,4,0.75,1,4,5,4,0,0,0,3,6,5.3
Mindaugas Kuzminskas,27-014,F,11/2/16,NYK,HOU,0,6,1,3,0.333,0,2,0,1,1,1,3,4,0.75,1,0,1,0,1,0,0,0,6,5.6
Alex Abrines,23-093,G-F,11/2/16,OKC,LAC,0,8,2,2,1,0,0,,2,2,1,0,0,,0,0,0,0,0,0,2,0,6,3.4
Joffrey Lauvergne,25-101,C-F,1/9/17,OKC,CHI,0,14,2,3,0.667,1,1,1,1,2,0.5,1,2,0.5,0,0,0,0,0,0,3,0,6,1.3
P.J. Tucker,31-242,F,1/2/17,PHO,LAC,0,36,3,8,0.375,3,8,0.375,0,0,,0,0,,4,9,13,0,1,1,0,3,6,7.6
Jamal Murray,20-029,G,3/24/17,DEN,IND,0,17,1,6,0.167,1,2,0.5,0,4,0,4,4,1,0,1,1,3,1,0,1,3,6,3.4
Terrence Jones,24-337,F,12/11/16,NOP,PHO,0,25,2,9,0.222,1,6,0.167,1,3,0.333,1,2,0.5,2,4,6,3,0,1,1,0,6,4.5
Michael Carter-Williams,25-163,G,3/22/17,CHI,DET,0,17,3,7,0.429,3,7,0.429,0,0,,0,1,0,0,2,2,3,3,0,2,1,6,5.2
Robin Lopez,28-346,C,3/13/17,CHI,CHO,1,30,3,7,0.429,3,7,0.429,0,0,,0,0,,0,3,3,2,0,1,1,2,6,3.5
Ian Mahinmi,30-118,C,3/3/17,WAS,TOR,0,16,3,4,0.75,3,4,0.75,0,0,,0,0,,2,1,3,0,2,1,0,4,6,7.2
Jahlil Okafor,20-340,C-F,11/19/16,PHI,PHO,0,19,3,4,0.75,3,4,0.75,0,0,,0,0,,1,0,1,2,0,3,1,2,6,6.8
Kyle O'Quinn,26-296,F-C,1/16/17,NYK,ATL,0,16,3,10,0.3,3,10,0.3,0,0,,0,0,,2,6,8,2,0,0,1,1,6,3.4
Richard Jefferson,36-230,F,2/6/17,CLE,WAS,0,21,2,4,0.5,2,3,0.667,0,1,0,2,2,1,1,2,3,1,0,0,0,1,6,5.6
Patrick Patterson,28-007,F,3/21/17,TOR,CHI,0,23,3,4,0.75,3,4,0.75,0,0,,0,0,,2,5,7,1,0,2,0,2,6,8.6
Thon Maker,19-252,F-C,11/3/16,MIL,IND,0,1,2,2,1,0,0,,2,2,1,0,0,,0,0,0,0,0,0,0,0,6,5.4
P.J. Tucker,31-240,F,12/31/16,PHO,UTA,0,35,2,4,0.5,0,2,0,2,2,1,0,0,,1,5,6,0,1,0,0,1,6,6.8
Joe Johnson,35-175,G-F,12/21/16,UTA,SAC,0,22,2,7,0.286,0,2,0,2,5,0.4,0,0,,0,1,1,0,0,0,1,1,6,0.8
David Lee,33-237,F,12/22/16,SAS,LAC,0,16,3,3,1,3,3,1,0,0,,0,0,,2,3,5,2,0,0,0,2,6,8
Doug McDermott,24-306,F,11/4/16,CHI,NYK,0,26,3,5,0.6,3,4,0.75,0,1,0,0,0,,1,1,2,1,1,0,1,0,6,5.4
Terrence Ross,25-361,F-G,1/31/17,TOR,NOP,0,22,2,9,0.222,0,2,0,2,7,0.286,0,0,,0,5,5,0,0,0,1,1,6,0.6
Kyle Korver,35-310,G-F,1/21/17,CLE,SAS,0,22,2,3,0.667,0,0,,2,3,0.667,0,0,,1,1,2,0,0,0,0,0,6,5.7
JaMychal Green,26-133,F,11/1/16,MEM,MIN,1,27,2,8,0.25,1,5,0.2,1,3,0.333,1,2,0.5,0,2,2,1,1,1,2,2,6,1
Kent Bazemore,27-190,G-F,1/7/17,ATL,DAL,1,28,2,6,0.333,0,2,0,2,4,0.5,0,0,,2,2,4,4,0,1,0,2,6,7.3
Brandon Rush,31-222,G-F,2/14/17,MIN,CLE,1,37,2,6,0.333,0,2,0,2,4,0.5,0,0,,0,4,4,0,2,1,0,0,6,6.5
Derrick Jones,20-009,F,2/24/17,PHO,CHI,0,14,2,4,0.5,2,4,0.5,0,0,,2,2,1,1,1,2,2,0,0,1,0,6,5.4
Cory Joseph,25-203,G,3/11/17,TOR,MIA,1,22,3,8,0.375,3,8,0.375,0,0,,0,0,,0,3,3,0,1,0,2,2,6,0.7
Ish Smith,28-141,G,11/23/16,DET,MIA,1,18,2,6,0.333,2,6,0.333,0,0,,2,2,1,0,3,3,2,0,0,0,3,6,3.7
Meyers Leonard,25-003,C-F,3/2/17,POR,OKC,0,10,2,3,0.667,1,1,1,1,2,0.5,1,2,0.5,1,0,1,2,0,1,2,3,6,3.9
Danny Green,29-223,G-F,1/31/17,SAS,OKC,1,24,2,6,0.333,0,1,0,2,5,0.4,0,0,,0,1,1,1,2,3,1,4,6,5.1
Danny Green,29-255,G-F,3/4/17,SAS,MIN,1,38,2,8,0.25,1,3,0.333,1,5,0.2,1,2,0.5,4,0,4,1,0,0,1,1,6,2.9
Tony Snell,25-086,G-F,2/4/17,MIL,PHO,1,26,2,7,0.286,1,4,0.25,1,3,0.333,1,2,0.5,0,1,1,1,0,1,2,3,6,0
Timofey Mozgov,30-169,C,1/1/17,LAL,TOR,1,21,2,6,0.333,2,6,0.333,0,0,,2,2,1,0,3,3,0,1,1,1,3,6,3
Ian Mahinmi,30-146,C,3/31/17,WAS,UTA,0,18,3,6,0.5,3,6,0.5,0,0,,0,1,0,1,3,4,0,1,0,2,3,6,2
Jaylen Brown,20-149,F,3/22/17,BOS,IND,0,14,3,6,0.5,3,4,0.75,0,2,0,0,0,,1,2,3,2,0,0,0,0,6,5.7
Greg Monroe,26-249,C-F,2/8/17,MIL,MIA,0,22,2,5,0.4,2,5,0.4,0,0,,2,3,0.667,2,5,7,2,0,0,0,2,6,6.4
Trey Burke,24-041,G,12/23/16,WAS,MIL,0,16,2,5,0.4,2,4,0.5,0,1,0,2,2,1,0,0,0,1,0,0,2,1,6,1.6
Jarell Martin,22-191,F,12/1/16,MEM,ORL,0,28,2,11,0.182,2,10,0.2,0,1,0,2,2,1,2,8,10,0,0,0,0,4,6,1.3
Tristan Thompson,25-275,F-C,12/13/16,CLE,MEM,1,30,3,6,0.5,3,6,0.5,0,0,,0,0,,2,5,7,0,0,1,1,4,6,4
Jeff Withey,26-258,C,11/20/16,UTA,DEN,0,18,2,3,0.667,2,3,0.667,0,0,,2,2,1,3,2,5,0,1,3,0,1,6,10.1
Archie Goodwin,22-232,G,4/6/17,BRK,ORL,0,21,3,7,0.429,3,6,0.5,0,1,0,0,0,,0,5,5,2,0,0,1,0,6,4.2
Alan Williams,24-061,F-C,3/30/17,PHO,LAC,0,19,2,6,0.333,2,6,0.333,0,0,,2,4,0.5,2,5,7,0,0,0,0,1,6,4.3
Sheldon McClellan,23-331,G,11/16/16,WAS,PHI,1,20,2,7,0.286,2,4,0.5,0,3,0,2,2,1,1,1,2,1,2,0,1,3,6,3.4
John Henson,26-063,C-F,3/1/17,MIL,DEN,0,18,3,6,0.5,3,6,0.5,0,0,,0,0,,1,3,4,2,2,2,0,1,6,9
Malcolm Delaney,27-239,G,11/5/16,ATL,HOU,0,16,3,7,0.429,3,5,0.6,0,2,0,0,0,,0,1,1,1,0,0,2,0,6,1.3
Toney Douglas,30-345,G,2/24/17,MEM,IND,0,18,3,7,0.429,3,3,1,0,4,0,0,0,,0,1,1,1,2,1,0,1,6,5.6
Ramon Sessions,30-266,G,1/2/17,CHO,CHI,0,16,2,3,0.667,2,3,0.667,0,0,,2,3,0.667,0,1,1,3,1,0,2,0,6,5.7
T.J. McConnell,24-266,G,12/16/16,PHI,LAL,0,23,2,5,0.4,2,5,0.4,0,0,,2,2,1,0,1,1,9,3,0,2,2,6,10.1
Ron Baker,23-285,G,1/9/17,NYK,NOP,0,25,3,5,0.6,3,5,0.6,0,0,,0,0,,0,7,7,4,1,0,2,2,6,6.8
J.R. Smith,31-102,G-F,12/20/16,CLE,MIL,1,17,2,6,0.333,0,2,0,2,4,0.5,0,0,,0,1,1,0,0,0,0,2,6,2.1
Reggie Jackson,26-302,G,2/12/17,DET,TOR,1,17,1,5,0.2,1,3,0.333,0,2,0,4,4,1,0,0,0,1,2,0,2,1,6,3.2
D.J. Augustin,28-363,G,11/7/16,ORL,CHI,0,23,2,10,0.2,0,3,0,2,7,0.286,0,0,,0,0,0,2,0,0,0,1,6,0.8
Markieff Morris,27-078,F,11/19/16,WAS,MIA,1,9,3,4,0.75,3,3,1,0,1,0,0,0,,0,0,0,0,0,0,0,0,6,4.4
E'Twaun Moore,27-309,G,1/2/17,NOP,CLE,0,20,2,5,0.4,0,2,0,2,3,0.667,0,0,,1,3,4,1,0,1,0,5,6,4.3
Willie Reed,26-233,F-C,1/4/17,MIA,SAC,1,23,3,6,0.5,3,6,0.5,0,0,,0,0,,0,4,4,0,1,2,1,3,6,4.4
Maurice Harkless,23-314,F-G,3/21/17,POR,MIL,1,30,2,6,0.333,2,4,0.5,0,2,0,2,2,1,2,3,5,0,0,2,1,3,6,4.1
Willie Cauley-Stein,23-111,F-C,12/7/16,SAC,DAL,0,15,3,5,0.6,3,5,0.6,0,0,,0,2,0,1,2,3,1,3,0,1,4,6,5.3
D.J. Augustin,29-097,G,2/15/17,ORL,SAS,0,20,2,4,0.5,1,1,1,1,3,0.333,1,3,0.333,0,1,1,1,0,0,2,0,6,2.2
Cory Joseph,25-111,G,12/9/16,TOR,BOS,0,24,1,7,0.143,0,5,0,1,2,0.5,3,4,0.75,0,1,1,0,0,0,0,1,6,1
Roy Hibbert,30-001,C,12/12/16,CHO,IND,0,17,2,3,0.667,2,3,0.667,0,0,,2,2,1,1,2,3,0,0,1,1,2,6,4.9
Gorgui Dieng,26-340,C,12/23/16,MIN,SAC,1,43,3,5,0.6,3,5,0.6,0,0,,0,0,,3,7,10,1,1,2,1,5,6,8
Trevor Booker,29-033,F,12/28/16,BRK,CHI,1,26,3,7,0.429,3,7,0.429,0,0,,0,0,,5,8,13,2,0,1,2,0,6,8.3
Richard Jefferson,36-137,F,11/5/16,CLE,PHI,0,14,2,4,0.5,1,2,0.5,1,2,0.5,1,1,1,0,3,3,0,0,0,1,1,6,3.5
Terry Rozier,22-251,G,11/23/16,BOS,BRK,0,23,3,4,0.75,3,3,1,0,1,0,0,0,,1,5,6,1,2,0,1,2,6,7.5
Monta Ellis,31-089,G,1/23/17,IND,NYK,0,24,1,6,0.167,1,5,0.2,0,1,0,4,4,1,0,3,3,3,0,0,2,0,6,3.2
Brandon Bass,31-269,F,1/24/17,LAC,PHI,0,12,0,1,0,0,1,0,0,0,,6,6,1,1,1,2,0,0,0,0,0,6,6.3
Kris Humphries,31-326,F-C,12/28/16,ATL,NYK,0,12,2,7,0.286,2,6,0.333,0,1,0,2,2,1,2,4,6,0,1,0,0,0,6,5.5
Langston Galloway,24-325,G,10/29/16,NOP,SAS,0,23,3,10,0.3,3,6,0.5,0,4,0,0,0,,0,4,4,2,0,0,0,1,6,2.4
D.J. Augustin,29-053,G,1/2/17,ORL,NYK,1,14,2,4,0.5,0,0,,2,4,0.5,0,0,,0,0,0,2,1,0,0,1,6,6
Noah Vonleh,21-064,F,10/27/16,POR,LAC,0,10,1,3,0.333,1,2,0.5,0,1,0,4,5,0.8,0,0,0,0,0,0,1,3,6,1.7
Joe Johnson,35-183,G-F,12/29/16,UTA,PHI,0,17,2,6,0.333,0,2,0,2,4,0.5,0,0,,0,0,0,3,0,1,2,1,6,3
Kyle Singler,28-183,F,11/3/16,OKC,GSW,0,17,2,5,0.4,1,3,0.333,1,2,0.5,1,2,0.5,0,2,2,0,0,1,1,1,6,2.8
Corey Brewer,30-363,F-G,3/3/17,LAL,BOS,0,12,3,4,0.75,3,4,0.75,0,0,,0,0,,0,3,3,1,0,0,0,1,6,5.6
Langston Galloway,25-094,G,3/13/17,SAC,ORL,0,22,2,4,0.5,0,2,0,2,2,1,0,0,,0,0,0,2,0,0,1,0,6,4.4
Jonathon Simmons,27-163,G-F,2/24/17,SAS,LAC,0,10,2,5,0.4,2,3,0.667,0,2,0,2,2,1,0,0,0,1,0,0,0,0,6,4
Darrun Hilliard,23-274,G,1/12/17,DET,GSW,0,26,2,12,0.167,2,8,0.25,0,4,0,2,4,0.5,0,1,1,3,0,0,1,3,6,-2.2
Tomas Satoransky,25-022,G,11/21/16,WAS,PHO,0,16,1,1,1,0,0,,1,1,1,3,4,0.75,0,4,4,2,0,0,1,1,6,6.5
Justin Hamilton,26-315,C,2/10/17,BRK,MIA,0,18,2,6,0.333,1,4,0.25,1,2,0.5,1,1,1,2,1,3,0,0,4,0,0,6,7.1
Kevin Seraphin,26-347,F,11/18/16,IND,PHO,0,11,2,4,0.5,2,4,0.5,0,0,,2,2,1,2,0,2,0,0,1,0,0,6,6.1
Domantas Sabonis,20-286,F,2/13/17,OKC,WAS,1,23,3,11,0.273,3,6,0.5,0,5,0,0,0,,3,4,7,1,0,0,1,5,6,0.5
Terry Rozier,22-269,G,12/11/16,BOS,OKC,0,29,3,12,0.25,3,10,0.3,0,2,0,0,0,,2,3,5,3,0,0,0,2,6,2.4
Ian Clark,25-288,G,12/20/16,GSW,UTA,0,10,2,5,0.4,1,3,0.333,1,2,0.5,1,2,0.5,0,1,1,1,1,0,2,2,6,2.1
JaVale McGee,28-324,C,12/8/16,GSW,UTA,0,8,3,4,0.75,3,4,0.75,0,0,,0,0,,1,2,3,0,1,0,1,4,6,4.1
Michael Kidd-Gilchrist,23-152,F,2/25/17,CHO,SAC,1,27,1,6,0.167,1,5,0.2,0,1,0,4,4,1,6,6,12,3,2,1,0,1,6,12.6
David Lee,33-237,F,12/22/16,SAS,LAC,0,16,3,3,1,3,3,1,0,0,,0,0,,2,3,5,2,0,0,0,2,6,8
Jaylen Brown,20-107,F,2/8/17,BOS,SAC,1,26,2,5,0.4,2,4,0.5,0,1,0,2,2,1,0,3,3,0,1,0,3,4,6,0.6
Iman Shumpert,26-186,G,12/29/16,CLE,BOS,0,30,2,6,0.333,1,2,0.5,1,4,0.25,1,2,0.5,2,0,2,1,1,0,0,3,6,4.1
Otto Porter,23-268,F,2/26/17,WAS,UTA,1,40,3,9,0.333,3,7,0.429,0,2,0,0,0,,1,6,7,1,3,0,0,3,6,5.9
Derrick Favors,25-109,F-C,11/1/16,UTA,SAS,1,16,3,6,0.5,3,6,0.5,0,0,,0,0,,0,3,3,3,0,1,0,1,6,6.3
Nerlens Noel,22-278,C-F,1/13/17,PHI,CHO,0,20,3,3,1,3,3,1,0,0,,0,0,,1,1,2,1,1,4,2,2,6,7.8
Brian Roberts,31-068,G,2/9/17,CHO,HOU,0,12,2,4,0.5,0,1,0,2,3,0.667,0,0,,0,0,0,2,0,0,1,0,6,4.4
Justin Hamilton,26-215,C,11/2/16,BRK,DET,0,23,3,4,0.75,3,4,0.75,0,0,,0,0,,1,2,3,3,0,1,1,2,6,6.7
Dante Exum,21-119,G,11/9/16,UTA,CHO,0,24,2,4,0.5,1,1,1,1,3,0.333,1,2,0.5,0,1,1,5,0,0,1,3,6,5.2
Joffrey Lauvergne,25-057,C-F,11/26/16,OKC,DET,0,12,1,4,0.25,1,3,0.333,0,1,0,4,8,0.5,1,3,4,1,0,0,0,0,6,4.3
Tyler Zeller,27-064,F-C,3/22/17,BOS,IND,0,10,3,5,0.6,3,5,0.6,0,0,,0,1,0,0,3,3,2,0,1,0,2,6,5.5
Mirza Teletovic,31-070,F,11/27/16,MIL,ORL,0,15,2,5,0.4,0,0,,2,5,0.4,0,0,,1,2,3,1,0,0,0,2,6,4.5
Yogi Ferrell,23-294,G,2/27/17,DAL,MIA,1,29,2,9,0.222,1,7,0.143,1,2,0.5,1,2,0.5,2,3,5,5,1,0,1,2,6,5.1
Justise Winslow,20-226,F,11/7/16,MIA,OKC,1,32,2,13,0.154,2,11,0.182,0,2,0,2,2,1,1,2,3,0,2,0,0,2,6,0.2
DeAndre Jordan,28-106,C,11/4/16,LAC,MEM,1,36,3,8,0.375,3,8,0.375,0,0,,0,0,,6,15,21,0,1,2,3,4,6,8.1
Amir Johnson,29-247,F,1/3/17,BOS,UTA,1,28,3,7,0.429,3,7,0.429,0,0,,0,0,,1,4,5,2,0,3,1,1,6,6.3
Richard Jefferson,36-155,F,11/23/16,CLE,POR,0,25,3,4,0.75,3,3,1,0,1,0,0,0,,0,2,2,4,0,0,0,0,6,7.8
Marcin Gortat,33-009,C-F,2/26/17,WAS,UTA,1,28,3,9,0.333,3,9,0.333,0,0,,0,0,,2,6,8,0,2,0,1,2,6,4.3
Allen Crabbe,24-287,G-F,1/21/17,POR,BOS,0,24,3,10,0.3,3,8,0.375,0,2,0,0,0,,0,2,2,3,2,0,0,1,6,4.5
Dwight Howard,31-064,C,2/10/17,ATL,SAC,1,32,3,5,0.6,3,5,0.6,0,0,,0,0,,1,10,11,1,1,1,2,6,6,5.4
Maurice Harkless,23-174,F-G,11/1/16,POR,GSW,1,26,3,11,0.273,3,8,0.375,0,3,0,0,0,,1,1,2,0,0,2,0,1,6,1.5
Jonathon Simmons,27-176,G-F,3/9/17,SAS,OKC,0,18,1,5,0.2,1,5,0.2,0,0,,4,6,0.667,0,0,0,2,3,0,1,2,6,4.7
Andrew Harrison,22-075,G,1/11/17,MEM,OKC,0,11,2,5,0.4,2,4,0.5,0,1,0,2,2,1,0,0,0,0,1,0,0,0,6,4.3
Tyler Zeller,26-297,F-C,11/9/16,BOS,WAS,1,14,3,4,0.75,3,4,0.75,0,0,,0,0,,1,1,2,1,0,1,0,0,6,6.8
Wilson Chandler,29-298,F,3/4/17,DEN,CHO,1,22,1,8,0.125,0,3,0,1,5,0.2,3,4,0.75,0,4,4,3,0,0,0,2,6,2.9
Trevor Booker,29-064,F,1/28/17,BRK,MIN,1,16,3,4,0.75,3,4,0.75,0,0,,0,0,,1,4,5,1,0,0,1,3,6,4.8
Willie Reed,26-225,F-C,12/27/16,MIA,OKC,0,12,3,7,0.429,3,6,0.5,0,1,0,0,0,,2,4,6,0,0,2,1,2,6,4.5
Rodney Stuckey,30-321,G,3/8/17,IND,DET,0,24,2,7,0.286,1,4,0.25,1,3,0.333,1,1,1,0,2,2,7,0,0,0,0,6,7.4
Bobby Portis,21-264,F,10/31/16,CHI,BRK,0,4,3,4,0.75,3,4,0.75,0,0,,0,0,,2,0,2,0,0,0,1,0,6,4.8
David Lee,33-183,F,10/29/16,SAS,NOP,0,15,3,6,0.5,3,6,0.5,0,0,,0,0,,1,4,5,1,0,0,0,0,6,5.6
Richaun Holmes,23-060,F-C,12/14/16,PHI,TOR,0,7,3,5,0.6,3,5,0.6,0,0,,0,0,,1,0,1,1,1,0,0,1,6,5.7
Lucas Nogueira,24-201,C,2/12/17,TOR,DET,0,32,1,1,1,1,1,1,0,0,,4,4,1,1,1,2,3,1,3,0,1,6,11.5
Terrence Ross,25-362,F-G,2/1/17,TOR,BOS,0,23,3,10,0.3,3,6,0.5,0,4,0,0,2,0,0,6,6,3,1,0,3,2,6,0.5
Marvin Williams,30-282,F,3/28/17,CHO,MIL,1,32,1,5,0.2,1,2,0.5,0,3,0,4,4,1,1,6,7,1,1,0,0,2,6,6.3
Derrick Jones,20-020,F,3/7/17,PHO,WAS,0,22,3,3,1,3,3,1,0,0,,0,0,,0,2,2,0,0,2,0,4,6,5.5
Kay Felder,21-255,G,12/9/16,CLE,MIA,0,4,3,4,0.75,3,4,0.75,0,0,,0,0,,0,0,0,2,0,0,0,1,6,5.4
Brandan Wright,29-181,F-C,4/4/17,MEM,SAS,0,27,3,6,0.5,3,6,0.5,0,0,,0,0,,1,3,4,0,0,1,0,2,6,4.5
Roy Hibbert,30-048,C,1/28/17,CHO,SAC,1,12,2,2,1,2,2,1,0,0,,2,2,1,1,1,2,1,0,1,1,1,6,6.4
Darrun Hilliard,23-357,G,4/5/17,DET,TOR,0,8,2,2,1,2,2,1,0,0,,2,2,1,0,3,3,0,1,0,1,1,6,5.9
Robin Lopez,28-288,C,1/14/17,CHI,NOP,1,27,3,12,0.25,3,12,0.25,0,0,,0,0,,9,2,11,3,0,2,0,1,6,8.8
Lavoy Allen,27-275,F-C,11/5/16,IND,CHI,0,20,3,4,0.75,3,4,0.75,0,0,,0,0,,0,0,0,3,0,1,1,4,6,4.6
Salah Mejri,30-137,C,10/30/16,DAL,HOU,0,17,3,3,1,3,3,1,0,0,,0,0,,5,2,7,0,0,2,1,3,6,8.4
DeAndre Liggins,28-285,G,1/10/17,CLE,UTA,1,19,2,4,0.5,0,1,0,2,3,0.667,0,0,,1,1,2,1,1,1,2,2,6,4.6
Cheick Diallo,20-206,F,4/7/17,NOP,DEN,0,12,2,6,0.333,2,6,0.333,0,0,,2,2,1,1,2,3,1,0,1,0,2,6,4.5
Raymond Felton,32-171,G,12/14/16,LAC,ORL,0,17,2,6,0.333,2,5,0.4,0,1,0,2,2,1,0,1,1,1,1,0,0,1,6,4.2
Joe Ingles,29-095,F-G,1/5/17,UTA,TOR,0,26,3,6,0.5,3,3,1,0,3,0,0,0,,0,6,6,3,0,0,1,5,6,3.9
Shaun Livingston,31-113,G,1/2/17,GSW,DEN,0,18,3,6,0.5,3,6,0.5,0,0,,0,1,0,2,1,3,4,1,0,0,0,6,8.1
Deron Williams,32-253,G,3/6/17,CLE,MIA,0,17,2,3,0.667,2,2,1,0,1,0,2,2,1,0,1,1,2,0,1,3,1,6,3.7
Troy Daniels,25-243,G,3/15/17,MEM,CHI,0,19,2,8,0.25,0,1,0,2,7,0.286,0,0,,1,2,3,0,0,0,0,0,6,2.5
Deron Williams,32-184,G,12/27/16,DAL,HOU,1,23,2,11,0.182,0,6,0,2,5,0.4,0,1,0,2,1,3,6,0,0,2,2,6,1.8
Shaun Livingston,31-167,G,2/25/17,GSW,BRK,0,17,3,6,0.5,3,6,0.5,0,0,,0,0,,0,2,2,1,0,0,1,0,6,3.3
Ish Smith,28-194,G,1/15/17,DET,LAL,0,20,3,7,0.429,3,5,0.6,0,2,0,0,0,,0,1,1,6,2,0,0,1,6,8.4
Marquese Chriss,19-157,F,12/6/16,PHO,UTA,1,17,3,7,0.429,3,5,0.6,0,2,0,0,0,,2,2,4,0,0,0,1,3,6,2.1
Jon Leuer,27-169,F,10/30/16,DET,MIL,0,27,3,5,0.6,3,4,0.75,0,1,0,0,0,,0,3,3,1,0,1,0,3,6,4.8
Tony Allen,35-017,G-F,1/28/17,MEM,UTA,1,26,3,8,0.375,3,7,0.429,0,1,0,0,0,,1,3,4,1,2,0,0,0,6,5.9
Alex Len,23-193,C,12/26/16,PHO,HOU,0,20,2,2,1,2,2,1,0,0,,2,2,1,1,5,6,0,1,1,1,3,6,7.1
Jonathon Simmons,27-111,G-F,1/3/17,SAS,TOR,0,20,3,9,0.333,3,6,0.5,0,3,0,0,0,,0,4,4,3,1,1,3,2,6,2.1
Evan Turner,28-159,G,4/4/17,POR,UTA,0,23,3,9,0.333,3,6,0.5,0,3,0,0,0,,0,3,3,2,2,1,1,3,6,3.7
Marquese Chriss,19-219,F,2/6/17,PHO,NOP,1,17,3,7,0.429,3,5,0.6,0,2,0,0,1,0,0,3,3,2,1,1,0,2,6,5.1
Cody Zeller,24-146,F-C,2/28/17,CHO,LAL,0,18,3,6,0.5,3,6,0.5,0,0,,0,4,0,3,2,5,1,0,0,0,2,6,4
Kyle O'Quinn,26-235,F-C,11/16/16,NYK,DET,0,15,2,3,0.667,2,3,0.667,0,0,,2,2,1,2,3,5,2,1,3,2,2,6,8.7
Rashad Vaughn,20-214,G,3/18/17,MIL,GSW,0,12,2,5,0.4,0,1,0,2,4,0.5,0,0,,0,4,4,0,0,2,1,0,6,4.9
Josh Richardson,23-174,G,3/8/17,MIA,CHO,0,25,2,8,0.25,2,7,0.286,0,1,0,2,2,1,2,1,3,0,2,0,1,2,6,3.1
K.J. McDaniels,24-058,G-F,4/8/17,BRK,CHI,0,20,2,6,0.333,2,4,0.5,0,2,0,2,2,1,0,3,3,1,2,2,2,0,6,5.6
Amir Johnson,29-269,F,1/25/17,BOS,HOU,0,10,2,2,1,2,2,1,0,0,,2,2,1,0,5,5,1,0,0,2,3,6,4.4
J.R. Smith,31-197,G-F,3/25/17,CLE,WAS,1,31,2,6,0.333,0,0,,2,6,0.333,0,0,,0,1,1,2,0,0,0,2,6,3.5
Brandon Jennings,27-049,G,11/11/16,NYK,BOS,0,27,1,7,0.143,0,3,0,1,4,0.25,3,4,0.75,2,4,6,2,0,0,3,3,6,0.9
Kris Dunn,22-250,G,11/23/16,MIN,NOP,0,26,2,4,0.5,2,4,0.5,0,0,,2,2,1,0,4,4,2,4,1,2,3,6,8.1
Devin Harris,34-014,G,3/13/17,DAL,TOR,0,13,3,6,0.5,3,6,0.5,0,0,,0,1,0,0,2,2,1,0,0,2,0,6,1.9
Iman Shumpert,26-215,G,1/27/17,CLE,BRK,1,24,2,8,0.25,2,3,0.667,0,5,0,2,3,0.667,0,1,1,1,3,0,0,1,6,4.4
JaVale McGee,28-326,C,12/10/16,GSW,MEM,0,9,3,7,0.429,3,7,0.429,0,0,,0,2,0,1,3,4,0,0,1,1,1,6,2.4
Ron Baker,23-282,G,1/6/17,NYK,MIL,0,12,1,3,0.333,1,1,1,0,2,0,4,4,1,0,2,2,4,0,0,0,1,6,7.3
Manu Ginobili,39-226,G,3/11/17,SAS,GSW,0,19,2,6,0.333,2,4,0.5,0,2,0,2,3,0.667,2,3,5,6,3,0,2,3,6,8.5
Amir Johnson,29-309,F,3/6/17,BOS,LAC,1,24,2,5,0.4,2,5,0.4,0,0,,2,4,0.5,2,3,5,2,2,1,0,5,6,6.9
Alex Len,23-162,C,11/25/16,PHO,MIN,1,29,3,6,0.5,3,5,0.6,0,1,0,0,0,,2,9,11,0,0,4,7,5,6,0.9
Cristiano Felicio,24-167,F-C,12/21/16,CHI,WAS,0,7,3,3,1,3,3,1,0,0,,0,0,,1,2,3,0,1,0,0,0,6,7.4
Fred VanVleet,23-024,G,3/21/17,TOR,CHI,0,20,2,3,0.667,2,2,1,0,1,0,2,2,1,0,3,3,1,2,0,2,2,6,5.5
Malcolm Brogdon,24-059,G,2/8/17,MIL,MIA,0,33,2,7,0.286,2,6,0.333,0,1,0,2,4,0.5,1,1,2,6,3,0,1,2,6,7.5
E'Twaun Moore,28-003,G,3/3/17,NOP,SAS,0,37,2,8,0.25,1,6,0.167,1,2,0.5,1,1,1,0,4,4,5,0,1,0,2,6,5.8
Marreese Speights,29-122,C-F,12/4/16,LAC,IND,0,12,2,7,0.286,0,2,0,2,5,0.4,0,0,,2,1,3,0,0,0,0,5,6,1.6
Jerami Grant,22-256,F,11/23/16,OKC,SAC,0,32,2,5,0.4,2,3,0.667,0,2,0,2,4,0.5,0,3,3,1,1,1,0,2,6,5
Kevon Looney,20-293,F-C,11/25/16,GSW,LAL,0,13,3,3,1,3,3,1,0,0,,0,0,,0,1,1,0,1,2,0,1,6,7.4
Marcus Morris,27-108,F,12/19/16,DET,CHI,1,24,2,9,0.222,2,5,0.4,0,4,0,2,2,1,1,0,1,1,0,0,2,1,6,-0.5
Nick Collison,36-168,F,4/12/17,OKC,DEN,0,9,3,5,0.6,3,4,0.75,0,1,0,0,0,,2,0,2,1,0,0,0,1,6,5.4
Patrick Patterson,28-019,F,4/2/17,TOR,PHI,0,17,2,4,0.5,0,1,0,2,3,0.667,0,0,,0,2,2,0,0,0,0,2,6,3.8
Tim Hardaway,24-305,G,1/15/17,ATL,MIL,0,24,3,7,0.429,3,4,0.75,0,3,0,0,0,,0,2,2,1,1,0,1,2,6,2.8
Kris Dunn,22-299,G,1/11/17,MIN,HOU,0,13,3,7,0.429,3,7,0.429,0,0,,0,0,,1,2,3,0,2,1,2,1,6,3.9
Justin Hamilton,26-240,C,11/27/16,BRK,SAC,0,24,3,7,0.429,3,5,0.6,0,2,0,0,0,,4,6,10,3,1,0,0,0,6,10
Eric Bledsoe,26-345,G,11/18/16,PHO,IND,1,13,3,10,0.3,3,9,0.333,0,1,0,0,0,,0,3,3,2,1,0,2,4,6,-0.1
Danny Green,29-206,G-F,1/14/17,SAS,PHO,1,28,3,7,0.429,3,3,1,0,4,0,0,0,,0,2,2,0,0,0,0,2,6,2.1
Jamal Murray,19-298,G,12/17/16,DEN,NYK,0,13,2,5,0.4,0,1,0,2,4,0.5,0,0,,2,1,3,0,0,1,0,1,6,5.3
Derrick Jones,20-030,F,3/17/17,PHO,ORL,0,17,3,6,0.5,3,6,0.5,0,0,,0,0,,2,0,2,0,0,0,0,0,6,4.4
Myles Turner,20-256,F-C,12/5/16,IND,GSW,1,24,3,8,0.375,3,7,0.429,0,1,0,0,0,,1,4,5,0,0,2,0,3,6,3.7
Troy Daniels,25-241,G,3/13/17,MEM,MIL,0,15,2,8,0.25,0,2,0,2,6,0.333,0,0,,1,3,4,1,1,0,2,0,6,2.5
Tyus Jones,20-291,G,2/25/17,MIN,HOU,0,21,2,8,0.25,1,3,0.333,1,5,0.2,1,2,0.5,0,4,4,6,1,0,0,1,6,6.8
P.J. Tucker,31-302,F,3/3/17,TOR,WAS,0,24,3,5,0.6,3,5,0.6,0,0,,0,0,,1,2,3,0,1,1,1,4,6,4.1
Evan Turner,28-158,G,4/3/17,POR,MIN,0,27,3,7,0.429,3,6,0.5,0,1,0,0,0,,1,3,4,4,0,2,1,4,6,5.5
Tristan Thompson,25-267,F-C,12/5/16,CLE,TOR,1,29,3,5,0.6,3,5,0.6,0,0,,0,2,0,4,10,14,1,0,2,1,1,6,9.4
LaMarcus Aldridge,31-140,F-C,12/6/16,SAS,MIN,1,30,3,8,0.375,3,7,0.429,0,1,0,0,0,,0,2,2,0,3,0,3,3,6,1
DeAndre Liggins,28-251,G,12/7/16,CLE,NYK,1,21,2,2,1,0,0,,2,2,1,0,0,,1,1,2,2,1,0,0,3,6,7.6
D.J. Augustin,29-055,G,1/4/17,ORL,ATL,0,13,2,4,0.5,0,0,,2,4,0.5,0,0,,0,2,2,1,0,0,0,0,6,5.3
Michael Beasley,28-026,F,2/4/17,MIL,PHO,0,7,3,4,0.75,3,4,0.75,0,0,,0,0,,0,1,1,0,0,0,0,0,6,4.7
Jerian Grant,24-039,G,11/17/16,CHI,UTA,1,29,2,10,0.2,2,8,0.25,0,2,0,2,2,1,0,5,5,1,2,0,1,3,6,1.8
Mike Muscala,25-168,F-C,12/16/16,ATL,TOR,0,18,3,7,0.429,3,6,0.5,0,1,0,0,2,0,2,2,4,5,0,2,0,1,6,8
Trey Lyles,20-358,F,10/28/16,UTA,LAL,0,18,2,8,0.25,1,4,0.25,1,4,0.25,1,1,1,0,2,2,0,0,0,1,0,6,0.8
Shelvin Mack,26-242,G,12/20/16,UTA,GSW,0,22,3,7,0.429,3,5,0.6,0,2,0,0,2,0,0,1,1,2,0,0,4,1,6,-1.2
Metta World Peace,37-010,F,11/23/16,LAL,GSW,0,14,2,4,0.5,0,0,,2,4,0.5,0,0,,0,1,1,2,0,0,0,3,6,4.5
Isaiah Whitehead,22-000,G,3/8/17,BRK,ATL,0,24,3,6,0.5,3,4,0.75,0,2,0,0,0,,0,3,3,2,0,1,3,5,6,1
Norman Powell,23-163,G,11/4/16,TOR,MIA,0,14,2,2,1,1,1,1,1,1,1,1,2,0.5,0,2,2,1,0,0,0,1,6,5.9
Vince Carter,39-329,G-F,12/20/16,MEM,BOS,0,15,2,5,0.4,0,1,0,2,4,0.5,0,0,,0,2,2,2,2,1,1,1,6,6.6
Pascal Siakam,22-308,F,12/8/16,TOR,MIN,1,11,1,1,1,1,1,1,0,0,,4,4,1,0,1,1,0,0,0,0,2,6,5.2
Tiago Splitter,32-091,F-C,4/2/17,PHI,TOR,0,7,3,4,0.75,3,4,0.75,0,0,,0,0,,2,0,2,1,0,0,1,0,6,5.5
Kentavious Caldwell-Pope,23-305,G,12/19/16,DET,CHI,1,24,3,6,0.5,3,5,0.6,0,1,0,0,0,,0,1,1,0,0,1,0,1,6,3.6
Al Jefferson,31-299,C-F,10/29/16,IND,CHI,0,15,3,5,0.6,3,5,0.6,0,0,,0,0,,1,2,3,2,0,0,0,2,6,5.6
Thomas Robinson,25-363,F,3/15/17,LAL,HOU,0,5,2,3,0.667,2,3,0.667,0,0,,2,2,1,0,1,1,0,0,0,1,1,6,3.6
Michael Kidd-Gilchrist,23-098,F,1/2/17,CHO,CHI,1,27,3,10,0.3,3,10,0.3,0,0,,0,0,,2,1,3,3,2,0,1,6,6,2.6
Justin Holiday,27-328,G,2/27/17,NYK,TOR,0,15,2,5,0.4,1,3,0.333,1,2,0.5,1,1,1,0,1,1,0,0,1,0,0,6,4.3
Alex Abrines,23-189,G-F,2/6/17,OKC,IND,0,8,2,4,0.5,0,0,,2,4,0.5,0,0,,1,0,1,0,0,0,1,2,6,2.9
Tarik Black,25-136,C-F,4/7/17,LAL,SAC,0,20,3,6,0.5,3,6,0.5,0,0,,0,0,,2,2,4,0,3,1,0,4,6,7.1
Sergio Rodriguez,30-283,G,3/22/17,PHI,OKC,0,26,3,5,0.6,3,4,0.75,0,1,0,0,0,,0,1,1,4,1,0,1,0,6,6.8
Ryan Anderson,28-238,F,12/30/16,HOU,LAC,1,23,2,10,0.2,1,2,0.5,1,8,0.125,1,1,1,0,3,3,0,0,0,0,2,6,-0.1
Ryan Anderson,28-277,F,2/7/17,HOU,ORL,1,28,2,7,0.286,1,5,0.2,1,2,0.5,1,1,1,3,1,4,2,1,0,0,1,6,6.3
Matthew Dellavedova,26-093,G,12/10/16,MIL,WAS,1,31,2,8,0.25,0,3,0,2,5,0.4,0,0,,1,1,2,4,0,0,1,2,6,3.2
Jerian Grant,24-110,G,1/27/17,CHI,MIA,1,14,2,5,0.4,2,3,0.667,0,2,0,2,3,0.667,1,0,1,2,0,0,3,2,6,1.2
Courtney Lee,31-101,G,1/12/17,NYK,CHI,1,31,3,8,0.375,3,4,0.75,0,4,0,0,0,,0,2,2,3,0,0,0,0,6,4.3
Darren Collison,29-097,G,11/28/16,SAC,WAS,1,32,2,6,0.333,2,5,0.4,0,1,0,2,2,1,2,1,3,3,2,1,0,2,6,8.3
David Lee,33-311,F,3/6/17,SAS,HOU,0,23,3,6,0.5,3,6,0.5,0,0,,0,0,,5,3,8,0,2,1,1,4,6,7.5
Domantas Sabonis,20-310,F,3/9/17,OKC,SAS,0,20,3,8,0.375,3,7,0.429,0,1,0,0,0,,0,2,2,2,0,1,1,5,6,1.3
Marvin Williams,30-260,F,3/6/17,CHO,IND,1,40,1,7,0.143,1,2,0.5,0,5,0,4,4,1,1,4,5,0,1,1,0,1,6,4.7
Zach Randolph,35-151,F,12/14/16,MEM,CLE,0,19,2,11,0.182,2,10,0.2,0,1,0,2,2,1,3,4,7,4,0,0,0,1,6,4.8
Jerami Grant,22-231,F,10/29/16,PHI,ATL,0,19,2,7,0.286,2,6,0.333,0,1,0,2,4,0.5,0,3,3,0,0,2,1,3,6,1.2
Marc Gasol,31-295,C,11/19/16,MEM,MIN,1,35,2,12,0.167,2,11,0.182,0,1,0,2,2,1,0,7,7,3,1,2,2,4,6,1.4
Bojan Bogdanovic,27-205,G-F,11/9/16,BRK,NYK,1,29,2,9,0.222,2,6,0.333,0,3,0,2,2,1,0,2,2,2,3,0,1,2,6,3.7
C.J. Miles,29-330,G-F,3/14/17,IND,NYK,1,25,2,9,0.222,0,1,0,2,8,0.25,0,0,,0,4,4,0,0,0,0,1,6,1.3
Dorian Finney-Smith,23-319,F,3/19/17,DAL,BRK,0,12,2,3,0.667,0,0,,2,3,0.667,0,0,,0,1,1,0,0,1,0,1,6,5.3
Jerami Grant,22-236,F,11/3/16,OKC,GSW,0,25,3,9,0.333,3,9,0.333,0,0,,0,2,0,1,3,4,0,0,0,0,2,6,0.9
Spencer Hawes,28-184,C-F,10/29/16,CHO,BOS,0,20,3,9,0.333,3,9,0.333,0,0,,0,0,,3,2,5,4,1,1,1,0,6,7.1
Brandon Rush,31-264,G-F,3/28/17,MIN,IND,1,19,2,3,0.667,0,0,,2,3,0.667,0,0,,0,0,0,0,0,2,0,1,6,5.7
Matt Barnes,37-012,F,3/21/17,GSW,DAL,0,23,2,4,0.5,0,2,0,2,2,1,0,0,,0,5,5,5,0,0,3,1,6,5.6
T.J. McConnell,24-352,G,3/12/17,PHI,LAL,1,30,1,2,0.5,1,2,0.5,0,0,,4,4,1,1,4,5,8,3,0,1,1,6,14.1
Zaza Pachulia,33-053,C,4/4/17,GSW,MIN,1,19,3,5,0.6,3,5,0.6,0,0,,0,0,,1,6,7,0,0,0,0,1,6,5.8
Cody Zeller,24-087,F-C,12/31/16,CHO,CLE,1,19,3,3,1,3,3,1,0,0,,0,0,,0,1,1,3,0,1,1,4,6,5.6
Justin Anderson,23-021,G,12/10/16,DAL,HOU,0,12,2,7,0.286,0,1,0,2,6,0.333,0,0,,0,3,3,0,0,0,2,3,6,-0.4
Julius Randle,22-042,F,1/10/17,LAL,POR,1,26,2,9,0.222,2,9,0.222,0,0,,2,4,0.5,2,8,10,3,0,0,2,5,6,1.6
Vince Carter,40-073,G-F,4/9/17,MEM,DET,1,22,2,4,0.5,0,1,0,2,3,0.667,0,0,,0,1,1,0,0,0,2,1,6,1.9
Jared Dudley,31-129,F-G,11/16/16,PHO,DEN,0,23,2,4,0.5,1,1,1,1,3,0.333,1,2,0.5,0,2,2,0,0,0,1,3,6,2
Alexis Ajinca,28-218,C,12/10/16,NOP,LAC,1,19,3,7,0.429,3,6,0.5,0,1,0,0,0,,2,4,6,0,0,0,3,0,6,1.9
Brandon Knight,25-070,G,2/10/17,PHO,CHI,0,15,3,6,0.5,3,4,0.75,0,2,0,0,0,,1,2,3,3,0,0,1,0,6,5.4
Matthew Dellavedova,26-194,G,3/21/17,MIL,POR,0,25,2,7,0.286,2,6,0.333,0,1,0,2,2,1,0,2,2,1,1,0,0,0,6,4.2
Tristan Thompson,26-009,F-C,3/22/17,CLE,DEN,1,27,3,4,0.75,3,4,0.75,0,0,,0,0,,2,2,4,2,0,1,0,0,6,8.5
Thabo Sefolosha,32-229,G-F,12/17/16,ATL,CHO,1,30,2,4,0.5,0,1,0,2,3,0.667,0,0,,0,2,2,0,1,0,2,3,6,2.4
Pascal Siakam,22-295,F,11/25/16,TOR,MIL,1,23,2,3,0.667,2,3,0.667,0,0,,2,4,0.5,3,4,7,0,0,1,2,1,6,5.5
T.J. McConnell,24-218,G,10/29/16,PHI,ATL,0,19,2,5,0.4,2,4,0.5,0,1,0,2,3,0.667,1,2,3,2,1,0,2,2,6,3.8
Andre Iguodala,33-036,G-F,3/5/17,GSW,NYK,0,31,2,5,0.4,0,0,,2,5,0.4,0,0,,1,2,3,4,2,0,1,1,6,8
Isaiah Whitehead,21-245,G,11/8/16,BRK,MIN,1,26,2,5,0.4,2,4,0.5,0,1,0,2,2,1,2,5,7,7,0,1,2,1,6,9.4
Wade Baldwin,20-259,G,12/13/16,MEM,CLE,0,4,1,1,1,1,1,1,0,0,,4,4,1,0,0,0,0,0,1,0,0,6,6.4
Jae Crowder,26-236,F,2/27/17,BOS,ATL,1,31,2,9,0.222,1,4,0.25,1,5,0.2,1,3,0.333,1,3,4,1,0,1,0,1,6,2.3
Will Barton,26-022,G,1/28/17,DEN,PHO,0,20,2,5,0.4,2,3,0.667,0,2,0,2,3,0.667,1,4,5,3,1,0,3,4,6,3.3
P.J. Tucker,31-277,F,2/6/17,PHO,NOP,0,31,3,7,0.429,3,4,0.75,0,3,0,0,0,,1,4,5,1,2,0,4,5,6,0.9
Domantas Sabonis,20-186,F,11/5/16,OKC,MIN,1,24,3,9,0.333,3,6,0.5,0,3,0,0,0,,1,4,5,5,0,1,0,3,6,5.8
Donatas Motiejunas,26-148,F-C,2/15/17,NOP,MEM,0,22,2,3,0.667,2,3,0.667,0,0,,2,4,0.5,0,1,1,2,1,0,0,4,6,5
Markieff Morris,27-186,F,3/7/17,WAS,PHO,1,25,1,5,0.2,1,5,0.2,0,0,,4,4,1,0,2,2,1,1,0,1,3,6,3
Bobby Portis,21-289,F,11/25/16,CHI,PHI,0,19,3,6,0.5,3,5,0.6,0,1,0,0,0,,2,3,5,3,0,0,0,3,6,6.2
Julius Randle,22-089,F,2/26/17,LAL,SAS,1,28,2,9,0.222,2,7,0.286,0,2,0,2,6,0.333,2,10,12,4,0,0,3,3,6,1.9
Nik Stauskas,23-150,G,3/6/17,PHI,MIL,0,27,3,6,0.5,3,4,0.75,0,2,0,0,0,,0,0,0,2,0,0,0,1,6,4
Dante Cunningham,29-240,F,12/18/16,NOP,SAS,0,17,2,5,0.4,1,2,0.5,1,3,0.333,1,2,0.5,0,1,1,1,1,0,1,1,6,3.5
DeMarre Carroll,30-189,F,2/1/17,TOR,BOS,1,38,2,8,0.25,0,2,0,2,6,0.333,0,0,,1,5,6,1,1,0,1,3,6,2.9
Andre Iguodala,32-342,G-F,1/4/17,GSW,POR,0,30,2,3,0.667,1,2,0.5,1,1,1,1,2,0.5,2,3,5,6,2,0,0,1,6,12.4
Kelly Oubre,21-114,F,4/2/17,WAS,GSW,0,29,2,11,0.182,2,5,0.4,0,6,0,2,4,0.5,1,1,2,0,0,1,0,4,6,-1.6
Nerlens Noel,22-323,C-F,2/27/17,DAL,MIA,0,25,3,3,1,3,3,1,0,0,,0,0,,2,4,6,1,1,1,0,3,6,8.9
Shaun Livingston,31-110,G,12/30/16,GSW,DAL,0,18,3,5,0.6,3,5,0.6,0,0,,0,0,,0,2,2,0,0,2,0,1,6,5.3
Evan Turner,28-075,G,1/10/17,POR,LAL,0,26,3,9,0.333,3,7,0.429,0,2,0,0,0,,0,3,3,7,0,0,0,1,6,6.3
Patty Mills,28-171,G,1/29/17,SAS,DAL,0,21,3,10,0.3,3,6,0.5,0,4,0,0,0,,1,7,8,2,0,0,1,0,6,3.4
Eric Gordon,28-026,G,1/20/17,HOU,GSW,0,33,2,14,0.143,2,7,0.286,0,7,0,2,2,1,1,3,4,2,2,0,1,1,6,0.6
Quincy Acy,26-034,F,11/9/16,DAL,GSW,0,24,2,6,0.333,2,4,0.5,0,2,0,2,2,1,1,2,3,0,0,0,1,5,6,0.9
E'Twaun Moore,28-033,G,4/2/17,NOP,CHI,0,22,1,6,0.167,1,4,0.25,0,2,0,4,4,1,1,1,2,3,1,1,0,0,6,7
Ish Smith,28-257,G,3/19/17,DET,PHO,0,23,2,9,0.222,1,8,0.125,1,1,1,1,2,0.5,0,3,3,6,0,1,1,0,6,4.9
Andre Drummond,23-084,C,11/2/16,DET,BRK,1,25,3,9,0.333,3,9,0.333,0,0,,0,0,,0,6,6,4,0,2,2,2,6,4.1
Kosta Koufos,27-277,C,11/27/16,SAC,BRK,1,26,3,5,0.6,3,5,0.6,0,0,,0,0,,1,1,2,0,0,0,2,3,6,1.5
Marco Belinelli,30-360,G-F,3/20/17,CHO,ATL,0,21,1,5,0.2,0,1,0,1,4,0.25,3,4,0.75,1,2,3,2,1,0,1,1,6,4.8
Zaza Pachulia,33-061,C,4/12/17,GSW,LAL,1,12,2,3,0.667,2,2,1,0,1,0,2,2,1,3,3,6,2,0,1,0,0,6,9.8
Dewayne Dedmon,27-128,C,12/18/16,SAS,NOP,0,17,3,7,0.429,3,7,0.429,0,0,,0,0,,0,2,2,2,0,1,1,2,6,3.2
Jordan McRae,25-317,G,2/8/17,CLE,IND,0,14,2,5,0.4,0,1,0,2,4,0.5,0,0,,0,0,0,2,0,1,0,0,6,5.4
Marco Belinelli,30-248,G-F,11/28/16,CHO,MEM,0,21,2,9,0.222,2,6,0.333,0,3,0,2,2,1,0,3,3,2,0,0,0,1,6,2.4
Justin Holiday,27-358,G,3/29/17,NYK,MIA,0,23,3,3,1,3,3,1,0,0,,0,0,,0,3,3,3,0,0,2,0,6,6.1
Nik Stauskas,23-156,G,3/12/17,PHI,LAL,0,23,3,6,0.5,3,4,0.75,0,2,0,0,0,,0,0,0,3,0,0,2,0,6,3.1
Steven Adams,23-152,C,12/19/16,OKC,ATL,1,31,2,4,0.5,2,4,0.5,0,0,,2,5,0.4,4,5,9,0,3,1,1,2,6,9
Willie Reed,26-252,F-C,1/23/17,MIA,GSW,0,11,3,5,0.6,3,5,0.6,0,0,,0,0,,1,6,7,1,0,1,0,2,6,6.8
Timothe Luwawu-Cabarrot,21-294,F,2/27/17,PHI,GSW,0,17,1,3,0.333,1,2,0.5,0,1,0,4,4,1,1,1,2,0,0,0,3,2,6,1.5
Semaj Christon,24-001,G,11/2/16,OKC,LAC,0,15,3,7,0.429,3,7,0.429,0,0,,0,0,,1,1,2,0,0,0,2,3,6,0.1
Jonathon Simmons,27-122,G-F,1/14/17,SAS,PHO,0,16,2,4,0.5,1,3,0.333,1,1,1,1,2,0.5,0,3,3,1,3,0,4,5,6,2.2
Justin Hamilton,26-294,C,1/20/17,BRK,NOP,1,24,3,6,0.5,3,4,0.75,0,2,0,0,0,,1,4,5,0,0,0,0,0,6,4.9
Ben McLemore,24-018,G,3/1/17,SAC,BRK,1,14,2,7,0.286,2,7,0.286,0,0,,2,2,1,0,1,1,0,0,0,0,2,6,1.4
Vince Carter,39-323,G-F,12/14/16,MEM,CLE,0,19,2,4,0.5,0,1,0,2,3,0.667,0,0,,1,4,5,2,0,0,0,2,6,6.5
Willy Hernangomez,22-239,C,1/21/17,NYK,PHO,0,14,2,4,0.5,2,4,0.5,0,0,,2,2,1,0,8,8,1,0,0,1,2,6,5.3
DeAndre Jordan,28-098,C,10/27/16,LAC,POR,1,28,2,7,0.286,2,7,0.286,0,0,,2,10,0.2,7,5,12,0,0,1,1,5,6,2.8
Kelly Olynyk,25-228,C-F,12/3/16,BOS,PHI,0,11,2,2,1,1,1,1,1,1,1,1,2,0.5,0,0,0,1,0,0,3,4,6,1.1
Robin Lopez,28-222,C,11/9/16,CHI,ATL,1,30,3,4,0.75,3,4,0.75,0,0,,0,0,,1,4,5,1,0,0,0,3,6,5.8
David West,36-199,F,3/16/17,GSW,ORL,0,12,3,4,0.75,3,4,0.75,0,0,,0,0,,0,4,4,0,2,1,2,2,6,5.5
Derrick Favors,25-209,F-C,2/9/17,UTA,DAL,1,33,2,9,0.222,2,9,0.222,0,0,,2,3,0.667,5,5,10,2,2,0,0,4,6,6.9
Jason Terry,39-092,G,12/16/16,MIL,CHI,0,19,2,5,0.4,0,1,0,2,4,0.5,0,0,,0,1,1,3,0,0,0,1,6,5.3
Draymond Green,27-027,F,3/31/17,GSW,HOU,1,35,2,11,0.182,2,8,0.25,0,3,0,2,2,1,1,5,6,8,1,3,3,1,6,6.6
Marco Belinelli,30-301,G-F,1/20/17,CHO,TOR,0,22,2,7,0.286,2,3,0.667,0,4,0,2,2,1,0,1,1,1,2,1,1,1,6,4.2
Marcin Gortat,33-018,C-F,3/7/17,WAS,PHO,1,19,3,8,0.375,3,8,0.375,0,0,,0,0,,0,3,3,1,0,1,0,4,6,2.3
Jeremy Lamb,24-269,G-F,2/23/17,CHO,DET,0,17,3,8,0.375,3,5,0.6,0,3,0,0,0,,0,4,4,1,0,1,0,5,6,2.2
Denzel Valentine,23-112,G,3/8/17,CHI,ORL,0,23,2,8,0.25,0,0,,2,8,0.25,0,0,,0,5,5,0,1,0,2,2,6,0.9
Adreian Payne,26-041,F-C,4/1/17,MIN,SAC,0,7,2,4,0.5,2,3,0.667,0,1,0,2,4,0.5,1,2,3,0,0,2,0,2,6,5.1
Rajon Rondo,30-261,G,11/9/16,CHI,ATL,1,34,2,10,0.2,1,6,0.167,1,4,0.25,1,2,0.5,1,4,5,7,1,0,2,4,6,3.6
Jamal Crawford,36-273,G,12/18/16,LAC,WAS,0,29,2,6,0.333,1,3,0.333,1,3,0.333,1,1,1,0,2,2,3,0,0,4,1,6,0.9
Nerlens Noel,22-279,C-F,1/14/17,PHI,WAS,0,13,3,7,0.429,3,7,0.429,0,0,,0,0,,5,7,12,0,0,0,3,5,6,2.9
Tarik Black,24-356,C-F,11/12/16,LAL,NOP,0,18,3,5,0.6,3,5,0.6,0,0,,0,0,,2,3,5,2,0,1,0,0,6,8.1
Alex Len,23-272,C,3/15/17,PHO,SAC,1,17,3,4,0.75,3,4,0.75,0,0,,0,0,,2,6,8,0,2,0,2,4,6,6
Tarik Black,25-042,C-F,1/3/17,LAL,MEM,0,10,1,4,0.25,1,4,0.25,0,0,,4,6,0.667,1,2,3,0,1,0,0,3,6,3.9
Glenn Robinson,22-332,G-F,12/5/16,IND,GSW,0,16,2,7,0.286,2,6,0.333,0,1,0,2,2,1,0,0,0,2,0,1,1,1,6,2.6
Al Jefferson,31-365,C-F,1/3/17,IND,DET,0,12,2,7,0.286,2,7,0.286,0,0,,2,2,1,0,2,2,3,0,0,0,0,6,4.6
Al-Farouq Aminu,26-041,F,11/1/16,POR,GSW,1,30,3,11,0.273,3,5,0.6,0,6,0,0,2,0,1,9,10,3,3,1,3,1,6,4.5
Dante Cunningham,29-211,F,11/19/16,NOP,CHO,1,43,2,8,0.25,0,5,0,2,3,0.667,0,0,,4,4,8,1,1,0,0,5,6,4.9
Jonathon Simmons,27-192,G-F,3/25/17,SAS,NYK,1,24,2,7,0.286,2,4,0.5,0,3,0,2,2,1,0,2,2,1,1,0,3,5,6,-0.8
Kosta Koufos,27-298,C,12/18/16,SAC,DAL,1,23,3,3,1,3,3,1,0,0,,0,0,,2,7,9,0,2,0,3,4,6,6
Anthony Tolliver,31-147,F-C,10/26/16,SAC,PHO,0,15,3,6,0.5,3,3,1,0,3,0,0,0,,2,3,5,2,0,0,0,1,6,6.3
Iman Shumpert,26-199,G,1/11/17,CLE,POR,0,26,3,5,0.6,3,4,0.75,0,1,0,0,2,0,0,2,2,2,0,0,0,2,6,4.1
Tiago Splitter,32-093,F-C,4/4/17,PHI,BRK,0,8,1,3,0.333,1,2,0.5,0,1,0,4,4,1,1,0,1,1,0,0,0,1,6,5.3
Jarell Martin,22-186,F,11/26/16,MEM,MIA,0,17,3,5,0.6,3,5,0.6,0,0,,0,0,,0,3,3,0,2,0,3,3,6,2.4
Al Jefferson,31-343,C-F,12/12/16,IND,CHO,0,12,3,7,0.429,3,7,0.429,0,0,,0,0,,1,2,3,1,0,0,0,1,6,3.9
Ed Davis,27-199,F,12/21/16,POR,DAL,0,19,1,1,1,1,1,1,0,0,,4,6,0.667,5,5,10,0,0,0,2,3,6,6.7
Tony Snell,25-092,G-F,2/10/17,MIL,LAL,1,23,2,4,0.5,1,2,0.5,1,2,0.5,1,1,1,0,3,3,1,1,0,0,2,6,5.8
Alex Abrines,23-240,G-F,3/29/17,OKC,ORL,0,22,2,8,0.25,0,2,0,2,6,0.333,0,0,,1,0,1,1,2,0,0,2,6,3.8
Alec Burks,25-196,G,2/1/17,UTA,MIL,0,25,2,7,0.286,1,3,0.333,1,4,0.25,1,2,0.5,0,4,4,0,2,0,2,0,6,2.7
Bismack Biyombo,24-192,C-F,3/8/17,ORL,CHI,1,35,3,11,0.273,3,11,0.273,0,0,,0,0,,2,4,6,0,0,1,2,4,6,-0.8
Spencer Hawes,28-263,C-F,1/16/17,CHO,BOS,0,17,3,5,0.6,3,4,0.75,0,1,0,0,0,,0,3,3,1,1,0,1,2,6,4.5
Jason Smith,30-275,F-C,12/2/16,WAS,SAS,0,14,3,6,0.5,3,6,0.5,0,0,,0,0,,1,2,3,0,0,0,1,5,6,1.3
Patty Mills,28-139,G,12/28/16,SAS,PHO,0,16,2,5,0.4,2,3,0.667,0,2,0,2,2,1,1,2,3,2,0,0,4,2,6,1.2
Tyler Ennis,22-193,G,3/5/17,LAL,NOP,0,7,2,3,0.667,0,1,0,2,2,1,0,0,,0,2,2,1,1,0,0,0,6,7
Rodney Hood,24-144,G-F,3/13/17,UTA,LAC,1,20,2,7,0.286,2,7,0.286,0,0,,2,2,1,0,0,0,1,0,0,0,4,6,1
Isaiah Canaan,25-206,G,12/13/16,CHI,MIN,0,27,3,9,0.333,3,6,0.5,0,3,0,0,0,,0,3,3,3,1,0,1,1,6,3.5
Taj Gibson,31-210,F,1/20/17,CHI,ATL,1,18,3,5,0.6,3,4,0.75,0,1,0,0,0,,3,0,3,0,0,0,1,1,6,4.4
Luc Mbah a Moute,30-110,F,12/28/16,LAC,NOP,1,32,2,6,0.333,0,2,0,2,4,0.5,0,0,,1,3,4,0,1,0,1,2,6,3.4
Derrick Williams,25-174,F,11/15/16,MIA,ATL,1,18,3,8,0.375,3,6,0.5,0,2,0,0,0,,0,1,1,1,1,0,0,3,6,2.4
Solomon Hill,25-290,F,1/2/17,NOP,CLE,1,27,2,8,0.25,0,1,0,2,7,0.286,0,0,,0,2,2,0,0,1,0,3,6,1.3
Robert Covington,25-324,F,11/2/16,PHI,CHO,1,26,2,9,0.222,0,1,0,2,8,0.25,0,0,,1,2,3,0,2,0,2,4,6,0.2
Otto Porter,23-235,F,1/24/17,WAS,BOS,1,31,2,4,0.5,0,2,0,2,2,1,0,0,,0,4,4,0,0,0,0,1,6,4.8
Ty Lawson,29-097,G,2/8/17,SAC,BOS,1,14,3,6,0.5,3,6,0.5,0,0,,0,0,,0,2,2,4,1,0,1,0,6,6.4
Patty Mills,28-077,G,10/27/16,SAS,SAC,0,23,2,7,0.286,0,3,0,2,4,0.5,0,0,,0,1,1,1,0,0,0,1,6,2.5
Terrence Jones,24-334,F,12/8/16,NOP,PHI,0,19,2,4,0.5,2,2,1,0,2,0,2,4,0.5,0,3,3,0,0,0,1,1,6,2.7
Danny Green,29-254,G-F,3/3/17,SAS,NOP,1,36,3,10,0.3,3,7,0.429,0,3,0,0,0,,0,7,7,3,0,0,0,2,6,3.6
Rondae Hollis-Jefferson,22-093,F,4/6/17,BRK,ORL,1,25,3,8,0.375,3,8,0.375,0,0,,0,0,,1,4,5,4,1,0,1,0,6,6.3
Dwight Powell,25-181,F-C,1/17/17,DAL,CHI,0,12,3,4,0.75,3,3,1,0,1,0,0,0,,0,1,1,1,0,0,0,0,6,5.4
Omri Casspi,28-286,F,4/4/17,MIN,GSW,0,14,3,3,1,3,3,1,0,0,,0,0,,1,2,3,1,0,0,1,1,6,5.7
Juan Hernangomez,21-133,F,2/8/17,DEN,ATL,0,14,2,4,0.5,1,1,1,1,3,0.333,1,2,0.5,1,5,6,0,0,0,1,1,6,4.4
Jameer Nelson,34-263,G,10/29/16,DEN,POR,0,15,2,5,0.4,0,1,0,2,4,0.5,0,0,,0,0,0,2,0,0,1,3,6,2.5
Paul Millsap,31-276,F,11/12/16,ATL,PHI,1,27,3,10,0.3,3,8,0.375,0,2,0,0,0,,0,4,4,3,0,0,2,1,6,1.1
Nene Hilario,34-196,F-C,3/28/17,HOU,GSW,0,18,1,6,0.167,1,6,0.167,0,0,,4,6,0.667,3,0,3,2,0,0,1,1,6,3.5
Boris Diaw,34-282,F-C,1/23/17,UTA,OKC,0,16,3,3,1,3,3,1,0,0,,0,0,,0,2,2,5,1,0,1,1,6,8.8
Taj Gibson,31-192,F,1/2/17,CHI,CHO,1,27,3,8,0.375,3,8,0.375,0,0,,0,0,,5,3,8,0,0,2,2,3,6,4.2
Derrick Jones,20-016,F,3/3/17,PHO,OKC,0,15,3,3,1,3,3,1,0,0,,0,0,,1,0,1,1,0,0,0,4,6,4.9
Andre Roberson,25-061,G-F,2/3/17,OKC,MEM,1,20,3,5,0.6,3,3,1,0,2,0,0,0,,1,3,4,0,1,1,0,1,6,6.6
Greg Monroe,26-189,C-F,12/10/16,MIL,WAS,0,23,2,5,0.4,2,5,0.4,0,0,,2,2,1,0,6,6,5,0,0,2,3,6,5.4
James Johnson,29-313,F,12/29/16,MIA,CHO,0,18,2,7,0.286,2,6,0.333,0,1,0,2,7,0.286,1,3,4,2,1,1,3,3,6,0.4
Thabo Sefolosha,32-204,G-F,11/22/16,ATL,NOP,0,23,3,7,0.429,3,6,0.5,0,1,0,0,0,,0,3,3,1,1,0,1,0,6,3.9
Brandon Jennings,27-050,G,11/12/16,NYK,TOR,0,16,2,6,0.333,2,6,0.333,0,0,,2,2,1,1,1,2,5,1,0,0,2,6,7.3
Jeff Withey,26-269,C,12/1/16,UTA,MIA,0,13,2,2,1,2,2,1,0,0,,2,3,0.667,0,2,2,0,0,3,0,0,6,7.7
Timothe Luwawu-Cabarrot,21-200,F,11/25/16,PHI,CHI,0,10,1,4,0.25,1,2,0.5,0,2,0,4,4,1,0,3,3,1,0,0,0,1,6,4.8
Matthew Dellavedova,26-204,G,3/31/17,MIL,DET,1,35,2,8,0.25,0,3,0,2,5,0.4,0,0,,0,3,3,7,0,0,1,3,6,4.8
Brandon Rush,31-255,G-F,3/19/17,MIN,NOP,1,39,2,5,0.4,0,1,0,2,4,0.5,0,0,,0,3,3,3,1,0,0,1,6,6.9
Raymond Felton,32-283,G,4/5/17,LAC,DAL,0,16,3,6,0.5,3,3,1,0,3,0,0,0,,0,0,0,1,1,0,1,1,6,3.3
Beno Udrih,34-136,G,11/18/16,DET,CLE,0,17,2,7,0.286,2,6,0.333,0,1,0,2,2,1,0,2,2,3,0,0,0,2,6,3.8
Domantas Sabonis,20-183,F,11/2/16,OKC,LAC,1,17,2,3,0.667,0,0,,2,3,0.667,0,0,,0,2,2,1,1,0,0,5,6,5
Jonathon Simmons,27-082,G-F,12/5/16,SAS,MIL,0,24,3,5,0.6,3,5,0.6,0,0,,0,0,,0,4,4,2,1,0,1,3,6,5.1
Victor Oladipo,24-285,G,2/13/17,OKC,WAS,1,18,2,6,0.333,2,3,0.667,0,3,0,2,2,1,1,0,1,0,0,0,2,4,6,-0.3
Andre Drummond,23-226,C,3/24/17,DET,ORL,1,20,3,8,0.375,3,8,0.375,0,0,,0,2,0,4,10,14,2,0,1,1,2,6,6.9
Ish Smith,28-189,G,1/10/17,DET,SAC,0,17,2,5,0.4,2,4,0.5,0,1,0,2,2,1,0,1,1,0,2,0,1,0,6,4.6
Thomas Robinson,25-257,F,11/29/16,LAL,NOP,0,10,1,2,0.5,1,2,0.5,0,0,,4,4,1,1,1,2,0,0,0,0,1,6,5.6
Marquese Chriss,19-170,F,12/19/16,PHO,MIN,1,17,2,6,0.333,1,4,0.25,1,2,0.5,1,2,0.5,3,1,4,2,1,0,2,2,6,4.2
Chandler Parsons,28-085,F,1/18/17,MEM,WAS,1,19,1,6,0.167,0,3,0,1,3,0.333,3,4,0.75,1,1,2,1,0,0,1,2,6,1.7
Josh McRoberts,29-285,F,12/9/16,MIA,CLE,1,19,3,13,0.231,3,11,0.273,0,2,0,0,0,,3,1,4,4,0,0,1,2,6,1.5
Jared Dudley,31-115,F-G,11/2/16,PHO,POR,1,21,2,5,0.4,0,2,0,2,3,0.667,0,0,,0,5,5,2,2,0,3,2,6,4.4
Cory Joseph,25-081,G,11/9/16,TOR,OKC,0,19,2,4,0.5,1,3,0.333,1,1,1,1,2,0.5,0,0,0,2,2,0,0,2,6,6.2
Alex Len,23-167,C,11/30/16,PHO,ATL,0,23,3,4,0.75,3,4,0.75,0,0,,0,0,,5,5,10,0,1,2,2,3,6,8.6
Jonas Jerebko,29-287,F,12/14/16,BOS,SAS,0,15,2,6,0.333,2,3,0.667,0,3,0,2,2,1,0,0,0,1,1,0,0,0,6,4.3
Montrezl Harrell,22-302,F-C,11/23/16,HOU,TOR,0,12,3,3,1,3,3,1,0,0,,0,0,,0,3,3,0,0,0,2,3,6,2.8
Malcolm Brogdon,24-015,G,12/26/16,MIL,WAS,0,23,3,3,1,3,3,1,0,0,,0,0,,0,1,1,1,1,0,1,0,6,6.1
Maurice Harkless,23-316,F-G,3/23/17,POR,NYK,1,18,2,3,0.667,2,3,0.667,0,0,,2,2,1,0,2,2,2,0,0,3,4,6,2.1
Henry Ellenson,19-339,F,12/17/16,DET,IND,0,5,2,2,1,0,0,,2,2,1,0,0,,0,0,0,0,0,0,0,0,6,5.4
Chris Andersen,38-114,F-C,10/29/16,CLE,ORL,0,9,2,2,1,2,2,1,0,0,,2,4,0.5,1,1,2,1,1,0,0,2,6,6.5
Doug McDermott,25-059,F,3/3/17,OKC,PHO,0,35,2,8,0.25,2,4,0.5,0,4,0,2,2,1,0,1,1,1,0,0,1,1,6,0.8
Timothe Luwawu-Cabarrot,21-299,F,3/4/17,PHI,DET,0,21,3,9,0.333,3,6,0.5,0,3,0,0,0,,1,2,3,0,0,0,0,5,6,0.2
Steven Adams,23-245,C,3/22/17,OKC,PHI,1,25,3,7,0.429,3,7,0.429,0,0,,0,5,0,5,0,5,0,1,1,1,1,6,4.1
Andrew Nicholson,27-106,F,3/24/17,BRK,WAS,0,15,3,5,0.6,3,5,0.6,0,0,,0,0,,0,3,3,0,0,0,0,1,6,4.2
Andrew Harrison,22-036,G,12/3/16,MEM,LAL,1,30,2,7,0.286,1,2,0.5,1,5,0.2,1,2,0.5,1,3,4,4,1,1,3,2,6,3.8
Cory Joseph,25-160,G,1/27/17,TOR,MIL,0,29,3,6,0.5,3,6,0.5,0,0,,0,0,,0,2,2,5,2,0,2,2,6,6.3
Patty Mills,28-154,G,1/12/17,SAS,LAL,0,17,2,5,0.4,1,2,0.5,1,3,0.333,1,2,0.5,0,1,1,2,0,0,1,3,6,2.4
Kelly Oubre,21-003,F,12/12/16,WAS,MIA,0,24,2,5,0.4,2,3,0.667,0,2,0,2,2,1,1,4,5,0,1,0,1,2,6,4.4
Jeff Green,30-133,F,1/8/17,ORL,LAL,0,24,2,5,0.4,2,4,0.5,0,1,0,2,2,1,0,1,1,0,0,0,2,2,6,0.8
Enes Kanter,24-311,C,3/27/17,OKC,DAL,0,17,2,6,0.333,2,6,0.333,0,0,,2,4,0.5,2,0,2,0,0,0,3,4,6,-1.4
Reggie Jackson,26-340,G,3/22/17,DET,CHI,0,20,3,10,0.3,3,9,0.333,0,1,0,0,0,,0,1,1,4,0,0,3,0,6,0.3
Al Jefferson,32-065,C-F,3/10/17,IND,MIL,0,13,2,7,0.286,2,7,0.286,0,0,,2,2,1,0,1,1,0,1,0,0,3,6,2
E'Twaun Moore,27-361,G,2/23/17,NOP,HOU,1,23,2,6,0.333,2,5,0.4,0,1,0,2,2,1,0,3,3,3,1,0,0,2,6,5.8
Marcin Gortat,32-293,C-F,12/6/16,WAS,ORL,1,38,3,11,0.273,3,11,0.273,0,0,,0,1,0,2,9,11,1,1,1,0,5,6,3.6
Wilson Chandler,29-263,F,1/28/17,DEN,PHO,0,23,2,10,0.2,2,8,0.25,0,2,0,2,2,1,1,2,3,0,1,0,1,1,6,0.7
Skal Labissiere,21-014,F,4/1/17,SAC,MIN,1,20,3,6,0.5,3,6,0.5,0,0,,0,0,,1,5,6,0,0,0,2,2,6,2.4
Thon Maker,19-344,F-C,2/3/17,MIL,DEN,0,4,2,2,1,0,0,,2,2,1,0,0,,0,0,0,0,0,1,1,3,6,3.9
Wesley Matthews,30-042,G,11/25/16,DAL,CLE,1,29,2,8,0.25,0,1,0,2,7,0.286,0,0,,0,2,2,3,1,0,4,0,6,0.9
Luol Deng,31-218,F,11/20/16,LAL,CHI,1,23,2,5,0.4,0,1,0,2,4,0.5,0,0,,0,4,4,1,1,0,0,3,6,5
Zaza Pachulia,32-285,C,11/21/16,GSW,IND,1,14,2,4,0.5,2,4,0.5,0,0,,2,2,1,2,5,7,1,0,0,0,1,6,7.2
Omri Casspi,28-165,F,12/4/16,SAC,NYK,0,20,2,4,0.5,2,3,0.667,0,1,0,2,2,1,0,3,3,1,1,0,0,1,6,6.2
Willy Hernangomez,22-187,C,11/30/16,NYK,MIN,0,8,2,2,1,2,2,1,0,0,,2,2,1,1,1,2,1,0,0,1,2,6,5.3
T.J. Warren,23-147,F,1/30/17,PHO,MEM,1,21,1,4,0.25,1,4,0.25,0,0,,4,4,1,2,3,5,2,1,1,0,2,6,8.2
Jason Terry,39-099,G,12/23/16,MIL,WAS,0,18,2,2,1,0,0,,2,2,1,0,0,,0,1,1,1,0,0,0,0,6,6.4
Goran Dragic,30-188,G,11/10/16,MIA,CHI,1,22,3,9,0.333,3,7,0.429,0,2,0,0,0,,0,0,0,4,2,0,4,1,6,1.3
Johnny O'Bryant,23-255,F-C,2/11/17,DEN,CLE,0,11,3,5,0.6,3,5,0.6,0,0,,0,0,,1,1,2,0,0,0,0,1,6,4.3
Hollis Thompson,25-234,G-F,11/23/16,PHI,MEM,1,27,3,10,0.3,3,7,0.429,0,3,0,0,0,,0,3,3,1,2,1,0,3,6,3.3
Tyson Chandler,34-054,C,11/25/16,PHO,MIN,0,11,3,3,1,3,3,1,0,0,,0,0,,3,4,7,0,0,0,1,4,6,5.8
Michael Kidd-Gilchrist,23-077,F,12/12/16,CHO,IND,1,20,1,9,0.111,1,8,0.125,0,1,0,4,4,1,5,5,10,1,2,1,1,0,6,7.5
Aaron Gordon,21-181,F,3/16/17,ORL,GSW,1,21,2,7,0.286,2,5,0.4,0,2,0,2,4,0.5,2,1,3,1,0,0,1,0,6,2.5
Justin Hamilton,26-211,C,10/29/16,BRK,MIL,1,30,2,6,0.333,0,2,0,2,4,0.5,0,0,,1,2,3,1,3,2,1,3,6,6.8
Kevin Seraphin,27-098,F,3/15/17,IND,CHO,0,11,3,4,0.75,3,4,0.75,0,0,,0,0,,0,1,1,1,0,1,1,0,6,5.1
Boban Marjanovic,28-151,C,1/13/17,DET,UTA,0,15,3,5,0.6,3,5,0.6,0,0,,0,0,,1,3,4,0,0,0,0,1,6,4.9
Kyle O'Quinn,26-274,F-C,12/25/16,NYK,BOS,0,13,3,4,0.75,3,4,0.75,0,0,,0,0,,1,3,4,0,0,0,4,3,6,0.8
Joe Ingles,29-154,F-G,3/5/17,UTA,SAC,0,28,2,7,0.286,0,0,,2,7,0.286,0,0,,1,0,1,1,2,0,2,4,6,1.7
Trevor Ariza,31-142,F,11/19/16,HOU,UTA,1,31,2,6,0.333,1,2,0.5,1,4,0.25,1,2,0.5,1,3,4,0,1,0,0,1,6,4.4
Thomas Robinson,25-294,F,1/5/17,LAL,POR,0,15,3,5,0.6,3,5,0.6,0,0,,0,0,,3,2,5,2,2,0,0,2,6,9
Aron Baynes,30-037,C,1/15/17,DET,LAL,0,16,3,4,0.75,3,4,0.75,0,0,,0,0,,1,3,4,0,0,1,0,4,6,5.1
Trevor Booker,29-123,F,3/28/17,BRK,PHI,0,23,2,5,0.4,2,5,0.4,0,0,,2,2,1,2,5,7,0,0,0,2,3,6,3
Rodney Stuckey,30-327,G,3/14/17,IND,NYK,0,16,1,6,0.167,0,3,0,1,3,0.333,3,6,0.5,0,1,1,3,0,0,1,1,6,2
Mirza Teletovic,31-136,F,2/1/17,MIL,UTA,0,8,3,4,0.75,3,3,1,0,1,0,0,1,0,0,2,2,0,0,0,1,2,6,2.8
C.J. Miles,29-344,G-F,3/28/17,IND,MIN,0,20,2,6,0.333,2,4,0.5,0,2,0,2,3,0.667,0,1,1,1,1,0,2,2,6,1.4
Austin Rivers,24-222,G,3/11/17,LAC,PHI,0,19,2,8,0.25,2,5,0.4,0,3,0,2,4,0.5,0,2,2,3,2,0,3,2,6,1.3
Tony Allen,35-007,G-F,1/18/17,MEM,WAS,1,30,2,7,0.286,2,7,0.286,0,0,,2,4,0.5,5,2,7,1,2,0,2,6,6,3.5
Marvin Williams,30-138,F,11/4/16,CHO,BRK,1,30,2,13,0.154,0,5,0,2,8,0.25,0,0,,2,2,4,4,0,0,0,0,6,2.5
Isaiah Whitehead,21-313,G,1/15/17,BRK,HOU,0,15,2,6,0.333,1,3,0.333,1,3,0.333,1,2,0.5,0,3,3,4,0,0,1,2,6,4.1
Shaun Livingston,31-198,G,3/28/17,GSW,HOU,0,17,2,2,1,2,2,1,0,0,,2,2,1,1,5,6,4,1,1,2,5,6,8.1
Stanley Johnson,20-164,F,11/9/16,DET,PHO,0,6,2,3,0.667,2,3,0.667,0,0,,2,2,1,0,0,0,0,0,0,1,0,6,3.7
Ivica Zubac,19-229,C,11/2/16,LAL,ATL,1,19,3,4,0.75,3,4,0.75,0,0,,0,0,,2,2,4,0,1,0,0,4,6,5.8
Alex Abrines,23-253,G-F,4/11/17,OKC,MIN,0,15,2,3,0.667,0,1,0,2,2,1,0,0,,0,0,0,0,1,1,1,0,6,5.4
Marreese Speights,29-168,C-F,1/19/17,LAC,MIN,0,18,2,9,0.222,1,4,0.25,1,5,0.2,1,2,0.5,1,3,4,2,1,2,2,1,6,3.1
Bobby Portis,21-284,F,11/20/16,CHI,LAL,0,11,3,5,0.6,3,4,0.75,0,1,0,0,0,,1,1,2,0,0,0,0,2,6,3.9
Andre Iguodala,32-356,G-F,1/18/17,GSW,OKC,0,25,3,4,0.75,3,4,0.75,0,0,,0,0,,1,1,2,5,4,0,2,1,6,10.5
Jonas Jerebko,29-303,F,12/30/16,BOS,MIA,0,23,2,4,0.5,0,1,0,2,3,0.667,0,1,0,1,2,3,5,0,1,1,1,6,7.7
Treveon Graham,23-030,G,11/28/16,CHO,MEM,0,4,2,2,1,0,0,,2,2,1,0,0,,0,0,0,0,0,0,1,1,6,4
Raul Neto,24-215,G,12/20/16,UTA,GSW,0,13,3,7,0.429,3,4,0.75,0,3,0,0,0,,0,1,1,2,2,0,0,1,6,5.6
Troy Daniels,25-131,G,11/23/16,MEM,PHI,1,23,2,7,0.286,0,2,0,2,5,0.4,0,0,,0,4,4,1,1,0,0,0,6,4.8
Salah Mejri,30-296,C,4/7/17,DAL,SAS,0,8,3,6,0.5,3,6,0.5,0,0,,0,0,,0,1,1,0,0,0,0,1,6,2.9
Markieff Morris,27-061,F,11/2/16,WAS,TOR,1,36,2,7,0.286,1,5,0.2,1,2,0.5,1,2,0.5,0,3,3,2,1,0,2,3,6,1.6
Joe Young,24-123,G,10/28/16,IND,BRK,0,13,2,6,0.333,1,5,0.2,1,1,1,1,2,0.5,0,2,2,1,0,0,0,2,6,2.7
Cory Joseph,25-128,G,12/26/16,TOR,POR,0,23,2,11,0.182,2,10,0.2,0,1,0,2,2,1,0,2,2,1,1,0,0,1,6,1
Rodney McGruder,25-211,G,2/25/17,MIA,IND,1,18,2,4,0.5,0,1,0,2,3,0.667,0,0,,0,1,1,0,0,1,0,2,6,4.2
Larry Nance Jr.,23-345,F,12/11/16,LAL,NYK,0,20,3,5,0.6,3,5,0.6,0,0,,0,0,,2,0,2,3,1,0,1,2,6,6.4
Jeremy Lamb,24-187,G-F,12/3/16,CHO,MIN,0,12,2,5,0.4,0,2,0,2,3,0.667,0,0,,0,5,5,0,0,0,2,0,6,2.8
Robin Lopez,28-278,C,1/4/17,CHI,CLE,1,23,3,5,0.6,3,5,0.6,0,0,,0,0,,3,2,5,1,0,1,2,3,6,4.6
Gerald Green,30-297,G-F,11/18/16,BOS,GSW,0,17,2,11,0.182,0,6,0,2,5,0.4,0,0,,0,6,6,0,0,0,0,1,6,0.5
Shaun Livingston,31-119,G,1/8/17,GSW,SAC,0,19,3,4,0.75,3,4,0.75,0,0,,0,0,,0,2,2,0,1,0,1,0,6,5
D.J. Augustin,29-132,G,3/22/17,ORL,CHO,0,15,2,5,0.4,1,2,0.5,1,3,0.333,1,1,1,0,1,1,2,0,0,1,1,6,3.6
Evan Turner,28-163,G,4/8/17,POR,UTA,0,24,3,7,0.429,3,5,0.6,0,2,0,0,0,,1,5,6,2,1,1,1,3,6,5.4
E'Twaun Moore,27-289,G,12/13/16,NOP,GSW,0,25,2,6,0.333,2,3,0.667,0,3,0,2,2,1,1,1,2,5,0,0,1,2,6,5.3
Michael Kidd-Gilchrist,23-050,F,11/15/16,CHO,MIN,1,33,2,5,0.4,2,5,0.4,0,0,,2,4,0.5,0,6,6,0,0,1,2,1,6,2.6
Tony Snell,24-354,G-F,10/29/16,MIL,BRK,1,21,3,7,0.429,3,4,0.75,0,3,0,0,0,,1,1,2,0,0,0,1,4,6,0.7
Robin Lopez,28-258,C,12/15/16,CHI,MIL,1,25,3,6,0.5,3,6,0.5,0,0,,0,0,,1,5,6,2,0,1,0,2,6,6.5
P.J. Tucker,31-279,F,2/8/17,PHO,MEM,0,30,2,9,0.222,2,7,0.286,0,2,0,2,2,1,7,3,10,0,2,0,1,1,6,6.9
Meyers Leonard,25-012,C-F,3/11/17,POR,WAS,0,25,3,4,0.75,3,4,0.75,0,0,,0,0,,0,6,6,3,2,0,1,2,6,8.5
Jerian Grant,24-071,G,12/19/16,CHI,DET,0,15,3,5,0.6,3,5,0.6,0,0,,0,0,,0,0,0,1,0,1,2,2,6,2.3
Jonathon Simmons,27-099,G-F,12/22/16,SAS,LAC,0,22,2,10,0.2,1,8,0.125,1,2,0.5,1,2,0.5,1,3,4,1,0,1,3,5,6,-2.6
Elfrid Payton,22-257,G,11/5/16,ORL,WAS,1,29,2,8,0.25,1,5,0.2,1,3,0.333,1,2,0.5,1,0,1,3,0,0,2,2,6,0.8
Kelly Oubre,21-036,F,1/14/17,WAS,PHI,0,27,3,6,0.5,3,4,0.75,0,2,0,0,0,,0,2,2,0,2,0,0,1,6,5.2
Channing Frye,33-301,C-F,3/14/17,CLE,DET,0,20,2,4,0.5,0,1,0,2,3,0.667,0,0,,0,3,3,1,0,1,0,2,6,5.5
Mike Dunleavy,36-127,F-G,1/20/17,ATL,CHI,0,15,2,5,0.4,0,1,0,2,4,0.5,0,0,,0,0,0,1,1,0,0,1,6,4.6
Al Horford,30-209,C-F,12/29/16,BOS,CLE,1,29,3,9,0.333,3,7,0.429,0,2,0,0,0,,0,1,1,4,0,3,2,2,6,3.3
Isaiah Canaan,25-263,G,2/8/17,CHI,GSW,0,23,2,4,0.5,2,3,0.667,0,1,0,2,2,1,0,2,2,2,0,0,0,1,6,5.6
Rodney McGruder,25-113,G,11/19/16,MIA,WAS,0,19,2,5,0.4,2,4,0.5,0,1,0,2,3,0.667,1,3,4,0,0,0,2,4,6,0.9
Shaun Livingston,31-090,G,12/10/16,GSW,MEM,0,18,3,4,0.75,3,4,0.75,0,0,,0,1,0,0,0,0,1,0,1,3,2,6,1.6
Brandon Jennings,27-140,G,2/10/17,NYK,DEN,1,39,2,10,0.2,0,4,0,2,6,0.333,0,0,,1,1,2,13,1,0,0,1,6,10.5
Sean Kilpatrick,26-339,G,12/10/16,BRK,SAS,1,24,2,7,0.286,2,5,0.4,0,2,0,2,2,1,1,0,1,1,0,0,1,1,6,1.9
Shabazz Muhammad,24-139,F-G,4/1/17,MIN,SAC,0,16,2,6,0.333,2,6,0.333,0,0,,2,2,1,1,1,2,0,0,0,1,2,6,1.8
James Michael McAdoo,24-071,F,3/16/17,GSW,ORL,0,8,3,3,1,3,3,1,0,0,,0,4,0,0,1,1,0,1,2,0,0,6,6.2
Kosta Koufos,27-350,C,2/8/17,SAC,BOS,1,27,3,8,0.375,3,8,0.375,0,0,,0,0,,3,8,11,3,1,0,1,2,6,7.4
Brandon Ingram,19-121,F,1/1/17,LAL,TOR,0,26,2,7,0.286,2,4,0.5,0,3,0,2,2,1,1,2,3,2,0,0,0,2,6,3.8
Dante Cunningham,29-320,F,3/8/17,NOP,TOR,0,26,3,7,0.429,3,5,0.6,0,2,0,0,0,,1,4,5,1,2,0,0,2,6,6.1
Trey Burke,24-072,G,1/23/17,WAS,CHO,0,12,3,3,1,3,3,1,0,0,,0,0,,0,1,1,4,0,0,0,1,6,7.8
Rodney Stuckey,30-296,G,2/11/17,IND,MIL,0,16,1,4,0.25,0,2,0,1,2,0.5,3,3,1,0,1,1,1,0,0,0,3,6,3.4
Boris Diaw,34-273,F-C,1/14/17,UTA,ORL,0,14,2,8,0.25,2,5,0.4,0,3,0,2,3,0.667,1,0,1,2,0,0,1,1,6,1.5
Gary Payton,24-124,G,4/4/17,MIL,OKC,0,30,2,8,0.25,2,6,0.333,0,2,0,2,3,0.667,0,2,2,3,2,1,2,1,6,3.8
Shaun Livingston,31-051,G,11/1/16,GSW,POR,0,18,2,3,0.667,2,3,0.667,0,0,,2,2,1,0,1,1,5,2,0,3,2,6,6.7
C.J. Miles,29-277,G-F,1/20/17,IND,LAL,0,14,2,5,0.4,0,2,0,2,3,0.667,0,1,0,0,1,1,0,0,1,0,2,6,3.1
Maurice Ndour,24-180,F,12/15/16,NYK,GSW,0,6,2,4,0.5,2,4,0.5,0,0,,2,2,1,1,0,1,0,1,0,0,0,6,5.7
Mike Dunleavy,36-051,F-G,11/5/16,CLE,PHI,0,13,2,5,0.4,0,1,0,2,4,0.5,0,0,,1,0,1,0,0,0,2,2,6,1.2
Salah Mejri,30-301,C,4/12/17,DAL,MEM,0,12,2,2,1,1,1,1,1,1,1,1,2,0.5,1,1,2,0,0,0,0,3,6,4.8
Alex Len,23-233,C,2/4/17,PHO,MIL,0,11,3,5,0.6,3,5,0.6,0,0,,0,0,,1,0,1,0,0,0,0,3,6,3.2
Malcolm Delaney,27-269,G,12/5/16,ATL,OKC,0,14,2,5,0.4,2,5,0.4,0,0,,2,2,1,0,0,0,2,0,0,2,2,6,1.9
Andrew Bogut,31-337,C,10/30/16,DAL,HOU,1,28,3,7,0.429,3,7,0.429,0,0,,0,2,0,5,10,15,3,0,0,2,3,6,6.9
Darrell Arthur,28-348,F,3/8/17,DEN,WAS,0,28,2,4,0.5,0,1,0,2,3,0.667,0,1,0,0,5,5,1,0,1,2,3,6,3.3
Lucas Nogueira,24-182,C,1/24/17,TOR,SAS,0,26,3,6,0.5,3,6,0.5,0,0,,0,0,,4,6,10,1,1,2,0,3,6,9.5
Tyus Jones,20-199,G,11/25/16,MIN,PHO,0,19,3,6,0.5,3,6,0.5,0,0,,0,0,,0,2,2,3,2,0,0,0,6,7.7
Shaun Livingston,31-060,G,11/10/16,GSW,DEN,0,18,3,4,0.75,3,4,0.75,0,0,,0,0,,0,2,2,0,1,0,1,3,6,3.8
Kosta Koufos,27-315,C,1/4/17,SAC,MIA,1,15,2,2,1,2,2,1,0,0,,2,2,1,1,3,4,2,1,1,1,1,6,8.7
JaMychal Green,26-133,F,11/1/16,MEM,MIN,1,27,2,8,0.25,1,5,0.2,1,3,0.333,1,2,0.5,0,2,2,1,1,1,2,2,6,1
John Henson,26-083,C-F,3/21/17,MIL,POR,0,20,3,6,0.5,3,6,0.5,0,0,,0,0,,5,3,8,0,1,3,3,4,6,5.9
Andre Roberson,25-115,G-F,3/29/17,OKC,ORL,1,35,3,7,0.429,3,5,0.6,0,2,0,0,0,,3,6,9,3,1,2,0,5,6,8.7
Jamal Murray,19-289,G,12/8/16,DEN,WAS,0,17,2,5,0.4,0,1,0,2,4,0.5,0,0,,1,1,2,2,1,0,5,2,6,0.9
Mike Dunleavy,36-120,F-G,1/13/17,ATL,BOS,0,15,2,3,0.667,0,0,,2,3,0.667,0,0,,0,5,5,1,0,0,0,1,6,6.5
Iman Shumpert,26-124,G,10/28/16,CLE,TOR,0,20,1,4,0.25,0,3,0,1,1,1,3,4,0.75,0,4,4,2,3,0,2,2,6,6
Norman Powell,23-203,G,12/14/16,TOR,PHI,0,21,2,5,0.4,2,3,0.667,0,2,0,2,3,0.667,0,0,0,0,2,2,0,3,6,5.1
Meyers Leonard,25-013,C-F,3/12/17,POR,PHO,0,14,3,5,0.6,3,3,1,0,2,0,0,0,,0,2,2,0,0,1,0,3,6,3.8
Domantas Sabonis,20-238,F,12/27/16,OKC,MIA,1,26,3,6,0.5,3,4,0.75,0,2,0,0,0,,2,3,5,0,1,0,0,1,6,5.9
David West,36-140,F,1/16/17,GSW,CLE,0,15,3,4,0.75,3,4,0.75,0,0,,0,0,,0,2,2,3,1,0,1,2,6,6.3
Denzel Valentine,23-030,G,12/16/16,CHI,MIL,0,22,2,7,0.286,2,5,0.4,0,2,0,2,2,1,0,4,4,2,1,0,0,1,6,5.1
Allen Crabbe,24-211,G-F,11/6/16,POR,MEM,0,27,2,4,0.5,0,2,0,2,2,1,0,0,,0,3,3,0,0,0,1,3,6,2.7
Tim Frazier,26-028,G,11/29/16,NOP,LAL,1,32,3,7,0.429,3,5,0.6,0,2,0,0,0,,0,1,1,5,0,0,1,3,6,3.9
Rondae Hollis-Jefferson,22-070,F,3/14/17,BRK,OKC,1,26,1,2,0.5,1,2,0.5,0,0,,4,4,1,2,2,4,1,1,2,1,3,6,7.9
Georgios Papagiannis,19-283,C,4/12/17,SAC,LAC,0,28,3,6,0.5,3,5,0.6,0,1,0,0,0,,1,0,1,3,0,0,3,3,6,1.6
Georgios Papagiannis,19-259,C,3/19/17,SAC,SAS,0,24,2,7,0.286,2,7,0.286,0,0,,2,2,1,4,6,10,0,1,1,1,5,6,5.2
Isaiah Whitehead,22-033,G,4/10/17,BRK,BOS,0,26,3,8,0.375,3,6,0.5,0,2,0,0,2,0,0,1,1,4,1,0,1,1,6,3.5
Jakob Poeltl,21-034,C,11/18/16,TOR,DEN,0,16,2,2,1,2,2,1,0,0,,2,3,0.667,2,4,6,0,2,0,0,2,6,8.8
Shabazz Muhammad,24-040,F-G,12/23/16,MIN,SAC,0,17,1,1,1,0,0,,1,1,1,3,4,0.75,0,1,1,0,0,0,1,2,6,3.8
John Henson,26-013,C-F,1/10/17,MIL,SAS,1,17,3,6,0.5,3,6,0.5,0,0,,0,0,,2,4,6,3,0,0,1,0,6,6.7
Justin Anderson,23-041,G,12/30/16,DAL,GSW,0,15,3,11,0.273,3,7,0.429,0,4,0,0,0,,2,2,4,1,2,2,0,3,6,4.4
Serge Ibaka,27-057,F-C,11/14/16,ORL,IND,1,28,3,13,0.231,3,9,0.333,0,4,0,0,0,,3,10,13,2,0,0,2,1,6,2.2
Patrick McCaw,21-019,G,11/13/16,GSW,PHO,0,18,2,4,0.5,0,1,0,2,3,0.667,0,0,,1,1,2,0,1,2,0,1,6,7
Isaiah Whitehead,21-266,G,11/29/16,BRK,LAC,1,46,2,8,0.25,1,5,0.2,1,3,0.333,1,3,0.333,0,3,3,4,0,0,0,5,6,2.1
Jonathon Simmons,27-173,G-F,3/6/17,SAS,HOU,0,14,3,4,0.75,3,3,1,0,1,0,0,0,,1,1,2,0,0,1,1,1,6,4.7
J.J. Redick,32-245,G,2/24/17,LAC,SAS,1,32,2,9,0.222,0,1,0,2,8,0.25,0,0,,0,2,2,2,1,0,0,1,6,3.1
Jonathon Simmons,27-178,G-F,3/11/17,SAS,GSW,0,27,3,6,0.5,3,6,0.5,0,0,,0,0,,0,3,3,2,1,0,2,2,6,3.5
Mindaugas Kuzminskas,27-143,F,3/11/17,NYK,DET,0,7,2,4,0.5,2,4,0.5,0,0,,2,2,1,0,1,1,0,0,0,1,2,6,2.5
Vince Carter,39-305,G-F,11/26/16,MEM,MIA,0,16,2,8,0.25,2,3,0.667,0,5,0,2,2,1,0,4,4,4,0,0,0,1,6,4.8
Emmanuel Mudiay,21-031,G,4/5/17,DEN,HOU,0,16,1,5,0.2,1,2,0.5,0,3,0,4,4,1,2,4,6,3,1,0,2,2,6,5.8
Derrick Favors,25-112,F-C,11/4/16,UTA,SAS,1,27,3,13,0.231,3,13,0.231,0,0,,0,0,,2,5,7,0,2,1,1,1,6,2.3
Derrick Jones,20-034,F,3/21/17,PHO,MIA,0,18,2,4,0.5,2,4,0.5,0,0,,2,2,1,0,1,1,0,0,0,0,3,6,3.1
Vince Carter,40-031,G-F,2/26/17,MEM,DEN,0,26,2,6,0.333,2,3,0.667,0,3,0,2,2,1,0,2,2,2,1,0,2,2,6,2.8
Joe Ingles,29-113,F-G,1/23/17,UTA,OKC,1,22,3,5,0.6,3,5,0.6,0,0,,0,0,,0,2,2,2,3,0,2,2,6,5.9
Kris Dunn,22-259,G,12/2/16,MIN,NYK,0,18,2,3,0.667,2,3,0.667,0,0,,2,2,1,0,1,1,5,1,0,1,3,6,7.3
Kosta Koufos,27-341,C,1/30/17,SAC,PHI,1,17,3,4,0.75,3,4,0.75,0,0,,0,0,,0,0,0,0,0,1,0,2,6,4.3
Edy Tavares,25-021,C,4/12/17,CLE,TOR,0,24,3,4,0.75,3,4,0.75,0,0,,0,1,0,4,6,10,1,0,6,2,3,6,10.3
Troy Daniels,25-159,G,12/21/16,MEM,DET,0,17,2,9,0.222,0,1,0,2,8,0.25,0,0,,0,1,1,0,1,0,0,1,6,1.4
Brandon Ingram,19-142,F,1/22/17,LAL,DAL,1,36,2,12,0.167,2,9,0.222,0,3,0,2,3,0.667,0,1,1,0,1,0,3,5,6,-5.7
Willie Reed,26-185,F-C,11/17/16,MIA,MIL,0,19,3,4,0.75,3,4,0.75,0,0,,0,2,0,1,2,3,1,0,0,1,2,6,3.8
Manu Ginobili,39-244,G,3/29/17,SAS,GSW,0,17,2,7,0.286,0,2,0,2,5,0.4,0,0,,0,1,1,3,2,0,1,2,6,4.5
Boban Marjanovic,28-205,C,3/8/17,DET,IND,0,11,1,2,0.5,1,2,0.5,0,0,,4,5,0.8,0,5,5,1,0,0,0,2,6,6
Willie Cauley-Stein,23-124,F-C,12/20/16,SAC,POR,0,7,3,3,1,3,3,1,0,0,,0,0,,0,0,0,0,0,0,0,1,6,4.7
Patrick Beverley,28-140,G,11/29/16,HOU,UTA,1,22,2,5,0.4,2,4,0.5,0,1,0,2,2,1,1,5,6,3,0,0,0,4,6,6
Jason Terry,39-120,G,1/13/17,MIL,MIA,0,23,2,5,0.4,0,1,0,2,4,0.5,0,0,,0,1,1,3,1,0,0,1,6,6.3
Lance Stephenson,26-156,G-F,2/8/17,MIN,TOR,0,20,3,7,0.429,3,7,0.429,0,0,,0,0,,0,4,4,1,0,0,1,0,6,3.2
Boris Diaw,34-261,F-C,1/2/17,UTA,BRK,0,13,3,7,0.429,3,6,0.5,0,1,0,0,0,,1,1,2,0,0,0,1,1,6,1.9
Shaun Livingston,31-053,G,11/3/16,GSW,OKC,0,17,3,4,0.75,3,4,0.75,0,0,,0,0,,1,1,2,1,0,0,0,2,6,5.3
Rajon Rondo,30-277,G,11/25/16,CHI,PHI,1,26,2,5,0.4,2,5,0.4,0,0,,2,3,0.667,0,8,8,10,2,0,1,2,6,12.5
Mason Plumlee,26-361,C-F,3/1/17,DEN,MIL,0,18,3,6,0.5,3,6,0.5,0,0,,0,0,,1,3,4,0,2,0,0,3,6,5.4
Larry Nance Jr.,23-336,F,12/2/16,LAL,TOR,0,23,3,6,0.5,3,6,0.5,0,0,,0,0,,2,4,6,0,0,0,0,1,6,5.2
Jeff Teague,28-199,G,12/26/16,IND,CHI,1,24,2,8,0.25,1,5,0.2,1,3,0.333,1,2,0.5,1,1,2,5,0,0,3,0,6,2.3
Channing Frye,33-204,C-F,12/7/16,CLE,NYK,0,13,2,4,0.5,0,1,0,2,3,0.667,0,0,,0,0,0,0,1,0,0,2,6,4.2
DeMarre Carroll,30-212,F,2/24/17,TOR,BOS,1,28,2,4,0.5,1,1,1,1,3,0.333,1,2,0.5,1,3,4,1,0,1,0,5,6,4.6
Dante Cunningham,29-351,F,4/8/17,NOP,GSW,1,27,3,6,0.5,3,4,0.75,0,2,0,0,0,,1,4,5,0,0,0,0,0,6,4.9
Patty Mills,28-145,G,1/3/17,SAS,TOR,0,18,2,4,0.5,0,0,,2,4,0.5,0,0,,0,3,3,3,1,0,1,1,6,6.6
Brandon Knight,24-346,G,11/12/16,PHO,BRK,0,22,2,13,0.154,2,9,0.222,0,4,0,2,2,1,2,7,9,4,0,0,2,1,6,1.6
Donatas Motiejunas,26-204,F-C,4/12/17,NOP,POR,0,17,3,11,0.273,3,7,0.429,0,4,0,0,1,0,1,1,2,0,3,0,0,2,6,2.3
Tarik Black,25-110,C-F,3/12/17,LAL,PHI,0,18,3,5,0.6,3,5,0.6,0,0,,0,0,,3,1,4,1,1,0,0,3,6,6.6
Greg Monroe,26-237,C-F,1/27/17,MIL,TOR,0,17,3,5,0.6,3,5,0.6,0,0,,0,0,,1,1,2,1,1,1,2,0,6,5.1
Bobby Portis,22-004,F,2/14/17,CHI,TOR,0,11,1,5,0.2,0,3,0,1,2,0.5,3,4,0.75,0,4,4,0,0,1,1,0,6,3.4
Jason Smith,30-345,F-C,2/10/17,WAS,IND,0,17,3,5,0.6,3,5,0.6,0,0,,0,0,,1,1,2,0,0,1,0,0,6,5.4
Kyle O'Quinn,26-277,F-C,12/28/16,NYK,ATL,0,13,3,5,0.6,3,5,0.6,0,0,,0,0,,0,4,4,0,1,1,2,3,6,3.4
Caris LeVert,22-136,G-F,1/8/17,BRK,PHI,0,21,3,5,0.6,3,4,0.75,0,1,0,0,1,0,0,3,3,2,0,0,2,2,6,2.8
Langston Galloway,25-051,G,1/29/17,NOP,WAS,0,11,2,4,0.5,0,0,,2,4,0.5,0,0,,0,2,2,0,1,0,0,2,6,4.8
Jason Smith,30-327,F-C,1/23/17,WAS,CHO,0,19,3,4,0.75,3,4,0.75,0,0,,0,0,,0,6,6,0,1,1,2,4,6,4.3
Ersan Ilyasova,29-305,F,3/16/17,ATL,MEM,0,14,2,5,0.4,1,4,0.25,1,1,1,1,2,0.5,3,2,5,0,0,0,1,2,6,3.8
Anthony Morrow,31-033,G,10/30/16,OKC,LAL,0,6,3,5,0.6,3,4,0.75,0,1,0,0,0,,0,0,0,1,1,0,0,1,6,5
Jon Leuer,27-326,F,4/5/17,DET,TOR,1,14,3,5,0.6,3,5,0.6,0,0,,0,0,,2,3,5,1,0,0,1,1,6,5.3
Reggie Bullock,26-022,G-F,4/7/17,DET,HOU,0,25,2,6,0.333,0,3,0,2,3,0.667,0,0,,2,1,3,4,1,0,0,1,6,7.7
Stanley Johnson,20-196,F,12/11/16,DET,PHI,0,26,2,8,0.25,1,5,0.2,1,3,0.333,1,2,0.5,1,1,2,4,5,1,0,5,6,8.3
Cory Joseph,25-191,G,2/27/17,TOR,NYK,1,34,3,7,0.429,3,4,0.75,0,3,0,0,0,,1,2,3,4,2,0,2,1,6,6
Kris Humphries,31-364,F-C,2/4/17,ATL,ORL,0,12,2,4,0.5,2,4,0.5,0,0,,2,2,1,1,2,3,1,0,0,1,1,6,4.6
Ersan Ilyasova,29-329,F,4/9/17,ATL,CLE,0,21,2,10,0.2,2,5,0.4,0,5,0,2,3,0.667,4,4,8,0,1,0,2,2,6,1.6
Danny Green,29-197,G-F,1/5/17,SAS,DEN,1,25,2,7,0.286,0,1,0,2,6,0.333,0,0,,1,4,5,2,1,1,1,0,6,5.9
Evan Turner,28-167,G,4/12/17,POR,NOP,1,23,3,8,0.375,3,8,0.375,0,0,,0,0,,0,4,4,3,0,0,3,1,6,1.5
Trevor Booker,29-096,F,3/1/17,BRK,SAC,0,24,3,7,0.429,3,7,0.429,0,0,,0,0,,3,5,8,4,2,0,3,3,6,6.5
Jeff Withey,26-331,C,2/1/17,UTA,MIL,0,14,2,5,0.4,2,5,0.4,0,0,,2,2,1,2,2,4,0,0,1,0,1,6,5.6
JaMychal Green,26-150,F,11/18/16,MEM,DAL,1,32,2,6,0.333,1,3,0.333,1,3,0.333,1,2,0.5,0,12,12,1,1,0,2,4,6,3.9
Mike Dunleavy,36-044,F-G,10/29/16,CLE,ORL,0,20,2,8,0.25,0,2,0,2,6,0.333,0,0,,0,2,2,1,0,0,0,1,6,2.1
Dwight Powell,25-159,F-C,12/26/16,DAL,NOP,0,21,2,3,0.667,2,2,1,0,1,0,2,4,0.5,0,5,5,0,0,0,0,3,6,4.2
Jerami Grant,23-030,F,4/11/17,OKC,MIN,0,22,2,5,0.4,1,3,0.333,1,2,0.5,1,2,0.5,1,7,8,1,0,1,0,5,6,5.1
Isaiah Whitehead,21-272,G,12/5/16,BRK,WAS,1,24,3,8,0.375,3,8,0.375,0,0,,0,0,,0,4,4,5,0,0,3,3,6,2.1
Rodney McGruder,25-233,G,3/19/17,MIA,POR,1,19,2,4,0.5,1,1,1,1,3,0.333,1,2,0.5,2,2,4,1,0,1,1,1,6,5.6
Nikola Vucevic,26-162,C,4/4/17,ORL,CLE,1,24,3,9,0.333,3,9,0.333,0,0,,0,0,,1,9,10,2,1,1,1,2,6,5.6
Andrew Harrison,22-021,G,11/18/16,MEM,DAL,0,26,2,8,0.25,1,4,0.25,1,4,0.25,1,2,0.5,0,4,4,1,2,0,3,4,6,0.1
Boris Diaw,34-321,F-C,3/3/17,UTA,BRK,0,13,2,8,0.25,2,7,0.286,0,1,0,2,4,0.5,2,4,6,4,0,1,1,2,6,4.7
Chris Paul,31-313,G,3/15/17,LAC,MIL,1,36,2,10,0.2,1,6,0.167,1,4,0.25,1,1,1,1,4,5,7,1,0,6,4,6,0
Beno Udrih,34-144,G,11/26/16,DET,OKC,0,17,3,3,1,3,3,1,0,0,,0,0,,1,1,2,2,0,0,0,0,6,7.5
Nene Hilario,34-188,F-C,3/20/17,HOU,DEN,0,21,3,6,0.5,3,6,0.5,0,0,,0,0,,1,2,3,0,2,0,1,2,6,4.5
Patty Mills,28-230,G,3/29/17,SAS,GSW,0,23,1,4,0.25,0,1,0,1,3,0.333,3,5,0.6,1,1,2,0,0,0,2,2,6,1
Luc Mbah a Moute,30-175,F,3/3/17,LAC,MIL,1,30,3,5,0.6,3,3,1,0,2,0,0,0,,2,1,3,2,3,0,0,0,6,9.8
Trevor Ariza,31-122,F,10/30/16,HOU,DAL,1,33,2,4,0.5,0,0,,2,4,0.5,0,0,,2,5,7,3,2,1,3,1,6,8.3
Patrick Patterson,27-242,F,11/11/16,TOR,CHO,0,33,2,10,0.2,0,3,0,2,7,0.286,0,0,,2,5,7,3,0,0,0,2,6,4
James Jones,36-054,F-G,11/27/16,CLE,PHI,0,11,2,2,1,0,0,,2,2,1,0,0,,0,0,0,0,1,0,0,2,6,5.6
Elfrid Payton,22-324,G,1/11/17,ORL,LAC,1,23,3,9,0.333,3,9,0.333,0,0,,0,2,0,0,2,2,3,0,0,2,2,6,0
Terrence Ross,25-355,F-G,1/25/17,TOR,MEM,0,21,2,9,0.222,0,2,0,2,7,0.286,0,0,,0,1,1,1,0,0,0,0,6,1.5
Patrick McCaw,21-134,G,3/8/17,GSW,BOS,1,32,3,7,0.429,3,4,0.75,0,3,0,0,0,,1,3,4,3,0,0,1,1,6,4.6
Jrue Holiday,26-256,G,2/23/17,NOP,HOU,1,35,3,12,0.25,3,6,0.5,0,6,0,0,0,,1,3,4,4,1,2,7,0,6,-1.4
Brandon Jennings,27-131,G,2/1/17,NYK,BRK,1,43,1,11,0.091,1,7,0.143,0,4,0,4,6,0.667,0,3,3,10,5,0,2,2,6,8
Richaun Holmes,23-011,F-C,10/26/16,PHI,OKC,0,12,2,2,1,2,2,1,0,0,,2,2,1,1,2,3,0,0,3,1,3,6,6.6
Iman Shumpert,26-150,G,11/23/16,CLE,POR,0,17,2,4,0.5,0,1,0,2,3,0.667,0,0,,1,1,2,2,0,0,1,5,6,3.4
Boris Diaw,34-285,F-C,1/26/17,UTA,LAL,0,18,2,8,0.25,2,6,0.333,0,2,0,2,2,1,1,0,1,1,0,0,1,0,6,1.6
Mason Plumlee,26-360,C-F,2/28/17,DEN,CHI,0,23,3,5,0.6,3,5,0.6,0,0,,0,0,,0,6,6,5,0,0,1,4,6,6.4
Patrick Beverley,28-269,G,4/7/17,HOU,DET,1,31,1,3,0.333,0,0,,1,3,0.333,3,5,0.6,2,11,13,5,0,1,0,2,6,11.6
Boban Marjanovic,28-126,C,12/19/16,DET,CHI,0,7,3,6,0.5,3,6,0.5,0,0,,0,0,,0,2,2,0,1,2,0,0,6,6
J.R. Smith,31-081,G-F,11/29/16,CLE,MIL,1,30,2,7,0.286,0,0,,2,7,0.286,0,0,,0,0,0,1,2,1,2,4,6,1.7
Terry Rozier,22-360,G,3/12/17,BOS,CHI,0,16,2,5,0.4,2,3,0.667,0,2,0,2,2,1,0,1,1,2,1,0,2,0,6,4
Dejounte Murray,20-047,G,11/5/16,SAS,LAC,0,9,2,4,0.5,0,2,0,2,2,1,0,0,,0,0,0,0,0,0,1,1,6,2.6
Doug McDermott,25-072,F,3/16/17,OKC,TOR,0,16,2,5,0.4,0,1,0,2,4,0.5,0,0,,0,2,2,1,0,0,1,2,6,2.8
Delon Wright,24-309,G,3/1/17,TOR,WAS,0,20,1,2,0.5,1,2,0.5,0,0,,4,4,1,0,1,1,2,2,0,1,2,6,6.9
Sasha Vujacic,32-269,G,12/2/16,NYK,MIN,0,11,2,3,0.667,0,0,,2,3,0.667,0,0,,0,0,0,2,2,0,0,0,6,8.1
Trevor Ariza,31-152,F,11/29/16,HOU,UTA,1,26,3,8,0.375,3,4,0.75,0,4,0,0,0,,1,2,3,0,1,1,1,2,6,2.8
Zaza Pachulia,32-348,C,1/23/17,GSW,MIA,1,27,2,6,0.333,2,6,0.333,0,0,,2,4,0.5,4,6,10,2,2,0,1,3,6,7.6
Luol Deng,31-314,F,2/24/17,LAL,OKC,0,18,3,9,0.333,3,8,0.375,0,1,0,0,0,,2,0,2,2,0,0,0,1,6,3.3
Tyler Ulis,21-050,G,2/24/17,PHO,CHI,0,13,3,4,0.75,3,4,0.75,0,0,,0,0,,0,2,2,4,1,0,1,0,6,7.8
Patrick Beverley,28-185,G,1/13/17,HOU,MEM,1,33,3,7,0.429,3,4,0.75,0,3,0,0,0,,0,2,2,3,3,1,0,3,6,7.5
Fred VanVleet,23-007,G,3/4/17,TOR,MIL,0,8,2,3,0.667,2,3,0.667,0,0,,2,2,1,0,2,2,2,1,0,1,1,6,6.3
Damjan Rudez,30-194,F,12/28/16,ORL,CHO,0,12,2,7,0.286,0,1,0,2,6,0.333,0,0,,0,0,0,1,0,0,0,1,6,2.2
Jaylen Brown,20-067,F,12/30/16,BOS,MIA,0,16,3,4,0.75,3,3,1,0,1,0,0,0,,0,0,0,1,0,0,0,1,6,4.7
Noah Vonleh,21-113,F,12/15/16,POR,DEN,1,18,3,8,0.375,3,8,0.375,0,0,,0,0,,3,4,7,0,0,0,1,3,6,2.7
Cristiano Felicio,24-216,F-C,2/8/17,CHI,GSW,0,15,3,4,0.75,3,4,0.75,0,0,,0,0,,2,2,4,0,1,0,0,0,6,7.4
Dante Cunningham,29-290,F,2/6/17,NOP,PHO,0,20,3,5,0.6,3,5,0.6,0,0,,0,0,,1,4,5,0,1,1,0,1,6,6.9
Jahlil Okafor,21-008,C-F,12/23/16,PHI,PHO,1,20,3,4,0.75,3,4,0.75,0,0,,0,0,,1,3,4,1,0,1,1,5,6,4.4
Austin Rivers,24-096,G,11/5/16,LAC,SAS,0,22,3,10,0.3,3,7,0.429,0,3,0,0,0,,0,1,1,1,1,1,1,2,6,1.1
Darren Collison,29-127,G,12/28/16,SAC,POR,1,20,2,7,0.286,2,6,0.333,0,1,0,2,2,1,0,1,1,5,0,0,0,1,6,5.3
Georgios Papagiannis,19-280,C,4/9/17,SAC,HOU,0,13,3,3,1,3,3,1,0,0,,0,0,,1,2,3,3,1,0,1,2,6,7.7
Pau Gasol,36-146,F-C,11/29/16,SAS,ORL,1,22,2,6,0.333,2,5,0.4,0,1,0,2,2,1,2,4,6,3,0,0,0,0,6,7.3
Jarell Martin,22-185,F,11/25/16,MEM,MIA,0,18,2,4,0.5,2,4,0.5,0,0,,2,2,1,1,11,12,0,0,1,1,2,6,6.9
Buddy Hield,22-344,G,11/25/16,NOP,POR,0,12,2,4,0.5,1,2,0.5,1,2,0.5,1,1,1,0,1,1,0,0,1,0,1,6,4.6
Michael Kidd-Gilchrist,23-142,F,2/15/17,CHO,TOR,1,36,2,7,0.286,2,7,0.286,0,0,,2,2,1,1,13,14,2,2,2,3,2,6,7.5
Maurice Harkless,23-300,F-G,3/7/17,POR,OKC,1,29,3,5,0.6,3,4,0.75,0,1,0,0,2,0,3,1,4,2,2,2,0,2,6,9.3
Michael Kidd-Gilchrist,23-037,F,11/2/16,CHO,PHI,1,32,2,4,0.5,2,4,0.5,0,0,,2,4,0.5,2,11,13,1,3,1,2,4,6,8.7
Kyle Singler,28-285,F,2/13/17,OKC,WAS,0,17,2,3,0.667,2,3,0.667,0,0,,2,3,0.667,1,2,3,1,1,0,0,0,6,7.3
Marco Belinelli,31-003,G-F,3/28/17,CHO,MIL,0,25,2,6,0.333,2,3,0.667,0,3,0,2,2,1,0,4,4,5,0,0,0,1,6,6.9
Trevor Booker,29-049,F,1/13/17,BRK,TOR,1,27,3,8,0.375,3,8,0.375,0,0,,0,0,,1,6,7,4,0,0,0,3,6,5.7
Tyus Jones,20-179,G,11/5/16,MIN,OKC,0,16,0,4,0,0,2,0,0,2,0,6,6,1,1,1,2,4,0,0,2,1,6,4.6
Jakob Poeltl,21-152,C,3/16/17,TOR,OKC,0,17,2,3,0.667,2,3,0.667,0,0,,2,2,1,1,1,2,0,0,2,0,2,6,6.3
Trevor Ariza,31-176,F,12/23/16,HOU,MEM,1,36,2,5,0.4,0,1,0,2,4,0.5,0,0,,0,4,4,3,1,0,1,1,6,6.2
Greg Monroe,26-302,C-F,4/2/17,MIL,DAL,0,24,2,2,1,2,2,1,0,0,,2,4,0.5,1,5,6,1,1,0,0,4,6,6.9
Brian Roberts,31-093,G,3/6/17,CHO,IND,0,13,2,3,0.667,0,0,,2,3,0.667,0,0,,0,2,2,0,0,0,1,0,6,4.3
Pascal Siakam,23-001,F,2/5/17,TOR,BRK,1,29,2,4,0.5,2,4,0.5,0,0,,2,2,1,1,6,7,0,1,0,2,3,6,4.3
Shabazz Napier,25-254,G,3/25/17,POR,MIN,0,14,2,5,0.4,2,4,0.5,0,1,0,2,2,1,0,1,1,1,0,0,1,0,6,3.3
Kent Bazemore,27-274,G-F,4/1/17,ATL,CHI,0,21,2,8,0.25,0,3,0,2,5,0.4,0,0,,0,5,5,2,0,0,0,2,6,3.3
Jameer Nelson,34-347,G,1/21/17,DEN,LAC,0,29,3,8,0.375,3,6,0.5,0,2,0,0,0,,0,2,2,8,0,0,1,2,6,6
Matt Barnes,36-331,F,2/3/17,SAC,PHO,1,39,3,9,0.333,3,5,0.6,0,4,0,0,0,,0,10,10,4,0,1,1,3,6,5.2
Justin Anderson,22-351,G,11/4/16,DAL,POR,0,18,3,5,0.6,3,4,0.75,0,1,0,0,0,,1,1,2,0,0,1,0,2,6,4.6
Joffrey Lauvergne,25-103,C-F,1/11/17,OKC,MEM,0,11,1,2,0.5,1,1,1,0,1,0,4,4,1,1,2,3,1,0,0,0,2,6,6.2
Okaro White,24-203,F,3/4/17,MIA,CLE,0,25,2,5,0.4,2,5,0.4,0,0,,2,2,1,3,4,7,0,0,0,3,3,6,2.4
Matthew Dellavedova,26-177,G,3/4/17,MIL,TOR,0,26,2,11,0.182,2,9,0.222,0,2,0,2,2,1,0,3,3,3,0,0,0,2,6,1.3
Boris Diaw,34-280,F-C,1/21/17,UTA,IND,0,19,3,7,0.429,3,7,0.429,0,0,,0,0,,1,2,3,4,0,0,0,0,6,6.4
Dorian Finney-Smith,23-340,F,4/9/17,DAL,PHO,1,30,2,9,0.222,2,7,0.286,0,2,0,2,2,1,7,4,11,3,1,0,0,4,6,8.1
Draymond Green,26-242,F,11/1/16,GSW,POR,1,30,2,3,0.667,1,1,1,1,2,0.5,1,2,0.5,0,8,8,9,3,2,0,2,6,16.6
J.J. Redick,32-226,G,2/5/17,LAC,BOS,1,33,2,9,0.222,2,6,0.333,0,3,0,2,2,1,1,3,4,1,0,0,2,4,6,-0.8
David Lee,33-311,F,3/6/17,SAS,HOU,0,23,3,6,0.5,3,6,0.5,0,0,,0,0,,5,3,8,0,2,1,1,4,6,7.5
Rodney McGruder,25-243,G,3/29/17,MIA,NYK,1,13,3,5,0.6,3,4,0.75,0,1,0,0,0,,0,0,0,0,0,0,1,5,6,0.7
Mason Plumlee,27-028,C-F,4/2/17,DEN,MIA,0,13,2,4,0.5,2,4,0.5,0,0,,2,4,0.5,0,2,2,1,0,2,0,2,6,5.1
Terrence Jones,24-359,F,1/2/17,NOP,CLE,0,18,2,5,0.4,2,5,0.4,0,0,,2,2,1,0,3,3,2,1,0,1,0,6,5.6
Ty Lawson,29-128,G,3/11/17,SAC,DEN,0,24,3,8,0.375,3,6,0.5,0,2,0,0,0,,1,3,4,3,1,0,1,6,6,2.9
Tristan Thompson,25-255,F-C,11/23/16,CLE,POR,1,27,2,3,0.667,2,3,0.667,0,0,,2,6,0.333,1,5,6,1,0,1,0,1,6,6.3
Andrew Harrison,22-094,G,1/30/17,MEM,PHO,0,10,1,1,1,0,0,,1,1,1,3,4,0.75,0,0,0,0,0,0,1,4,6,2.7
Kent Bazemore,27-193,G-F,1/10/17,ATL,BRK,1,22,1,7,0.143,1,4,0.25,0,3,0,4,6,0.667,1,2,3,0,2,0,1,2,6,2.2
Raymond Felton,32-286,G,4/8/17,LAC,SAS,0,18,3,5,0.6,3,5,0.6,0,0,,0,0,,0,3,3,2,1,0,0,1,6,6.6
Anthony Tolliver,31-236,F-C,1/23/17,SAC,DET,0,24,2,4,0.5,1,2,0.5,1,2,0.5,1,2,0.5,1,1,2,1,1,0,0,1,6,5.9
Terrence Ross,25-301,F-G,12/2/16,TOR,LAL,0,20,2,6,0.333,0,1,0,2,5,0.4,0,0,,0,1,1,1,0,0,1,2,6,1.8
Roy Hibbert,29-351,C,11/26/16,CHO,NYK,0,14,1,2,0.5,1,2,0.5,0,0,,4,4,1,1,2,3,1,0,2,1,1,6,7
Tarik Black,25-008,C-F,11/30/16,LAL,CHI,0,12,2,2,1,2,2,1,0,0,,2,4,0.5,1,0,1,0,0,1,1,5,6,3
Darrell Arthur,28-258,F,12/8/16,DEN,WAS,1,20,2,3,0.667,0,0,,2,3,0.667,0,0,,0,3,3,4,0,1,2,2,6,6.3
Elfrid Payton,22-255,G,11/3/16,ORL,SAC,1,34,3,13,0.231,3,8,0.375,0,5,0,0,1,0,0,3,3,11,0,0,1,1,6,4.9
Buddy Hield,23-049,G,2/4/17,NOP,WAS,1,23,3,10,0.3,3,7,0.429,0,3,0,0,0,,1,2,3,2,0,0,1,2,6,1.1
Anthony Morrow,31-048,G,11/14/16,OKC,DET,0,9,3,5,0.6,3,4,0.75,0,1,0,0,0,,2,0,2,1,0,1,0,0,6,6.5
Danny Green,29-213,G-F,1/21/17,SAS,CLE,1,32,2,5,0.4,0,0,,2,5,0.4,0,0,,0,2,2,2,0,0,0,4,6,3.7
Jonathon Simmons,27-059,G-F,11/12/16,SAS,HOU,0,16,3,4,0.75,3,3,1,0,1,0,0,0,,0,2,2,1,0,1,0,1,6,6
Emmanuel Mudiay,20-336,G,2/4/17,DEN,SAS,0,20,2,10,0.2,2,7,0.286,0,3,0,2,2,1,1,3,4,4,1,0,1,2,6,3.4
Nikola Mirotic,25-293,F,11/30/16,CHI,LAL,0,22,3,9,0.333,3,5,0.6,0,4,0,0,0,,1,5,6,1,2,1,0,1,6,6.1
Tarik Black,25-140,C-F,4/11/17,LAL,NOP,0,21,3,9,0.333,3,9,0.333,0,0,,0,0,,0,9,9,0,1,3,0,0,6,6.7
Jameer Nelson,34-360,G,2/3/17,DEN,MIL,1,30,2,6,0.333,1,3,0.333,1,3,0.333,1,2,0.5,0,3,3,4,0,0,1,1,6,4.5
Jameer Nelson,35-043,G,3/24/17,DEN,IND,1,33,2,6,0.333,1,2,0.5,1,4,0.25,1,2,0.5,1,1,2,6,1,0,1,2,6,6.6
Corey Brewer,30-259,F-G,11/19/16,HOU,UTA,0,15,2,3,0.667,2,2,1,0,1,0,2,2,1,2,3,5,1,0,0,0,0,6,7.7
Joe Harris,25-175,G,3/1/17,BRK,SAC,0,21,2,6,0.333,0,0,,2,6,0.333,0,0,,0,3,3,0,0,0,1,4,6,0.9
Anthony Morrow,31-064,G,11/30/16,OKC,WAS,0,31,2,9,0.222,0,2,0,2,7,0.286,0,0,,0,1,1,4,0,0,1,3,6,1.4
Bobby Portis,21-279,F,11/15/16,CHI,POR,0,14,2,5,0.4,1,4,0.25,1,1,1,1,2,0.5,3,3,6,1,0,0,2,2,6,3.8
Al-Farouq Aminu,26-100,F,12/30/16,POR,SAS,1,28,2,9,0.222,2,6,0.333,0,3,0,2,3,0.667,1,5,6,3,2,0,0,4,6,4.8
Derrick Jones,20-000,F,2/15/17,PHO,LAL,0,4,3,3,1,3,3,1,0,0,,0,0,,1,1,2,0,0,0,0,0,6,6.1
Kelly Oubre,21-028,F,1/6/17,WAS,MIN,0,14,2,4,0.5,0,1,0,2,3,0.667,0,0,,0,1,1,0,0,0,1,4,6,1.7
Rodney McGruder,25-089,G,10/26/16,MIA,ORL,0,24,1,3,0.333,1,2,0.5,0,1,0,4,5,0.8,1,2,3,0,2,0,1,4,6,4.6
Corey Brewer,31-027,F-G,4/1/17,LAL,LAC,0,10,1,3,0.333,1,3,0.333,0,0,,4,4,1,0,3,3,1,1,0,0,2,6,6.1
Jonathon Simmons,27-165,G-F,2/26/17,SAS,LAL,0,17,2,8,0.25,2,7,0.286,0,1,0,2,2,1,0,0,0,1,0,1,2,0,6,0.6
Dewayne Dedmon,27-133,C,12/23/16,SAS,POR,1,27,2,4,0.5,2,4,0.5,0,0,,2,2,1,2,5,7,0,0,2,0,3,6,7.1
Mike Muscala,25-165,F-C,12/13/16,ATL,ORL,0,24,3,8,0.375,3,7,0.429,0,1,0,0,0,,1,4,5,2,0,1,0,2,6,4.8
Rajon Rondo,30-327,G,1/14/17,CHI,NOP,0,19,2,7,0.286,0,4,0,2,3,0.667,0,0,,0,2,2,5,1,0,2,1,6,4.6
Rondae Hollis-Jefferson,22-075,F,3/19/17,BRK,DAL,1,30,2,6,0.333,2,6,0.333,0,0,,2,2,1,1,8,9,0,0,1,0,2,6,5.6
Daniel Ochefu,23-008,C,12/23/16,WAS,MIL,0,11,3,4,0.75,3,4,0.75,0,0,,0,2,0,0,2,2,0,0,0,0,2,6,3.4
Jon Leuer,27-294,F,3/4/17,DET,PHI,1,19,3,7,0.429,3,6,0.5,0,1,0,0,0,,0,2,2,1,1,0,1,2,6,2.8
LaMarcus Aldridge,31-225,F-C,3/1/17,SAS,IND,1,32,3,9,0.333,3,9,0.333,0,0,,0,0,,1,4,5,2,1,0,2,0,6,3.2
Kyle Anderson,23-202,F-G,4/10/17,SAS,POR,0,24,2,6,0.333,2,5,0.4,0,1,0,2,2,1,1,3,4,2,3,0,2,0,6,6.6
Jarell Martin,22-162,F,11/2/16,MEM,NOP,0,17,2,6,0.333,2,5,0.4,0,1,0,2,2,1,1,3,4,1,2,1,1,2,6,5.8
T.J. McConnell,24-279,G,12/29/16,PHI,UTA,0,27,3,5,0.6,3,5,0.6,0,0,,0,0,,0,0,0,3,1,0,3,1,6,3.4
Marcin Gortat,33-029,C-F,3/18/17,WAS,CHO,1,27,2,7,0.286,2,7,0.286,0,0,,2,2,1,1,14,15,0,0,1,1,1,6,6.1
Luc Mbah a Moute,30-119,F,1/6/17,LAC,SAC,1,23,3,8,0.375,3,8,0.375,0,0,,0,0,,1,1,2,0,1,0,0,0,6,3.6
Cory Joseph,25-223,G,3/31/17,TOR,IND,1,29,3,5,0.6,3,3,1,0,2,0,0,0,,0,2,2,6,1,0,3,3,6,5.3
Ed Davis,27-191,F,12/13/16,POR,OKC,0,11,2,3,0.667,2,3,0.667,0,0,,2,2,1,1,2,3,1,0,1,0,4,6,5.8
Kosta Koufos,28-001,C,2/25/17,SAC,CHO,1,19,3,7,0.429,3,7,0.429,0,0,,0,0,,4,3,7,0,0,1,2,2,6,3.9
Josh Richardson,23-113,G,1/6/17,MIA,LAL,1,30,2,6,0.333,1,2,0.5,1,4,0.25,1,2,0.5,0,1,1,2,0,0,2,3,6,0.7
Nick Young,31-281,G-F,3/9/17,LAL,PHO,1,14,2,6,0.333,0,3,0,2,3,0.667,0,0,,0,1,1,1,0,0,1,3,6,1.4
Ty Lawson,29-034,G,12/7/16,SAC,DAL,0,21,3,9,0.333,3,8,0.375,0,1,0,0,0,,0,2,2,1,2,0,0,1,6,3.8
Shabazz Napier,25-117,G,11/8/16,POR,PHO,0,11,2,3,0.667,0,0,,2,3,0.667,0,2,0,0,0,0,2,1,0,2,3,6,3.1
Dewayne Dedmon,27-219,C,3/19/17,SAS,SAC,0,12,3,3,1,3,3,1,0,0,,0,0,,1,3,4,0,1,0,0,3,6,6.5
Willy Hernangomez,22-227,C,1/9/17,NYK,NOP,0,13,3,4,0.75,3,4,0.75,0,0,,0,0,,2,2,4,3,0,0,2,0,6,6.5
Nerlens Noel,22-360,C-F,4/5/17,DAL,LAC,1,22,2,4,0.5,2,4,0.5,0,0,,2,2,1,0,4,4,1,0,1,2,3,6,3.4
Willie Cauley-Stein,23-084,F-C,11/10/16,SAC,LAL,0,12,3,4,0.75,3,4,0.75,0,0,,0,0,,2,2,4,0,1,0,1,2,6,5.6
Nerlens Noel,22-357,C-F,4/2/17,DAL,MIL,0,19,3,4,0.75,3,4,0.75,0,0,,0,0,,1,2,3,2,3,0,0,4,6,8.5
Cristiano Felicio,24-165,F-C,12/19/16,CHI,DET,0,22,3,5,0.6,3,5,0.6,0,0,,0,0,,3,4,7,2,1,1,0,2,6,9.3
Marcus Smart,22-299,G,12/30/16,BOS,MIA,1,34,1,7,0.143,1,6,0.167,0,1,0,4,4,1,1,3,4,2,2,0,1,1,6,5.1
Aron Baynes,30-014,C,12/23/16,DET,GSW,0,17,3,4,0.75,3,4,0.75,0,0,,0,0,,2,0,2,1,0,0,0,1,6,6.1
Vince Carter,39-327,G-F,12/18/16,MEM,UTA,0,18,2,6,0.333,1,4,0.25,1,2,0.5,1,1,1,1,1,2,1,0,0,1,2,6,2.5
Kosta Koufos,27-308,C,12/28/16,SAC,POR,1,23,3,3,1,3,3,1,0,0,,0,0,,3,7,10,0,0,1,1,1,6,8.6
Amir Johnson,29-216,F,12/3/16,BOS,PHI,1,15,3,4,0.75,3,3,1,0,1,0,0,0,,0,2,2,1,0,1,0,2,6,5.6
Domantas Sabonis,20-247,F,1/5/17,OKC,HOU,1,22,3,5,0.6,3,5,0.6,0,0,,0,0,,0,3,3,1,1,2,0,3,6,6.5
Thaddeus Young,28-276,F,3/24/17,IND,DEN,1,30,3,5,0.6,3,5,0.6,0,0,,0,0,,0,3,3,1,0,0,1,3,6,3.1
K.J. McDaniels,24-036,G-F,3/17/17,BRK,BOS,0,19,3,6,0.5,3,5,0.6,0,1,0,0,0,,1,3,4,0,1,0,0,2,6,4.8
Patrick McCaw,21-136,G,3/10/17,GSW,MIN,1,25,3,7,0.429,3,6,0.5,0,1,0,0,0,,1,3,4,1,0,0,1,0,6,3.6
Ron Baker,23-252,G,12/7/16,NYK,CLE,0,10,2,7,0.286,1,3,0.333,1,4,0.25,1,2,0.5,0,1,1,1,0,0,1,0,6,1.5
Marvin Williams,30-149,F,11/15/16,CHO,MIN,1,23,1,9,0.111,1,4,0.25,0,5,0,4,4,1,0,1,1,1,0,1,1,1,6,0.4
DeAndre' Bembry,22-185,F,1/5/17,ATL,NOP,0,15,3,4,0.75,3,3,1,0,1,0,0,0,,0,1,1,0,0,0,0,1,6,4.3
Spencer Dinwiddie,23-329,G,3/1/17,BRK,SAC,0,27,1,5,0.2,1,5,0.2,0,0,,4,4,1,1,3,4,3,0,0,0,3,6,5.4
Tony Snell,25-066,G-F,1/15/17,MIL,ATL,1,22,2,5,0.4,0,0,,2,5,0.4,0,0,,0,0,0,2,1,0,0,1,6,5.3
Lavoy Allen,27-363,F-C,2/1/17,IND,ORL,0,19,1,2,0.5,1,2,0.5,0,0,,4,4,1,0,1,1,1,0,0,1,2,6,4.2
Willy Hernangomez,22-198,C,12/11/16,NYK,LAL,0,20,3,8,0.375,3,7,0.429,0,1,0,0,0,,4,8,12,1,1,2,0,3,6,8.7
Manu Ginobili,39-238,G,3/23/17,SAS,MEM,0,19,1,7,0.143,0,2,0,1,5,0.2,3,3,1,0,2,2,3,2,0,0,4,6,4.6
Deyonta Davis,20-011,F-C,12/13/16,MEM,CLE,0,11,3,3,1,3,3,1,0,0,,0,1,0,1,3,4,0,0,0,0,1,6,5.9
Raymond Felton,32-273,G,3/26/17,LAC,SAC,0,24,2,6,0.333,2,5,0.4,0,1,0,2,2,1,0,0,0,1,1,0,1,1,6,2.9
Lavoy Allen,28-004,F-C,2/8/17,IND,CLE,1,23,3,6,0.5,3,6,0.5,0,0,,0,0,,3,2,5,0,1,0,2,4,6,3.1
Dejounte Murray,20-100,G,12/28/16,SAS,PHO,0,3,2,2,1,2,2,1,0,0,,2,2,1,0,0,0,1,0,0,0,0,6,6.1
Isaiah Whitehead,21-339,G,2/10/17,BRK,MIA,0,16,3,9,0.333,3,7,0.429,0,2,0,0,0,,2,0,2,0,0,0,3,1,6,-1.1
Dario Saric,22-296,F,1/29/17,PHI,CHI,0,16,2,6,0.333,2,3,0.667,0,3,0,2,2,1,1,2,3,1,0,0,1,2,6,2.8
Tony Allen,34-345,G-F,12/21/16,MEM,DET,1,28,3,8,0.375,3,8,0.375,0,0,,0,0,,1,1,2,2,1,0,1,4,6,2.4
Derrick Favors,25-120,F-C,11/12/16,UTA,MIA,1,6,3,3,1,3,3,1,0,0,,0,0,,0,1,1,0,0,0,1,0,6,4.4
Trevor Booker,29-099,F,3/4/17,BRK,POR,0,20,3,6,0.5,3,5,0.6,0,1,0,0,0,,1,5,6,0,1,1,3,2,6,3.1
Troy Daniels,25-201,G,2/1/17,MEM,DEN,0,6,2,3,0.667,0,0,,2,3,0.667,0,0,,0,0,0,0,0,0,1,0,6,3.7
Norman Powell,23-304,G,3/25/17,TOR,DAL,0,14,2,5,0.4,2,3,0.667,0,2,0,2,2,1,0,0,0,1,1,0,3,2,6,1.2
D.J. Augustin,29-078,G,1/27/17,ORL,BOS,0,18,2,6,0.333,2,4,0.5,0,2,0,2,6,0.333,0,1,1,4,0,0,1,2,6,2.3
Nikola Mirotic,25-356,F,2/1/17,CHI,OKC,0,20,2,5,0.4,2,3,0.667,0,2,0,2,2,1,1,3,4,0,0,0,1,0,6,3.9
Bismack Biyombo,24-110,C-F,12/16/16,ORL,BRK,1,25,0,2,0,0,2,0,0,0,,6,8,0.75,3,4,7,2,0,3,0,4,6,9
Diamond Stone,19-278,C,11/14/16,LAC,BRK,0,8,2,6,0.333,2,6,0.333,0,0,,2,2,1,1,1,2,0,0,1,0,3,6,3.1
Jarell Martin,22-320,F,4/9/17,MEM,DET,0,14,3,4,0.75,3,4,0.75,0,0,,0,0,,0,2,2,1,2,1,0,1,6,8
Kris Humphries,32-044,F-C,3/22/17,ATL,WAS,0,12,2,4,0.5,2,4,0.5,0,0,,2,2,1,1,2,3,0,0,0,0,1,6,4.9
Draymond Green,26-324,F,1/22/17,GSW,ORL,1,33,1,7,0.143,1,3,0.333,0,4,0,4,4,1,4,6,10,4,1,0,3,3,6,5.7
Trevor Ariza,31-284,F,4/10/17,HOU,LAC,1,36,3,11,0.273,3,4,0.75,0,7,0,0,0,,0,2,2,2,2,0,2,3,6,0.3
Reggie Jackson,26-326,G,3/8/17,DET,IND,1,23,1,8,0.125,1,4,0.25,0,4,0,4,4,1,0,2,2,5,1,0,2,4,6,2.3
Patrick Beverley,28-180,G,1/8/17,HOU,TOR,1,32,2,6,0.333,2,3,0.667,0,3,0,2,2,1,0,2,2,7,0,1,1,4,6,6.2
Rajon Rondo,31-002,G,2/24/17,CHI,PHO,0,29,3,5,0.6,3,4,0.75,0,1,0,0,0,,1,3,4,9,3,1,1,2,6,13.5
Domantas Sabonis,20-339,F,4/7/17,OKC,PHO,0,9,2,3,0.667,1,1,1,1,2,0.5,1,2,0.5,0,0,0,0,0,0,0,1,6,3.9
Derrick Favors,25-161,F-C,12/23/16,UTA,TOR,0,15,2,8,0.25,2,8,0.25,0,0,,2,2,1,2,5,7,0,0,1,1,4,6,2.2
Montrezl Harrell,22-325,F-C,12/16/16,HOU,NOP,0,16,3,4,0.75,3,3,1,0,1,0,0,0,,1,7,8,1,0,0,0,2,6,7.1
Jeff Green,30-159,F,2/3/17,ORL,TOR,0,13,3,9,0.333,3,8,0.375,0,1,0,0,0,,1,0,1,0,0,0,1,1,6,0.2
Derrick Favors,25-267,F-C,4/8/17,UTA,POR,0,14,3,7,0.429,3,6,0.5,0,1,0,0,1,0,3,0,3,0,0,0,0,1,6,3.6
Gerald Green,31-021,G-F,2/16/17,BOS,CHI,0,12,2,5,0.4,0,1,0,2,4,0.5,0,0,,1,2,3,0,0,0,1,0,6,3.6
Beno Udrih,34-266,G,3/28/17,DET,MIA,0,17,2,6,0.333,2,5,0.4,0,1,0,2,2,1,0,3,3,4,1,0,0,2,6,6.5
Thon Maker,19-331,F-C,1/21/17,MIL,MIA,1,18,1,3,0.333,0,1,0,1,2,0.5,3,4,0.75,1,0,1,0,1,0,0,2,6,4.8
T.J. McConnell,24-284,G,1/3/17,PHI,MIN,1,35,3,9,0.333,3,6,0.5,0,3,0,0,0,,0,7,7,8,2,0,2,1,6,8.2
Frank Kaminsky,23-252,F-C,12/12/16,CHO,IND,0,20,1,8,0.125,0,6,0,1,2,0.5,3,4,0.75,0,4,4,0,1,0,1,0,6,1.6
Joakim Noah,31-339,C,1/29/17,NYK,ATL,1,41,2,5,0.4,2,5,0.4,0,0,,2,2,1,7,7,14,5,3,2,1,6,6,14.8
Denzel Valentine,23-145,G,4/10/17,CHI,ORL,0,10,2,2,1,0,0,,2,2,1,0,0,,0,2,2,1,0,0,2,0,6,4.7
Jahlil Okafor,21-011,C-F,12/26/16,PHI,SAC,1,20,3,5,0.6,3,5,0.6,0,0,,0,0,,1,1,2,2,1,0,3,4,6,2.5
Matt Barnes,36-322,F,1/25/17,SAC,CLE,0,16,2,7,0.286,0,2,0,2,5,0.4,0,0,,2,4,6,3,1,0,1,4,6,5
Jaylen Brown,20-066,F,12/29/16,BOS,CLE,0,12,3,4,0.75,3,4,0.75,0,0,,0,0,,1,2,3,1,0,0,0,1,6,6
Hassan Whiteside,27-163,C,11/23/16,MIA,DET,1,25,3,8,0.375,3,8,0.375,0,0,,0,0,,1,7,8,0,1,1,2,2,6,3.3
Malcolm Brogdon,23-324,G,10/30/16,MIL,DET,0,17,3,7,0.429,3,6,0.5,0,1,0,0,1,0,0,2,2,1,1,0,0,0,6,4.2
T.J. Warren,23-145,F,1/28/17,PHO,DEN,1,20,3,10,0.3,3,9,0.333,0,1,0,0,0,,4,1,5,0,0,0,1,5,6,0.3
Tyreke Evans,27-197,G-F,4/4/17,SAC,DAL,1,28,2,9,0.222,2,7,0.286,0,2,0,2,2,1,1,3,4,5,1,0,1,1,6,5.2
David Lee,33-197,F,11/12/16,SAS,HOU,0,21,2,3,0.667,2,3,0.667,0,0,,2,3,0.667,0,6,6,0,0,1,0,3,6,5.6
Quinn Cook,23-343,G,3/1/17,DAL,ATL,0,14,2,5,0.4,0,1,0,2,4,0.5,0,0,,0,0,0,3,0,0,3,2,6,1.6
Anthony Tolliver,31-234,F-C,1/21/17,SAC,CHI,0,25,2,7,0.286,0,1,0,2,6,0.333,0,0,,0,1,1,0,0,0,1,1,6,0.8
Lance Thomas,28-229,F,12/9/16,NYK,SAC,0,18,2,5,0.4,0,2,0,2,3,0.667,0,0,,1,1,2,0,1,0,1,2,6,3.5
Cole Aldrich,28-038,C,12/8/16,MIN,TOR,0,15,3,3,1,3,3,1,0,0,,0,0,,2,6,8,0,1,0,1,0,6,8.3
Frank Kaminsky,24-007,F-C,4/11/17,CHO,ATL,0,25,3,11,0.273,3,8,0.375,0,3,0,0,1,0,0,1,1,2,0,0,1,1,6,-0.6
David West,36-116,F,12/23/16,GSW,DET,0,14,3,4,0.75,3,4,0.75,0,0,,0,0,,0,1,1,5,1,0,0,3,6,8
Mike Muscala,25-238,F-C,2/24/17,ATL,MIA,0,19,1,5,0.2,1,2,0.5,0,3,0,4,6,0.667,2,7,9,2,1,2,0,0,6,9.4
Gorgui Dieng,26-299,C,11/12/16,MIN,LAC,1,30,3,6,0.5,3,5,0.6,0,1,0,0,0,,3,2,5,2,1,0,1,2,6,6.3
Kosta Koufos,27-251,C,11/1/16,SAC,MIA,0,25,3,4,0.75,3,3,1,0,1,0,0,0,,2,7,9,0,0,1,1,2,6,6.8
Andre Roberson,24-352,G-F,11/20/16,OKC,IND,1,36,2,5,0.4,0,1,0,2,4,0.5,0,0,,1,5,6,1,1,1,0,3,6,6.7
Meyers Leonard,24-256,C-F,11/9/16,POR,LAC,0,22,3,8,0.375,3,6,0.5,0,2,0,0,0,,2,8,10,1,0,1,4,2,6,2
Corey Brewer,30-314,F-G,1/13/17,HOU,MEM,0,17,2,7,0.286,1,3,0.333,1,4,0.25,1,2,0.5,1,3,4,0,0,0,0,2,6,2.3
Jason Smith,31-039,F-C,4/10/17,WAS,DET,0,25,3,5,0.6,3,3,1,0,2,0,0,0,,1,5,6,3,0,1,1,1,6,7.3
Dewayne Dedmon,27-172,C,1/31/17,SAS,OKC,1,17,2,3,0.667,2,3,0.667,0,0,,2,2,1,2,6,8,0,3,1,1,4,6,9
Anthony Tolliver,31-250,F-C,2/6/17,SAC,CHI,0,30,3,4,0.75,3,3,1,0,1,0,0,0,,5,1,6,2,1,0,2,0,6,8.6
Andrew Harrison,22-041,G,12/8/16,MEM,POR,1,26,2,12,0.167,2,8,0.25,0,4,0,2,4,0.5,1,0,1,3,2,0,1,3,6,0.2
Alexis Ajinca,28-190,C,11/12/16,NOP,LAL,0,24,3,4,0.75,3,4,0.75,0,0,,0,0,,3,4,7,0,0,2,0,1,6,8.7
Kyle O'Quinn,26-364,F-C,3/25/17,NYK,SAS,0,13,3,6,0.5,3,6,0.5,0,0,,0,0,,2,4,6,2,1,2,2,1,6,7
Chasson Randle,24-054,G,3/31/17,NYK,MIA,0,10,2,3,0.667,2,3,0.667,0,0,,2,2,1,1,1,2,0,2,0,1,2,6,5.9
P.J. Tucker,31-328,F,3/29/17,TOR,CHO,0,23,2,4,0.5,0,1,0,2,3,0.667,0,0,,2,1,3,1,0,0,2,3,6,3.2
Josh Richardson,23-094,G,12/18/16,MIA,BOS,1,35,3,11,0.273,3,4,0.75,0,7,0,0,0,,0,3,3,0,0,0,0,1,6,0
Tristan Thompson,25-318,F-C,1/25/17,CLE,SAC,1,32,2,3,0.667,2,3,0.667,0,0,,2,6,0.333,3,5,8,1,0,1,0,5,6,6.1
Reggie Bullock,25-250,G-F,11/21/16,DET,HOU,0,10,3,5,0.6,3,4,0.75,0,1,0,0,0,,2,0,2,0,0,0,0,0,6,5.1
Justin Holiday,27-282,G,1/12/17,NYK,CHI,0,17,2,5,0.4,0,1,0,2,4,0.5,0,0,,0,0,0,1,0,0,0,2,6,3.2
Tony Allen,35-075,G-F,3/27/17,MEM,SAC,1,19,3,7,0.429,3,7,0.429,0,0,,0,0,,3,4,7,0,1,0,1,2,6,4.8
Raymond Felton,32-258,G,3/11/17,LAC,PHI,0,22,3,6,0.5,3,5,0.6,0,1,0,0,0,,0,1,1,0,2,0,0,0,6,5.3
Malcolm Brogdon,24-096,G,3/17/17,MIL,LAL,1,32,2,7,0.286,2,3,0.667,0,4,0,2,2,1,0,5,5,2,2,0,2,3,6,3.6
Jason Terry,39-151,G,2/13/17,MIL,DET,0,17,2,3,0.667,0,0,,2,3,0.667,0,0,,0,0,0,0,0,0,0,2,6,3.9
Buddy Hield,22-357,G,12/8/16,NOP,PHI,1,34,2,12,0.167,0,6,0,2,6,0.333,0,0,,0,4,4,2,0,0,1,1,6,-0.4
Alex Len,23-228,C,1/30/17,PHO,MEM,0,21,3,6,0.5,3,6,0.5,0,0,,0,1,0,3,4,7,0,1,1,1,2,6,5.8
Davis Bertans,23-353,F,10/30/16,SAS,MIA,0,17,2,3,0.667,0,0,,2,3,0.667,0,0,,1,0,1,0,0,1,0,2,6,5.3
Alex Len,23-214,C,1/16/17,PHO,UTA,1,21,3,4,0.75,3,4,0.75,0,0,,0,1,0,0,5,5,0,0,2,1,2,6,5.1
Nemanja Bjelica,28-190,F,11/15/16,MIN,CHO,0,21,2,4,0.5,0,0,,2,4,0.5,0,0,,0,2,2,1,0,0,0,2,6,4.5
Archie Goodwin,22-234,G,4/8/17,BRK,CHI,0,11,2,5,0.4,1,3,0.333,1,2,0.5,1,2,0.5,0,1,1,1,1,0,0,0,6,4.9
Paul Zipser,23-043,G-F,4/2/17,CHI,NOP,1,31,2,5,0.4,2,4,0.5,0,1,0,2,2,1,0,4,4,3,1,1,1,3,6,6.1
K.J. McDaniels,24-047,G-F,3/28/17,BRK,PHI,0,19,3,6,0.5,3,4,0.75,0,2,0,0,0,,0,4,4,0,3,0,2,1,6,4.8
Amir Johnson,29-251,F,1/7/17,BOS,NOP,1,24,2,6,0.333,2,5,0.4,0,1,0,2,4,0.5,4,2,6,1,0,1,2,4,6,3
C.J. Miles,29-353,G-F,4/6/17,IND,MIL,0,24,2,7,0.286,0,1,0,2,6,0.333,0,0,,3,1,4,0,3,0,2,1,6,4.9
Dewayne Dedmon,27-185,C,2/13/17,SAS,IND,1,28,3,5,0.6,3,5,0.6,0,0,,0,0,,5,7,12,1,0,0,1,2,6,8.2
Derrick Favors,25-211,F-C,2/11/17,UTA,BOS,1,26,3,5,0.6,3,5,0.6,0,0,,0,0,,3,3,6,0,1,0,0,0,6,7.7
Anthony Bennett,23-273,F,12/12/16,BRK,HOU,0,18,2,3,0.667,2,2,1,0,1,0,2,2,1,2,2,4,0,0,0,0,1,6,6.3
Jose Calderon,35-181,G,3/28/17,ATL,PHO,0,18,2,5,0.4,2,3,0.667,0,2,0,2,2,1,0,1,1,2,0,0,1,1,6,3.6
Mason Plumlee,26-241,C-F,11/1/16,POR,GSW,1,22,3,5,0.6,3,5,0.6,0,0,,0,0,,1,4,5,6,2,0,2,1,6,9.4
Rodney McGruder,25-176,G,1/21/17,MIA,MIL,1,18,2,5,0.4,1,3,0.333,1,2,0.5,1,2,0.5,0,0,0,3,0,0,0,3,6,3.8
Jonas Valanciunas,24-217,C,12/9/16,TOR,BOS,1,24,3,7,0.429,3,7,0.429,0,0,,0,0,,2,8,10,0,0,0,2,2,6,3.3
Shawn Long,24-042,C-F,3/12/17,PHI,LAL,0,12,2,3,0.667,2,3,0.667,0,0,,2,2,1,0,5,5,0,0,0,0,4,6,4.6
Donatas Motiejunas,26-156,F-C,2/23/17,NOP,HOU,0,10,2,3,0.667,1,1,1,1,2,0.5,1,1,1,0,2,2,0,0,0,2,3,6,2.1
Terrence Ross,26-055,F-G,4/1/17,ORL,BRK,1,33,3,10,0.3,3,7,0.429,0,3,0,0,1,0,0,2,2,2,1,0,0,2,6,2
Gorgui Dieng,27-016,C,2/3/17,MIN,DET,1,32,3,9,0.333,3,8,0.375,0,1,0,0,0,,1,11,12,2,1,3,1,3,6,7.2
Raymond Felton,32-173,G,12/16/16,LAC,MIA,0,17,1,3,0.333,1,3,0.333,0,0,,4,4,1,1,2,3,2,0,0,0,1,6,6.6
Troy Daniels,25-197,G,1/28/17,MEM,UTA,0,19,2,4,0.5,0,1,0,2,3,0.667,0,0,,0,0,0,0,0,0,0,2,6,3.2
Patrick Patterson,27-349,F,2/26/17,TOR,POR,0,19,2,5,0.4,0,0,,2,5,0.4,0,0,,0,1,1,0,1,1,0,1,6,4.9
Ian Clark,25-276,G,12/8/16,GSW,UTA,0,20,2,5,0.4,0,2,0,2,3,0.667,0,0,,0,0,0,1,1,0,0,0,6,5
Trey Lyles,21-080,F,1/24/17,UTA,DEN,0,21,2,4,0.5,1,2,0.5,1,2,0.5,1,3,0.333,1,4,5,1,0,0,2,2,6,3
Rudy Gobert,24-141,C,11/14/16,UTA,MEM,1,22,2,3,0.667,2,3,0.667,0,0,,2,2,1,0,5,5,2,1,1,2,5,6,5.3
Trey Burke,24-032,G,12/14/16,WAS,CHO,0,18,3,4,0.75,3,3,1,0,1,0,0,0,,0,1,1,1,0,0,0,2,6,4.6
T.J. McConnell,24-359,G,3/19/17,PHI,BOS,1,28,3,6,0.5,3,5,0.6,0,1,0,0,0,,0,3,3,7,1,0,1,1,6,8.4
Jeff Green,30-110,F,12/16/16,ORL,BRK,0,27,2,8,0.25,2,4,0.5,0,4,0,2,2,1,0,0,0,0,0,0,0,1,6,0.8
Rajon Rondo,31-023,G,3/17/17,CHI,WAS,1,33,3,6,0.5,3,4,0.75,0,2,0,0,0,,1,3,4,10,0,0,3,2,6,7.8
Mirza Teletovic,31-169,F,3/6/17,MIL,PHI,0,21,2,8,0.25,0,2,0,2,6,0.333,0,0,,0,5,5,0,0,0,0,0,6,2.7
Justin Hamilton,26-363,C,3/30/17,BRK,DET,0,17,2,4,0.5,0,1,0,2,3,0.667,0,0,,0,1,1,0,0,0,0,1,6,3.9
Gorgui Dieng,26-347,C,12/30/16,MIN,MIL,1,34,3,6,0.5,3,6,0.5,0,0,,0,0,,1,3,4,3,1,3,0,1,6,9.4
Dante Cunningham,29-326,F,3/14/17,NOP,POR,0,25,3,4,0.75,3,3,1,0,1,0,0,0,,0,10,10,0,0,0,0,1,6,7
Luke Babbitt,27-130,F,10/28/16,MIA,CHO,1,20,2,5,0.4,0,1,0,2,4,0.5,0,0,,0,3,3,0,0,0,0,1,6,3.8
Cody Zeller,24-059,F-C,12/3/16,CHO,MIN,1,35,3,7,0.429,3,7,0.429,0,0,,0,0,,3,6,9,2,1,4,0,3,6,10.2
Andre Iguodala,32-302,G-F,11/25/16,GSW,LAL,0,24,3,5,0.6,3,4,0.75,0,1,0,0,0,,0,4,4,4,1,0,1,0,6,7.7
Derrick Favors,25-122,F-C,11/14/16,UTA,MEM,1,21,2,6,0.333,2,6,0.333,0,0,,2,2,1,0,2,2,0,2,0,1,3,6,3
Ish Smith,28-197,G,1/18/17,DET,ATL,0,18,3,5,0.6,3,3,1,0,2,0,0,0,,0,3,3,4,0,0,1,5,6,4.4
Anthony Bennett,23-266,F,12/5/16,BRK,WAS,0,13,2,2,1,0,0,,2,2,1,0,0,,1,1,2,1,0,0,2,0,6,5.1
Wayne Ellington,29-100,G,2/6/17,MIA,MIN,0,15,2,4,0.5,0,2,0,2,2,1,0,0,,0,2,2,0,0,0,0,0,6,4.6
Marcin Gortat,33-014,C-F,3/3/17,WAS,TOR,1,31,2,7,0.286,2,6,0.333,0,1,0,2,2,1,0,6,6,1,0,0,2,1,6,2
Willie Cauley-Stein,23-069,F-C,10/26/16,SAC,PHO,0,19,3,6,0.5,3,6,0.5,0,0,,0,0,,1,1,2,2,0,0,1,1,6,4
Greg Monroe,26-199,C-F,12/20/16,MIL,CLE,0,18,3,5,0.6,3,5,0.6,0,0,,0,1,0,1,3,4,1,0,0,1,1,6,4.2
Dwight Howard,31-055,C,2/1/17,ATL,MIA,1,25,2,6,0.333,2,6,0.333,0,0,,2,2,1,3,8,11,1,1,2,0,3,6,9
Tristan Thompson,25-279,F-C,12/17/16,CLE,LAL,1,27,3,7,0.429,3,7,0.429,0,0,,0,0,,3,3,6,1,0,0,0,0,6,6
Otto Porter,23-169,F,11/19/16,WAS,MIA,1,37,2,9,0.222,0,3,0,2,6,0.333,0,0,,1,6,7,1,4,0,0,2,6,6.9
Tarik Black,24-345,C-F,11/1/16,LAL,IND,0,19,1,2,0.5,1,2,0.5,0,0,,4,4,1,2,6,8,1,0,1,1,3,6,7.4
Trey Burke,24-059,G,1/10/17,WAS,CHI,0,13,2,4,0.5,0,2,0,2,2,1,0,0,,0,1,1,1,0,0,2,2,6,2.2
E'Twaun Moore,28-024,G,3/24/17,NOP,HOU,0,27,3,6,0.5,3,4,0.75,0,2,0,0,0,,1,1,2,5,0,0,0,3,6,6.3
Greg Monroe,26-150,C-F,11/1/16,MIL,NOP,0,18,2,6,0.333,2,6,0.333,0,0,,2,2,1,4,8,12,6,0,1,2,4,6,9.1
David West,36-214,F,3/31/17,GSW,HOU,0,13,3,6,0.5,3,6,0.5,0,0,,0,0,,1,2,3,1,0,2,3,4,6,1.8
Shaun Livingston,31-063,G,11/13/16,GSW,PHO,0,20,3,5,0.6,3,5,0.6,0,0,,0,2,0,3,1,4,3,0,0,0,2,6,6.6
Jared Dudley,31-156,F-G,12/13/16,PHO,NYK,0,22,2,4,0.5,0,1,0,2,3,0.667,0,0,,0,6,6,1,2,1,3,4,6,4.6
Joe Johnson,35-193,G-F,1/8/17,UTA,MEM,0,17,3,8,0.375,3,7,0.429,0,1,0,0,0,,0,3,3,0,0,0,0,0,6,2.5
Stephen Zimmerman,20-182,C,3/10/17,ORL,CHO,0,18,2,5,0.4,2,5,0.4,0,0,,2,2,1,1,2,3,0,0,0,0,5,6,2.6
Kyle Korver,36-019,G-F,4/5/17,CLE,BOS,0,19,2,2,1,0,0,,2,2,1,0,0,,0,2,2,0,0,0,0,3,6,4.8
Andre Iguodala,32-318,G-F,12/11/16,GSW,MIN,0,29,1,6,0.167,0,3,0,1,3,0.333,3,4,0.75,1,3,4,5,1,1,1,1,6,7.2
Michael Kidd-Gilchrist,23-112,F,1/16/17,CHO,BOS,1,35,3,11,0.273,3,10,0.3,0,1,0,0,0,,2,7,9,1,0,1,1,2,6,2.6
Victor Oladipo,24-257,G,1/16/17,OKC,LAC,1,24,3,11,0.273,3,9,0.333,0,2,0,0,0,,0,3,3,3,2,0,1,1,6,3.1
Jared Dudley,31-110,F-G,10/28/16,PHO,OKC,1,25,1,2,0.5,0,0,,1,2,0.5,3,5,0.6,0,2,2,3,1,0,0,2,6,7.1
Dwight Powell,25-140,F-C,12/7/16,DAL,SAC,0,25,3,7,0.429,3,7,0.429,0,0,,0,0,,2,3,5,5,2,1,0,3,6,9.6
Robin Lopez,28-264,C,12/21/16,CHI,WAS,1,33,3,5,0.6,3,5,0.6,0,0,,0,0,,1,3,4,1,1,1,2,1,6,5.3
Shelvin Mack,26-351,G,4/8/17,UTA,POR,0,27,3,7,0.429,3,5,0.6,0,2,0,0,0,,1,2,3,2,0,0,2,2,6,2.2
Noah Vonleh,21-115,F,12/17/16,POR,GSW,1,24,3,7,0.429,3,7,0.429,0,0,,0,2,0,3,5,8,0,1,0,2,1,6,3.7
JaMychal Green,26-140,F,11/8/16,MEM,DEN,1,26,3,7,0.429,3,6,0.5,0,1,0,0,0,,1,3,4,1,0,0,2,5,6,0.6
Iman Shumpert,26-177,G,12/20/16,CLE,MIL,0,33,2,8,0.25,1,4,0.25,1,4,0.25,1,2,0.5,0,4,4,2,1,0,0,1,6,4
Michael Kidd-Gilchrist,23-140,F,2/13/17,CHO,PHI,1,32,2,2,1,2,2,1,0,0,,2,2,1,2,5,7,2,2,1,2,5,6,8.4
Tyler Ennis,22-220,G,4/1/17,LAL,LAC,0,19,2,5,0.4,0,0,,2,5,0.4,0,0,,0,3,3,3,1,0,1,0,6,6.3
Luc Mbah a Moute,30-100,F,12/18/16,LAC,WAS,1,17,2,4,0.5,2,3,0.667,0,1,0,2,2,1,1,0,1,0,1,0,1,2,6,3.9
Tyler Zeller,26-284,F-C,10/27/16,BOS,CHI,0,20,3,9,0.333,3,9,0.333,0,0,,0,1,0,1,4,5,1,0,2,1,3,6,2.3
Miles Plumlee,28-065,C-F,11/5/16,MIL,SAC,1,15,2,2,1,2,2,1,0,0,,2,2,1,1,2,3,0,0,3,0,3,6,7.6
Davis Bertans,24-078,F,1/29/17,SAS,DAL,1,17,2,5,0.4,1,2,0.5,1,3,0.333,1,1,1,0,3,3,1,0,2,0,2,6,5.5
Jordan McRae,25-294,G,1/16/17,CLE,GSW,0,7,3,4,0.75,3,3,1,0,1,0,0,0,,0,0,0,0,0,0,0,1,6,4
Marco Belinelli,30-231,G-F,11/11/16,CHO,TOR,0,27,2,9,0.222,1,4,0.25,1,5,0.2,1,1,1,0,4,4,0,1,1,1,1,6,2
Jared Dudley,31-134,F-G,11/21/16,PHO,WAS,0,27,3,9,0.333,3,6,0.5,0,3,0,0,0,,1,4,5,4,0,0,1,3,6,3.4
Clint Capela,22-303,F-C,3/17/17,HOU,NOP,1,19,3,9,0.333,3,9,0.333,0,0,,0,2,0,2,2,4,0,1,2,1,2,6,2.7
Malcolm Brogdon,24-043,G,1/23/17,MIL,HOU,0,30,2,8,0.25,2,6,0.333,0,2,0,2,4,0.5,0,2,2,9,4,0,4,1,6,6.9
Gerald Green,31-043,G-F,3/10/17,BOS,DEN,0,15,1,2,0.5,0,0,,1,2,0.5,3,4,0.75,0,3,3,0,2,0,1,0,6,6.5
Lance Thomas,28-233,F,12/13/16,NYK,PHO,0,23,1,4,0.25,0,2,0,1,2,0.5,3,3,1,1,1,2,1,1,0,1,1,6,4.9
Joe Ingles,29-157,F-G,3/8/17,UTA,HOU,0,28,2,6,0.333,0,0,,2,6,0.333,0,0,,1,4,5,6,0,0,2,4,6,5.1
Darren Collison,29-079,G,11/10/16,SAC,LAL,0,23,2,11,0.182,2,11,0.182,0,0,,2,2,1,0,2,2,9,2,0,2,1,6,5.6
Jerian Grant,24-024,G,11/2/16,CHI,BOS,0,13,3,3,1,3,3,1,0,0,,0,0,,0,2,2,3,0,0,1,1,6,6.4
Luc Mbah a Moute,30-121,F,1/8/17,LAC,MIA,1,28,3,8,0.375,3,6,0.5,0,2,0,0,0,,0,1,1,0,1,1,1,0,6,2.6
Domantas Sabonis,20-319,F,3/18/17,OKC,SAC,0,26,2,8,0.25,1,4,0.25,1,4,0.25,1,2,0.5,1,3,4,3,1,0,0,3,6,4.3
Ivica Zubac,19-280,C,12/23/16,LAL,ORL,0,17,2,7,0.286,2,7,0.286,0,0,,2,2,1,1,1,2,1,0,0,1,1,6,2.2
Nerlens Noel,22-325,C-F,3/1/17,DAL,ATL,0,16,3,5,0.6,3,5,0.6,0,0,,0,0,,1,1,2,0,1,1,0,2,6,5.6
James Ennis,26-208,F,1/25/17,MEM,TOR,1,37,2,6,0.333,0,3,0,2,3,0.667,0,0,,2,4,6,1,1,0,2,3,6,3.7
Dewayne Dedmon,27-084,C,11/4/16,SAS,UTA,0,12,3,5,0.6,3,5,0.6,0,0,,0,0,,1,7,8,0,0,3,0,3,6,7.4
Willie Reed,26-259,F-C,1/30/17,MIA,BRK,0,17,3,3,1,3,3,1,0,0,,0,0,,1,5,6,0,0,0,0,3,6,6.1
Ryan Anderson,28-190,F,11/12/16,HOU,SAS,1,37,1,13,0.077,0,6,0,1,7,0.143,3,4,0.75,4,4,8,1,0,0,2,5,6,-2.4
Tobias Harris,24-213,F,2/13/17,DET,MIL,0,20,3,11,0.273,3,9,0.333,0,2,0,0,0,,2,1,3,0,0,0,1,2,6,-0.6
Allen Crabbe,24-357,G-F,4/1/17,POR,PHO,0,24,2,8,0.25,0,2,0,2,6,0.333,0,0,,0,2,2,1,0,1,0,2,6,2.4
Amir Johnson,29-201,F,11/18/16,BOS,GSW,1,16,3,5,0.6,3,5,0.6,0,0,,0,0,,1,1,2,1,0,1,2,0,6,4.1
Malcolm Brogdon,24-009,G,12/20/16,MIL,CLE,0,19,3,6,0.5,3,4,0.75,0,2,0,0,0,,0,1,1,5,1,0,2,4,6,4.2
Joakim Noah,31-294,C,12/15/16,NYK,GSW,1,15,3,10,0.3,3,10,0.3,0,0,,0,0,,6,4,10,1,0,1,1,2,6,5.2
Jordan McRae,25-318,G,2/9/17,CLE,OKC,1,27,2,9,0.222,1,5,0.2,1,4,0.25,1,1,1,2,0,2,0,0,0,1,1,6,0.5
Jarrett Jack,33-120,G,2/25/17,NOP,DAL,0,25,2,3,0.667,2,2,1,0,1,0,2,2,1,0,0,0,4,1,0,2,4,6,4.9
Rudy Gobert,24-201,C,1/13/17,UTA,DET,1,31,3,4,0.75,3,4,0.75,0,0,,0,0,,3,7,10,1,1,3,2,1,6,10
Dwight Powell,25-134,F-C,12/1/16,DAL,CHO,0,24,2,4,0.5,2,4,0.5,0,0,,2,2,1,2,6,8,0,1,1,0,6,6,6.5
Will Barton,26-029,G,2/4/17,DEN,SAS,0,25,3,9,0.333,3,7,0.429,0,2,0,0,0,,1,2,3,5,1,0,3,2,6,2.9
Justin Anderson,23-142,G,4/10/17,PHI,IND,1,21,1,4,0.25,1,2,0.5,0,2,0,4,4,1,0,0,0,0,1,0,2,1,6,2.2
Spencer Dinwiddie,23-344,G,3/16/17,BRK,NYK,0,21,1,2,0.5,0,1,0,1,1,1,3,6,0.5,0,3,3,3,1,0,2,0,6,5.8
Thabo Sefolosha,32-212,G-F,11/30/16,ATL,PHO,0,31,3,6,0.5,3,6,0.5,0,0,,0,0,,1,7,8,1,5,0,1,4,6,8.9
Mirza Teletovic,31-068,F,11/25/16,MIL,TOR,0,13,2,4,0.5,0,0,,2,4,0.5,0,0,,0,0,0,0,0,0,0,0,6,4
George Hill,30-285,G,2/13/17,UTA,LAC,1,26,2,11,0.182,1,5,0.2,1,6,0.167,1,2,0.5,0,1,1,1,0,0,0,2,6,-1.1
Jodie Meeks,29-117,G,12/16/16,ORL,BRK,0,18,1,3,0.333,1,2,0.5,0,1,0,4,5,0.8,0,2,2,3,4,0,0,0,6,10.6
Myles Turner,20-351,F-C,3/10/17,IND,MIL,1,33,3,9,0.333,3,8,0.375,0,1,0,0,0,,1,3,4,1,3,2,1,3,6,5.4
Bobby Brown,32-127,G,1/29/17,HOU,IND,0,3,2,3,0.667,0,1,0,2,2,1,0,0,,0,0,0,0,0,0,0,0,6,4.7
Troy Daniels,25-226,G,2/26/17,MEM,DEN,0,18,2,5,0.4,0,0,,2,5,0.4,0,0,,0,2,2,0,0,0,0,4,6,2.3
Cody Zeller,24-157,F-C,3/11/17,CHO,NOP,1,40,3,7,0.429,3,7,0.429,0,0,,0,2,0,3,6,9,2,2,0,1,5,6,5.8
Luol Deng,31-285,F,1/26/17,LAL,UTA,1,21,3,6,0.5,3,6,0.5,0,0,,0,0,,1,3,4,0,0,0,1,2,6,2.8
Deron Williams,32-278,G,3/31/17,CLE,PHI,0,17,3,8,0.375,3,6,0.5,0,2,0,0,0,,0,1,1,6,0,0,0,4,6,4.5
Timothe Luwawu-Cabarrot,21-319,F,3/24/17,PHI,CHI,1,18,3,4,0.75,3,3,1,0,1,0,0,0,,0,1,1,1,1,1,2,1,6,4.7
DeAndre Jordan,28-195,C,2/1/17,LAC,PHO,1,23,3,3,1,3,3,1,0,0,,0,2,0,2,10,12,2,2,4,3,4,6,10.3
Aaron Brooks,31-338,G,12/17/16,IND,DET,0,18,3,7,0.429,3,6,0.5,0,1,0,0,0,,0,0,0,3,0,0,1,3,6,2.2
Jerian Grant,24-055,G,12/3/16,CHI,DAL,0,25,3,6,0.5,3,6,0.5,0,0,,0,0,,0,1,1,1,0,1,2,3,6,1.5
Tristan Thompson,25-332,F-C,2/8/17,CLE,IND,1,35,3,3,1,3,3,1,0,0,,0,0,,3,7,10,2,0,1,0,3,6,10.2
Beno Udrih,34-268,G,3/30/17,DET,BRK,0,16,2,5,0.4,2,5,0.4,0,0,,2,2,1,0,3,3,5,1,0,1,1,6,7.3
Bismack Biyombo,24-159,C-F,2/3/17,ORL,TOR,0,18,2,4,0.5,2,4,0.5,0,0,,2,4,0.5,2,5,7,1,0,1,0,4,6,5.9
Julius Randle,22-119,F,3/28/17,LAL,WAS,1,32,2,7,0.286,2,6,0.333,0,1,0,2,2,1,0,6,6,5,0,1,3,2,6,4.1
Jamal Crawford,36-227,G,11/2/16,LAC,OKC,0,26,3,11,0.273,3,7,0.429,0,4,0,0,0,,0,0,0,3,1,0,2,2,6,-0.2
Nikola Mirotic,25-288,F,11/25/16,CHI,PHI,0,25,2,5,0.4,1,2,0.5,1,3,0.333,1,3,0.333,1,2,3,2,2,0,2,0,6,5.2
Trey Lyles,20-365,F,11/4/16,UTA,SAS,0,29,1,8,0.125,0,4,0,1,4,0.25,3,4,0.75,2,5,7,2,1,1,0,0,6,6.4
Boris Diaw,34-212,F-C,11/14/16,UTA,MEM,0,21,3,4,0.75,3,4,0.75,0,0,,0,0,,1,0,1,1,1,0,0,5,6,4.8
Michael Kidd-Gilchrist,23-159,F,3/4/17,CHO,DEN,1,22,3,9,0.333,3,9,0.333,0,0,,0,0,,1,2,3,2,2,1,0,1,6,5.9
Wade Baldwin,20-244,G,11/28/16,MEM,CHO,0,15,3,5,0.6,3,3,1,0,2,0,0,2,0,1,2,3,3,0,1,1,3,6,4.8
Luke Babbitt,27-256,F,3/3/17,MIA,ORL,1,14,2,3,0.667,0,0,,2,3,0.667,0,0,,0,0,0,0,0,0,0,1,6,4.3
Devin Harris,34-004,G,3/3/17,DAL,MEM,0,15,3,7,0.429,3,4,0.75,0,3,0,0,2,0,0,1,1,6,0,0,1,3,6,3.8
Matt Barnes,37-022,F,3/31/17,GSW,HOU,1,26,2,4,0.5,2,3,0.667,0,1,0,2,2,1,1,1,2,2,3,0,0,1,6,9
T.J. McConnell,24-231,G,11/11/16,PHI,IND,0,19,1,2,0.5,0,1,0,1,1,1,3,4,0.75,0,4,4,3,0,0,2,1,6,5.5
Ramon Sessions,30-216,G,11/13/16,CHO,CLE,0,17,3,7,0.429,3,7,0.429,0,0,,0,0,,0,0,0,4,1,0,1,0,6,5.1
Terrence Jones,24-291,F,10/26/16,NOP,DEN,0,18,2,6,0.333,2,5,0.4,0,1,0,2,2,1,1,2,3,1,3,0,0,0,6,7.6
Tyler Ennis,22-080,G,11/12/16,HOU,SAS,0,9,3,6,0.5,3,5,0.6,0,1,0,0,0,,1,1,2,1,1,0,1,0,6,4.7
David Lee,33-183,F,10/29/16,SAS,NOP,0,15,3,6,0.5,3,6,0.5,0,0,,0,0,,1,4,5,1,0,0,0,0,6,5.6
Kosta Koufos,27-326,C,1/15/17,SAC,OKC,0,16,3,6,0.5,3,6,0.5,0,0,,0,0,,1,0,1,1,2,1,2,5,6,3.1
Spencer Hawes,28-274,C-F,1/27/17,CHO,NYK,0,25,1,4,0.25,1,2,0.5,0,2,0,4,4,1,2,3,5,1,1,2,2,0,6,7
Rashad Vaughn,20-227,G,3/31/17,MIL,DET,0,17,2,6,0.333,0,2,0,2,4,0.5,0,0,,0,0,0,1,1,0,0,3,6,3.1
Marcus Smart,22-287,G,12/18/16,BOS,MIA,0,27,2,8,0.25,2,7,0.286,0,1,0,2,2,1,1,5,6,4,2,0,3,1,6,4.8
Langston Galloway,25-021,G,12/30/16,NOP,NYK,0,21,2,8,0.25,0,1,0,2,7,0.286,0,0,,0,2,2,1,0,0,1,1,6,1.1
Luc Mbah a Moute,30-107,F,12/25/16,LAC,LAL,1,16,3,9,0.333,3,6,0.5,0,3,0,0,0,,1,1,2,0,0,0,0,1,6,1.5
Tyus Jones,20-311,G,3/17/17,MIN,MIA,0,14,3,6,0.5,3,4,0.75,0,2,0,0,0,,0,0,0,0,0,0,0,1,6,2.6
Kenneth Faried,27-039,F,12/28/16,DEN,MIN,0,16,3,4,0.75,3,4,0.75,0,0,,0,2,0,2,3,5,2,0,0,0,1,6,6.9
Rudy Gobert,24-128,C,11/1/16,UTA,SAS,1,33,1,4,0.25,1,4,0.25,0,0,,4,6,0.667,2,10,12,1,0,0,2,4,6,4.3
Jason Terry,39-199,G,4/2/17,MIL,DAL,0,20,2,4,0.5,0,0,,2,4,0.5,0,0,,0,0,0,2,0,0,1,1,6,4
Zach Randolph,35-186,F,1/18/17,MEM,WAS,0,20,3,14,0.214,3,13,0.231,0,1,0,0,0,,3,6,9,0,0,0,0,1,6,0.9
Frank Kaminsky,23-250,F-C,12/10/16,CHO,CLE,0,29,2,13,0.154,1,8,0.125,1,5,0.2,1,2,0.5,4,2,6,5,0,0,1,1,6,2.8
Luol Deng,31-237,F,12/9/16,LAL,PHO,1,37,3,6,0.5,3,5,0.6,0,1,0,0,0,,0,11,11,0,1,0,1,0,6,6.3
Ron Baker,23-351,G,3/16/17,NYK,BRK,0,25,2,10,0.2,2,7,0.286,0,3,0,2,2,1,0,1,1,3,1,1,0,4,6,2.3
Iman Shumpert,26-138,G,11/11/16,CLE,WAS,0,27,2,4,0.5,2,2,1,0,2,0,2,2,1,2,2,4,0,4,0,2,2,6,7.2
Andrew Bogut,31-354,C,11/16/16,DAL,BOS,1,25,3,7,0.429,3,7,0.429,0,0,,0,0,,1,6,7,4,1,1,1,6,6,5.9
Willy Hernangomez,22-189,C,12/2/16,NYK,MIN,0,17,3,6,0.5,3,6,0.5,0,0,,0,0,,1,3,4,1,0,0,2,2,6,2.5
Kenneth Faried,27-127,F,3/26/17,DEN,NOP,0,20,2,5,0.4,2,5,0.4,0,0,,2,2,1,2,4,6,0,0,0,0,1,6,5.5
Stephen Zimmerman,20-110,C,12/28/16,ORL,CHO,0,6,3,3,1,3,3,1,0,0,,0,0,,1,3,4,0,0,0,0,0,6,6.7
Chinanu Onuaku,20-055,F-C,12/26/16,HOU,PHO,0,8,2,2,1,2,2,1,0,0,,2,2,1,1,2,3,1,1,0,0,1,6,8
Zaza Pachulia,33-024,C,3/6/17,GSW,ATL,1,15,3,6,0.5,3,6,0.5,0,0,,0,0,,1,4,5,2,0,0,0,2,6,5.5
Tim Frazier,26-161,G,4/11/17,NOP,LAL,1,19,1,7,0.143,0,6,0,1,1,1,3,4,0.75,0,1,1,6,0,0,1,2,6,3.8
Michael Kidd-Gilchrist,23-039,F,11/4/16,CHO,BRK,1,34,3,5,0.6,3,5,0.6,0,0,,0,0,,1,8,9,2,2,1,0,2,6,10.1
Kosta Koufos,27-306,C,12/26/16,SAC,PHI,1,15,3,3,1,3,3,1,0,0,,0,2,0,0,3,3,1,2,0,0,5,6,5.9
Pascal Siakam,22-305,F,12/5/16,TOR,CLE,1,18,3,6,0.5,3,6,0.5,0,0,,0,0,,1,1,2,1,1,0,0,1,6,5.3
Trevor Ariza,31-242,F,2/27/17,HOU,IND,1,36,2,10,0.2,2,3,0.667,0,7,0,2,2,1,1,4,5,1,0,0,1,1,6,1
Danny Green,29-176,G-F,12/15/16,SAS,PHO,1,16,2,2,1,0,0,,2,2,1,0,0,,0,1,1,1,0,0,0,4,6,4.8
Sean Kilpatrick,26-314,G,11/15/16,BRK,LAL,1,19,3,7,0.429,3,5,0.6,0,2,0,0,1,0,1,3,4,1,0,0,1,5,6,1.2
Kelly Olynyk,25-267,C-F,1/11/17,BOS,WAS,0,23,2,5,0.4,0,2,0,2,3,0.667,0,0,,0,6,6,3,0,2,2,1,6,6.2
Glenn Robinson,23-018,G-F,1/26/17,IND,MIN,0,17,2,2,1,2,2,1,0,0,,2,2,1,0,0,0,0,0,0,1,2,6,3.6
Taj Gibson,31-247,F,2/26/17,OKC,NOP,0,21,2,9,0.222,2,9,0.222,0,0,,2,2,1,1,4,5,0,0,0,1,2,6,0.6
Rondae Hollis-Jefferson,22-033,F,2/5/17,BRK,TOR,1,20,2,4,0.5,2,3,0.667,0,1,0,2,2,1,1,5,6,2,1,1,2,2,6,6.5
Ron Baker,23-322,G,2/15/17,NYK,OKC,0,18,2,4,0.5,1,2,0.5,1,2,0.5,1,2,0.5,0,1,1,2,0,0,0,2,6,4.5
Udonis Haslem,36-206,F-C,1/1/17,MIA,DET,0,21,2,4,0.5,2,4,0.5,0,0,,2,2,1,1,5,6,0,1,0,2,3,6,4
Marco Belinelli,30-238,G-F,11/18/16,CHO,ATL,0,27,2,7,0.286,1,3,0.333,1,4,0.25,1,2,0.5,0,1,1,3,1,0,1,1,6,3.5
Rondae Hollis-Jefferson,22-075,F,3/19/17,BRK,DAL,1,30,2,6,0.333,2,6,0.333,0,0,,2,2,1,1,8,9,0,0,1,0,2,6,5.6
Goran Dragic,30-201,G,11/23/16,MIA,DET,1,22,1,7,0.143,0,3,0,1,4,0.25,3,5,0.6,1,1,2,4,0,0,3,2,6,0.7
Lucas Nogueira,24-145,C,12/18/16,TOR,ORL,0,17,3,4,0.75,3,4,0.75,0,0,,0,0,,0,5,5,1,0,1,0,1,6,6.9
Salah Mejri,30-239,C,2/9/17,DAL,UTA,0,15,3,4,0.75,3,4,0.75,0,0,,0,0,,1,1,2,0,1,3,0,0,6,8.5
Jon Leuer,27-207,F,12/7/16,DET,CHO,0,23,3,11,0.273,3,7,0.429,0,4,0,0,0,,0,4,4,6,0,0,0,1,6,4.5
JaVale McGee,29-075,C,4/4/17,GSW,MIN,0,8,3,3,1,3,3,1,0,0,,0,0,,1,1,2,0,0,1,0,2,6,6
Jason Smith,30-260,F-C,11/17/16,WAS,NYK,0,11,2,2,1,2,2,1,0,0,,2,2,1,2,1,3,0,0,0,0,0,6,7.1
Brandan Wright,29-128,F-C,2/10/17,MEM,GSW,0,12,3,7,0.429,3,7,0.429,0,0,,0,0,,0,0,0,0,0,2,1,0,6,2.7
Brandon Bass,31-191,F,11/7/16,LAC,DET,0,9,3,5,0.6,3,5,0.6,0,0,,0,0,,0,1,1,1,0,1,0,1,6,5
Andre Roberson,25-069,G-F,2/11/17,OKC,GSW,1,34,3,9,0.333,3,6,0.5,0,3,0,0,0,,5,6,11,1,1,3,2,4,6,6.4
Mirza Teletovic,31-104,F,12/31/16,MIL,CHI,0,23,2,6,0.333,0,2,0,2,4,0.5,0,0,,0,3,3,1,0,0,1,2,6,2.4
Brook Lopez,28-357,C,3/24/17,BRK,WAS,1,22,3,8,0.375,3,6,0.5,0,2,0,0,0,,1,6,7,2,0,0,2,3,6,2.3
Tyler Ulis,20-361,G,12/31/16,PHO,UTA,0,10,3,7,0.429,3,7,0.429,0,0,,0,0,,0,0,0,0,0,0,1,0,6,1.3
Gerald Green,31-064,G-F,3/31/17,BOS,ORL,0,9,3,4,0.75,3,3,1,0,1,0,0,0,,0,0,0,0,0,0,0,1,6,4
Kelly Olynyk,25-280,C-F,1/24/17,BOS,WAS,0,22,3,8,0.375,3,4,0.75,0,4,0,0,0,,1,2,3,0,0,1,1,2,6,1.8
Jonas Valanciunas,24-338,C,4/9/17,TOR,NYK,1,20,3,8,0.375,3,8,0.375,0,0,,0,0,,3,4,7,0,1,0,1,1,6,4.5
Adreian Payne,25-274,F-C,11/19/16,MIN,MEM,0,15,2,4,0.5,2,3,0.667,0,1,0,2,2,1,1,2,3,1,2,1,2,4,6,5.1
Cory Joseph,25-114,G,12/12/16,TOR,MIL,0,27,3,8,0.375,3,7,0.429,0,1,0,0,0,,1,3,4,7,2,0,3,2,6,6.3
Andrew Harrison,22-029,G,11/26/16,MEM,MIA,0,24,0,2,0,0,1,0,0,1,0,6,8,0.75,0,2,2,1,1,1,1,3,6,4.6
Richaun Holmes,23-119,F-C,2/11/17,PHI,MIA,0,16,2,2,1,2,2,1,0,0,,2,3,0.667,4,0,4,1,0,1,1,4,6,6.6
Cody Zeller,24-156,F-C,3/10/17,CHO,ORL,1,31,3,4,0.75,3,4,0.75,0,0,,0,0,,0,7,7,3,0,0,1,3,6,6.4
Gerald Henderson,29-017,G,12/26/16,PHI,SAC,1,25,3,9,0.333,3,6,0.5,0,3,0,0,0,,0,2,2,1,0,0,0,1,6,1.8
Shabazz Napier,25-174,G,1/4/17,POR,GSW,0,12,2,4,0.5,1,2,0.5,1,2,0.5,1,2,0.5,0,0,0,1,1,0,2,1,6,2.9
David Lee,33-344,F,4/8/17,SAS,LAC,0,13,3,6,0.5,3,6,0.5,0,0,,0,0,,0,0,0,0,0,0,0,0,6,3
Maurice Harkless,23-215,F-G,12/12/16,POR,LAC,1,32,3,7,0.429,3,6,0.5,0,1,0,0,0,,3,3,6,0,1,0,1,2,6,4.5
Ty Lawson,29-043,G,12/16/16,SAC,MEM,0,22,2,5,0.4,1,3,0.333,1,2,0.5,1,2,0.5,0,3,3,1,0,0,2,1,6,2.1
DeMarre Carroll,30-152,F,12/26/16,TOR,POR,1,27,2,7,0.286,0,2,0,2,5,0.4,0,0,,1,1,2,1,0,0,1,0,6,2.6
Dante Cunningham,29-338,F,3/26/17,NOP,DEN,1,29,3,6,0.5,3,4,0.75,0,2,0,0,0,,2,6,8,0,0,2,0,1,6,7.2
Gorgui Dieng,27-079,C,4/7/17,MIN,UTA,1,27,2,4,0.5,2,4,0.5,0,0,,2,2,1,2,3,5,1,2,1,0,1,6,9.3
Willy Hernangomez,22-182,C,11/25/16,NYK,CHO,0,20,3,5,0.6,3,5,0.6,0,0,,0,0,,2,7,9,2,0,1,4,3,6,4.1
Rodney Stuckey,30-233,G,12/10/16,IND,POR,0,27,1,5,0.2,1,3,0.333,0,2,0,4,4,1,0,3,3,2,0,0,3,2,6,1.4
Lucas Nogueira,24-125,C,11/28/16,TOR,PHI,0,22,1,2,0.5,1,2,0.5,0,0,,4,6,0.667,2,2,4,0,1,1,1,1,6,6.5
Andre Iguodala,32-320,G-F,12/13/16,GSW,NOP,0,31,2,6,0.333,0,1,0,2,5,0.4,0,0,,2,6,8,3,0,0,0,2,6,7.1
Frank Kaminsky,23-273,F-C,1/2/17,CHO,CHI,0,20,2,5,0.4,2,4,0.5,0,1,0,2,2,1,1,2,3,3,1,0,2,2,6,4.9
Evan Turner,28-143,G,3/19/17,POR,MIA,0,20,3,8,0.375,3,6,0.5,0,2,0,0,0,,0,3,3,1,1,0,1,3,6,2
Tony Snell,25-078,G-F,1/27/17,MIL,TOR,1,27,2,4,0.5,0,0,,2,4,0.5,0,0,,0,2,2,1,0,2,1,3,6,4.5
Garrett Temple,30-304,G,3/8/17,SAC,SAS,0,25,2,7,0.286,2,3,0.667,0,4,0,2,3,0.667,0,7,7,3,4,0,1,3,6,7.5
Rondae Hollis-Jefferson,22-033,F,2/5/17,BRK,TOR,1,20,2,4,0.5,2,3,0.667,0,1,0,2,2,1,1,5,6,2,1,1,2,2,6,6.5
Isaiah Whitehead,21-270,G,12/3/16,BRK,MIL,1,24,3,6,0.5,3,4,0.75,0,2,0,0,0,,0,3,3,0,0,0,3,3,6,-0.3
Corey Brewer,30-322,F-G,1/21/17,HOU,MEM,0,24,2,3,0.667,1,1,1,1,2,0.5,1,1,1,0,5,5,2,0,1,0,2,6,7.5
Jarell Martin,22-204,F,12/14/16,MEM,CLE,0,23,2,2,1,2,2,1,0,0,,2,2,1,1,5,6,1,1,1,1,2,6,8.2
Kosta Koufos,27-258,C,11/8/16,SAC,NOP,1,23,3,7,0.429,3,7,0.429,0,0,,0,0,,2,5,7,0,0,0,1,3,6,3
Luis Scola,36-211,F,11/27/16,BRK,SAC,0,12,2,6,0.333,2,5,0.4,0,1,0,2,2,1,1,0,1,0,2,0,1,3,6,3.1
Corey Brewer,31-033,F-G,4/7/17,LAL,SAC,0,22,2,7,0.286,2,5,0.4,0,2,0,2,2,1,0,2,2,1,2,0,4,1,6,0.8
Brandon Jennings,27-036,G,10/29/16,NYK,MEM,0,16,2,4,0.5,0,0,,2,4,0.5,0,0,,0,2,2,3,1,0,2,1,6,5.3
Jonathon Simmons,27-052,G-F,11/5/16,SAS,LAC,0,19,3,6,0.5,3,5,0.6,0,1,0,0,0,,1,3,4,2,2,0,2,0,6,6
Luke Babbitt,27-264,F,3/11/17,MIA,TOR,1,20,2,4,0.5,0,0,,2,4,0.5,0,0,,0,1,1,3,2,0,1,4,6,5.8
Nikola Mirotic,26-023,F,3/6/17,CHI,DET,0,18,2,7,0.286,1,2,0.5,1,5,0.2,1,2,0.5,0,0,0,1,0,0,0,3,6,1
Leandro Barbosa,34-015,G,12/13/16,PHO,NYK,0,18,3,5,0.6,3,3,1,0,2,0,0,0,,0,3,3,0,0,1,1,0,6,4.3
Rajon Rondo,30-307,G,12/25/16,CHI,SAS,1,30,3,7,0.429,3,6,0.5,0,1,0,0,0,,2,4,6,2,2,0,2,1,6,5.9
Mindaugas Kuzminskas,27-092,F,1/19/17,NYK,WAS,1,18,1,5,0.2,0,0,,1,5,0.2,3,4,0.75,0,1,1,2,0,0,1,1,6,2.8
Willie Cauley-Stein,23-155,F-C,1/20/17,SAC,MEM,0,12,2,3,0.667,2,3,0.667,0,0,,2,2,1,0,2,2,0,1,1,0,3,6,5.8
Taj Gibson,31-254,F,3/5/17,OKC,DAL,0,23,2,5,0.4,2,5,0.4,0,0,,2,3,0.667,0,2,2,1,0,0,1,2,6,2.4
Alan Anderson,34-073,G-F,12/28/16,LAC,NOP,0,5,2,3,0.667,0,1,0,2,2,1,0,0,,0,1,1,0,0,0,0,0,6,5
James Johnson,29-342,F,1/27/17,MIA,CHI,0,31,3,15,0.2,3,13,0.231,0,2,0,0,1,0,4,5,9,9,1,1,3,1,6,5.2
Ian Mahinmi,30-115,C,2/28/17,WAS,GSW,0,16,2,4,0.5,2,4,0.5,0,0,,2,4,0.5,4,2,6,1,0,1,2,3,6,4.8
Aaron Brooks,31-318,G,11/27/16,IND,LAC,0,16,3,6,0.5,3,5,0.6,0,1,0,0,0,,2,2,4,3,2,1,1,0,6,8.8
Jerami Grant,22-258,F,11/25/16,OKC,DEN,0,29,1,6,0.167,1,3,0.333,0,3,0,4,6,0.667,0,5,5,0,1,1,1,3,6,2.4
Matt Barnes,36-241,F,11/5/16,SAC,MIL,0,14,2,7,0.286,2,6,0.333,0,1,0,2,2,1,0,2,2,2,0,0,0,0,6,3.9
Steven Adams,23-119,C,11/16/16,OKC,HOU,1,33,3,7,0.429,3,7,0.429,0,0,,0,0,,0,6,6,1,0,3,2,1,6,4.5
Draymond Green,27-031,F,4/4/17,GSW,MIN,1,28,2,6,0.333,2,4,0.5,0,2,0,2,2,1,0,1,1,5,1,1,2,1,6,5.7
Nik Stauskas,23-168,G,3/24/17,PHI,CHI,0,24,2,4,0.5,1,3,0.333,1,1,1,1,2,0.5,1,1,2,2,0,0,1,0,6,5
Shaun Livingston,31-078,G,11/28/16,GSW,ATL,0,16,3,5,0.6,3,5,0.6,0,0,,0,0,,0,2,2,1,1,0,0,1,6,5.6
Isaiah Whitehead,21-361,G,3/4/17,BRK,POR,0,23,3,5,0.6,3,4,0.75,0,1,0,0,0,,0,0,0,1,0,0,1,3,6,2.2
Ricky Rubio,26-036,G,11/26/16,MIN,GSW,1,29,2,5,0.4,2,3,0.667,0,2,0,2,2,1,1,1,2,7,0,0,1,1,6,7.8
Jeff Green,30-117,F,12/23/16,ORL,LAL,0,20,2,3,0.667,1,1,1,1,2,0.5,1,2,0.5,0,0,0,1,0,0,4,2,6,0.2
Andre Iguodala,33-051,G-F,3/20/17,GSW,OKC,0,22,1,4,0.25,1,3,0.333,0,1,0,4,4,1,0,4,4,4,2,1,0,0,6,10.3
Nikola Mirotic,25-341,F,1/17/17,CHI,DAL,0,22,2,4,0.5,0,1,0,2,3,0.667,0,0,,2,3,5,0,1,1,0,4,6,6.4
Monta Ellis,31-008,G,11/3/16,IND,MIL,1,34,2,4,0.5,2,2,1,0,2,0,2,2,1,0,3,3,10,3,0,1,1,6,13.5
Iman Shumpert,26-266,G,3/19/17,CLE,LAL,1,28,3,8,0.375,3,6,0.5,0,2,0,0,0,,0,1,1,2,1,0,0,1,6,3.9
Lance Thomas,28-188,F,10/29/16,NYK,MEM,0,19,3,5,0.6,3,4,0.75,0,1,0,0,0,,1,2,3,0,0,0,0,1,6,4.6
Willy Hernangomez,22-289,C,3/12/17,NYK,BRK,1,17,3,8,0.375,3,7,0.429,0,1,0,0,0,,1,9,10,1,0,1,0,1,6,6
J.R. Smith,31-092,G-F,12/10/16,CLE,CHO,1,32,2,6,0.333,0,0,,2,6,0.333,0,0,,0,2,2,2,0,0,0,4,6,3
Trey Burke,24-000,G,11/12/16,WAS,CHI,0,17,3,7,0.429,3,7,0.429,0,0,,0,0,,0,0,0,3,1,0,1,0,6,4.4
Dorian Finney-Smith,23-201,F,11/21/16,DAL,SAS,1,27,2,5,0.4,2,2,1,0,3,0,2,2,1,0,1,1,2,0,0,0,4,6,3.4
Michael Kidd-Gilchrist,23-184,F,3/29/17,CHO,TOR,1,32,2,9,0.222,2,9,0.222,0,0,,2,2,1,0,5,5,0,0,0,0,2,6,1.2
Larry Nance Jr.,23-316,F,11/12/16,LAL,NOP,0,22,3,5,0.6,3,5,0.6,0,0,,0,0,,1,7,8,3,2,0,0,5,6,8.6
Tarik Black,25-070,C-F,1/31/17,LAL,DEN,1,18,3,5,0.6,3,5,0.6,0,0,,0,1,0,4,4,8,0,1,1,2,3,6,5.8
David Lee,33-208,F,11/23/16,SAS,CHO,0,18,2,4,0.5,2,4,0.5,0,0,,2,2,1,0,3,3,4,0,2,3,4,6,4.5
Jameer Nelson,34-365,G,2/8/17,DEN,ATL,1,31,2,8,0.25,0,3,0,2,5,0.4,0,0,,1,0,1,8,1,0,1,3,6,6.3
Tyus Jones,20-293,G,2/27/17,MIN,SAC,0,27,2,8,0.25,1,3,0.333,1,5,0.2,1,1,1,0,1,1,6,1,0,1,1,6,5.3
Brian Roberts,31-120,G,4/2/17,CHO,OKC,0,14,3,6,0.5,3,4,0.75,0,2,0,0,0,,0,1,1,2,1,0,1,1,6,4.3
Kevin Seraphin,26-343,F,11/14/16,IND,ORL,0,19,3,8,0.375,3,8,0.375,0,0,,0,0,,5,5,10,3,1,1,2,1,6,8
Salah Mejri,30-237,C,2/7/17,DAL,POR,0,15,2,2,1,2,2,1,0,0,,2,2,1,1,4,5,0,0,3,0,3,6,8.2
Justin Holiday,27-313,G,2/12/17,NYK,SAS,0,13,2,3,0.667,0,1,0,2,2,1,0,0,,0,0,0,1,0,0,3,1,6,2
Spencer Hawes,28-244,C-F,12/28/16,CHO,ORL,0,8,3,4,0.75,3,3,1,0,1,0,0,0,,0,3,3,2,0,0,1,0,6,5.7
Dwight Powell,25-252,F-C,3/29/17,DAL,NOP,0,15,3,5,0.6,3,4,0.75,0,1,0,0,0,,0,2,2,0,0,0,0,2,6,3.5
Danny Green,29-235,G-F,2/12/17,SAS,NYK,1,34,2,13,0.154,0,3,0,2,10,0.2,0,0,,2,1,3,1,1,0,1,2,6,-0.7
Trey Burke,24-026,G,12/8/16,WAS,DEN,0,12,3,6,0.5,3,6,0.5,0,0,,0,0,,1,0,1,2,1,0,1,0,6,5.1
Malcolm Delaney,27-234,G,10/31/16,ATL,SAC,0,16,2,6,0.333,0,2,0,2,4,0.5,0,0,,0,2,2,4,0,0,0,3,6,4.8
Omri Casspi,28-189,F,12/28/16,SAC,POR,0,14,2,3,0.667,1,2,0.5,1,1,1,1,2,0.5,0,5,5,2,0,0,1,1,6,5.8
Wilson Chandler,29-305,F,3/11/17,DEN,SAC,1,29,3,13,0.231,3,8,0.375,0,5,0,0,0,,1,3,4,1,0,0,0,3,6,-0.8
Wayne Selden,22-187,G-F,4/5/17,MEM,OKC,0,23,2,6,0.333,2,3,0.667,0,3,0,2,2,1,0,3,3,3,0,0,0,1,6,5.2
Andrew Bogut,32-059,C,1/26/17,DAL,OKC,1,17,3,5,0.6,3,5,0.6,0,0,,0,0,,1,2,3,0,0,0,2,4,6,1.4
Manu Ginobili,39-213,G,2/26/17,SAS,LAL,0,20,2,4,0.5,0,0,,2,4,0.5,0,0,,0,0,0,4,2,0,0,5,6,6.8
Markieff Morris,27-108,F,12/19/16,WAS,IND,1,27,2,9,0.222,2,6,0.333,0,3,0,2,2,1,0,6,6,1,1,1,2,3,6,1.5
Jonathon Simmons,27-046,G-F,10/30/16,SAS,MIA,0,25,2,8,0.25,2,7,0.286,0,1,0,2,2,1,0,2,2,3,0,0,0,1,6,3.5
Kevin Seraphin,27-066,F,2/11/17,IND,MIL,0,8,3,5,0.6,3,5,0.6,0,0,,0,0,,0,0,0,0,0,1,0,2,6,3.6
James Michael McAdoo,24-052,F,2/25/17,GSW,BRK,0,15,3,3,1,3,3,1,0,0,,0,2,0,1,0,1,0,0,0,0,0,6,5
Willie Cauley-Stein,23-079,F-C,11/5/16,SAC,MIL,0,17,2,2,1,2,2,1,0,0,,2,2,1,0,3,3,1,1,1,1,3,6,6.5
Willie Reed,26-204,F-C,12/6/16,MIA,NYK,0,10,2,5,0.4,2,5,0.4,0,0,,2,4,0.5,3,1,4,0,0,0,0,0,6,4.9
Dwight Powell,25-196,F-C,2/1/17,DAL,PHI,0,10,2,5,0.4,1,4,0.25,1,1,1,1,2,0.5,1,2,3,1,1,1,1,4,6,4
Brandon Rush,31-266,G-F,3/30/17,MIN,LAL,1,20,2,7,0.286,0,2,0,2,5,0.4,0,0,,0,0,0,0,0,1,0,0,6,2.6
Jordan Clarkson,24-238,G,1/31/17,LAL,DEN,0,21,3,7,0.429,3,6,0.5,0,1,0,0,0,,0,3,3,2,1,0,3,1,6,2.2
Rashad Vaughn,20-086,G,11/10/16,MIL,NOP,0,15,3,5,0.6,3,4,0.75,0,1,0,0,0,,0,2,2,0,0,0,0,0,6,4.3
Thomas Robinson,25-253,F,11/25/16,LAL,GSW,0,16,3,8,0.375,3,8,0.375,0,0,,0,2,0,3,7,10,0,1,1,1,3,6,4.5
Alex Abrines,23-163,G-F,1/11/17,OKC,MEM,0,17,2,3,0.667,0,0,,2,3,0.667,0,0,,0,0,0,0,0,0,0,3,6,3.5
Jameer Nelson,35-025,G,3/6/17,DEN,SAC,1,30,3,5,0.6,3,4,0.75,0,1,0,0,0,,1,0,1,6,1,0,0,3,6,8.4
Steven Adams,23-114,C,11/11/16,OKC,LAC,1,32,2,5,0.4,2,5,0.4,0,0,,2,2,1,1,4,5,1,0,0,1,4,6,3.3
Nikola Jokic,21-260,C-F,11/5/16,DEN,DET,1,23,3,9,0.333,3,9,0.333,0,0,,0,0,,2,4,6,0,1,1,1,3,6,3
Gerald Green,30-282,G-F,11/3/16,BOS,CLE,0,9,2,6,0.333,0,2,0,2,4,0.5,0,0,,0,0,0,0,0,0,0,1,6,2.2
Troy Daniels,25-244,G,3/16/17,MEM,ATL,0,19,2,7,0.286,0,2,0,2,5,0.4,0,0,,1,3,4,0,0,0,1,3,6,1.3
Justin Anderson,22-365,G,11/18/16,DAL,MEM,0,32,2,9,0.222,2,5,0.4,0,4,0,2,2,1,0,6,6,2,1,1,4,1,6,1
Isaiah Whitehead,21-297,G,12/30/16,BRK,WAS,1,25,2,8,0.25,1,4,0.25,1,4,0.25,1,2,0.5,0,1,1,2,1,0,2,1,6,1.1
Joe Johnson,35-245,G-F,3/1/17,UTA,MIN,0,22,3,8,0.375,3,6,0.5,0,2,0,0,0,,1,3,4,3,0,0,1,0,6,4.3
Troy Daniels,25-177,G,1/8/17,MEM,UTA,0,13,2,4,0.5,0,2,0,2,2,1,0,0,,0,2,2,0,0,0,1,1,6,3.2
Rudy Gobert,24-147,C,11/20/16,UTA,DEN,1,26,3,6,0.5,3,6,0.5,0,0,,0,0,,3,4,7,1,0,2,0,4,6,6.8
Terrence Jones,24-308,F,11/12/16,NOP,LAL,0,21,2,7,0.286,2,5,0.4,0,2,0,2,3,0.667,1,3,4,1,0,0,1,1,6,2.4
Boris Diaw,34-343,F-C,3/25/17,UTA,LAC,1,21,3,9,0.333,3,7,0.429,0,2,0,0,0,,2,3,5,5,1,0,0,4,6,6.1
Willie Reed,26-316,F-C,3/28/17,MIA,DET,0,16,3,5,0.6,3,5,0.6,0,0,,0,0,,2,5,7,0,0,0,0,1,6,6.2
Marco Belinelli,30-294,G-F,1/13/17,CHO,PHI,0,22,1,6,0.167,1,4,0.25,0,2,0,4,5,0.8,0,4,4,1,2,0,5,0,6,0.7
Solomon Hill,25-259,F,12/2/16,NOP,LAC,1,25,2,3,0.667,0,0,,2,3,0.667,0,0,,0,2,2,0,0,1,1,0,6,5
Kyle Korver,35-261,G-F,12/3/16,ATL,TOR,1,25,3,7,0.429,3,4,0.75,0,3,0,0,0,,0,0,0,1,2,0,2,2,6,2.2
Al Jefferson,32-037,C-F,2/10/17,IND,WAS,0,17,3,6,0.5,3,6,0.5,0,0,,0,0,,1,7,8,1,0,0,1,1,6,5.1
Luc Mbah a Moute,30-185,F,3/13/17,LAC,UTA,1,21,2,2,1,1,1,1,1,1,1,1,1,1,0,1,1,0,1,0,0,3,6,5.5
Ramon Sessions,30-295,G,1/31/17,CHO,POR,0,13,0,2,0,0,2,0,0,0,,6,6,1,0,1,1,2,0,0,2,0,6,4.3
Joakim Noah,31-301,C,12/22/16,NYK,ORL,1,22,2,5,0.4,2,5,0.4,0,0,,2,2,1,4,3,7,1,2,0,3,2,6,5.9
Alan Williams,24-002,F-C,1/30/17,PHO,MEM,0,5,2,3,0.667,2,3,0.667,0,0,,2,3,0.667,1,2,3,0,0,1,1,0,6,5.3
Tyus Jones,20-326,G,4/1/17,MIN,SAC,0,11,3,5,0.6,3,4,0.75,0,1,0,0,0,,0,1,1,3,1,0,1,0,6,6.1
Alexis Ajinca,28-194,C,11/16/16,NOP,ORL,0,25,2,8,0.25,2,8,0.25,0,0,,2,2,1,1,5,6,0,0,3,1,4,6,2.9
Reggie Jackson,26-332,G,3/14/17,DET,CLE,1,20,3,13,0.231,3,12,0.25,0,1,0,0,0,,0,1,1,5,1,0,1,2,6,1.1
Wayne Ellington,29-121,G,2/27/17,MIA,DAL,0,17,2,6,0.333,0,0,,2,6,0.333,0,1,0,0,2,2,2,0,1,1,0,6,3.9
Derrick Favors,25-171,F-C,1/2/17,UTA,BRK,1,18,3,7,0.429,3,7,0.429,0,0,,0,0,,1,2,3,0,0,0,0,3,6,2.4
Amir Johnson,29-224,F,12/11/16,BOS,OKC,1,29,3,8,0.375,3,7,0.429,0,1,0,0,0,,4,4,8,3,1,2,1,3,6,7.9
Yogi Ferrell,23-193,G,11/18/16,BRK,OKC,0,19,1,5,0.2,1,2,0.5,0,3,0,4,4,1,3,1,4,1,0,0,2,2,6,3.2
Rajon Rondo,30-250,G,10/29/16,CHI,IND,1,25,2,5,0.4,2,3,0.667,0,2,0,2,2,1,1,2,3,13,1,0,4,0,6,10.7
Ben McLemore,23-314,G,12/21/16,SAC,UTA,1,17,3,6,0.5,3,5,0.6,0,1,0,0,0,,1,1,2,0,2,0,2,1,6,3.6
Cheick Diallo,20-096,F,12/18/16,NOP,SAS,0,10,3,4,0.75,3,4,0.75,0,0,,0,0,,1,3,4,0,0,0,0,0,6,6
Luke Babbitt,27-132,F,10/30/16,MIA,SAS,1,25,2,6,0.333,0,1,0,2,5,0.4,0,0,,0,5,5,4,0,0,0,2,6,6.1
Luis Scola,36-204,F,11/20/16,BRK,POR,0,14,1,4,0.25,1,2,0.5,0,2,0,4,5,0.8,1,1,2,1,0,0,1,2,6,3.1
Roy Hibbert,29-358,C,12/3/16,CHO,MIN,0,18,2,8,0.25,2,8,0.25,0,0,,2,2,1,2,1,3,0,0,2,2,1,6,1.9
Sheldon McClellan,24-002,G,12/23/16,WAS,MIL,0,23,1,5,0.2,1,2,0.5,0,3,0,4,4,1,0,2,2,2,0,0,0,2,6,4.1
Ramon Sessions,30-269,G,1/5/17,CHO,DET,0,22,3,8,0.375,3,6,0.5,0,2,0,0,0,,0,1,1,3,1,0,0,1,6,4.6
Ricky Rubio,26-117,G,2/15/17,MIN,DEN,1,34,1,5,0.2,1,1,1,0,4,0,4,4,1,1,2,3,5,3,0,4,2,6,5.9
Tony Parker,34-168,G,11/1/16,SAS,UTA,1,33,3,5,0.6,3,5,0.6,0,0,,0,1,0,0,3,3,6,0,0,1,3,6,6.2
Semaj Christon,24-050,G,12/21/16,OKC,NOP,0,14,3,7,0.429,3,5,0.6,0,2,0,0,0,,0,0,0,5,0,0,0,1,6,5.4
Ramon Sessions,30-221,G,11/18/16,CHO,ATL,0,15,2,5,0.4,1,4,0.25,1,1,1,1,2,0.5,0,0,0,1,0,1,1,1,6,2.9
Tony Snell,25-090,G-F,2/8/17,MIL,MIA,1,34,2,6,0.333,0,2,0,2,4,0.5,0,0,,0,2,2,1,0,0,1,1,6,2.5
Richaun Holmes,23-017,F-C,11/1/16,PHI,ORL,0,23,3,6,0.5,3,6,0.5,0,0,,0,0,,1,6,7,2,0,1,2,2,6,4.8
Noah Vonleh,21-069,F,11/1/16,POR,GSW,0,12,2,7,0.286,0,2,0,2,5,0.4,0,0,,0,1,1,0,1,0,1,0,6,2.2
Timothe Luwawu-Cabarrot,21-276,F,2/9/17,PHI,ORL,0,8,2,4,0.5,1,3,0.333,1,1,1,1,2,0.5,1,0,1,1,0,0,0,4,6,3.4
Alex Len,23-136,C,10/30/16,PHO,GSW,0,18,2,7,0.286,2,7,0.286,0,0,,2,2,1,1,7,8,1,1,3,0,4,6,6.9
Justin Hamilton,26-286,C,1/12/17,BRK,NOP,0,16,3,9,0.333,3,5,0.6,0,4,0,0,0,,1,3,4,0,0,2,0,2,6,3.1
Jared Dudley,31-215,F-G,2/10/17,PHO,CHI,0,14,2,4,0.5,0,1,0,2,3,0.667,0,0,,1,1,2,1,0,0,0,1,6,5.3
Julius Randle,22-015,F,12/14/16,LAL,BRK,1,31,2,8,0.25,2,8,0.25,0,0,,2,5,0.4,1,9,10,1,0,0,0,5,6,2.1
Tony Parker,34-202,G,12/5/16,SAS,MIL,1,18,3,8,0.375,3,7,0.429,0,1,0,0,0,,1,0,1,5,0,0,2,3,6,2.6
Jason Smith,30-294,F-C,12/21/16,WAS,CHI,0,12,2,4,0.5,2,4,0.5,0,0,,2,3,0.667,1,2,3,1,0,1,0,1,6,5.9
Dragan Bender,19-058,F,1/14/17,PHO,SAS,0,21,2,4,0.5,0,1,0,2,3,0.667,0,0,,0,6,6,1,0,0,0,5,6,4.5
J.R. Smith,31-060,G-F,11/8/16,CLE,ATL,1,32,2,13,0.154,0,3,0,2,10,0.2,0,0,,1,1,2,3,2,0,1,1,6,1.4
Jared Dudley,31-265,F-G,4/1/17,PHO,POR,0,16,2,4,0.5,2,3,0.667,0,1,0,2,2,1,0,0,0,2,2,0,2,1,6,5
David West,36-204,F,3/21/17,GSW,DAL,0,15,2,3,0.667,2,3,0.667,0,0,,2,2,1,0,5,5,3,2,0,3,1,6,6.9
Joakim Noah,31-274,C,11/25/16,NYK,CHO,1,18,3,5,0.6,3,5,0.6,0,0,,0,0,,4,5,9,1,1,0,0,3,6,8.5
Khris Middleton,25-224,F-G,3/24/17,MIL,ATL,1,32,1,13,0.077,1,9,0.111,0,4,0,4,4,1,0,3,3,3,3,0,3,4,6,-1.3
Alex Len,23-195,C,12/28/16,PHO,SAS,0,20,2,4,0.5,2,4,0.5,0,0,,2,2,1,1,4,5,2,1,0,1,3,6,6.1
Julius Randle,22-004,F,12/3/16,LAL,MEM,1,29,3,8,0.375,3,7,0.429,0,1,0,0,3,0,2,4,6,2,0,0,1,5,6,1.4
Seth Curry,26-085,G,11/16/16,DAL,BOS,0,32,3,7,0.429,3,6,0.5,0,1,0,0,0,,0,4,4,4,0,0,2,1,6,3.9
Kentavious Caldwell-Pope,23-314,G,12/28/16,DET,MIL,1,30,3,7,0.429,3,7,0.429,0,0,,0,0,,0,2,2,7,1,0,1,1,6,7.4
Nikola Jokic,21-267,C-F,11/12/16,DEN,DET,0,20,2,7,0.286,2,7,0.286,0,0,,2,2,1,2,1,3,1,1,0,1,1,6,3.9
Alan Anderson,34-104,G-F,1/28/17,LAC,GSW,0,11,2,4,0.5,0,1,0,2,3,0.667,0,0,,0,0,0,1,1,0,0,0,6,5.7
DeAndre Jordan,28-199,C,2/5/17,LAC,BOS,1,31,2,6,0.333,2,6,0.333,0,0,,2,4,0.5,4,12,16,3,0,0,1,1,6,8.9
Patty Mills,28-219,G,3/18/17,SAS,MEM,0,22,2,8,0.25,0,0,,2,8,0.25,0,0,,0,2,2,2,0,0,0,2,6,2.4
Spencer Hawes,28-199,C-F,11/13/16,CHO,CLE,0,20,3,7,0.429,3,7,0.429,0,0,,0,0,,2,3,5,2,1,1,1,3,6,5.5
Caris LeVert,22-133,G-F,1/5/17,BRK,IND,0,21,2,3,0.667,0,0,,2,3,0.667,0,0,,1,1,2,1,1,0,0,1,6,7
Ersan Ilyasova,29-178,F,11/9/16,PHI,IND,0,21,2,6,0.333,1,4,0.25,1,2,0.5,1,2,0.5,0,2,2,2,1,0,0,1,6,4.8
Jerami Grant,22-268,F,12/5/16,OKC,ATL,0,25,3,6,0.5,3,5,0.6,0,1,0,0,0,,0,2,2,3,2,0,1,3,6,5.5
Tyler Zeller,26-294,F-C,11/6/16,BOS,DEN,1,26,3,7,0.429,3,7,0.429,0,0,,0,0,,0,5,5,2,1,1,1,5,6,3.9
Omer Asik,30-144,C,11/25/16,NOP,POR,1,18,2,2,1,2,2,1,0,0,,2,2,1,0,4,4,0,0,0,0,2,6,5.8
Bismack Biyombo,24-114,C-F,12/20/16,ORL,MIA,1,31,3,4,0.75,3,4,0.75,0,0,,0,4,0,2,7,9,1,0,1,1,3,6,5.5
Paul Pierce,39-036,F-G,11/18/16,LAC,SAC,0,9,2,2,1,0,0,,2,2,1,0,0,,0,0,0,1,0,0,0,2,6,5.3
Brandan Wright,29-133,F-C,2/15/17,MEM,NOP,0,12,3,3,1,3,3,1,0,0,,0,0,,0,1,1,0,0,0,0,0,6,5.4
Stanley Johnson,20-275,F,2/28/17,DET,POR,0,28,2,6,0.333,0,3,0,2,3,0.667,0,0,,2,5,7,1,2,0,1,1,6,6.8
Steven Adams,23-162,C,12/29/16,OKC,MEM,1,27,1,9,0.111,1,9,0.111,0,0,,4,8,0.5,8,6,14,2,0,2,3,2,6,4.9
David Nwaba,24-057,G,3/12/17,LAL,PHI,1,16,1,3,0.333,1,2,0.5,0,1,0,4,4,1,0,1,1,0,0,1,0,2,6,4.5
Roy Hibbert,30-022,C,1/2/17,CHO,CHI,1,22,2,4,0.5,2,4,0.5,0,0,,2,2,1,0,1,1,0,0,0,1,2,6,2.5
Seth Curry,26-071,G,11/2/16,DAL,UTA,0,15,3,4,0.75,3,3,1,0,1,0,0,0,,0,1,1,1,0,0,0,0,6,5.4
Monta Ellis,31-137,G,3/12/17,IND,MIA,0,19,2,6,0.333,1,5,0.2,1,1,1,1,2,0.5,0,1,1,2,0,0,1,1,6,2.5
Emmanuel Mudiay,20-277,G,12/7/16,DEN,BRK,1,18,2,10,0.2,2,7,0.286,0,3,0,2,4,0.5,1,1,2,1,0,0,0,1,6,0.3
Donatas Motiejunas,26-122,F-C,1/20/17,NOP,BRK,0,12,2,5,0.4,0,0,,2,5,0.4,0,0,,0,2,2,0,0,1,0,1,6,4.2
Terrence Ross,26-024,F-G,3/1/17,ORL,NYK,1,37,3,10,0.3,3,5,0.6,0,5,0,0,0,,0,5,5,2,1,0,1,1,6,2.7
Alexis Ajinca,28-324,C,3/26/17,NOP,DEN,0,19,3,6,0.5,3,6,0.5,0,0,,0,0,,3,6,9,0,2,1,0,1,6,9.2
Jason Terry,39-205,G,4/8/17,MIL,PHI,0,18,2,4,0.5,0,1,0,2,3,0.667,0,0,,0,2,2,0,0,0,3,2,6,0.8
Shaun Livingston,31-073,G,11/23/16,GSW,LAL,0,17,3,4,0.75,3,4,0.75,0,0,,0,0,,0,2,2,2,0,0,0,0,6,6.4
Jonas Valanciunas,24-210,C,12/2/16,TOR,LAL,1,24,2,4,0.5,2,4,0.5,0,0,,2,2,1,1,6,7,1,0,1,0,3,6,6.7
Juan Hernangomez,21-083,F,12/20/16,DEN,LAC,0,6,2,4,0.5,2,3,0.667,0,1,0,2,2,1,1,1,2,0,0,0,0,0,6,5
Jamal Murray,20-045,G,4/9/17,DEN,OKC,1,36,3,9,0.333,3,6,0.5,0,3,0,0,0,,0,6,6,5,0,0,1,1,6,4.8
Mason Plumlee,27-035,C-F,4/9/17,DEN,OKC,0,18,2,6,0.333,2,6,0.333,0,0,,2,3,0.667,1,2,3,1,2,2,1,4,6,5
Kyle Korver,35-284,G-F,12/26/16,ATL,MIN,0,23,2,7,0.286,0,1,0,2,6,0.333,0,0,,0,3,3,1,0,0,0,1,6,3.1
Andrew Nicholson,27-011,F,12/19/16,WAS,IND,0,7,2,2,1,0,0,,2,2,1,0,0,,0,2,2,1,0,1,1,0,6,6.4
Taj Gibson,31-215,F,1/25/17,CHI,ATL,1,28,3,10,0.3,3,9,0.333,0,1,0,0,2,0,5,5,10,1,0,1,0,3,6,4.6
Nicolas Batum,27-350,F-G,11/28/16,CHO,MEM,1,23,1,5,0.2,1,3,0.333,0,2,0,4,4,1,0,2,2,4,0,0,2,1,6,3.9
J.J. Barea,32-262,G,3/15/17,DAL,WAS,0,20,3,8,0.375,3,4,0.75,0,4,0,0,0,,0,2,2,13,0,0,0,1,6,10.9
Jonas Jerebko,29-278,F,12/5/16,BOS,HOU,1,21,2,5,0.4,0,2,0,2,3,0.667,0,0,,3,2,5,0,1,1,1,1,6,6.3
Ian Mahinmi,30-130,C,3/15/17,WAS,DAL,0,19,3,6,0.5,3,6,0.5,0,0,,0,0,,0,5,5,0,0,1,0,3,6,4
Alex Len,23-178,C,12/11/16,PHO,NOP,0,15,1,5,0.2,1,5,0.2,0,0,,4,6,0.667,1,3,4,1,0,1,0,4,6,3.5
Cristiano Felicio,24-156,F-C,12/10/16,CHI,MIA,0,17,2,3,0.667,2,3,0.667,0,0,,2,2,1,4,3,7,0,1,0,0,3,6,8.2
Justin Anderson,23-102,G,3/1/17,PHI,MIA,0,26,3,4,0.75,3,3,1,0,1,0,0,0,,2,2,4,2,1,0,2,2,6,6
Alex Abrines,23-213,G-F,3/2/17,OKC,POR,1,10,2,3,0.667,0,1,0,2,2,1,0,0,,0,0,0,0,0,0,0,5,6,2.7
C.J. Miles,29-304,G-F,2/16/17,IND,WAS,0,26,3,7,0.429,3,6,0.5,0,1,0,0,0,,0,1,1,1,2,0,0,1,6,4.9
Sean Kilpatrick,27-007,G,1/13/17,BRK,TOR,0,22,2,5,0.4,2,3,0.667,0,2,0,2,2,1,0,2,2,0,0,0,0,2,6,3.1
Omer Asik,30-141,C,11/22/16,NOP,ATL,1,22,2,3,0.667,2,3,0.667,0,0,,2,2,1,1,5,6,1,0,0,0,2,6,6.8
Nikola Mirotic,26-017,F,2/28/17,CHI,DEN,0,20,2,4,0.5,1,1,1,1,3,0.333,1,1,1,0,1,1,2,0,1,2,3,6,3.2
Shelvin Mack,26-201,G,11/9/16,UTA,CHO,1,24,3,11,0.273,3,8,0.375,0,3,0,0,0,,1,2,3,5,1,0,1,2,6,3.5
Tyler Johnson,24-305,G,3/8/17,MIA,CHO,0,22,2,6,0.333,0,2,0,2,4,0.5,0,0,,0,1,1,0,0,0,3,3,6,-1.3
Wayne Ellington,29-107,G,2/13/17,MIA,ORL,0,21,2,7,0.286,0,1,0,2,6,0.333,0,0,,0,0,0,0,0,0,0,2,6,1.1
Michael Kidd-Gilchrist,23-085,F,12/20/16,CHO,LAL,1,30,3,11,0.273,3,11,0.273,0,0,,0,0,,5,6,11,0,1,0,1,0,6,4.8
Mike Miller,36-360,F-G,2/13/17,DEN,GSW,0,11,2,2,1,0,0,,2,2,1,0,0,,0,2,2,0,0,0,0,2,6,5.2
Cameron Payne,22-201,G,2/25/17,CHI,CLE,0,12,2,3,0.667,0,0,,2,3,0.667,0,0,,0,1,1,1,0,0,2,1,6,3.3
C.J. Miles,29-278,G-F,1/21/17,IND,UTA,0,28,2,8,0.25,1,3,0.333,1,5,0.2,1,2,0.5,0,2,2,1,1,1,2,3,6,0.6
Dante Exum,21-160,G,12/20/16,UTA,GSW,1,26,2,2,1,0,0,,2,2,1,0,0,,0,1,1,0,0,0,3,2,6,1.9
Gorgui Dieng,26-342,C,12/25/16,MIN,OKC,1,29,3,7,0.429,3,7,0.429,0,0,,0,0,,3,3,6,0,2,0,2,3,6,4.1
Al Jefferson,31-335,C-F,12/4/16,IND,LAC,0,18,2,4,0.5,2,4,0.5,0,0,,2,3,0.667,0,4,4,2,0,0,0,2,6,5.4
Alex Len,23-255,C,2/26/17,PHO,MIL,1,14,2,7,0.286,2,7,0.286,0,0,,2,2,1,4,5,9,0,2,0,0,1,6,7.8
Reggie Jackson,26-291,G,2/1/17,DET,NOP,1,21,2,7,0.286,2,4,0.5,0,3,0,2,2,1,0,0,0,3,0,0,1,0,6,3
Steven Adams,23-179,C,1/15/17,OKC,SAC,1,20,3,6,0.5,3,6,0.5,0,0,,0,0,,1,3,4,1,1,0,3,1,6,2.9
Tyson Chandler,34-131,C,2/10/17,PHO,CHI,1,12,3,4,0.75,3,4,0.75,0,0,,0,0,,1,4,5,2,0,0,1,1,6,6.3
Ben McLemore,23-258,G,10/26/16,SAC,PHO,0,17,3,7,0.429,3,5,0.6,0,2,0,0,1,0,0,0,0,2,0,0,1,0,6,2.3
Enes Kanter,24-207,C,12/13/16,OKC,POR,0,19,1,7,0.143,1,6,0.167,0,1,0,4,7,0.571,5,2,7,1,0,0,4,1,6,0.7
Will Barton,25-357,G,12/28/16,DEN,MIN,0,19,3,6,0.5,3,5,0.6,0,1,0,0,0,,0,0,0,2,1,0,1,1,6,4
Jared Dudley,31-257,F-G,3/24/17,PHO,BOS,0,28,2,3,0.667,1,1,1,1,2,0.5,1,2,0.5,2,2,4,10,0,0,1,5,6,10.3
Al Jefferson,31-361,C-F,12/30/16,IND,CHI,0,17,2,6,0.333,2,6,0.333,0,0,,2,2,1,2,5,7,2,0,0,1,0,6,5.9
Sam Dekker,22-195,F,11/17/16,HOU,POR,0,17,2,3,0.667,2,2,1,0,1,0,2,2,1,1,1,2,1,0,0,1,0,6,5.4
Draymond Green,26-344,F,2/11/17,GSW,OKC,1,34,2,7,0.286,2,6,0.333,0,1,0,2,2,1,0,8,8,8,3,1,2,5,6,9.6
Boris Diaw,34-272,F-C,1/13/17,UTA,DET,0,18,2,3,0.667,2,3,0.667,0,0,,2,2,1,0,1,1,5,0,0,1,1,6,7.1
Alex Len,23-260,C,3/3/17,PHO,OKC,1,13,2,4,0.5,2,3,0.667,0,1,0,2,2,1,1,1,2,1,0,0,0,4,6,4.1
Troy Daniels,25-213,G,2/13/17,MEM,BRK,0,16,2,5,0.4,0,1,0,2,4,0.5,0,0,,0,1,1,1,0,0,0,0,6,4.3
Noah Vonleh,21-108,F,12/10/16,POR,IND,0,7,2,2,1,2,2,1,0,0,,2,2,1,1,1,2,0,0,0,0,1,6,6
Rodney McGruder,25-133,G,12/9/16,MIA,CLE,1,37,3,10,0.3,3,6,0.5,0,4,0,0,0,,4,4,8,5,2,0,2,3,6,6.5
Deron Williams,32-207,G,1/19/17,DAL,MIA,1,32,2,8,0.25,1,3,0.333,1,5,0.2,1,2,0.5,0,3,3,9,0,0,2,3,6,4.8
P.J. Tucker,31-315,F,3/16/17,TOR,OKC,0,18,2,6,0.333,1,3,0.333,1,3,0.333,1,2,0.5,0,3,3,1,0,1,1,0,6,3.5
Tyson Chandler,34-059,C,11/30/16,PHO,ATL,1,25,3,5,0.6,3,5,0.6,0,0,,0,0,,3,6,9,1,3,1,3,4,6,7.4
Terrence Jones,24-325,F,11/29/16,NOP,LAL,0,26,2,7,0.286,2,4,0.5,0,3,0,2,2,1,1,7,8,0,0,0,1,2,6,2.9
Shaun Livingston,31-191,G,3/21/17,GSW,DAL,0,20,3,4,0.75,3,4,0.75,0,0,,0,0,,1,1,2,3,1,0,1,0,6,7.5
Glenn Robinson,23-015,G-F,1/23/17,IND,NYK,0,18,3,3,1,3,3,1,0,0,,0,0,,1,2,3,0,2,0,1,3,6,6.2
Mike Dunleavy,36-102,F-G,12/26/16,CLE,DET,0,28,2,4,0.5,1,3,0.333,1,1,1,1,2,0.5,0,4,4,1,1,0,1,2,6,4.7
Glenn Robinson,23-052,G-F,3/1/17,IND,SAS,0,16,3,4,0.75,3,3,1,0,1,0,0,1,0,0,2,2,1,3,0,0,0,6,8.3
Jason Smith,31-026,F-C,3/28/17,WAS,LAL,0,17,2,6,0.333,1,3,0.333,1,3,0.333,1,1,1,1,3,4,0,0,1,1,1,6,3.5
Rondae Hollis-Jefferson,22-099,F,4/12/17,BRK,CHI,1,31,2,7,0.286,2,7,0.286,0,0,,2,2,1,2,6,8,1,0,1,2,2,6,3.7
Larry Nance Jr.,24-038,F,2/8/17,LAL,DET,0,19,3,5,0.6,3,5,0.6,0,0,,0,0,,1,6,7,0,0,0,3,1,6,2.8
Quincy Acy,26-171,F,3/26/17,BRK,ATL,0,22,2,4,0.5,1,1,1,1,3,0.333,1,2,0.5,0,5,5,0,3,0,0,3,6,6.9
Jahlil Okafor,21-076,C-F,3/1/17,PHI,MIA,1,22,3,11,0.273,3,11,0.273,0,0,,0,0,,2,5,7,2,0,1,5,2,6,-1.3
Aaron Gordon,21-097,F,12/22/16,ORL,NYK,1,19,3,8,0.375,3,5,0.6,0,3,0,0,0,,0,2,2,1,0,0,1,2,6,1.1
Aron Baynes,30-019,C,12/28/16,DET,MIL,0,18,3,3,1,3,3,1,0,0,,0,0,,0,4,4,0,1,0,0,4,6,5.7
Jeff Green,30-093,F,11/29/16,ORL,SAS,0,25,3,10,0.3,3,8,0.375,0,2,0,0,0,,1,2,3,2,0,0,0,2,6,2.1
Jared Dudley,31-231,F-G,2/26/17,PHO,MIL,0,25,2,5,0.4,0,1,0,2,4,0.5,0,0,,0,2,2,4,1,1,2,1,6,6
Spencer Dinwiddie,23-351,G,3/23/17,BRK,PHO,0,23,3,6,0.5,3,5,0.6,0,1,0,0,0,,0,4,4,2,2,1,0,0,6,8.3
Zaza Pachulia,33-039,C,3/21/17,GSW,DAL,1,14,3,3,1,3,3,1,0,0,,0,0,,1,5,6,0,0,0,1,3,6,5.1
Manu Ginobili,39-211,G,2/24/17,SAS,LAC,0,22,2,5,0.4,1,1,1,1,4,0.25,1,1,1,2,0,2,4,3,0,0,1,6,10.1
Manu Ginobili,39-130,G,12/5/16,SAS,MIL,0,21,2,7,0.286,1,4,0.25,1,3,0.333,1,2,0.5,0,2,2,1,4,0,2,1,6,4.4
Dennis Schroder,23-122,G,1/15/17,ATL,MIL,1,24,3,8,0.375,3,8,0.375,0,0,,0,0,,0,2,2,6,0,0,5,0,6,1.4
Roy Hibbert,30-009,C,12/20/16,CHO,LAL,0,9,2,3,0.667,2,3,0.667,0,0,,2,2,1,0,2,2,0,0,1,0,1,6,5.6
DeAndre Jordan,28-226,C,3/4/17,LAC,CHI,1,31,3,5,0.6,3,5,0.6,0,0,,0,0,,4,10,14,3,0,1,3,3,6,8.1
Adreian Payne,25-260,F-C,11/5/16,MIN,OKC,0,6,2,3,0.667,2,2,1,0,1,0,2,2,1,0,1,1,0,0,0,0,0,6,5
Dion Waiters,25-097,G,3/17/17,MIA,MIN,1,12,3,3,1,3,3,1,0,0,,0,0,,0,2,2,3,0,0,2,0,6,5.8
Khris Middleton,25-182,F-G,2/10/17,MIL,LAL,0,21,2,7,0.286,1,5,0.2,1,2,0.5,1,2,0.5,0,1,1,6,3,0,1,2,6,7.2
James Johnson,29-361,F,2/15/17,MIA,HOU,0,31,3,10,0.3,3,8,0.375,0,2,0,0,0,,0,6,6,5,1,0,4,4,6,0.9
Lou Williams,30-019,G,11/15/16,LAL,BRK,0,17,2,11,0.182,2,9,0.222,0,2,0,2,2,1,0,2,2,1,0,0,2,0,6,-1.6
JaMychal Green,26-170,F,12/8/16,MEM,POR,1,34,2,8,0.25,2,6,0.333,0,2,0,2,2,1,3,15,18,2,1,0,3,5,6,5.2
Ben McLemore,23-327,G,1/3/17,SAC,DEN,1,15,2,4,0.5,0,1,0,2,3,0.667,0,0,,0,2,2,0,0,0,0,2,6,3.8
Salah Mejri,30-177,C,12/9/16,DAL,IND,1,27,3,4,0.75,3,4,0.75,0,0,,0,0,,1,4,5,0,4,1,0,0,6,11
Patty Mills,28-141,G,12/30/16,SAS,POR,0,22,3,4,0.75,3,4,0.75,0,0,,0,0,,0,1,1,4,2,0,2,3,6,6.3
Rodney Hood,24-169,G-F,4/7/17,UTA,MIN,0,21,2,8,0.25,1,2,0.5,1,6,0.167,1,1,1,0,3,3,2,0,1,1,2,6,2.4
Troy Daniels,25-251,G,3/23/17,MEM,SAS,0,20,2,4,0.5,0,0,,2,4,0.5,0,0,,0,0,0,0,0,0,2,2,6,1.2
Ed Davis,27-247,F,2/7/17,POR,DAL,0,18,3,5,0.6,3,5,0.6,0,0,,0,0,,3,2,5,1,1,0,1,2,6,6.3
Will Barton,26-051,G,2/26/17,DEN,MEM,0,25,2,5,0.4,1,2,0.5,1,3,0.333,1,2,0.5,0,2,2,3,1,0,2,0,6,4.6
Meyers Leonard,24-316,C-F,1/8/17,POR,DET,0,18,2,8,0.25,0,4,0,2,4,0.5,0,0,,0,4,4,2,0,0,0,3,6,2.6
Kris Humphries,31-333,F-C,1/4/17,ATL,ORL,0,14,2,5,0.4,2,4,0.5,0,1,0,2,2,1,0,0,0,0,0,1,0,0,6,4
Bismack Biyombo,24-195,C-F,3/11/17,ORL,CLE,0,16,2,4,0.5,2,4,0.5,0,0,,2,2,1,2,6,8,0,0,0,0,2,6,6.4
Andre Drummond,23-217,C,3/15/17,DET,UTA,1,20,3,4,0.75,3,4,0.75,0,0,,0,0,,0,5,5,0,1,0,0,3,6,5.7
Dewayne Dedmon,27-109,C,11/29/16,SAS,ORL,0,17,3,4,0.75,3,4,0.75,0,0,,0,1,0,1,7,8,0,1,2,1,2,6,7.4
Pascal Siakam,22-318,F,12/18/16,TOR,ORL,1,28,2,4,0.5,2,3,0.667,0,1,0,2,2,1,3,4,7,0,0,4,2,4,6,6.5
Ramon Sessions,30-207,G,11/4/16,CHO,BRK,0,21,1,7,0.143,1,5,0.2,0,2,0,4,6,0.667,0,2,2,4,0,0,2,2,6,1.3
Roy Hibbert,29-338,C,11/13/16,CHO,CLE,0,13,3,5,0.6,3,5,0.6,0,0,,0,0,,2,1,3,0,0,0,0,2,6,4.6
Luc Mbah a Moute,30-083,F,12/1/16,LAC,CLE,1,30,3,7,0.429,3,5,0.6,0,2,0,0,0,,0,3,3,1,5,0,2,4,6,5.3
Domantas Sabonis,20-288,F,2/15/17,OKC,NYK,1,24,3,8,0.375,3,7,0.429,0,1,0,0,0,,2,3,5,0,1,0,0,3,6,3.7
Andrew Bogut,31-333,C,10/26/16,DAL,IND,1,20,3,5,0.6,3,5,0.6,0,0,,0,2,0,2,4,6,3,0,1,1,3,6,6.1
Semaj Christon,24-141,G,3/22/17,OKC,PHI,0,18,3,4,0.75,3,3,1,0,1,0,0,0,,0,1,1,1,0,0,1,1,6,4
Harrison Barnes,24-237,F,1/22/17,DAL,LAL,1,27,3,12,0.25,3,10,0.3,0,2,0,0,0,,2,3,5,2,0,0,1,0,6,1.5
Leandro Barbosa,34-090,G,2/26/17,PHO,MIL,0,19,3,7,0.429,3,6,0.5,0,1,0,0,0,,0,1,1,3,0,0,1,1,6,3.3
Gorgui Dieng,27-084,C,4/12/17,MIN,HOU,1,27,3,8,0.375,3,8,0.375,0,0,,0,0,,3,5,8,2,0,0,3,2,6,2.8
Dejounte Murray,20-163,G,3/1/17,SAS,IND,1,21,2,6,0.333,1,3,0.333,1,3,0.333,1,2,0.5,0,1,1,6,1,0,3,2,6,3.9
Dewayne Dedmon,27-204,C,3/4/17,SAS,MIN,1,18,3,3,1,3,3,1,0,0,,0,0,,2,2,4,1,0,1,2,2,6,5.7
David Lee,33-341,F,4/5/17,SAS,LAL,0,26,3,4,0.75,3,4,0.75,0,0,,0,0,,1,3,4,6,1,2,1,3,6,10.4
Lucas Nogueira,24-132,C,12/5/16,TOR,CLE,0,15,2,2,1,2,2,1,0,0,,2,3,0.667,1,2,3,0,1,1,1,0,6,7
Glenn Robinson,22-336,G-F,12/9/16,IND,DAL,0,8,2,3,0.667,0,0,,2,3,0.667,0,0,,0,1,1,0,0,1,0,0,6,5.7
Langston Galloway,25-027,G,1/5/17,NOP,ATL,0,18,2,7,0.286,0,1,0,2,6,0.333,0,0,,1,1,2,1,2,0,0,3,6,4.4
Thon Maker,19-354,F-C,2/13/17,MIL,DET,1,17,3,10,0.3,3,6,0.5,0,4,0,0,0,,2,3,5,0,0,0,3,1,6,-0.9
Derrick Williams,25-226,F,1/6/17,MIA,LAL,0,15,1,7,0.143,1,4,0.25,0,3,0,4,6,0.667,1,5,6,2,0,1,0,3,6,3.8
Jerami Grant,22-235,F,11/2/16,OKC,LAC,0,18,2,6,0.333,2,6,0.333,0,0,,2,4,0.5,0,2,2,0,0,2,1,1,6,2.4
Ish Smith,28-197,G,1/18/17,DET,ATL,0,18,3,5,0.6,3,3,1,0,2,0,0,0,,0,3,3,4,0,0,1,5,6,4.4
Rakeem Christmas,25-108,F,3/19/17,IND,TOR,0,16,2,4,0.5,2,4,0.5,0,0,,2,2,1,2,3,5,1,0,0,0,1,6,6.6
Myles Turner,20-356,F-C,3/15/17,IND,CHO,1,37,3,7,0.429,3,7,0.429,0,0,,0,0,,0,11,11,2,2,3,1,3,6,8.9
Jared Dudley,31-261,F-G,3/28/17,PHO,ATL,0,35,2,11,0.182,1,5,0.2,1,6,0.167,1,2,0.5,0,8,8,7,3,2,1,6,6,7
Cameron Payne,22-204,G,2/28/17,CHI,DEN,0,17,2,10,0.2,0,5,0,2,5,0.4,0,0,,1,1,2,3,0,0,0,1,6,2.5
Kevon Looney,20-294,F-C,11/26/16,GSW,MIN,1,18,2,3,0.667,2,3,0.667,0,0,,2,2,1,1,2,3,2,1,0,0,1,6,8
Kris Humphries,31-284,F-C,11/16/16,ATL,MIL,0,15,2,4,0.5,2,3,0.667,0,1,0,2,2,1,1,1,2,1,0,2,0,2,6,6.3
Nik Stauskas,23-022,G,10/29/16,PHI,ATL,0,29,2,7,0.286,0,4,0,2,3,0.667,0,0,,0,5,5,1,0,1,3,3,6,0.6
Greg Monroe,26-265,C-F,2/24/17,MIL,UTA,0,21,2,8,0.25,2,8,0.25,0,0,,2,2,1,5,3,8,2,0,0,2,3,6,3.8
Bojan Bogdanovic,27-319,G-F,3/3/17,WAS,TOR,0,20,1,5,0.2,1,3,0.333,0,2,0,4,4,1,0,1,1,1,0,0,0,1,6,3.5
Trevor Ariza,31-247,F,3/4/17,HOU,MEM,1,29,2,8,0.25,1,2,0.5,1,6,0.167,1,2,0.5,1,8,9,1,1,0,2,2,6,2.8
Cody Zeller,24-105,F-C,1/18/17,CHO,POR,1,25,3,7,0.429,3,7,0.429,0,0,,0,0,,3,7,10,0,0,1,2,4,6,3.6
Dwight Howard,31-024,C,1/1/17,ATL,SAS,1,34,2,4,0.5,2,4,0.5,0,0,,2,4,0.5,4,4,8,1,0,1,2,4,6,5
Ish Smith,28-262,G,3/24/17,DET,ORL,1,16,3,7,0.429,3,7,0.429,0,0,,0,0,,0,3,3,0,0,0,1,1,6,1.8
Cory Joseph,25-067,G,10/26/16,TOR,DET,0,22,3,6,0.5,3,6,0.5,0,0,,0,0,,2,2,4,2,1,0,1,1,6,6
David Lee,33-344,F,4/8/17,SAS,LAC,0,13,3,6,0.5,3,6,0.5,0,0,,0,0,,0,0,0,0,0,0,0,0,6,3
Lance Stephenson,26-160,G-F,2/12/17,MIN,CHI,0,14,3,5,0.6,3,5,0.6,0,0,,0,0,,0,0,0,1,0,0,1,1,6,3
Lucas Nogueira,24-109,C,11/12/16,TOR,NYK,0,26,3,3,1,3,3,1,0,0,,0,0,,4,6,10,1,3,5,0,2,6,16.1
Marquese Chriss,19-140,F,11/19/16,PHO,PHI,1,20,2,7,0.286,0,2,0,2,5,0.4,0,2,0,0,2,2,1,0,0,3,3,6,-1.8
Rodney McGruder,25-172,G,1/17/17,MIA,HOU,1,16,3,4,0.75,3,4,0.75,0,0,,0,2,0,0,0,0,0,1,0,1,4,6,2
Pau Gasol,36-188,F-C,1/10/17,SAS,MIL,1,28,3,9,0.333,3,8,0.375,0,1,0,0,0,,3,8,11,4,0,0,2,0,6,6.2
Gordon Hayward,26-272,F-G,12/20/16,UTA,GSW,1,27,2,10,0.2,2,4,0.5,0,6,0,2,3,0.667,1,2,3,2,0,0,2,3,6,-1.1
Cody Zeller,24-057,F-C,12/1/16,CHO,DAL,1,31,3,5,0.6,3,5,0.6,0,0,,0,0,,1,6,7,1,0,1,0,2,6,6.8
Cameron Payne,22-171,G,1/26/17,OKC,DAL,0,13,2,4,0.5,0,2,0,2,2,1,0,0,,0,0,0,0,0,0,2,0,6,2
Ramon Sessions,30-280,G,1/16/17,CHO,BOS,0,16,3,4,0.75,3,4,0.75,0,0,,0,1,0,0,1,1,4,1,0,0,3,6,6.9
Shelvin Mack,26-232,G,12/10/16,UTA,SAC,0,28,3,8,0.375,3,5,0.6,0,3,0,0,0,,3,1,4,5,1,0,3,2,6,4.7
Gorgui Dieng,27-076,C,4/4/17,MIN,GSW,1,28,2,5,0.4,2,4,0.5,0,1,0,2,2,1,2,7,9,4,0,0,0,0,6,9.6
Ed Davis,27-188,F,12/10/16,POR,IND,1,34,3,6,0.5,3,6,0.5,0,0,,0,0,,4,6,10,2,2,1,2,1,6,9.3
Roy Hibbert,30-045,C,1/25/17,CHO,GSW,1,17,2,3,0.667,2,3,0.667,0,0,,2,2,1,2,2,4,0,0,0,2,2,6,3.9
Al Horford,30-269,C-F,2/27/17,BOS,ATL,1,28,3,9,0.333,3,5,0.6,0,4,0,0,0,,1,5,6,5,1,1,3,5,6,3.3
Jrue Holiday,26-259,G,2/26/17,NOP,OKC,1,33,3,9,0.333,3,7,0.429,0,2,0,0,0,,0,3,3,8,2,1,5,2,6,4.3
Cory Joseph,25-072,G,10/31/16,TOR,DEN,0,24,3,8,0.375,3,7,0.429,0,1,0,0,0,,1,2,3,4,1,0,1,3,6,4.5
Chandler Parsons,28-099,F,2/1/17,MEM,DEN,1,22,2,7,0.286,2,5,0.4,0,2,0,2,2,1,0,6,6,3,0,0,0,2,6,5
JaMychal Green,26-239,F,2/15/17,MEM,NOP,1,22,3,8,0.375,3,6,0.5,0,2,0,0,1,0,2,4,6,1,1,0,1,1,6,4.1
Dante Cunningham,29-255,F,1/2/17,NOP,CLE,1,33,3,5,0.6,3,4,0.75,0,1,0,0,0,,0,6,6,0,0,0,1,2,6,3.7
Alex Abrines,23-156,G-F,1/4/17,OKC,CHO,0,21,2,6,0.333,0,1,0,2,5,0.4,0,0,,0,1,1,0,2,0,0,4,6,3.3
Danny Green,29-157,G-F,11/26/16,SAS,WAS,1,27,2,4,0.5,0,0,,2,4,0.5,0,0,,0,5,5,2,0,1,1,1,6,6.2
Kyle Anderson,23-194,F-G,4/2/17,SAS,UTA,1,32,1,3,0.333,1,3,0.333,0,0,,4,4,1,2,7,9,4,3,0,2,3,6,10.4
Devin Harris,33-354,G,2/15/17,DAL,DET,0,18,1,7,0.143,1,5,0.2,0,2,0,4,4,1,0,3,3,2,1,0,0,2,6,4
Mario Hezonja,22-019,F-G,3/16/17,ORL,GSW,0,24,3,10,0.3,3,8,0.375,0,2,0,0,1,0,0,4,4,2,1,1,3,1,6,0.7
Gerald Henderson,29-122,G,4/10/17,PHI,IND,0,23,2,6,0.333,1,2,0.5,1,4,0.25,1,2,0.5,1,1,2,1,1,0,1,3,6,2.7
Cristiano Felicio,24-204,F-C,1/27/17,CHI,MIA,0,23,3,5,0.6,3,5,0.6,0,0,,0,2,0,2,2,4,0,0,2,1,0,6,5.3
Boris Diaw,34-301,F-C,2/11/17,UTA,BOS,0,6,1,2,0.5,1,1,1,0,1,0,4,4,1,0,1,1,1,0,0,0,0,6,6
Al-Farouq Aminu,26-093,F,12/23/16,POR,SAS,1,29,2,6,0.333,0,1,0,2,5,0.4,0,0,,2,0,2,2,0,0,3,0,6,2.4
Brandon Bass,31-200,F,11/16/16,LAC,MEM,0,9,2,2,1,2,2,1,0,0,,2,2,1,0,0,0,1,0,0,1,1,6,4.7
Lucas Nogueira,24-147,C,12/20/16,TOR,BRK,0,22,2,3,0.667,2,3,0.667,0,0,,2,2,1,3,3,6,1,1,4,0,5,6,10.2
Danny Green,29-195,G-F,1/3/17,SAS,TOR,1,22,2,5,0.4,0,2,0,2,3,0.667,0,0,,0,3,3,1,1,0,2,1,6,3.5
Thabo Sefolosha,32-217,G-F,12/5/16,ATL,OKC,1,33,3,6,0.5,3,5,0.6,0,1,0,0,2,0,0,3,3,2,4,2,0,5,6,7.9
Zaza Pachulia,33-013,C,2/23/17,GSW,LAC,1,18,3,3,1,3,3,1,0,0,,0,0,,1,3,4,1,1,4,1,4,6,8.6
E'Twaun Moore,27-297,G,12/21/16,NOP,OKC,0,15,2,7,0.286,0,3,0,2,4,0.5,0,0,,1,0,1,1,0,0,0,1,6,2.9
Bobby Portis,21-309,F,12/15/16,CHI,MIL,0,23,2,6,0.333,2,3,0.667,0,3,0,2,3,0.667,0,6,6,0,0,0,3,1,6,0.6
Richard Jefferson,36-130,F,10/29/16,CLE,ORL,0,23,3,6,0.5,3,4,0.75,0,2,0,0,0,,0,3,3,0,1,0,1,4,6,2.3
Rudy Gobert,24-158,C,12/1/16,UTA,MIA,1,35,3,4,0.75,3,4,0.75,0,0,,0,0,,3,7,10,1,0,3,0,2,6,10.6
Dewayne Dedmon,27-128,C,12/18/16,SAS,NOP,0,17,3,7,0.429,3,7,0.429,0,0,,0,0,,0,2,2,2,0,1,1,2,6,3.2
Isaiah Whitehead,21-237,G,10/31/16,BRK,CHI,0,21,3,11,0.273,3,9,0.333,0,2,0,0,0,,2,2,4,2,0,0,5,3,6,-3.3
Tyson Chandler,34-031,C,11/2/16,PHO,POR,1,28,2,4,0.5,2,4,0.5,0,0,,2,2,1,2,16,18,1,0,1,2,1,6,9.2
Shabazz Muhammad,24-028,F-G,12/11/16,MIN,GSW,0,15,1,5,0.2,0,2,0,1,3,0.333,3,4,0.75,2,3,5,2,0,0,0,0,6,6.2
Joffrey Lauvergne,25-059,C-F,11/28/16,OKC,NYK,0,20,3,8,0.375,3,5,0.6,0,3,0,0,0,,0,5,5,1,0,0,1,3,6,1.6
Reggie Bullock,25-363,G-F,3/14/17,DET,CLE,0,21,2,6,0.333,1,2,0.5,1,4,0.25,1,1,1,0,2,2,1,1,0,1,1,6,3.5
Omer Asik,30-142,C,11/23/16,NOP,MIN,1,28,2,3,0.667,2,3,0.667,0,0,,2,4,0.5,1,8,9,0,0,0,0,1,6,6.6
Mindaugas Kuzminskas,27-064,F,12/22/16,NYK,ORL,0,18,2,3,0.667,1,1,1,1,2,0.5,1,2,0.5,0,2,2,3,1,1,0,3,6,7.5
Glenn Robinson,22-341,G-F,12/14/16,IND,MIA,1,25,2,5,0.4,2,5,0.4,0,0,,2,3,0.667,2,3,5,1,0,0,0,0,6,5.9
Brandon Jennings,27-042,G,11/4/16,NYK,CHI,0,23,2,4,0.5,1,1,1,1,3,0.333,1,2,0.5,0,5,5,7,0,0,1,0,6,9
Patrick Beverley,28-158,G,12/17/16,HOU,MIN,1,43,2,6,0.333,2,6,0.333,0,0,,2,2,1,2,8,10,4,2,0,1,5,6,8.2
T.J. McConnell,24-320,G,2/8/17,PHI,SAS,1,31,3,10,0.3,3,10,0.3,0,0,,0,0,,0,1,1,5,3,0,0,1,6,6.6
Iman Shumpert,26-234,G,2/15/17,CLE,IND,1,26,2,5,0.4,0,1,0,2,4,0.5,0,0,,0,1,1,2,0,0,0,3,6,3.8
Kevin Seraphin,27-025,F,1/1/17,IND,ORL,0,16,3,3,1,3,3,1,0,0,,0,0,,1,5,6,0,0,0,1,0,6,6.3
John Henson,25-347,C-F,12/9/16,MIL,ATL,1,25,3,6,0.5,3,6,0.5,0,0,,0,0,,2,4,6,4,1,1,0,1,6,9.7
Greg Monroe,26-154,C-F,11/5/16,MIL,SAC,0,14,2,4,0.5,2,4,0.5,0,0,,2,2,1,0,3,3,2,1,1,1,3,6,5.8
Isaiah Whitehead,22-025,G,4/2/17,BRK,ATL,0,23,2,4,0.5,2,3,0.667,0,1,0,2,2,1,2,2,4,2,0,0,3,4,6,2.8
Cristiano Felicio,24-275,F-C,4/8/17,CHI,BRK,0,13,3,3,1,3,3,1,0,0,,0,0,,2,4,6,0,0,0,1,1,6,6.3
Robin Lopez,28-281,C,1/7/17,CHI,TOR,1,27,3,7,0.429,3,7,0.429,0,0,,0,0,,1,4,5,0,0,0,0,2,6,3.4
Maurice Ndour,24-295,F,4/9/17,NYK,TOR,1,25,2,4,0.5,2,4,0.5,0,0,,2,2,1,0,2,2,1,0,0,0,3,6,4.1
Ramon Sessions,30-222,G,11/19/16,CHO,NOP,0,21,3,7,0.429,3,4,0.75,0,3,0,0,2,0,0,0,0,7,3,0,1,1,6,8
Alan Anderson,34-118,G-F,2/11/17,LAC,CHO,0,13,2,3,0.667,2,2,1,0,1,0,2,2,1,0,1,1,1,0,0,0,2,6,4.9
Raul Neto,24-310,G,3/25/17,UTA,LAC,0,16,2,4,0.5,2,4,0.5,0,0,,2,2,1,0,3,3,4,1,0,0,3,6,7.5
Donatas Motiejunas,26-159,F-C,2/26/17,NOP,OKC,0,23,2,6,0.333,2,4,0.5,0,2,0,2,6,0.333,1,3,4,0,1,0,0,2,6,2.8
Stanley Johnson,20-166,F,11/11/16,DET,SAS,0,15,1,6,0.167,0,2,0,1,4,0.25,3,4,0.75,0,2,2,0,0,0,1,2,6,0.6
T.J. McConnell,24-357,G,3/17/17,PHI,DAL,1,22,3,5,0.6,3,5,0.6,0,0,,0,0,,0,2,2,6,1,0,1,0,6,8.5
Marco Belinelli,30-312,G-F,1/31/17,CHO,POR,0,24,3,6,0.5,3,6,0.5,0,0,,0,0,,0,1,1,1,0,0,0,2,6,3.2
Ed Davis,27-142,F,10/25/16,POR,UTA,0,24,2,3,0.667,2,3,0.667,0,0,,2,2,1,3,4,7,1,0,1,0,2,6,8.6
Dewayne Dedmon,27-153,C,1/12/17,SAS,LAL,0,21,2,3,0.667,2,3,0.667,0,0,,2,2,1,3,9,12,2,1,2,1,2,6,11.5
Patrick Patterson,28-003,F,3/17/17,TOR,DET,0,14,2,5,0.4,0,2,0,2,3,0.667,0,0,,0,2,2,1,0,0,0,2,6,3.8
Andrew Nicholson,26-353,F,11/25/16,WAS,ORL,0,16,3,7,0.429,3,6,0.5,0,1,0,0,0,,0,1,1,1,0,2,0,2,6,3.9
Anthony Brown,24-044,F-G,11/23/16,NOP,MIN,0,3,2,2,1,0,0,,2,2,1,0,0,,0,0,0,0,0,0,0,1,6,5
Avery Bradley,26-093,G,2/27/17,BOS,ATL,1,15,2,4,0.5,0,1,0,2,3,0.667,0,0,,0,0,0,0,3,0,0,2,6,6.2
Jonas Valanciunas,24-208,C,11/30/16,TOR,MEM,1,23,3,6,0.5,3,6,0.5,0,0,,0,0,,1,3,4,0,1,1,4,2,6,1.5
Thon Maker,20-002,F-C,2/27/17,MIL,CLE,1,9,2,4,0.5,0,1,0,2,3,0.667,0,0,,0,0,0,0,0,1,1,2,6,2.9
Shaun Livingston,31-140,G,1/29/17,GSW,POR,1,23,3,6,0.5,3,6,0.5,0,0,,0,0,,0,1,1,3,1,0,2,3,6,3.2
Trey Burke,24-073,G,1/24/17,WAS,BOS,0,10,3,5,0.6,3,4,0.75,0,1,0,0,0,,1,1,2,3,0,0,1,0,6,5.8
Andre Iguodala,33-004,G-F,2/1/17,GSW,CHO,0,25,3,4,0.75,3,3,1,0,1,0,0,0,,0,5,5,3,0,0,0,1,6,7.6
Adreian Payne,25-278,F-C,11/23/16,MIN,NOP,0,10,3,4,0.75,3,4,0.75,0,0,,0,0,,0,3,3,0,0,0,2,2,6,2.5
Dwight Powell,25-246,F-C,3/23/17,DAL,LAC,0,12,2,5,0.4,2,5,0.4,0,0,,2,2,1,0,2,2,0,0,0,0,1,6,3.5
Kyle Lowry,30-284,G,1/3/17,TOR,SAS,1,29,2,9,0.222,2,2,1,0,7,0,2,2,1,0,4,4,2,0,0,1,3,6,0.9
Nik Stauskas,23-101,G,1/16/17,PHI,MIL,1,20,2,5,0.4,0,2,0,2,3,0.667,0,0,,1,2,3,2,1,1,1,1,6,6.3
Maurice Harkless,23-270,F-G,2/5/17,POR,OKC,0,22,3,6,0.5,3,5,0.6,0,1,0,0,0,,1,2,3,1,2,0,0,0,6,7
Doug McDermott,25-061,F,3/5/17,OKC,DAL,0,35,3,9,0.333,3,7,0.429,0,2,0,0,0,,0,4,4,2,0,0,0,1,6,3.1
Jaylen Brown,20-147,F,3/20/17,BOS,WAS,0,20,3,6,0.5,3,4,0.75,0,2,0,0,0,,1,2,3,1,1,0,1,3,6,3.8
Alex Abrines,23-240,G-F,3/29/17,OKC,ORL,0,22,2,8,0.25,0,2,0,2,6,0.333,0,0,,1,0,1,1,2,0,0,2,6,3.8
Trey Burke,24-039,G,12/21/16,WAS,CHI,0,12,3,5,0.6,3,5,0.6,0,0,,0,1,0,0,1,1,1,0,0,1,2,6,2.5
Lance Stephenson,26-217,G-F,4/10/17,IND,PHI,0,21,3,7,0.429,3,7,0.429,0,0,,0,1,0,0,2,2,5,0,0,0,2,6,5.2
Tristan Thompson,25-309,F-C,1/16/17,CLE,GSW,1,30,2,3,0.667,2,3,0.667,0,0,,2,2,1,2,3,5,0,0,3,1,2,6,7.3
Troy Daniels,25-210,G,2/10/17,MEM,GSW,0,15,2,7,0.286,1,3,0.333,1,4,0.25,1,2,0.5,2,1,3,0,0,0,0,0,6,3.2
Marreese Speights,29-109,C-F,11/21/16,LAC,TOR,0,14,2,5,0.4,2,2,1,0,3,0,2,2,1,0,6,6,1,0,0,1,4,6,3.2
Domantas Sabonis,20-199,F,11/18/16,OKC,BRK,1,26,3,9,0.333,3,6,0.5,0,3,0,0,0,,0,3,3,0,1,2,2,3,6,1
Dorian Finney-Smith,23-325,F,3/25/17,DAL,TOR,0,12,1,3,0.333,1,2,0.5,0,1,0,4,4,1,1,0,1,0,1,0,1,0,6,5
Zaza Pachulia,32-290,C,11/26/16,GSW,MIN,1,25,2,6,0.333,2,6,0.333,0,0,,2,2,1,1,3,4,3,1,1,0,1,6,7.6
DeAndre Jordan,28-134,C,12/2/16,LAC,NOP,1,34,2,2,1,2,2,1,0,0,,2,2,1,3,10,13,2,0,3,1,1,6,12.6
Bojan Bogdanovic,27-344,G-F,3/28/17,WAS,LAL,0,16,3,8,0.375,3,6,0.5,0,2,0,0,1,0,0,1,1,1,1,0,2,2,6,0.4
Jonas Valanciunas,24-264,C,1/25/17,TOR,MEM,1,26,2,3,0.667,2,3,0.667,0,0,,2,2,1,2,10,12,1,0,1,3,5,6,5.5
Langston Galloway,25-107,G,3/26/17,SAC,LAC,0,25,2,8,0.25,0,4,0,2,4,0.5,0,0,,1,1,2,3,1,0,1,3,6,3.1
Dwight Howard,30-363,C,12/5/16,ATL,OKC,1,19,2,6,0.333,2,6,0.333,0,0,,2,4,0.5,3,3,6,1,2,0,4,3,6,2.3
Alex Poythress,23-214,F,4/8/17,PHI,MIL,0,24,2,8,0.25,2,7,0.286,0,1,0,2,2,1,2,6,8,0,0,0,2,3,6,1.2
Jeremy Lamb,24-310,G-F,4/5/17,CHO,MIA,0,23,2,5,0.4,2,4,0.5,0,1,0,2,2,1,0,5,5,1,0,1,0,1,6,5.8
Zach Randolph,35-158,F,12/21/16,MEM,DET,0,19,3,13,0.231,3,11,0.273,0,2,0,0,0,,1,3,4,4,1,0,1,2,6,1.7
DeAndre' Bembry,22-217,F,2/6/17,ATL,UTA,0,18,3,7,0.429,3,7,0.429,0,0,,0,0,,0,0,0,0,0,0,0,1,6,1.9
Brandon Ingram,19-165,F,2/14/17,LAL,SAC,1,27,2,7,0.286,1,5,0.2,1,2,0.5,1,4,0.25,2,3,5,4,0,0,0,0,6,5.8
Nemanja Bjelica,28-253,F,1/17/17,MIN,SAS,0,25,1,4,0.25,1,3,0.333,0,1,0,4,5,0.8,0,4,4,3,1,1,2,2,6,5.4
Arron Afflalo,31-100,G,1/23/17,SAC,DET,1,29,2,9,0.222,0,2,0,2,7,0.286,0,0,,0,2,2,2,0,0,0,0,6,2.5
Enes Kanter,24-166,C,11/2/16,OKC,LAC,0,24,3,11,0.273,3,10,0.3,0,1,0,0,0,,3,9,12,0,1,0,2,1,6,2.9
Zaza Pachulia,33-047,C,3/29/17,GSW,SAS,1,18,2,7,0.286,2,7,0.286,0,0,,2,2,1,4,0,4,2,1,0,1,3,6,4.9
Anthony Tolliver,31-233,F-C,1/20/17,SAC,MEM,0,26,2,9,0.222,1,3,0.333,1,6,0.167,1,2,0.5,3,1,4,1,1,0,2,1,6,1.8
Marcin Gortat,32-334,C-F,1/16/17,WAS,POR,1,27,3,9,0.333,3,9,0.333,0,0,,0,0,,2,4,6,0,0,2,1,2,6,3.1
Raul Neto,24-185,G,11/20/16,UTA,DEN,0,3,2,3,0.667,1,2,0.5,1,1,1,1,1,1,0,0,0,0,0,0,0,0,6,4.7
Steven Adams,23-110,C,11/7/16,OKC,MIA,1,29,3,5,0.6,3,5,0.6,0,0,,0,0,,0,6,6,0,3,2,2,3,6,6.7
Thaddeus Young,28-176,F,12/14/16,IND,MIA,1,39,3,6,0.5,3,5,0.6,0,1,0,0,0,,0,7,7,0,3,0,1,1,6,6.7
Tyreke Evans,27-093,G-F,12/21/16,NOP,OKC,0,15,2,6,0.333,1,4,0.25,1,2,0.5,1,1,1,0,1,1,3,0,0,2,1,6,2.6
Joe Ingles,29-127,F-G,2/6/17,UTA,ATL,1,24,2,2,1,0,0,,2,2,1,0,0,,1,3,4,2,2,0,1,4,6,7.8
Jameer Nelson,34-329,G,1/3/17,DEN,SAC,0,19,2,7,0.286,0,2,0,2,5,0.4,0,0,,0,1,1,4,0,0,3,2,6,1.2
DeAndre Jordan,28-121,C,11/19/16,LAC,CHI,1,27,3,6,0.5,3,6,0.5,0,0,,0,0,,1,8,9,0,0,0,1,2,6,4.3
Troy Daniels,25-254,G,3/26/17,MEM,GSW,0,12,2,8,0.25,0,2,0,2,6,0.333,0,0,,2,1,3,1,0,0,0,0,6,3.6
Ish Smith,28-164,G,12/16/16,DET,WAS,0,18,3,6,0.5,3,4,0.75,0,2,0,0,0,,0,2,2,3,0,0,1,1,6,4.3
Gerald Henderson,28-339,G,11/12/16,PHI,ATL,1,21,3,6,0.5,3,5,0.6,0,1,0,0,2,0,1,2,3,2,1,0,0,1,6,5.5
Ian Clark,25-291,G,12/23/16,GSW,DET,0,15,2,2,1,2,2,1,0,0,,2,2,1,0,2,2,1,0,0,1,1,6,5.3
Marreese Speights,29-117,C-F,11/29/16,LAC,BRK,0,15,1,4,0.25,1,2,0.5,0,2,0,4,4,1,1,4,5,0,1,0,2,3,6,3.3
Beno Udrih,34-265,G,3/27/17,DET,NYK,0,13,3,4,0.75,3,4,0.75,0,0,,0,0,,0,3,3,3,1,0,5,0,6,3.4
Arron Afflalo,31-034,G,11/18/16,SAC,LAC,1,24,1,3,0.333,1,1,1,0,2,0,4,4,1,0,1,1,0,0,0,0,1,6,4.2
Gerald Henderson,29-061,G,2/8/17,PHI,SAS,1,23,1,6,0.167,0,3,0,1,3,0.333,3,4,0.75,0,3,3,1,0,0,1,2,6,1.6
Marcus Morris,27-166,F,2/15/17,DET,DAL,1,36,3,11,0.273,3,8,0.375,0,3,0,0,0,,0,13,13,1,0,1,2,1,6,2.4
Allen Crabbe,24-232,G-F,11/27/16,POR,HOU,0,29,2,5,0.4,0,2,0,2,3,0.667,0,0,,0,5,5,0,1,0,2,2,6,3
Omri Casspi,28-136,F,11/5/16,SAC,MIL,1,24,3,8,0.375,3,5,0.6,0,3,0,0,0,,3,3,6,2,0,0,3,1,6,2.6
Danny Green,29-186,G-F,12/25/16,SAS,CHI,1,24,2,4,0.5,0,0,,2,4,0.5,0,0,,0,3,3,4,1,0,1,0,6,7.7
Dwight Powell,25-117,F-C,11/14/16,DAL,NYK,0,18,2,8,0.25,2,8,0.25,0,0,,2,2,1,1,3,4,0,1,1,2,1,6,2.1
Jason Terry,39-194,G,3/28/17,MIL,CHO,0,23,2,4,0.5,0,1,0,2,3,0.667,0,0,,0,3,3,1,0,0,0,3,6,4.4
Brandan Wright,29-117,F-C,1/30/17,MEM,PHO,0,5,3,5,0.6,3,5,0.6,0,0,,0,0,,1,1,2,0,0,0,0,0,6,4.7
Frank Kaminsky,23-245,F-C,12/5/16,CHO,DAL,1,23,3,7,0.429,3,6,0.5,0,1,0,0,0,,0,3,3,0,1,0,0,0,6,4.2
Mirza Teletovic,31-038,F,10/26/16,MIL,CHO,1,27,3,12,0.25,3,7,0.429,0,5,0,0,0,,0,2,2,1,0,0,1,1,6,-1.3
Rondae Hollis-Jefferson,21-346,F,12/14/16,BRK,LAL,0,19,2,4,0.5,2,3,0.667,0,1,0,2,2,1,3,4,7,1,0,1,1,2,6,6.9
Zaza Pachulia,32-287,C,11/23/16,GSW,LAL,1,18,2,3,0.667,2,3,0.667,0,0,,2,2,1,0,3,3,2,3,0,0,3,6,8.8
Kris Dunn,22-278,G,12/21/16,MIN,ATL,0,15,2,5,0.4,1,2,0.5,1,3,0.333,1,1,1,0,1,1,0,0,0,0,2,6,2.8
Kris Dunn,22-344,G,2/25/17,MIN,HOU,0,18,2,4,0.5,1,3,0.333,1,1,1,1,1,1,2,3,5,2,0,0,0,5,6,5.7
Courtney Lee,31-173,G,3/25/17,NYK,SAS,1,40,3,11,0.273,3,10,0.3,0,1,0,0,0,,1,6,7,7,2,1,3,1,6,6.2
Shaun Livingston,31-153,G,2/11/17,GSW,OKC,0,16,3,3,1,3,3,1,0,0,,0,1,0,0,2,2,2,1,0,0,0,6,7.7
Meyers Leonard,24-264,C-F,11/17/16,POR,HOU,0,6,2,2,1,0,0,,2,2,1,0,0,,1,0,1,0,0,0,0,0,6,6.1
Joe Harris,25-051,G,10/28/16,BRK,IND,0,18,2,7,0.286,0,1,0,2,6,0.333,0,0,,0,3,3,1,1,0,1,2,6,2.7
Tony Snell,25-083,G-F,2/1/17,MIL,UTA,1,22,2,3,0.667,0,0,,2,3,0.667,0,0,,0,7,7,0,0,0,1,1,6,5.4
Kosta Koufos,27-334,C,1/23/17,SAC,DET,1,12,3,5,0.6,3,5,0.6,0,0,,0,0,,0,3,3,0,0,0,1,3,6,2.4
Marreese Speights,29-247,C-F,4/8/17,LAC,SAS,0,14,2,5,0.4,1,1,1,1,4,0.25,0,0,,1,1,2,2,1,1,0,2,5,5.6
J.J. Redick,32-156,G,11/27/16,LAC,IND,1,22,1,7,0.143,0,2,0,1,5,0.2,2,2,1,0,2,2,1,0,0,3,0,5,-1.2
Alex Abrines,23-098,G-F,11/7/16,OKC,MIA,0,17,2,9,0.222,1,2,0.5,1,7,0.143,0,0,,1,1,2,0,1,0,2,2,5,-1.3
Kevon Looney,20-313,F-C,12/15/16,GSW,NYK,0,15,2,2,1,2,2,1,0,0,,1,2,0.5,2,2,4,0,1,1,0,2,5,6.9
Rajon Rondo,30-350,G,2/6/17,CHI,SAC,0,20,2,6,0.333,2,4,0.5,0,2,0,1,2,0.5,0,2,2,6,4,0,1,1,5,8.6
Ian Clark,26-013,G,3/20/17,GSW,OKC,0,18,2,4,0.5,2,3,0.667,0,1,0,1,2,0.5,0,0,0,1,0,0,0,0,5,3.3
Yogi Ferrell,23-202,G,11/27/16,BRK,SAC,0,17,2,6,0.333,1,2,0.5,1,4,0.25,0,0,,1,0,1,1,0,1,2,1,5,1.3
Tarik Black,25-000,C-F,11/22/16,LAL,OKC,0,16,2,3,0.667,2,3,0.667,0,0,,1,1,1,2,4,6,0,0,2,1,2,5,5.9
Nemanja Bjelica,28-176,F,11/1/16,MIN,MEM,0,18,2,4,0.5,1,2,0.5,1,2,0.5,0,0,,1,7,8,2,1,0,1,3,5,6
Willy Hernangomez,22-174,C,11/17/16,NYK,WAS,0,10,2,2,1,2,2,1,0,0,,1,2,0.5,0,1,1,0,0,1,0,0,5,5
Caris LeVert,22-113,G-F,12/16/16,BRK,ORL,0,11,2,3,0.667,1,1,1,1,2,0.5,0,0,,0,4,4,2,1,0,0,1,5,6.9
Nerlens Noel,22-283,C-F,1/18/17,PHI,TOR,0,21,2,5,0.4,2,5,0.4,0,0,,1,2,0.5,0,2,2,0,0,0,3,4,5,-2.1
Patrick McCaw,21-144,G,3/18/17,GSW,MIL,1,15,2,2,1,2,2,1,0,0,,1,1,1,0,1,1,1,0,0,0,1,5,5
Michael Carter-Williams,25-089,G,1/7/17,CHI,TOR,1,16,2,4,0.5,1,2,0.5,1,2,0.5,0,0,,1,4,5,4,0,0,3,3,5,3.5
Ron Baker,23-307,G,1/31/17,NYK,WAS,0,28,2,6,0.333,2,5,0.4,0,1,0,1,3,0.333,1,1,2,2,1,0,0,3,5,3
Courtney Lee,31-104,G,1/15/17,NYK,TOR,1,25,2,9,0.222,1,5,0.2,1,4,0.25,0,0,,0,1,1,0,2,0,0,1,5,1.4
Andrew Harrison,22-129,G,3/6/17,MEM,BRK,1,22,1,4,0.25,0,1,0,1,3,0.333,2,2,1,0,2,2,1,1,0,2,1,5,2.5
Arron Afflalo,31-090,G,1/13/17,SAC,CLE,0,17,2,3,0.667,1,2,0.5,1,1,1,0,0,,0,0,0,0,1,0,2,2,5,1.9
Luc Mbah a Moute,30-157,F,2/13/17,LAC,UTA,1,38,2,5,0.4,1,3,0.333,1,2,0.5,0,0,,1,4,5,2,2,0,0,3,5,6.4
Ben McLemore,23-268,G,11/5/16,SAC,MIL,0,23,2,8,0.25,2,6,0.333,0,2,0,1,2,0.5,0,1,1,4,1,0,1,1,5,2.5
Langston Galloway,24-345,G,11/18/16,NOP,POR,0,20,2,8,0.25,1,5,0.2,1,3,0.333,0,0,,0,1,1,1,1,0,1,3,5,0
Timothe Luwawu-Cabarrot,21-235,F,12/30/16,PHI,DEN,0,11,1,3,0.333,0,2,0,1,1,1,2,2,1,0,1,1,0,0,0,0,2,5,2.8
Michael Beasley,27-329,F,12/3/16,MIL,BRK,0,18,2,5,0.4,2,5,0.4,0,0,,1,2,0.5,0,3,3,1,0,1,2,4,5,0.6
Mirza Teletovic,31-053,F,11/10/16,MIL,NOP,0,11,1,6,0.167,0,2,0,1,4,0.25,2,2,1,0,2,2,1,0,0,1,3,5,0.3
Ricky Rubio,26-110,G,2/8/17,MIN,TOR,1,21,2,7,0.286,1,6,0.167,1,1,1,0,0,,0,1,1,7,1,0,1,2,5,5.3
Solomon Hill,25-261,F,12/4/16,NOP,OKC,1,33,1,7,0.143,0,1,0,1,6,0.167,2,2,1,0,3,3,2,0,1,0,0,5,3.5
Gerald Henderson,29-087,G,3/6/17,PHI,MIL,1,17,2,4,0.5,1,3,0.333,1,1,1,0,0,,1,2,3,0,0,0,1,1,5,2.9
Rajon Rondo,30-310,G,12/28/16,CHI,BRK,1,35,2,8,0.25,1,7,0.143,1,1,1,0,0,,2,7,9,12,2,0,2,1,5,11.7
Draymond Green,26-294,F,12/23/16,GSW,DET,1,38,1,7,0.143,1,2,0.5,0,5,0,3,4,0.75,0,9,9,12,2,1,4,4,5,8.3
Cory Joseph,25-151,G,1/18/17,TOR,PHI,0,26,2,5,0.4,2,4,0.5,0,1,0,1,2,0.5,1,2,3,3,1,0,0,2,5,5.5
Norris Cole,28-181,G,4/12/17,OKC,DEN,0,15,2,9,0.222,2,7,0.286,0,2,0,1,2,0.5,0,2,2,0,2,0,0,2,5,0.9
Dante Cunningham,29-245,F,12/23/16,NOP,MIA,1,34,2,8,0.25,1,5,0.2,1,3,0.333,0,0,,0,6,6,2,0,2,0,4,5,3.2
Patty Mills,28-147,G,1/5/17,SAS,DEN,0,18,2,6,0.333,1,3,0.333,1,3,0.333,0,0,,0,1,1,4,1,0,0,1,5,5.3
Spencer Hawes,28-219,C-F,12/3/16,CHO,MIN,0,22,2,6,0.333,1,4,0.25,1,2,0.5,0,0,,1,5,6,0,0,0,0,1,5,3.4
Jordan Clarkson,24-201,G,12/25/16,LAL,LAC,0,20,2,9,0.222,2,5,0.4,0,4,0,1,2,0.5,1,0,1,0,1,0,1,2,5,-1
Terrence Ross,26-029,F-G,3/6/17,ORL,NYK,1,35,2,10,0.2,1,4,0.25,1,6,0.167,0,0,,0,4,4,1,1,1,3,3,5,-1.8
Jason Smith,30-341,F-C,2/6/17,WAS,CLE,0,16,2,4,0.5,2,4,0.5,0,0,,1,2,0.5,2,3,5,0,0,1,0,1,5,5.2
Tony Allen,35-088,G-F,4/9/17,MEM,DET,1,20,2,5,0.4,2,4,0.5,0,1,0,1,2,0.5,1,3,4,2,2,0,0,0,5,6.9
Al Jefferson,31-345,C-F,12/14/16,IND,MIA,0,11,2,5,0.4,2,5,0.4,0,0,,1,2,0.5,1,1,2,0,1,0,0,1,5,3.5
Otto Porter,23-294,F,3/24/17,WAS,BRK,1,21,2,5,0.4,1,1,1,1,4,0.25,0,0,,1,3,4,2,0,1,0,2,5,5.2
Mario Hezonja,21-297,F-G,12/18/16,ORL,TOR,0,7,2,3,0.667,2,3,0.667,0,0,,1,1,1,0,1,1,0,1,0,3,0,5,2
E'Twaun Moore,28-029,G,3/29/17,NOP,DAL,0,17,1,7,0.143,0,2,0,1,5,0.2,2,2,1,0,0,0,3,1,1,0,1,5,3.9
Iman Shumpert,26-125,G,10/29/16,CLE,ORL,0,19,2,3,0.667,1,2,0.5,1,1,1,0,0,,0,0,0,1,3,0,1,5,5,4.4
Jordan McRae,25-289,G,1/11/17,CLE,POR,0,7,2,2,1,1,1,1,1,1,1,0,0,,0,1,1,0,0,0,1,0,5,3.7
Richard Jefferson,36-185,F,12/23/16,CLE,BRK,0,9,2,4,0.5,2,3,0.667,0,1,0,1,1,1,0,0,0,1,0,0,0,2,5,2.9
Derrick Jones,20-022,F,3/9/17,PHO,LAL,0,10,2,2,1,2,2,1,0,0,,1,2,0.5,1,1,2,0,0,1,0,1,5,5.3
Trevor Ariza,31-202,F,1/18/17,HOU,MIL,1,39,2,8,0.25,1,1,1,1,7,0.143,0,0,,1,5,6,4,1,0,1,2,5,4.4
Jonas Jerebko,30-022,F,3/24/17,BOS,PHO,0,10,2,4,0.5,1,2,0.5,1,2,0.5,0,0,,0,1,1,1,0,0,0,2,5,3.2
Joe Johnson,35-255,G-F,3/11/17,UTA,OKC,1,19,2,6,0.333,1,4,0.25,1,2,0.5,0,0,,1,1,2,1,0,0,0,2,5,2.5
Jamal Crawford,36-275,G,12/20/16,LAC,DEN,0,19,2,4,0.5,1,2,0.5,1,2,0.5,0,0,,0,1,1,3,0,0,2,0,5,3.4
Jusuf Nurkic,22-158,C,1/28/17,DEN,PHO,1,15,2,4,0.5,2,4,0.5,0,0,,1,1,1,0,4,4,0,0,0,3,3,5,0
Mike Dunleavy,36-075,F-G,11/29/16,CLE,MIL,0,12,2,4,0.5,1,1,1,1,3,0.333,0,0,,0,1,1,2,0,0,1,0,5,3.7
Jamal Murray,19-329,G,1/17/17,DEN,LAL,0,13,2,5,0.4,1,2,0.5,1,3,0.333,0,0,,0,1,1,0,0,2,3,2,5,0.2
Corey Brewer,30-237,F-G,10/28/16,HOU,DAL,0,11,2,5,0.4,1,3,0.333,1,2,0.5,0,0,,0,2,2,1,0,0,1,1,5,2.2
DeMarre Carroll,30-214,F,2/26/17,TOR,POR,1,32,1,5,0.2,0,2,0,1,3,0.333,2,4,0.5,0,4,4,1,0,1,1,2,5,1.9
Joe Harris,25-156,G,2/10/17,BRK,MIA,0,20,1,4,0.25,0,3,0,1,1,1,2,4,0.5,1,1,2,2,0,0,3,5,5,-0.8
Kelly Oubre,21-103,F,3/22/17,WAS,ATL,0,19,2,7,0.286,1,5,0.2,1,2,0.5,0,0,,1,4,5,1,0,0,1,3,5,1.3
Dorian Finney-Smith,23-305,F,3/5/17,DAL,OKC,0,16,2,3,0.667,1,1,1,1,2,0.5,0,0,,0,4,4,2,1,0,0,2,5,6.5
David Lee,33-190,F,11/5/16,SAS,LAC,0,14,1,4,0.25,1,4,0.25,0,0,,3,4,0.75,1,3,4,1,0,0,0,1,5,4.1
Terry Rozier,22-307,G,1/18/17,BOS,NYK,0,24,1,8,0.125,0,4,0,1,4,0.25,2,2,1,0,1,1,2,1,0,0,3,5,1.3
Sean Kilpatrick,27-009,G,1/15/17,BRK,HOU,0,23,2,11,0.182,1,4,0.25,1,7,0.143,0,0,,0,3,3,4,1,0,1,2,5,1
Ty Lawson,29-003,G,11/6/16,SAC,TOR,1,36,0,6,0,0,5,0,0,1,0,5,6,0.833,0,2,2,11,0,0,1,2,5,6.9
Buddy Hield,23-026,G,1/12/17,NOP,BRK,1,24,2,9,0.222,1,3,0.333,1,6,0.167,0,0,,3,2,5,1,0,0,1,2,5,1.1
Malik Beasley,20-006,G,12/2/16,DEN,HOU,0,4,2,3,0.667,1,1,1,1,2,0.5,0,0,,0,0,0,0,1,0,0,0,5,4.7
Nemanja Bjelica,28-211,F,12/6/16,MIN,SAS,0,11,2,4,0.5,1,2,0.5,1,2,0.5,0,0,,0,0,0,1,0,0,0,2,5,2.9
Kentavious Caldwell-Pope,23-253,G,10/28/16,DET,ORL,1,24,2,5,0.4,2,2,1,0,3,0,1,1,1,0,1,1,1,2,0,1,1,5,3.9
Alex Abrines,23-233,G-F,3/22/17,OKC,PHI,0,24,1,6,0.167,0,1,0,1,5,0.2,2,2,1,0,3,3,0,1,1,1,2,5,2
Patrick McCaw,21-099,G,2/1/17,GSW,CHO,0,18,1,5,0.2,0,1,0,1,4,0.25,2,4,0.5,0,1,1,0,1,1,1,1,5,1.7
Terry Rozier,22-276,G,12/18/16,BOS,MIA,0,18,2,3,0.667,2,3,0.667,0,0,,1,2,0.5,0,1,1,1,0,0,0,0,5,4.3
Robin Lopez,28-217,C,11/4/16,CHI,NYK,1,29,2,6,0.333,2,6,0.333,0,0,,1,2,0.5,4,2,6,1,0,2,1,2,5,4.9
Jordan McRae,25-270,G,12/23/16,CLE,BRK,0,16,1,5,0.2,1,4,0.25,0,1,0,3,4,0.75,0,0,0,2,0,1,0,1,5,3.2
Raul Neto,24-293,G,3/8/17,UTA,HOU,0,21,2,6,0.333,1,3,0.333,1,3,0.333,0,0,,1,0,1,2,0,2,1,0,5,4.1
Alec Burks,25-238,G,3/15/17,UTA,DET,0,13,2,8,0.25,2,5,0.4,0,3,0,1,1,1,0,3,3,3,0,0,0,0,5,3.2
Sam Dekker,22-249,F,1/10/17,HOU,CHO,0,21,2,5,0.4,1,3,0.333,1,2,0.5,0,0,,0,1,1,3,1,0,1,1,5,4.3
Danny Green,29-262,G-F,3/11/17,SAS,GSW,1,21,2,7,0.286,1,2,0.5,1,5,0.2,0,0,,0,3,3,2,0,2,2,0,5,2.6
Anthony Morrow,31-139,G,2/13/17,OKC,WAS,0,16,2,8,0.25,1,2,0.5,1,6,0.167,0,0,,0,1,1,0,1,0,0,0,5,1.5
Jusuf Nurkic,22-116,C,12/17/16,DEN,NYK,0,8,2,5,0.4,2,5,0.4,0,0,,1,2,0.5,1,0,1,0,1,1,1,0,5,3.3
Trey Lyles,21-001,F,11/6/16,UTA,NYK,0,21,2,6,0.333,1,2,0.5,1,4,0.25,0,0,,0,2,2,1,0,1,0,0,5,3.6
Justin Hamilton,26-263,C,12/20/16,BRK,TOR,0,23,2,6,0.333,2,3,0.667,0,3,0,1,2,0.5,2,9,11,4,0,1,1,1,5,7.4
Trevor Booker,28-350,F,11/9/16,BRK,NYK,1,29,1,6,0.167,1,6,0.167,0,0,,3,4,0.75,1,5,6,2,3,0,1,2,5,5.6
Stanley Johnson,20-224,F,1/8/17,DET,POR,0,25,2,3,0.667,1,1,1,1,2,0.5,0,0,,0,5,5,2,1,0,1,1,5,6.2
Jonathon Simmons,27-043,G-F,10/27/16,SAS,SAC,0,18,1,2,0.5,1,2,0.5,0,0,,3,4,0.75,1,1,2,3,0,0,2,3,5,3.5
Steven Adams,23-259,C,4/5/17,OKC,MEM,1,33,2,8,0.25,2,8,0.25,0,0,,1,3,0.333,5,5,10,1,0,1,1,2,5,4
Danilo Gallinari,28-121,F,12/7/16,DEN,BRK,1,23,2,7,0.286,1,6,0.167,1,1,1,0,0,,0,3,3,3,1,0,1,0,5,3.9
Amir Johnson,29-222,F,12/9/16,BOS,TOR,1,13,2,4,0.5,1,2,0.5,1,2,0.5,0,0,,0,3,3,1,1,0,0,1,5,5.2
Treveon Graham,23-095,G,2/1/17,CHO,GSW,0,6,1,3,0.333,0,2,0,1,1,1,2,2,1,0,1,1,0,1,0,0,1,5,4.2
Cristiano Felicio,24-177,F-C,12/31/16,CHI,MIL,0,17,2,3,0.667,2,3,0.667,0,0,,1,2,0.5,1,3,4,0,1,1,1,3,5,4.4
Tony Snell,25-050,G-F,12/30/16,MIL,MIN,1,29,2,7,0.286,1,2,0.5,1,5,0.2,0,1,0,0,0,0,1,0,0,0,2,5,0.4
Ian Clark,26-019,G,3/26/17,GSW,MEM,0,14,2,4,0.5,1,3,0.333,1,1,1,0,0,,0,4,4,2,0,0,0,1,5,5.2
Austin Rivers,24-209,G,2/26/17,LAC,CHO,0,20,2,8,0.25,2,3,0.667,0,5,0,1,1,1,1,0,1,1,0,0,0,5,5,-0.4
Cameron Payne,22-168,G,1/23/17,OKC,UTA,0,14,2,6,0.333,1,3,0.333,1,3,0.333,0,0,,0,1,1,0,0,0,0,2,5,1.1
Richard Jefferson,36-287,F,4/4/17,CLE,ORL,0,15,2,4,0.5,1,2,0.5,1,2,0.5,0,2,0,0,2,2,0,0,0,0,3,5,1.6
Meyers Leonard,24-265,C-F,11/18/16,POR,NOP,0,8,1,3,0.333,0,1,0,1,2,0.5,2,2,1,0,1,1,0,0,0,1,2,5,1.8
Terry Rozier,22-247,G,11/19/16,BOS,DET,0,14,1,3,0.333,0,1,0,1,2,0.5,2,2,1,1,4,5,1,0,0,0,0,5,5.9
John Henson,25-361,C-F,12/23/16,MIL,WAS,1,19,1,4,0.25,1,4,0.25,0,0,,3,4,0.75,2,1,3,1,1,0,1,1,5,4.2
Corey Brewer,30-332,F-G,1/31/17,HOU,SAC,0,17,2,3,0.667,1,2,0.5,1,1,1,0,0,,0,2,2,2,0,0,1,3,5,3.5
LaMarcus Aldridge,31-134,F-C,11/30/16,SAS,DAL,1,32,2,9,0.222,2,9,0.222,0,0,,1,2,0.5,2,6,8,3,0,0,2,2,5,1.6
Richard Jefferson,36-167,F,12/5/16,CLE,TOR,0,16,2,3,0.667,1,2,0.5,1,1,1,0,0,,0,0,0,1,1,1,1,3,5,3.9
Brandon Jennings,27-058,G,11/20/16,NYK,ATL,0,28,2,6,0.333,1,3,0.333,1,3,0.333,0,0,,0,4,4,3,3,0,1,3,5,5.7
Patrick Patterson,27-263,F,12/2/16,TOR,LAL,0,24,2,4,0.5,1,1,1,1,3,0.333,0,0,,1,6,7,0,0,1,1,2,5,4.4
John Henson,26-042,C-F,2/8/17,MIL,MIA,1,26,1,3,0.333,1,3,0.333,0,0,,3,5,0.6,0,5,5,0,3,2,2,4,5,4.8
Rondae Hollis-Jefferson,22-079,F,3/23/17,BRK,PHO,1,15,2,10,0.2,2,10,0.2,0,0,,1,2,0.5,5,11,16,2,2,1,2,3,5,6.1
Marco Belinelli,30-246,G-F,11/26/16,CHO,NYK,0,20,2,5,0.4,1,2,0.5,1,3,0.333,0,0,,0,2,2,1,0,0,0,1,5,3.2
Ish Smith,28-233,G,2/23/17,DET,CHO,0,33,2,12,0.167,2,10,0.2,0,2,0,1,2,0.5,0,6,6,15,1,1,1,4,5,8.4
JaMychal Green,26-255,F,3/3/17,MEM,DAL,1,26,2,4,0.5,1,3,0.333,1,1,1,0,0,,0,7,7,1,0,0,0,3,5,4.6
Devin Harris,33-286,G,12/9/16,DAL,IND,0,17,2,5,0.4,1,2,0.5,1,3,0.333,0,0,,0,0,0,2,1,0,1,1,5,3.3
Dario Saric,22-201,F,10/26/16,PHI,OKC,1,27,2,12,0.167,2,8,0.25,0,4,0,1,2,0.5,1,6,7,2,0,0,2,3,5,-2.3
E'Twaun Moore,27-319,G,1/12/17,NOP,BRK,0,19,2,5,0.4,1,3,0.333,1,2,0.5,0,0,,0,1,1,1,0,2,2,0,5,2.7
Marquese Chriss,19-252,F,3/11/17,PHO,DAL,1,24,2,4,0.5,1,2,0.5,1,2,0.5,0,0,,0,8,8,1,0,3,1,5,5,5.2
Channing Frye,33-265,C-F,2/6/17,CLE,WAS,0,12,2,4,0.5,1,1,1,1,3,0.333,0,0,,0,4,4,1,0,0,2,4,5,1.3
Maurice Ndour,24-298,F,4/12/17,NYK,PHI,1,25,2,6,0.333,2,6,0.333,0,0,,1,2,0.5,1,0,1,0,0,2,1,0,5,2.3
Draymond Green,26-294,F,12/23/16,GSW,DET,1,38,1,7,0.143,1,2,0.5,0,5,0,3,4,0.75,0,9,9,12,2,1,4,4,5,8.3
Luc Mbah a Moute,30-079,F,11/27/16,LAC,IND,1,12,1,2,0.5,1,1,1,0,1,0,3,4,0.75,0,0,0,0,1,0,2,0,5,2.6
Mirza Teletovic,31-180,F,3/17/17,MIL,LAL,0,22,2,7,0.286,1,2,0.5,1,5,0.2,0,1,0,0,5,5,1,0,0,0,2,5,1.9
Luc Mbah a Moute,30-113,F,12/31/16,LAC,OKC,1,12,2,6,0.333,2,4,0.5,0,2,0,1,1,1,2,1,3,0,0,0,1,0,5,2.3
Sheldon McClellan,24-021,G,1/11/17,WAS,BOS,0,16,2,3,0.667,1,1,1,1,2,0.5,0,0,,0,4,4,0,0,0,0,2,5,4.1
Andre Roberson,25-059,G-F,2/1/17,OKC,CHI,1,30,2,5,0.4,1,1,1,1,4,0.25,0,0,,0,6,6,1,0,2,1,2,5,4.4
Kyle Korver,35-246,G-F,11/18/16,ATL,CHO,1,29,2,6,0.333,1,3,0.333,1,3,0.333,0,0,,0,0,0,2,0,0,1,2,5,1.2
Sergio Rodriguez,30-234,G,2/1/17,PHI,DAL,0,13,2,6,0.333,1,2,0.5,1,4,0.25,0,0,,0,2,2,4,0,0,0,1,5,4.6
Kyle Anderson,23-040,F-G,10/30/16,SAS,MIA,1,20,2,3,0.667,1,2,0.5,1,1,1,0,0,,0,1,1,1,0,0,2,2,5,1.9
Wayne Selden,22-184,G-F,4/2/17,MEM,LAL,1,27,2,5,0.4,2,3,0.667,0,2,0,1,2,0.5,0,2,2,3,1,0,2,5,5,1.6
Darrun Hilliard,23-238,G,12/7/16,DET,CHO,0,11,2,4,0.5,2,3,0.667,0,1,0,1,1,1,0,3,3,0,1,0,1,1,5,3.5
D'Angelo Russell,21-020,G,3/15/17,LAL,HOU,0,25,2,10,0.2,2,5,0.4,0,5,0,1,2,0.5,0,2,2,2,2,0,7,6,5,-7
Miles Plumlee,28-085,C-F,11/25/16,MIL,TOR,1,20,2,2,1,2,2,1,0,0,,1,2,0.5,1,2,3,1,2,0,1,1,5,6.6
Timothe Luwawu-Cabarrot,21-324,F,3/29/17,PHI,ATL,1,32,2,10,0.2,1,3,0.333,1,7,0.143,0,0,,2,7,9,4,0,1,0,5,5,3.8
Justin Holiday,27-309,G,2/8/17,NYK,LAC,0,24,2,6,0.333,1,1,1,1,5,0.2,0,0,,0,3,3,0,1,1,1,2,5,2.4
Mindaugas Kuzminskas,27-023,F,11/11/16,NYK,BOS,0,16,2,5,0.4,2,4,0.5,0,1,0,1,2,0.5,1,1,2,2,0,0,2,0,5,2.3
Manu Ginobili,39-233,G,3/18/17,SAS,MEM,0,16,2,5,0.4,1,2,0.5,1,3,0.333,0,0,,0,0,0,1,0,1,3,2,5,-0.1
Willie Reed,26-329,F-C,4/10/17,MIA,CLE,0,8,1,1,1,1,1,1,0,0,,3,3,1,2,1,3,0,0,0,0,1,5,6
Avery Bradley,26-051,G,1/16/17,BOS,CHO,1,33,2,9,0.222,1,3,0.333,1,6,0.167,0,0,,0,3,3,3,2,0,2,2,5,1.7
Gerald Green,31-002,G-F,1/28/17,BOS,MIL,0,13,2,7,0.286,1,4,0.25,1,3,0.333,0,0,,0,1,1,0,0,1,0,2,5,1.1
Cristiano Felicio,24-184,F-C,1/7/17,CHI,TOR,0,26,2,5,0.4,2,5,0.4,0,0,,1,1,1,5,3,8,2,0,0,1,6,5,4.7
James Ennis,26-181,F,12/29/16,MEM,OKC,0,24,1,2,0.5,0,1,0,1,1,1,2,2,1,0,1,1,1,0,0,0,0,5,5
Elfrid Payton,22-268,G,11/16/16,ORL,NOP,1,30,2,9,0.222,2,6,0.333,0,3,0,1,2,0.5,1,3,4,4,3,2,1,2,5,6.1
Shabazz Muhammad,24-103,F-G,2/24/17,MIN,DAL,0,16,2,6,0.333,2,4,0.5,0,2,0,1,1,1,0,2,2,0,0,0,0,0,5,2.2
Frank Kaminsky,23-284,F-C,1/13/17,CHO,PHI,0,22,2,10,0.2,1,6,0.167,1,4,0.25,0,0,,2,0,2,0,0,0,1,0,5,-0.8
Doug McDermott,25-070,F,3/14/17,OKC,BRK,0,14,1,4,0.25,0,2,0,1,2,0.5,2,2,1,0,1,1,0,0,0,0,1,5,2.5
Matthew Dellavedova,26-132,G,1/18/17,MIL,HOU,0,17,2,6,0.333,1,2,0.5,1,4,0.25,0,0,,0,0,0,2,1,0,2,1,5,1.6
Jared Dudley,31-136,F-G,11/23/16,PHO,ORL,0,26,1,4,0.25,0,0,,1,4,0.25,2,2,1,0,4,4,3,0,0,0,3,5,4.7
Harrison Barnes,24-295,F,3/21/17,DAL,GSW,1,34,2,10,0.2,2,9,0.222,0,1,0,1,2,0.5,1,3,4,2,1,0,0,2,5,1.6
Brandon Jennings,27-193,G,4/4/17,WAS,CHO,0,14,2,5,0.4,1,3,0.333,1,2,0.5,0,0,,0,1,1,3,0,0,1,0,5,3.7
Frank Kaminsky,23-298,F-C,1/27/17,CHO,NYK,0,22,2,6,0.333,1,3,0.333,1,3,0.333,0,0,,1,3,4,1,0,1,1,3,5,2.4
Sam Dekker,22-231,F,12/23/16,HOU,MEM,0,17,2,6,0.333,1,3,0.333,1,3,0.333,0,0,,1,0,1,0,0,0,0,2,5,1.5
Kenneth Faried,27-121,F,3/20/17,DEN,HOU,0,10,2,6,0.333,2,6,0.333,0,0,,1,1,1,3,0,3,0,0,0,4,2,5,-1.1
Terry Rozier,22-314,G,1/25/17,BOS,HOU,0,19,2,7,0.286,1,4,0.25,1,3,0.333,0,0,,1,2,3,1,2,0,0,1,5,4.5
Kyle Singler,28-223,F,12/13/16,OKC,POR,0,6,1,1,1,0,0,,1,1,1,2,2,1,0,2,2,1,0,0,0,0,5,6
Maurice Harkless,23-188,F-G,11/15/16,POR,CHI,1,29,2,9,0.222,1,5,0.2,1,4,0.25,0,0,,3,5,8,1,3,1,0,4,5,5.9
Rajon Rondo,31-028,G,3/22/17,CHI,DET,1,28,2,5,0.4,1,3,0.333,1,2,0.5,0,0,,0,2,2,9,1,0,2,3,5,7
Jonathon Simmons,27-079,G-F,12/2/16,SAS,WAS,0,14,0,0,,0,0,,0,0,,5,6,0.833,0,0,0,1,2,1,1,0,5,7
Mario Hezonja,21-311,F-G,1/1/17,ORL,IND,0,4,1,2,0.5,0,1,0,1,1,1,2,2,1,0,0,0,0,0,1,0,0,5,4.7
Ian Mahinmi,30-144,C,3/29/17,WAS,LAC,0,24,2,6,0.333,2,6,0.333,0,0,,1,5,0.2,5,3,8,1,0,0,0,6,5,2.7
Sergio Rodriguez,30-177,G,12/6/16,PHI,MEM,1,23,2,7,0.286,1,3,0.333,1,4,0.25,0,0,,0,3,3,3,0,0,3,3,5,-0.3
Rondae Hollis-Jefferson,21-337,F,12/5/16,BRK,WAS,0,23,2,5,0.4,2,5,0.4,0,0,,1,2,0.5,1,4,5,5,0,0,1,1,5,5.9
Paul Pierce,39-154,F-G,3/16/17,LAC,DEN,0,16,2,7,0.286,1,2,0.5,1,5,0.2,0,0,,0,4,4,0,0,0,1,0,5,1.1
Arron Afflalo,31-048,G,12/2/16,SAC,BOS,1,17,2,4,0.5,2,4,0.5,0,0,,1,2,0.5,1,2,3,2,2,0,0,0,5,7.3
Anthony Bennett,23-251,F,11/20/16,BRK,POR,0,6,1,2,0.5,1,1,1,0,1,0,3,7,0.429,3,1,4,1,0,0,0,0,5,5.5
Randy Foye,33-142,G,2/13/17,BRK,MEM,1,16,2,4,0.5,1,2,0.5,1,2,0.5,0,0,,0,1,1,2,1,0,1,1,5,4.3
Will Barton,25-341,G,12/12/16,DEN,DAL,1,33,2,12,0.167,1,9,0.111,1,3,0.333,0,0,,2,1,3,1,1,0,2,0,5,-1.2
Davis Bertans,23-348,F,10/25/16,SAS,GSW,0,4,2,2,1,1,1,1,1,1,1,0,0,,0,1,1,0,0,0,0,0,5,4.7
Sam Dekker,22-190,F,11/12/16,HOU,SAS,0,11,2,3,0.667,1,1,1,1,2,0.5,0,0,,0,1,1,0,0,0,0,2,5,3.2
Glenn Robinson,23-047,G-F,2/24/17,IND,MEM,0,14,2,4,0.5,1,2,0.5,1,2,0.5,0,0,,2,1,3,1,0,0,2,0,5,3.4
Wesley Matthews,30-160,G,3/23/17,DAL,LAC,1,35,1,8,0.125,0,4,0,1,4,0.25,2,3,0.667,0,4,4,6,1,1,1,3,5,4.3
Kelly Oubre,20-348,F,11/21/16,WAS,PHO,0,25,2,5,0.4,2,3,0.667,0,2,0,1,4,0.25,0,4,4,2,0,0,0,1,5,3.3
Gerald Henderson,28-363,G,12/6/16,PHI,MEM,1,16,2,4,0.5,1,3,0.333,1,1,1,0,1,0,0,3,3,0,0,0,1,1,5,2.1
Terrence Jones,24-352,F,12/26/16,NOP,DAL,0,12,1,3,0.333,1,2,0.5,0,1,0,3,4,0.75,0,3,3,0,0,1,1,0,5,3.5
Matthew Dellavedova,26-146,G,2/1/17,MIL,UTA,1,26,2,6,0.333,1,3,0.333,1,3,0.333,0,0,,0,1,1,6,1,0,4,2,5,2.3
Mindaugas Kuzminskas,27-159,F,3/27/17,NYK,DET,0,22,2,6,0.333,1,3,0.333,1,3,0.333,0,0,,0,0,0,4,1,0,1,2,5,3.6
Michael Beasley,27-327,F,12/1/16,MIL,BRK,0,17,1,4,0.25,1,4,0.25,0,0,,3,4,0.75,2,5,7,1,1,0,2,0,5,4.8
Anthony Morrow,31-111,G,1/16/17,OKC,LAC,0,5,1,1,1,0,0,,1,1,1,2,2,1,0,0,0,0,0,0,0,1,5,4.3
Marreese Speights,29-104,C-F,11/16/16,LAC,MEM,0,14,2,5,0.4,2,4,0.5,0,1,0,1,1,1,1,1,2,0,0,0,0,3,5,2.1
Bobby Portis,21-281,F,11/17/16,CHI,UTA,0,10,1,3,0.333,0,1,0,1,2,0.5,2,2,1,0,0,0,1,0,1,0,1,5,4.3
Terrence Jones,25-028,F,2/6/17,NOP,PHO,1,24,2,8,0.25,2,7,0.286,0,1,0,1,2,0.5,0,9,9,0,2,0,1,6,5,1.1
Joe Ingles,29-092,F-G,1/2/17,UTA,BRK,0,28,2,6,0.333,1,2,0.5,1,4,0.25,0,0,,1,8,9,2,1,1,1,1,5,6.4
Alex Abrines,23-094,G-F,11/3/16,OKC,GSW,0,19,1,6,0.167,0,0,,1,6,0.167,2,2,1,1,2,3,1,0,0,0,0,5,3.2
Mindaugas Kuzminskas,27-021,F,11/9/16,NYK,BRK,0,17,2,4,0.5,1,1,1,1,3,0.333,0,0,,1,1,2,1,2,0,0,3,5,5.5
Alex Abrines,23-233,G-F,3/22/17,OKC,PHI,0,24,1,6,0.167,0,1,0,1,5,0.2,2,2,1,0,3,3,0,1,1,1,2,5,2
Matt Barnes,36-362,F,3/6/17,GSW,ATL,0,18,1,5,0.2,0,1,0,1,4,0.25,2,2,1,2,5,7,3,0,1,3,0,5,4.6
Trevor Ariza,31-118,F,10/26/16,HOU,LAL,1,33,2,8,0.25,1,4,0.25,1,4,0.25,0,0,,0,6,6,2,1,0,0,2,5,3.6
Yogi Ferrell,23-291,G,2/24/17,DAL,MIN,1,30,2,9,0.222,1,3,0.333,1,6,0.167,0,1,0,0,3,3,4,1,0,3,2,5,0
Marreese Speights,29-237,C-F,3/29/17,LAC,WAS,0,10,2,5,0.4,1,2,0.5,1,3,0.333,0,0,,1,1,2,0,0,2,1,4,5,2.1
Iman Shumpert,26-223,G,2/4/17,CLE,NYK,1,36,2,7,0.286,1,1,1,1,6,0.167,0,0,,1,8,9,2,0,0,0,3,5,4.2
Kyle O'Quinn,26-264,F-C,12/15/16,NYK,GSW,0,15,2,4,0.5,2,4,0.5,0,0,,1,3,0.333,2,5,7,0,1,0,2,2,5,3.3
Danny Green,29-257,G-F,3/6/17,SAS,HOU,1,33,2,8,0.25,1,2,0.5,1,6,0.167,0,0,,0,4,4,5,2,0,0,1,5,6.5
Channing Frye,33-312,C-F,3/25/17,CLE,WAS,0,6,2,2,1,1,1,1,1,1,1,0,0,,0,2,2,0,0,1,0,0,5,5.7
Tim Frazier,26-120,G,3/1/17,NOP,DET,0,13,2,3,0.667,2,3,0.667,0,0,,1,2,0.5,1,2,3,1,1,0,3,2,5,2.5
Justin Anderson,23-071,G,1/29/17,DAL,SAS,0,7,2,4,0.5,1,1,1,1,3,0.333,0,0,,0,1,1,0,0,0,0,0,5,3.3
Amir Johnson,29-286,F,2/11/17,BOS,UTA,1,14,2,2,1,2,2,1,0,0,,1,2,0.5,0,3,3,2,1,0,2,1,5,4.9
Kelly Olynyk,25-209,C-F,11/14/16,BOS,NOP,1,35,1,8,0.125,0,1,0,1,7,0.143,2,2,1,0,8,8,1,0,0,2,6,5,-1.5
Dewayne Dedmon,27-158,C,1/17/17,SAS,MIN,0,19,2,4,0.5,2,4,0.5,0,0,,1,2,0.5,2,6,8,0,1,0,0,3,5,5.6
Ed Davis,27-263,F,2/23/17,POR,ORL,0,13,1,3,0.333,1,3,0.333,0,0,,3,6,0.5,2,3,5,0,0,0,1,3,5,2.2
Wilson Chandler,29-325,F,3/31/17,DEN,CHO,0,20,2,8,0.25,1,4,0.25,1,4,0.25,0,1,0,0,1,1,1,0,0,1,1,5,-0.6
Solomon Hill,25-252,F,11/25/16,NOP,POR,1,27,2,4,0.5,1,3,0.333,1,1,1,0,0,,2,4,6,0,1,1,1,0,5,6.3
Courtney Lee,31-145,G,2/25/17,NYK,PHI,1,24,2,7,0.286,1,3,0.333,1,4,0.25,0,0,,0,4,4,2,1,0,0,1,5,4.1
Trevor Booker,28-341,F,10/31/16,BRK,CHI,1,19,2,7,0.286,2,5,0.4,0,2,0,1,2,0.5,2,6,8,0,3,0,1,0,5,5.7
Joffrey Lauvergne,25-038,C-F,11/7/16,OKC,MIA,0,16,2,9,0.222,1,5,0.2,1,4,0.25,0,0,,1,1,2,0,1,1,1,2,5,0.4
Salah Mejri,30-254,C,2/24/17,DAL,MIN,0,19,2,4,0.5,2,4,0.5,0,0,,1,2,0.5,1,6,7,0,1,2,1,5,5,4.5
Rajon Rondo,31-041,G,4/4/17,CHI,NYK,1,25,2,6,0.333,1,4,0.25,1,2,0.5,0,0,,2,5,7,9,0,0,2,0,5,8.8
Thabo Sefolosha,32-303,G-F,3/1/17,ATL,DAL,1,32,2,4,0.5,1,1,1,1,3,0.333,0,0,,1,4,5,1,3,0,0,1,5,8.2
Matt Barnes,36-300,F,1/3/17,SAC,DEN,1,28,2,6,0.333,1,2,0.5,1,4,0.25,0,0,,0,3,3,3,1,0,0,1,5,5.2
Terry Rozier,22-223,G,10/26/16,BOS,BRK,0,28,2,5,0.4,1,3,0.333,1,2,0.5,0,0,,0,3,3,3,2,0,1,2,5,5.5
Darrun Hilliard,23-230,G,11/29/16,DET,CHO,0,9,2,4,0.5,1,2,0.5,1,2,0.5,0,1,0,0,0,0,0,1,0,0,2,5,2.8
Ricky Rubio,26-116,G,2/14/17,MIN,CLE,1,39,2,8,0.25,2,6,0.333,0,2,0,1,2,0.5,1,7,8,16,2,0,4,3,5,10.6
Paul Pierce,39-050,F-G,12/2/16,LAC,NOP,0,9,1,2,0.5,0,0,,1,2,0.5,2,2,1,0,0,0,0,0,1,1,3,5,2.5
Markieff Morris,27-068,F,11/9/16,WAS,BOS,1,17,2,6,0.333,1,5,0.2,1,1,1,0,0,,0,6,6,1,1,0,3,3,5,0.9
Trey Lyles,21-154,F,4/8/17,UTA,POR,0,6,1,3,0.333,0,2,0,1,1,1,2,2,1,1,1,2,0,0,0,0,0,5,4.3
Iman Shumpert,26-171,G,12/14/16,CLE,MEM,0,22,2,5,0.4,2,3,0.667,0,2,0,1,2,0.5,0,5,5,3,0,0,5,0,5,0.5
Norman Powell,23-187,G,11/28/16,TOR,PHI,0,11,1,3,0.333,1,3,0.333,0,0,,3,3,1,0,0,0,3,1,1,1,2,5,5.3
Randy Foye,33-185,G,3/28/17,BRK,PHI,1,14,2,4,0.5,1,2,0.5,1,2,0.5,0,0,,0,1,1,1,0,0,1,2,5,2.2
Tyler Johnson,24-196,G,11/19/16,MIA,WAS,0,25,1,9,0.111,0,5,0,1,4,0.25,2,2,1,1,2,3,4,0,0,1,2,5,1.4
Ersan Ilyasova,29-286,F,2/25/17,ATL,ORL,0,25,2,10,0.2,2,9,0.222,0,1,0,1,2,0.5,3,7,10,2,0,0,2,4,5,0.4
Andrew Harrison,22-017,G,11/14/16,MEM,UTA,0,26,1,4,0.25,0,2,0,1,2,0.5,2,2,1,0,2,2,2,0,0,1,5,5,1.6
Patty Mills,28-126,G,12/15/16,SAS,PHO,0,18,2,9,0.222,1,3,0.333,1,6,0.167,0,0,,0,1,1,3,1,0,1,3,5,0.7
Joe Ingles,29-075,F-G,12/16/16,UTA,DAL,0,21,2,3,0.667,1,1,1,1,2,0.5,0,0,,0,2,2,1,0,0,2,4,5,1.4
Ersan Ilyasova,29-294,F,3/5/17,ATL,IND,0,21,2,4,0.5,1,1,1,1,3,0.333,0,0,,1,3,4,1,0,0,0,0,5,5.3
Kyle Korver,35-224,G-F,10/27/16,ATL,WAS,1,22,2,4,0.5,1,1,1,1,3,0.333,0,0,,0,3,3,4,1,0,2,3,5,4.5
Danny Green,29-143,G-F,11/12/16,SAS,HOU,1,27,2,4,0.5,1,2,0.5,1,2,0.5,0,0,,0,0,0,2,0,2,1,2,5,4
Buddy Hield,23-039,G,1/25/17,NOP,OKC,1,23,2,10,0.2,1,7,0.143,1,3,0.333,0,0,,0,3,3,1,0,0,0,1,5,0
James Ennis,26-140,F,11/18/16,MEM,DAL,1,30,2,5,0.4,1,3,0.333,1,2,0.5,0,0,,1,5,6,4,1,0,0,4,5,6.7
Ryan Anderson,28-197,F,11/19/16,HOU,UTA,1,32,2,9,0.222,1,4,0.25,1,5,0.2,0,0,,1,2,3,0,0,0,0,1,5,0.4
Monta Ellis,31-026,G,11/21/16,IND,GSW,1,23,2,8,0.25,1,5,0.2,1,3,0.333,0,0,,0,2,2,1,0,1,4,3,5,-3
Patrick Patterson,27-228,F,10/28/16,TOR,CLE,0,34,2,6,0.333,1,1,1,1,5,0.2,0,0,,1,5,6,3,1,0,0,2,5,6.1
Brandon Jennings,27-088,G,12/20/16,NYK,IND,0,22,2,3,0.667,2,3,0.667,0,0,,1,2,0.5,0,3,3,6,1,0,3,2,5,5.6
E'Twaun Moore,27-248,G,11/2/16,NOP,MEM,1,27,2,6,0.333,2,3,0.667,0,3,0,1,2,0.5,0,3,3,1,0,1,2,2,5,0.7
Nicolas Brussino,23-261,G-F,11/18/16,DAL,MEM,0,14,1,3,0.333,0,0,,1,3,0.333,2,2,1,1,3,4,0,0,0,1,0,5,3.9
Terrence Ross,25-350,F-G,1/20/17,TOR,CHO,0,27,2,9,0.222,1,5,0.2,1,4,0.25,0,0,,0,4,4,1,2,0,0,1,5,3
Dewayne Dedmon,27-116,C,12/6/16,SAS,MIN,0,24,2,2,1,2,2,1,0,0,,1,2,0.5,1,7,8,0,0,0,0,2,5,6
Ian Clark,25-232,G,10/25/16,GSW,SAS,0,13,2,8,0.25,2,4,0.5,0,4,0,1,2,0.5,0,0,0,2,0,1,0,0,5,1.9
Troy Daniels,25-148,G,12/10/16,MEM,GSW,0,22,2,9,0.222,1,3,0.333,1,6,0.167,0,1,0,2,1,3,1,1,0,0,3,5,1.3
Doug McDermott,24-314,F,11/12/16,CHI,WAS,0,18,2,6,0.333,2,5,0.4,0,1,0,1,1,1,0,1,1,2,0,0,1,0,5,2.3
JaMychal Green,26-144,F,11/12/16,MEM,MIL,1,23,2,6,0.333,2,6,0.333,0,0,,1,1,1,1,2,3,2,0,0,2,4,5,0.7
Isaiah Canaan,25-233,G,1/9/17,CHI,OKC,0,8,1,3,0.333,0,2,0,1,1,1,2,2,1,1,0,1,2,0,0,1,0,5,4.4
Bismack Biyombo,24-080,C-F,11/16/16,ORL,NOP,0,25,2,4,0.5,2,4,0.5,0,0,,1,2,0.5,5,3,8,1,1,1,2,4,5,5.8
Rodney Hood,24-098,G-F,1/26/17,UTA,LAL,1,22,2,6,0.333,1,2,0.5,1,4,0.25,0,0,,0,4,4,0,0,0,0,2,5,2
Nikola Mirotic,25-344,F,1/20/17,CHI,ATL,0,17,1,6,0.167,1,1,1,0,5,0,3,4,0.75,1,3,4,2,0,0,1,5,5,0.8
Mindaugas Kuzminskas,27-049,F,12/7/16,NYK,CLE,0,17,1,5,0.2,0,2,0,1,3,0.333,2,2,1,0,0,0,1,1,0,3,1,5,0.2
Ty Lawson,29-086,G,1/28/17,SAC,CHO,0,32,2,6,0.333,2,5,0.4,0,1,0,1,2,0.5,0,0,0,9,1,0,2,0,5,6.5
Tarik Black,25-134,C-F,4/5/17,LAL,SAS,0,27,2,4,0.5,2,4,0.5,0,0,,1,1,1,0,8,8,2,0,1,0,1,5,7.1
Dario Saric,22-204,F,10/29/16,PHI,ATL,1,26,2,9,0.222,1,6,0.167,1,3,0.333,0,0,,0,4,4,2,0,0,1,1,5,0.7
Dorian Finney-Smith,23-270,F,1/29/17,DAL,SAS,0,17,2,5,0.4,2,3,0.667,0,2,0,1,1,1,0,2,2,0,0,1,0,3,5,2.4
Manny Harris,27-177,G,3/17/17,DAL,PHI,0,16,2,9,0.222,2,8,0.25,0,1,0,1,2,0.5,1,5,6,2,0,0,1,1,5,1.3
Kris Humphries,32-064,F-C,4/11/17,ATL,CHO,0,11,1,4,0.25,0,2,0,1,2,0.5,2,2,1,2,2,4,0,3,0,1,0,5,6.6
Mike Scott,28-163,F,12/26/16,ATL,MIN,0,18,2,6,0.333,1,1,1,1,5,0.2,0,0,,0,3,3,1,1,1,1,0,5,3.9
Al-Farouq Aminu,26-038,F,10/29/16,POR,DEN,1,32,1,6,0.167,0,0,,1,6,0.167,2,4,0.5,1,11,12,1,2,3,1,4,5,6.6
Nemanja Bjelica,28-242,F,1/6/17,MIN,WAS,0,11,2,5,0.4,1,1,1,1,4,0.25,0,0,,0,1,1,0,0,0,0,0,5,2.6
Mason Plumlee,26-364,C-F,3/4/17,DEN,CHO,0,15,2,4,0.5,2,4,0.5,0,0,,1,1,1,3,3,6,1,0,1,2,4,5,3.8
Brandon Rush,31-214,G-F,2/6/17,MIN,MIA,1,33,2,4,0.5,1,2,0.5,1,2,0.5,0,0,,0,3,3,2,1,0,2,0,5,4.3
Al-Farouq Aminu,26-091,F,12/21/16,POR,DAL,1,30,1,4,0.25,0,2,0,1,2,0.5,2,2,1,0,6,6,2,2,0,1,2,5,6
Draymond Green,27-006,F,3/10/17,GSW,MIN,1,38,1,8,0.125,1,5,0.2,0,3,0,3,4,0.75,3,4,7,7,2,1,0,4,5,8.7
Kyle Singler,28-259,F,1/18/17,OKC,GSW,0,17,2,4,0.5,1,2,0.5,1,2,0.5,0,0,,1,1,2,0,0,0,0,1,5,3.6
Wesley Johnson,29-184,F-G,1/11/17,LAC,ORL,0,18,2,4,0.5,1,2,0.5,1,2,0.5,0,0,,0,3,3,1,2,0,0,2,5,5.8
Shaun Livingston,31-206,G,4/5/17,GSW,PHO,0,25,2,3,0.667,1,2,0.5,1,1,1,0,0,,0,1,1,2,1,0,0,2,5,5.6
Tyson Chandler,34-026,C,10/28/16,PHO,OKC,1,38,2,3,0.667,2,3,0.667,0,0,,1,1,1,2,8,10,0,1,0,2,5,5,4.5
Kelly Olynyk,25-214,C-F,11/19/16,BOS,DET,0,14,2,3,0.667,1,1,1,1,2,0.5,0,0,,0,1,1,1,0,0,1,1,5,3.3
Shabazz Muhammad,23-356,F-G,11/3/16,MIN,DEN,0,13,2,5,0.4,1,4,0.25,1,1,1,0,0,,1,0,1,0,1,0,0,0,5,4
Davis Bertans,24-095,F,2/15/17,SAS,ORL,0,16,1,7,0.143,0,1,0,1,6,0.167,2,2,1,0,0,0,1,1,0,0,2,5,1.4
Kelly Oubre,20-323,F,10/27/16,WAS,ATL,0,22,1,6,0.167,0,2,0,1,4,0.25,2,4,0.5,0,1,1,1,1,0,0,1,5,2
Yogi Ferrell,23-184,G,11/9/16,BRK,NYK,0,14,2,3,0.667,1,2,0.5,1,1,1,0,0,,0,1,1,3,1,0,3,0,5,4.1
Draymond Green,26-286,F,12/15/16,GSW,NYK,1,32,2,12,0.167,1,7,0.143,1,5,0.2,0,0,,5,6,11,7,0,2,3,3,5,4.8
Ron Baker,23-291,G,1/15/17,NYK,TOR,0,16,2,3,0.667,1,1,1,1,2,0.5,0,0,,0,3,3,1,0,2,1,0,5,5.7
Kelly Olynyk,25-255,C-F,12/30/16,BOS,MIA,0,19,2,7,0.286,2,5,0.4,0,2,0,1,2,0.5,0,2,2,3,0,1,2,1,5,1.5
Andre Iguodala,32-322,G-F,12/15/16,GSW,NYK,0,21,2,3,0.667,2,2,1,0,1,0,1,2,0.5,1,3,4,3,1,2,1,5,5,6.4
Willy Hernangomez,22-257,C,2/8/17,NYK,LAC,0,20,0,3,0,0,3,0,0,0,,5,6,0.833,2,7,9,4,0,0,1,3,5,6.6
Nik Stauskas,23-096,G,1/11/17,PHI,NYK,1,22,2,6,0.333,1,2,0.5,1,4,0.25,0,0,,1,1,2,3,0,0,1,1,5,3.3
Norman Powell,23-238,G,1/18/17,TOR,PHI,0,18,2,6,0.333,1,4,0.25,1,2,0.5,0,0,,1,2,3,0,1,1,0,3,5,3.4
Shabazz Napier,25-129,G,11/20/16,POR,BRK,0,5,1,2,0.5,0,0,,1,2,0.5,2,2,1,0,0,0,0,0,0,0,0,5,4
Jonathon Simmons,27-058,G-F,11/11/16,SAS,DET,0,18,0,3,0,0,1,0,0,2,0,5,6,0.833,0,4,4,2,0,0,0,2,5,4.3
Ryan Anderson,28-175,F,10/28/16,HOU,DAL,1,25,2,5,0.4,1,4,0.25,1,1,1,0,0,,1,3,4,0,0,0,2,2,5,1.1
Kentavious Caldwell-Pope,24-051,G,4/10/17,DET,WAS,1,28,2,7,0.286,1,2,0.5,1,5,0.2,0,0,,0,2,2,2,0,0,0,2,5,2.1
D'Angelo Russell,20-329,G,1/17/17,LAL,DEN,1,17,2,9,0.222,1,7,0.143,1,2,0.5,0,0,,1,1,2,3,1,0,1,2,5,1.8
Mike Dunleavy,36-130,F-G,1/23/17,ATL,LAC,0,17,2,2,1,1,1,1,1,1,1,0,0,,0,1,1,1,0,0,0,2,5,4.6
Alex Len,23-170,C,12/3/16,PHO,GSW,0,17,1,3,0.333,1,3,0.333,0,0,,3,4,0.75,0,1,1,2,0,0,1,3,5,2.4
Tarik Black,25-111,C-F,3/13/17,LAL,DEN,0,14,2,5,0.4,2,5,0.4,0,0,,1,1,1,2,1,3,0,0,0,3,3,5,-0.2
Sergio Rodriguez,30-232,G,1/30/17,PHI,SAC,0,14,2,5,0.4,1,2,0.5,1,3,0.333,0,0,,0,0,0,1,0,0,1,0,5,2
Kyle Anderson,23-145,F-G,2/12/17,SAS,NYK,0,7,1,3,0.333,1,3,0.333,0,0,,3,3,1,0,1,1,0,0,0,1,0,5,2.6
Courtney Lee,31-153,G,3/5/17,NYK,GSW,1,29,2,5,0.4,1,3,0.333,1,2,0.5,0,0,,0,0,0,1,3,0,1,4,5,3.4
Vince Carter,39-330,G-F,12/21/16,MEM,DET,0,16,2,4,0.5,1,1,1,1,3,0.333,0,0,,0,0,0,0,0,0,0,0,5,3
Caris LeVert,22-123,G-F,12/26/16,BRK,CHO,0,15,2,3,0.667,1,1,1,1,2,0.5,0,0,,0,1,1,1,0,0,1,2,5,2.9
Timofey Mozgov,30-174,C,1/6/17,LAL,MIA,1,16,2,4,0.5,2,4,0.5,0,0,,1,2,0.5,0,2,2,0,0,0,2,1,5,0.8
Corey Brewer,31-031,F-G,4/5/17,LAL,SAS,0,21,2,6,0.333,1,4,0.25,1,2,0.5,0,0,,0,1,1,4,2,0,2,1,5,4.3
Domantas Sabonis,20-176,F,10/26/16,OKC,PHI,1,16,2,5,0.4,1,2,0.5,1,3,0.333,0,0,,0,4,4,0,0,0,0,2,5,2.7
Anthony Bennett,23-297,F,1/5/17,BRK,IND,0,3,2,2,1,1,1,1,1,1,1,0,0,,0,1,1,0,0,0,0,0,5,4.7
Danny Green,29-175,G-F,12/14/16,SAS,BOS,1,23,2,4,0.5,1,2,0.5,1,2,0.5,0,0,,0,0,0,1,0,0,1,3,5,1.5
Brandon Ingram,19-135,F,1/15/17,LAL,DET,0,28,1,7,0.143,1,6,0.167,0,1,0,3,6,0.5,2,2,4,3,0,1,0,0,5,4.1
Tiago Splitter,32-089,F-C,3/31/17,PHI,CLE,0,8,1,2,0.5,0,1,0,1,1,1,2,3,0.667,0,2,2,1,0,0,1,1,5,3.5
Michael Kidd-Gilchrist,23-127,F,1/31/17,CHO,POR,1,24,1,5,0.2,1,5,0.2,0,0,,3,4,0.75,0,5,5,2,0,0,0,5,5,2.4
Rudy Gobert,24-196,C,1/8/17,UTA,MEM,1,36,1,3,0.333,1,3,0.333,0,0,,3,6,0.5,7,5,12,2,3,1,3,3,5,9.4
Alex Abrines,23-094,G-F,11/3/16,OKC,GSW,0,19,1,6,0.167,0,0,,1,6,0.167,2,2,1,1,2,3,1,0,0,0,0,5,3.2
Marco Belinelli,30-288,G-F,1/7/17,CHO,SAS,0,27,2,10,0.2,1,6,0.167,1,4,0.25,0,0,,1,3,4,2,0,0,1,0,5,0.8
Solomon Hill,26-003,F,3/21/17,NOP,MEM,1,34,1,7,0.143,1,4,0.25,0,3,0,3,4,0.75,1,4,5,2,1,0,2,2,5,1.6
Juan Hernangomez,21-191,F,4/7/17,DEN,NOP,0,4,1,3,0.333,0,0,,1,3,0.333,2,2,1,0,1,1,0,0,0,2,0,5,1.6
Allen Crabbe,24-222,G-F,11/17/16,POR,HOU,1,20,1,5,0.2,0,2,0,1,3,0.333,2,2,1,0,1,1,1,1,0,1,1,5,2.5
Shabazz Muhammad,24-045,F-G,12/28/16,MIN,DEN,0,19,2,4,0.5,1,3,0.333,1,1,1,0,0,,1,1,2,0,0,0,0,3,5,2.8
Jamal Murray,19-336,G,1/24/17,DEN,UTA,0,17,1,3,0.333,1,2,0.5,0,1,0,3,4,0.75,0,2,2,5,1,0,2,2,5,5.2
J.R. Smith,31-213,G-F,4/10/17,CLE,MIA,1,40,2,9,0.222,1,4,0.25,1,5,0.2,0,0,,1,3,4,2,2,0,2,3,5,1.3
Markieff Morris,27-080,F,11/21/16,WAS,PHO,1,26,2,8,0.25,2,6,0.333,0,2,0,1,4,0.25,4,1,5,1,2,0,2,3,5,1.6
Justin Anderson,23-016,G,12/5/16,DAL,CHO,0,17,2,7,0.286,1,3,0.333,1,4,0.25,0,0,,0,1,1,0,1,0,1,1,5,0.8
Seth Curry,26-202,G,3/13/17,DAL,TOR,1,32,2,8,0.25,1,4,0.25,1,4,0.25,0,0,,0,3,3,0,2,0,1,1,5,1.7
Clint Capela,22-245,F-C,1/18/17,HOU,MIL,0,11,2,3,0.667,2,3,0.667,0,0,,1,2,0.5,1,2,3,0,0,2,0,1,5,5.6
Anthony Morrow,31-137,G,2/11/17,OKC,GSW,0,17,1,5,0.2,0,3,0,1,2,0.5,2,2,1,1,0,1,0,1,0,0,1,5,3.2
Ricky Rubio,26-070,G,12/30/16,MIN,MIL,1,35,2,4,0.5,1,1,1,1,3,0.333,0,0,,1,0,1,9,4,0,2,2,5,11.2
Wade Baldwin,20-214,G,10/29/16,MEM,NYK,0,22,2,4,0.5,1,3,0.333,1,1,1,0,0,,0,2,2,3,0,0,2,1,5,3.3
Dragan Bender,19-076,F,2/1/17,PHO,LAC,0,13,2,6,0.333,1,3,0.333,1,3,0.333,0,0,,3,2,5,2,0,0,0,1,5,5.3
Jae Crowder,26-249,F,3/12/17,BOS,CHI,1,25,2,9,0.222,1,4,0.25,1,5,0.2,0,0,,0,10,10,3,1,0,1,2,5,3.8
Garrett Temple,30-232,G,12/26/16,SAC,PHI,0,29,1,4,0.25,0,1,0,1,3,0.333,2,2,1,0,1,1,3,1,0,1,0,5,5
Alexis Ajinca,28-185,C,11/7/16,NOP,GSW,0,6,2,2,1,2,2,1,0,0,,1,2,0.5,0,2,2,0,0,0,1,0,5,3.6
Kelly Olynyk,25-313,C-F,2/26/17,BOS,DET,0,19,2,8,0.25,1,5,0.2,1,3,0.333,0,0,,0,6,6,1,1,0,3,3,5,-0.5
Jameer Nelson,34-297,G,12/2/16,DEN,HOU,0,19,2,5,0.4,1,2,0.5,1,3,0.333,0,0,,0,1,1,2,0,0,2,3,5,0.8
Matthew Dellavedova,26-056,G,11/3/16,MIL,IND,1,24,2,6,0.333,2,3,0.667,0,3,0,1,1,1,0,2,2,4,1,0,5,5,5,-1
Stanley Johnson,20-173,F,11/18/16,DET,CLE,0,16,2,3,0.667,2,2,1,0,1,0,1,2,0.5,0,3,3,1,2,1,0,4,5,6
Rodney Hood,24-164,G-F,4/2/17,UTA,SAS,1,27,2,9,0.222,1,4,0.25,1,5,0.2,0,0,,0,1,1,2,1,0,0,2,5,1.4
Terrence Ross,26-060,F-G,4/6/17,ORL,BRK,1,25,2,6,0.333,1,2,0.5,1,4,0.25,0,0,,0,2,2,4,2,0,0,0,5,7
Jamal Crawford,36-332,G,2/15/17,LAC,ATL,0,27,1,7,0.143,0,1,0,1,6,0.167,2,2,1,0,2,2,4,2,0,1,1,5,4.5
Paul Pierce,39-079,F-G,12/31/16,LAC,OKC,1,16,2,5,0.4,2,4,0.5,0,1,0,1,2,0.5,0,3,3,0,0,0,1,2,5,1
Doug McDermott,25-083,F,3/27/17,OKC,DAL,0,13,2,3,0.667,1,1,1,1,2,0.5,0,0,,1,1,2,0,1,0,0,1,5,5.3
Allen Crabbe,24-312,G-F,2/15/17,POR,UTA,0,26,2,8,0.25,1,5,0.2,1,3,0.333,0,0,,0,1,1,0,1,0,3,2,5,-2.3
Iman Shumpert,26-269,G,3/22/17,CLE,DEN,0,17,2,2,1,1,1,1,1,1,1,0,0,,0,3,3,2,0,1,2,0,5,5.4
Rondae Hollis-Jefferson,21-297,F,10/26/16,BRK,BOS,1,24,1,3,0.333,1,2,0.5,0,1,0,3,4,0.75,0,2,2,0,1,0,1,1,5,3.1
Dorian Finney-Smith,23-342,F,4/11/17,DAL,DEN,1,30,2,7,0.286,1,3,0.333,1,4,0.25,0,0,,2,4,6,1,1,0,1,2,5,3.4
Robin Lopez,28-276,C,1/2/17,CHI,CHO,1,23,2,6,0.333,2,6,0.333,0,0,,1,2,0.5,1,4,5,0,0,3,0,1,5,4.8
Matthew Dellavedova,26-106,G,12/23/16,MIL,WAS,1,22,2,6,0.333,1,2,0.5,1,4,0.25,0,0,,0,0,0,4,0,0,1,2,5,2.6
Tyler Ennis,22-186,G,2/26/17,LAL,SAS,0,8,2,3,0.667,1,1,1,1,2,0.5,0,0,,1,0,1,2,1,0,0,0,5,6.8
Buddy Hield,23-057,G,2/12/17,NOP,SAC,1,14,2,5,0.4,1,2,0.5,1,3,0.333,0,0,,0,0,0,2,0,0,0,2,5,2.9
Brandon Rush,31-251,G-F,3/15/17,MIN,BOS,1,28,2,7,0.286,1,2,0.5,1,5,0.2,0,0,,1,2,3,2,1,0,1,3,5,2.4
Mike Dunleavy,36-085,F-G,12/9/16,CLE,MIA,0,22,1,3,0.333,0,1,0,1,2,0.5,2,2,1,0,2,2,1,0,0,0,1,5,4.2
T.J. McConnell,24-239,G,11/19/16,PHI,PHO,0,19,2,6,0.333,2,6,0.333,0,0,,1,2,0.5,1,1,2,6,3,0,2,1,5,7
Marreese Speights,29-206,C-F,2/26/17,LAC,CHO,0,8,1,3,0.333,0,0,,1,3,0.333,2,2,1,0,0,0,0,0,0,1,3,5,1.1
Monta Ellis,31-164,G,4/8/17,IND,ORL,1,25,2,5,0.4,1,3,0.333,1,2,0.5,0,0,,0,1,1,5,1,0,4,2,5,2.3
Ian Clark,25-357,G,2/27/17,GSW,PHI,0,8,2,2,1,1,1,1,1,1,1,0,0,,0,0,0,0,0,0,0,0,5,4.4
Aaron Brooks,32-021,G,2/4/17,IND,DET,0,17,2,5,0.4,1,2,0.5,1,3,0.333,0,0,,0,1,1,2,0,0,1,0,5,3
Dante Cunningham,29-202,F,11/10/16,NOP,MIL,1,19,2,8,0.25,1,3,0.333,1,5,0.2,0,0,,0,4,4,1,2,1,0,2,5,4
Kenneth Faried,27-001,F,11/20/16,DEN,UTA,1,25,2,6,0.333,2,6,0.333,0,0,,1,3,0.333,2,4,6,0,1,0,0,0,5,4.4
Draymond Green,26-330,F,1/28/17,GSW,LAC,1,26,1,4,0.25,1,3,0.333,0,1,0,3,4,0.75,0,5,5,5,2,2,1,3,5,8.4
Luc Mbah a Moute,30-198,F,3/26/17,LAC,SAC,1,16,2,4,0.5,1,2,0.5,1,2,0.5,0,0,,0,1,1,0,1,0,1,2,5,2.5
Derrick Rose,28-125,G,2/6/17,NYK,LAL,1,32,2,8,0.25,2,7,0.286,0,1,0,1,1,1,0,4,4,3,0,0,3,2,5,-0.3
Yogi Ferrell,23-318,G,3/23/17,DAL,LAC,0,16,2,4,0.5,1,2,0.5,1,2,0.5,0,0,,0,2,2,1,2,0,0,2,5,5.5
Dewayne Dedmon,27-120,C,12/10/16,SAS,BRK,0,8,2,2,1,2,2,1,0,0,,1,1,1,0,6,6,2,0,0,0,1,5,7.2
Alec Burks,25-258,G,4/4/17,UTA,POR,0,22,2,6,0.333,1,5,0.2,1,1,1,0,0,,0,7,7,1,0,0,2,0,5,2.4
Domantas Sabonis,20-337,F,4/5/17,OKC,MEM,0,10,2,4,0.5,1,2,0.5,1,2,0.5,0,0,,1,0,1,0,0,1,0,2,5,3.6
Luc Mbah a Moute,30-105,F,12/23/16,LAC,DAL,1,37,2,5,0.4,2,3,0.667,0,2,0,1,1,1,1,5,6,3,3,2,0,3,5,9.8
Raymond Felton,32-194,G,1/6/17,LAC,SAC,0,21,2,6,0.333,1,5,0.2,1,1,1,0,0,,0,3,3,2,0,1,0,1,5,4.2
Lavoy Allen,28-057,F-C,4/2/17,IND,CLE,0,16,2,2,1,2,2,1,0,0,,1,1,1,1,3,4,0,0,0,0,2,5,5.2
Richard Jefferson,36-157,F,11/25/16,CLE,DAL,0,9,1,2,0.5,0,0,,1,2,0.5,2,2,1,0,2,2,0,0,0,0,0,5,4.6
Jameer Nelson,34-283,G,11/18/16,DEN,TOR,1,37,2,6,0.333,1,3,0.333,1,3,0.333,0,0,,0,3,3,5,0,0,2,5,5,2
Courtney Lee,31-098,G,1/9/17,NYK,NOP,1,28,2,8,0.25,1,5,0.2,1,3,0.333,0,0,,2,0,2,1,0,0,0,1,5,1.9
Devin Harris,33-291,G,12/14/16,DAL,DET,0,14,2,5,0.4,1,2,0.5,1,3,0.333,0,0,,0,1,1,3,0,0,0,2,5,3.9
Dennis Schroder,23-140,G,2/2/17,ATL,HOU,1,21,2,12,0.167,2,9,0.222,0,3,0,1,1,1,0,2,2,3,0,0,3,3,5,-4.1
Ty Lawson,29-017,G,11/20/16,SAC,TOR,1,27,2,7,0.286,1,3,0.333,1,4,0.25,0,0,,0,1,1,5,2,0,1,2,5,4.9
Marreese Speights,29-238,C-F,3/30/17,LAC,PHO,0,13,2,2,1,1,1,1,1,1,1,0,0,,0,4,4,1,0,1,2,3,5,3.8
Quincy Acy,26-103,F,1/17/17,BRK,TOR,0,3,2,4,0.5,2,4,0.5,0,0,,1,1,1,1,0,1,0,0,0,0,0,5,3.7
Draymond Green,26-264,F,11/23/16,GSW,LAL,1,28,1,6,0.167,1,3,0.333,0,3,0,3,6,0.5,1,8,9,11,1,1,0,1,5,12.1
Doug McDermott,24-357,F,12/25/16,CHI,SAS,0,27,2,5,0.4,1,3,0.333,1,2,0.5,0,0,,0,2,2,1,0,0,1,1,5,2.2
Brandon Rush,31-114,G-F,10/29/16,MIN,SAC,0,12,2,3,0.667,1,1,1,1,2,0.5,0,0,,0,1,1,0,0,0,0,0,5,4
J.R. Smith,31-199,G-F,3/27/17,CLE,SAS,1,27,2,7,0.286,1,1,1,1,6,0.167,0,0,,1,3,4,1,1,0,3,3,5,0
Justin Holiday,27-245,G,12/6/16,NYK,MIA,0,18,2,3,0.667,1,1,1,1,2,0.5,0,0,,0,3,3,1,2,0,0,2,5,6.5
Chasson Randle,23-363,G,2/2/17,PHI,SAS,0,15,2,6,0.333,1,4,0.25,1,2,0.5,0,0,,0,1,1,1,0,0,0,2,5,1.8
Miles Plumlee,28-111,C-F,12/21/16,MIL,CLE,0,11,2,4,0.5,2,4,0.5,0,0,,1,2,0.5,0,0,0,1,0,0,0,0,5,3.3
Alex Abrines,23-198,G-F,2/15/17,OKC,NYK,0,16,2,5,0.4,1,3,0.333,1,2,0.5,0,0,,0,1,1,0,0,0,0,2,5,1.8
Brandon Jennings,27-052,G,11/14/16,NYK,DAL,0,23,2,4,0.5,1,1,1,1,3,0.333,0,0,,1,2,3,1,1,0,1,0,5,5
Spencer Dinwiddie,23-286,G,1/17/17,BRK,TOR,1,24,1,3,0.333,1,3,0.333,0,0,,3,4,0.75,0,1,1,3,0,1,4,2,5,1.2
Alan Anderson,34-092,G-F,1/16/17,LAC,OKC,0,19,2,5,0.4,2,5,0.4,0,0,,1,1,1,0,1,1,1,0,0,0,3,5,2.1
Rondae Hollis-Jefferson,22-035,F,2/7/17,BRK,CHO,1,22,2,4,0.5,2,4,0.5,0,0,,1,2,0.5,0,7,7,2,0,4,1,0,5,7.9
Channing Frye,33-317,C-F,3/30/17,CLE,CHI,0,28,2,3,0.667,1,1,1,1,2,0.5,0,0,,0,7,7,1,0,1,2,3,5,4
Timothe Luwawu-Cabarrot,21-304,F,3/9/17,PHI,POR,0,18,1,3,0.333,0,1,0,1,2,0.5,2,2,1,0,0,0,0,1,0,0,1,5,3.9
Shabazz Muhammad,24-055,F-G,1/7/17,MIN,UTA,0,18,2,3,0.667,1,1,1,1,2,0.5,0,0,,0,3,3,0,0,0,0,1,5,4.2
Kenneth Faried,26-355,F,11/8/16,DEN,MEM,0,28,2,4,0.5,2,3,0.667,0,1,0,1,2,0.5,2,9,11,1,0,1,0,2,5,7.3
Glenn Robinson,22-346,G-F,12/19/16,IND,WAS,1,31,2,5,0.4,1,2,0.5,1,3,0.333,0,0,,0,4,4,0,0,0,3,2,5,-0.3
Spencer Dinwiddie,24-006,G,4/12/17,BRK,CHI,1,31,1,5,0.2,0,0,,1,5,0.2,2,2,1,1,3,4,2,1,0,1,4,5,3.3
Devin Harris,34-011,G,3/10/17,DAL,BRK,0,15,2,3,0.667,2,2,1,0,1,0,1,2,0.5,0,1,1,3,0,0,1,0,5,4.7
Ersan Ilyasova,29-166,F,10/28/16,OKC,PHO,0,16,2,3,0.667,1,1,1,1,2,0.5,0,0,,0,5,5,0,1,0,2,2,5,3.4
D.J. Augustin,29-142,G,4/1/17,ORL,BRK,0,16,2,5,0.4,1,3,0.333,1,2,0.5,0,0,,0,1,1,2,1,0,4,0,5,1
Wayne Selden,22-191,G-F,4/9/17,MEM,DET,0,28,2,9,0.222,2,6,0.333,0,3,0,1,2,0.5,0,1,1,2,0,0,0,0,5,0.8
Ish Smith,28-162,G,12/14/16,DET,DAL,0,18,2,5,0.4,2,4,0.5,0,1,0,1,2,0.5,1,3,4,6,0,0,2,2,5,4.9
Julius Randle,22-096,F,3/5/17,LAL,NOP,1,33,2,7,0.286,2,7,0.286,0,0,,1,2,0.5,2,10,12,6,1,0,2,5,5,6.1
Salah Mejri,30-191,C,12/23/16,DAL,LAC,0,21,1,1,1,1,1,1,0,0,,3,5,0.6,5,3,8,1,0,1,1,0,5,8.7
Darrell Arthur,28-260,F,12/10/16,DEN,ORL,1,23,2,5,0.4,1,3,0.333,1,2,0.5,0,0,,0,0,0,4,0,0,0,1,5,4.7
Matthew Dellavedova,26-191,G,3/18/17,MIL,GSW,0,26,2,7,0.286,1,4,0.25,1,3,0.333,0,0,,0,0,0,3,1,0,2,2,5,1.2
Luke Babbitt,27-281,F,3/28/17,MIA,DET,1,14,2,3,0.667,1,1,1,1,2,0.5,0,0,,0,1,1,3,1,0,0,2,5,6.3
Ron Baker,23-334,G,2/27/17,NYK,TOR,0,19,2,4,0.5,1,2,0.5,1,2,0.5,0,0,,0,5,5,2,0,0,4,2,5,1.1
Kris Humphries,32-004,F-C,2/10/17,ATL,SAC,0,12,2,2,1,1,1,1,1,1,1,0,2,0,0,4,4,0,0,0,0,2,5,4
Jose Calderon,35-185,G,4/1/17,ATL,CHI,0,11,2,3,0.667,1,1,1,1,2,0.5,0,0,,1,2,3,1,0,0,2,0,5,3.7
Luol Deng,31-227,F,11/29/16,LAL,NOP,1,22,2,6,0.333,1,2,0.5,1,4,0.25,0,0,,0,2,2,1,1,0,0,0,5,3.9
Serge Ibaka,27-139,F-C,2/4/17,ORL,ATL,1,24,2,9,0.222,1,5,0.2,1,4,0.25,0,0,,2,0,2,2,0,0,2,2,5,-0.5
Kevon Looney,21-009,F-C,2/15/17,GSW,SAC,0,16,2,4,0.5,2,3,0.667,0,1,0,1,2,0.5,0,2,2,1,4,0,0,1,5,7.5
Terry Rozier,22-356,G,3/8/17,BOS,GSW,0,14,2,6,0.333,1,2,0.5,1,4,0.25,0,0,,0,1,1,3,0,0,0,1,5,3.6
Caris LeVert,22-206,G-F,3/19/17,BRK,DAL,1,25,2,6,0.333,1,3,0.333,1,3,0.333,0,0,,0,5,5,1,0,0,1,2,5,2
Khris Middleton,25-180,F-G,2/8/17,MIL,MIA,0,15,2,5,0.4,2,4,0.5,0,1,0,1,2,0.5,0,2,2,2,0,1,0,1,5,4.2
Luke Babbitt,27-215,F,1/21/17,MIA,MIL,1,18,2,4,0.5,1,2,0.5,1,2,0.5,0,0,,1,3,4,0,2,0,0,4,5,5
Stanley Johnson,20-173,F,11/18/16,DET,CLE,0,16,2,3,0.667,2,2,1,0,1,0,1,2,0.5,0,3,3,1,2,1,0,4,5,6
Solomon Hill,25-306,F,1/18/17,NOP,ORL,1,32,2,7,0.286,1,4,0.25,1,3,0.333,0,0,,0,5,5,2,2,0,1,2,5,4
Patrick McCaw,21-146,G,3/20/17,GSW,OKC,1,20,2,2,1,1,1,1,1,1,1,0,0,,2,3,5,3,1,0,1,1,5,8.4
Nemanja Bjelica,28-201,F,11/26/16,MIN,GSW,0,13,2,5,0.4,1,2,0.5,1,3,0.333,0,0,,0,1,1,0,1,0,3,0,5,0.6
Kris Humphries,31-298,F-C,11/30/16,ATL,PHO,0,15,2,4,0.5,2,3,0.667,0,1,0,1,2,0.5,1,2,3,0,0,1,1,1,5,3.2
Ramon Sessions,30-256,G,12/23/16,CHO,CHI,0,16,2,5,0.4,2,4,0.5,0,1,0,1,2,0.5,0,1,1,3,0,0,2,0,5,2.3
Willie Reed,26-268,F-C,2/8/17,MIA,MIL,0,14,2,5,0.4,1,4,0.25,1,1,1,0,0,,1,4,5,0,0,0,1,3,5,2
Pau Gasol,36-181,F-C,1/3/17,SAS,TOR,1,19,1,6,0.167,1,6,0.167,0,0,,3,4,0.75,0,4,4,3,0,4,0,1,5,6.5
Patrick Patterson,27-273,F,12/12/16,TOR,MIL,0,25,2,2,1,1,1,1,1,1,1,0,0,,1,3,4,3,0,0,2,2,5,5.3
Jameer Nelson,34-345,G,1/19/17,DEN,SAS,0,27,2,7,0.286,1,3,0.333,1,4,0.25,0,0,,0,2,2,9,2,1,1,4,5,7.9
Rajon Rondo,31-010,G,3/4/17,CHI,LAC,0,29,2,7,0.286,1,6,0.167,1,1,1,0,0,,1,3,4,9,3,0,4,2,5,7
Pau Gasol,36-185,F-C,1/7/17,SAS,CHO,1,20,2,7,0.286,1,5,0.2,1,2,0.5,0,0,,1,4,5,3,1,2,0,2,5,6.5
Wade Baldwin,20-241,G,11/25/16,MEM,MIA,0,13,2,5,0.4,2,5,0.4,0,0,,1,2,0.5,1,0,1,0,0,0,1,0,5,1.6
Thomas Robinson,25-267,F,12/9/16,LAL,PHO,0,11,1,1,1,1,1,1,0,0,,3,4,0.75,2,3,5,1,0,0,0,1,5,6.9
Malcolm Brogdon,23-346,G,11/21/16,MIL,ORL,0,21,1,6,0.167,1,3,0.333,0,3,0,3,3,1,1,1,2,3,1,0,2,1,5,2.9
Gerald Henderson,29-110,G,3/29/17,PHI,ATL,0,22,2,10,0.2,1,4,0.25,1,6,0.167,0,0,,1,3,4,2,1,0,3,4,5,-1.8
Draymond Green,26-330,F,1/28/17,GSW,LAC,1,26,1,4,0.25,1,3,0.333,0,1,0,3,4,0.75,0,5,5,5,2,2,1,3,5,8.4
Rajon Rondo,31-024,G,3/18/17,CHI,UTA,1,21,2,5,0.4,1,3,0.333,1,2,0.5,0,0,,0,2,2,5,0,0,2,2,5,3.6
Vince Carter,39-280,G-F,11/1/16,MEM,MIN,0,14,2,7,0.286,1,2,0.5,1,5,0.2,0,0,,0,4,4,1,2,0,0,1,5,4.4
Vince Carter,40-076,G-F,4/12/17,MEM,DAL,1,22,1,4,0.25,0,0,,1,4,0.25,2,2,1,0,2,2,4,0,0,1,2,5,4.2
Channing Frye,33-234,C-F,1/6/17,CLE,BRK,0,25,2,6,0.333,1,2,0.5,1,4,0.25,0,0,,0,5,5,0,4,1,0,3,5,6.6
Kenneth Faried,27-061,F,1/19/17,DEN,SAS,1,25,2,7,0.286,2,7,0.286,0,0,,1,2,0.5,3,6,9,1,0,0,2,1,5,2.7
Trevor Booker,29-023,F,12/18/16,BRK,PHI,1,31,2,7,0.286,2,6,0.333,0,1,0,1,2,0.5,1,5,6,4,0,0,2,3,5,2.3
Kelly Oubre,20-326,F,10/30/16,WAS,MEM,0,15,2,4,0.5,2,2,1,0,2,0,1,1,1,1,1,2,1,0,0,2,0,5,2.7
Shabazz Napier,25-159,G,12/20/16,POR,SAC,0,17,2,8,0.25,1,3,0.333,1,5,0.2,0,0,,0,1,1,2,1,0,2,2,5,0.1
Sam Dekker,22-257,F,1/18/17,HOU,MIL,0,25,2,9,0.222,2,7,0.286,0,2,0,1,2,0.5,3,2,5,1,0,0,1,0,5,1.5
Tyus Jones,20-213,G,12/9/16,MIN,DET,0,5,2,3,0.667,1,2,0.5,1,1,1,0,0,,0,0,0,1,0,0,1,0,5,3.4
Patty Mills,28-143,G,1/1/17,SAS,ATL,0,21,2,8,0.25,1,4,0.25,1,4,0.25,0,0,,0,0,0,3,0,0,0,1,5,1.9
Darren Collison,29-197,G,3/8/17,SAC,SAS,1,24,2,9,0.222,2,7,0.286,0,2,0,1,1,1,1,4,5,4,0,1,3,1,5,1.5
A.J. Hammons,24-225,C,4/9/17,DAL,PHO,0,19,2,7,0.286,2,6,0.333,0,1,0,1,2,0.5,0,1,1,0,0,1,1,2,5,-0.3
Leandro Barbosa,33-347,G,11/9/16,PHO,DET,0,8,2,3,0.667,1,2,0.5,1,1,1,0,0,,1,1,2,1,0,0,0,0,5,5.4
Brian Roberts,31-013,G,12/16/16,CHO,BOS,0,16,1,5,0.2,1,5,0.2,0,0,,3,4,0.75,1,0,1,2,1,0,2,0,5,2.6
Ben McLemore,23-311,G,12/18/16,SAC,DAL,1,27,2,5,0.4,1,3,0.333,1,2,0.5,0,0,,0,3,3,2,1,0,2,5,5,1.6
Malcolm Delaney,27-350,G,2/24/17,ATL,MIA,1,23,2,10,0.2,2,8,0.25,0,2,0,1,2,0.5,2,1,3,4,1,0,1,2,5,2.1
Dorian Finney-Smith,23-303,F,3/3/17,DAL,MEM,0,28,2,6,0.333,2,3,0.667,0,3,0,1,2,0.5,2,3,5,1,0,0,0,0,5,4.2
Justin Hamilton,26-276,C,1/2/17,BRK,UTA,0,16,2,4,0.5,1,2,0.5,1,2,0.5,0,0,,1,5,6,0,0,1,2,1,5,3.5
Chandler Parsons,28-137,F,3/11/17,MEM,ATL,1,23,2,7,0.286,1,5,0.2,1,2,0.5,0,0,,1,1,2,3,1,1,0,1,5,5.3
Meyers Leonard,24-348,C-F,2/9/17,POR,BOS,0,18,2,3,0.667,1,1,1,1,2,0.5,0,0,,0,2,2,1,0,0,1,4,5,2.4
Dirk Nowitzki,38-138,F,11/4/16,DAL,POR,1,16,2,6,0.333,2,6,0.333,0,0,,1,1,1,0,7,7,1,0,1,0,0,5,5.1
Dewayne Dedmon,27-138,C,12/28/16,SAS,PHO,0,15,2,4,0.5,2,4,0.5,0,0,,1,2,0.5,1,3,4,0,2,0,1,3,5,4
Jose Calderon,35-065,G,12/2/16,LAL,TOR,1,18,2,7,0.286,1,5,0.2,1,2,0.5,0,0,,1,4,5,2,0,0,1,0,5,3.2
Bismack Biyombo,24-098,C-F,12/4/16,ORL,DET,1,30,2,3,0.667,2,3,0.667,0,0,,1,2,0.5,0,7,7,4,1,1,1,4,5,7.3
Chandler Parsons,28-080,F,1/13/17,MEM,HOU,1,19,1,7,0.143,0,2,0,1,5,0.2,2,2,1,0,2,2,1,2,0,0,2,5,3
Aaron Brooks,31-330,G,12/9/16,IND,DAL,0,15,1,3,0.333,0,1,0,1,2,0.5,2,2,1,1,2,3,2,0,0,0,2,5,5.2
Ersan Ilyasova,29-274,F,2/13/17,PHI,CHO,1,20,2,7,0.286,1,3,0.333,1,4,0.25,0,0,,1,9,10,4,1,0,1,3,5,5.9
Thabo Sefolosha,32-186,G-F,11/4/16,ATL,WAS,0,27,2,4,0.5,1,2,0.5,1,2,0.5,0,0,,0,2,2,3,2,0,0,3,5,6.5
Brandon Bass,31-300,F,2/24/17,LAC,SAS,0,10,2,5,0.4,2,5,0.4,0,0,,1,2,0.5,3,3,6,0,1,1,0,0,5,6.6
Devin Harris,34-000,G,2/27/17,DAL,MIA,0,13,2,5,0.4,1,4,0.25,1,1,1,0,0,,0,0,0,3,0,0,3,0,5,1.4
Michael Carter-Williams,25-173,G,4/1/17,CHI,ATL,0,11,2,5,0.4,1,2,0.5,1,3,0.333,0,0,,1,1,2,2,0,0,0,1,5,4.3
Jeremy Lamb,24-152,G-F,10/29/16,CHO,BOS,0,9,2,7,0.286,2,3,0.667,0,4,0,1,2,0.5,0,3,3,0,1,0,0,0,5,2.4
Dragan Bender,19-145,F,4/11/17,PHO,SAC,0,21,2,11,0.182,2,4,0.5,0,7,0,1,1,1,1,3,4,2,0,0,0,5,5,-0.9
Jeff Green,30-071,F,11/7/16,ORL,CHI,0,15,2,6,0.333,1,3,0.333,1,3,0.333,0,0,,2,2,4,1,0,0,0,2,5,3.5
Matthew Dellavedova,26-155,G,2/10/17,MIL,LAL,1,18,2,5,0.4,2,3,0.667,0,2,0,1,1,1,0,1,1,2,1,0,3,0,5,2
Joe Ingles,29-171,F-G,3/22/17,UTA,NYK,0,25,2,7,0.286,1,2,0.5,1,5,0.2,0,2,0,0,3,3,3,0,0,0,0,5,3.1
Kyle O'Quinn,26-287,F-C,1/7/17,NYK,IND,0,11,2,2,1,2,2,1,0,0,,1,1,1,0,1,1,0,1,1,2,2,5,3.6
Shabazz Napier,25-264,G,4/4/17,POR,UTA,0,13,1,3,0.333,0,1,0,1,2,0.5,2,2,1,0,3,3,0,0,0,1,1,5,2.8
Yogi Ferrell,23-308,G,3/13/17,DAL,TOR,1,31,1,7,0.143,1,3,0.333,0,4,0,3,4,0.75,0,3,3,6,1,0,1,2,5,4.4
Kent Bazemore,27-175,G-F,12/23/16,ATL,DEN,1,31,2,9,0.222,2,7,0.286,0,2,0,1,2,0.5,0,2,2,4,2,0,2,3,5,1.3
Isaiah Canaan,25-324,G,4/10/17,CHI,ORL,0,7,1,3,0.333,0,1,0,1,2,0.5,2,2,1,0,2,2,2,0,0,0,0,5,5.3
Davis Bertans,24-061,F,1/12/17,SAS,LAL,0,11,2,5,0.4,1,1,1,1,4,0.25,0,0,,0,3,3,2,0,0,0,3,5,3.4
Richard Jefferson,36-147,F,11/15/16,CLE,TOR,1,26,2,5,0.4,1,3,0.333,1,2,0.5,0,0,,0,0,0,1,0,0,1,5,5,0
Jameer Nelson,34-321,G,12/26/16,DEN,LAC,0,30,2,10,0.2,1,4,0.25,1,6,0.167,0,0,,0,1,1,6,1,0,0,0,5,4.3
DeAndre Liggins,28-249,G,12/5/16,CLE,TOR,0,21,1,2,0.5,0,1,0,1,1,1,2,4,0.5,2,3,5,1,0,0,1,3,5,4
J.J. Barea,32-258,G,3/11/17,DAL,PHO,0,16,2,9,0.222,1,5,0.2,1,4,0.25,0,0,,1,1,2,4,0,0,3,0,5,0.3
Domantas Sabonis,20-334,F,4/2/17,OKC,CHO,0,13,2,5,0.4,1,4,0.25,1,1,1,0,0,,0,1,1,0,0,0,0,0,5,2.6
Iman Shumpert,26-283,G,4/5/17,CLE,BOS,0,28,2,6,0.333,1,3,0.333,1,3,0.333,0,0,,1,3,4,1,0,0,2,4,5,0.3
Sam Dekker,22-213,F,12/5/16,HOU,BOS,0,18,2,5,0.4,1,3,0.333,1,2,0.5,0,0,,1,3,4,0,1,0,2,1,5,2.5
Matt Barnes,36-244,F,11/8/16,SAC,NOP,0,27,2,5,0.4,1,1,1,1,4,0.25,0,0,,0,8,8,3,0,0,1,2,5,5
Ersan Ilyasova,29-311,F,3/22/17,ATL,WAS,1,26,2,8,0.25,2,5,0.4,0,3,0,1,1,1,1,7,8,2,1,1,1,5,5,3.1
Rodney McGruder,25-115,G,11/21/16,MIA,PHI,0,18,2,5,0.4,1,1,1,1,4,0.25,0,2,0,4,3,7,1,1,0,1,2,5,5.1
Richard Jefferson,36-216,F,1/23/17,CLE,NOP,0,22,2,5,0.4,1,2,0.5,1,3,0.333,0,2,0,0,2,2,0,0,0,1,6,5,-1.3
Anthony Morrow,31-054,G,11/20/16,OKC,IND,0,7,2,5,0.4,2,2,1,0,3,0,1,2,0.5,0,1,1,0,0,0,0,0,5,2.2
Rudy Gobert,24-131,C,11/4/16,UTA,SAS,1,29,2,2,1,2,2,1,0,0,,1,4,0.25,2,6,8,1,0,0,2,2,5,4.3
James Jones,36-099,F-G,1/11/17,CLE,POR,0,7,1,2,0.5,0,0,,1,2,0.5,2,2,1,0,2,2,0,0,0,0,0,5,4.6
Pat Connaughton,24-025,G,1/31/17,POR,CHO,0,4,2,2,1,1,1,1,1,1,1,0,0,,0,0,0,0,0,0,0,0,5,4.4
Rodney McGruder,25-163,G,1/8/17,MIA,LAC,1,34,1,7,0.143,0,1,0,1,6,0.167,2,2,1,2,1,3,2,1,0,0,0,5,4.6
Brandon Jennings,27-180,G,3/22/17,WAS,ATL,0,14,2,5,0.4,1,2,0.5,1,3,0.333,0,0,,0,2,2,6,0,0,1,2,5,5.3
Brandon Jennings,27-111,G,1/12/17,NYK,CHI,0,14,1,4,0.25,0,0,,1,4,0.25,2,3,0.667,0,0,0,1,1,0,2,1,5,1.5
Alex Abrines,23-105,G-F,11/14/16,OKC,DET,0,17,1,7,0.143,0,2,0,1,5,0.2,2,2,1,0,1,1,1,0,0,1,2,5,-0.3
Matt Barnes,37-001,F,3/10/17,GSW,MIN,0,10,2,2,1,1,1,1,1,1,1,0,0,,0,2,2,1,0,0,0,3,5,4.5
Joe Harris,25-104,G,12/20/16,BRK,TOR,0,22,2,6,0.333,1,3,0.333,1,3,0.333,0,0,,0,6,6,2,0,0,0,3,5,3.6
Nerlens Noel,22-292,C-F,1/27/17,PHI,HOU,0,20,2,3,0.667,2,3,0.667,0,0,,1,2,0.5,1,3,4,3,2,2,0,1,5,10
Troy Daniels,25-257,G,3/29/17,MEM,IND,0,19,2,10,0.2,1,3,0.333,1,7,0.143,0,0,,0,1,1,2,0,0,0,0,5,0.5
A.J. Hammons,24-114,C,12/19/16,DAL,DEN,0,5,2,3,0.667,1,1,1,1,2,0.5,0,0,,1,0,1,0,0,0,2,0,5,2.4
Nicolas Brussino,23-341,G-F,2/6/17,DAL,DEN,0,3,2,2,1,1,1,1,1,1,1,0,2,0,0,0,0,0,0,0,0,0,5,3.6
David Lee,33-199,F,11/14/16,SAS,MIA,0,17,2,4,0.5,2,4,0.5,0,0,,1,2,0.5,2,5,7,2,0,1,0,0,5,7.6
Kelly Oubre,21-014,F,12/23/16,WAS,MIL,0,14,2,4,0.5,1,1,1,1,3,0.333,0,0,,0,3,3,0,1,0,0,1,5,4.5
Danny Green,29-211,G-F,1/19/17,SAS,DEN,1,22,2,5,0.4,1,2,0.5,1,3,0.333,0,0,,0,1,1,4,2,2,2,2,5,6
Kent Bazemore,27-165,G-F,12/13/16,ATL,ORL,0,15,2,8,0.25,2,6,0.333,0,2,0,1,2,0.5,0,3,3,0,0,0,0,1,5,0.3
Jonathon Simmons,27-061,G-F,11/14/16,SAS,MIA,0,22,1,5,0.2,1,3,0.333,0,2,0,3,4,0.75,2,2,4,2,1,1,1,1,5,5.2
Caris LeVert,22-119,G-F,12/22/16,BRK,GSW,0,13,2,6,0.333,2,5,0.4,0,1,0,1,2,0.5,0,1,1,4,0,0,0,0,5,4.3
Tyson Chandler,34-093,C,1/3/17,PHO,MIA,1,32,2,4,0.5,2,4,0.5,0,0,,1,2,0.5,6,14,20,1,0,2,1,3,5,10.9
Amir Johnson,29-278,F,2/3/17,BOS,LAL,1,15,2,2,1,2,2,1,0,0,,1,2,0.5,1,1,2,1,0,0,0,3,5,4.5
Channing Frye,33-293,C-F,3/6/17,CLE,MIA,0,14,1,3,0.333,0,1,0,1,2,0.5,2,4,0.5,0,3,3,0,0,0,3,2,5,-0.4
Dante Cunningham,29-258,F,1/5/17,NOP,ATL,1,27,2,4,0.5,1,1,1,1,3,0.333,0,0,,0,5,5,1,1,0,1,1,5,4.8
Brandon Rush,31-232,G-F,2/24/17,MIN,DAL,1,23,2,5,0.4,1,2,0.5,1,3,0.333,0,0,,0,3,3,0,1,0,1,0,5,3.2
Joe Harris,25-100,G,12/16/16,BRK,ORL,0,19,1,4,0.25,1,3,0.333,0,1,0,3,3,1,0,6,6,1,0,0,0,4,5,3.5
Marcus Smart,22-347,G,2/16/17,BOS,CHI,1,33,1,5,0.2,1,4,0.25,0,1,0,3,4,0.75,1,3,4,3,1,0,1,4,5,3.6
Goran Dragic,30-237,G,12/29/16,MIA,CHO,1,32,2,11,0.182,2,7,0.286,0,4,0,1,2,0.5,0,3,3,8,0,0,4,3,5,-1
Luke Babbitt,27-158,F,11/25/16,MIA,MEM,0,20,2,4,0.5,1,1,1,1,3,0.333,0,0,,0,1,1,1,0,1,0,1,5,4.3
Marreese Speights,29-223,C-F,3/15/17,LAC,MIL,0,11,2,5,0.4,2,2,1,0,3,0,1,2,0.5,1,5,6,0,0,1,0,2,5,4
Rodney McGruder,25-154,G,12/30/16,MIA,BOS,1,29,2,4,0.5,1,1,1,1,3,0.333,0,0,,1,1,2,5,0,0,0,0,5,7.5
Brandon Ingram,19-153,F,2/2/17,LAL,WAS,0,21,1,3,0.333,1,3,0.333,0,0,,3,4,0.75,1,5,6,0,1,3,0,3,5,7
Paul Pierce,39-047,F-G,11/29/16,LAC,BRK,1,29,1,7,0.143,0,2,0,1,5,0.2,2,2,1,0,3,3,0,1,0,1,5,5,-0.6
Dante Cunningham,29-282,F,1/29/17,NOP,WAS,1,21,2,4,0.5,1,1,1,1,3,0.333,0,0,,2,2,4,2,0,0,0,0,5,6.4
Kris Humphries,31-328,F-C,12/30/16,ATL,DET,0,10,2,3,0.667,1,2,0.5,1,1,1,0,0,,1,1,2,1,0,0,0,2,5,4.6
Marquese Chriss,19-162,F,12/11/16,PHO,NOP,1,17,1,5,0.2,1,2,0.5,0,3,0,3,6,0.5,0,5,5,1,0,0,0,4,5,1.3
Andre Iguodala,32-358,G-F,1/20/17,GSW,HOU,0,27,2,5,0.4,1,3,0.333,1,2,0.5,0,0,,1,8,9,2,1,0,0,1,5,7.4
Marquese Chriss,19-206,F,1/24/17,PHO,MIN,1,12,2,5,0.4,1,3,0.333,1,2,0.5,0,0,,0,2,2,0,1,1,0,4,5,3
Markieff Morris,27-194,F,3/15/17,WAS,DAL,1,32,2,6,0.333,2,4,0.5,0,2,0,1,2,0.5,1,6,7,3,1,0,2,6,5,2.4
Richard Jefferson,36-279,F,3/27/17,CLE,SAS,0,22,1,5,0.2,0,2,0,1,3,0.333,2,2,1,1,2,3,2,0,0,1,1,5,3.2
Dorian Finney-Smith,23-279,F,2/7/17,DAL,POR,0,17,1,3,0.333,0,0,,1,3,0.333,2,2,1,0,2,2,1,0,0,1,2,5,2.8
Kevon Looney,20-291,F-C,11/23/16,GSW,LAL,0,7,2,2,1,1,1,1,1,1,1,0,0,,1,4,5,0,0,0,0,1,5,5.9
Gorgui Dieng,27-012,C,1/30/17,MIN,ORL,1,33,2,7,0.286,1,5,0.2,1,2,0.5,0,0,,4,10,14,3,0,0,1,3,5,6.6
Jamal Murray,19-269,G,11/18/16,DEN,TOR,0,19,2,8,0.25,2,5,0.4,0,3,0,1,2,0.5,1,1,2,4,2,0,1,2,5,3.8
Jarell Martin,22-190,F,11/30/16,MEM,TOR,0,24,1,5,0.2,0,3,0,1,2,0.5,2,2,1,0,4,4,1,0,0,1,2,5,2
Nerlens Noel,22-285,C-F,1/20/17,PHI,POR,0,21,1,4,0.25,1,4,0.25,0,0,,3,4,0.75,2,7,9,2,2,0,2,0,5,7.1
Kyle O'Quinn,27-017,F-C,4/12/17,NYK,PHI,0,13,2,4,0.5,1,3,0.333,1,1,1,0,0,,2,2,4,2,1,2,0,2,5,8
James Ennis,26-257,F,3/15/17,MEM,CHI,0,24,1,3,0.333,1,1,1,0,2,0,3,4,0.75,1,3,4,1,0,0,1,3,5,3
Timothe Luwawu-Cabarrot,21-247,F,1/11/17,PHI,NYK,0,12,2,4,0.5,2,3,0.667,0,1,0,1,2,0.5,1,1,2,1,1,0,0,3,5,4.1
Clint Capela,22-248,F-C,1/21/17,HOU,MEM,0,16,2,4,0.5,2,4,0.5,0,0,,1,2,0.5,2,2,4,2,0,1,0,3,5,5.5
Raul Neto,24-312,G,3/27/17,UTA,NOP,0,18,2,5,0.4,1,2,0.5,1,3,0.333,0,0,,2,1,3,2,1,0,0,4,5,4.8
Danny Green,29-292,G-F,4/10/17,SAS,POR,1,20,2,5,0.4,1,1,1,1,4,0.25,0,0,,0,4,4,2,0,1,0,0,5,5.6
James Johnson,29-264,F,11/10/16,MIA,CHI,0,21,2,5,0.4,1,2,0.5,1,3,0.333,0,0,,0,4,4,1,0,1,1,0,5,3.9
Mike Muscala,25-262,F-C,3/20/17,ATL,CHO,0,6,2,3,0.667,1,1,1,1,2,0.5,0,0,,1,0,1,1,0,0,0,0,5,5.1
Dewayne Dedmon,27-151,C,1/10/17,SAS,MIL,0,20,2,6,0.333,2,6,0.333,0,0,,1,2,0.5,4,3,7,0,1,1,0,0,5,6.6
Langston Galloway,25-031,G,1/9/17,NOP,NYK,0,19,2,8,0.25,1,4,0.25,1,4,0.25,0,0,,0,0,0,1,0,1,0,1,5,1.2
Garrett Temple,30-215,G,12/9/16,SAC,NYK,0,26,2,6,0.333,1,2,0.5,1,4,0.25,0,0,,0,0,0,1,3,0,0,0,5,5.3
Nene Hilario,34-092,F-C,12/14/16,HOU,SAC,0,14,2,4,0.5,2,4,0.5,0,0,,1,3,0.333,0,2,2,0,1,0,2,1,5,1.4
Alex Len,23-143,C,11/6/16,PHO,LAL,0,18,2,4,0.5,2,4,0.5,0,0,,1,2,0.5,2,9,11,0,1,1,2,4,5,4.8
Justin Anderson,23-034,G,12/23/16,DAL,LAC,0,7,2,4,0.5,1,2,0.5,1,2,0.5,0,0,,0,1,1,0,0,0,0,2,5,2.5
Dante Cunningham,29-206,F,11/14/16,NOP,BOS,1,23,2,4,0.5,1,1,1,1,3,0.333,0,0,,0,1,1,0,0,0,1,1,5,1.9
Jamal Crawford,36-285,G,12/30/16,LAC,HOU,0,30,2,10,0.2,1,6,0.167,1,4,0.25,0,0,,0,1,1,4,1,1,2,2,5,0.8
Brandon Ingram,19-101,F,12/12/16,LAL,SAC,0,26,2,7,0.286,2,6,0.333,0,1,0,1,2,0.5,1,4,5,2,0,0,0,2,5,3
T.J. McConnell,24-273,G,12/23/16,PHI,PHO,0,22,1,6,0.167,0,5,0,1,1,1,2,2,1,1,1,2,2,1,0,1,2,5,2.8
Kelly Oubre,21-081,F,2/28/17,WAS,GSW,0,17,2,4,0.5,1,1,1,1,3,0.333,0,0,,0,2,2,0,1,0,0,3,5,3.4
Quincy Acy,26-114,F,1/28/17,BRK,MIN,0,17,2,6,0.333,1,4,0.25,1,2,0.5,0,0,,2,0,2,0,0,1,0,1,5,3.3
J.J. Redick,32-190,G,12/31/16,LAC,OKC,1,20,2,9,0.222,1,3,0.333,1,6,0.167,0,1,0,0,1,1,0,1,0,0,3,5,-0.8
Mirza Teletovic,31-112,F,1/8/17,MIL,WAS,1,31,2,8,0.25,1,3,0.333,1,5,0.2,0,0,,0,4,4,2,1,0,1,2,5,2
Bojan Bogdanovic,27-280,G-F,1/23/17,BRK,SAS,1,23,2,8,0.25,1,5,0.2,1,3,0.333,0,0,,0,3,3,2,0,0,2,2,5,-0.3
Juan Hernangomez,21-038,F,11/5/16,DEN,DET,0,11,1,2,0.5,0,0,,1,2,0.5,2,2,1,0,1,1,0,0,0,0,0,5,4.3
Iman Shumpert,26-170,G,12/13/16,CLE,MEM,0,24,2,5,0.4,1,2,0.5,1,3,0.333,0,0,,0,2,2,2,0,1,2,2,5,2.2
Andrew Bogut,31-365,C,11/27/16,DAL,NOP,1,29,1,3,0.333,1,3,0.333,0,0,,3,4,0.75,5,9,14,3,0,1,0,3,5,10.7
Troy Daniels,25-215,G,2/15/17,MEM,NOP,0,10,1,3,0.333,0,0,,1,3,0.333,2,2,1,2,1,3,1,0,0,0,0,5,5.7
Patty Mills,28-097,G,11/16/16,SAS,SAC,0,19,2,4,0.5,1,1,1,1,3,0.333,0,0,,0,2,2,3,0,0,2,1,5,3.3
Joe Johnson,35-208,G-F,1/23/17,UTA,OKC,0,16,2,6,0.333,2,5,0.4,0,1,0,1,1,1,1,2,3,0,0,0,0,0,5,2.9
Brandon Knight,25-031,G,1/2/17,PHO,LAC,0,7,2,4,0.5,2,4,0.5,0,0,,1,1,1,0,0,0,3,0,0,0,2,5,4.3
Chris Paul,31-316,G,3/18/17,LAC,CLE,1,27,0,8,0,0,3,0,0,5,0,5,5,1,0,4,4,7,0,0,3,2,5,1.7
Jerian Grant,24-057,G,12/5/16,CHI,POR,1,23,1,7,0.143,0,3,0,1,4,0.25,2,2,1,0,3,3,1,1,0,1,3,5,0.9
Dragan Bender,18-361,F,11/12/16,PHO,BRK,0,8,2,3,0.667,1,1,1,1,2,0.5,0,0,,0,1,1,0,0,0,0,1,5,3.6
Dorian Finney-Smith,23-186,F,11/6/16,DAL,MIL,0,32,1,6,0.167,0,1,0,1,5,0.2,2,2,1,2,1,3,0,3,1,1,3,5,4.4
Ian Clark,25-338,G,2/8/17,GSW,CHI,0,16,2,5,0.4,1,1,1,1,4,0.25,0,0,,0,1,1,4,2,1,1,0,5,7.1
Mike Dunleavy,36-061,F-G,11/15/16,CLE,TOR,0,19,2,3,0.667,1,1,1,1,2,0.5,0,0,,0,2,2,1,0,0,0,0,5,5
Malcolm Brogdon,24-004,G,12/15/16,MIL,CHI,0,21,2,4,0.5,2,3,0.667,0,1,0,1,2,0.5,2,0,2,7,0,0,3,0,5,5.9
Derrick Favors,25-189,F-C,1/20/17,UTA,DAL,1,26,2,5,0.4,2,5,0.4,0,0,,1,2,0.5,1,3,4,0,0,1,2,4,5,0.6
Domantas Sabonis,20-260,F,1/18/17,OKC,GSW,1,15,2,3,0.667,1,2,0.5,1,1,1,0,0,,0,2,2,0,1,0,1,1,5,3.9
Nick Collison,36-064,F,12/29/16,OKC,MEM,0,8,2,3,0.667,2,3,0.667,0,0,,1,1,1,0,0,0,0,0,1,0,1,5,4
Patrick Patterson,27-247,F,11/16/16,TOR,GSW,0,25,2,7,0.286,1,4,0.25,1,3,0.333,0,0,,1,3,4,1,0,0,1,0,5,2.2
Solomon Hill,25-352,F,3/5/17,NOP,LAL,1,34,2,8,0.25,1,2,0.5,1,6,0.167,0,0,,3,3,6,3,0,0,1,0,5,4.3
Langston Galloway,25-119,G,4/7/17,SAC,LAL,0,20,2,7,0.286,1,3,0.333,1,4,0.25,0,0,,0,3,3,5,1,0,1,1,5,4.9
Tomas Satoransky,25-126,G,3/5/17,WAS,ORL,0,7,2,2,1,1,1,1,1,1,1,0,0,,0,1,1,0,0,0,0,0,5,4.7
Darren Collison,29-220,G,3/31/17,SAC,NOP,1,27,2,8,0.25,2,7,0.286,0,1,0,1,1,1,0,5,5,5,2,0,3,3,5,3
Andrew Harrison,22-019,G,11/16/16,MEM,LAC,0,26,2,4,0.5,1,2,0.5,1,2,0.5,0,0,,0,3,3,3,0,1,2,4,5,3.1
Bismack Biyombo,24-211,C-F,3/27/17,ORL,TOR,0,17,1,2,0.5,1,2,0.5,0,0,,3,4,0.75,2,3,5,0,0,2,4,2,5,2.5
Kris Humphries,32-065,F-C,4/12/17,ATL,IND,1,28,2,9,0.222,2,6,0.333,0,3,0,1,4,0.25,4,4,8,0,0,2,0,2,5,2.9
Channing Frye,33-267,C-F,2/8/17,CLE,IND,0,12,2,7,0.286,1,4,0.25,1,3,0.333,0,0,,0,5,5,0,0,0,0,1,5,2
Garrett Temple,30-243,G,1/6/17,SAC,LAC,0,33,2,7,0.286,1,5,0.2,1,2,0.5,0,0,,5,4,9,1,0,0,0,5,5,4.3
D.J. Augustin,29-147,G,4/6/17,ORL,BRK,0,15,1,8,0.125,0,5,0,1,3,0.333,2,2,1,1,1,2,0,1,0,1,1,5,0.4
Jake Layman,22-249,F,11/11/16,POR,SAC,0,14,2,3,0.667,1,1,1,1,2,0.5,0,0,,0,2,2,2,0,0,1,1,5,4.3
Dorian Finney-Smith,23-207,F,11/27/16,DAL,NOP,1,25,2,7,0.286,1,2,0.5,1,5,0.2,0,0,,2,2,4,0,0,1,0,2,5,2.8
Spencer Dinwiddie,23-331,G,3/3/17,BRK,UTA,0,21,2,5,0.4,2,4,0.5,0,1,0,1,2,0.5,0,3,3,3,0,0,2,2,5,2.1
Kelly Oubre,21-017,F,12/26/16,WAS,MIL,0,17,2,6,0.333,1,2,0.5,1,4,0.25,0,0,,1,1,2,3,1,0,1,2,5,3.9
James Ennis,26-170,F,12/18/16,MEM,UTA,0,16,1,3,0.333,1,3,0.333,0,0,,3,4,0.75,1,3,4,0,0,0,0,5,5,2.5
Shaun Livingston,31-199,G,3/29/17,GSW,SAS,0,12,2,4,0.5,2,4,0.5,0,0,,1,1,1,0,0,0,3,0,1,1,2,5,4
Omer Asik,30-127,C,11/8/16,NOP,SAC,1,26,1,4,0.25,1,4,0.25,0,0,,3,4,0.75,4,5,9,0,0,1,1,3,5,5
Kyle Singler,28-175,F,10/26/16,OKC,PHI,0,22,1,6,0.167,0,1,0,1,5,0.2,2,2,1,0,1,1,0,0,0,1,2,5,-0.3
Nikola Jokic,21-250,C-F,10/26/16,DEN,NOP,1,21,2,5,0.4,1,3,0.333,1,2,0.5,0,0,,1,6,7,2,0,0,4,4,5,0.6
Darrun Hilliard,23-250,G,12/19/16,DET,CHI,0,18,2,6,0.333,1,2,0.5,1,4,0.25,0,0,,1,3,4,1,1,0,2,0,5,2.9
Ramon Sessions,30-231,G,11/28/16,CHO,MEM,0,12,2,6,0.333,2,6,0.333,0,0,,1,1,1,0,2,2,2,1,0,1,0,5,3.6
Jerami Grant,22-244,F,11/11/16,OKC,LAC,0,13,2,3,0.667,1,2,0.5,1,1,1,0,0,,0,2,2,1,0,0,0,1,5,4.6
Richard Jefferson,36-148,F,11/16/16,CLE,IND,1,20,2,6,0.333,1,4,0.25,1,2,0.5,0,0,,0,3,3,1,0,1,1,1,5,2.5
Alex Abrines,23-134,G-F,12/13/16,OKC,POR,0,13,2,7,0.286,1,2,0.5,1,5,0.2,0,0,,0,2,2,1,0,0,0,1,5,1.8
Shaun Livingston,31-087,G,12/7/16,GSW,LAC,0,17,2,2,1,2,2,1,0,0,,1,2,0.5,0,1,1,2,1,0,2,0,5,4.7
Buddy Hield,22-333,G,11/14/16,NOP,BOS,1,21,2,7,0.286,1,3,0.333,1,4,0.25,0,0,,0,2,2,3,0,0,0,2,5,2.8
Leandro Barbosa,34-030,G,12/28/16,PHO,SAS,0,13,2,4,0.5,1,3,0.333,1,1,1,0,0,,0,1,1,1,2,0,2,3,5,2.8
Langston Galloway,24-322,G,10/26/16,NOP,DEN,0,11,2,5,0.4,2,4,0.5,0,1,0,1,1,1,0,2,2,1,1,0,0,1,5,4.2
D.J. Augustin,29-151,G,4/10/17,ORL,CHI,0,23,2,9,0.222,2,3,0.667,0,6,0,1,2,0.5,0,1,1,2,0,0,3,2,5,-3
Mike Muscala,25-127,F-C,11/5/16,ATL,HOU,0,21,2,3,0.667,1,2,0.5,1,1,1,0,0,,1,2,3,1,1,1,3,2,5,3.6
DeAndre Liggins,28-296,G,1/21/17,CLE,SAS,0,12,2,4,0.5,2,4,0.5,0,0,,1,2,0.5,0,1,1,1,1,0,0,1,5,4.2
DeAndre Liggins,28-281,G,1/6/17,CLE,BRK,1,18,2,4,0.5,1,1,1,1,3,0.333,0,0,,0,3,3,1,1,0,0,1,5,5.2
Jose Calderon,35-108,G,1/14/17,LAL,LAC,0,7,2,3,0.667,1,1,1,1,2,0.5,0,0,,0,0,0,0,0,0,1,0,5,2.7
DeAndre Liggins,28-281,G,1/6/17,CLE,BRK,1,18,2,4,0.5,1,1,1,1,3,0.333,0,0,,0,3,3,1,1,0,0,1,5,5.2
James Jones,36-169,F-G,3/22/17,CLE,DEN,0,3,2,2,1,1,1,1,1,1,1,0,0,,0,1,1,0,0,0,0,0,5,4.7
Paul Pierce,39-073,F-G,12/25/16,LAC,LAL,1,12,2,4,0.5,1,2,0.5,1,2,0.5,0,0,,0,3,3,0,1,1,1,1,5,4.2
Monta Ellis,31-147,G,3/22/17,IND,BOS,0,25,2,10,0.2,1,8,0.125,1,2,0.5,0,0,,1,3,4,2,2,0,3,1,5,0.4
Terry Rozier,22-331,G,2/11/17,BOS,UTA,0,23,1,5,0.2,1,4,0.25,0,1,0,3,4,0.75,1,3,4,2,0,1,1,1,5,3.8
Bryn Forbes,23-233,G,3/13/17,SAS,ATL,0,11,2,3,0.667,1,1,1,1,2,0.5,0,0,,0,1,1,1,0,0,0,0,5,4.7
Courtney Lee,31-149,G,3/1/17,NYK,ORL,1,35,2,5,0.4,1,2,0.5,1,3,0.333,0,0,,1,3,4,2,1,1,2,1,5,4.6
Alex Len,23-164,C,11/27/16,PHO,DEN,0,29,1,5,0.2,1,5,0.2,0,0,,3,3,1,3,7,10,0,1,2,1,4,5,5.9
Norman Powell,23-257,G,2/6/17,TOR,LAC,0,12,2,4,0.5,1,1,1,1,3,0.333,0,0,,0,1,1,0,0,0,0,1,5,2.9
Patty Mills,28-237,G,4/5/17,SAS,LAL,0,18,2,8,0.25,1,2,0.5,1,6,0.167,0,0,,0,0,0,4,0,0,0,0,5,3
Justin Anderson,23-030,G,12/19/16,DAL,DEN,0,14,1,1,1,0,0,,1,1,1,2,2,1,0,2,2,0,0,0,1,2,5,3.5
Mirza Teletovic,31-202,F,4/8/17,MIL,PHI,0,22,2,6,0.333,1,1,1,1,5,0.2,0,0,,0,4,4,1,0,0,0,2,5,2.7
Danny Green,29-184,G-F,12/23/16,SAS,POR,1,30,2,7,0.286,1,4,0.25,1,3,0.333,0,0,,0,0,0,0,1,1,2,3,5,-0.6
Jerian Grant,24-083,G,12/31/16,CHI,MIL,0,18,1,5,0.2,0,1,0,1,4,0.25,2,2,1,0,0,0,1,0,0,0,3,5,1.4
Lavoy Allen,28-025,F-C,3/1/17,IND,SAS,0,20,2,3,0.667,2,3,0.667,0,0,,1,2,0.5,3,3,6,1,1,1,0,4,5,7.1
Brandon Jennings,27-098,G,12/30/16,NYK,NOP,0,28,2,8,0.25,1,5,0.2,1,3,0.333,0,0,,0,3,3,3,1,0,1,1,5,2.8
Reggie Bullock,25-247,G-F,11/18/16,DET,CLE,0,8,2,4,0.5,1,1,1,1,3,0.333,0,0,,0,0,0,0,0,0,1,0,5,2
Ty Lawson,29-083,G,1/25/17,SAC,CLE,0,17,2,6,0.333,2,4,0.5,0,2,0,1,1,1,0,1,1,4,1,0,1,1,5,4.3
Tyus Jones,20-295,G,3/1/17,MIN,UTA,0,17,2,4,0.5,1,2,0.5,1,2,0.5,0,0,,0,1,1,2,2,0,1,0,5,5.7
Andre Iguodala,33-018,G-F,2/15/17,GSW,SAC,0,22,2,4,0.5,1,2,0.5,1,2,0.5,0,0,,1,5,6,3,1,2,1,2,5,7.9
Jimmy Butler,27-179,G-F,3/12/17,CHI,BOS,1,32,2,11,0.182,1,9,0.111,1,2,0.5,0,0,,2,5,7,3,2,0,1,0,5,4.1
Anthony Morrow,31-099,G,1/4/17,OKC,CHO,0,4,2,4,0.5,1,2,0.5,1,2,0.5,0,0,,0,0,0,0,0,0,0,1,5,2.6
Ramon Sessions,30-274,G,1/10/17,CHO,HOU,0,14,2,5,0.4,1,4,0.25,1,1,1,0,0,,0,1,1,1,0,0,1,0,5,2.3
Mindaugas Kuzminskas,27-051,F,12/9/16,NYK,SAC,0,7,2,4,0.5,1,2,0.5,1,2,0.5,0,0,,1,1,2,0,0,1,1,1,5,3.3
Manu Ginobili,39-258,G,4/12/17,SAS,UTA,0,18,1,3,0.333,0,0,,1,3,0.333,2,2,1,0,2,2,2,1,0,2,1,5,3.9
Quinn Cook,23-345,G,3/3/17,DAL,MEM,0,15,2,5,0.4,1,1,1,1,4,0.25,0,0,,0,0,0,3,0,0,1,1,5,3
Andre Drummond,23-242,C,4/9/17,DET,MEM,1,25,2,6,0.333,2,6,0.333,0,0,,1,2,0.5,6,5,11,2,1,1,2,2,5,7.2
Danny Green,29-167,G-F,12/6/16,SAS,MIN,1,20,2,4,0.5,1,1,1,1,3,0.333,0,0,,0,3,3,2,0,0,0,1,5,4.9
Randy Foye,33-052,G,11/15/16,BRK,LAL,0,19,2,6,0.333,1,2,0.5,1,4,0.25,0,0,,0,2,2,7,0,0,0,0,5,7.1
Luol Deng,31-233,F,12/5/16,LAL,UTA,1,27,2,7,0.286,2,6,0.333,0,1,0,1,1,1,2,0,2,0,2,0,0,3,5,3.1
David Lee,33-186,F,11/1/16,SAS,UTA,0,14,2,3,0.667,2,3,0.667,0,0,,1,1,1,1,1,2,0,1,0,1,3,5,3.5
Jameer Nelson,35-039,G,3/20/17,DEN,HOU,1,31,2,9,0.222,1,5,0.2,1,4,0.25,0,0,,0,6,6,4,1,0,2,2,5,2.3
Luc Mbah a Moute,30-112,F,12/30/16,LAC,HOU,1,26,2,6,0.333,1,3,0.333,1,3,0.333,0,0,,1,0,1,1,2,0,1,3,5,2.8
Solomon Hill,25-225,F,10/29/16,NOP,SAS,1,27,2,7,0.286,1,4,0.25,1,3,0.333,0,0,,1,3,4,0,2,0,1,4,5,1.9
Mirza Teletovic,31-138,F,2/3/17,MIL,DEN,0,9,2,4,0.5,1,1,1,1,3,0.333,0,0,,1,1,2,1,0,1,2,1,5,3
Nikola Mirotic,26-035,F,3/18/17,CHI,UTA,1,17,2,7,0.286,1,2,0.5,1,5,0.2,0,0,,0,4,4,0,0,0,1,1,5,0.7
Davis Bertans,24-052,F,1/3/17,SAS,TOR,0,8,2,3,0.667,1,1,1,1,2,0.5,0,0,,0,2,2,1,0,2,1,0,5,5.4
Dewayne Dedmon,27-078,C,10/29/16,SAS,NOP,0,16,2,4,0.5,2,4,0.5,0,0,,1,2,0.5,1,5,6,0,1,2,0,1,5,6.8
James Johnson,29-334,F,1/19/17,MIA,DAL,0,32,1,6,0.167,1,3,0.333,0,3,0,3,4,0.75,0,7,7,4,0,0,3,1,5,2.3
Marco Belinelli,30-218,G-F,10/29/16,CHO,BOS,0,23,1,6,0.167,1,3,0.333,0,3,0,3,3,1,0,1,1,1,1,0,0,2,5,2.4
Patty Mills,28-207,G,3/6/17,SAS,HOU,0,19,2,7,0.286,1,3,0.333,1,4,0.25,0,0,,0,2,2,4,0,0,0,1,5,3.9
Gerald Henderson,28-352,G,11/25/16,PHI,CHI,1,19,2,7,0.286,1,4,0.25,1,3,0.333,0,0,,0,1,1,0,0,0,1,3,5,-1
Timothe Luwawu-Cabarrot,21-280,F,2/13/17,PHI,CHO,0,11,2,4,0.5,1,3,0.333,1,1,1,0,0,,0,0,0,2,0,0,0,1,5,4
Emmanuel Mudiay,20-262,G,11/22/16,DEN,CHI,1,27,1,7,0.143,0,4,0,1,3,0.333,2,2,1,0,1,1,3,0,0,2,1,5,0.5
Tyson Chandler,34-129,C,2/8/17,PHO,MEM,1,20,1,4,0.25,1,4,0.25,0,0,,3,4,0.75,5,5,10,0,3,1,2,2,5,8.1
James Johnson,29-282,F,11/28/16,MIA,BOS,0,21,2,9,0.222,1,4,0.25,1,5,0.2,0,0,,0,3,3,0,1,0,2,4,5,-2.2
Cristiano Felicio,24-257,F-C,3/21/17,CHI,TOR,0,16,2,3,0.667,2,3,0.667,0,0,,1,2,0.5,2,0,2,0,1,0,1,0,5,4.7
Randy Foye,33-128,G,1/30/17,BRK,MIA,1,21,2,7,0.286,1,2,0.5,1,5,0.2,0,0,,2,2,4,0,0,0,1,3,5,0.7
Semaj Christon,24-015,G,11/16/16,OKC,HOU,0,14,2,4,0.5,1,3,0.333,1,1,1,0,0,,0,0,0,1,0,0,2,1,5,1.3
Mirza Teletovic,31-198,F,4/4/17,MIL,OKC,0,24,2,9,0.222,1,6,0.167,1,3,0.333,0,0,,0,3,3,0,0,0,0,1,5,0
Jonas Jerebko,29-295,F,12/22/16,BOS,IND,0,15,2,4,0.5,1,1,1,1,3,0.333,0,0,,1,3,4,1,0,0,0,0,5,5.3
Matthew Dellavedova,26-190,G,3/17/17,MIL,LAL,0,25,1,7,0.143,1,4,0.25,0,3,0,3,3,1,1,1,2,5,1,0,2,1,5,3.6
Jamal Murray,19-314,G,1/2/17,DEN,GSW,0,19,2,7,0.286,1,2,0.5,1,5,0.2,0,0,,1,3,4,3,1,0,0,0,5,5.6
Zaza Pachulia,32-265,C,11/1/16,GSW,POR,1,19,2,3,0.667,2,3,0.667,0,0,,1,2,0.5,1,5,6,2,0,0,0,0,5,6.9
Al Horford,30-229,C-F,1/18/17,BOS,NYK,1,34,2,14,0.143,1,6,0.167,1,8,0.125,0,0,,2,5,7,10,1,1,0,0,5,7.6
Ron Baker,23-343,G,3/8/17,NYK,MIL,0,9,2,5,0.4,1,2,0.5,1,3,0.333,0,0,,1,0,1,1,0,0,0,0,5,3.7
Langston Galloway,24-349,G,11/22/16,NOP,ATL,0,19,2,5,0.4,1,2,0.5,1,3,0.333,0,0,,0,3,3,4,2,0,1,3,5,5.8
Quincy Acy,26-151,F,3/6/17,BRK,MEM,0,15,2,5,0.4,1,1,1,1,4,0.25,0,0,,0,2,2,0,0,1,1,6,5,0.2
Jonas Jerebko,29-259,F,11/16/16,BOS,DAL,0,24,2,3,0.667,1,1,1,1,2,0.5,0,0,,1,6,7,0,0,0,0,1,5,5.8
Aaron Brooks,31-316,G,11/25/16,IND,BRK,0,21,2,7,0.286,1,2,0.5,1,5,0.2,0,0,,0,1,1,3,2,0,3,1,5,1.9
Arron Afflalo,31-085,G,1/8/17,SAC,GSW,0,14,2,4,0.5,1,1,1,1,3,0.333,0,0,,0,1,1,0,1,0,0,2,5,3.5
Mike Scott,28-156,F,12/19/16,ATL,OKC,0,8,2,4,0.5,1,3,0.333,1,1,1,0,0,,1,1,2,0,0,0,0,0,5,4
Doug McDermott,24-348,F,12/16/16,CHI,MIL,0,24,2,8,0.25,2,5,0.4,0,3,0,1,1,1,1,2,3,0,0,0,0,0,5,1.5
K.J. McDaniels,23-272,G-F,11/7/16,HOU,WAS,0,14,2,4,0.5,1,2,0.5,1,2,0.5,0,0,,0,1,1,1,0,0,0,1,5,3.6
Kyle Korver,35-312,G-F,1/23/17,CLE,NOP,0,26,2,4,0.5,1,2,0.5,1,2,0.5,0,0,,0,4,4,0,0,0,0,0,5,4.2
Spencer Hawes,28-337,C-F,3/31/17,MIL,DET,0,6,1,4,0.25,0,1,0,1,3,0.333,2,2,1,1,3,4,1,0,1,0,0,5,5.6
DeAndre Jordan,28-231,C,3/9/17,LAC,MEM,1,35,1,2,0.5,1,2,0.5,0,0,,3,5,0.6,1,10,11,0,0,2,1,2,5,6.5
Josh McRoberts,29-290,F,12/14/16,MIA,IND,1,18,2,2,1,1,1,1,1,1,1,0,0,,1,3,4,2,0,0,0,1,5,7
Dewayne Dedmon,27-225,C,3/25/17,SAS,NYK,1,21,2,3,0.667,2,3,0.667,0,0,,1,1,1,6,7,13,0,0,0,1,3,5,7.8
Solomon Hill,25-285,F,12/28/16,NOP,LAC,1,24,1,4,0.25,0,1,0,1,3,0.333,2,2,1,1,3,4,2,1,0,0,2,5,5.8
DeAndre Liggins,28-253,G,12/9/16,CLE,MIA,1,26,2,3,0.667,2,3,0.667,0,0,,1,2,0.5,0,2,2,2,1,3,0,1,5,8
Trey Burke,24-028,G,12/10/16,WAS,MIL,0,9,2,5,0.4,1,3,0.333,1,2,0.5,0,0,,0,0,0,2,0,0,0,0,5,3.7
Marcus Smart,22-285,G,12/16/16,BOS,CHO,0,24,2,4,0.5,2,3,0.667,0,1,0,1,1,1,1,6,7,5,0,0,3,1,5,5.6
Cameron Payne,22-170,G,1/25/17,OKC,NOP,0,12,2,6,0.333,1,3,0.333,1,3,0.333,0,0,,0,0,0,3,0,0,0,1,5,3.3
Alex Abrines,23-090,G-F,10/30/16,OKC,LAL,0,2,1,1,1,1,1,1,0,0,,3,3,1,0,0,0,0,1,0,0,0,5,5.7
Sean Kilpatrick,27-035,G,2/10/17,BRK,MIA,0,16,1,4,0.25,0,1,0,1,3,0.333,2,2,1,1,3,4,1,0,0,0,1,5,4.5
Andrew Harrison,22-024,G,11/21/16,MEM,CHO,0,24,2,6,0.333,1,4,0.25,1,2,0.5,0,0,,0,2,2,3,0,1,0,5,5,3
Kenneth Faried,27-003,F,11/22/16,DEN,CHI,1,15,2,4,0.5,2,4,0.5,0,0,,1,2,0.5,1,3,4,1,2,0,0,3,5,5.7
Rajon Rondo,30-297,G,12/15/16,CHI,MIL,1,29,2,6,0.333,1,2,0.5,1,4,0.25,0,0,,0,5,5,8,1,0,3,4,5,5.1
Leandro Barbosa,34-101,G,3/9/17,PHO,LAL,0,16,2,7,0.286,1,4,0.25,1,3,0.333,0,0,,1,0,1,2,2,0,1,1,5,3.6
Solomon Hill,25-278,F,12/21/16,NOP,OKC,1,26,1,2,0.5,0,1,0,1,1,1,2,2,1,1,2,3,0,0,0,0,0,5,5.3
Tim Frazier,26-007,G,11/8/16,NOP,SAC,1,32,2,8,0.25,1,7,0.143,1,1,1,0,0,,1,4,5,9,0,1,3,4,5,4.5
Jonas Jerebko,29-276,F,12/3/16,BOS,PHI,0,16,2,4,0.5,1,2,0.5,1,2,0.5,0,0,,1,5,6,1,0,0,1,3,5,3.7
Jaylen Brown,20-026,F,11/19/16,BOS,DET,0,8,1,2,0.5,0,1,0,1,1,1,2,2,1,0,0,0,0,0,0,1,0,5,3
Wayne Ellington,29-109,G,2/15/17,MIA,HOU,0,15,2,5,0.4,1,2,0.5,1,3,0.333,0,0,,1,0,1,1,0,0,0,0,5,3.7
Joe Harris,25-052,G,10/29/16,BRK,MIL,0,18,2,7,0.286,1,3,0.333,1,4,0.25,0,0,,0,2,2,1,1,0,2,1,5,0.8
Dragan Bender,19-056,F,1/12/17,PHO,DAL,0,8,1,3,0.333,0,1,0,1,2,0.5,2,2,1,1,0,1,0,0,1,2,1,5,2.3
Marcus Smart,23-002,G,3/8/17,BOS,GSW,0,25,1,8,0.125,1,6,0.167,0,2,0,3,4,0.75,2,1,3,3,1,0,1,2,5,2.4
Aaron Brooks,32-020,G,2/3/17,IND,BRK,0,14,2,6,0.333,1,4,0.25,1,2,0.5,0,0,,0,0,0,3,0,0,2,1,5,1.3
Aaron Brooks,32-088,G,4/12/17,IND,ATL,0,17,2,3,0.667,1,1,1,1,2,0.5,0,0,,0,0,0,0,0,0,0,1,5,3.3
Rondae Hollis-Jefferson,21-335,F,12/3/16,BRK,MIL,0,24,2,5,0.4,1,2,0.5,1,3,0.333,0,3,0,1,8,9,3,3,1,1,3,5,7.8
Monta Ellis,31-042,G,12/7/16,IND,PHO,1,22,1,4,0.25,0,2,0,1,2,0.5,2,2,1,0,4,4,1,0,0,2,1,5,2.1
Bojan Bogdanovic,27-246,G-F,12/20/16,BRK,TOR,1,19,1,6,0.167,0,2,0,1,4,0.25,2,2,1,0,0,0,2,0,0,0,2,5,1.8
Stanley Johnson,20-167,F,11/12/16,DET,DEN,0,14,2,5,0.4,2,4,0.5,0,1,0,1,2,0.5,1,3,4,1,0,0,1,1,5,2.8
Richard Jefferson,36-228,F,2/4/17,CLE,NYK,0,19,2,5,0.4,1,1,1,1,4,0.25,0,0,,1,2,3,0,0,0,1,3,5,1.4
Malcolm Delaney,27-311,G,1/16/17,ATL,NYK,0,19,2,4,0.5,1,3,0.333,1,1,1,0,0,,0,1,1,5,2,0,1,1,5,7.4
Rodney McGruder,25-130,G,12/6/16,MIA,NYK,1,35,2,11,0.182,1,7,0.143,1,4,0.25,0,0,,3,3,6,4,1,1,1,2,5,3.8
Matt Barnes,36-328,F,1/31/17,SAC,HOU,0,30,2,8,0.25,1,3,0.333,1,5,0.2,0,0,,1,10,11,3,0,0,2,3,5,2.8
Mirza Teletovic,31-187,F,3/24/17,MIL,ATL,0,12,2,6,0.333,1,1,1,1,5,0.2,0,0,,0,1,1,0,0,0,0,1,5,1.5
Garrett Temple,30-226,G,12/20/16,SAC,POR,0,24,1,3,0.333,1,2,0.5,0,1,0,3,5,0.6,0,3,3,3,1,1,0,5,5,5.2
T.J. McConnell,24-256,G,12/6/16,PHI,MEM,0,25,2,5,0.4,1,4,0.25,1,1,1,0,0,,1,1,2,9,2,0,3,2,5,7.8
Jordan Clarkson,24-287,G,3/21/17,LAL,LAC,1,36,1,9,0.111,1,5,0.2,0,4,0,3,3,1,0,3,3,5,0,0,2,4,5,-0.1
Ron Baker,23-209,G,10/25/16,NYK,CLE,0,7,2,3,0.667,1,2,0.5,1,1,1,0,0,,0,1,1,0,0,0,0,0,5,4
Marreese Speights,29-177,C-F,1/28/17,LAC,GSW,0,19,2,6,0.333,1,3,0.333,1,3,0.333,0,0,,0,3,3,2,0,1,0,1,5,4.2
Kris Dunn,23-003,G,3/21/17,MIN,SAS,0,24,2,3,0.667,1,1,1,1,2,0.5,0,0,,0,2,2,0,2,0,2,5,5,2.3
Thabo Sefolosha,32-308,G-F,3/6/17,ATL,GSW,1,30,2,5,0.4,1,4,0.25,1,1,1,0,0,,1,3,4,4,0,1,2,2,5,4.6
Brandon Bass,31-186,F,11/2/16,LAC,OKC,0,13,2,5,0.4,1,4,0.25,1,1,1,0,0,,3,1,4,0,1,0,1,2,5,3.9
Darrell Arthur,28-273,F,12/23/16,DEN,ATL,0,11,2,4,0.5,1,2,0.5,1,2,0.5,0,0,,0,1,1,0,0,0,2,4,5,-0.3
Nene Hilario,34-108,F-C,12/30/16,HOU,LAC,1,16,0,1,0,0,0,,0,1,0,5,8,0.625,2,3,5,1,0,0,4,1,5,1.7
Marco Belinelli,30-286,G-F,1/5/17,CHO,DET,0,21,0,6,0,0,6,0,0,0,,5,6,0.833,0,2,2,1,2,0,0,2,5,2.9
Garrett Temple,30-250,G,1/13/17,SAC,CLE,1,35,2,4,0.5,1,1,1,1,3,0.333,0,0,,0,2,2,1,3,1,4,1,5,3.6
Domantas Sabonis,20-251,F,1/9/17,OKC,CHI,1,22,1,5,0.2,1,3,0.333,0,2,0,3,3,1,1,4,5,1,0,0,0,3,5,3.3
Danny Green,29-249,G-F,2/26/17,SAS,LAL,1,20,2,6,0.333,1,5,0.2,1,1,1,0,0,,0,1,1,1,3,1,0,0,5,6.3
Justin Holiday,27-301,G,1/31/17,NYK,WAS,0,20,1,9,0.111,1,5,0.2,0,4,0,3,4,0.75,0,2,2,3,0,0,1,1,5,0
Justin Hamilton,26-271,C,12/28/16,BRK,CHI,0,18,2,7,0.286,1,2,0.5,1,5,0.2,0,0,,3,2,5,2,1,2,0,1,5,7
Trey Lyles,20-355,F,10/25/16,UTA,POR,0,18,2,6,0.333,1,4,0.25,1,2,0.5,0,0,,0,2,2,2,0,0,3,0,5,0.6
Tarik Black,24-362,C-F,11/18/16,LAL,SAS,0,12,2,4,0.5,2,4,0.5,0,0,,1,2,0.5,3,3,6,0,0,0,0,4,5,4
Jodie Meeks,29-150,G,1/18/17,ORL,NOP,1,16,2,6,0.333,2,4,0.5,0,2,0,1,1,1,0,4,4,0,2,0,2,2,5,2
Matt Barnes,36-247,F,11/11/16,SAC,POR,0,19,1,4,0.25,0,0,,1,4,0.25,2,2,1,1,3,4,1,0,0,2,1,5,2.5
Mike Muscala,25-218,F-C,2/4/17,ATL,ORL,0,20,1,2,0.5,0,0,,1,2,0.5,2,2,1,1,3,4,2,0,1,3,1,5,4.3
Vince Carter,40-004,G-F,1/30/17,MEM,PHO,0,28,1,6,0.167,0,4,0,1,2,0.5,2,2,1,1,4,5,5,3,0,1,2,5,7.8
Ramon Sessions,30-292,G,1/28/17,CHO,SAC,0,21,2,3,0.667,1,2,0.5,1,1,1,0,0,,0,2,2,0,0,0,1,0,5,3.3
Patrick Patterson,27-270,F,12/9/16,TOR,BOS,0,30,2,7,0.286,1,3,0.333,1,4,0.25,0,0,,2,8,10,4,1,0,1,5,5,5.5
Alec Burks,25-210,G,2/15/17,UTA,POR,0,16,2,6,0.333,1,5,0.2,1,1,1,0,0,,0,2,2,1,2,0,0,1,5,4.5
Bismack Biyombo,24-077,C-F,11/13/16,ORL,OKC,0,29,2,4,0.5,2,4,0.5,0,0,,1,2,0.5,1,7,8,1,1,0,2,1,5,4.7
Kentavious Caldwell-Pope,23-345,G,1/28/17,DET,MIA,1,34,2,11,0.182,1,7,0.143,1,4,0.25,0,0,,0,0,0,1,1,0,1,2,5,-2
Patrick Patterson,28-009,F,3/23/17,TOR,MIA,0,22,2,8,0.25,2,4,0.5,0,4,0,1,2,0.5,3,7,10,0,0,0,0,1,5,3.6
Malcolm Delaney,27-353,G,2/27/17,ATL,BOS,0,18,2,4,0.5,2,4,0.5,0,0,,1,1,1,0,1,1,4,1,0,1,2,5,5.3
Jerami Grant,22-294,F,12/31/16,OKC,LAC,0,17,2,2,1,1,1,1,1,1,1,0,0,,0,1,1,0,0,0,1,1,5,3.3
Darrun Hilliard,23-240,G,12/9/16,DET,MIN,0,17,2,3,0.667,1,1,1,1,2,0.5,0,0,,0,0,0,1,0,0,1,3,5,2.2
Meyers Leonard,24-321,C-F,1/13/17,POR,ORL,0,20,1,8,0.125,0,4,0,1,4,0.25,2,2,1,1,5,6,2,0,2,0,5,5,2.8
D.J. Augustin,29-130,G,3/20/17,ORL,PHI,0,18,1,5,0.2,0,4,0,1,1,1,2,2,1,1,2,3,1,1,0,2,0,5,2.9
Jameer Nelson,35-027,G,3/8/17,DEN,WAS,1,24,2,6,0.333,2,4,0.5,0,2,0,1,2,0.5,1,2,3,6,0,0,4,2,5,1.9
Jerian Grant,24-077,G,12/25/16,CHI,SAS,0,18,2,6,0.333,1,3,0.333,1,3,0.333,0,0,,0,1,1,1,2,0,1,1,5,3.2
Andrew Harrison,22-139,G,3/16/17,MEM,ATL,0,15,2,4,0.5,1,2,0.5,1,2,0.5,0,0,,0,3,3,2,1,0,0,0,5,6.3
Amir Johnson,29-179,F,10/27/16,BOS,CHI,1,16,2,4,0.5,2,4,0.5,0,0,,1,2,0.5,0,1,1,1,1,1,0,3,5,4.1
Davis Bertans,24-028,F,12/10/16,SAS,BRK,0,21,1,4,0.25,1,1,1,0,3,0,3,3,1,0,6,6,0,2,2,0,2,5,7
Kyle Anderson,23-039,F-G,10/29/16,SAS,NOP,1,26,2,7,0.286,1,5,0.2,1,2,0.5,0,0,,0,7,7,1,1,1,1,1,5,4
Aaron Gordon,21-082,F,12/7/16,ORL,BOS,1,26,2,9,0.222,1,6,0.167,1,3,0.333,0,2,0,0,3,3,4,1,0,2,4,5,-0.2
Marquese Chriss,19-198,F,1/16/17,PHO,UTA,1,22,2,9,0.222,2,6,0.333,0,3,0,1,1,1,1,2,3,0,0,0,0,5,5,-1.2
Nicolas Brussino,23-257,G-F,11/14/16,DAL,NYK,0,8,2,3,0.667,1,1,1,1,2,0.5,0,0,,0,2,2,1,0,1,1,0,5,4.7
Derrick Favors,25-156,F-C,12/18/16,UTA,MEM,0,14,2,4,0.5,2,4,0.5,0,0,,1,2,0.5,0,1,1,0,0,4,0,0,5,5.7
Patrick McCaw,21-027,G,11/21/16,GSW,IND,0,12,2,8,0.25,1,4,0.25,1,4,0.25,0,0,,0,0,0,0,0,0,0,1,5,-0.2
Pascal Siakam,22-365,F,2/3/17,TOR,ORL,0,10,2,2,1,2,2,1,0,0,,1,2,0.5,1,2,3,0,0,0,0,2,5,4.5
Terry Rozier,22-226,G,10/29/16,BOS,CHO,0,21,2,4,0.5,2,3,0.667,0,1,0,1,1,1,0,3,3,2,0,0,2,1,5,2.9
Kelly Olynyk,25-286,C-F,1/30/17,BOS,DET,0,20,2,3,0.667,2,2,1,0,1,0,1,2,0.5,0,4,4,0,1,1,0,1,5,5.8
JaMychal Green,26-138,F,11/6/16,MEM,POR,1,33,2,6,0.333,2,3,0.667,0,3,0,1,2,0.5,4,4,8,2,0,1,1,3,5,5.1
Devin Harris,33-350,G,2/11/17,DAL,ORL,0,12,1,5,0.2,0,2,0,1,3,0.333,2,2,1,1,2,3,1,0,0,1,0,5,2.9
Mindaugas Kuzminskas,27-018,F,11/6/16,NYK,UTA,0,8,2,5,0.4,1,3,0.333,1,2,0.5,0,0,,2,0,2,0,0,0,0,1,5,3.3
Cristiano Felicio,24-232,F-C,2/24/17,CHI,PHO,0,17,2,4,0.5,2,4,0.5,0,0,,1,2,0.5,2,4,6,0,0,0,0,2,5,4.4
Trey Lyles,21-018,F,11/23/16,UTA,DEN,1,15,2,4,0.5,2,2,1,0,2,0,1,1,1,1,6,7,2,0,0,2,5,5,2.9
Dorian Finney-Smith,23-273,F,2/1/17,DAL,PHI,0,18,1,1,1,1,1,1,0,0,,3,4,0.75,0,1,1,2,0,1,0,2,5,5.9
K.J. McDaniels,24-002,G-F,2/11/17,HOU,PHO,0,5,2,4,0.5,1,2,0.5,1,2,0.5,0,0,,2,0,2,0,0,0,0,0,5,4.4
Ben McLemore,23-271,G,11/8/16,SAC,NOP,0,16,2,3,0.667,1,1,1,1,2,0.5,0,0,,1,3,4,0,0,0,1,0,5,4.3
Trevor Ariza,31-230,F,2/15/17,HOU,MIA,1,36,2,7,0.286,1,2,0.5,1,5,0.2,0,0,,0,4,4,2,2,0,2,1,5,3.1
Will Barton,26-018,G,1/24/17,DEN,UTA,0,22,1,7,0.143,0,3,0,1,4,0.25,2,3,0.667,1,3,4,2,0,1,1,2,5,2
Wesley Johnson,29-141,F-G,11/29/16,LAC,BRK,0,12,2,4,0.5,1,1,1,1,3,0.333,0,0,,0,1,1,1,1,1,0,4,5,4.1
Willie Cauley-Stein,23-125,F-C,12/21/16,SAC,UTA,0,19,2,4,0.5,2,4,0.5,0,0,,1,2,0.5,0,5,5,1,0,2,0,0,5,6.2
Stanley Johnson,20-289,F,3/14/17,DET,CLE,0,24,1,10,0.1,0,6,0,1,4,0.25,2,2,1,0,1,1,3,1,0,2,3,5,-1.4
Kentavious Caldwell-Pope,24-011,G,3/1/17,DET,NOP,1,33,2,11,0.182,1,5,0.2,1,6,0.167,0,0,,2,1,3,1,2,0,0,1,5,2.1
Mindaugas Kuzminskas,27-057,F,12/15/16,NYK,GSW,0,14,2,5,0.4,1,2,0.5,1,3,0.333,0,0,,1,0,1,1,2,0,0,0,5,5.7
Andre Iguodala,32-310,G-F,12/3/16,GSW,PHO,0,23,2,4,0.5,1,3,0.333,1,1,1,0,0,,1,5,6,3,0,0,1,2,5,5.5
Jerian Grant,24-185,G,4/12/17,CHI,BRK,0,22,2,7,0.286,1,3,0.333,1,4,0.25,0,0,,0,6,6,2,2,0,1,0,5,5.1
Thabo Sefolosha,32-214,G-F,12/2/16,ATL,DET,1,17,2,5,0.4,1,4,0.25,1,1,1,0,0,,0,2,2,0,1,0,0,0,5,3.9
Buddy Hield,23-046,G,2/1/17,NOP,DET,1,21,2,8,0.25,1,2,0.5,1,6,0.167,0,0,,0,6,6,1,1,0,1,3,5,1.5
Terrence Jones,24-356,F,12/30/16,NOP,NYK,0,18,2,6,0.333,2,6,0.333,0,0,,1,1,1,0,4,4,1,0,2,1,0,5,3.9
Evan Fournier,24-036,G-F,12/4/16,ORL,DET,1,32,1,7,0.143,0,4,0,1,3,0.333,2,2,1,0,1,1,2,3,0,3,2,5,1.4
Jordan Clarkson,24-166,G,11/20/16,LAL,CHI,0,25,1,12,0.083,0,9,0,1,3,0.333,2,3,0.667,1,1,2,3,0,0,0,0,5,-0.3
Spencer Hawes,28-212,C-F,11/26/16,CHO,NYK,0,14,2,7,0.286,1,3,0.333,1,4,0.25,0,0,,1,2,3,1,0,1,1,3,5,1.4
Isaiah Canaan,25-267,G,2/12/17,CHI,MIN,0,19,1,6,0.167,0,3,0,1,3,0.333,2,2,1,0,0,0,1,2,0,0,1,5,3.5
Omri Casspi,28-272,F,3/21/17,MIN,SAS,0,22,2,2,1,1,1,1,1,1,1,0,0,,0,1,1,0,0,0,5,1,5,-0.7
Jared Dudley,31-256,F-G,3/23/17,PHO,BRK,0,21,2,4,0.5,2,2,1,0,2,0,1,3,0.333,2,0,2,2,3,0,1,3,5,5.8
Danny Green,29-209,G-F,1/17/17,SAS,MIN,1,27,1,8,0.125,0,3,0,1,5,0.2,2,2,1,0,4,4,1,4,1,1,1,5,5
Joe Ingles,29-049,F-G,11/20/16,UTA,DEN,0,21,1,4,0.25,0,0,,1,4,0.25,2,2,1,0,2,2,4,1,0,1,3,5,4.8
Kelly Oubre,21-099,F,3/18/17,WAS,CHO,0,20,2,3,0.667,1,2,0.5,1,1,1,0,0,,0,1,1,0,0,0,1,2,5,2.2
Damjan Rudez,30-239,F,2/11/17,ORL,DAL,0,12,2,6,0.333,1,3,0.333,1,3,0.333,0,0,,0,0,0,1,1,0,0,1,5,2.9
Kelly Oubre,20-332,F,11/5/16,WAS,ORL,0,17,2,5,0.4,1,4,0.25,1,1,1,0,0,,0,0,0,0,0,0,0,1,5,1.9
Allen Crabbe,24-284,G-F,1/18/17,POR,CHO,0,18,2,7,0.286,1,4,0.25,1,3,0.333,0,0,,0,0,0,0,1,0,0,2,5,1.1
Randy Foye,33-057,G,11/20/16,BRK,POR,0,13,1,6,0.167,0,2,0,1,4,0.25,2,2,1,0,3,3,2,0,0,2,2,5,0.7
Courtney Lee,31-108,G,1/19/17,NYK,WAS,0,29,2,6,0.333,1,3,0.333,1,3,0.333,0,0,,0,4,4,2,1,0,0,2,5,4.4
Wesley Johnson,29-121,F-G,11/9/16,LAC,POR,0,19,2,6,0.333,1,2,0.5,1,4,0.25,0,0,,2,5,7,0,1,1,1,1,5,4.8
Kosta Koufos,28-023,C,3/19/17,SAC,SAS,1,15,2,5,0.4,2,5,0.4,0,0,,1,1,1,1,4,5,0,0,0,1,2,5,2.4
Corey Brewer,30-341,F-G,2/9/17,HOU,CHO,0,25,1,4,0.25,0,0,,1,4,0.25,2,2,1,0,4,4,2,3,0,0,4,5,6.6
Michael Carter-Williams,25-017,G,10/27/16,CHI,BOS,0,17,2,6,0.333,1,5,0.2,1,1,1,0,0,,3,3,6,3,0,0,0,3,5,5.5
Nemanja Bjelica,28-183,F,11/8/16,MIN,BRK,0,12,2,5,0.4,1,2,0.5,1,3,0.333,0,1,0,1,4,5,0,1,1,1,2,5,3.7
Patrick Beverley,28-203,G,1/31/17,HOU,SAC,1,32,2,11,0.182,1,5,0.2,1,6,0.167,0,0,,1,4,5,5,0,1,1,2,5,2.4
James Ennis,26-282,F,4/9/17,MEM,DET,0,22,2,4,0.5,1,1,1,1,3,0.333,0,0,,1,5,6,1,1,0,1,1,5,5.5
Rodney McGruder,25-213,G,2/27/17,MIA,DAL,1,25,2,5,0.4,1,2,0.5,1,3,0.333,0,0,,1,1,2,1,1,1,1,1,5,4.3
Solomon Hill,25-272,F,12/15/16,NOP,IND,1,31,1,3,0.333,0,0,,1,3,0.333,2,2,1,1,1,2,1,0,0,1,2,5,3.2
Kelly Olynyk,25-259,C-F,1/3/17,BOS,UTA,0,21,2,6,0.333,2,2,1,0,4,0,1,2,0.5,1,6,7,3,1,2,1,2,5,6.4
Sam Dekker,22-224,F,12/16/16,HOU,NOP,0,23,1,8,0.125,0,3,0,1,5,0.2,2,2,1,0,4,4,1,1,1,0,0,5,3.4
Andre Roberson,25-019,G-F,12/23/16,OKC,BOS,1,38,2,4,0.5,2,3,0.667,0,1,0,1,6,0.167,0,5,5,4,0,2,3,4,5,2.1
Manu Ginobili,39-218,G,3/3/17,SAS,NOP,0,21,2,5,0.4,2,2,1,0,3,0,1,1,1,0,3,3,2,0,0,0,1,5,4.2
Alex Len,23-196,C,12/29/16,PHO,TOR,0,21,2,5,0.4,2,5,0.4,0,0,,1,2,0.5,2,4,6,0,0,1,2,2,5,2.4
Semaj Christon,24-162,G,4/12/17,OKC,DEN,0,18,2,4,0.5,1,2,0.5,1,2,0.5,0,0,,0,0,0,2,0,0,0,4,5,2.8
Dorian Finney-Smith,23-301,F,3/1/17,DAL,ATL,1,24,2,8,0.25,1,3,0.333,1,5,0.2,0,0,,1,1,2,0,2,1,1,4,5,1.3
Boris Diaw,34-331,F-C,3/13/17,UTA,LAC,1,21,2,3,0.667,1,2,0.5,1,1,1,0,0,,1,2,3,2,0,0,1,0,5,5.4
Timothe Luwawu-Cabarrot,21-192,F,11/17/16,PHI,MIN,0,9,1,5,0.2,0,3,0,1,2,0.5,2,2,1,1,0,1,0,0,0,1,1,5,1.2
Dante Exum,21-211,G,2/9/17,UTA,DAL,1,18,2,3,0.667,1,1,1,1,2,0.5,0,0,,0,0,0,0,0,0,4,2,5,-1.1
Troy Daniels,25-151,G,12/13/16,MEM,CLE,0,20,1,6,0.167,0,1,0,1,5,0.2,2,2,1,0,2,2,1,0,0,2,1,5,0.1
JaMychal Green,26-167,F,12/5/16,MEM,NOP,1,43,2,9,0.222,2,6,0.333,0,3,0,1,3,0.333,3,14,17,1,1,0,1,4,5,4.1
Tim Quarterman,22-034,G,11/30/16,POR,IND,0,2,2,2,1,1,1,1,1,1,1,0,0,,0,0,0,0,0,0,0,0,5,4.4
Nikola Mirotic,25-306,F,12/13/16,CHI,MIN,0,20,1,5,0.2,1,1,1,0,4,0,3,4,0.75,1,4,5,0,0,0,0,0,5,3.4
James Ennis,26-172,F,12/20/16,MEM,BOS,1,18,2,4,0.5,2,4,0.5,0,0,,1,1,1,2,0,2,1,0,0,0,2,5,4.3
Thon Maker,19-320,F-C,1/10/17,MIL,SAS,0,13,2,2,1,1,1,1,1,1,1,0,0,,0,0,0,1,0,0,0,2,5,4.3
Zaza Pachulia,32-343,C,1/18/17,GSW,OKC,1,19,1,5,0.2,1,5,0.2,0,0,,3,5,0.6,3,3,6,2,1,0,1,3,5,4.3
Emmanuel Mudiay,20-304,G,1/3/17,DEN,SAC,1,28,2,8,0.25,1,3,0.333,1,5,0.2,0,0,,1,1,2,6,0,0,1,1,5,4
Caris LeVert,22-204,G-F,3/17/17,BRK,BOS,1,25,1,6,0.167,0,2,0,1,4,0.25,2,2,1,1,3,4,2,1,0,0,2,5,4.4
Johnny O'Bryant,23-248,F-C,2/4/17,DEN,SAS,0,9,2,3,0.667,1,2,0.5,1,1,1,0,0,,0,2,2,0,0,0,1,1,5,2.9
Marreese Speights,29-153,C-F,1/4/17,LAC,MEM,0,13,1,6,0.167,0,2,0,1,4,0.25,2,2,1,2,4,6,2,0,0,1,5,5,2.2
Ty Lawson,29-037,G,12/10/16,SAC,UTA,0,17,2,6,0.333,2,5,0.4,0,1,0,1,1,1,1,0,1,4,0,1,3,0,5,2.8
Patrick McCaw,21-015,G,11/9/16,GSW,DAL,0,20,2,4,0.5,1,3,0.333,1,1,1,0,0,,0,2,2,3,0,0,0,3,5,4.5
Jaylen Brown,20-142,F,3/15/17,BOS,MIN,0,17,2,5,0.4,1,3,0.333,1,2,0.5,0,0,,0,5,5,0,1,0,2,1,5,2.4
Patty Mills,28-181,G,2/8/17,SAS,PHI,0,18,2,5,0.4,1,2,0.5,1,3,0.333,0,0,,0,3,3,2,0,0,0,1,5,4.2
Andrew Harrison,22-009,G,11/6/16,MEM,POR,0,17,1,6,0.167,1,4,0.25,0,2,0,3,5,0.6,0,2,2,1,1,0,0,2,5,1.9
Jonas Jerebko,29-254,F,11/11/16,BOS,NYK,0,21,2,4,0.5,2,3,0.667,0,1,0,1,2,0.5,3,2,5,1,1,1,0,1,5,7.3
Aaron Gordon,21-066,F,11/21/16,ORL,MIL,0,21,1,5,0.2,1,2,0.5,0,3,0,3,6,0.5,0,4,4,0,1,0,2,2,5,0.1
Gerald Green,31-052,G-F,3/19/17,BOS,PHI,0,14,2,5,0.4,1,2,0.5,1,3,0.333,0,0,,0,2,2,0,0,1,1,0,5,2.6
JaMychal Green,26-234,F,2/10/17,MEM,GSW,1,22,2,4,0.5,2,3,0.667,0,1,0,1,1,1,2,5,7,0,0,0,4,6,5,-0.5
Stanley Johnson,20-246,F,1/30/17,DET,BOS,0,18,2,7,0.286,2,3,0.667,0,4,0,1,2,0.5,1,5,6,1,0,0,1,2,5,1.6
Andrew Harrison,22-141,G,3/18/17,MEM,SAS,0,12,0,2,0,0,1,0,0,1,0,5,5,1,0,0,0,2,0,0,1,0,5,4
Monta Ellis,31-032,G,11/27/16,IND,LAC,1,35,2,12,0.167,1,8,0.125,1,4,0.25,0,0,,0,6,6,2,1,1,1,3,5,0.1
Troy Daniels,25-146,G,12/8/16,MEM,POR,0,32,2,12,0.167,1,8,0.125,1,4,0.25,0,0,,0,2,2,0,1,0,1,2,5,-2.8
Trey Burke,24-082,G,2/2/17,WAS,LAL,0,12,2,9,0.222,2,8,0.25,0,1,0,1,2,0.5,0,1,1,2,0,1,0,1,5,1.1
Nerlens Noel,22-302,C-F,2/6/17,PHI,DET,0,16,2,4,0.5,2,4,0.5,0,0,,1,2,0.5,2,3,5,0,0,0,0,0,5,4.9
Miles Plumlee,28-209,C-F,3/29/17,CHO,TOR,0,15,2,2,1,2,2,1,0,0,,1,2,0.5,0,1,1,0,2,0,0,0,5,6.3
DeAndre Liggins,28-265,G,12/21/16,CLE,MIL,1,26,2,5,0.4,1,4,0.25,1,1,1,0,0,,0,4,4,0,0,1,1,2,5,2.4
Davis Bertans,24-090,F,2/10/17,SAS,DET,0,11,2,4,0.5,1,2,0.5,1,2,0.5,0,0,,0,1,1,0,0,0,2,2,5,0.5
Zach LaVine,21-305,G,1/9/17,MIN,DAL,1,29,2,7,0.286,1,3,0.333,1,4,0.25,0,0,,0,6,6,5,1,0,2,2,5,4.4
Joe Ingles,29-118,F-G,1/28/17,UTA,MEM,0,15,1,1,1,0,0,,1,1,1,2,2,1,0,1,1,1,0,0,2,2,5,2.9
D.J. Augustin,29-081,G,1/30/17,ORL,MIN,0,23,2,9,0.222,1,4,0.25,1,5,0.2,0,0,,0,1,1,3,0,0,1,0,5,0.9
John Henson,26-077,C-F,3/15/17,MIL,LAC,0,13,2,4,0.5,2,4,0.5,0,0,,1,2,0.5,3,4,7,0,0,0,0,2,5,5.1
Tarik Black,25-051,C-F,1/12/17,LAL,SAS,0,18,2,3,0.667,2,3,0.667,0,0,,1,2,0.5,2,1,3,0,1,0,1,3,5,3.8
Ian Mahinmi,30-128,C,3/13/17,WAS,MIN,0,22,2,2,1,2,2,1,0,0,,1,1,1,2,5,7,0,1,1,4,6,5,2.6
Patty Mills,28-210,G,3/9/17,SAS,OKC,0,22,2,7,0.286,1,3,0.333,1,4,0.25,0,0,,0,0,0,0,1,1,1,1,5,1.2
Andre Iguodala,32-360,G-F,1/22/17,GSW,ORL,0,29,1,5,0.2,0,1,0,1,4,0.25,2,2,1,0,6,6,5,1,0,3,0,5,5.2
Andrew Harrison,22-056,G,12/23/16,MEM,HOU,0,20,1,6,0.167,1,3,0.333,0,3,0,3,4,0.75,0,2,2,6,0,0,2,2,5,2.8
Garrett Temple,30-210,G,12/4/16,SAC,NYK,0,18,2,3,0.667,1,1,1,1,2,0.5,0,0,,0,3,3,1,1,1,1,3,5,4.8
Terry Rozier,22-256,G,11/28/16,BOS,MIA,0,13,2,4,0.5,1,1,1,1,3,0.333,0,0,,0,3,3,1,0,0,1,0,5,3.6
Sean Kilpatrick,27-049,G,2/24/17,BRK,DEN,0,18,1,7,0.143,1,5,0.2,0,2,0,3,7,0.429,0,0,0,0,0,0,2,1,5,-3.5
Gary Payton,24-122,G,4/2/17,MIL,DAL,0,9,2,3,0.667,1,1,1,1,2,0.5,0,0,,0,1,1,0,0,0,2,0,5,2
Matthew Dellavedova,26-214,G,4/10/17,MIL,CHO,0,22,2,5,0.4,1,3,0.333,1,2,0.5,0,0,,1,1,2,2,0,0,0,3,5,3.5
Sam Dekker,22-326,F,3/28/17,HOU,GSW,0,15,2,7,0.286,1,3,0.333,1,4,0.25,0,0,,0,5,5,0,0,0,0,2,5,1.6
Randy Foye,33-126,G,1/28/17,BRK,MIN,1,17,2,6,0.333,1,3,0.333,1,3,0.333,0,0,,0,2,2,1,0,0,3,0,5,-0.1
Marshall Plumlee,24-262,C,4/2/17,NYK,BOS,0,12,1,2,0.5,1,2,0.5,0,0,,3,3,1,2,2,4,0,2,0,1,0,5,7
Ed Davis,27-159,F,11/11/16,POR,SAC,0,11,1,3,0.333,1,3,0.333,0,0,,3,4,0.75,1,1,2,0,0,0,1,1,5,2.5
Nicolas Batum,28-076,F-G,2/28/17,CHO,LAL,1,36,2,13,0.154,1,4,0.25,1,9,0.111,0,0,,1,4,5,4,0,1,3,1,5,-1.3
Ian Clark,26-028,G,4/4/17,GSW,MIN,0,18,2,8,0.25,1,5,0.2,1,3,0.333,0,0,,1,2,3,1,1,0,1,1,5,1.8
Channing Frye,33-228,C-F,12/31/16,CLE,CHO,0,17,1,3,0.333,0,1,0,1,2,0.5,2,2,1,0,3,3,0,0,0,0,1,5,3.8
C.J. Miles,29-338,G-F,3/22/17,IND,BOS,1,24,2,8,0.25,1,4,0.25,1,4,0.25,0,0,,1,0,1,1,1,0,0,3,5,1.4
Jonathon Simmons,27-113,G-F,1/5/17,SAS,DEN,0,13,1,1,1,1,1,1,0,0,,3,4,0.75,0,0,0,0,0,0,1,1,5,2.9
Patrick Beverley,28-130,G,11/19/16,HOU,UTA,1,27,2,6,0.333,1,4,0.25,1,2,0.5,0,0,,0,1,1,6,3,0,2,2,5,6.3
Channing Frye,33-255,C-F,1/27/17,CLE,BRK,0,18,2,7,0.286,1,2,0.5,1,5,0.2,0,0,,3,5,8,0,0,1,0,1,5,4.8
James Ennis,26-217,F,2/3/17,MEM,OKC,0,23,2,5,0.4,1,3,0.333,1,2,0.5,0,0,,2,1,3,1,1,1,2,6,5,2
Gerald Henderson,29-107,G,3/26/17,PHI,IND,0,18,2,6,0.333,1,3,0.333,1,3,0.333,0,0,,1,1,2,1,0,0,0,2,5,2.5
Tony Snell,24-362,G-F,11/6/16,MIL,DAL,1,36,2,8,0.25,1,1,1,1,7,0.143,0,0,,0,3,3,1,0,0,3,4,5,-2.8
Nicolas Brussino,24-040,G-F,4/11/17,DAL,DEN,0,27,2,5,0.4,1,1,1,1,4,0.25,0,0,,0,2,2,2,1,0,1,0,5,4.3
Dante Exum,21-255,G,3/25/17,UTA,LAC,0,3,2,2,1,1,1,1,1,1,1,0,0,,0,0,0,1,0,0,0,0,5,5.1
Thabo Sefolosha,32-190,G-F,11/8/16,ATL,CLE,1,35,2,6,0.333,1,3,0.333,1,3,0.333,0,0,,2,3,5,1,1,0,1,3,5,3.4
Meyers Leonard,24-280,C-F,12/3/16,POR,MIA,0,19,2,6,0.333,1,4,0.25,1,2,0.5,0,0,,1,5,6,1,0,0,1,0,5,3.5
Jerian Grant,24-112,G,1/29/17,CHI,PHI,1,17,2,4,0.5,1,3,0.333,1,1,1,0,0,,0,0,0,0,0,1,1,2,5,1.9
Joffrey Lauvergne,25-061,C-F,11/30/16,OKC,WAS,0,12,2,3,0.667,1,2,0.5,1,1,1,0,0,,0,4,4,1,1,0,2,1,5,4.2
Solomon Hill,26-020,F,4/7/17,NOP,DEN,1,41,2,8,0.25,2,5,0.4,0,3,0,1,1,1,1,4,5,2,3,0,1,3,5,4.3
Troy Daniels,25-161,G,12/23/16,MEM,HOU,0,10,1,1,1,0,0,,1,1,1,2,3,0.667,0,1,1,0,1,0,0,0,5,5.6
Tyler Johnson,24-189,G,11/12/16,MIA,UTA,0,29,2,7,0.286,2,5,0.4,0,2,0,1,1,1,1,2,3,4,1,0,0,1,5,5.6
Larry Nance Jr.,23-301,F,10/28/16,LAL,UTA,0,16,2,4,0.5,1,2,0.5,1,2,0.5,0,1,0,0,3,3,0,0,0,0,2,5,2.7
Quincy Acy,26-180,F,4/4/17,BRK,PHI,0,13,2,5,0.4,1,2,0.5,1,3,0.333,0,0,,0,3,3,0,0,0,2,1,5,0.8
Nicolas Laprovittola,26-283,G,11/9/16,SAS,HOU,0,14,2,5,0.4,1,3,0.333,1,2,0.5,0,0,,0,0,0,0,1,0,1,0,5,2.3
Ed Davis,27-214,F,1/5/17,POR,LAL,0,16,1,3,0.333,1,3,0.333,0,0,,3,4,0.75,3,5,8,0,0,0,1,3,5,4.3
Tyler Johnson,24-225,G,12/18/16,MIA,BOS,0,30,2,7,0.286,2,2,1,0,5,0,1,2,0.5,2,4,6,3,1,1,4,3,5,1.7
Paul Pierce,39-037,F-G,11/19/16,LAC,CHI,0,9,2,4,0.5,1,1,1,1,3,0.333,0,0,,0,0,0,0,0,0,0,1,5,2.6
J.J. Barea,32-270,G,3/23/17,DAL,LAC,0,12,2,5,0.4,1,1,1,1,4,0.25,0,0,,0,0,0,3,0,0,0,2,5,3.6
Al Jefferson,32-035,C-F,2/8/17,IND,CLE,0,3,2,2,1,2,2,1,0,0,,1,2,0.5,1,2,3,0,0,0,0,1,5,4.9
DeAndre Liggins,28-253,G,12/9/16,CLE,MIA,1,26,2,3,0.667,2,3,0.667,0,0,,1,2,0.5,0,2,2,2,1,3,0,1,5,8
Corey Brewer,30-358,F-G,2/26/17,LAL,SAS,0,13,1,3,0.333,0,2,0,1,1,1,2,2,1,1,1,2,1,1,0,0,2,5,5.2
Justin Anderson,22-349,G,11/2/16,DAL,UTA,0,20,2,5,0.4,1,3,0.333,1,2,0.5,0,0,,4,4,8,1,1,0,3,2,5,4.2
Raul Neto,24-203,G,12/8/16,UTA,GSW,0,14,2,5,0.4,1,3,0.333,1,2,0.5,0,0,,0,2,2,1,0,0,2,2,5,0.8
Garrett Temple,30-322,G,3/26/17,SAC,LAC,0,27,2,8,0.25,1,6,0.167,1,2,0.5,0,0,,1,4,5,5,0,0,3,3,5,1.4
Luis Scola,36-255,F,1/10/17,BRK,ATL,0,16,2,6,0.333,1,4,0.25,1,2,0.5,0,0,,4,3,7,1,1,0,0,1,5,6.6
Terry Rozier,22-319,G,1/30/17,BOS,DET,0,11,2,3,0.667,1,1,1,1,2,0.5,0,0,,0,1,1,0,1,0,0,2,5,4.2
Jarell Martin,22-225,F,1/4/17,MEM,LAC,1,12,1,3,0.333,0,2,0,1,1,1,2,2,1,2,1,3,0,0,0,0,4,5,3.4
Allen Crabbe,24-282,G-F,1/16/17,POR,WAS,0,25,2,6,0.333,1,3,0.333,1,3,0.333,0,1,0,1,2,3,5,0,0,1,4,5,3.4
Jake Layman,22-309,F,1/10/17,POR,LAL,0,3,2,3,0.667,1,2,0.5,1,1,1,0,0,,0,0,0,0,0,0,0,0,5,3.7
Dorian Finney-Smith,23-229,F,12/19/16,DAL,DEN,1,26,2,4,0.5,1,2,0.5,1,2,0.5,0,0,,0,4,4,0,0,1,2,2,5,2.1
Johnny O'Bryant,23-257,F-C,2/13/17,DEN,GSW,0,12,1,1,1,0,0,,1,1,1,2,2,1,2,1,3,1,0,1,2,1,5,5.4
Jerian Grant,24-073,G,12/21/16,CHI,WAS,0,14,2,4,0.5,2,2,1,0,2,0,1,1,1,2,0,2,2,1,0,1,3,5,4.6
Serge Ibaka,27-066,F-C,11/23/16,ORL,PHO,1,32,2,9,0.222,1,6,0.167,1,3,0.333,0,0,,2,2,4,0,0,3,2,3,5,0.4
Omer Asik,30-120,C,11/1/16,NOP,MIL,0,13,1,3,0.333,1,3,0.333,0,0,,3,6,0.5,2,5,7,1,1,1,1,1,5,6
Patrick McCaw,21-095,G,1/28/17,GSW,LAC,0,18,2,5,0.4,1,1,1,1,4,0.25,0,0,,0,2,2,1,0,0,0,1,5,3.2
Andre Roberson,24-339,G-F,11/7/16,OKC,MIA,1,30,2,4,0.5,2,4,0.5,0,0,,1,2,0.5,1,4,5,2,3,0,1,0,5,7.9
Vince Carter,39-277,G-F,10/29/16,MEM,NYK,0,25,2,4,0.5,1,1,1,1,3,0.333,0,0,,1,2,3,1,0,0,0,2,5,4.2
Kris Dunn,22-268,G,12/11/16,MIN,GSW,0,16,2,4,0.5,2,4,0.5,0,0,,1,2,0.5,0,2,2,1,0,0,0,1,5,3.5
Zaza Pachulia,32-263,C,10/30/16,GSW,PHO,1,22,1,5,0.2,1,5,0.2,0,0,,3,3,1,4,6,10,4,0,0,3,1,5,5.9
Dante Exum,21-238,G,3/8/17,UTA,HOU,1,9,1,2,0.5,1,1,1,0,1,0,3,3,1,0,1,1,1,0,0,2,4,5,1.4
Allen Crabbe,24-213,G-F,11/8/16,POR,PHO,0,32,2,6,0.333,1,3,0.333,1,3,0.333,0,1,0,0,1,1,1,0,0,1,5,5,-0.8
Kris Dunn,22-307,G,1/19/17,MIN,LAC,0,25,2,4,0.5,2,3,0.667,0,1,0,1,2,0.5,1,3,4,4,1,1,3,5,5,3.7
Domantas Sabonis,20-224,F,12/13/16,OKC,POR,1,20,2,4,0.5,1,3,0.333,1,1,1,0,0,,2,7,9,0,0,1,2,4,5,3.6
Robert Covington,26-012,F,12/26/16,PHI,SAC,1,37,2,6,0.333,2,4,0.5,0,2,0,1,2,0.5,1,5,6,1,2,2,3,4,5,2.9
Iman Shumpert,26-244,G,2/25/17,CLE,CHI,1,23,2,9,0.222,2,5,0.4,0,4,0,1,2,0.5,1,5,6,1,0,1,2,3,5,-0.5
Nemanja Bjelica,28-237,F,1/1/17,MIN,POR,0,15,2,3,0.667,1,1,1,1,2,0.5,0,0,,0,2,2,1,1,0,1,4,5,3.4
Andre Roberson,25-043,G-F,1/16/17,OKC,LAC,1,26,2,5,0.4,1,1,1,1,4,0.25,0,0,,1,4,5,1,0,0,0,1,5,4.5
Kris Dunn,22-240,G,11/13/16,MIN,LAL,0,14,1,2,0.5,1,2,0.5,0,0,,3,5,0.6,0,2,2,2,1,0,0,1,5,5.8
Nene Hilario,34-104,F-C,12/26/16,HOU,PHO,0,14,2,3,0.667,2,3,0.667,0,0,,1,2,0.5,1,2,3,1,0,1,0,1,5,5.6
Darrell Arthur,29-001,F,3/26/17,DEN,NOP,0,11,2,4,0.5,1,3,0.333,1,1,1,0,0,,0,1,1,1,1,0,0,1,5,4.6
Patrick Patterson,27-355,F,3/4/17,TOR,MIL,0,19,2,4,0.5,1,2,0.5,1,2,0.5,0,0,,0,2,2,0,0,1,0,4,5,2.7
Marreese Speights,29-188,C-F,2/8/17,LAC,NYK,0,10,2,5,0.4,1,1,1,1,4,0.25,0,0,,1,2,3,0,1,0,1,1,5,3.2
Tyus Jones,20-272,G,2/6/17,MIN,MIA,0,31,2,5,0.4,2,4,0.5,0,1,0,1,2,0.5,0,1,1,9,2,0,0,2,5,9.7
Nicolas Brussino,23-262,G-F,11/19/16,DAL,ORL,0,5,2,3,0.667,1,2,0.5,1,1,1,0,0,,0,1,1,0,0,0,1,1,5,2.6
Jerian Grant,24-144,G,3/2/17,CHI,GSW,1,13,2,2,1,1,1,1,1,1,1,0,0,,0,1,1,1,1,0,0,0,5,6.4
Trey Burke,24-067,G,1/18/17,WAS,MEM,0,8,2,3,0.667,2,3,0.667,0,0,,1,1,1,0,2,2,1,0,0,1,0,5,4
James Ennis,26-123,F,11/1/16,MEM,MIN,1,21,2,5,0.4,1,3,0.333,1,2,0.5,0,0,,0,4,4,0,2,0,2,3,5,2.3
Georges Niang,23-161,F,11/25/16,IND,BRK,0,6,2,6,0.333,1,3,0.333,1,3,0.333,0,0,,0,0,0,0,1,0,0,0,5,2.6
Dante Cunningham,29-307,F,2/23/17,NOP,HOU,0,25,2,3,0.667,1,1,1,1,2,0.5,0,0,,1,3,4,1,1,0,1,4,5,4.4
Norman Powell,23-233,G,1/13/17,TOR,BRK,0,13,2,5,0.4,1,3,0.333,1,2,0.5,0,0,,0,0,0,2,1,0,1,1,5,3.3
Danny Green,29-278,G-F,3/27/17,SAS,CLE,1,19,1,7,0.143,0,1,0,1,6,0.167,2,2,1,0,2,2,1,2,4,2,1,5,4.2
Langston Galloway,25-006,G,12/15/16,NOP,IND,0,20,2,10,0.2,1,3,0.333,1,7,0.143,0,0,,0,1,1,0,2,0,0,0,5,1.1
Malcolm Brogdon,23-358,G,12/3/16,MIL,BRK,0,21,2,8,0.25,2,6,0.333,0,2,0,1,1,1,0,2,2,4,0,0,0,0,5,3.6
Dante Exum,21-141,G,12/1/16,UTA,MIA,1,18,1,6,0.167,0,2,0,1,4,0.25,2,2,1,1,1,2,2,0,1,4,2,5,-0.5
Justin Holiday,27-261,G,12/22/16,NYK,ORL,0,20,2,8,0.25,1,6,0.167,1,2,0.5,0,0,,0,0,0,0,1,0,0,0,5,1.2
Wesley Johnson,29-248,F-G,3/16/17,LAC,DEN,0,14,2,6,0.333,1,2,0.5,1,4,0.25,0,0,,0,2,2,1,0,0,1,1,5,1.5
Jose Calderon,35-051,G,11/18/16,LAL,SAS,1,13,2,5,0.4,1,3,0.333,1,2,0.5,0,0,,1,0,1,3,0,0,0,2,5,4.3
Channing Frye,33-198,C-F,12/1/16,CLE,LAC,0,15,0,2,0,0,1,0,0,1,0,5,6,0.833,0,5,5,0,0,0,1,4,5,2.1
Malcolm Delaney,27-318,G,1/23/17,ATL,LAC,0,19,2,5,0.4,1,3,0.333,1,2,0.5,0,0,,0,2,2,2,1,0,0,0,5,5.3
Damjan Rudez,30-280,F,3/24/17,ORL,DET,0,6,2,3,0.667,1,2,0.5,1,1,1,0,0,,0,1,1,1,0,0,0,0,5,4.7
Stanley Johnson,20-208,F,12/23/16,DET,GSW,0,18,1,4,0.25,0,2,0,1,2,0.5,2,4,0.5,1,2,3,2,3,0,1,1,5,6.1
Tarik Black,25-101,C-F,3/3/17,LAL,BOS,1,18,1,4,0.25,1,4,0.25,0,0,,3,4,0.75,1,3,4,1,0,2,0,1,5,5.5
Kelly Oubre,21-010,F,12/19/16,WAS,IND,0,19,2,8,0.25,2,6,0.333,0,2,0,1,2,0.5,4,3,7,1,0,1,0,3,5,3.7
Vince Carter,40-020,G-F,2/15/17,MEM,NOP,0,25,1,7,0.143,0,2,0,1,5,0.2,2,4,0.5,0,3,3,2,0,1,1,3,5,0.5
Jamal Murray,19-333,G,1/21/17,DEN,LAC,0,19,2,7,0.286,1,4,0.25,1,3,0.333,0,0,,0,1,1,3,1,0,3,1,5,0.9
Jared Dudley,31-213,F-G,2/8/17,PHO,MEM,0,17,2,5,0.4,2,3,0.667,0,2,0,1,2,0.5,2,4,6,3,0,0,0,3,5,5.4
James Ennis,26-173,F,12/21/16,MEM,DET,0,18,2,4,0.5,1,3,0.333,1,1,1,0,0,,0,5,5,1,2,2,0,0,5,8.6
Devin Harris,33-303,G,12/26/16,DAL,NOP,0,18,2,4,0.5,1,1,1,1,3,0.333,0,0,,0,3,3,2,0,0,0,1,5,4.9
Larry Nance Jr.,23-299,F,10/26/16,LAL,HOU,0,23,2,5,0.4,2,4,0.5,0,1,0,1,2,0.5,3,2,5,2,1,1,0,1,5,7.3
Udonis Haslem,36-211,F-C,1/6/17,MIA,LAL,0,7,2,2,1,2,2,1,0,0,,1,2,0.5,1,3,4,2,0,0,1,1,5,5.6
Malcolm Brogdon,23-344,G,11/19/16,MIL,GSW,0,14,2,6,0.333,1,4,0.25,1,2,0.5,0,0,,0,4,4,1,0,0,1,0,5,2.5
Marcus Smart,23-037,G,4/12/17,BOS,MIL,0,28,1,3,0.333,0,1,0,1,2,0.5,2,2,1,2,3,5,8,2,1,2,4,5,10.3
Semaj Christon,23-364,G,10/30/16,OKC,LAL,0,20,2,6,0.333,1,5,0.2,1,1,1,0,1,0,0,0,0,2,2,0,1,1,5,3.2
Solomon Hill,25-235,F,11/8/16,NOP,SAC,1,26,1,4,0.25,0,2,0,1,2,0.5,2,2,1,0,5,5,1,0,0,0,4,5,3.2
Ian Clark,25-327,G,1/28/17,GSW,LAC,0,12,2,5,0.4,1,2,0.5,1,3,0.333,0,0,,0,1,1,1,0,0,1,0,5,2.3
Nicolas Batum,28-104,F-G,3/28/17,CHO,MIL,1,29,2,9,0.222,2,7,0.286,0,2,0,1,1,1,0,2,2,4,1,0,0,1,5,3.5
Mike Muscala,25-144,F-C,11/22/16,ATL,NOP,0,15,1,4,0.25,1,3,0.333,0,1,0,3,4,0.75,2,4,6,1,0,0,1,2,5,3.7
Ricky Rubio,26-074,G,1/3/17,MIN,PHI,1,30,2,3,0.667,1,1,1,1,2,0.5,0,0,,1,2,3,5,2,0,3,2,5,6.7
Andre Iguodala,33-028,G-F,2/25/17,GSW,BRK,0,26,2,4,0.5,1,2,0.5,1,2,0.5,0,0,,0,2,2,9,2,2,1,2,5,11.5
Marquese Chriss,19-223,F,2/10/17,PHO,CHI,1,22,2,3,0.667,1,2,0.5,1,1,1,0,0,,0,2,2,3,0,1,0,5,5,5.1
Malcolm Brogdon,24-120,G,4/10/17,MIL,CHO,1,25,2,6,0.333,1,3,0.333,1,3,0.333,0,0,,1,3,4,3,0,0,3,0,5,2.3
Buddy Hield,23-060,G,2/15/17,NOP,MEM,1,18,2,4,0.5,1,2,0.5,1,2,0.5,0,0,,0,2,2,1,1,0,0,1,5,4.9
Luis Scola,36-193,F,11/9/16,BRK,NYK,0,14,2,5,0.4,2,4,0.5,0,1,0,1,3,0.333,1,3,4,0,0,0,2,3,5,-0.1
Patrick Patterson,27-254,F,11/23/16,TOR,HOU,0,27,1,3,0.333,0,1,0,1,2,0.5,2,2,1,1,4,5,1,4,0,0,3,5,8.7
Tim Hardaway,24-229,G,10/31/16,ATL,SAC,0,13,2,6,0.333,2,3,0.667,0,3,0,1,3,0.333,1,1,2,0,0,0,1,1,5,0.4
Glenn Robinson,23-012,G-F,1/20/17,IND,LAL,1,22,2,4,0.5,1,2,0.5,1,2,0.5,0,2,0,1,1,2,1,0,0,2,1,5,1.5
James Jones,36-021,F-G,10/25/16,CLE,NYK,0,6,1,2,0.5,0,1,0,1,1,1,2,2,1,0,0,0,0,0,0,0,1,5,3.6
Brandon Ingram,19-067,F,11/8/16,LAL,DAL,0,26,2,5,0.4,1,3,0.333,1,2,0.5,0,0,,0,4,4,1,1,1,1,1,5,4.5
Iman Shumpert,26-242,G,2/23/17,CLE,NYK,1,23,2,9,0.222,1,3,0.333,1,6,0.167,0,0,,1,2,3,0,2,0,0,4,5,1.2
D.J. Augustin,29-052,G,1/1/17,ORL,IND,1,15,2,6,0.333,1,2,0.5,1,4,0.25,0,0,,0,0,0,3,1,0,1,1,5,3.3
Justin Anderson,23-014,G,12/3/16,DAL,CHI,0,10,1,3,0.333,0,2,0,1,1,1,2,4,0.5,1,2,3,0,1,1,0,0,5,5.5
Jerian Grant,24-087,G,1/4/17,CHI,CLE,0,20,1,5,0.2,0,1,0,1,4,0.25,2,2,1,0,2,2,3,1,0,1,3,5,3.4
JaVale McGee,28-305,C,11/19/16,GSW,MIL,0,5,2,2,1,2,2,1,0,0,,1,2,0.5,1,2,3,0,0,1,0,0,5,6
Meyers Leonard,24-326,C-F,1/18/17,POR,CHO,0,18,2,8,0.25,1,5,0.2,1,3,0.333,0,0,,1,3,4,1,0,1,1,0,5,2.2
James Ennis,26-253,F,3/11/17,MEM,ATL,1,18,2,7,0.286,2,4,0.5,0,3,0,1,2,0.5,0,3,3,2,0,1,0,1,5,3.1
E'Twaun Moore,27-299,G,12/23/16,NOP,MIA,0,26,2,6,0.333,1,4,0.25,1,2,0.5,0,1,0,0,3,3,1,1,1,1,2,5,2.7
Tim Frazier,26-134,G,3/15/17,NOP,MIA,0,17,2,3,0.667,1,1,1,1,2,0.5,0,0,,1,0,1,4,1,0,0,0,5,8.2
Aaron Brooks,32-064,G,3/19/17,IND,TOR,0,10,2,5,0.4,1,4,0.25,1,1,1,0,0,,0,1,1,1,0,0,1,3,5,1.1
Michael Beasley,28-012,F,1/21/17,MIL,MIA,0,10,2,4,0.5,2,4,0.5,0,0,,1,2,0.5,0,2,2,0,0,0,1,0,5,2.2
Kentavious Caldwell-Pope,24-032,G,3/22/17,DET,CHI,1,30,2,4,0.5,1,2,0.5,1,2,0.5,0,0,,0,1,1,1,2,0,2,2,5,3.2
Luc Mbah a Moute,30-195,F,3/23/17,LAC,DAL,1,13,2,4,0.5,1,2,0.5,1,2,0.5,0,0,,0,0,0,0,1,0,1,1,5,2.6
Channing Frye,33-238,C-F,1/10/17,CLE,UTA,0,19,1,6,0.167,1,3,0.333,0,3,0,3,3,1,1,2,3,0,0,1,1,2,5,1.4
Justin Holiday,27-235,G,11/26/16,NYK,CHO,0,18,2,7,0.286,1,4,0.25,1,3,0.333,0,0,,0,4,4,4,1,0,1,2,5,4.1
Dante Exum,21-150,G,12/10/16,UTA,SAC,1,22,2,5,0.4,1,4,0.25,1,1,1,0,0,,0,2,2,2,2,0,2,1,5,3.9
Patrick Patterson,27-289,F,12/28/16,TOR,GSW,0,33,2,9,0.222,1,4,0.25,1,5,0.2,0,0,,1,4,5,0,0,1,2,1,5,-0.3
Amir Johnson,29-284,F,2/9/17,BOS,POR,1,15,2,5,0.4,2,4,0.5,0,1,0,1,2,0.5,4,1,5,1,0,0,1,1,5,4.3
Nemanja Bjelica,28-281,F,2/14/17,MIN,CLE,0,15,2,4,0.5,1,3,0.333,1,1,1,0,0,,2,4,6,0,0,0,1,2,5,3.8
Alexis Ajinca,28-283,C,2/13/17,NOP,PHO,1,19,2,5,0.4,2,5,0.4,0,0,,1,2,0.5,2,1,3,0,1,0,1,4,5,2
Tony Snell,25-149,G-F,4/8/17,MIL,PHI,1,33,2,6,0.333,1,1,1,1,5,0.2,0,0,,0,2,2,1,2,0,0,0,5,4.9
Raymond Felton,32-132,G,11/5/16,LAC,SAS,0,19,2,3,0.667,1,2,0.5,1,1,1,0,0,,0,1,1,3,1,1,1,0,5,6.8
Dragan Bender,19-060,F,1/16/17,PHO,UTA,0,25,2,4,0.5,1,1,1,1,3,0.333,0,0,,1,3,4,0,0,2,1,2,5,4.2
Buddy Hield,22-346,G,11/27/16,NOP,DAL,0,16,1,5,0.2,0,2,0,1,3,0.333,2,2,1,0,4,4,1,0,0,0,2,5,3
Patrick Patterson,27-228,F,10/28/16,TOR,CLE,0,34,2,6,0.333,1,1,1,1,5,0.2,0,0,,1,5,6,3,1,0,0,2,5,6.1
Nik Stauskas,23-147,G,3/3/17,PHI,NYK,1,30,1,5,0.2,0,1,0,1,4,0.25,2,2,1,0,5,5,1,0,0,1,0,5,3.1
Marquese Chriss,19-208,F,1/26/17,PHO,DEN,1,8,2,3,0.667,1,1,1,1,2,0.5,0,0,,0,0,0,0,2,0,1,4,5,3.1
Josh Richardson,23-183,G,3/17/17,MIA,MIN,0,32,1,5,0.2,1,5,0.2,0,0,,3,4,0.75,1,3,4,3,0,3,0,3,5,6.1
Patty Mills,28-242,G,4/10/17,SAS,POR,0,16,2,5,0.4,1,3,0.333,1,2,0.5,0,0,,0,1,1,2,0,0,3,1,5,0.6
Boban Marjanovic,28-201,C,3/4/17,DET,PHI,0,3,2,3,0.667,2,3,0.667,0,0,,1,2,0.5,0,0,0,0,0,0,0,0,5,3.3
Vince Carter,39-336,G-F,12/27/16,MEM,BOS,0,23,2,10,0.2,1,4,0.25,1,6,0.167,0,2,0,0,3,3,2,2,0,1,2,5,0.5
Marshall Plumlee,24-188,C,1/18/17,NYK,BOS,0,20,2,2,1,2,2,1,0,0,,1,3,0.333,3,4,7,3,0,2,2,5,5,6.4
Ian Clark,25-303,G,1/4/17,GSW,POR,0,12,2,5,0.4,1,2,0.5,1,3,0.333,0,0,,0,0,0,1,0,0,0,1,5,2.6
Matthew Dellavedova,26-153,G,2/8/17,MIL,MIA,1,15,2,6,0.333,1,4,0.25,1,2,0.5,0,0,,0,1,1,1,0,0,0,1,5,2.2
Tony Parker,34-274,G,2/15/17,SAS,ORL,1,23,2,10,0.2,2,7,0.286,0,3,0,1,2,0.5,0,0,0,8,2,0,0,1,5,5.6
Darrell Arthur,28-245,F,11/25/16,DEN,OKC,0,20,2,5,0.4,1,1,1,1,4,0.25,0,0,,0,2,2,0,1,0,3,3,5,-0.3
Malachi Richardson,21-018,G,1/23/17,SAC,DET,0,14,2,4,0.5,2,4,0.5,0,0,,1,2,0.5,0,0,0,1,1,0,0,0,5,4.3
Gerald Green,30-329,G-F,12/20/16,BOS,MEM,0,7,2,6,0.333,1,3,0.333,1,3,0.333,0,0,,1,2,3,0,0,0,1,0,5,1.9
Solomon Hill,26-008,F,3/26/17,NOP,DEN,1,21,1,5,0.2,0,2,0,1,3,0.333,2,2,1,0,5,5,1,0,0,1,3,5,1.9
Andrew Harrison,22-119,G,2/24/17,MEM,IND,0,3,1,1,1,0,0,,1,1,1,2,2,1,0,0,0,0,0,0,0,0,5,4.7
Trey Burke,24-104,G,2/24/17,WAS,PHI,0,10,1,4,0.25,0,2,0,1,2,0.5,2,2,1,0,0,0,1,0,0,1,3,5,1.1
Josh Richardson,23-172,G,3/6/17,MIA,CLE,0,32,1,4,0.25,1,2,0.5,0,2,0,3,4,0.75,0,2,2,4,3,0,0,3,5,7.4
Buddy Hield,22-337,G,11/18/16,NOP,POR,0,7,2,2,1,1,1,1,1,1,1,0,0,,0,1,1,0,0,0,0,0,5,4.7
Rondae Hollis-Jefferson,22-059,F,3/3/17,BRK,UTA,1,17,2,4,0.5,2,4,0.5,0,0,,1,2,0.5,1,1,2,1,0,0,0,2,5,3.5
Boris Diaw,34-340,F-C,3/22/17,UTA,NYK,1,14,2,6,0.333,1,5,0.2,1,1,1,0,0,,0,1,1,1,0,0,0,0,5,2.6
Amir Johnson,29-302,F,2/27/17,BOS,ATL,1,17,2,3,0.667,2,2,1,0,1,0,1,2,0.5,0,2,2,1,1,2,1,2,5,5.2
Chasson Randle,24-001,G,2/6/17,PHI,DET,0,5,1,1,1,1,1,1,0,0,,3,3,1,0,0,0,1,0,0,1,0,5,4.4
Justin Anderson,23-105,G,3/4/17,PHI,DET,0,30,1,6,0.167,0,3,0,1,3,0.333,2,2,1,0,8,8,0,0,0,1,2,5,1.8
Jusuf Nurkic,22-149,C,1/19/17,DEN,SAS,0,14,2,5,0.4,2,5,0.4,0,0,,1,5,0.2,0,1,1,0,0,1,1,1,5,0.3
Rondae Hollis-Jefferson,22-038,F,2/10/17,BRK,MIA,1,23,1,3,0.333,1,3,0.333,0,0,,3,4,0.75,2,4,6,3,2,0,1,3,5,7.4
Josh McRoberts,29-271,F,11/25/16,MIA,MEM,0,12,2,7,0.286,2,7,0.286,0,0,,1,2,0.5,1,4,5,3,0,1,0,2,5,4.4
Bismack Biyombo,24-221,C-F,4/6/17,ORL,BRK,0,6,1,1,1,1,1,1,0,0,,3,4,0.75,1,1,2,0,0,1,2,1,5,3.6
Brandon Rush,31-212,G-F,2/4/17,MIN,MEM,1,24,1,5,0.2,0,2,0,1,3,0.333,2,2,1,1,2,3,0,0,0,1,1,5,1.8
Alex Abrines,23-222,G-F,3/11/17,OKC,UTA,0,15,2,3,0.667,1,2,0.5,1,1,1,0,0,,0,0,0,1,0,0,0,1,5,4
Randy Foye,33-046,G,11/9/16,BRK,NYK,0,15,2,6,0.333,1,2,0.5,1,4,0.25,0,0,,0,0,0,1,0,0,1,1,5,0.9
Amir Johnson,29-334,F,3/31/17,BOS,ORL,1,19,1,1,1,0,0,,1,1,1,2,3,0.667,0,5,5,3,1,2,0,1,5,9.9
Trey Burke,24-078,G,1/29/17,WAS,NOP,0,11,2,5,0.4,1,3,0.333,1,2,0.5,0,0,,0,0,0,3,0,0,1,0,5,3.4
Andre Roberson,24-354,G-F,11/22/16,OKC,LAL,1,27,2,5,0.4,1,2,0.5,1,3,0.333,0,2,0,1,2,3,1,2,2,0,1,5,6.5
Meyers Leonard,24-270,C-F,11/23/16,POR,CLE,0,8,2,4,0.5,1,3,0.333,1,1,1,0,0,,1,2,3,0,0,1,1,2,5,3.2
Luke Babbitt,27-193,F,12/30/16,MIA,BOS,1,16,2,4,0.5,1,1,1,1,3,0.333,0,0,,0,2,2,1,0,0,0,1,5,3.9
Stanley Johnson,20-251,F,2/4/17,DET,IND,0,19,2,5,0.4,2,5,0.4,0,0,,1,1,1,0,4,4,1,0,0,2,1,5,1.8
Domantas Sabonis,20-209,F,11/28/16,OKC,NYK,1,16,2,5,0.4,1,4,0.25,1,1,1,0,0,,0,1,1,0,0,0,2,3,5,-0.6
Jameer Nelson,34-328,G,1/2/17,DEN,GSW,0,17,2,4,0.5,2,2,1,0,2,0,1,1,1,0,0,0,4,0,0,4,4,5,0.2
D'Angelo Russell,20-326,G,1/14/17,LAL,LAC,1,28,1,7,0.143,1,6,0.167,0,1,0,3,5,0.6,1,4,5,5,0,0,2,1,5,2.7
Jared Dudley,31-235,F-G,3/2/17,PHO,CHO,0,27,2,7,0.286,1,2,0.5,1,5,0.2,0,0,,0,1,1,2,0,1,1,3,5,1.1
Danny Green,29-227,G-F,2/4/17,SAS,DEN,1,20,2,5,0.4,1,1,1,1,4,0.25,0,0,,0,4,4,3,2,0,2,0,5,5.6
Jrue Holiday,26-189,G,12/18/16,NOP,SAS,1,24,2,8,0.25,1,6,0.167,1,2,0.5,0,0,,0,2,2,6,1,1,2,2,5,3.9
Allen Crabbe,24-344,G-F,3/19/17,POR,MIA,0,30,2,9,0.222,1,5,0.2,1,4,0.25,0,0,,1,4,5,0,1,0,0,1,5,2
Semaj Christon,24-092,G,2/1/17,OKC,CHI,0,13,2,5,0.4,1,3,0.333,1,2,0.5,0,0,,1,2,3,0,0,0,1,3,5,1.4
Gerald Green,30-351,G-F,1/11/17,BOS,WAS,0,14,2,6,0.333,1,2,0.5,1,4,0.25,0,1,0,1,2,3,1,1,0,0,0,5,4.2
Ian Mahinmi,30-103,C,2/16/17,WAS,IND,0,13,2,2,1,2,2,1,0,0,,1,4,0.25,0,4,4,0,0,0,0,3,5,3.2
Jason Smith,31-035,F-C,4/6/17,WAS,NYK,1,23,1,4,0.25,0,0,,1,4,0.25,2,2,1,1,5,6,1,1,1,3,4,5,2.6
Alan Anderson,34-097,G-F,1/21/17,LAC,DEN,0,11,1,6,0.167,0,2,0,1,4,0.25,2,2,1,0,0,0,0,0,0,0,0,5,1.2
Boris Diaw,34-316,F-C,2/26/17,UTA,WAS,0,13,2,4,0.5,2,4,0.5,0,0,,1,1,1,0,0,0,2,0,0,2,1,5,2
Jared Dudley,31-218,F-G,2/13/17,PHO,NOP,0,12,2,4,0.5,1,2,0.5,1,2,0.5,0,0,,0,0,0,0,0,0,1,3,5,0.8
E'Twaun Moore,27-294,G,12/18/16,NOP,SAS,1,24,2,5,0.4,1,4,0.25,1,1,1,0,0,,0,1,1,5,1,0,0,1,5,6.7
Mike Muscala,25-182,F-C,12/30/16,ATL,DET,0,18,2,5,0.4,1,2,0.5,1,3,0.333,0,0,,2,3,5,2,2,0,1,2,5,6.2
Langston Galloway,24-337,G,11/10/16,NOP,MIL,0,14,2,7,0.286,1,5,0.2,1,2,0.5,0,0,,0,5,5,1,0,0,0,0,5,3.1
E'Twaun Moore,27-330,G,1/23/17,NOP,CLE,0,24,2,8,0.25,2,5,0.4,0,3,0,1,2,0.5,1,3,4,1,1,1,0,2,5,3
Justin Hamilton,26-244,C,12/1/16,BRK,MIL,0,17,2,9,0.222,1,4,0.25,1,5,0.2,0,0,,1,1,2,2,2,0,1,1,5,2.5
Darren Collison,29-161,G,1/31/17,SAC,HOU,1,26,2,10,0.2,1,8,0.125,1,2,0.5,0,0,,1,1,2,4,1,0,0,1,5,3.2
Willie Reed,26-266,F-C,2/6/17,MIA,MIN,0,12,2,6,0.333,2,6,0.333,0,0,,1,1,1,4,2,6,0,0,1,1,0,5,4.7
Mike Dunleavy,36-097,F-G,12/21/16,CLE,MIL,0,13,2,4,0.5,1,2,0.5,1,2,0.5,0,0,,1,1,2,2,0,0,1,2,5,3.6
Bojan Bogdanovic,27-338,G-F,3/22/17,WAS,ATL,0,15,2,6,0.333,1,2,0.5,1,4,0.25,0,0,,0,2,2,0,0,0,2,1,5,-0.2
Jonas Jerebko,29-264,F,11/21/16,BOS,MIN,0,19,2,3,0.667,1,1,1,1,2,0.5,0,0,,0,3,3,0,1,0,0,2,5,4.8
James Michael McAdoo,23-302,F,11/1/16,GSW,POR,0,9,2,3,0.667,2,3,0.667,0,0,,1,2,0.5,0,1,1,0,0,0,0,0,5,3.6
Norman Powell,23-161,G,11/2/16,TOR,WAS,0,15,2,3,0.667,1,1,1,1,2,0.5,0,0,,0,3,3,4,1,0,1,1,5,7
Maurice Harkless,23-242,F-G,1/8/17,POR,DET,1,26,1,4,0.25,0,1,0,1,3,0.333,2,4,0.5,0,2,2,1,0,1,1,0,5,2.8
Channing Frye,33-330,C-F,4/12/17,CLE,TOR,1,7,2,4,0.5,1,2,0.5,1,2,0.5,0,0,,0,1,1,0,0,0,0,0,5,3.3
Jonas Jerebko,30-006,F,3/8/17,BOS,GSW,0,12,2,3,0.667,1,2,0.5,1,1,1,0,0,,1,4,5,1,1,0,0,0,5,7.3
Danny Green,29-171,G-F,12/10/16,SAS,BRK,1,23,2,4,0.5,2,3,0.667,0,1,0,1,2,0.5,0,3,3,2,1,1,0,1,5,6.2
Pat Connaughton,24-067,G,3/14/17,POR,NOP,0,12,2,4,0.5,1,3,0.333,1,1,1,0,0,,0,3,3,1,0,0,1,2,5,2.8
Jamal Crawford,36-314,G,1/28/17,LAC,GSW,0,30,2,7,0.286,1,4,0.25,1,3,0.333,0,0,,0,1,1,2,2,0,2,5,5,0.6
Dante Exum,21-104,G,10/25/16,UTA,POR,0,8,2,4,0.5,2,3,0.667,0,1,0,1,1,1,1,1,2,0,0,0,0,2,5,3.2
Luke Babbitt,27-284,F,3/31/17,MIA,NYK,1,16,2,6,0.333,1,1,1,1,5,0.2,0,0,,0,0,0,0,0,0,0,0,5,1.6
Salah Mejri,30-147,C,11/9/16,DAL,GSW,0,14,2,2,1,2,2,1,0,0,,1,1,1,0,5,5,0,0,0,0,2,5,5.1
Justin Holiday,27-243,G,12/4/16,NYK,SAC,1,23,2,7,0.286,1,3,0.333,1,4,0.25,0,0,,3,5,8,2,3,0,2,2,5,6.1
Jaylen Brown,20-060,F,12/23/16,BOS,OKC,0,13,2,5,0.4,2,5,0.4,0,0,,1,1,1,2,1,3,1,0,0,0,2,5,3.9
Luc Mbah a Moute,30-201,F,3/29/17,LAC,WAS,1,22,2,2,1,2,2,1,0,0,,1,3,0.333,0,1,1,0,1,0,0,2,5,4.1
Jared Dudley,31-117,F-G,11/4/16,PHO,NOP,1,20,2,4,0.5,1,1,1,1,3,0.333,0,0,,0,2,2,2,0,0,0,4,5,3.4
Brandon Ingram,19-116,F,12/27/16,LAL,UTA,0,31,2,5,0.4,2,5,0.4,0,0,,1,2,0.5,0,2,2,2,0,0,2,4,5,0.3
Austin Rivers,24-188,G,2/5/17,LAC,BOS,1,34,1,8,0.125,1,4,0.25,0,4,0,3,4,0.75,1,2,3,5,0,0,3,3,5,0
Wilson Chandler,29-212,F,12/8/16,DEN,WAS,0,32,2,16,0.125,1,8,0.125,1,8,0.125,0,0,,2,6,8,2,1,0,1,2,5,-1.6
Terry Rozier,22-354,G,3/6/17,BOS,LAC,0,20,2,7,0.286,1,3,0.333,1,4,0.25,0,0,,0,2,2,2,0,0,1,0,5,1.9
Alex Abrines,23-222,G-F,3/11/17,OKC,UTA,0,15,2,3,0.667,1,2,0.5,1,1,1,0,0,,0,0,0,1,0,0,0,1,5,4
Frank Kaminsky,23-247,F-C,12/7/16,CHO,DET,0,22,2,7,0.286,2,5,0.4,0,2,0,1,4,0.25,1,4,5,2,1,0,0,0,5,4
Stanley Johnson,20-315,F,4/9/17,DET,MEM,0,27,2,8,0.25,1,6,0.167,1,2,0.5,0,0,,0,4,4,3,1,0,1,0,5,3.5
Quinn Cook,24-008,G,3/31/17,NOP,SAC,0,3,2,2,1,1,1,1,1,1,1,0,0,,0,0,0,0,0,0,0,1,5,4
Raul Neto,24-229,G,1/3/17,UTA,BOS,0,14,2,4,0.5,1,2,0.5,1,2,0.5,0,0,,0,2,2,1,1,0,0,1,5,4.9
Justin Holiday,27-362,G,4/2/17,NYK,BOS,0,28,2,12,0.167,1,6,0.167,1,6,0.167,0,0,,0,1,1,1,1,0,0,2,5,-1.4
Roy Hibbert,29-353,C,11/28/16,CHO,MEM,0,17,2,4,0.5,2,4,0.5,0,0,,1,3,0.333,3,3,6,0,0,1,1,4,5,3.3
K.J. McDaniels,23-267,G-F,11/2/16,HOU,NYK,0,19,1,3,0.333,0,1,0,1,2,0.5,2,2,1,0,3,3,0,1,4,1,1,5,6.6
Lucas Nogueira,24-139,C,12/12/16,TOR,MIL,0,20,2,3,0.667,2,3,0.667,0,0,,1,2,0.5,3,2,5,1,1,1,1,1,5,7
Juan Hernangomez,21-129,F,2/4/17,DEN,SAS,0,22,2,7,0.286,1,4,0.25,1,3,0.333,0,0,,2,5,7,0,1,0,0,1,5,4.4
Kevon Looney,20-277,F-C,11/9/16,GSW,DAL,0,11,1,1,1,1,1,1,0,0,,3,5,0.6,0,0,0,1,0,1,0,1,5,4.9
David Nwaba,24-088,G,4/12/17,LAL,GSW,0,25,2,4,0.5,2,4,0.5,0,0,,1,2,0.5,0,3,3,2,0,0,1,2,5,3.1
Alex Len,23-259,C,3/2/17,PHO,CHO,1,16,2,3,0.667,2,3,0.667,0,0,,1,1,1,0,5,5,1,0,0,0,1,5,5.5
Shabazz Muhammad,24-089,F-G,2/10/17,MIN,NOP,0,22,2,8,0.25,2,5,0.4,0,3,0,1,2,0.5,1,1,2,0,0,0,0,0,5,0.8
Malik Beasley,19-363,G,11/23/16,DEN,UTA,0,12,1,5,0.2,1,3,0.333,0,2,0,3,4,0.75,0,1,1,1,1,0,0,2,5,2.7
Allen Crabbe,24-300,G-F,2/3/17,POR,DAL,0,23,1,4,0.25,0,3,0,1,1,1,2,2,1,0,0,0,0,1,0,0,5,5,1.6
Terry Rozier,22-244,G,11/16/16,BOS,DAL,0,22,2,4,0.5,1,3,0.333,1,1,1,0,0,,0,3,3,0,0,2,3,2,5,1.5
Solomon Hill,25-268,F,12/11/16,NOP,PHO,1,18,2,6,0.333,1,2,0.5,1,4,0.25,0,0,,0,2,2,2,1,0,1,4,5,2
Shabazz Muhammad,24-030,F-G,12/13/16,MIN,CHI,0,13,2,5,0.4,2,5,0.4,0,0,,1,2,0.5,1,1,2,0,0,0,0,0,5,2.9
Tony Allen,35-054,G-F,3/6/17,MEM,BRK,0,17,2,4,0.5,2,3,0.667,0,1,0,1,2,0.5,2,1,3,1,2,0,2,2,5,4.2
Isaiah Canaan,25-193,G,11/30/16,CHI,LAL,0,26,2,9,0.222,1,4,0.25,1,5,0.2,0,0,,1,0,1,1,1,0,1,0,5,0.9
Dragan Bender,18-362,F,11/13/16,PHO,GSW,0,14,2,2,1,1,1,1,1,1,1,0,0,,1,1,2,0,0,1,0,2,5,5.3
Marquese Chriss,19-123,F,11/2/16,PHO,POR,0,16,2,5,0.4,2,4,0.5,0,1,0,1,3,0.333,0,4,4,1,0,0,0,1,5,3
Sam Dekker,22-180,F,11/2/16,HOU,NYK,0,19,2,5,0.4,2,4,0.5,0,1,0,1,2,0.5,2,5,7,1,1,0,2,1,5,4.1
Alexis Ajinca,28-231,C,12/23/16,NOP,MIA,1,21,2,5,0.4,2,5,0.4,0,0,,1,2,0.5,2,2,4,0,1,0,0,0,5,4.9
Mike Dunleavy,36-142,F-G,2/4/17,ATL,ORL,0,16,2,6,0.333,1,2,0.5,1,4,0.25,0,0,,0,3,3,1,0,0,4,2,5,-1.6
Sam Dekker,22-185,F,11/7/16,HOU,WAS,0,14,2,3,0.667,1,1,1,1,2,0.5,0,0,,1,3,4,1,0,1,0,1,5,6.3
Tyler Ennis,22-230,G,4/11/17,LAL,NOP,0,29,2,5,0.4,2,2,1,0,3,0,1,2,0.5,0,1,1,3,2,0,3,3,5,2.1
Ersan Ilyasova,29-276,F,2/15/17,PHI,BOS,1,15,2,9,0.222,2,6,0.333,0,3,0,1,1,1,3,0,3,0,1,0,2,4,5,-1
Manu Ginobili,39-118,G,11/23/16,SAS,CHO,0,16,1,6,0.167,0,3,0,1,3,0.333,2,2,1,0,3,3,2,2,0,0,3,5,4.3
Richard Jefferson,36-169,F,12/7/16,CLE,NYK,0,18,2,5,0.4,1,3,0.333,1,2,0.5,0,0,,0,3,3,0,0,0,0,1,5,2.8
Amir Johnson,29-233,F,12/20/16,BOS,MEM,1,24,2,4,0.5,2,3,0.667,0,1,0,1,2,0.5,1,2,3,2,0,0,0,5,5,3.3
Dorian Finney-Smith,23-198,F,11/18/16,DAL,MEM,1,22,2,6,0.333,2,3,0.667,0,3,0,1,1,1,0,3,3,0,0,1,0,0,5,3.2
Al Jefferson,31-359,C-F,12/28/16,IND,WAS,0,14,2,3,0.667,2,3,0.667,0,0,,1,3,0.333,1,6,7,0,1,0,1,2,5,4.6
Willie Cauley-Stein,23-156,F-C,1/21/17,SAC,CHI,0,13,2,3,0.667,2,3,0.667,0,0,,1,2,0.5,2,2,4,0,1,0,0,0,5,6.3
Nik Stauskas,23-029,G,11/5/16,PHI,CLE,0,19,2,5,0.4,1,1,1,1,4,0.25,0,0,,0,2,2,1,0,0,0,0,5,3.6
Pat Connaughton,23-346,G,12/17/16,POR,GSW,0,18,2,2,1,2,2,1,0,0,,1,1,1,1,3,4,0,0,0,0,2,5,5.2
Leandro Barbosa,34-038,G,1/5/17,PHO,DAL,0,14,1,7,0.143,0,5,0,1,2,0.5,2,2,1,0,1,1,1,1,0,0,4,5,0.9
Luke Babbitt,27-186,F,12/23/16,MIA,NOP,0,13,2,4,0.5,1,3,0.333,1,1,1,0,0,,1,0,1,0,1,0,0,1,5,4.3
Anthony Bennett,23-240,F,11/9/16,BRK,NYK,0,4,2,3,0.667,1,1,1,1,2,0.5,0,0,,1,1,2,0,0,0,0,0,5,4.7
Glenn Robinson,23-050,G-F,2/27/17,IND,HOU,0,9,2,2,1,1,1,1,1,1,1,0,0,,0,1,1,1,1,0,0,3,5,5.2
Nikola Mirotic,25-299,F,12/6/16,CHI,DET,0,23,2,7,0.286,1,3,0.333,1,4,0.25,0,0,,0,6,6,0,2,1,0,2,5,4.6
Markieff Morris,27-203,F,3/24/17,WAS,BRK,1,20,2,5,0.4,1,4,0.25,1,1,1,0,0,,0,0,0,1,1,1,2,2,5,1.9
Draymond Green,26-240,F,10/30/16,GSW,PHO,1,38,2,9,0.222,2,5,0.4,0,4,0,1,2,0.5,1,12,13,9,0,3,2,3,5,8.6
Mike Dunleavy,36-064,F-G,11/18/16,CLE,DET,0,19,2,3,0.667,1,1,1,1,2,0.5,0,0,,0,5,5,0,0,1,2,1,5,3.5
Joe Ingles,29-150,F-G,3/1/17,UTA,MIN,1,26,2,8,0.25,1,3,0.333,1,5,0.2,0,0,,0,3,3,1,2,0,1,1,5,2.4
Jeff Green,30-138,F,1/13/17,ORL,POR,0,20,2,4,0.5,1,3,0.333,1,1,1,0,0,,0,5,5,2,0,0,1,1,5,4.5
Willie Reed,26-227,F-C,12/29/16,MIA,CHO,0,13,2,3,0.667,2,3,0.667,0,0,,1,1,1,1,6,7,0,0,3,0,2,5,7.5
Dorian Finney-Smith,23-196,F,11/16/16,DAL,BOS,1,16,2,5,0.4,1,3,0.333,1,2,0.5,0,0,,2,1,3,0,0,0,0,1,5,3.6
Randy Foye,33-153,G,2/24/17,BRK,DEN,1,19,2,4,0.5,1,1,1,1,3,0.333,0,0,,0,2,2,2,2,0,2,3,5,3.8
Luc Mbah a Moute,30-141,F,1/28/17,LAC,GSW,1,12,1,4,0.25,0,3,0,1,1,1,2,2,1,0,1,1,1,1,0,0,2,5,3.8
Shabazz Napier,25-244,G,3/15/17,POR,SAS,0,15,2,5,0.4,1,2,0.5,1,3,0.333,0,0,,0,5,5,2,0,0,0,1,5,4.8
Amir Johnson,29-276,F,2/1/17,BOS,TOR,1,15,2,2,1,1,1,1,1,1,1,0,0,,1,1,2,0,0,0,1,4,5,2.8
Sam Dekker,22-220,F,12/12/16,HOU,BRK,0,15,2,5,0.4,1,2,0.5,1,3,0.333,0,0,,0,3,3,0,0,1,0,0,5,3.9
Domantas Sabonis,20-215,F,12/4/16,OKC,NOP,1,25,2,5,0.4,1,4,0.25,1,1,1,0,0,,0,2,2,0,2,1,1,4,5,3
Arron Afflalo,31-014,G,10/29/16,SAC,MIN,1,30,2,6,0.333,1,2,0.5,1,4,0.25,0,0,,0,0,0,2,0,1,0,2,5,2.9
Iman Shumpert,26-152,G,11/25/16,CLE,DAL,0,11,1,3,0.333,0,0,,1,3,0.333,2,2,1,0,3,3,2,0,1,1,1,5,4.9
Anthony Morrow,31-197,G,4/12/17,CHI,BRK,0,4,2,3,0.667,1,2,0.5,1,1,1,0,0,,0,0,0,0,0,0,0,0,5,3.7
Roy Hibbert,30-043,C,1/23/17,CHO,WAS,0,12,2,2,1,2,2,1,0,0,,1,1,1,1,1,2,0,0,0,1,2,5,3.6
Tim Frazier,25-363,G,10/29/16,NOP,SAS,1,25,2,8,0.25,1,6,0.167,1,2,0.5,0,0,,0,4,4,7,0,0,2,3,5,3.1
Juan Hernangomez,21-163,F,3/10/17,DEN,BOS,0,13,1,1,1,0,0,,1,1,1,2,2,1,0,3,3,0,1,0,1,2,5,4.8
Al Jefferson,31-304,C-F,11/3/16,IND,MIL,0,19,1,8,0.125,1,7,0.143,0,1,0,3,4,0.75,3,4,7,0,0,1,0,2,5,2.6
Nene Hilario,34-127,F-C,1/18/17,HOU,MIL,0,10,2,3,0.667,2,3,0.667,0,0,,1,2,0.5,0,0,0,2,2,0,0,1,5,6.3
Ed Davis,27-183,F,12/5/16,POR,CHI,1,30,2,3,0.667,2,3,0.667,0,0,,1,2,0.5,2,5,7,0,1,1,0,5,5,5.9
Jameer Nelson,35-032,G,3/13/17,DEN,LAL,1,29,2,5,0.4,1,1,1,1,4,0.25,0,0,,0,4,4,6,1,1,1,2,5,7.6
Dorian Finney-Smith,23-188,F,11/8/16,DAL,LAL,1,20,2,2,1,1,1,1,1,1,1,0,0,,0,3,3,1,0,0,0,1,5,5.6
Rakeem Christmas,25-059,F,1/29/17,IND,HOU,0,3,1,1,1,1,1,1,0,0,,3,4,0.75,1,1,2,0,0,1,0,0,5,6
Jonas Jerebko,29-275,F,12/2/16,BOS,SAC,0,17,2,5,0.4,1,4,0.25,1,1,1,0,0,,1,8,9,1,0,0,2,1,5,3.7
Danny Green,29-270,G-F,3/19/17,SAS,SAC,1,20,2,5,0.4,1,3,0.333,1,2,0.5,0,0,,2,3,5,3,0,0,1,3,5,4.5
Terry Rozier,22-321,G,2/1/17,BOS,TOR,0,23,2,7,0.286,1,5,0.2,1,2,0.5,0,0,,2,5,7,1,0,0,0,0,5,4.5
Jerami Grant,23-004,F,3/16/17,OKC,TOR,0,7,2,2,1,1,1,1,1,1,1,0,0,,0,0,0,0,0,0,2,1,5,2
Thon Maker,19-302,F-C,12/23/16,MIL,WAS,0,8,2,2,1,1,1,1,1,1,1,0,0,,0,2,2,0,0,0,1,2,5,3.2
Bobby Portis,22-031,F,3/13/17,CHI,CHO,1,20,2,7,0.286,1,4,0.25,1,3,0.333,0,0,,0,7,7,1,0,0,0,1,5,3.3
Thabo Sefolosha,32-305,G-F,3/3/17,ATL,CLE,1,31,2,7,0.286,1,5,0.2,1,2,0.5,0,2,0,2,3,5,6,0,0,1,0,5,5.6
David Lee,33-263,F,1/17/17,SAS,MIN,0,15,1,4,0.25,1,4,0.25,0,0,,3,4,0.75,1,3,4,4,0,0,0,2,5,5.8
Matt Barnes,36-342,F,2/14/17,SAC,LAL,0,27,2,7,0.286,1,2,0.5,1,5,0.2,0,0,,2,4,6,3,1,1,2,2,5,4.5
DeMarre Carroll,30-158,F,1/1/17,TOR,LAL,1,17,1,2,0.5,0,0,,1,2,0.5,2,2,1,0,0,0,0,0,1,2,4,5,1.1
Tyus Jones,20-200,G,11/26/16,MIN,GSW,0,13,2,2,1,1,1,1,1,1,1,0,0,,0,2,2,2,0,0,1,0,5,5.4
Kris Humphries,32-046,F-C,3/24/17,ATL,MIL,0,12,2,7,0.286,1,5,0.2,1,2,0.5,0,0,,1,2,3,0,0,0,0,2,5,1.4
Reggie Bullock,25-248,G-F,11/19/16,DET,BOS,0,20,2,5,0.4,1,3,0.333,1,2,0.5,0,0,,1,2,3,1,1,2,0,0,5,6.7
Dragan Bender,19-052,F,1/8/17,PHO,CLE,0,12,2,5,0.4,1,2,0.5,1,3,0.333,0,0,,3,0,3,1,1,1,1,1,5,5.4
Jared Dudley,31-113,F-G,10/31/16,PHO,LAC,1,19,2,6,0.333,1,3,0.333,1,3,0.333,0,0,,1,4,5,1,2,0,2,5,5,2.2
Luc Mbah a Moute,30-159,F,2/15/17,LAC,ATL,1,15,2,3,0.667,1,1,1,1,2,0.5,0,0,,0,1,1,1,0,0,0,0,5,4.7
Nikola Mirotic,25-306,F,12/13/16,CHI,MIN,0,20,1,5,0.2,1,1,1,0,4,0,3,4,0.75,1,4,5,0,0,0,0,0,5,3.4
Tarik Black,25-103,C-F,3/5/17,LAL,NOP,1,17,2,8,0.25,2,8,0.25,0,0,,1,1,1,5,1,6,0,0,0,2,4,5,0.4
Jerian Grant,24-108,G,1/25/17,CHI,ATL,1,19,2,6,0.333,1,2,0.5,1,4,0.25,0,0,,0,2,2,3,0,0,0,2,5,3.5
Al-Farouq Aminu,26-078,F,12/8/16,POR,MEM,0,24,2,9,0.222,2,3,0.667,0,6,0,1,2,0.5,1,10,11,2,2,0,3,1,5,2.8
Kay Felder,21-241,G,11/25/16,CLE,DAL,0,14,2,4,0.5,2,4,0.5,0,0,,1,2,0.5,0,1,1,4,0,1,2,1,5,4
Iman Shumpert,26-135,G,11/8/16,CLE,ATL,0,22,2,4,0.5,1,2,0.5,1,2,0.5,0,0,,2,3,5,4,2,0,2,2,5,7.3
Justin Holiday,27-272,G,1/2/17,NYK,ORL,0,14,2,3,0.667,1,1,1,1,2,0.5,0,0,,0,4,4,0,0,0,2,1,5,2.5
Darrun Hilliard,23-242,G,12/11/16,DET,PHI,1,20,2,7,0.286,2,5,0.4,0,2,0,1,1,1,0,1,1,0,0,0,3,0,5,-1.8
Timofey Mozgov,30-134,C,11/27/16,LAL,ATL,1,20,2,5,0.4,2,5,0.4,0,0,,1,2,0.5,2,3,5,2,0,0,0,1,5,5.2
Ed Davis,27-243,F,2/3/17,POR,DAL,0,16,2,2,1,2,2,1,0,0,,1,2,0.5,1,1,2,0,0,0,0,2,5,4.2
Randy Foye,33-070,G,12/3/16,BRK,MIL,0,20,2,5,0.4,1,1,1,1,4,0.25,0,0,,0,2,2,2,0,0,1,3,5,2.1
Rodney Hood,24-010,G-F,10/30/16,UTA,LAC,1,28,2,10,0.2,1,8,0.125,1,2,0.5,0,1,0,0,3,3,0,0,0,2,3,5,-3.9
Sergio Rodriguez,30-267,G,3/6/17,PHI,MIL,0,24,2,7,0.286,1,3,0.333,1,4,0.25,0,0,,0,3,3,8,0,0,0,3,5,6.2
Courtney Lee,31-162,G,3/14/17,NYK,IND,1,29,2,9,0.222,1,4,0.25,1,5,0.2,0,0,,0,7,7,3,1,0,2,1,5,2.3
Austin Rivers,24-125,G,12/4/16,LAC,IND,0,15,2,4,0.5,2,3,0.667,0,1,0,1,2,0.5,1,2,3,0,0,0,1,0,5,2.9
Tyson Chandler,34-125,C,2/4/17,PHO,MIL,1,25,1,1,1,1,1,1,0,0,,3,4,0.75,3,11,14,3,0,0,2,3,5,8.6
Patrick McCaw,21-022,G,11/16/16,GSW,TOR,0,21,2,3,0.667,1,1,1,1,2,0.5,0,0,,0,2,2,2,1,1,0,3,5,6.2
Yogi Ferrell,23-282,G,2/15/17,DAL,DET,0,20,2,8,0.25,1,5,0.2,1,3,0.333,0,0,,1,4,5,3,2,0,1,2,5,4.4
Meyers Leonard,24-365,C-F,2/26/17,POR,TOR,0,21,1,5,0.2,1,3,0.333,0,2,0,3,4,0.75,0,5,5,2,1,1,0,3,5,4.9
C.J. Miles,29-301,G-F,2/13/17,IND,SAS,0,22,2,7,0.286,1,2,0.5,1,5,0.2,0,0,,1,3,4,0,1,0,2,4,5,-0.1
Marco Belinelli,30-338,G-F,2/26/17,CHO,LAC,0,14,2,4,0.5,1,1,1,1,3,0.333,0,0,,0,2,2,0,0,0,1,2,5,1.8
Stanley Johnson,20-302,F,3/27/17,DET,NYK,0,18,2,7,0.286,1,3,0.333,1,4,0.25,0,0,,0,0,0,0,0,1,1,0,5,0.6
Courtney Lee,31-120,G,1/31/17,NYK,WAS,1,27,2,10,0.2,1,5,0.2,1,5,0.2,0,0,,2,3,5,1,0,0,1,0,5,0.8
Ricky Rubio,26-008,G,10/29/16,MIN,SAC,1,28,2,4,0.5,2,3,0.667,0,1,0,1,1,1,0,1,1,5,3,0,1,3,5,7.6
Pat Connaughton,24-019,G,1/25/17,POR,LAL,0,15,2,4,0.5,1,3,0.333,1,1,1,0,0,,0,1,1,0,1,1,0,0,5,5
Brandon Rush,31-235,G-F,2/27/17,MIN,SAC,1,19,2,5,0.4,1,3,0.333,1,2,0.5,0,0,,0,2,2,0,0,1,1,1,5,2.2
Randy Foye,33-087,G,12/20/16,BRK,TOR,0,7,1,1,1,0,0,,1,1,1,2,2,1,0,1,1,1,1,0,0,0,5,6.7
Buddy Hield,23-041,G,1/27/17,NOP,SAS,1,13,2,7,0.286,1,4,0.25,1,3,0.333,0,0,,1,1,2,2,0,0,1,2,5,1.5
Andrew Harrison,22-084,G,1/20/17,MEM,SAC,0,14,1,4,0.25,0,2,0,1,2,0.5,2,2,1,1,2,3,1,1,0,1,2,5,3.8
Kelly Olynyk,25-281,C-F,1/25/17,BOS,HOU,0,17,2,4,0.5,2,3,0.667,0,1,0,1,2,0.5,2,2,4,2,0,0,3,3,5,1.8
Kelly Olynyk,25-234,C-F,12/9/16,BOS,TOR,0,23,2,6,0.333,2,4,0.5,0,2,0,1,2,0.5,1,8,9,3,3,1,2,1,5,7.7
Joakim Noah,31-286,C,12/7/16,NYK,CLE,1,15,2,3,0.667,2,3,0.667,0,0,,1,2,0.5,2,4,6,2,0,0,1,1,5,5.9
Nikola Mirotic,25-365,F,2/10/17,CHI,PHO,0,14,2,6,0.333,1,2,0.5,1,4,0.25,0,0,,0,4,4,2,1,1,1,1,5,4.5
Mike Scott,28-160,F,12/23/16,ATL,DEN,0,12,1,4,0.25,1,1,1,0,3,0,3,4,0.75,1,3,4,3,1,0,0,1,5,6.5
Tyus Jones,20-274,G,2/8/17,MIN,TOR,0,27,2,6,0.333,1,2,0.5,1,4,0.25,0,0,,0,0,0,3,1,0,0,3,5,3.5
Bismack Biyombo,24-122,C-F,12/28/16,ORL,CHO,1,22,2,3,0.667,2,3,0.667,0,0,,1,1,1,0,4,4,0,0,1,2,2,5,2.8
Tyler Johnson,24-294,G,2/25/17,MIA,IND,0,31,0,5,0,0,2,0,0,3,0,5,6,0.833,0,1,1,4,0,1,0,1,5,4.5
Alan Anderson,34-076,G-F,12/31/16,LAC,OKC,0,18,2,7,0.286,1,2,0.5,1,5,0.2,0,0,,0,3,3,0,1,0,1,1,5,1.4
Bryn Forbes,23-105,G,11/5/16,SAS,LAC,0,14,2,4,0.5,2,2,1,0,2,0,1,1,1,0,1,1,1,0,0,0,1,5,3.6
Matt Barnes,36-338,F,2/10/17,SAC,ATL,0,25,2,5,0.4,1,2,0.5,1,3,0.333,0,0,,1,3,4,5,2,1,1,4,5,7.5
Draymond Green,26-331,F,1/29/17,GSW,POR,1,34,2,8,0.25,1,2,0.5,1,6,0.167,0,0,,1,5,6,5,3,1,7,5,5,0.6
Glenn Robinson,22-337,G-F,12/10/16,IND,POR,0,14,2,2,1,1,1,1,1,1,1,0,0,,0,1,1,0,0,0,1,1,5,3.3
Leandro Barbosa,33-359,G,11/21/16,PHO,WAS,0,14,2,4,0.5,1,2,0.5,1,2,0.5,0,0,,0,1,1,2,0,0,1,1,5,3.3
C.J. Miles,29-241,G-F,12/15/16,IND,NOP,0,30,1,9,0.111,0,3,0,1,6,0.167,2,2,1,0,5,5,1,1,0,0,2,5,1.5
Courtney Lee,31-044,G,11/16/16,NYK,DET,1,29,2,12,0.167,1,9,0.111,1,3,0.333,0,0,,2,2,4,3,3,0,0,1,5,4.1
Draymond Green,26-286,F,12/15/16,GSW,NYK,1,32,2,12,0.167,1,7,0.143,1,5,0.2,0,0,,5,6,11,7,0,2,3,3,5,4.8
Justin Anderson,23-002,G,11/21/16,DAL,SAS,0,15,2,7,0.286,2,4,0.5,0,3,0,1,2,0.5,2,2,4,0,1,1,4,0,5,0.2
Pat Connaughton,24-034,G,2/9/17,POR,BOS,0,15,2,3,0.667,1,1,1,1,2,0.5,0,0,,1,0,1,2,0,0,0,0,5,5.8
JaVale McGee,29-045,C,3/5/17,GSW,NYK,0,8,2,3,0.667,2,3,0.667,0,0,,1,2,0.5,1,3,4,0,0,0,0,0,5,4.9
Tony Snell,25-067,G-F,1/16/17,MIL,PHI,1,29,2,2,1,1,1,1,1,1,1,0,0,,0,4,4,1,0,0,0,2,5,5.5
Joe Ingles,29-100,F-G,1/10/17,UTA,CLE,0,27,2,5,0.4,1,1,1,1,4,0.25,0,0,,0,2,2,5,1,0,2,1,5,5
Tyson Chandler,34-045,C,11/16/16,PHO,DEN,1,21,2,2,1,2,2,1,0,0,,1,2,0.5,0,5,5,0,0,2,0,3,5,5.7
Tyler Ennis,22-209,G,3/21/17,LAL,LAC,0,8,1,5,0.2,1,3,0.333,0,2,0,3,3,1,0,1,1,2,1,0,0,0,5,4.6
Ben McLemore,23-321,G,12/28/16,SAC,POR,1,19,2,9,0.222,2,7,0.286,0,2,0,1,1,1,0,0,0,0,2,0,1,1,5,0.1
Rondae Hollis-Jefferson,22-010,F,1/13/17,BRK,TOR,0,16,2,3,0.667,2,3,0.667,0,0,,1,2,0.5,0,1,1,3,1,0,1,1,5,5.3
Dante Cunningham,29-288,F,2/4/17,NOP,WAS,0,19,2,3,0.667,2,3,0.667,0,0,,1,1,1,1,2,3,0,1,0,0,1,5,5.6
Josh McRoberts,29-296,F,12/20/16,MIA,ORL,1,16,2,4,0.5,2,4,0.5,0,0,,1,2,0.5,1,0,1,0,0,0,1,2,5,1.5
Ronnie Price,33-294,G,4/11/17,PHO,SAC,0,19,2,7,0.286,1,3,0.333,1,4,0.25,0,0,,0,0,0,3,1,0,1,1,5,2.6
Derrick Favors,25-107,F-C,10/30/16,UTA,LAC,0,23,1,8,0.125,1,8,0.125,0,0,,3,4,0.75,1,10,11,0,1,0,0,2,5,3.3
Doug McDermott,24-298,F,10/27/16,CHI,BOS,0,22,2,5,0.4,2,4,0.5,0,1,0,1,2,0.5,0,1,1,1,0,0,1,2,5,1.1
James Ennis,26-227,F,2/13/17,MEM,BRK,1,28,2,2,1,1,1,1,1,1,1,0,0,,0,3,3,0,0,0,3,3,5,1.1
Terry Rozier,22-234,G,11/6/16,BOS,DEN,0,16,2,6,0.333,1,3,0.333,1,3,0.333,0,0,,0,2,2,1,0,0,0,0,5,2.9
Al-Farouq Aminu,26-201,F,4/10/17,POR,SAS,0,25,1,6,0.167,0,2,0,1,4,0.25,2,2,1,0,4,4,1,1,2,0,2,5,4.7
Brandon Rush,31-220,G-F,2/12/17,MIN,CHI,1,29,1,5,0.2,1,1,1,0,4,0,3,4,0.75,1,1,2,1,1,1,1,2,5,3.1
Aaron Gordon,21-064,F,11/19/16,ORL,DAL,0,25,2,5,0.4,1,3,0.333,1,2,0.5,0,0,,1,3,4,1,0,0,2,4,5,1
Luke Babbitt,27-156,F,11/23/16,MIA,DET,0,18,2,5,0.4,1,3,0.333,1,2,0.5,0,0,,1,1,2,0,0,0,2,4,5,-0.3
Marquese Chriss,19-196,F,1/14/17,PHO,SAS,1,15,2,6,0.333,1,2,0.5,1,4,0.25,0,0,,2,3,5,1,2,0,1,4,5,4
Salah Mejri,30-298,C,4/9/17,DAL,PHO,0,9,2,2,1,2,2,1,0,0,,1,2,0.5,2,1,3,0,0,0,0,1,5,5.3
Kelly Olynyk,25-252,C-F,12/27/16,BOS,MEM,0,18,2,4,0.5,1,1,1,1,3,0.333,0,0,,1,6,7,3,0,1,1,5,5,5.3
Jakob Poeltl,21-120,C,2/12/17,TOR,DET,1,20,2,3,0.667,2,3,0.667,0,0,,1,2,0.5,2,2,4,0,1,0,0,2,5,5.5
Kris Humphries,31-268,F-C,10/31/16,ATL,SAC,0,13,1,1,1,0,0,,1,1,1,2,2,1,0,1,1,2,0,0,1,1,5,5
Tony Snell,25-131,G-F,3/21/17,MIL,POR,1,36,2,5,0.4,1,2,0.5,1,3,0.333,0,0,,0,5,5,2,0,0,2,1,5,2.8
Brandon Knight,25-041,G,1/12/17,PHO,DAL,0,19,2,9,0.222,2,8,0.25,0,1,0,1,1,1,0,1,1,1,0,0,1,1,5,-0.9
Richard Jefferson,36-276,F,3/24/17,CLE,CHO,0,16,2,2,1,1,1,1,1,1,1,0,0,,0,4,4,0,0,0,0,1,5,5.2
Vince Carter,39-283,G-F,11/4/16,MEM,LAC,0,23,2,7,0.286,1,4,0.25,1,3,0.333,0,0,,1,6,7,3,0,1,0,2,5,5.4
Jeff Green,30-122,F,12/28/16,ORL,CHO,0,15,1,4,0.25,1,1,1,0,3,0,3,3,1,0,0,0,1,0,0,0,0,5,3.3
Malik Beasley,20-006,G,12/2/16,DEN,HOU,0,4,2,3,0.667,1,1,1,1,2,0.5,0,0,,0,0,0,0,1,0,0,0,5,4.7
Courtney Lee,31-050,G,11/22/16,NYK,POR,1,27,2,8,0.25,2,4,0.5,0,4,0,1,1,1,1,3,4,3,1,1,1,1,5,4.2
Larry Nance Jr.,24-077,F,3/19/17,LAL,CLE,0,14,2,5,0.4,1,4,0.25,1,1,1,0,0,,1,1,2,0,0,0,0,3,5,2.1
Brandon Jennings,27-044,G,11/6/16,NYK,UTA,0,16,2,4,0.5,1,2,0.5,1,2,0.5,0,0,,0,1,1,2,2,0,1,2,5,4.9
Arron Afflalo,31-097,G,1/20/17,SAC,MEM,1,25,2,5,0.4,2,2,1,0,3,0,1,1,1,0,2,2,0,2,0,1,0,5,3.9
Amir Johnson,29-304,F,3/1/17,BOS,CLE,1,11,2,3,0.667,1,1,1,1,2,0.5,0,0,,2,0,2,0,0,0,0,2,5,4.3
D.J. Augustin,29-121,G,3/11/17,ORL,CLE,0,12,2,6,0.333,2,3,0.667,0,3,0,1,1,1,0,1,1,2,0,0,0,1,5,2.9
Arron Afflalo,31-114,G,2/6/17,SAC,CHI,1,17,2,5,0.4,1,2,0.5,1,3,0.333,0,0,,0,1,1,0,0,0,0,4,5,1
Mike Dunleavy,36-071,F-G,11/25/16,CLE,DAL,0,14,1,3,0.333,0,0,,1,3,0.333,2,2,1,0,0,0,1,0,0,0,0,5,4
Sam Dekker,22-318,F,3/20/17,HOU,DEN,0,5,2,3,0.667,2,3,0.667,0,0,,1,2,0.5,0,0,0,0,2,0,0,0,5,5.3
Gerald Henderson,29-042,G,1/20/17,PHI,POR,0,26,2,10,0.2,1,7,0.143,1,3,0.333,0,0,,2,5,7,1,0,0,0,1,5,2
Matt Barnes,37-007,F,3/16/17,GSW,ORL,0,20,2,7,0.286,1,4,0.25,1,3,0.333,0,0,,3,2,5,3,0,1,1,2,5,4.6
Aaron Brooks,31-333,G,12/12/16,IND,CHO,0,13,2,5,0.4,1,1,1,1,4,0.25,0,0,,1,2,3,1,0,0,0,2,5,3.5