GS,MP,FG,FGA,2P,2PA,3P,3PA,FT,FTA,ORB,DRB,TRB,AST,STL,BLK,TOV,PF,PTS,GmSc
1,45,21,40,17,29,4,11,24,26,2,6,8,6,3,1,5,3,70,54.5
1,29,21,33,13,19,8,14,10,11,0,2,2,1,0,0,0,0,60,46.2
1,42,18,34,9,20,9,14,14,16,0,6,6,5,1,1,0,0,59,48.6
1,36,21,39,18,30,3,9,13,16,1,2,3,9,3,1,4,4,58,43.6
1,42,21,40,15,25,6,15,9,11,3,10,13,11,3,0,7,3,57,44.2
1,41,17,28,12,20,5,8,16,17,1,12,13,1,1,3,5,5,55,42.9
1,42,14,26,5,10,9,16,16,18,3,13,16,17,0,0,8,2,53,48.7
1,38,15,24,14,20,1,4,21,22,3,9,12,6,3,1,2,0,52,51.5
1,37,15,26,6,13,9,13,13,13,1,1,2,0,1,0,2,2,52,39
1,42,18,31,13,23,5,8,11,14,1,3,4,8,3,0,4,3,52,41.3
1,39,16,28,10,17,6,11,13,14,1,12,13,13,2,1,5,4,51,46.9
1,45,17,44,15,34,2,10,15,20,3,10,13,10,2,0,5,3,51,32.9
1,37,17,32,12,20,5,12,11,11,2,14,16,10,1,0,2,1,50,45.6
1,41,17,34,17,32,0,2,16,17,1,14,15,5,5,4,3,4,50,44.2
1,36,14,21,5,9,9,12,12,12,0,1,1,5,0,1,3,1,49,41
1,38,16,34,8,19,8,15,9,11,1,7,8,5,2,0,5,2,49,33.3
1,42,15,28,7,14,8,14,11,11,0,2,2,4,2,1,0,4,49,39.9
1,38,14,30,11,18,3,12,17,18,1,16,17,9,3,0,4,4,48,41.4
1,42,15,22,15,19,0,3,17,20,3,15,18,2,1,3,4,2,47,42.7
1,37,14,26,11,16,3,10,16,18,1,10,11,8,1,0,11,5,47,30.9
1,41,14,21,12,16,2,5,17,22,1,3,4,3,0,1,2,2,47,37.5
1,32,11,16,7,10,4,6,20,22,4,11,15,5,1,1,8,6,46,39.3
1,45,18,31,14,26,4,5,6,8,4,17,21,3,0,1,0,1,46,41
1,36,16,26,3,9,13,17,1,2,3,2,5,5,2,0,4,2,46,37.2
1,38,15,21,9,11,6,10,10,10,0,2,2,3,0,0,3,2,46,36.2
1,35,16,33,13,23,3,10,11,13,2,9,11,7,1,0,4,2,46,33.7
1,37,12,36,6,20,6,16,15,15,2,5,7,4,1,1,4,0,45,28
1,46,18,36,15,27,3,9,6,7,0,6,6,4,0,1,3,6,45,26.5
1,40,17,31,16,29,1,2,10,14,6,11,17,3,2,2,1,2,45,39.7
1,38,14,25,6,12,8,13,9,12,0,9,9,10,4,0,7,4,45,37
1,35,16,29,12,21,4,8,9,11,1,7,8,3,2,0,4,2,45,32.4
1,39,17,27,15,23,2,4,9,10,1,9,10,3,2,1,4,1,45,36.3
1,45,16,30,8,18,8,12,5,6,0,2,2,9,1,0,3,3,45,33.7
1,35,13,25,8,18,5,7,14,16,1,10,11,11,1,0,4,1,45,39.9
1,42,17,24,12,14,5,10,5,9,1,8,9,10,3,1,5,3,44,40
1,38,12,22,7,10,5,12,15,16,0,4,4,7,0,0,3,3,44,34.9
1,38,10,16,3,6,7,10,17,17,0,3,3,6,2,1,1,1,44,43.2
1,36,14,21,9,13,5,8,10,10,0,2,2,9,4,1,3,0,43,42.5
1,29,15,23,6,8,9,15,4,4,0,9,9,6,0,0,2,1,43,37.4
1,39,13,28,7,19,6,9,11,12,0,11,11,10,0,0,8,1,43,30.1
1,37,15,28,14,25,1,3,12,12,0,5,5,5,0,0,3,2,43,30.6
1,42,15,26,12,22,3,4,10,16,4,6,10,5,2,0,1,4,43,35.9
1,48,16,33,10,17,6,16,5,7,0,9,9,9,3,1,3,5,43,33.2
1,39,16,25,13,19,3,6,8,9,1,4,5,3,3,1,3,3,43,35
1,35,15,25,7,13,8,12,4,7,0,4,4,11,2,2,3,0,42,38.6
1,44,13,33,8,20,5,13,11,14,1,11,12,9,1,1,2,4,42,31.3
1,36,16,22,14,19,2,3,8,11,2,11,13,2,1,1,2,3,42,36.4
1,38,14,25,9,15,5,10,9,10,0,7,7,2,1,2,2,1,42,33.2
1,36,15,22,6,8,9,14,3,3,0,1,1,8,1,0,1,3,42,37.3
1,40,14,22,9,12,5,10,9,11,1,3,4,1,0,0,1,2,42,31.9
1,34,12,26,10,19,2,7,16,18,1,9,10,7,1,0,4,2,42,32.3
1,43,17,38,16,33,1,5,7,11,4,3,7,8,2,1,2,1,42,30.2
1,35,16,28,14,21,2,7,8,9,2,12,14,3,1,2,2,4,42,34.3
1,44,10,25,6,17,4,8,18,20,4,6,10,5,2,0,4,1,42,33.4
1,37,12,18,7,12,5,6,13,14,0,4,4,4,0,0,1,4,42,35.2
1,35,16,34,15,28,1,6,9,11,1,3,4,8,0,0,4,3,42,25.8
1,43,15,28,14,24,1,4,10,12,2,14,16,5,0,1,6,4,41,28.8
1,39,16,30,15,27,1,3,8,10,1,0,1,2,2,0,2,2,41,26.9
1,38,14,21,14,18,0,3,13,18,2,10,12,16,0,0,2,2,41,42.7
1,38,13,23,7,13,6,10,9,11,0,3,3,3,1,0,1,2,41,31.5
1,41,16,29,12,21,4,8,5,6,1,2,3,2,1,0,0,1,41,30
1,39,16,23,15,20,1,3,8,11,2,5,7,8,3,0,6,5,41,33.6
1,37,11,23,7,12,4,11,15,15,0,0,0,8,2,0,3,4,41,32.3
1,45,16,28,10,14,6,14,3,3,0,5,5,8,0,0,0,1,41,34.5
1,37,14,29,12,21,2,8,11,12,2,9,11,11,1,0,9,2,41,28.9
1,40,13,22,11,18,2,4,13,15,0,4,4,8,0,0,6,3,41,29.6
1,40,12,21,8,11,4,10,13,14,2,12,14,11,2,0,5,2,41,39.6
1,44,14,28,10,17,4,11,9,11,1,2,3,6,0,0,6,1,41,25.3
1,41,14,27,13,23,1,4,12,14,6,10,16,3,4,2,1,4,41,39
1,52,16,29,13,19,3,10,6,12,4,10,14,11,2,1,1,4,41,38.3
1,37,14,27,9,18,5,9,8,9,4,12,16,2,2,2,2,5,41,34.5
1,46,15,30,12,22,3,8,8,8,0,6,6,5,1,1,6,3,41,25.8
1,42,11,20,10,14,1,6,18,21,1,7,8,6,2,3,5,3,41,35.1
1,41,18,31,16,26,2,5,3,3,2,3,5,0,1,4,0,3,41,31.4
1,33,13,24,6,10,7,14,8,9,0,2,2,3,2,1,1,2,41,32.6
1,39,12,16,6,9,6,7,11,11,1,8,9,7,0,0,4,3,41,37.4
1,38,13,26,11,21,2,5,13,14,1,1,2,1,0,0,2,2,41,26.5
1,38,16,29,15,27,1,2,8,9,2,11,13,0,2,0,1,1,41,32
1,45,12,27,9,19,3,8,14,15,2,4,6,7,2,0,3,3,41,31.8
1,39,10,23,5,11,5,12,16,21,2,6,8,8,4,0,4,3,41,34.5
1,38,13,20,8,11,5,9,10,14,1,6,7,15,1,0,1,3,41,42.4
1,38,11,24,4,10,7,14,11,14,1,14,15,10,0,0,4,3,40,33.1
1,38,13,22,9,14,4,8,10,11,0,3,3,10,0,0,5,2,40,31.5
1,34,17,27,17,25,0,2,6,6,1,3,4,1,1,0,6,1,40,24.8
1,42,15,25,13,17,2,8,8,10,0,4,4,2,1,0,1,3,40,29.1
1,38,15,26,13,22,2,4,8,11,1,3,4,2,2,0,1,2,40,29.8
0,32,11,20,7,12,4,8,14,14,0,2,2,1,2,0,2,0,40,31.7
1,36,14,25,14,23,0,2,12,13,1,5,6,3,1,0,1,0,40,32
1,38,14,29,13,27,1,2,11,11,6,4,10,4,4,0,3,2,40,33.7
1,35,12,19,5,7,7,12,9,11,1,9,10,7,0,0,1,2,40,37.2
1,38,11,26,8,22,3,4,15,20,2,7,9,4,1,0,3,1,40,28.1
1,40,13,22,9,14,4,8,10,10,2,2,4,3,3,0,1,0,40,35.9
1,29,14,22,13,21,1,1,11,12,4,14,18,2,0,3,0,2,40,39.5
1,32,12,20,4,8,8,12,8,8,4,4,8,3,1,1,1,2,40,36.8
1,34,13,16,8,9,5,7,9,10,2,10,12,4,0,3,2,2,40,40.1
1,29,9,17,1,2,8,15,14,16,1,5,6,8,0,0,8,2,40,29.9
1,37,17,23,15,20,2,3,4,5,4,5,9,5,2,0,2,2,40,37.3
1,40,14,23,14,22,0,1,12,14,4,3,7,6,1,0,1,1,40,36.2
1,38,13,26,9,17,4,9,10,10,3,7,10,11,2,2,10,3,40,31.1
1,42,15,27,10,14,5,13,5,5,0,3,3,6,1,1,4,2,40,29.1
1,39,12,30,8,15,4,15,12,13,1,11,12,10,2,0,6,3,40,29.2
1,36,14,31,7,16,7,15,5,5,1,12,13,10,2,0,8,1,40,28.8
1,41,14,22,7,10,7,12,5,7,0,2,2,6,2,0,1,2,40,34.4
1,37,11,23,8,15,3,8,15,17,0,10,10,10,2,0,8,3,40,30.3
1,38,13,21,8,14,5,7,9,9,0,7,7,11,0,0,2,4,40,36.7
1,39,13,21,6,9,7,12,7,7,0,6,6,2,1,0,2,5,40,30.7
1,41,17,22,16,20,1,2,5,8,3,18,21,4,1,1,3,3,40,38
1,37,14,23,13,21,1,2,11,16,1,4,5,5,2,0,1,3,40,32.7
1,36,13,24,11,17,2,7,12,19,2,10,12,8,2,1,6,2,40,31.5
1,42,11,17,7,10,4,7,14,14,0,6,6,13,0,0,4,3,40,38.2
1,31,15,24,8,13,7,11,2,3,1,6,7,1,0,1,2,3,39,28.5
1,30,14,20,3,5,11,15,0,0,1,4,5,8,3,0,1,2,39,39.3
1,39,14,26,11,23,3,3,8,10,3,3,6,5,1,1,1,0,39,32.8
1,39,13,24,10,15,3,9,10,16,0,11,11,13,0,0,5,4,39,30.8
1,35,13,20,9,14,4,6,9,9,1,8,9,6,0,0,4,3,39,32.3
1,33,12,19,12,18,0,1,15,17,1,7,8,6,2,1,1,1,39,38
1,42,11,17,5,7,6,10,11,11,4,8,12,3,3,0,4,3,39,36.6
1,37,12,25,7,13,5,12,10,10,2,1,3,2,1,0,2,0,39,28.4
1,37,14,20,8,13,6,7,5,7,0,1,1,3,1,0,7,4,39,24.6
1,39,14,22,10,17,4,5,7,8,0,3,3,5,2,0,2,3,39,32
1,37,12,22,9,17,3,5,12,12,2,0,2,2,0,0,3,4,39,26.6
1,36,13,20,7,11,6,9,7,8,1,2,3,12,0,0,7,2,39,31.7
1,40,15,24,12,19,3,5,6,6,0,5,5,3,1,0,1,2,39,31
1,40,13,29,9,18,4,11,9,11,1,6,7,11,4,0,6,4,39,29.7
1,41,14,27,9,16,5,11,6,6,1,3,4,2,0,0,1,0,39,27.7
1,39,13,24,9,15,4,9,9,12,1,3,4,7,6,0,4,1,39,34.3
1,45,13,29,10,22,3,7,10,10,1,2,3,7,0,0,2,3,39,26.9
1,38,13,26,9,16,4,10,9,9,1,5,6,2,1,0,4,3,39,25.4
1,33,15,21,9,11,6,10,3,3,1,4,5,3,3,0,3,3,39,33.1
1,39,12,18,8,13,4,5,11,11,0,6,6,5,1,2,1,1,39,37.5
1,49,12,28,9,17,3,11,12,12,1,13,14,2,3,3,2,3,39,32.1
1,39,17,34,16,30,1,4,4,9,3,11,14,0,1,2,2,2,39,25
1,40,13,23,10,18,3,5,10,12,0,2,2,9,0,1,5,0,39,29.9
1,35,17,26,15,22,2,4,3,3,3,10,13,2,1,0,0,2,39,34.3
1,42,15,27,13,22,2,5,6,8,2,14,16,2,1,3,2,3,38,31.2
1,38,15,27,11,17,4,10,4,4,3,2,5,9,1,0,3,1,38,31.7
0,34,13,27,9,18,4,9,8,9,0,6,6,7,1,0,3,1,38,28.2
1,38,13,24,7,13,6,11,6,6,1,2,3,0,2,1,1,2,38,28.6
1,39,12,18,4,7,8,11,6,8,0,4,4,1,4,0,2,2,38,32.5
1,38,14,32,14,31,0,1,10,11,1,5,6,2,1,1,6,1,38,19.7
1,37,14,17,12,14,2,3,8,11,0,5,5,4,2,2,3,3,38,34
1,38,13,22,10,17,3,5,9,13,3,11,14,12,3,1,6,0,38,37.7
1,42,10,21,6,11,4,10,14,16,3,9,12,12,0,1,4,5,38,34.4
1,47,14,34,10,22,4,12,6,8,0,14,14,2,0,0,5,4,38,18
1,37,12,23,9,15,3,8,11,12,2,3,5,3,0,0,4,4,38,25.1
1,36,11,29,8,22,3,7,13,17,1,10,11,10,4,1,6,3,38,28.7
1,32,15,28,13,25,2,3,6,6,3,4,7,4,1,0,1,4,38,28.9
1,37,14,22,12,17,2,5,8,10,0,9,9,6,2,4,2,2,38,36.3
1,38,13,24,8,13,5,11,7,7,0,2,2,4,1,0,6,2,38,24
1,34,11,22,6,10,5,12,11,13,1,1,2,10,2,1,5,3,38,30.7
1,40,13,28,9,14,4,14,8,12,3,7,10,11,1,1,4,2,38,30.8
1,37,14,25,10,14,4,11,6,6,0,6,6,8,0,2,2,2,38,32.1
1,38,12,24,7,12,5,12,9,11,1,6,7,17,2,1,3,2,38,38.5
1,33,12,18,5,8,7,10,7,8,0,6,6,9,2,0,2,2,38,37.1
1,37,16,24,13,18,3,6,3,4,0,3,3,2,2,1,3,2,38,28.4
1,43,13,24,8,15,5,9,7,7,2,8,10,3,1,1,2,1,38,31.6
1,39,14,27,8,17,6,10,4,8,1,12,13,8,0,0,2,4,38,29.4
1,38,14,29,9,18,5,11,5,6,3,2,5,5,0,0,4,1,38,24.7
1,32,12,20,10,15,2,5,12,14,1,3,4,3,1,0,3,2,38,28.9
1,41,13,22,10,15,3,7,9,9,0,4,4,3,0,0,6,6,38,22.7
1,37,12,29,10,22,2,7,12,14,4,9,13,7,3,1,4,4,38,30.2
1,38,8,20,3,13,5,7,17,17,2,11,13,12,3,0,5,2,38,37.5
1,35,13,22,10,14,3,8,8,8,0,5,5,5,0,0,4,2,37,27
1,41,15,28,13,20,2,8,5,5,1,4,5,7,2,1,5,2,37,27.1
1,44,11,21,8,14,3,7,12,14,2,8,10,6,1,2,0,1,37,35.9
1,35,12,21,7,13,5,8,8,11,2,11,13,4,3,1,5,5,37,30.1
1,37,16,24,15,22,1,2,4,4,9,13,22,3,1,1,4,2,37,35.8
1,33,11,19,9,16,2,3,13,15,1,3,4,7,1,0,2,2,37,32
1,36,14,22,7,13,7,9,2,3,0,4,4,3,1,0,0,1,37,30.7
1,36,13,24,9,19,4,5,7,9,2,9,11,2,4,1,1,2,37,33
1,38,13,29,8,20,5,9,6,8,0,5,5,4,1,0,1,3,37,24.2
1,39,13,23,7,11,6,12,5,6,0,4,4,2,1,1,1,4,37,27.4
1,40,14,22,10,13,4,9,5,7,0,7,7,6,0,0,2,2,37,29.9
1,39,13,22,13,20,0,2,11,15,0,4,4,6,3,0,4,2,37,28.8
1,37,14,21,12,19,2,2,7,8,1,3,4,11,2,1,3,2,37,35.7
1,36,13,27,8,17,5,10,6,7,1,4,5,3,3,0,2,2,37,27.1
1,38,10,16,8,12,2,4,15,16,0,4,4,4,4,1,4,2,37,33.3
1,42,13,23,10,16,3,7,8,9,3,5,8,6,0,0,0,2,37,32.7
1,36,15,30,13,21,2,9,5,5,0,13,13,10,2,0,6,0,37,28.9
1,41,17,24,16,22,1,2,2,2,5,7,12,5,1,0,2,3,37,33.9
1,35,8,14,5,9,3,5,18,18,1,7,8,7,3,0,10,2,37,30.3
1,36,15,26,13,23,2,3,5,8,4,9,13,1,1,4,2,1,37,31.2
1,37,15,25,13,18,2,7,5,7,1,5,6,2,0,1,3,4,37,24.4
1,41,12,22,9,16,3,6,10,10,2,10,12,1,1,1,1,1,37,31.8
1,39,12,21,8,14,4,7,9,9,2,5,7,2,4,1,1,2,37,34.3
1,41,11,21,5,10,6,11,9,9,0,3,3,8,1,0,3,3,37,30
1,42,11,26,6,13,5,13,10,13,1,4,5,2,3,1,5,3,37,22.8
1,38,11,23,10,20,1,3,14,14,2,6,8,9,3,0,2,2,37,35
1,37,10,22,7,17,3,5,14,16,3,13,16,2,1,0,3,3,37,29
1,37,13,25,7,11,6,14,5,6,0,5,5,4,2,0,2,3,37,27.4
1,39,11,22,8,15,3,7,12,14,1,1,2,5,3,0,5,3,37,26.5
1,43,14,32,14,31,0,1,9,11,5,10,15,2,2,4,3,3,37,27.9
1,37,13,25,12,22,1,3,10,13,3,5,8,2,2,0,2,1,37,28.1
1,36,14,26,12,21,2,5,7,12,3,9,12,6,2,0,7,3,37,25.2
1,36,13,29,10,19,3,10,8,10,0,3,3,7,2,0,1,3,37,26.7
1,60,13,29,10,21,3,8,8,10,8,11,19,7,1,0,3,4,37,31.3
1,43,13,27,9,17,4,10,6,7,1,3,4,3,1,0,1,2,36,24.8
0,34,15,21,12,18,3,3,3,6,1,4,5,0,1,0,4,3,36,23.8
1,39,14,22,13,18,1,4,7,7,2,8,10,6,1,2,3,3,36,32.4
1,36,13,27,12,20,1,7,9,11,2,7,9,4,4,0,3,3,36,27.6
1,40,14,27,13,22,1,5,7,9,1,7,8,3,2,0,3,2,36,25
1,38,13,21,6,9,7,12,3,3,0,3,3,6,4,0,1,1,36,34.2
1,35,12,20,10,15,2,5,10,10,1,4,5,2,0,0,1,2,36,28.3
1,36,13,18,10,14,3,4,7,10,3,8,11,1,2,3,1,1,36,35.3
1,44,14,28,9,21,5,7,3,5,3,1,4,2,1,1,2,6,36,22.3
1,39,13,21,13,21,0,0,10,10,0,6,6,5,0,1,6,4,36,24.9
1,38,13,23,5,8,8,15,2,2,0,1,1,3,0,0,1,5,36,24.5
1,38,13,22,12,17,1,5,9,9,4,4,8,1,0,0,4,5,36,24.5
1,34,12,22,9,14,3,8,9,9,1,2,3,4,2,0,2,0,36,29.5
1,34,13,24,9,18,4,6,6,9,2,7,9,2,0,0,2,3,36,24.9
0,35,13,20,8,11,5,9,5,6,1,1,2,2,0,0,1,0,36,28.2
1,41,9,25,6,21,3,4,15,17,1,10,11,17,0,1,7,3,36,29.4
1,43,10,23,10,22,0,1,16,17,1,7,8,2,2,1,2,3,36,27.2
1,43,9,31,5,21,4,10,14,16,5,8,13,4,1,3,2,0,36,26.9
1,35,14,20,14,19,0,1,8,10,0,9,9,6,3,0,5,2,36,30.9
1,36,15,25,9,11,6,14,0,0,0,10,10,5,0,0,6,4,36,23.4
1,42,12,19,7,9,5,10,7,9,0,1,1,7,0,0,5,1,36,26.5
1,39,9,26,6,14,3,12,15,18,2,5,7,7,1,2,8,2,36,21.6
1,39,13,22,11,15,2,7,8,10,1,1,2,4,0,1,2,3,36,26.3
1,39,12,27,8,16,4,11,8,12,3,5,8,11,2,0,4,3,36,28.4
1,42,10,24,10,23,0,1,16,21,3,4,7,11,3,0,0,1,36,34.8
1,33,15,20,11,12,4,8,2,3,0,4,4,5,2,0,4,2,36,29.5
1,43,13,23,8,13,5,10,5,7,2,9,11,4,2,1,5,3,36,27.7
1,37,13,28,13,28,0,0,10,10,2,9,11,6,1,0,3,2,36,27.1
1,39,14,23,14,23,0,0,8,10,3,11,14,2,1,3,3,3,36,30.4
1,38,14,21,13,20,1,1,7,9,3,13,16,2,0,2,3,0,36,31.9
1,41,13,29,7,22,6,7,4,8,5,3,8,2,1,0,4,2,36,21.3
1,36,13,21,12,20,1,1,9,14,0,2,2,3,0,0,2,3,36,24
1,40,12,15,8,8,4,7,8,9,2,6,8,5,1,0,2,5,36,33.6
1,41,12,23,11,21,1,2,11,14,1,16,17,3,3,3,1,1,36,34.8
1,36,11,21,7,16,4,5,10,11,2,9,11,10,4,0,7,1,36,33
1,40,15,25,14,23,1,2,5,6,2,15,17,3,3,2,6,2,36,29.7
1,40,12,22,12,21,0,1,12,14,3,10,13,3,1,1,2,3,36,30.3
1,35,14,28,11,23,3,5,5,6,2,11,13,2,0,0,2,3,36,24.5
1,38,11,23,9,15,2,8,12,12,0,15,15,3,1,1,0,2,36,31.8
1,40,16,34,15,28,1,6,3,10,4,16,20,4,2,1,5,5,36,21.9
1,35,12,20,6,10,6,10,6,8,2,2,4,1,1,8,0,2,36,34.5
1,38,12,19,7,10,5,9,7,11,2,3,5,2,1,0,2,1,36,28.2
1,36,13,26,12,22,1,4,9,11,1,7,8,4,0,2,3,0,36,26.2
1,39,11,19,9,16,2,3,12,13,2,9,11,9,2,0,5,4,36,32.5
1,47,13,20,5,10,8,10,1,1,0,2,2,5,0,0,1,3,35,28.1
1,41,12,35,11,29,1,6,10,10,4,10,14,11,2,0,5,3,35,24.6
1,41,14,25,11,19,3,6,4,4,1,12,13,5,2,1,2,2,35,30.8
1,40,10,23,6,15,4,8,11,11,0,6,6,6,2,2,3,3,35,28.1
1,29,11,15,11,15,0,0,13,15,0,2,2,0,0,0,2,2,35,25.9
1,46,11,21,8,15,3,6,10,13,0,2,2,3,3,0,0,2,35,28.4
1,32,10,16,4,6,6,10,9,10,1,6,7,5,4,0,4,5,35,31.4
1,38,13,20,11,17,2,3,7,10,4,4,8,0,2,1,2,4,35,28.1
1,37,13,25,6,14,7,11,2,2,0,4,4,4,2,0,0,3,35,27.5
1,37,13,26,7,16,6,10,3,4,2,0,2,4,1,1,2,4,35,23.9
1,32,10,21,10,18,0,3,15,15,3,2,5,3,5,0,2,1,35,31.7
1,37,10,19,7,10,3,9,12,13,2,1,3,7,1,0,3,3,35,28.7
1,34,13,22,11,20,2,2,7,9,7,11,18,4,0,1,2,4,35,32.1
1,36,9,22,4,9,5,13,12,13,0,11,11,15,1,0,10,2,35,26.8
1,32,10,25,5,13,5,12,10,11,0,2,2,5,2,0,1,4,35,24.6
1,39,11,24,9,21,2,3,11,15,2,14,16,0,0,5,4,2,35,25.3
1,35,10,21,6,13,4,8,11,13,3,2,5,4,0,1,3,3,35,25.5
1,36,10,23,6,13,4,10,11,13,1,2,3,7,1,1,3,1,35,26.6
0,36,12,18,5,8,7,10,4,5,2,3,5,3,1,0,2,1,35,29.8
1,44,16,28,13,19,3,9,0,0,0,3,3,6,1,1,1,0,35,27.6
1,36,13,27,10,18,3,9,6,7,1,2,3,2,0,1,1,2,35,22.5
1,38,14,20,11,14,3,6,4,4,4,6,10,4,1,0,3,0,35,32
1,37,9,21,9,18,0,3,17,18,3,12,15,2,3,3,1,2,35,33.9
1,38,13,31,9,20,4,11,5,5,2,7,9,5,0,2,5,4,35,20.3
1,41,13,19,12,18,1,1,8,11,3,6,9,8,2,7,4,2,35,37.3
1,40,12,25,7,15,5,10,6,6,2,8,10,3,2,0,3,2,35,26.4
1,33,14,30,14,23,0,7,7,9,1,5,6,5,3,0,10,4,35,15.9
1,31,14,25,7,10,7,15,0,0,1,4,5,4,0,0,3,1,35,24.4
1,46,14,25,9,16,5,9,2,4,0,7,7,9,1,1,10,3,35,21.2
1,33,12,20,7,13,5,7,6,8,2,8,10,1,0,0,3,3,35,25.3
1,38,13,15,13,15,0,0,9,12,13,2,15,1,1,4,3,2,35,38.9
1,31,12,18,5,6,7,12,4,7,2,3,5,4,2,0,0,1,35,32.7
1,38,14,22,12,18,2,4,5,5,4,8,12,4,0,2,3,2,35,30.8
1,37,10,22,10,14,0,8,15,16,0,4,4,6,2,1,6,1,35,24.9
1,39,11,20,9,16,2,4,11,12,0,7,7,5,0,2,1,3,35,29.8
1,42,11,20,3,6,8,14,5,6,0,4,4,9,3,0,3,2,35,31.7
0,35,10,19,4,7,6,12,9,11,0,5,5,2,1,0,2,2,35,26
1,40,14,21,11,16,3,5,4,6,4,10,14,1,1,2,4,4,35,28.4
1,36,12,25,7,12,5,13,6,8,1,6,7,5,1,0,5,1,35,23.1
1,40,13,22,10,15,3,7,6,7,4,3,7,3,1,1,1,2,35,30.1
1,42,12,26,10,19,2,7,8,9,3,5,8,7,2,0,1,2,34,28.9
1,37,13,19,9,11,4,8,4,4,1,7,8,6,2,0,6,4,34,27.3
1,47,12,25,7,16,5,9,5,6,3,9,12,7,1,1,2,2,34,29.5
1,36,14,26,13,24,1,2,5,7,2,12,14,2,1,2,2,5,34,25.4
1,35,13,26,13,24,0,2,8,11,1,7,8,2,0,2,1,0,34,24.4
1,32,10,12,7,9,3,3,11,12,0,2,2,7,0,0,4,4,34,29.1
1,48,13,26,11,21,2,5,6,7,3,5,8,2,2,0,1,0,34,26.6
1,37,12,22,5,11,7,11,3,3,1,3,4,4,0,3,3,1,34,26.5
1,39,12,17,10,14,2,3,8,9,1,6,7,5,1,0,1,4,34,30.9
1,36,13,22,12,19,1,3,7,9,4,9,13,5,2,3,1,2,34,34.3
1,42,11,19,8,13,3,6,9,9,1,6,7,6,2,0,0,3,34,32.6
1,35,13,25,11,15,2,10,6,7,0,9,9,7,0,1,2,2,34,26.8
1,36,14,26,14,25,0,1,6,7,0,3,3,3,2,0,1,1,34,24.6
1,38,8,18,7,14,1,4,17,17,1,5,6,4,1,0,5,3,34,24.4
1,32,12,21,5,6,7,15,3,3,1,5,6,2,2,0,1,2,34,27.9
1,38,13,20,7,12,6,8,2,2,0,9,9,4,1,1,1,2,34,30.6
1,35,13,19,12,17,1,2,7,10,1,11,12,5,5,2,6,4,34,31
1,37,10,20,4,10,6,10,8,8,0,3,3,4,1,0,0,5,34,26.7
1,37,15,26,15,26,0,0,4,6,0,5,5,4,2,1,3,3,34,23.8
1,38,14,19,11,14,3,5,3,3,7,7,14,4,3,3,0,2,34,40.4
1,36,11,23,10,20,1,3,11,13,2,2,4,3,1,2,4,3,34,22.8
1,35,13,27,10,20,3,7,5,7,1,9,10,2,1,0,1,2,34,23.5
1,34,12,22,10,14,2,8,8,9,0,2,2,10,1,0,5,3,34,25.4
1,37,14,25,13,21,1,4,5,5,0,3,3,14,4,0,3,3,34,32.6
1,42,13,23,8,14,5,9,3,3,0,0,0,6,0,0,0,0,34,27.3
1,31,14,23,12,18,2,5,4,4,2,3,5,5,1,0,3,4,34,25.7
1,30,9,16,5,9,4,7,12,12,2,3,5,11,0,1,7,2,34,29.3
1,40,12,21,11,19,1,2,9,11,2,7,9,1,1,5,2,3,34,28.8
1,37,12,21,8,14,4,7,6,7,0,9,9,6,3,2,2,4,34,31.4
1,39,15,25,15,25,0,0,4,4,4,8,12,0,0,0,1,2,34,25.9
1,42,12,23,8,19,4,4,6,7,1,7,8,0,3,3,2,6,34,25.8
1,29,12,21,8,13,4,8,6,9,2,9,11,1,2,1,2,2,34,27.6
1,38,11,26,9,15,2,11,10,11,0,1,1,4,1,0,2,1,34,21.5
1,37,14,26,14,24,0,2,6,6,1,3,4,4,0,0,4,2,34,21
1,37,15,19,13,16,2,3,2,2,1,10,11,4,1,3,3,4,34,31.7
1,36,12,22,10,17,2,5,8,8,0,5,5,4,2,1,1,1,34,29
1,33,10,20,7,11,3,9,11,11,1,1,2,7,0,0,2,2,34,27.1
1,38,12,20,8,11,4,9,6,6,0,10,10,3,2,0,2,2,34,29.1
1,44,11,25,10,20,1,5,11,12,1,9,10,5,6,1,1,1,34,32.7
1,31,11,13,7,8,4,5,8,10,1,10,11,4,2,1,5,2,34,31.9
1,33,12,21,9,15,3,6,7,7,1,8,9,3,0,0,3,5,34,24.3
1,38,13,22,10,14,3,8,5,8,0,6,6,7,1,0,3,2,34,26.5
1,37,14,22,14,20,0,2,6,7,1,7,8,1,2,4,3,2,34,28.3
1,30,14,22,11,15,3,7,3,6,2,7,9,6,0,0,2,2,34,27.9
1,37,12,26,10,15,2,11,8,9,1,7,8,3,0,0,2,1,34,22.7
1,39,11,26,7,20,4,6,8,8,2,5,7,1,1,2,2,1,34,23.8
1,43,11,19,5,9,6,10,6,8,0,2,2,2,1,0,3,2,34,23.5
1,37,9,19,8,12,1,7,15,16,3,4,7,17,1,0,7,5,34,31.1
1,37,12,23,7,17,5,6,5,8,1,2,3,8,0,0,3,3,34,24.2
1,41,13,25,10,17,3,8,5,6,1,10,11,9,1,0,4,2,34,27.5
1,45,15,22,12,15,3,7,1,1,2,7,9,9,1,0,4,4,34,29.8
1,36,9,18,5,10,4,8,12,13,1,6,7,2,3,0,2,4,34,27.9
1,36,13,30,9,21,4,9,4,5,3,5,8,13,2,0,8,3,34,23.3
1,40,12,26,8,15,4,11,6,6,2,3,5,4,1,0,3,4,34,22.1
1,38,12,19,6,10,6,9,4,5,0,5,5,4,1,0,5,3,34,24.2
1,39,12,19,8,12,4,7,5,5,0,6,6,10,3,2,3,5,33,32.7
1,43,11,20,10,18,1,2,10,10,1,4,5,8,0,1,1,3,33,29.4
1,31,14,24,14,23,0,1,5,8,3,2,5,2,2,1,1,2,33,25.6
1,36,9,26,6,16,3,10,12,13,1,10,11,14,2,2,5,1,33,29.5
1,35,13,20,7,10,6,10,1,2,1,5,6,4,2,0,2,2,33,28
1,37,13,23,10,16,3,7,4,4,0,9,9,3,1,1,2,2,33,25.8
1,35,11,21,6,10,5,11,6,6,1,5,6,7,1,0,1,4,33,28.2
1,35,13,17,6,8,7,9,0,0,1,1,2,9,1,0,4,4,33,29
1,33,12,19,7,11,5,8,4,8,0,3,3,3,1,0,3,1,33,23.5
1,27,11,22,7,17,4,5,7,7,1,1,2,3,0,0,0,2,33,24.3
1,36,12,20,11,17,1,3,8,9,1,6,7,4,2,1,2,3,33,28.2
1,45,11,21,5,7,6,14,5,7,0,4,4,10,0,0,3,3,33,25.9
1,40,12,19,8,12,4,7,5,5,0,3,3,4,1,1,7,4,33,21.3
1,34,11,21,6,15,5,6,6,6,4,7,11,16,1,1,7,3,33,32.3
1,33,13,20,7,12,6,8,1,1,1,4,5,4,1,0,3,1,33,26.5
1,41,11,23,8,16,3,7,8,10,1,2,3,11,2,1,3,2,33,28.4
1,38,9,18,3,9,6,9,9,12,1,4,5,8,1,0,4,2,33,26.5
1,36,13,27,9,16,4,11,3,4,0,3,3,7,0,0,6,5,33,16.7
1,36,13,26,12,19,1,7,6,6,2,8,10,6,0,1,7,2,33,20.9
1,27,12,17,10,14,2,3,7,8,2,8,10,1,2,3,3,2,33,30.3
1,40,9,21,4,10,5,11,10,11,1,4,5,6,0,0,4,1,33,23.2
1,37,10,24,5,10,5,14,8,9,1,2,3,9,0,0,2,4,33,23.8
1,36,11,17,11,15,0,2,11,11,1,13,14,3,0,1,2,2,33,30.1
1,31,12,19,6,9,6,10,3,3,0,4,4,5,0,0,5,5,33,22.2
1,34,9,19,5,12,4,7,11,13,1,3,4,3,0,0,4,3,33,21
1,38,13,23,9,17,4,6,3,4,2,8,10,4,2,0,2,2,33,27.5
1,37,11,20,10,16,1,4,10,10,0,5,5,2,0,4,6,3,33,21.9
1,35,12,24,10,18,2,6,7,10,0,6,6,0,0,1,2,3,33,19.1
1,33,12,18,8,9,4,9,5,7,0,6,6,3,0,1,3,2,33,25.2
1,34,10,16,8,12,2,4,11,15,4,8,12,3,4,1,6,4,33,28.6
1,33,13,21,8,12,5,9,2,2,0,1,1,4,2,0,1,1,33,27.2
1,38,10,25,3,6,7,19,6,7,2,7,9,12,0,1,1,4,33,29.1
1,38,15,20,15,20,0,0,3,6,3,6,9,1,0,0,1,4,33,25.8
1,45,8,18,7,13,1,5,16,17,1,3,4,3,2,0,4,2,33,24.1
1,37,13,19,13,16,0,3,7,9,1,4,5,11,3,1,9,3,33,27.2
1,41,10,17,6,9,4,8,9,11,1,5,6,5,3,0,2,2,33,30.2
1,38,12,22,7,17,5,5,4,4,1,6,7,4,0,0,3,0,33,24.7
1,37,13,20,11,16,2,4,5,6,1,7,8,2,1,0,2,1,33,26.6
1,32,12,23,8,16,4,7,5,6,0,5,5,2,0,0,2,3,33,21
1,30,10,17,3,4,7,13,6,6,1,4,5,6,1,0,4,1,33,27.8
1,38,11,23,8,14,3,9,8,9,1,3,4,5,1,0,2,1,33,24.6
1,37,11,18,7,12,4,6,7,8,0,6,6,7,2,1,3,2,33,30
1,39,12,22,9,15,3,7,6,9,2,7,9,3,1,2,3,5,33,24.2
1,34,11,21,11,19,0,2,11,12,2,13,15,8,0,0,7,4,33,24.6
1,35,13,26,10,20,3,6,4,4,1,8,9,1,1,1,0,1,33,25.1
1,39,10,23,8,12,2,11,11,13,0,6,6,12,1,2,6,0,33,26.7
1,43,11,25,4,10,7,15,4,4,1,8,9,3,0,0,0,1,33,24.7
1,36,10,17,5,9,5,8,8,11,0,6,6,5,2,1,0,5,33,29.9
1,33,12,15,12,15,0,0,9,11,5,10,15,2,1,2,3,4,33,32.2
1,33,13,20,10,12,3,8,4,4,0,2,2,3,0,1,1,2,33,25.8
1,35,11,18,10,16,1,2,10,13,1,12,13,1,0,0,3,1,33,25.2
1,32,9,15,4,8,5,7,10,10,0,3,3,2,1,0,2,2,33,26.6
1,36,9,16,9,14,0,2,15,16,0,6,6,2,2,1,4,2,33,26.1
1,36,11,23,10,22,1,1,10,13,2,5,7,4,2,0,2,1,33,25.4
1,36,9,22,6,12,3,10,12,14,0,7,7,4,1,1,2,3,33,23.8
1,38,12,20,8,15,4,5,5,6,1,4,5,10,2,0,3,1,33,30.9
1,40,13,25,13,24,0,1,7,10,2,7,9,3,4,1,0,2,33,29
1,32,11,18,6,9,5,9,6,8,1,4,5,2,1,1,1,2,33,27.2
1,39,13,23,13,22,0,1,7,9,2,3,5,1,1,0,1,1,33,23.9
1,38,13,20,11,15,2,5,5,10,0,10,10,6,2,1,6,0,33,26.1
1,33,11,23,4,9,7,14,4,4,0,4,4,3,0,0,2,4,33,21
1,34,10,31,8,19,2,12,11,13,3,12,15,8,2,1,4,5,33,22.5
1,34,12,20,7,14,5,6,4,4,1,2,3,4,0,0,3,4,33,23.3
1,31,13,20,10,16,3,4,4,5,4,2,6,0,0,1,3,1,33,24.5
1,41,14,24,14,23,0,1,5,6,3,13,16,1,3,1,1,2,33,30
1,39,14,27,10,19,4,8,1,2,2,4,6,2,1,0,3,2,33,20.5
1,33,12,20,8,12,4,8,5,5,1,6,7,9,1,1,5,2,33,28.5
1,35,10,23,5,11,5,12,8,9,0,2,2,3,3,0,2,3,33,23
1,37,15,22,14,18,1,4,2,2,2,2,4,4,0,0,1,0,33,27.4
1,40,13,22,13,20,0,2,7,7,5,2,7,6,2,3,4,4,33,29.6
1,37,13,22,9,15,4,7,3,6,0,2,2,9,1,0,3,6,33,24.1
1,38,11,24,6,13,5,11,6,6,0,4,4,1,1,1,3,2,33,20.4
1,41,11,24,7,16,4,8,7,10,0,2,2,2,2,1,1,4,33,21.5
1,36,9,15,3,5,6,10,9,13,1,6,7,11,2,0,5,2,33,30.9
1,40,13,21,9,13,4,8,3,6,4,3,7,2,0,0,3,3,33,23.2
1,39,13,20,9,13,4,7,2,6,1,2,3,3,0,1,1,1,32,24.3
1,41,12,21,9,16,3,5,5,5,1,2,3,4,2,1,1,1,32,27.5
1,43,11,21,11,17,0,4,10,10,0,6,6,4,0,1,3,1,32,23.6
1,38,11,19,9,15,2,4,8,10,5,9,14,2,1,2,2,4,32,28.7
1,38,11,14,9,10,2,4,8,10,0,4,4,6,1,0,1,3,32,30
1,35,10,19,6,13,4,6,8,8,1,1,2,4,0,0,3,1,32,23.1
1,38,12,28,12,27,0,1,8,8,2,5,7,2,2,0,3,3,32,19.3
1,41,13,18,8,9,5,9,1,2,0,13,13,1,0,1,2,4,32,25.9
1,37,9,18,6,14,3,4,11,11,0,4,4,0,2,0,4,2,32,21.4
1,29,11,16,5,7,6,9,4,5,1,3,4,8,0,0,2,2,32,29.2
1,42,12,17,10,12,2,5,6,7,2,3,5,12,3,0,4,0,32,34.2
1,39,11,17,2,6,9,11,1,2,0,2,2,5,0,0,2,4,32,24.6
1,34,10,22,7,14,3,8,9,14,1,12,13,12,1,1,4,1,32,28.6
1,40,11,24,10,22,1,2,9,9,1,9,10,3,2,1,6,4,32,20.2
0,38,13,20,10,15,3,5,3,5,0,5,5,3,3,0,0,6,32,26.6
1,35,11,20,8,13,3,7,7,7,2,10,12,0,1,2,0,2,32,28.4
1,38,12,20,8,9,4,11,4,6,0,2,2,5,2,0,3,2,32,24.3
1,36,11,21,10,19,1,2,9,11,1,11,12,9,0,0,2,2,32,28.4
1,33,7,18,4,11,3,7,15,15,2,6,8,6,4,0,1,0,32,32.6
1,40,12,21,7,11,5,10,3,3,0,11,11,3,1,0,1,3,32,26.3
1,36,10,26,7,17,3,9,9,9,0,3,3,4,2,0,0,1,32,23.1
1,31,11,20,6,11,5,9,5,6,0,5,5,3,2,1,2,5,32,24.3
1,34,12,19,10,12,2,7,6,7,0,4,4,7,2,2,1,2,32,30.8
1,34,10,18,5,7,5,11,7,8,0,2,2,6,1,0,6,2,32,22
1,35,10,19,6,11,4,8,8,9,0,2,2,5,3,0,3,4,32,24.8
1,37,14,25,12,20,2,5,2,2,3,8,11,4,0,1,2,3,32,24.9
1,40,9,14,9,13,0,1,14,16,0,9,9,11,1,2,4,2,32,33
1,39,13,21,11,17,2,4,4,4,2,0,2,3,1,0,2,4,32,23.4
1,42,12,18,6,10,6,8,2,5,0,7,7,17,2,2,6,6,32,32
1,37,12,20,10,15,2,5,6,11,2,3,5,1,1,3,5,4,32,20.3
1,47,11,23,8,17,3,6,7,10,3,10,13,3,0,1,2,5,32,23
1,37,10,20,7,10,3,10,9,9,0,4,4,1,2,0,4,4,32,20.3
1,47,11,21,10,18,1,3,9,10,3,13,16,10,1,0,3,6,32,29.9
1,37,9,18,6,11,3,7,11,11,1,5,6,5,0,0,2,2,32,25.9
1,38,12,19,4,5,8,14,0,0,0,2,2,3,1,0,0,5,32,25.2
1,36,12,24,8,15,4,9,4,5,1,6,7,5,0,0,3,4,32,21
1,40,12,22,11,20,1,2,7,10,3,11,14,5,2,1,0,2,32,31
0,30,11,15,10,14,1,1,9,11,2,9,11,0,2,0,3,2,32,27.4
1,38,10,17,7,14,3,3,9,12,2,11,13,5,0,0,4,2,32,26.3
1,37,8,22,6,15,2,7,14,15,2,13,15,12,0,0,8,1,32,24.7
1,40,12,22,9,15,3,7,5,6,1,2,3,7,2,0,0,0,32,29.2
1,40,12,20,8,12,4,8,4,5,0,5,5,10,0,0,5,1,32,25.5
1,29,11,13,7,8,4,5,6,6,1,3,4,4,1,0,4,2,32,27.9
1,40,13,19,13,19,0,0,6,8,2,10,12,7,0,4,6,4,32,27.6
1,31,11,20,4,7,7,13,3,4,1,7,8,4,3,0,3,1,32,27.2
1,33,13,19,13,19,0,0,6,8,7,6,13,0,0,2,3,5,32,26.2
1,37,13,20,12,16,1,4,5,6,1,10,11,6,1,3,4,3,32,28.6
1,37,9,20,5,13,4,7,10,11,2,4,6,5,0,0,4,3,32,22.1
1,32,13,18,10,14,3,4,3,4,0,8,8,3,0,0,4,5,32,22.7
1,39,13,23,11,20,2,3,4,5,0,6,6,3,5,0,2,0,32,27.6
1,40,13,26,10,15,3,11,3,4,1,2,3,8,2,0,4,6,32,21.1
1,38,11,15,7,11,4,4,6,10,2,4,6,2,0,0,1,3,32,26.1
1,41,11,21,11,20,0,1,10,13,6,7,13,7,4,2,1,2,32,35.3
1,37,13,24,10,18,3,6,3,5,2,5,7,7,4,2,5,3,32,26.6
1,36,11,24,8,19,3,5,7,8,5,11,16,1,1,2,0,2,32,28.3
1,30,9,18,7,9,2,9,12,15,1,4,5,12,0,0,7,4,32,23.5
1,37,9,14,6,9,3,5,11,11,1,7,8,1,0,0,1,0,32,28.3
1,40,13,30,13,25,0,5,6,6,3,12,15,8,2,1,7,5,32,21.2
1,36,10,17,8,14,2,3,10,10,1,5,6,2,0,2,2,0,32,27.1
1,41,11,22,9,19,2,3,8,10,6,3,9,2,2,1,3,5,32,24.4
1,39,9,18,6,12,3,6,11,14,2,1,3,6,1,0,2,1,32,26.3
1,40,12,21,10,16,2,5,6,6,1,7,8,5,0,4,2,5,32,27.2
1,37,10,16,8,12,2,4,10,11,1,0,1,6,1,0,1,3,32,28.1
1,34,12,19,10,14,2,5,6,8,2,8,10,2,1,0,4,4,32,23.3
1,29,13,17,13,16,0,1,6,9,3,5,8,2,0,0,2,4,32,25.5
0,28,12,20,9,15,3,5,5,7,1,3,4,4,1,0,1,1,32,26
1,33,11,22,8,14,3,8,7,9,0,6,6,5,1,0,3,2,32,22.7
1,32,12,21,9,16,3,5,5,5,3,10,13,2,1,0,3,4,32,25
1,40,9,19,6,12,3,7,11,11,0,5,5,15,0,0,7,2,32,26.5
1,35,10,15,10,15,0,0,12,14,6,5,11,1,0,0,1,4,32,28.5
1,40,10,24,5,16,5,8,7,8,0,12,12,4,2,1,1,5,32,24.9
1,28,11,20,7,14,4,6,6,6,1,6,7,4,3,2,5,3,32,25.9
1,40,11,25,7,16,4,9,6,7,2,5,7,3,0,1,3,1,32,20.8
1,33,11,22,8,11,3,11,7,10,2,8,10,7,2,0,6,5,32,22.5
1,47,14,22,14,22,0,0,4,6,4,11,15,0,1,5,1,5,32,29
1,30,12,22,7,13,5,9,3,5,0,9,9,1,0,5,4,5,32,21.5
1,35,10,20,3,8,7,12,5,6,2,15,17,11,3,0,5,3,32,32
1,37,9,17,4,8,5,9,9,9,1,4,5,4,3,0,4,2,32,26.6
1,37,12,22,9,18,3,4,5,6,1,3,4,5,1,0,3,4,32,22.5
1,36,11,23,9,20,2,3,8,11,3,5,8,5,2,0,0,2,32,27.4
1,36,12,25,8,17,4,8,4,6,2,4,6,9,1,0,1,1,32,27
1,41,12,22,9,14,3,8,5,7,1,4,5,7,0,1,2,0,32,26.1
1,39,9,15,6,10,3,5,11,14,0,3,3,6,1,0,2,5,32,26
1,35,11,19,9,12,2,7,7,9,5,6,11,1,1,0,3,2,31,24.5
1,40,10,16,9,13,1,3,10,10,2,3,5,8,0,0,4,1,31,27.3
1,39,11,24,8,14,3,10,6,7,1,6,7,3,2,0,3,3,31,20.6
1,36,11,17,9,14,2,3,7,8,3,4,7,3,1,4,5,3,31,26.1
1,37,10,26,9,15,1,11,10,10,2,8,10,7,0,0,3,1,31,22.1
0,34,12,23,6,11,6,12,1,3,1,1,2,4,1,1,0,2,31,23.6
1,40,11,26,10,21,1,5,8,10,1,6,7,6,3,0,1,1,31,24.7
1,35,12,18,10,13,2,5,5,5,0,2,2,5,2,0,5,3,31,23.1
1,38,8,15,8,15,0,0,15,16,1,6,7,4,3,0,2,2,31,28.8
0,33,9,16,6,10,3,6,10,11,0,6,6,0,1,1,1,0,31,25.5
1,40,12,22,8,14,4,8,3,7,5,8,13,4,2,1,5,2,31,24.4
1,34,13,18,12,15,1,3,4,7,0,5,5,11,0,0,5,1,31,26.2
1,35,12,30,12,29,0,1,7,10,5,11,16,2,0,2,1,2,31,21.4
1,37,12,21,11,19,1,2,6,9,2,6,8,7,1,0,5,2,31,23.2
1,31,9,13,7,10,2,3,11,12,0,4,4,4,0,0,2,3,31,25.9
1,34,10,25,7,18,3,7,8,8,0,6,6,6,0,1,0,3,31,23
1,34,13,18,9,11,4,7,1,1,0,9,9,7,1,0,1,2,31,30.4
1,21,8,15,8,12,0,3,15,15,2,8,10,3,0,0,1,6,31,26.2
1,33,9,15,2,4,7,11,6,6,0,0,0,1,0,0,1,2,31,23
1,41,12,24,5,11,7,13,0,2,1,5,6,3,0,1,2,0,31,21.2
1,30,13,21,12,18,1,3,4,4,0,5,5,4,1,0,3,2,31,23
1,34,10,17,7,11,3,6,8,9,3,6,9,3,0,1,0,0,31,29.4
1,32,8,19,4,9,4,10,11,13,0,1,1,2,1,0,1,3,31,20.6
1,38,10,18,6,9,4,9,7,7,0,4,4,11,2,0,3,1,31,29.9
1,37,13,29,11,18,2,11,3,4,2,8,10,5,0,1,1,1,31,22.1
1,39,13,24,11,16,2,8,3,4,0,1,1,5,4,0,1,5,31,23.8
1,33,11,25,10,21,1,4,8,9,3,4,7,15,1,1,5,2,31,27.2
1,38,12,22,8,14,4,8,3,3,2,5,7,3,2,0,3,4,31,22.8
1,28,12,17,11,15,1,2,6,7,1,12,13,3,0,1,3,3,31,26.4
1,30,10,15,5,8,5,7,6,6,0,2,2,1,1,0,3,2,31,23
1,37,11,21,6,13,5,8,4,4,0,4,4,2,3,0,1,3,31,24.1
1,35,10,25,10,25,0,0,11,13,0,1,1,3,1,1,1,3,31,18.6
1,29,11,18,6,9,5,9,4,4,0,4,4,2,0,0,3,2,31,21.6
1,38,11,17,10,14,1,3,8,8,6,5,11,1,0,1,3,3,31,26.4
1,37,12,21,7,15,5,6,2,4,0,4,4,7,0,0,5,4,31,19.8
1,38,13,22,9,17,4,5,1,1,0,5,5,5,1,1,0,1,31,27.1
1,34,8,20,7,14,1,6,14,17,6,5,11,7,3,1,6,2,31,26.5
1,32,12,16,12,16,0,0,7,10,3,8,11,0,3,0,3,4,31,26.3
1,37,11,24,6,11,5,13,4,6,2,6,8,6,2,0,2,2,31,24.4
1,35,9,15,7,11,2,4,11,11,1,3,4,8,0,1,4,4,31,26.4
1,36,11,19,3,8,8,11,1,2,1,10,11,4,1,0,1,4,31,26.6
1,35,12,18,5,7,7,11,0,0,0,2,2,1,0,0,1,1,31,23.1
1,41,9,23,5,13,4,10,9,11,1,2,3,8,1,0,1,0,31,24.6
1,33,11,22,8,17,3,5,6,7,1,2,3,5,1,0,6,3,31,18.2
1,39,13,26,11,24,2,2,3,3,0,2,2,2,1,0,0,2,31,20.2
1,36,11,15,9,12,2,3,7,8,0,1,1,4,2,0,1,1,31,28.2
1,36,10,21,9,17,1,4,10,10,0,2,2,5,3,0,4,3,31,22.2
1,41,9,17,4,11,5,6,8,10,1,6,7,6,1,0,3,2,31,25.8
1,39,9,13,6,8,3,5,10,10,0,2,2,0,1,0,3,2,31,23.3
1,38,10,19,6,10,4,9,7,7,0,1,1,4,1,0,1,2,31,24
1,34,8,13,6,8,2,5,13,13,1,2,3,9,2,0,3,1,31,31.3
1,37,13,19,11,17,2,2,3,3,3,6,9,0,0,4,2,4,31,26
1,36,13,23,11,17,2,6,3,3,1,3,4,9,0,1,5,3,31,22.5
1,35,10,20,7,11,3,9,8,12,1,1,2,5,2,1,4,2,31,21.8
1,35,7,16,3,5,4,11,13,13,1,4,5,7,1,0,4,3,31,25.2
1,35,11,17,10,15,1,2,8,9,0,6,6,13,1,0,4,2,31,30.2
1,38,12,19,10,17,2,2,5,7,0,7,7,2,2,0,3,4,31,22.6
1,26,10,13,7,8,3,5,8,9,0,2,2,2,2,0,0,0,31,29.5
1,35,7,18,6,13,1,5,16,19,1,10,11,9,2,0,3,1,31,28.6
1,33,12,17,8,12,4,5,3,4,0,5,5,4,1,0,4,2,31,24
1,39,11,22,9,18,2,4,7,8,2,4,6,3,2,0,2,1,31,23.9
1,29,11,18,4,6,7,12,2,2,0,5,5,9,1,0,1,1,31,30.2
1,34,12,17,5,6,7,11,0,0,0,3,3,6,1,0,3,0,31,27
1,39,12,18,8,10,4,8,3,3,0,2,2,8,2,1,3,3,31,27.9
1,35,10,18,2,4,8,14,3,3,1,6,7,0,0,2,2,4,31,22.7
1,40,13,26,11,17,2,9,3,6,1,4,5,7,4,0,1,0,31,26.6
1,38,9,19,4,11,5,8,8,8,1,2,3,4,0,0,5,5,31,18.4
1,35,9,16,4,7,5,9,8,11,0,4,4,5,2,0,1,1,31,27.5
1,37,12,18,7,11,5,7,2,2,1,7,8,5,0,2,3,5,31,25.9
1,39,13,21,12,19,1,2,4,6,1,8,9,5,1,1,1,5,31,26
1,39,13,23,11,19,2,4,3,3,1,4,5,1,1,0,1,2,31,21.9
1,37,13,17,10,11,3,6,2,2,0,1,1,1,1,0,4,1,31,21.9
1,36,12,23,10,17,2,6,5,7,1,3,4,2,0,1,1,2,31,20.8
1,30,11,18,11,17,0,1,9,11,2,3,5,3,0,0,2,1,31,24
1,39,9,21,8,17,1,4,12,12,2,4,6,8,2,1,5,2,31,25
1,39,12,23,12,21,0,2,7,7,0,4,4,5,3,0,1,3,31,25.2
1,41,12,25,9,19,3,6,4,4,2,4,6,2,2,0,4,4,31,18.7
1,38,10,21,7,14,3,7,8,9,0,6,6,4,0,0,1,5,31,21.5
1,43,12,20,10,17,2,3,5,7,0,4,4,1,0,0,1,3,31,20.7
1,34,11,22,8,13,3,9,6,6,2,9,11,2,3,0,2,4,31,24.9
1,39,8,19,4,9,4,10,11,15,0,7,7,10,1,3,4,3,31,26.3
0,28,10,20,4,9,6,11,5,5,0,4,4,5,3,0,1,1,31,27.3
0,36,11,18,5,6,6,12,3,4,0,2,2,3,0,1,3,4,31,21.2
1,39,13,24,8,12,5,12,0,0,0,3,3,3,1,0,4,4,31,17.8
1,41,11,23,7,15,4,8,5,7,1,7,8,3,0,0,1,1,31,22
0,31,11,15,4,7,7,8,2,2,0,3,3,4,1,0,3,1,31,26.2
1,35,10,24,6,14,4,10,7,9,0,4,4,10,0,2,0,3,31,25.8
1,38,11,22,9,19,2,3,7,9,2,3,5,2,1,0,0,1,31,23.5
1,33,13,15,13,15,0,0,5,8,3,11,14,4,1,0,4,1,31,29.3
1,40,13,23,10,15,3,8,2,2,3,6,9,1,0,1,2,4,31,21.8
1,47,13,26,11,20,2,6,3,4,1,0,1,3,2,0,2,4,31,18.8
1,36,8,16,5,10,3,6,12,13,0,5,5,7,0,0,0,0,31,29
1,40,10,18,10,15,0,3,11,12,1,14,15,9,4,2,5,2,31,32.8
1,38,11,21,9,18,2,3,7,8,1,9,10,13,3,0,3,0,31,32.8
1,38,11,19,10,17,1,2,8,9,2,3,5,6,2,1,3,2,31,27.1
1,42,10,25,10,21,0,4,11,14,1,2,3,7,3,0,7,2,31,17.7
1,30,12,18,12,18,0,0,7,10,0,6,6,3,1,2,0,3,31,27.1
1,35,12,22,10,19,2,3,5,7,2,15,17,5,2,3,8,3,31,23.9
1,37,11,20,9,14,2,6,7,7,2,7,9,9,1,0,2,1,31,29.8
1,36,10,22,10,21,0,1,11,17,2,7,9,2,2,3,1,0,31,25.2
1,30,10,19,10,19,0,0,11,13,5,3,8,2,3,1,3,2,31,26.6
1,43,9,18,1,5,8,13,5,5,0,8,8,4,0,1,5,3,31,21.7
1,39,10,24,7,16,3,8,8,10,0,5,5,4,0,1,5,4,31,15.8
1,38,10,18,6,9,4,9,7,7,0,4,4,9,0,1,1,1,31,29.2
1,39,11,22,9,18,2,4,7,8,2,4,6,3,2,0,2,1,31,23.9
1,41,13,24,13,23,0,1,5,6,2,10,12,2,2,4,5,3,31,23.4
1,42,10,21,6,11,4,10,7,10,1,4,5,1,2,0,4,5,31,17.7
1,40,11,18,10,15,1,3,8,9,0,2,2,2,0,0,1,3,31,22.2
1,43,10,17,8,13,2,4,9,13,0,13,13,2,0,5,1,1,31,28.9
1,42,14,24,14,20,0,4,3,3,0,4,4,8,2,1,1,4,31,26.7
1,40,13,34,11,26,2,8,3,5,5,6,11,15,2,0,7,3,31,21.2
0,34,10,16,10,14,0,2,10,11,2,4,6,8,1,1,2,0,30,30.3
0,43,12,15,7,10,5,5,1,1,0,1,1,1,1,0,2,3,30,23.1
1,35,12,19,6,8,6,11,0,0,0,5,5,0,2,0,0,4,30,23.4
1,35,12,19,10,13,2,6,4,5,1,2,3,10,1,0,4,1,30,26
1,37,12,21,10,17,2,4,4,4,0,5,5,2,2,0,7,3,30,16.8
1,39,13,24,10,17,3,7,1,2,1,7,8,3,0,0,7,3,30,14.7
1,34,13,21,13,20,0,1,4,5,3,7,10,13,1,0,3,0,30,31.4
1,37,14,21,12,14,2,7,0,1,2,3,5,4,1,1,0,2,30,26.5
1,31,10,17,9,14,1,3,9,12,3,5,8,1,0,2,3,0,30,23.6
1,34,11,24,8,18,3,6,5,5,0,3,3,7,2,3,0,2,30,26.7
1,31,9,17,5,10,4,7,8,8,0,4,4,5,2,0,2,1,30,26
1,35,12,20,8,14,4,6,2,2,0,4,4,2,0,1,1,0,30,23.1
1,33,13,24,13,24,0,0,4,4,4,6,10,5,2,2,4,3,30,24.7
1,35,9,20,9,18,0,2,12,15,3,3,6,4,4,4,2,0,30,29
1,40,11,22,7,16,4,6,4,8,2,7,9,2,0,0,3,2,30,18.5
1,39,8,18,3,5,5,13,9,9,0,7,7,6,0,0,2,1,30,24.5
1,34,9,18,4,9,5,9,7,7,0,5,5,7,0,0,3,0,30,24.4
1,37,11,30,9,17,2,13,6,7,2,6,8,4,1,0,6,2,30,13.2
1,39,11,18,8,13,3,5,5,5,2,6,8,2,1,1,7,3,30,19.9
1,40,12,20,8,9,4,11,2,3,0,7,7,5,2,0,8,2,30,19.2
1,37,9,17,4,8,5,9,7,7,0,6,6,6,2,0,3,2,30,25.9
1,35,9,18,6,14,3,4,9,9,0,4,4,3,2,1,2,1,30,24.6
1,41,10,16,9,13,1,3,9,10,0,2,2,9,2,1,1,1,30,30.6
1,38,9,12,2,3,7,9,5,6,0,5,5,8,3,0,4,2,30,30.1
1,36,10,18,5,11,5,7,5,5,0,7,7,2,2,0,2,1,30,24.5
1,42,9,23,8,16,1,7,11,12,0,5,5,2,0,1,5,4,30,14.1
1,37,8,16,6,11,2,5,12,12,2,5,7,1,4,1,6,2,30,23.5
1,36,11,21,8,13,3,8,5,6,2,7,9,6,1,0,4,3,30,22.8
1,39,11,22,9,17,2,5,6,10,3,14,17,6,1,1,3,2,30,25.8
1,31,10,25,6,14,4,11,6,7,3,7,10,3,0,3,2,2,30,21.7
1,36,10,16,8,13,2,3,8,10,2,5,7,2,3,3,1,1,30,30
1,38,12,26,11,21,1,5,5,6,2,4,6,8,1,1,5,1,30,20.7
1,39,12,18,9,13,3,5,3,3,2,9,11,1,1,1,4,3,30,23.5
1,36,9,20,7,16,2,4,10,11,1,6,7,9,2,0,6,0,30,24
1,27,10,18,6,11,4,7,6,6,1,6,7,3,1,1,0,1,30,27.3
1,34,9,16,6,11,3,5,9,11,1,5,6,5,1,0,1,4,30,25.7
1,39,11,20,5,13,6,7,2,2,0,4,4,4,1,2,4,4,30,21.2
1,34,11,16,7,12,4,4,4,4,0,3,3,7,2,0,3,1,30,27.6
1,27,14,17,14,17,0,0,2,3,6,14,20,0,0,3,3,1,30,30.4
1,36,12,22,11,18,1,4,5,5,1,6,7,12,1,0,2,2,30,28.5
1,36,12,22,9,16,3,6,3,4,0,5,5,2,1,0,2,1,30,20.5
1,41,10,23,9,20,1,3,9,11,0,4,4,6,2,1,4,5,30,19.2
1,37,11,22,6,11,5,11,3,3,2,2,4,6,2,0,4,3,30,22
1,33,11,18,6,10,5,8,3,3,0,2,2,1,0,0,5,3,30,16.9
1,37,13,19,12,17,1,2,3,5,6,10,16,1,2,4,2,4,30,30.2
1,35,10,18,8,12,2,6,8,9,0,2,2,3,0,0,6,2,30,16.9
1,34,10,22,4,6,6,16,4,4,3,12,15,2,2,0,4,4,30,22.1
1,36,12,25,10,18,2,7,4,5,2,3,5,1,1,0,5,2,30,15.1
1,34,10,15,8,10,2,5,8,9,1,12,13,10,5,2,6,1,30,34.4
1,33,10,18,7,13,3,5,7,8,0,4,4,9,3,1,1,0,30,31.2
1,33,9,17,8,13,1,4,11,12,0,1,1,5,1,0,4,3,30,20.9
1,38,9,24,5,16,4,8,8,10,2,6,8,7,1,3,1,3,30,25
1,34,13,23,9,18,4,5,0,0,0,2,2,1,0,0,1,3,30,18.2
0,32,11,17,4,8,7,9,1,1,0,4,4,7,2,1,3,3,30,27.1
1,37,11,22,8,15,3,7,5,6,2,8,10,7,2,3,4,4,30,25.8
1,34,12,20,12,17,0,3,6,9,2,10,12,6,0,4,4,4,30,25.4
1,46,13,25,13,23,0,2,4,7,3,6,9,3,0,0,0,3,30,21.3
1,37,12,26,6,17,6,9,0,0,1,1,2,2,0,0,2,4,30,15.4
1,39,13,23,13,20,0,3,4,6,5,4,9,5,3,0,0,4,30,27.9
1,32,13,18,13,18,0,0,4,4,1,9,10,4,1,2,1,1,30,29.8
1,36,9,15,6,9,3,6,9,10,0,2,2,4,1,0,1,4,30,24.5
1,41,11,24,11,24,0,0,8,8,3,5,8,2,2,4,2,3,30,24.2
1,32,11,22,8,14,3,8,5,8,1,6,7,1,0,0,4,2,30,16.2
1,38,12,25,11,21,1,4,5,7,1,3,4,2,1,0,2,3,30,17.3
1,36,11,27,7,17,4,10,4,5,0,3,3,4,1,0,1,5,30,16.8
1,33,12,20,8,12,4,8,2,3,1,4,5,0,1,0,2,4,30,19.7
1,39,11,21,7,9,4,12,4,4,2,4,6,2,1,1,2,2,30,22.6
1,37,6,18,4,7,2,11,16,19,0,6,6,12,1,1,7,3,30,22.3
1,38,8,13,2,4,6,9,8,9,1,5,6,7,1,0,2,3,30,28.6
1,34,9,16,4,4,5,12,7,8,1,5,6,15,2,0,3,1,30,33.3
1,39,13,27,11,23,2,4,2,2,3,11,14,3,3,1,2,4,30,23.9
1,36,12,25,12,24,0,1,6,10,0,5,5,4,2,0,4,5,30,16
1,38,9,16,6,8,3,8,9,9,0,5,5,4,2,3,2,3,30,27.6
1,39,8,21,4,12,4,9,10,12,1,10,11,8,1,1,9,4,30,18.1
1,33,11,18,11,16,0,2,8,9,0,2,2,0,1,0,2,5,30,19
1,35,8,16,8,16,0,0,14,18,1,6,7,4,0,1,4,6,30,20
1,37,10,23,6,13,4,10,6,8,1,10,11,7,2,0,2,3,30,24.5
1,40,9,16,6,12,3,4,9,9,0,5,5,9,6,0,3,2,30,32.4
1,28,12,22,10,16,2,6,4,5,2,5,7,1,0,2,1,1,30,22.6
1,46,13,18,12,16,1,2,3,4,1,8,9,1,3,0,4,5,30,23
1,32,7,11,6,10,1,1,15,15,1,2,3,3,0,0,2,0,30,26.5
1,34,8,19,8,13,0,6,14,14,0,3,3,6,0,0,3,3,30,20.8
1,36,9,28,7,18,2,10,10,11,0,7,7,6,3,0,5,3,30,16.7
1,35,11,21,10,16,1,5,7,7,0,3,3,5,5,0,1,5,30,26.1
1,40,8,19,7,15,1,4,13,14,2,9,11,2,3,1,3,2,30,24.9
1,34,11,14,7,10,4,4,4,5,1,1,2,1,1,1,0,4,30,26
1,39,9,19,9,16,0,3,12,12,0,17,17,6,2,2,2,2,30,30.2
1,41,13,21,10,16,3,5,1,2,1,1,2,3,2,2,3,3,30,22.4
1,37,10,19,6,11,4,8,6,7,1,8,9,11,3,0,8,4,30,24.5
1,38,10,14,8,8,2,6,8,8,2,2,4,5,2,0,3,0,30,28.7
1,34,11,23,6,14,5,9,3,4,2,2,4,7,1,0,2,2,30,23
1,37,11,22,10,17,1,5,7,8,2,0,2,2,3,0,6,5,30,16.4
1,36,13,19,12,17,1,2,3,5,3,8,11,5,3,1,2,2,30,30
1,36,11,22,11,21,0,1,8,8,4,10,14,2,2,1,1,1,30,27.5
1,35,10,16,8,12,2,4,8,11,2,5,7,2,1,0,5,5,30,19.9
1,35,12,19,10,16,2,3,4,4,0,5,5,6,5,0,2,3,30,29
1,30,12,18,10,13,2,5,4,5,2,5,7,5,2,0,2,3,30,27
1,31,12,19,9,15,3,4,3,7,3,3,6,2,1,1,1,3,30,23.8
1,34,10,20,8,16,2,4,8,9,2,5,7,5,3,2,5,4,30,23.8
1,34,12,18,11,16,1,2,5,5,4,12,16,5,1,0,4,2,30,28.3
1,33,7,18,4,13,3,5,13,16,2,2,4,6,0,0,5,2,30,19.4
1,38,10,20,10,18,0,2,10,10,2,5,7,4,0,0,1,0,30,24.7
1,27,9,18,5,9,4,9,8,8,0,3,3,5,0,0,6,3,30,18.2
1,37,9,20,2,9,7,11,5,7,0,2,2,10,1,2,0,2,30,28
1,42,11,24,9,20,2,4,6,6,0,12,12,1,1,0,2,2,30,20.1
1,37,12,19,12,19,0,0,6,9,5,7,12,2,2,3,3,2,30,27.6
1,36,10,22,7,14,3,8,7,8,5,9,14,9,1,1,2,6,30,28
1,41,7,13,4,5,3,8,12,12,0,6,6,15,2,0,12,4,29,23.4
1,39,10,23,7,14,3,9,6,6,0,3,3,4,1,0,6,0,29,15.6
1,33,10,19,9,15,1,4,8,8,0,2,2,1,1,0,3,3,29,17.8
0,31,11,13,5,6,6,7,1,2,1,4,5,1,0,0,1,2,29,24.7
1,38,13,19,12,18,1,1,2,5,8,9,17,2,0,3,2,3,29,28.3
1,38,10,18,9,14,1,4,8,10,0,7,7,3,2,0,2,2,29,23
1,42,7,18,6,15,1,3,14,16,1,7,8,3,1,1,3,4,29,20.4
1,36,10,20,9,15,1,5,8,10,0,5,5,7,3,0,3,4,29,23
1,36,12,26,9,14,3,12,2,3,1,3,4,6,4,0,4,2,29,20.2
1,34,12,24,8,17,4,7,1,1,1,8,9,6,0,0,2,0,29,22.3
1,33,10,19,4,9,6,10,3,3,1,4,5,8,1,2,1,1,29,28.2
1,40,10,25,7,16,3,9,6,7,2,7,9,6,2,2,4,2,29,21.4
1,36,10,15,7,8,3,7,6,7,0,1,1,1,0,0,3,0,29,20.1
1,40,9,20,7,15,2,5,9,9,2,2,4,7,0,1,1,2,29,24.4
1,37,8,14,8,12,0,2,13,13,6,8,14,1,1,2,1,3,29,29.9
1,38,9,17,9,15,0,2,11,11,2,7,9,5,1,0,3,5,29,23.7
1,35,10,19,5,13,5,6,4,4,1,4,5,7,1,0,2,1,29,25.1
1,45,9,17,4,7,5,10,6,7,2,3,5,0,0,0,2,4,29,19
1,39,12,15,12,15,0,0,5,12,6,10,16,2,0,2,1,4,29,27.9
1,39,10,19,7,13,3,6,6,8,1,2,3,8,0,0,0,2,29,25
1,36,11,23,7,14,4,9,3,4,0,2,2,6,0,0,2,3,29,18.5
1,36,9,16,6,8,3,8,8,9,2,0,2,3,2,1,0,4,29,25.6
0,24,10,18,6,7,4,11,5,5,0,1,1,5,2,1,1,0,29,25.9
1,37,7,15,7,14,0,1,15,16,2,5,7,6,2,1,2,4,29,27.1
1,31,12,20,9,13,3,7,2,2,1,4,5,5,2,5,5,1,29,25.3
1,37,11,20,9,13,2,7,5,5,0,1,1,4,3,0,4,3,29,20.3
0,28,10,17,3,5,7,12,2,2,0,1,1,1,1,1,2,1,29,21.4
1,36,10,17,5,10,5,7,4,4,0,1,1,3,0,0,1,3,29,21.3
1,36,9,22,5,13,4,9,7,7,0,7,7,3,1,2,1,3,29,21.6
1,39,10,18,8,14,2,4,7,9,1,3,4,6,0,0,2,2,29,22.6
1,37,11,22,11,21,0,1,7,10,0,17,17,11,0,0,7,0,29,22.6
1,34,7,9,3,3,4,6,11,12,1,5,6,10,3,2,6,3,29,31.5
1,37,10,20,9,15,1,5,8,11,0,1,1,0,1,1,3,2,29,16
1,42,10,24,7,18,3,6,6,9,0,2,2,3,0,2,4,1,29,14.7
1,34,11,17,10,13,1,4,6,7,1,2,3,4,0,0,1,3,29,23
1,37,12,19,11,16,1,3,4,4,2,5,7,6,1,0,3,3,29,24.4
1,36,11,24,9,19,2,5,5,7,1,9,10,3,0,0,4,6,29,14.9
1,32,9,18,8,13,1,5,10,10,4,7,11,4,1,1,1,2,29,27.6
1,40,9,19,8,14,1,5,10,12,2,14,16,6,0,1,1,3,29,26.8
1,33,11,19,8,13,3,6,4,6,1,5,6,9,1,2,2,4,29,26.6
1,39,11,27,10,20,1,7,6,7,0,1,1,4,0,1,0,3,29,16.7
1,34,9,19,5,9,4,10,7,9,0,1,1,8,0,0,1,2,29,22.6
1,33,8,21,8,19,0,2,13,16,3,6,9,1,2,2,3,2,29,20.5
1,43,9,18,7,14,2,4,9,10,4,10,14,3,2,1,6,2,29,23.4
1,40,11,21,7,11,4,10,3,3,2,2,4,8,1,1,0,1,29,27.6
1,37,10,20,7,14,3,6,6,7,1,5,6,5,4,0,4,0,29,24.3
1,32,11,18,7,10,4,8,3,3,0,3,3,2,1,0,0,3,29,22.9
0,32,10,18,10,17,0,1,9,11,7,5,12,2,1,1,4,5,29,23.1
1,35,12,17,12,16,0,1,5,6,0,6,6,11,1,0,4,4,29,26.4
1,39,9,24,7,17,2,7,9,9,2,5,7,2,1,1,2,2,29,19
1,37,9,14,8,11,1,3,10,10,0,4,4,12,0,0,6,1,29,26
1,34,12,22,12,17,0,5,5,5,0,0,0,7,2,0,3,2,29,21.5
1,32,9,20,7,11,2,9,9,10,0,2,2,3,1,0,1,3,29,19.7
1,37,9,15,5,9,4,6,7,7,1,0,1,7,1,0,6,1,29,22.3
1,37,8,23,3,10,5,13,8,8,2,4,6,5,3,0,5,3,29,19
0,35,14,22,14,22,0,0,1,1,3,7,10,0,0,1,3,3,29,19.9
1,36,10,14,8,12,2,2,7,8,1,3,4,3,1,0,4,4,29,21.9
1,37,8,21,4,12,4,9,9,9,2,2,4,1,1,0,1,1,29,19.8
1,45,11,16,9,11,2,5,5,7,0,6,6,7,2,0,7,5,29,21.1
1,34,8,18,4,9,4,9,9,9,0,3,3,7,0,0,3,3,29,21.2
1,37,11,19,8,12,3,7,4,4,1,5,6,2,0,0,1,1,29,22.3
1,30,10,25,5,16,5,9,4,5,2,4,6,4,1,4,3,4,29,19.7
1,35,9,17,6,11,3,6,8,8,3,10,13,3,2,0,2,0,29,27.9
1,34,12,23,9,16,3,7,2,2,2,1,3,7,1,0,4,4,29,19.7
1,39,10,23,10,22,0,1,9,10,1,4,5,6,3,1,0,2,29,25.5
1,34,8,24,6,14,2,10,11,13,0,6,6,5,2,1,1,4,29,20
1,36,10,17,4,6,6,11,3,3,0,4,4,2,2,0,4,3,29,20.5
1,37,11,23,8,13,3,10,4,4,1,2,3,11,3,0,4,1,29,24.9
1,35,12,22,10,16,2,6,3,3,0,3,3,10,1,0,2,3,29,24.1
1,34,7,15,1,3,6,12,9,11,2,9,11,13,0,0,4,2,29,28.9
1,39,11,18,7,12,4,6,3,5,0,5,5,5,1,2,2,1,29,25
1,38,10,21,8,17,2,4,7,7,4,3,7,2,1,0,0,4,29,22.8
1,35,9,20,5,12,4,8,7,7,1,3,4,11,1,0,2,5,29,24.9
1,30,11,18,9,13,2,5,5,5,0,3,3,1,2,0,2,2,29,21.6
1,34,10,20,4,8,6,12,3,4,0,3,3,4,4,0,4,1,29,21.9
1,28,9,17,6,12,3,5,8,8,2,1,3,4,1,0,2,1,29,23.8
0,28,10,15,8,11,2,4,7,7,0,4,4,3,4,1,2,3,29,27.3
1,29,12,20,7,11,5,9,0,0,0,4,4,5,0,1,3,1,29,21.8
1,37,8,13,4,6,4,7,9,10,0,3,3,8,2,0,2,4,29,27.6
1,35,9,25,6,20,3,5,8,9,1,13,14,9,1,0,4,5,29,20.6
0,29,5,9,2,3,3,6,16,16,2,7,9,0,0,0,0,0,29,28.2
1,33,13,24,10,15,3,9,0,2,2,5,7,1,0,0,1,3,29,18
1,35,11,20,9,12,2,8,5,5,0,2,2,1,4,0,2,5,29,20.7
1,38,11,25,8,20,3,5,4,4,1,3,4,0,0,0,0,1,29,17.1
1,30,12,22,8,15,4,7,1,1,1,1,2,4,2,0,0,1,29,23.8
1,38,10,21,8,16,2,5,7,7,0,9,9,5,1,2,4,2,29,22.1
1,39,12,22,12,16,0,6,5,8,4,10,14,10,1,0,3,1,29,27.6
1,36,12,20,12,19,0,1,5,6,1,3,4,3,0,2,1,3,29,22.3
1,39,11,20,8,13,3,7,4,5,3,5,8,4,0,2,1,4,29,24.2
1,36,12,21,12,19,0,2,5,6,8,6,14,8,1,2,3,2,29,30.3
1,31,12,16,9,12,3,4,2,2,0,4,4,3,1,0,2,0,29,24.9
1,35,10,20,7,13,3,7,6,9,0,7,7,5,2,1,5,4,29,19.5
1,41,13,22,10,14,3,8,0,1,1,2,3,9,2,0,2,2,29,25.2
1,35,14,21,13,16,1,5,0,0,4,10,14,2,0,0,1,3,29,24.9
1,35,10,18,5,10,5,8,4,4,0,4,4,15,1,0,1,3,29,30.9
1,35,9,16,5,9,4,7,7,9,0,2,2,5,0,0,3,2,29,20.9
1,40,12,22,7,13,5,9,0,0,1,4,5,6,2,0,2,5,29,22.5
1,33,9,16,9,14,0,2,11,14,5,2,7,4,1,0,3,6,29,22.7
1,36,10,16,6,8,4,8,5,6,0,2,2,3,3,0,4,2,29,22.3
1,34,10,14,10,14,0,0,9,10,1,7,8,5,1,1,1,1,29,29.4
0,30,10,14,10,14,0,0,9,11,2,0,2,3,1,1,0,4,29,26
1,35,8,14,4,10,4,4,9,12,0,2,2,11,3,0,0,2,29,31.7
1,41,8,21,8,18,0,3,13,14,2,6,8,14,0,2,6,2,29,24.7
1,38,9,17,4,7,5,10,6,6,0,3,3,2,0,0,3,1,29,19.6
1,34,9,20,4,10,5,10,6,6,0,5,5,3,3,0,1,2,29,23.4
1,40,11,17,7,13,4,4,3,4,1,3,4,7,2,0,5,1,29,24.2
1,31,8,18,4,11,4,7,9,9,1,3,4,2,0,0,4,1,29,18.2
1,34,12,22,11,17,1,5,4,6,7,8,15,1,0,3,2,3,29,24.5
0,26,10,12,2,3,8,9,1,1,0,5,5,0,0,0,1,2,29,24.3
1,30,8,11,7,9,1,2,12,12,2,5,7,1,1,1,1,2,29,28
1,46,8,23,6,12,2,11,11,14,1,14,15,13,2,1,7,4,29,23
1,35,10,17,9,13,1,4,8,9,1,4,5,10,1,0,1,2,29,28.8
1,37,11,21,10,18,1,3,6,8,0,5,5,13,3,0,2,2,29,28.7
1,37,11,17,11,15,0,2,7,7,2,15,17,1,2,3,2,4,29,28.6
0,44,10,20,3,9,7,11,2,2,0,0,0,3,0,0,1,2,29,19.3
1,40,9,14,9,14,0,0,11,14,2,14,16,8,1,5,4,4,29,31.7
1,35,12,24,7,15,5,9,0,0,0,2,2,5,0,1,0,2,29,21
1,30,9,17,2,5,7,12,4,5,0,2,2,0,1,1,1,2,29,20.8
1,36,10,19,7,11,3,8,6,6,0,7,7,4,1,1,4,3,29,21.1
1,27,11,16,6,9,5,7,2,4,0,8,8,5,1,1,3,1,29,25.6
1,35,11,27,9,21,2,6,5,5,1,11,12,11,4,0,7,4,29,21.6
1,37,11,17,10,14,1,3,6,7,2,2,4,2,3,0,3,0,29,24.5
1,36,11,19,6,8,5,11,2,2,0,4,4,2,1,1,2,0,29,22.4
1,39,12,20,9,12,3,8,2,2,2,0,2,6,0,0,1,3,29,23.2
1,40,12,18,7,11,5,7,0,0,1,9,10,5,2,0,3,4,29,25.5
1,33,11,18,10,17,1,1,5,6,1,3,4,1,1,1,1,2,28,21.6
1,41,9,21,6,15,3,6,7,9,3,5,8,7,2,1,2,5,28,23.3
1,39,11,17,7,9,4,8,2,4,1,2,3,3,0,0,2,3,28,19.9
1,35,10,16,6,9,4,7,4,5,0,10,10,4,0,1,3,3,28,22.7
1,38,8,18,2,7,6,11,6,6,2,12,14,0,0,0,2,2,28,20.8
1,32,10,16,7,10,3,6,5,5,1,1,2,6,0,0,4,3,28,20.8
1,40,10,21,6,9,4,12,4,4,1,5,6,9,0,1,4,1,28,22.1
1,35,12,20,12,14,0,6,4,6,1,8,9,3,0,0,1,5,28,20.2
1,36,9,20,5,11,4,9,6,7,3,5,8,10,4,0,7,1,28,24.4
1,30,9,16,3,8,6,8,4,5,1,3,4,4,1,0,1,1,28,24
1,38,10,17,8,14,2,3,6,8,2,3,5,5,3,0,2,2,28,25.3
1,31,9,16,5,7,4,9,6,6,0,8,8,2,0,2,6,3,28,18.4
1,35,10,22,6,13,4,9,4,4,2,4,6,7,1,0,1,1,28,23.7
1,52,13,20,13,20,0,0,2,3,2,12,14,0,4,2,1,4,28,26.6
1,31,11,20,8,14,3,6,3,4,2,5,7,6,0,1,2,0,28,23.8
1,41,11,16,7,9,4,7,2,3,2,7,9,1,1,0,5,5,28,19
1,38,9,18,9,18,0,0,10,13,7,13,20,8,2,6,3,5,28,33.4
1,37,9,17,6,8,3,9,7,7,0,5,5,8,2,0,2,3,28,25.6
1,39,11,30,11,25,0,5,6,9,2,9,11,9,3,1,2,3,28,21.1
1,42,9,15,4,5,5,10,5,6,1,4,5,3,0,0,0,1,28,24.3
0,28,8,15,3,5,5,10,7,8,1,2,3,1,1,1,1,4,28,21.4
1,44,10,16,8,12,2,4,6,7,0,4,4,7,1,1,4,3,28,23
1,40,9,18,7,13,2,5,8,9,1,9,10,3,0,0,3,3,28,19.9
1,29,13,19,13,17,0,2,2,3,1,4,5,3,1,0,0,2,28,23.7
1,30,10,21,5,11,5,10,3,4,1,3,4,3,1,0,4,3,28,16.4
1,30,9,17,5,11,4,6,6,6,0,3,3,6,0,0,2,1,28,22.4
1,38,6,17,4,8,2,9,14,19,2,6,8,11,0,1,6,2,28,21.3
1,35,11,14,5,5,6,9,0,0,1,7,8,1,0,0,1,2,28,24.3
1,35,11,16,11,14,0,2,6,6,4,7,11,3,0,0,5,1,28,22.8
1,36,7,18,6,13,1,5,13,15,1,2,3,4,0,0,2,2,28,18.7
1,34,8,19,7,15,1,4,11,12,0,2,2,2,0,0,4,2,28,14.7
1,34,13,16,12,14,1,2,1,1,1,2,3,3,0,0,2,0,28,23.4
1,38,9,14,3,3,6,11,4,4,1,9,10,1,0,1,2,2,28,23.8
1,40,8,20,6,13,2,7,10,11,2,4,6,7,0,0,3,4,28,19.7
1,36,10,20,6,13,4,7,4,5,0,6,6,8,2,0,4,2,28,22.2
1,37,10,16,6,9,4,7,4,5,1,1,2,1,0,1,1,1,28,21.4
1,35,11,20,9,13,2,7,4,4,2,5,7,6,0,1,2,5,28,22.2
1,35,8,19,5,13,3,6,9,10,1,7,8,6,2,1,2,5,28,23.2
1,32,7,13,6,9,1,4,13,14,1,4,5,5,2,1,1,1,28,28
1,41,11,18,10,16,1,2,5,7,3,10,13,7,0,0,7,3,28,20.8
1,39,12,15,8,9,4,6,0,0,1,4,5,2,3,1,1,1,28,27.9
1,39,10,16,7,10,3,6,5,6,1,1,2,4,3,0,3,2,28,23.4
1,33,11,21,8,13,3,8,3,5,2,5,7,5,0,2,0,0,28,24.7
1,36,10,14,9,13,1,1,7,8,0,8,8,3,2,5,6,2,28,25
1,36,10,22,10,20,0,2,8,8,1,6,7,0,0,0,0,3,28,17.9
1,29,10,23,8,16,2,7,6,8,1,4,5,8,2,1,3,1,28,21.9
1,32,13,22,11,15,2,7,0,0,1,6,7,3,1,0,5,3,28,17.2
1,36,9,17,6,8,3,9,7,8,0,4,4,2,0,0,2,2,28,19.1
1,36,11,23,5,11,6,12,0,0,0,2,2,6,1,1,4,2,28,18
1,35,11,24,11,22,0,2,6,7,0,3,3,3,1,2,3,2,28,16.8
1,32,12,18,10,12,2,6,2,2,1,1,2,4,1,0,3,1,28,21.6
1,36,10,25,7,19,3,6,5,8,3,6,9,4,2,0,4,3,28,16.8
1,31,9,18,3,6,6,12,4,6,1,3,4,5,1,0,0,2,28,23.5
1,30,11,15,9,11,2,4,4,5,1,5,6,5,1,1,1,3,28,26.7
1,38,10,17,7,13,3,4,5,5,3,7,10,5,0,6,3,1,28,28.6
1,39,8,20,4,12,4,8,8,8,2,8,10,0,0,0,2,0,28,19
1,45,7,16,7,15,0,1,14,21,2,12,14,9,1,2,4,3,28,25.3
1,39,6,16,3,8,3,8,13,14,1,1,2,3,0,1,5,1,28,17.2
0,26,12,13,12,13,0,0,4,6,3,2,5,0,0,1,1,2,28,24.5
1,39,11,19,9,14,2,5,4,4,0,8,8,7,3,1,3,3,28,25.9
1,35,11,18,10,12,1,6,5,7,0,5,5,10,4,0,1,3,28,29.3
1,36,11,25,9,21,2,4,4,5,2,4,6,7,0,0,1,3,28,19.8
1,41,12,16,12,16,0,0,4,6,3,13,16,1,0,5,1,1,28,29.6
1,31,10,17,7,12,3,5,5,5,0,4,4,6,0,2,3,3,28,22.7
1,29,11,19,11,19,0,0,6,6,6,4,10,1,0,0,0,2,28,24.4
1,45,8,23,5,16,3,7,9,9,0,5,5,5,0,0,2,1,28,17.7
1,33,11,20,11,17,0,3,6,8,1,3,4,4,2,2,2,5,28,21.4
1,37,11,18,10,16,1,2,5,6,3,2,5,5,2,0,2,1,28,25.2
1,39,11,21,9,12,2,9,4,4,0,2,2,4,1,0,1,0,28,21.1
1,30,11,17,11,16,0,1,6,8,2,2,4,5,3,0,1,2,28,26.4
1,38,10,22,5,13,5,9,3,3,1,1,2,1,0,0,1,1,28,16.9
1,36,8,16,6,13,2,3,10,13,0,5,5,4,3,0,1,1,28,24.7
1,29,10,18,4,9,6,9,2,2,0,5,5,3,0,0,3,2,28,19.2
1,38,10,16,5,9,5,7,3,4,1,6,7,3,1,0,4,3,28,20.8
1,31,12,14,12,14,0,0,4,9,5,10,15,0,0,2,1,4,28,26.3
1,36,10,19,6,14,4,5,4,6,0,5,5,6,0,0,1,2,28,21.8
1,40,11,20,8,12,3,8,3,4,0,4,4,1,1,1,3,3,28,17.4
1,38,9,22,5,9,4,13,6,6,1,2,3,5,3,1,5,6,28,17.3
1,32,10,19,8,13,2,6,6,6,0,2,2,1,1,1,2,4,28,18.1
1,40,11,23,7,15,4,8,2,2,3,2,5,9,4,0,1,3,28,27.1
1,40,9,26,6,17,3,9,7,8,0,2,2,0,3,0,3,6,28,11.2
1,36,6,17,4,9,2,8,14,14,1,4,5,0,0,0,3,3,28,16.2
1,35,9,18,9,17,0,1,10,11,0,1,1,4,1,0,2,4,28,19.1
1,41,11,26,7,16,4,10,2,2,5,3,8,10,0,0,3,4,28,21
1,36,9,17,6,11,3,6,7,7,0,6,6,5,0,0,5,2,28,19.2
1,44,9,17,7,11,2,6,8,9,1,7,8,8,1,0,4,2,28,23.9
0,35,11,22,9,19,2,3,4,4,3,8,11,5,1,1,2,3,28,23.5
1,38,11,20,9,16,2,4,4,5,0,4,4,2,0,1,3,4,28,16.7
1,37,11,21,9,17,2,4,4,4,2,2,4,5,1,0,7,2,28,16.4
1,39,8,18,8,18,0,0,12,15,1,7,8,7,4,0,3,2,28,25.3
1,37,12,30,11,22,1,8,3,4,1,7,8,6,2,0,3,5,28,15.4
1,32,9,21,7,10,2,11,8,9,0,1,1,9,0,0,0,4,28,21.5
1,34,9,17,4,9,5,8,5,5,0,1,1,3,0,0,1,5,28,19.1
1,34,8,15,6,9,2,6,10,11,0,5,5,6,1,1,3,3,28,23.5
1,37,10,20,7,13,3,7,5,6,2,7,9,1,1,2,1,5,28,21.2
1,36,11,14,8,9,3,5,3,4,0,0,0,4,0,0,3,2,28,21.2
1,34,11,18,7,13,4,5,2,2,0,1,1,4,2,1,6,3,28,18.4
1,39,11,24,11,22,0,2,6,7,1,5,6,8,0,0,2,1,28,20.6
1,33,10,17,6,9,4,8,4,5,1,3,4,0,2,0,1,2,28,21.5
1,36,9,15,7,11,2,4,8,9,0,7,7,6,1,4,1,1,28,29.4
1,37,10,21,7,15,3,6,5,5,1,7,8,0,1,2,2,2,28,19.7
1,36,12,17,9,13,3,4,1,1,1,20,21,3,1,0,0,2,28,29.9
1,37,8,14,8,13,0,1,12,14,5,11,16,4,0,2,6,4,28,24
1,35,10,19,5,11,5,8,3,4,0,5,5,5,1,0,3,1,28,20.9
1,39,9,16,6,12,3,4,7,10,1,7,8,6,4,2,3,1,28,28.2
1,35,9,20,7,15,2,5,8,8,0,6,6,9,0,0,4,2,28,20.9
1,30,9,13,3,5,6,8,4,4,0,4,4,4,1,1,3,3,28,24
1,30,11,22,11,21,0,1,6,8,2,2,4,2,0,0,0,1,28,19.2
1,35,11,16,9,12,2,4,4,4,0,3,3,6,0,0,0,2,28,25.5
1,34,9,16,8,12,1,4,9,13,1,3,4,4,0,1,1,3,28,21.7
1,35,10,21,6,12,4,9,4,7,3,6,9,2,4,1,3,2,28,22.3
1,38,10,22,8,13,2,9,6,8,2,6,8,2,3,2,0,2,28,24
1,46,11,25,8,19,3,6,3,4,1,10,11,10,3,2,3,2,28,25.8
1,43,8,20,5,9,3,11,9,11,0,9,9,13,1,2,7,5,28,21.6
1,39,10,17,9,14,1,3,7,11,3,6,9,9,2,1,1,4,28,28.8
1,31,11,18,8,10,3,8,3,4,5,10,15,3,1,1,3,1,28,26.3
1,36,9,19,2,3,7,16,3,4,3,3,6,0,3,1,2,2,28,21.8
1,40,11,17,9,13,2,4,4,6,3,5,8,4,1,0,7,3,28,18.9
1,28,9,18,5,13,4,5,6,8,2,4,6,8,3,0,2,3,28,26.2
0,34,11,18,10,17,1,1,5,6,1,4,5,4,2,3,4,2,28,23.4
1,41,12,19,12,19,0,0,4,7,7,15,22,3,2,2,1,2,28,31.4
1,36,9,20,4,11,5,9,5,6,3,5,8,3,1,2,3,2,28,21.5
1,36,11,13,11,13,0,0,6,7,1,7,8,6,1,2,4,3,28,27.1
1,36,9,18,6,12,3,6,7,7,1,6,7,7,0,0,2,3,28,23.2
1,40,9,21,7,15,2,6,8,11,0,2,2,3,1,3,1,0,28,20.5
1,37,9,19,8,15,1,4,9,9,0,10,10,1,1,1,2,2,28,20.9
1,38,10,15,8,10,2,5,6,10,0,9,9,15,1,0,5,2,28,28.3
1,37,11,25,8,21,3,4,3,3,3,4,7,7,1,1,4,2,28,20
1,35,11,18,10,15,1,3,5,5,4,11,15,3,0,2,4,4,28,23.8
1,33,9,19,6,13,3,6,7,7,1,8,9,4,1,0,2,3,28,22
1,35,12,24,11,21,1,3,3,5,1,1,2,3,2,1,6,3,28,13.8
1,37,9,21,7,14,2,7,8,8,0,1,1,7,0,1,3,3,28,18.6
1,34,10,26,8,19,2,7,6,8,3,6,9,3,1,4,2,4,28,19.2
1,39,8,23,5,14,3,9,9,12,1,6,7,8,1,0,8,4,28,13.4
1,31,10,16,5,11,5,5,3,4,3,4,7,5,1,1,2,1,28,26.5
1,37,11,25,9,19,2,6,4,4,1,1,2,1,1,3,1,1,28,18.3
1,28,9,18,4,9,5,9,5,6,2,9,11,2,2,1,1,2,28,25
1,37,9,19,5,9,4,10,6,6,0,3,3,7,2,0,1,4,28,23.5
1,37,12,18,11,16,1,2,3,4,3,10,13,0,0,2,4,0,28,22.3
1,41,13,26,13,26,0,0,2,4,1,4,5,3,1,0,3,1,28,15.8
1,39,10,22,6,12,4,10,4,5,0,9,9,3,1,0,3,3,28,17.8
1,33,10,18,7,11,3,7,5,5,1,7,8,1,0,2,2,4,28,20.7
1,28,9,19,6,12,3,7,7,9,2,2,4,5,0,0,1,5,28,20
1,34,10,20,4,11,6,9,2,2,1,3,4,4,3,0,0,3,28,24.2
1,36,9,25,9,19,0,6,10,12,3,9,12,6,3,1,3,2,28,22.2
0,30,11,17,11,17,0,0,6,7,6,3,9,2,1,0,4,2,28,22.8
0,34,12,20,12,19,0,1,4,4,3,6,9,1,1,0,1,1,28,23
1,41,12,24,12,23,0,1,4,5,0,2,2,1,2,0,2,5,28,14.9
1,41,13,20,11,16,2,4,0,0,1,7,8,0,0,1,2,2,28,19.9
1,38,10,23,8,15,2,8,6,9,1,16,17,12,1,0,10,1,28,19.2
1,45,12,24,10,17,2,7,2,4,3,2,5,4,2,0,2,2,28,19.9
1,37,10,12,6,7,4,5,4,5,0,9,9,2,1,1,1,1,28,27.6
1,37,10,23,7,13,3,10,5,6,0,3,3,8,0,2,3,4,28,18.8
1,35,11,19,8,14,3,5,3,7,1,4,5,3,2,0,0,2,28,22.7
1,39,9,16,9,13,0,3,10,11,1,1,2,7,0,1,1,1,28,25.2
1,36,7,18,4,7,3,11,11,12,0,2,2,8,2,0,3,1,28,22.6
1,48,10,27,9,23,1,4,7,7,0,16,16,1,1,4,1,1,28,21
1,36,7,14,7,10,0,4,14,16,2,12,14,7,2,1,7,3,28,24.6
1,39,10,20,5,10,5,10,3,4,0,1,1,5,2,1,4,0,28,20.1
1,32,11,23,11,20,0,3,6,6,5,4,9,2,0,2,3,2,28,20
1,33,11,20,11,20,0,0,6,8,2,4,6,2,1,2,2,3,28,20.8
1,31,12,21,9,15,3,6,1,1,1,3,4,3,0,0,2,2,28,19
1,36,9,21,4,8,5,13,5,5,1,3,4,9,0,0,5,1,28,19.4
0,25,8,12,5,6,3,6,9,9,0,2,2,3,2,0,0,2,28,26.7
1,40,10,21,7,15,3,6,5,8,5,8,13,10,1,1,4,3,28,25.5
1,37,10,17,8,14,2,3,6,9,7,15,22,1,1,4,3,3,28,28.6
1,30,10,21,8,11,2,10,5,5,1,3,4,3,1,0,4,4,27,15.4
1,36,9,19,6,12,3,7,6,7,0,4,4,11,0,1,1,2,27,24.7
1,43,11,20,7,11,4,9,1,1,3,5,8,4,2,1,1,1,27,25.1
1,35,7,17,7,16,0,1,13,18,2,6,8,1,3,3,2,2,27,22.1
1,29,10,14,3,6,7,8,0,0,0,4,4,2,0,1,2,3,27,21.3
1,37,11,18,10,15,1,3,4,5,0,10,10,4,2,2,0,2,27,26.8
1,36,8,24,4,13,4,11,7,7,2,1,3,2,1,0,3,3,27,13.3
1,34,9,16,8,15,1,1,8,8,3,9,12,5,0,0,4,2,27,22.9
0,30,8,14,5,7,3,7,8,9,0,4,4,1,1,0,2,0,27,20.9
1,34,10,19,8,14,2,5,5,6,2,4,6,4,2,1,1,2,27,23.6
1,37,10,21,7,15,3,6,4,5,0,6,6,7,0,1,0,1,27,22.9
0,35,10,24,4,13,6,11,1,3,5,10,15,0,1,0,2,3,27,17.7
0,28,8,17,5,10,3,7,8,8,0,2,2,1,0,0,1,1,27,18.2
1,40,9,22,8,14,1,8,8,10,0,5,5,5,1,0,2,5,27,16.4
1,36,7,22,3,13,4,9,9,12,1,11,12,10,1,1,8,3,27,16.7
1,39,7,16,6,10,1,6,12,13,3,6,9,4,1,1,5,0,27,21.6
1,35,11,19,10,14,1,5,4,5,4,10,14,5,5,4,1,4,27,32.2
1,32,13,20,12,18,1,2,0,0,4,7,11,1,1,1,3,4,27,20.9
1,41,10,21,9,18,1,3,6,8,2,1,3,5,2,1,3,1,27,20
1,43,9,17,3,7,6,10,3,4,3,7,10,2,1,0,1,3,27,22.7
1,35,9,19,6,13,3,6,6,7,1,1,2,4,1,0,6,3,27,14.5
0,27,9,12,1,2,8,10,1,1,1,1,2,1,0,0,1,2,27,22.1
1,45,10,20,8,15,2,5,5,6,3,1,4,4,3,3,5,4,27,20.3
1,40,9,21,9,19,0,2,9,10,1,2,3,2,3,0,2,3,27,18
1,36,8,13,5,7,3,6,8,8,0,4,4,3,1,0,2,2,27,22.6
1,34,12,22,11,20,1,2,2,3,1,8,9,4,0,0,2,4,27,18.3
1,41,8,11,8,11,0,0,11,17,10,15,25,1,1,2,3,3,27,30.5
1,29,11,20,7,15,4,5,1,1,0,1,1,2,0,1,1,1,27,18.4
1,33,10,20,7,13,3,7,4,4,0,0,0,4,0,0,2,0,27,17.8
0,35,8,16,4,11,4,5,7,8,0,2,2,5,1,1,0,1,27,24
1,40,10,21,8,15,2,6,5,6,2,7,9,2,1,0,4,4,27,16.2
1,28,8,14,1,5,7,9,4,4,1,9,10,4,3,0,1,1,27,28.2
1,30,8,13,4,8,4,5,7,9,0,5,5,5,1,0,2,4,27,22.7
1,33,9,18,4,7,5,11,4,4,1,6,7,12,6,0,3,0,27,31.9
1,33,11,16,10,15,1,1,4,4,0,5,5,12,2,0,6,1,27,25.7
0,25,9,12,3,5,6,7,3,3,0,2,2,0,0,0,2,2,27,20
1,38,9,18,8,16,1,2,8,10,6,7,13,4,0,2,5,2,27,21.9
0,24,10,14,4,6,6,8,1,1,1,2,3,1,0,0,0,1,27,22.8
1,38,8,21,3,12,5,9,6,6,1,3,4,4,2,1,1,0,27,21.6
1,33,11,16,10,14,1,2,4,5,1,7,8,6,1,2,1,1,27,27.8
1,35,10,22,9,19,1,3,6,8,2,2,4,1,4,0,0,1,27,21.1
1,39,9,22,8,20,1,2,8,9,1,8,9,6,3,1,2,2,27,23
1,42,8,18,5,11,3,7,8,9,0,6,6,7,0,0,3,4,27,19.3
0,31,10,13,5,6,5,7,2,2,0,0,0,4,1,0,2,0,27,23.7
0,29,10,19,6,10,4,9,3,3,0,3,3,6,0,0,1,3,27,20.6
1,27,10,19,6,12,4,7,3,4,4,2,6,2,2,0,1,5,27,21.1
1,32,8,15,4,6,4,9,7,7,0,3,3,4,1,0,2,2,27,21.6
1,37,7,20,6,19,1,1,12,13,1,7,8,5,0,0,2,2,27,18.9
1,39,8,18,5,13,3,5,8,8,2,0,2,4,1,0,2,1,27,20.4
1,36,8,12,3,5,5,7,6,6,0,4,4,0,1,0,0,3,27,22.8
1,30,10,19,5,11,5,8,2,2,0,5,5,4,5,0,1,3,27,24.8
1,35,9,16,4,7,5,9,4,5,1,6,7,0,1,0,0,2,27,21.7
1,43,7,17,7,12,0,5,13,18,2,11,13,4,0,3,4,1,27,21.1
1,36,12,26,9,20,3,6,0,0,0,2,2,3,3,3,4,5,27,15.4
1,35,10,15,10,15,0,0,7,10,1,14,15,1,1,4,1,2,27,26.9
1,35,10,25,7,17,3,8,4,6,2,2,4,6,1,0,1,0,27,18.9
1,25,9,15,5,7,4,8,5,5,2,6,8,4,1,0,2,2,27,24.3
1,24,9,15,6,10,3,5,6,9,3,3,6,0,0,2,0,4,27,21.7
1,35,8,13,3,3,5,10,6,8,1,9,10,12,4,1,4,3,27,31.6
1,39,10,20,7,13,3,7,4,4,1,2,3,0,1,0,5,2,27,13.5
1,30,12,24,11,20,1,4,2,2,2,3,5,6,0,0,4,3,27,16.3
1,31,8,13,6,10,2,3,9,10,0,2,2,0,0,0,1,1,27,19.9
1,39,12,27,10,19,2,8,1,1,0,6,6,9,1,0,8,4,27,12.4
0,25,9,16,2,5,7,11,2,2,1,1,2,2,0,0,1,1,27,20.4
1,31,7,25,5,20,2,5,11,13,1,5,6,5,1,0,5,4,27,11.6
1,35,10,24,5,13,5,11,2,2,1,3,4,5,1,1,3,4,27,16.4
1,38,11,21,8,11,3,10,2,3,2,4,6,7,2,0,1,4,27,23.2
1,35,9,21,4,11,5,10,4,4,1,4,5,5,3,0,4,2,27,19.5
1,39,10,19,9,16,1,3,6,6,0,4,4,8,3,1,4,0,27,24.2
1,38,8,15,8,13,0,2,11,12,0,2,2,17,1,0,1,5,27,29.8
1,35,6,21,4,15,2,6,13,15,1,5,6,2,1,1,0,0,27,19.2
0,34,8,13,3,4,5,9,6,6,2,4,6,2,1,0,0,1,27,25.7
1,33,10,15,6,8,4,7,3,5,2,3,5,1,0,0,0,5,27,20.7
1,40,9,22,4,10,5,12,4,5,2,4,6,11,2,0,3,3,27,22.9
1,34,10,22,10,20,0,2,7,7,4,11,15,1,1,2,2,3,27,21.6
1,40,8,17,5,11,3,6,8,9,0,6,6,3,0,0,2,3,27,18.6
1,24,8,19,7,16,1,3,10,12,0,4,4,6,1,0,2,2,27,19.7
0,33,9,14,3,5,6,9,3,3,0,1,1,2,1,0,3,0,27,20.5
1,37,11,18,8,11,3,7,2,2,0,5,5,3,1,1,2,4,27,20.5
1,36,11,20,8,12,3,8,2,2,1,1,2,5,2,1,1,0,27,23.6
1,41,10,21,8,17,2,4,5,8,0,3,3,2,2,0,4,4,27,13.8
1,33,10,12,10,12,0,0,7,9,3,5,8,2,1,1,0,2,27,27.7
1,40,11,22,10,16,1,6,4,6,1,4,5,3,0,1,3,1,27,16.5
1,33,9,20,6,16,3,4,6,9,0,1,1,3,2,2,3,1,27,17.8
1,31,10,18,8,13,2,5,5,5,0,4,4,4,1,0,1,3,27,21.2
1,42,9,22,4,12,5,10,4,5,1,5,6,1,1,0,1,3,27,16.5
1,43,9,19,7,13,2,6,7,7,0,4,4,6,0,0,2,1,27,20.3
1,39,11,16,8,10,3,6,2,3,0,6,6,2,1,0,4,1,27,19.6
1,36,9,18,5,13,4,5,5,7,0,3,3,4,0,0,3,2,27,17.1
1,34,10,13,10,13,0,0,7,10,7,8,15,1,0,0,1,3,27,26.5
1,42,9,16,7,11,2,5,7,7,0,5,5,10,2,0,2,2,27,27.1
1,39,10,18,9,14,1,4,6,7,1,12,13,4,1,3,3,2,27,24.4
1,35,11,17,9,14,2,3,3,5,2,1,3,2,1,0,2,2,27,20
1,38,11,20,10,18,1,2,4,5,0,7,7,7,3,1,4,2,27,22.9
1,45,13,22,12,19,1,3,0,0,0,5,5,13,0,0,8,2,27,18.6
1,40,10,20,6,13,4,7,3,3,1,1,2,7,1,0,7,0,27,16.9
1,36,9,19,7,15,2,4,7,7,0,6,6,5,1,0,3,2,27,19.8
1,33,10,17,8,12,2,5,5,5,0,2,2,4,1,0,3,1,27,20.1
0,32,10,16,3,4,7,12,0,0,0,5,5,2,1,1,2,2,27,21.6
1,38,11,19,9,15,2,4,3,6,6,12,18,3,0,2,1,3,27,26
1,37,10,19,9,16,1,3,6,7,0,2,2,3,0,2,3,2,27,17.6
0,28,12,18,12,18,0,0,3,4,2,10,12,2,0,0,0,2,27,23.8
1,33,9,19,6,11,3,8,6,7,0,5,5,5,1,0,1,2,27,21.1
1,40,12,20,10,12,2,8,1,1,3,7,10,3,1,0,1,1,27,23.7
1,37,6,14,4,7,2,7,13,14,0,3,3,9,1,0,7,3,27,19.2
1,37,8,15,4,8,4,7,7,8,0,6,6,3,0,0,2,5,27,19.2
1,41,10,17,6,12,4,5,3,3,0,2,2,6,0,1,3,1,27,21.2
1,36,12,23,11,15,1,8,2,2,0,6,6,3,1,0,2,2,27,17.8
1,33,8,17,7,13,1,4,10,11,3,5,8,4,0,1,2,2,27,22.2
1,38,6,16,5,13,1,3,14,19,0,2,2,5,1,0,4,5,27,15.3
1,38,9,18,6,14,3,4,6,9,0,10,10,5,2,2,6,1,27,20.3
1,39,7,22,6,16,1,6,12,12,0,5,5,9,1,0,8,4,27,13.6
1,36,9,23,7,20,2,3,7,7,5,12,17,14,2,0,7,3,27,25.2
1,35,9,18,4,8,5,10,4,4,0,3,3,2,2,0,3,0,27,19.3
1,43,12,17,11,16,1,1,2,2,3,10,13,2,0,3,2,0,27,26.5
1,40,10,15,9,12,1,3,6,6,0,5,5,3,1,1,2,2,27,23
1,37,10,21,8,18,2,3,5,7,2,2,4,6,0,0,2,4,27,18.1
1,36,8,25,8,18,0,7,11,12,1,9,10,10,3,0,8,3,27,16.5
1,43,10,18,8,16,2,2,5,5,4,12,16,0,0,1,5,4,27,18.9
1,26,10,16,3,7,7,9,0,0,0,3,3,2,1,0,0,0,27,23.1
1,34,8,19,7,16,1,3,10,11,4,5,9,5,1,2,4,2,27,21.9
1,34,7,17,4,10,3,7,10,10,1,5,6,14,1,0,6,4,27,23.3
1,38,7,20,5,12,2,8,11,13,1,4,5,5,1,0,7,2,27,13.6
1,37,9,16,3,8,6,8,3,6,0,2,2,6,0,0,3,5,27,18
1,28,8,15,7,12,1,3,10,11,0,7,7,1,0,2,3,3,27,19.3
1,30,8,15,1,2,7,13,4,4,1,3,4,6,0,0,3,2,27,21.7
1,38,13,17,12,16,1,1,0,0,3,12,15,9,0,0,3,1,27,28.9
1,39,11,24,8,17,3,7,2,4,2,2,4,4,3,0,2,3,27,18.4
1,33,10,20,8,15,2,5,5,7,1,2,3,0,2,0,2,1,27,17.1
1,40,9,22,8,14,1,8,8,10,0,5,5,5,1,0,2,5,27,16.4
1,37,11,23,9,19,2,4,3,3,1,3,4,0,2,0,1,2,27,17.1
1,40,11,21,10,18,1,3,4,6,0,0,0,5,2,0,2,2,27,18.6
1,36,10,13,10,12,0,1,7,11,4,9,13,5,1,2,1,5,27,28.7
1,40,8,18,3,5,5,13,6,7,1,5,6,4,2,0,3,4,27,19.6
1,32,11,20,6,10,5,10,0,0,0,4,4,2,1,3,1,3,27,20.9
1,37,8,19,5,11,3,8,8,9,0,1,1,7,0,0,1,0,27,20.7
1,37,9,15,7,10,2,5,7,8,1,2,3,13,1,0,1,2,27,29.3
1,41,10,21,5,11,5,10,2,2,0,4,4,6,0,0,4,1,27,17.3
1,33,6,16,5,8,1,8,14,15,1,3,4,11,6,2,1,4,27,31.9
1,37,10,27,6,17,4,10,3,4,2,16,18,9,1,2,4,3,27,21.4
1,30,8,16,7,13,1,3,10,12,0,2,2,6,1,1,4,3,27,19.5
1,36,10,21,7,13,3,8,4,5,4,3,7,4,1,0,2,4,27,19.8
0,28,12,17,12,16,0,1,3,5,6,4,10,0,0,3,1,4,27,24
1,33,11,20,8,13,3,7,2,3,3,14,17,4,1,0,2,1,27,24.7
1,35,10,16,8,12,2,4,5,8,1,4,5,3,2,1,2,1,27,22.9
1,37,9,22,8,19,1,3,8,9,5,8,13,2,3,1,1,5,27,22.8
0,30,7,15,3,7,4,8,9,10,0,4,4,3,1,1,3,2,27,20.1
1,33,12,17,12,17,0,0,3,3,0,4,4,6,1,0,0,0,27,26.3
1,33,11,17,7,11,4,6,1,1,3,5,8,3,0,1,4,2,27,21.1
1,33,8,18,5,12,3,6,8,10,4,3,7,0,0,0,4,4,27,14.9
1,35,10,20,8,13,2,7,5,5,1,10,11,4,2,1,3,3,27,22
1,41,12,15,11,13,1,2,2,6,1,7,8,7,2,0,5,0,27,24.4
1,34,11,14,10,12,1,2,4,7,0,8,8,12,2,1,2,1,27,31.5
1,32,8,13,5,7,3,6,8,10,1,4,5,5,3,0,2,2,27,25.9
1,34,11,23,10,18,1,5,4,5,0,3,3,1,0,0,1,0,27,15.5
1,38,11,22,11,22,0,0,5,5,4,3,7,0,2,1,0,2,27,21.6
1,38,9,19,8,17,1,2,8,10,1,3,4,4,0,1,2,2,27,18.8
1,38,11,21,10,18,1,3,4,5,2,5,7,3,1,1,4,3,27,17.8
1,33,11,23,7,13,4,10,1,4,3,13,16,1,0,0,2,0,27,18.8
1,33,10,19,8,15,2,4,5,6,3,2,5,4,0,0,1,1,27,21.4
1,38,8,15,6,11,2,4,9,10,5,10,15,2,1,1,2,5,27,24.9
1,34,11,18,11,16,0,2,5,7,2,5,7,9,2,2,4,1,27,26.2
1,35,8,18,3,7,5,11,6,8,1,4,5,14,1,0,2,1,27,27.1
1,38,9,13,9,12,0,1,9,13,0,6,6,5,4,4,5,5,27,25
1,40,9,20,8,17,1,3,8,10,2,2,4,2,1,0,0,4,27,18.6
0,35,12,17,11,16,1,1,2,2,4,7,11,6,0,0,1,4,27,26.4
1,41,10,19,7,10,3,9,4,5,0,4,4,12,1,0,2,1,27,25.5
1,35,10,18,6,13,4,5,3,5,0,9,9,3,3,1,2,5,27,22.1
1,37,10,26,9,21,1,5,6,7,1,6,7,3,0,1,3,2,27,13.9
1,35,8,23,7,17,1,6,10,11,4,11,15,13,2,2,10,5,27,20.3
1,37,12,22,11,19,1,3,2,4,2,6,8,8,3,0,3,2,27,23.6
1,44,7,17,5,8,2,9,11,14,2,7,9,12,3,1,3,3,27,28.1
1,33,9,23,6,10,3,13,6,8,0,3,3,4,0,0,2,3,27,14.2
1,35,11,21,8,10,3,11,2,2,1,3,4,7,1,0,2,4,27,20.6
1,40,10,22,5,11,5,11,2,4,0,0,0,4,0,0,0,4,27,16
0,26,10,12,10,12,0,0,7,7,7,4,11,4,1,1,1,1,27,31.8
0,30,10,12,5,7,5,5,2,2,0,2,2,2,2,0,2,0,27,24.6
1,37,9,16,8,12,1,4,8,10,2,7,9,1,0,1,0,3,27,22.3
1,36,8,12,3,4,5,8,6,6,0,9,9,7,1,0,4,3,27,25.2
1,39,8,16,5,10,3,6,7,8,1,2,3,7,1,1,2,3,26,22.3
1,34,7,12,1,2,6,10,6,6,0,8,8,0,1,0,1,1,26,22.4
1,34,4,9,2,4,2,5,16,17,3,9,12,4,0,0,1,4,26,25.9
1,35,8,18,6,14,2,4,8,9,0,7,7,5,0,1,2,5,26,18.5
1,31,11,18,8,12,3,6,1,2,2,8,10,3,1,0,0,1,26,23.9
1,40,10,16,10,14,0,2,6,8,1,9,10,9,2,0,2,3,26,26.5
0,32,8,14,4,8,4,6,6,6,0,7,7,1,0,0,1,3,26,20
1,37,7,16,5,11,2,5,10,15,0,3,3,14,2,0,7,4,26,19.7
1,39,10,18,9,14,1,4,5,6,0,7,7,10,3,0,4,2,26,24.3
1,40,8,22,7,17,1,5,9,10,1,12,13,3,1,0,4,3,26,15.6
0,40,11,20,10,19,1,1,3,5,1,11,12,3,0,2,4,5,26,17.1
0,35,9,12,6,9,3,3,5,7,1,2,3,14,2,0,2,2,26,30.7
1,35,9,18,9,16,0,2,8,10,1,6,7,4,0,0,1,1,26,20.1
1,39,8,15,8,15,0,0,10,10,2,11,13,5,1,0,3,3,26,23.7
0,21,8,10,3,3,5,7,5,7,0,0,0,1,0,1,3,0,26,19.8
1,40,11,22,11,20,0,2,4,6,4,11,15,7,1,2,4,4,26,22
0,31,8,12,5,7,3,5,7,9,0,5,5,1,0,0,2,1,26,19.8
1,33,11,22,8,19,3,3,1,1,0,3,3,3,2,1,4,2,26,15.9
1,39,11,20,10,16,1,4,3,4,1,3,4,4,1,1,2,3,26,18.9
1,42,8,16,6,10,2,6,8,8,1,17,18,3,0,1,7,5,26,17.6
1,40,11,21,10,19,1,2,3,4,0,6,6,14,1,1,5,2,26,22.8
0,31,10,20,6,13,4,7,2,2,1,4,5,8,1,0,5,1,26,19.1
1,36,10,24,4,13,6,11,0,0,2,7,9,2,1,0,0,1,26,18.7
1,39,10,23,9,21,1,2,5,6,1,2,3,0,1,1,2,2,26,13.7
1,36,9,18,5,9,4,9,4,5,1,6,7,8,1,0,4,4,26,20.1
1,39,11,19,9,17,2,2,2,2,3,9,12,4,1,2,1,0,26,26.1
1,38,10,23,5,14,5,9,1,1,1,5,6,6,0,0,7,4,26,11.7
1,43,12,27,10,21,2,6,0,0,1,6,7,5,1,0,4,1,26,14.5
1,30,9,16,7,9,2,7,6,7,0,0,0,7,1,0,3,1,26,20.5
1,35,10,16,10,16,0,0,6,11,5,4,9,0,1,1,3,2,26,19.4
1,35,10,22,8,15,2,7,4,4,1,3,4,5,1,0,3,5,26,15.7
1,36,10,24,7,13,3,11,3,4,0,4,4,8,2,0,1,4,26,19
1,38,9,15,6,9,3,6,5,7,0,1,1,2,2,0,4,4,26,16.4
1,36,12,26,12,25,0,1,2,2,3,0,3,5,0,0,0,2,26,17.4
0,30,9,15,3,6,6,9,2,3,1,4,5,4,1,0,1,1,26,23
1,39,9,18,7,13,2,5,6,11,1,6,7,9,2,2,2,1,26,24.8
1,37,8,15,4,8,4,7,6,6,0,3,3,5,0,0,2,1,26,20.7
1,31,10,18,8,14,2,4,4,6,0,1,1,3,3,0,0,0,26,22
1,38,9,20,7,16,2,4,6,7,0,9,9,2,0,1,1,2,26,18.2
1,32,10,17,9,14,1,3,5,5,1,4,5,0,0,0,1,1,26,18.6
1,31,10,15,9,13,1,2,5,6,1,3,4,3,1,0,0,1,26,23.4
1,40,8,17,7,12,1,5,9,10,3,8,11,2,1,0,5,4,26,17.2
1,31,10,14,6,6,4,8,2,2,0,3,3,1,0,0,1,1,26,20.4
1,34,9,18,6,8,3,10,5,6,0,3,3,4,0,0,4,1,26,15.9
1,34,9,17,9,15,0,2,8,10,1,11,12,3,1,2,4,3,26,20.2
1,34,9,17,8,14,1,3,7,8,1,4,5,2,0,1,4,4,26,15.7
1,32,10,12,4,5,6,7,0,0,0,4,4,3,2,0,2,0,26,24.9
1,39,11,20,10,13,1,7,3,7,1,9,10,8,1,1,4,0,26,21.5
1,32,9,16,5,12,4,4,4,4,3,6,9,7,0,0,2,2,26,24.4
1,31,9,11,6,6,3,5,5,6,1,2,3,1,1,0,1,1,26,23.1
1,36,11,17,8,11,3,6,1,1,1,4,5,6,0,0,3,4,26,20
1,42,9,19,8,15,1,4,7,9,2,8,10,13,1,0,5,0,26,24.4
1,42,11,19,9,13,2,6,2,2,1,3,4,7,3,0,1,1,26,25.2
1,37,11,19,9,16,2,3,2,3,4,7,11,11,1,0,2,3,26,27.1
1,38,10,21,10,21,0,0,6,8,1,6,7,7,1,0,2,1,26,20.5
1,39,8,20,4,15,4,5,6,9,0,6,6,10,1,0,2,1,26,21.4
1,35,9,16,4,11,5,5,3,5,1,3,4,8,0,0,1,3,26,22.6
1,37,10,21,8,16,2,5,4,4,3,3,6,1,1,1,0,5,26,18.7
1,45,11,26,7,19,4,7,0,0,3,7,10,13,2,1,4,2,26,23.4
1,38,8,22,5,15,3,7,7,8,2,5,7,4,1,1,3,3,26,16.6
1,41,10,19,9,16,1,3,5,10,2,8,10,5,1,1,1,0,26,22.7
1,34,9,17,8,15,1,2,7,7,0,11,11,22,2,1,5,3,26,32.9
1,34,9,13,9,13,0,0,8,10,5,9,14,1,1,1,2,6,26,23.9
1,38,7,16,5,10,2,6,10,15,3,4,7,8,2,0,3,1,26,23.1
1,32,9,17,9,15,0,2,8,8,1,0,1,2,1,2,4,1,26,17.8
1,38,10,19,9,16,1,3,5,8,0,5,5,0,2,0,2,2,26,16.2
1,39,13,16,13,16,0,0,0,0,0,1,1,6,0,0,2,0,26,22.5
1,37,10,21,7,17,3,4,3,3,1,0,1,2,1,1,5,4,26,12.5
1,33,9,18,4,8,5,10,3,4,0,1,1,6,1,0,1,2,26,20.3
1,39,8,17,7,12,1,5,9,14,3,13,16,5,0,1,6,5,26,17.5
0,36,9,18,3,5,6,13,2,2,0,1,1,2,0,0,1,0,26,17.7
1,29,8,11,3,3,5,8,5,5,1,1,2,4,2,0,1,3,26,25.1
0,30,10,16,7,11,3,5,3,3,0,1,1,6,0,0,4,0,26,19.3
1,38,12,24,12,24,0,0,2,2,3,1,4,3,2,2,2,3,26,18.7
1,34,10,23,9,16,1,7,5,6,0,9,9,7,3,1,0,2,26,24
1,37,11,16,9,13,2,3,2,3,3,10,13,10,0,0,2,4,26,27.3
1,37,8,16,6,12,2,4,8,8,2,5,7,5,1,2,2,1,26,24.4
1,33,10,20,8,13,2,7,4,5,0,2,2,4,2,0,2,2,26,18.2
1,34,11,21,11,21,0,0,4,5,10,11,21,0,0,1,2,2,26,23.5
1,34,12,20,11,16,1,4,1,1,1,4,5,11,3,0,5,1,26,24
1,44,11,21,10,17,1,4,3,4,2,8,10,12,2,0,6,2,26,22.7
1,36,8,18,8,15,0,3,10,12,1,8,9,4,2,0,3,3,26,19.5
0,36,8,15,7,12,1,3,9,13,1,3,4,3,0,2,4,4,26,16.6
1,32,10,20,10,18,0,2,6,6,2,6,8,0,0,0,3,1,26,15.8
1,37,12,17,12,17,0,0,2,3,3,17,20,2,1,2,4,3,26,24.3
1,40,12,25,12,25,0,0,2,3,4,8,12,6,0,1,5,3,26,16.8
1,32,9,19,6,12,3,7,5,5,0,7,7,3,1,0,3,3,26,17.3
1,38,12,21,10,17,2,4,0,0,0,1,1,5,4,0,2,4,26,20.3
1,36,10,20,8,15,2,5,4,6,0,1,1,11,3,0,3,1,26,22.8
1,34,11,14,11,14,0,0,4,7,2,18,20,1,0,2,1,5,26,25.3
1,31,9,21,6,16,3,5,5,6,4,11,15,2,0,1,4,6,26,16.3
1,43,9,23,5,16,4,7,4,4,0,2,2,4,0,0,4,3,26,11.7
1,36,10,16,8,11,2,5,4,4,1,1,2,7,0,0,2,1,26,22.3
1,32,12,21,12,21,0,0,2,3,1,3,4,2,0,0,3,2,26,14.9
0,27,7,11,3,4,4,7,8,9,1,3,4,2,0,0,0,1,26,23.3
1,33,7,12,2,4,5,8,7,8,1,0,1,0,1,0,3,3,26,17.5
1,37,10,15,4,6,6,9,0,0,1,1,2,4,0,0,0,0,26,23.3
1,39,11,19,10,15,1,4,3,3,2,6,8,4,0,1,2,4,26,20.2
1,35,8,23,6,17,2,6,8,10,3,2,5,7,2,0,2,3,26,18.7
1,35,9,17,2,6,7,11,1,1,0,3,3,2,2,0,3,4,26,17.4
1,39,11,19,9,15,2,4,2,2,0,4,4,4,0,1,2,2,26,19
1,35,11,19,10,15,1,4,3,3,2,1,3,4,0,0,4,2,26,16.8
0,36,10,20,6,14,4,6,2,2,4,5,9,4,3,1,0,3,26,25.6
1,39,11,20,10,18,1,2,3,4,0,4,4,2,3,0,3,5,26,16.6
1,36,10,13,10,13,0,0,6,10,7,7,14,1,0,2,4,2,26,23.6
1,39,8,16,6,14,2,2,8,8,1,3,4,4,1,0,1,0,26,22.4
1,38,6,16,4,9,2,7,12,14,1,7,8,12,1,1,6,2,26,22.5
1,38,11,22,9,16,2,6,2,2,0,1,1,7,4,0,4,2,26,19.4
0,32,8,16,3,7,5,9,5,6,0,6,6,3,2,0,6,5,26,15.5
1,34,10,27,8,22,2,5,4,8,1,5,6,4,3,0,2,1,26,15.1
1,35,9,11,6,7,3,4,5,7,0,2,2,3,3,1,2,3,26,24.3
0,29,8,15,7,12,1,3,9,12,4,8,12,4,2,0,3,2,26,23.7
1,37,10,21,6,15,4,6,2,2,1,2,3,2,1,3,2,4,26,17.5
1,41,9,24,6,16,3,8,5,6,2,5,7,5,0,0,1,2,26,17
1,39,9,16,8,11,1,5,7,9,0,7,7,11,1,0,6,3,26,21.2
1,36,10,17,10,17,0,0,6,8,1,6,7,7,1,1,0,5,26,24.4
1,43,10,25,6,14,4,11,2,2,3,2,5,1,1,0,3,1,26,13.5
1,40,6,10,4,6,2,4,12,14,0,8,8,12,3,1,11,3,26,22.9
1,31,10,20,7,13,3,7,3,4,7,5,12,2,0,0,3,5,26,18.4
1,43,9,28,9,26,0,2,8,9,2,5,7,6,0,0,2,3,26,13.5
1,37,8,19,3,8,5,11,5,6,0,2,2,1,2,1,1,1,26,18.1
1,36,10,19,8,9,2,10,4,5,1,3,4,2,0,1,3,5,26,15
1,31,11,16,9,13,2,3,2,2,0,2,2,6,0,0,1,1,26,22.6
1,31,9,15,7,9,2,6,6,6,2,6,8,1,0,0,2,2,26,20.2
1,33,10,19,6,9,4,10,2,3,1,2,3,5,0,0,0,0,26,21.1
1,34,7,17,4,10,3,7,9,9,0,2,2,7,2,0,2,3,26,21.2
1,36,10,18,6,11,4,7,2,2,2,6,8,3,2,6,1,2,26,27.1
1,35,8,22,3,9,5,13,5,7,1,2,3,2,1,0,0,1,26,16.3
1,31,10,15,7,8,3,7,3,4,3,6,9,6,0,2,1,2,26,26.8
1,30,8,14,1,5,7,9,3,3,0,2,2,0,2,0,2,3,26,18.8
1,29,9,13,6,9,3,4,5,7,1,1,2,4,2,0,2,1,26,23.1
1,36,7,16,4,7,3,9,9,9,0,5,5,2,2,0,3,2,26,18.7
1,31,10,17,7,12,3,5,3,4,2,2,4,2,2,0,3,4,26,18.5
1,31,8,17,3,6,5,11,5,5,0,4,4,0,0,1,2,5,26,15.2
1,34,10,16,10,16,0,0,6,11,6,16,22,0,0,2,3,3,26,23
1,39,12,18,12,18,0,0,2,3,4,14,18,3,1,0,7,1,26,20.5
1,37,7,14,6,11,1,3,11,11,0,3,3,12,0,0,3,3,26,24.1
1,36,7,15,3,6,4,9,8,8,0,3,3,9,1,0,7,4,26,17.9
1,28,10,16,7,9,3,7,3,3,0,3,3,1,0,3,5,2,26,16.7
1,40,9,20,8,16,1,4,7,7,3,5,8,4,2,0,1,5,26,21
1,33,6,16,2,5,4,11,10,10,0,4,4,7,0,0,3,2,26,19.5
1,38,10,21,10,20,0,1,6,7,1,6,7,2,0,1,2,1,26,17.1
1,30,9,14,5,10,4,4,4,4,1,0,1,6,0,0,2,1,26,22.3
1,40,9,18,8,15,1,3,7,9,1,2,3,4,1,2,3,4,26,18.1
1,35,9,18,8,14,1,4,7,8,1,5,6,5,0,0,4,0,26,18.3
1,34,10,17,4,10,6,7,0,0,1,4,5,3,2,1,2,1,26,22.4
1,38,7,18,7,15,0,3,12,13,2,2,4,8,5,0,5,4,26,21.8
1,38,9,17,6,10,3,7,5,5,0,2,2,1,2,1,0,3,26,20.5
1,37,9,20,8,16,1,4,7,8,3,3,6,5,2,0,3,3,26,19.5
1,37,10,17,10,15,0,2,6,8,0,3,3,5,1,0,4,3,26,17.5
0,24,9,13,1,1,8,12,0,0,0,4,4,2,0,0,2,1,26,20.7
1,40,10,20,8,14,2,6,4,4,4,8,12,1,1,0,1,2,26,21.1
1,35,11,16,10,15,1,1,3,6,2,6,8,4,0,2,4,6,26,19
1,32,8,16,5,9,3,7,7,7,1,1,2,2,1,1,2,3,26,18.9
1,46,10,17,6,11,4,6,2,2,1,3,4,5,3,0,3,3,26,22
1,48,9,14,5,7,4,7,4,5,2,2,4,2,4,0,3,1,26,23.4
1,30,11,14,11,14,0,0,4,5,2,6,8,1,0,1,0,5,26,22.8
1,39,11,20,9,14,2,6,2,2,1,9,10,2,1,0,3,2,26,18.4
1,27,6,13,4,8,2,5,12,14,0,9,9,2,1,2,4,5,26,19
1,35,11,19,7,10,4,9,0,0,3,5,8,9,1,0,2,4,26,24.4
1,32,7,17,4,9,3,8,9,11,1,11,12,14,3,0,4,3,26,27.7
1,39,8,15,5,11,3,4,7,9,3,10,13,2,1,7,1,3,26,28.1
1,33,5,15,1,7,4,8,12,13,2,6,8,0,0,0,1,0,26,19.3
1,39,11,19,7,12,4,7,0,0,2,2,4,11,1,0,2,0,26,25.8
1,44,11,22,8,17,3,5,1,2,0,5,5,4,0,0,1,4,26,16.3
1,29,11,18,10,15,1,3,3,5,1,4,5,2,3,1,1,2,26,22.2
0,32,9,11,5,6,4,5,4,4,2,6,8,3,0,0,0,4,26,25.6
1,34,11,18,10,17,1,1,3,4,2,8,10,6,0,2,0,1,26,26.4
1,34,9,19,5,8,4,11,4,4,3,5,8,9,2,0,0,2,26,27.4
1,37,8,13,8,12,0,1,10,10,2,3,5,1,2,2,3,4,26,21.9
1,42,8,20,8,17,0,3,10,12,3,5,8,6,3,2,1,1,26,25.2
1,37,9,17,8,12,1,5,7,7,1,2,3,6,2,1,4,1,26,21.5
1,36,8,16,3,6,5,10,5,8,0,4,4,3,1,0,1,2,26,19.3
1,24,9,14,5,7,4,7,4,4,0,2,2,2,0,0,1,4,26,19.2
1,38,9,23,7,16,2,7,6,6,1,2,3,8,1,1,3,2,26,18.3
1,37,9,22,8,17,1,5,7,8,0,1,1,3,1,0,2,2,26,14.4
1,39,9,21,9,17,0,4,8,10,2,5,7,6,2,1,4,1,26,19.5
1,32,11,19,9,14,2,5,2,4,0,5,5,1,1,2,2,3,26,17.7
1,37,7,15,6,11,1,4,11,11,2,3,5,2,1,0,2,0,26,21
1,35,10,27,9,19,1,8,5,5,3,3,6,7,1,0,6,4,26,12.4
1,35,9,20,7,14,2,6,6,7,1,2,3,5,0,0,2,1,26,17.6
0,27,7,14,2,5,5,9,7,8,0,3,3,4,0,0,1,2,26,20.5
1,26,8,12,2,4,6,8,4,4,1,1,2,2,0,1,3,3,26,19.7
1,20,9,14,6,9,3,5,5,6,0,7,7,2,0,2,3,4,26,19.7
1,33,9,19,8,11,1,8,7,8,0,4,4,6,0,1,4,1,26,17.6
0,28,8,15,5,10,3,5,7,8,3,5,8,1,3,0,0,1,26,25.2
1,37,10,23,10,22,0,1,6,6,5,8,13,2,2,0,0,2,26,22.4
1,36,8,15,7,12,1,3,9,10,2,6,8,3,0,0,1,4,26,21
0,35,11,17,11,15,0,2,4,4,1,7,8,2,1,3,3,1,26,22.4
1,37,8,18,6,11,2,7,8,8,0,8,8,10,1,0,0,3,26,25.8
1,41,8,21,8,19,0,2,10,12,1,10,11,2,0,2,3,1,26,16.8
1,37,10,21,6,16,4,5,2,3,2,4,6,6,1,0,2,2,26,19.9
1,37,7,16,6,12,1,4,11,14,3,14,17,6,1,0,3,4,26,23.3
1,32,10,20,8,16,2,4,4,4,2,3,5,4,0,0,3,2,26,17.3
1,35,10,20,9,19,1,1,5,6,8,6,14,3,1,0,2,1,26,23.7
1,34,11,21,9,15,2,6,2,3,1,6,7,2,2,1,0,2,26,21.1
1,35,8,14,5,6,3,8,7,7,0,3,3,12,2,0,4,1,26,26.3
1,38,9,20,6,14,3,6,5,6,0,4,4,9,2,3,3,1,26,23.4
1,40,10,17,6,9,4,8,2,2,0,5,5,3,0,0,1,2,26,19.9
1,31,8,16,3,6,5,10,5,7,0,5,5,4,0,0,0,5,26,19.5
1,31,8,15,6,11,2,4,7,9,4,2,6,5,0,2,1,3,25,23
1,35,7,19,5,9,2,10,9,11,1,3,4,4,1,0,3,3,25,14.9
1,38,8,17,5,11,3,6,6,7,2,4,6,6,0,0,4,3,25,17.5
0,31,10,16,7,8,3,8,2,2,0,2,2,1,1,0,0,2,25,19.3
1,38,9,16,5,8,4,8,3,4,0,2,2,1,0,0,3,1,25,14.9
1,37,7,13,3,6,4,7,7,8,1,5,6,8,0,1,2,2,25,24
1,32,11,18,10,16,1,2,2,3,2,7,9,1,1,3,0,2,25,22.9
1,28,8,15,6,8,2,7,7,7,0,1,1,9,3,0,2,1,25,24.9
1,38,7,14,4,9,3,5,8,8,4,6,10,5,3,1,2,1,25,27.4
1,28,10,13,6,8,4,5,1,1,0,1,1,1,0,1,2,0,25,19.6
1,36,9,19,9,17,0,2,7,8,2,4,6,10,6,0,8,2,25,21.7
1,28,8,15,7,13,1,2,8,9,1,5,6,0,0,3,3,4,25,17
0,30,8,14,3,8,5,6,4,6,1,0,1,3,2,0,2,2,25,19.6
1,32,8,14,6,11,2,3,7,7,0,2,2,3,1,5,3,3,25,21.4
1,35,10,17,8,13,2,4,3,4,2,3,5,4,1,1,1,2,25,21.7
1,43,8,19,4,10,4,9,5,5,0,7,7,4,1,0,1,1,25,19.4
1,31,9,14,4,5,5,9,2,2,0,1,1,1,0,0,1,3,25,17.6
1,40,10,14,8,11,2,3,3,6,1,7,8,14,0,0,6,3,25,23.4
1,28,11,18,8,11,3,7,0,0,0,3,3,1,2,1,1,0,25,20.1
1,33,9,21,7,16,2,5,5,6,1,6,7,2,0,0,3,3,25,13.2
1,39,6,14,1,6,5,8,8,8,0,2,2,1,3,0,1,1,25,20.5
1,36,8,15,5,12,3,3,6,7,2,2,4,7,0,2,3,1,25,22.2
1,27,11,14,9,11,2,3,1,1,1,2,3,6,1,0,5,1,25,20.7
1,36,8,12,6,9,2,3,7,8,1,9,10,3,0,1,3,2,25,21.8
1,38,8,14,3,7,5,7,4,6,1,1,2,11,1,0,2,1,25,24.9
1,44,5,13,3,10,2,3,13,15,2,11,13,2,2,3,2,6,25,22.9
1,38,11,23,8,14,3,9,0,0,2,4,6,5,2,0,0,0,25,21.4
1,37,10,20,10,17,0,3,5,7,1,1,2,2,2,1,4,3,25,14.1
1,34,10,16,8,8,2,8,3,3,0,2,2,4,0,0,0,1,25,20.8
1,35,7,23,5,13,2,10,9,9,0,4,4,8,1,0,1,3,25,17.3
1,27,7,14,1,2,6,12,5,8,3,8,11,3,1,0,1,3,25,22.2
1,45,8,11,3,4,5,7,4,5,0,6,6,2,2,1,2,3,25,22.8
1,29,9,15,6,9,3,6,4,4,0,5,5,0,1,0,2,2,25,17.8
1,37,10,16,9,12,1,4,4,4,0,8,8,3,2,3,1,5,25,23.4
1,36,7,14,4,8,3,6,8,9,2,8,10,13,2,0,3,1,25,29.1
1,30,8,18,4,9,4,9,5,5,0,3,3,4,3,0,0,0,25,22.3
1,40,10,18,5,10,5,8,0,0,1,2,3,7,0,1,6,4,25,15.7
1,36,8,16,7,13,1,3,8,8,0,14,14,3,1,2,4,1,25,21.3
1,38,7,19,6,17,1,2,10,14,1,11,12,10,1,3,9,3,25,16.8
1,30,8,20,7,17,1,3,8,11,5,3,8,3,1,2,3,3,25,17.7
0,25,8,12,6,9,2,3,7,7,1,2,3,1,3,0,4,3,25,19.6
1,39,9,14,4,5,5,9,2,2,2,9,11,3,4,0,2,3,25,25.8
0,37,9,17,5,9,4,8,3,3,2,5,7,4,0,1,1,1,25,21.7
1,31,10,12,10,12,0,0,5,6,2,4,6,3,2,1,0,3,25,26.4
1,36,11,18,8,12,3,6,0,0,2,9,11,6,3,0,7,3,25,19.9
1,30,10,15,7,9,3,6,2,3,1,6,7,0,1,2,2,4,25,19.4
1,33,9,17,6,13,3,4,4,4,2,8,10,5,1,4,2,4,25,24.2
1,31,10,15,7,10,3,5,2,2,0,6,6,9,1,0,3,0,25,24.6
1,38,9,12,2,2,7,10,0,1,0,4,4,2,1,0,1,2,25,21.6
1,32,10,14,5,7,5,7,0,0,0,4,4,0,2,0,0,1,25,22
1,33,12,16,12,15,0,1,1,1,7,5,12,2,0,0,2,2,25,23.6
1,27,10,21,7,16,3,5,2,2,4,6,10,4,0,0,0,3,25,20.5
1,35,7,14,7,13,0,1,11,13,2,5,7,6,0,1,3,2,25,21.2
1,31,9,12,8,11,1,1,6,8,6,6,12,3,1,0,2,2,25,25.7
1,34,9,13,9,13,0,0,7,11,3,9,12,2,0,1,2,4,25,21.2
0,26,10,17,8,12,2,5,3,3,1,1,2,2,2,0,2,2,25,18.7
1,26,9,18,7,11,2,7,5,6,1,2,3,1,0,0,2,0,25,15.6
1,37,10,20,5,8,5,12,0,0,0,5,5,1,2,2,2,3,25,17.4
1,36,9,21,4,9,5,12,2,3,1,5,6,10,1,1,5,1,25,19
1,44,10,17,6,10,4,7,1,1,0,4,4,2,1,1,6,4,25,13.8
1,26,10,18,6,8,4,10,1,2,0,1,1,0,2,0,2,3,25,15.1
1,37,9,18,9,16,0,2,7,10,1,13,14,8,1,0,2,1,25,23.6
1,34,9,22,7,17,2,5,5,6,0,3,3,4,2,0,2,1,25,16.1
1,41,7,18,6,15,1,3,10,11,0,5,5,1,0,0,2,3,25,13.8
1,34,8,13,3,5,5,8,4,4,0,4,4,3,0,0,1,2,25,20.6
1,35,8,19,5,10,3,9,6,7,0,3,3,2,1,0,1,3,25,15.6
0,29,10,11,10,11,0,0,5,10,5,2,7,2,0,3,2,4,25,23.3
1,29,8,17,7,13,1,4,8,9,4,4,8,1,2,2,8,5,25,14
1,35,8,16,6,14,2,2,7,7,1,1,2,3,1,0,3,3,25,16.9
0,32,8,12,0,2,8,10,1,1,0,5,5,3,1,0,1,4,25,21.8
1,38,10,17,8,15,2,2,3,6,2,4,6,5,2,0,1,0,25,23
1,34,10,17,8,12,2,5,3,4,2,1,3,3,5,0,3,1,25,22.1
1,39,8,17,6,11,2,6,7,8,2,7,9,2,4,1,3,5,25,20.5
1,38,10,18,6,12,4,6,1,4,1,3,4,5,0,0,2,3,25,17.1
1,33,9,19,5,11,4,8,3,4,1,6,7,2,0,0,1,3,25,16.6
1,37,11,20,9,14,2,6,1,2,1,8,9,6,2,2,6,2,25,18.9
1,38,9,16,8,14,1,2,6,8,1,5,6,9,1,1,4,2,25,22
1,26,10,18,10,14,0,4,5,6,3,2,5,1,1,0,5,1,25,15
1,33,8,13,4,7,4,6,5,7,1,5,6,3,0,0,1,2,25,20.8
1,37,9,22,7,12,2,10,5,6,2,3,5,0,0,0,0,3,25,13.9
1,34,12,16,12,15,0,1,1,2,0,3,3,2,0,1,2,1,25,18.8
1,29,11,15,8,11,3,4,0,0,0,2,2,11,1,0,0,1,25,27.8
1,27,9,15,5,9,4,6,3,3,0,2,2,1,1,0,0,1,25,20
1,36,9,22,7,16,2,6,5,5,3,4,7,4,0,1,1,4,25,17.4
1,36,10,15,7,10,3,5,2,2,1,5,6,5,1,0,1,1,25,23.8
1,43,11,19,11,17,0,2,3,3,4,10,14,4,1,2,1,1,25,25.7
1,41,8,14,6,11,2,3,7,10,0,5,5,2,0,0,4,2,25,15.3
1,39,8,17,5,11,3,6,6,6,2,6,8,2,3,0,1,0,25,22.9
1,39,11,17,11,17,0,0,3,4,2,8,10,2,1,2,1,1,25,23.3
1,32,8,11,3,3,5,8,4,4,0,1,1,1,0,1,0,4,25,20.6
1,28,6,13,2,5,4,8,9,9,3,8,11,1,0,0,1,0,25,22.5
1,36,8,13,5,8,3,5,6,7,2,4,6,1,2,2,3,4,25,20.8
1,36,5,13,2,6,3,7,12,12,1,6,7,6,0,0,3,3,25,20.4
1,40,8,17,5,10,3,7,6,6,1,1,2,4,0,1,2,3,25,17.6
1,38,12,18,11,16,1,2,0,0,3,7,10,0,0,2,1,2,25,21
1,36,7,16,3,7,4,9,7,7,0,3,3,1,2,1,2,1,25,18.5
1,38,9,21,7,16,2,5,5,6,2,3,5,2,2,6,5,4,25,16.8
1,30,7,16,3,9,4,7,7,7,0,5,5,3,0,2,0,2,25,20.8
1,30,8,14,4,7,4,7,5,6,0,6,6,7,4,0,4,0,25,24.7
1,37,9,19,5,12,4,7,3,3,0,5,5,1,0,1,0,1,25,17.8
1,41,9,18,5,6,4,12,3,4,1,0,1,2,2,1,1,3,25,18.2
1,38,11,21,11,21,0,0,3,4,1,2,3,6,1,0,2,1,25,18.4
1,26,10,18,7,12,3,6,2,3,0,4,4,2,1,0,4,2,25,14.8
1,35,10,15,7,8,3,7,2,6,0,3,3,4,2,0,5,2,25,16.8
1,36,10,17,7,14,3,3,2,4,2,5,7,2,0,0,0,2,25,19.8
1,32,11,16,10,13,1,3,2,2,5,3,8,1,1,1,1,3,25,22.8
1,34,9,17,6,10,3,7,4,6,0,3,3,5,1,0,2,3,25,18.1
1,34,7,20,3,10,4,10,7,7,0,0,0,3,3,0,3,3,25,14.7
0,26,8,12,3,6,5,6,4,4,0,3,3,0,0,1,0,2,25,20.6
0,31,12,15,12,15,0,0,1,1,2,11,13,2,3,0,1,1,25,27
0,35,9,12,6,9,3,3,4,4,1,0,1,9,3,3,2,4,25,28.7
1,32,11,16,11,16,0,0,3,4,0,2,2,4,1,0,2,1,25,19.8
0,30,11,16,8,10,3,6,0,0,0,3,3,9,1,1,0,2,25,26.3
1,41,8,14,3,6,5,8,4,7,1,6,7,8,2,2,3,2,25,24.9
1,35,7,16,5,9,2,7,9,12,1,6,7,1,0,1,1,0,25,18.3
1,35,7,16,2,6,5,10,6,6,0,3,3,8,2,0,5,1,25,19.7
1,24,11,27,11,24,0,3,3,5,2,4,6,0,1,0,1,2,25,11.5
1,36,10,19,9,15,1,4,4,6,3,2,5,1,0,0,2,5,25,14.3
0,36,9,17,6,12,3,5,4,6,4,6,10,3,0,0,0,2,25,21.8
1,32,7,10,6,8,1,2,10,14,2,4,6,7,1,2,4,2,25,24.3
1,36,8,18,7,12,1,6,8,8,1,9,10,0,1,0,1,6,25,16.6
1,43,9,16,5,9,4,7,3,3,1,8,9,1,1,0,3,2,25,18.4
1,32,10,17,9,15,1,2,4,4,1,5,6,2,2,0,2,0,25,20.7
1,29,8,17,2,8,6,9,3,4,2,4,6,2,1,1,4,1,25,17.2
1,34,11,22,11,19,0,3,3,3,3,3,6,1,0,0,2,3,25,14.5
1,41,9,25,6,10,3,15,4,4,1,3,4,3,2,0,1,6,25,13.4
1,38,6,17,2,6,4,11,9,11,0,3,3,3,2,0,3,2,25,15.9
1,36,10,19,9,15,1,4,4,6,3,2,5,1,0,0,2,5,25,14.3
1,33,10,13,10,13,0,0,5,6,1,8,9,4,3,0,5,4,25,21.8
1,38,7,22,7,21,0,1,11,13,1,15,16,0,4,2,7,2,25,14.4
1,37,7,18,6,13,1,5,10,10,1,1,2,13,2,1,4,2,25,23.2
1,29,7,11,4,8,3,3,8,8,1,1,2,5,3,0,1,2,25,25.8
1,37,10,13,10,13,0,0,5,10,3,14,17,2,0,2,2,4,25,23.4
1,35,9,15,3,5,6,10,1,1,1,7,8,2,0,1,0,1,25,22.6
1,28,8,12,3,5,5,7,4,5,1,3,4,2,2,3,0,2,25,25.7
1,37,10,20,8,16,2,4,3,3,0,4,4,9,2,0,4,1,25,20.1
1,46,10,18,10,11,0,7,5,7,0,6,6,9,1,0,5,4,25,18.1
1,34,10,14,10,12,0,2,5,7,5,1,6,2,0,0,2,3,25,20.4
1,43,7,14,3,9,4,5,7,8,0,8,8,6,0,0,2,2,25,21.4
1,36,12,19,12,19,0,0,1,6,6,12,18,0,2,2,3,4,25,21.1
0,21,10,17,6,11,4,6,1,3,0,5,5,0,2,0,0,0,25,19.8
1,35,10,20,9,16,1,4,4,5,1,8,9,4,0,0,1,1,25,19.1
1,45,10,16,5,7,5,9,0,0,0,6,6,6,1,0,2,1,25,22.4
1,36,10,20,10,19,0,1,5,7,2,4,6,3,2,0,3,1,25,17.5
1,36,11,21,11,20,0,1,3,4,1,3,4,7,1,0,1,3,25,19.6
1,33,7,14,5,7,2,7,9,9,0,6,6,8,2,0,3,3,25,23.2
1,38,10,19,10,19,0,0,5,6,3,2,5,3,0,0,3,3,25,15.9
1,38,7,17,4,11,3,6,8,9,6,5,11,3,1,0,1,3,25,22.1
1,34,9,20,7,11,2,9,5,6,4,3,7,4,2,0,5,3,25,16.5
1,34,7,13,6,11,1,2,10,12,0,5,5,8,0,1,2,2,25,22.9
1,41,11,25,10,21,1,4,2,2,0,4,4,12,2,0,2,0,25,21.5
1,35,9,20,6,12,3,8,4,6,1,2,3,2,3,0,0,2,25,18.7
0,34,12,16,12,16,0,0,1,2,2,6,8,3,2,0,3,4,25,20.9
1,39,8,17,7,15,1,2,8,9,6,9,15,1,1,2,2,3,25,22.7
1,24,9,13,6,9,3,4,4,4,0,11,11,1,0,1,2,2,25,21.4
1,30,12,15,12,15,0,0,1,4,4,7,11,1,0,1,1,1,25,23
1,26,6,18,5,15,1,3,12,14,3,4,7,2,0,2,5,3,25,13.9
1,29,7,11,4,8,3,3,8,8,1,1,2,5,3,0,1,2,25,25.8
1,32,11,17,11,17,0,0,3,5,4,12,16,1,1,4,1,3,25,25.4
1,33,8,20,7,18,1,2,8,10,1,8,9,2,0,1,3,4,25,14
1,38,8,15,8,14,0,1,9,12,1,7,8,3,1,2,0,2,25,23
1,36,7,17,5,10,2,7,9,10,1,7,8,6,2,0,7,5,25,15.5
1,34,7,14,6,13,1,1,10,14,4,3,7,0,0,1,2,1,25,18.4
1,33,9,21,6,12,3,9,4,5,1,2,3,2,2,0,2,3,25,15
1,35,10,15,7,9,3,6,2,2,0,2,2,7,1,0,2,4,25,21.4
1,42,8,19,3,10,5,9,4,4,0,3,3,4,0,0,1,5,25,15.6
1,35,8,12,4,4,4,8,5,6,2,4,6,1,0,2,0,3,25,22.9
1,38,8,17,8,14,0,3,9,11,0,6,6,3,2,0,4,5,25,15.4
1,39,7,18,5,9,2,9,9,11,5,6,11,13,0,0,7,1,25,21.4
1,34,10,21,9,15,1,6,4,4,3,4,7,2,0,1,1,2,25,17.9
1,38,11,23,8,14,3,9,0,0,2,4,6,5,2,0,0,0,25,21.4
1,40,9,21,6,16,3,5,4,6,1,6,7,2,0,0,4,2,25,12.2
1,38,9,19,6,15,3,4,4,4,0,4,4,4,2,0,3,1,25,17.9
1,37,10,25,8,16,2,9,3,3,1,6,7,5,1,0,1,1,25,17.1
1,35,9,15,5,9,4,6,3,3,1,5,6,4,0,0,3,2,25,19.3
1,30,9,17,6,13,3,4,4,5,2,5,7,7,2,0,3,1,25,22.7
1,30,11,21,11,14,0,7,3,3,0,6,6,6,3,1,2,2,25,21.6
1,35,8,19,7,16,1,3,8,9,1,5,6,4,4,2,1,1,25,23.5
1,44,11,27,9,22,2,5,1,1,3,3,6,10,7,0,2,0,25,25.5
1,39,9,15,8,12,1,3,6,8,7,11,18,2,0,0,1,3,25,24.7
1,36,11,20,9,16,2,4,1,4,1,4,5,1,2,0,0,0,25,18.8
1,33,9,17,7,13,2,4,5,5,0,5,5,3,0,0,4,6,25,13.9
0,31,9,13,2,4,7,9,0,0,0,3,3,5,1,1,1,2,25,23.8
1,34,8,20,7,17,1,3,8,8,2,6,8,1,0,0,0,1,25,17.7
1,34,8,15,4,9,4,6,5,6,1,14,15,7,1,1,1,3,25,26.6
1,34,11,23,9,15,2,8,1,2,1,5,6,1,1,2,2,2,25,15.4
1,36,8,17,5,7,3,10,6,6,5,5,10,1,0,1,1,1,25,21.3
1,34,10,18,8,13,2,5,3,4,0,1,1,4,2,0,1,2,25,19.3
1,36,9,19,6,11,3,8,4,6,2,9,11,7,3,2,4,3,25,22.7
1,32,10,17,6,7,4,10,1,1,2,3,5,4,1,0,2,2,25,20.4
1,32,11,14,11,14,0,0,3,4,2,4,6,5,1,1,3,3,25,22.8
0,32,9,20,2,3,7,17,0,0,1,3,4,0,0,0,1,2,25,14.4
1,33,8,13,5,8,3,5,6,7,0,1,1,6,1,0,3,2,25,20.4
1,35,6,18,4,11,2,7,11,13,1,11,12,19,2,1,5,3,25,27.8
1,39,5,17,4,8,1,9,14,17,1,6,7,12,2,0,2,2,25,24
1,39,7,21,4,10,3,11,8,9,0,4,4,6,2,0,0,2,25,19.3
1,46,10,22,9,17,1,5,4,4,0,0,0,1,0,0,3,3,25,10.1
1,34,10,13,7,8,3,5,2,2,1,1,2,2,1,0,0,2,25,22.5
1,38,11,21,11,21,0,0,3,3,1,3,4,7,2,0,3,2,25,19.4
1,32,9,15,7,13,2,2,5,5,3,12,15,0,1,5,0,1,25,27.9
1,34,9,17,5,8,4,9,3,4,0,2,2,3,0,0,2,2,25,16.2
1,34,7,14,6,13,1,1,10,14,4,3,7,0,0,1,2,1,25,18.4
1,34,9,12,3,4,6,8,1,1,2,5,7,0,1,0,0,2,25,23.3
1,35,7,19,6,13,1,6,10,11,0,1,1,13,2,0,3,3,25,21.3
1,38,8,18,7,13,1,5,8,10,2,11,13,1,3,0,3,3,25,19
1,37,9,20,9,17,0,3,7,12,1,3,4,14,3,2,3,1,25,25
1,43,10,17,8,15,2,2,3,4,1,4,5,1,0,1,0,3,25,18.8
1,38,10,14,9,12,1,2,4,4,2,4,6,12,5,0,9,3,25,25
1,38,7,13,5,7,2,6,9,11,2,4,6,3,2,0,2,2,25,21.8
1,27,10,16,8,11,2,5,3,3,1,3,4,5,1,1,3,1,25,21.2
1,45,7,20,4,13,3,7,8,10,0,9,9,9,2,0,4,2,25,19.2
1,22,9,13,9,13,0,0,7,9,2,5,7,4,0,0,2,5,25,20.4
1,38,8,18,4,11,4,7,5,6,1,3,4,6,0,0,6,2,25,14.2
1,37,7,16,5,11,2,5,9,11,0,6,6,0,0,2,0,4,25,17.4
1,37,10,27,8,17,2,10,3,3,0,1,1,7,1,1,0,4,25,15.4
1,36,9,23,8,18,1,5,6,7,1,7,8,14,2,1,5,1,25,22
1,35,10,16,7,10,3,6,2,2,1,9,10,6,3,0,3,2,25,24.6
1,36,6,21,3,11,3,10,10,14,1,5,6,13,3,0,4,1,25,21
1,39,8,23,5,15,3,8,6,7,2,8,10,3,1,2,5,5,25,13
1,33,9,20,9,17,0,3,7,9,0,8,8,2,1,5,2,4,25,18.5
1,33,9,21,5,11,4,10,3,3,0,0,0,5,1,1,2,4,25,15.5
1,34,9,17,5,10,4,7,3,3,2,7,9,6,1,0,4,2,25,20.6
1,28,8,12,3,5,5,7,4,5,1,3,4,2,2,3,0,2,25,25.7
1,36,10,19,9,14,1,5,4,4,0,1,1,13,3,0,4,0,25,24.1
0,31,9,11,6,6,3,5,3,4,0,4,4,1,1,0,0,1,24,22
1,30,10,12,10,12,0,0,4,10,5,10,15,0,3,1,2,3,24,24.2
1,40,8,16,8,15,0,1,8,8,1,9,10,2,0,4,3,4,24,19
0,24,9,19,4,9,5,10,1,1,0,1,1,3,0,0,3,1,24,13.3
1,37,10,15,6,8,4,7,0,0,0,5,5,2,2,0,3,4,24,17.8
1,28,6,12,6,7,0,5,12,14,0,8,8,1,2,3,5,5,24,17.4
0,28,8,12,6,9,2,3,6,8,0,2,2,4,2,0,2,1,24,21
1,36,8,15,4,8,4,7,4,4,1,11,12,3,0,1,1,1,24,22.1
1,39,8,19,7,17,1,2,7,8,4,15,19,2,1,0,0,2,24,22.4
1,33,9,17,7,13,2,4,4,4,1,0,1,8,0,0,1,5,24,19
1,39,9,17,3,8,6,9,0,0,0,2,2,4,0,0,2,3,24,15.9
1,35,8,18,5,12,3,6,5,5,2,2,4,3,0,0,1,1,24,17.3
1,35,6,16,4,9,2,7,10,11,0,4,4,1,2,0,1,2,24,16.9
1,34,7,11,4,6,3,5,7,7,0,2,2,2,1,0,1,3,24,19.9
1,38,10,18,10,17,0,1,4,5,1,14,15,3,1,3,4,3,24,19.9
1,45,8,15,8,12,0,3,8,11,4,9,13,11,2,1,5,3,24,25.2
1,37,8,15,6,8,2,7,6,6,0,5,5,2,2,0,2,2,24,18.8
0,32,10,18,8,14,2,4,2,4,0,8,8,2,0,2,2,2,24,17
1,41,9,22,6,14,3,8,3,3,1,5,6,5,1,0,5,3,24,12.7
1,38,8,19,6,14,2,5,6,8,4,6,10,3,2,0,2,2,24,19
1,41,9,21,5,8,4,13,2,3,0,6,6,8,0,0,3,2,24,16.1
1,30,9,17,8,12,1,5,5,7,3,5,8,0,0,1,4,4,24,13.6
1,31,8,18,6,13,2,5,6,6,0,4,4,4,0,1,1,1,24,17.9
1,38,11,19,11,17,0,2,2,3,2,4,6,1,1,1,3,1,24,16.3
1,35,8,16,4,9,4,7,4,5,2,2,4,1,0,0,0,2,24,17.5
0,30,8,13,4,8,4,5,4,5,0,7,7,8,1,1,1,1,24,25.7
1,27,9,18,4,8,5,10,1,1,0,2,2,0,0,0,1,0,24,14.6
1,38,10,17,9,15,1,2,3,9,2,10,12,1,1,0,2,2,24,17
1,33,8,17,4,9,4,8,4,4,1,9,10,4,2,0,3,0,24,20.5
1,29,9,14,4,8,5,6,1,2,2,4,6,2,2,1,5,4,24,17.5
0,31,8,17,6,11,2,6,6,6,1,3,4,7,0,1,0,0,24,22.5
0,29,8,16,3,4,5,12,3,3,3,8,11,0,0,0,1,3,24,18.3
1,31,7,18,5,13,2,5,8,9,0,1,1,4,2,0,0,1,24,18.5
1,25,8,10,3,5,5,5,3,4,0,6,6,8,2,1,0,1,24,29.5
1,36,9,21,6,12,3,9,3,4,0,1,1,8,0,0,2,2,24,15.6
1,33,10,16,8,14,2,2,2,3,2,11,13,7,0,3,2,3,24,24.9
1,38,8,14,6,9,2,5,6,10,0,12,12,12,0,1,4,3,24,23.3
1,30,9,14,8,10,1,4,5,6,0,3,3,0,1,0,2,4,24,15.7
1,35,8,18,4,9,4,9,4,5,3,4,7,5,2,0,2,4,24,19.4
1,39,8,18,5,12,3,6,5,5,0,4,4,4,0,1,2,4,24,15.7
1,41,9,19,8,14,1,5,5,7,2,10,12,15,1,0,8,1,24,21
1,32,11,16,9,13,2,3,0,1,2,8,10,4,3,0,2,4,24,22.8
1,46,9,16,9,14,0,2,6,8,6,8,14,1,1,1,2,4,24,21
1,35,8,17,6,11,2,6,6,7,0,2,2,1,4,0,2,2,24,17.4
1,30,8,14,4,9,4,5,4,7,4,9,13,6,1,1,3,4,24,23
1,33,8,18,5,12,3,6,5,6,2,6,8,3,0,2,3,3,24,16.7
1,24,9,15,6,11,3,4,3,3,0,5,5,3,0,1,0,3,24,20.2
1,37,7,12,5,7,2,5,8,11,1,1,2,11,0,3,4,2,24,23.2
1,41,9,16,4,5,5,11,1,2,0,2,2,1,1,1,2,1,24,16.6
1,38,9,20,9,19,0,1,6,7,0,4,4,7,1,0,5,2,24,14.5
1,31,8,17,5,10,3,7,5,6,2,5,7,0,1,1,0,5,24,17.5
0,31,9,13,7,10,2,3,4,5,1,6,7,5,2,2,0,2,24,26.7
1,44,9,19,9,18,0,1,6,6,4,11,15,2,0,3,3,1,24,20.5
1,37,10,20,6,11,4,9,0,0,1,9,10,5,1,0,2,2,24,19.1
1,29,8,12,6,8,2,4,6,7,1,1,2,6,1,0,3,4,24,20
1,36,11,16,11,16,0,0,2,3,5,8,13,1,1,1,1,5,24,22.1
1,33,10,18,9,15,1,3,3,4,4,6,10,2,2,2,3,5,24,19.4
1,38,8,21,5,14,3,7,5,5,2,2,4,2,1,0,3,2,24,13.1
1,37,10,21,8,16,2,5,2,3,3,2,5,6,3,0,4,3,24,17.6
1,28,9,16,8,13,1,3,5,5,2,1,3,6,1,0,0,2,24,22.5
1,39,10,21,10,17,0,4,4,5,2,2,4,3,0,2,1,4,24,15.8
1,41,9,15,4,7,5,8,1,1,2,6,8,3,3,0,1,3,24,23.2
1,30,11,19,10,18,1,1,1,2,6,8,14,6,0,1,0,3,24,25
1,32,10,17,9,13,1,4,3,3,0,4,4,3,1,0,3,0,24,17.4
1,38,7,17,7,13,0,4,10,11,6,6,12,3,3,0,2,4,24,22
1,41,9,19,5,11,4,8,2,2,2,8,10,7,1,0,2,1,24,21.6
1,31,8,12,2,3,6,9,2,2,0,4,4,7,1,0,4,1,24,21.5
1,27,8,20,7,12,1,8,7,9,0,6,6,4,3,0,5,3,24,13.8
0,29,11,21,9,15,2,6,0,0,2,1,3,1,0,0,1,2,24,14.3
1,40,11,20,11,19,0,1,2,2,4,4,8,3,2,2,6,5,24,15.9
1,35,8,18,8,15,0,3,8,10,0,3,3,2,0,0,2,2,24,13.3
1,33,9,14,6,8,3,6,3,3,0,3,3,1,0,0,3,1,24,16
1,26,8,15,6,11,2,4,6,6,0,2,2,5,1,1,3,3,24,18.3
1,39,9,26,7,17,2,9,4,4,1,3,4,2,1,0,3,1,24,10
1,34,9,15,9,14,0,1,6,10,1,4,5,5,1,0,1,1,24,20.5
1,34,8,19,7,18,1,1,7,8,2,7,9,4,1,0,1,2,24,19
1,40,9,24,5,9,4,15,2,2,0,8,8,12,0,0,2,1,24,19.2
0,27,10,14,8,11,2,3,2,4,0,9,9,0,0,0,1,4,24,17.5
1,36,9,18,9,17,0,1,6,6,1,3,4,1,0,0,0,0,24,17.3
1,37,8,12,4,7,4,5,4,4,1,4,5,3,1,0,2,4,24,20.2
1,40,5,12,5,11,0,1,14,16,2,7,9,12,1,0,3,1,24,26.3
1,41,6,21,6,15,0,6,12,12,0,4,4,4,0,2,3,0,24,14.1
1,43,10,18,9,14,1,4,3,4,1,5,6,6,0,1,2,3,24,18.9
0,24,11,15,9,11,2,4,0,0,3,3,6,3,1,1,1,3,24,22.5
1,35,7,13,6,11,1,2,9,12,1,7,8,5,2,3,0,1,24,26.5
1,35,8,20,2,5,6,15,2,3,1,3,4,9,0,0,2,4,24,17.1
1,37,7,16,5,10,2,6,8,8,0,5,5,5,3,0,1,2,24,21.8
1,39,8,14,7,10,1,4,7,11,0,5,5,4,3,0,2,3,24,19.9
0,28,8,17,1,4,7,13,1,2,0,2,2,3,1,0,0,4,24,17
1,31,8,12,4,4,4,8,4,4,0,3,3,6,1,0,5,1,24,19.5
1,41,10,21,10,17,0,4,4,6,3,8,11,8,0,1,3,2,24,19.5
1,40,10,21,8,16,2,5,2,2,1,10,11,3,1,1,4,0,24,16.8
1,30,9,17,6,8,3,9,3,3,0,2,2,7,5,0,8,0,24,18.2
1,40,5,13,2,5,3,8,11,16,3,1,4,4,5,0,5,6,24,17.7
1,28,8,13,4,6,4,7,4,5,2,1,3,1,2,0,2,3,24,18.9
1,36,7,18,3,10,4,8,6,6,1,3,4,5,1,0,3,5,24,15.3
1,25,6,10,6,9,0,1,12,16,1,5,6,2,1,0,3,4,24,17.8
1,34,9,14,7,9,2,5,4,4,2,8,10,2,0,0,2,3,24,19.8
1,33,10,16,6,9,4,7,0,0,1,4,5,2,0,0,1,1,24,18.7
1,36,10,18,8,15,2,3,2,4,0,5,5,8,0,0,2,3,24,18.5
1,39,8,20,7,16,1,4,7,8,0,4,4,11,2,1,4,3,24,19.2
1,33,9,17,8,11,1,6,5,6,0,0,0,6,1,0,5,2,24,14.7
0,24,9,14,7,8,2,6,4,4,0,7,7,2,2,0,0,3,24,22.1
1,36,8,19,6,16,2,3,6,7,2,3,5,9,2,0,2,1,24,21.7
1,34,6,10,4,8,2,2,10,13,1,2,3,7,3,0,3,3,24,23.2
0,26,6,13,4,6,2,7,10,10,0,6,6,5,2,0,5,2,24,18.8
1,36,9,14,5,7,4,7,2,4,1,3,4,1,1,0,1,4,24,17.7
1,35,8,20,7,15,1,5,7,7,0,4,4,2,1,0,1,1,24,15.4
1,35,10,19,10,15,0,4,4,4,1,4,5,10,3,0,3,1,24,23.2
1,37,6,17,2,11,4,6,8,12,3,4,7,3,2,0,0,2,24,19.5
1,30,8,14,4,9,4,5,4,5,0,1,1,4,0,1,2,5,24,16.8
1,40,7,14,3,5,4,9,6,7,1,2,3,9,1,0,2,2,24,22.4
1,29,9,17,6,11,3,6,3,4,0,3,3,5,1,0,0,1,24,20.3
1,29,8,14,8,14,0,0,8,10,4,7,11,2,0,0,0,4,24,21.3
1,50,9,15,5,10,4,5,2,2,2,8,10,0,0,0,1,2,24,19.1
1,25,7,11,2,5,5,6,5,6,0,2,2,10,2,1,1,0,24,28
1,40,9,13,3,5,6,8,0,0,3,6,9,2,2,3,3,1,24,24.5
1,31,11,16,11,16,0,0,2,3,5,9,14,4,1,1,1,4,24,24.9
1,37,8,22,5,18,3,4,5,5,1,6,7,6,1,0,2,4,24,15.9
1,31,9,16,8,14,1,2,5,5,1,4,5,0,2,1,2,1,24,18.6
0,29,10,19,7,12,3,7,1,3,2,3,5,2,1,0,2,1,24,16.2
1,35,9,20,7,13,2,7,4,7,0,1,1,7,0,0,2,2,24,14.8
1,28,11,17,11,15,0,2,2,2,1,5,6,0,1,6,0,3,24,22.7
1,18,7,9,3,4,4,5,6,6,0,3,3,0,1,0,2,3,24,19.2
1,43,8,21,5,15,3,6,5,5,2,7,9,8,1,0,6,3,24,15.4
1,38,7,9,5,7,2,2,8,10,1,6,7,0,2,0,6,5,24,16.2
1,30,9,19,5,13,4,6,2,2,0,10,10,3,1,1,1,2,24,19.3
1,35,7,11,3,4,4,7,6,7,0,12,12,1,1,0,1,1,24,22.6
1,31,8,14,7,13,1,1,7,7,1,6,7,0,2,1,2,1,24,20.2
1,34,10,21,10,21,0,0,4,7,4,12,16,5,1,2,3,3,24,20.2
1,36,9,15,5,8,4,7,2,3,2,4,6,2,0,0,3,2,24,16.9
1,34,7,15,7,12,0,3,10,11,1,7,8,4,0,0,2,3,24,18.3
1,38,6,17,3,11,3,6,9,12,2,3,5,5,3,0,4,3,24,16.9
1,42,8,15,6,10,2,5,6,6,0,4,4,3,1,0,4,1,24,16.6
1,36,10,15,10,12,0,3,4,5,2,3,5,1,2,3,0,1,24,23.8
1,36,9,18,9,18,0,0,6,7,0,4,4,6,0,2,4,0,24,17.4
1,30,9,14,6,10,3,4,3,4,0,6,6,0,0,3,1,6,24,17.9
1,36,9,19,5,11,4,8,2,2,0,1,1,3,2,1,1,2,24,17.6
1,36,10,22,10,22,0,0,4,4,3,2,5,5,0,0,1,0,24,17.8
1,30,9,20,8,16,1,4,5,7,1,3,4,2,3,0,4,2,24,14
1,33,9,16,7,13,2,3,4,4,0,4,4,4,0,0,0,3,24,19.2
1,38,5,12,2,5,3,7,11,12,1,3,4,3,2,1,2,1,24,21.2
1,34,7,18,4,8,3,10,7,7,0,1,1,3,1,0,1,3,24,15.4
1,37,9,18,7,12,2,6,4,4,1,1,2,7,0,0,6,4,24,13.3
1,29,8,9,8,9,0,0,8,9,2,8,10,1,1,0,4,2,24,21.2
1,43,8,15,2,5,6,10,2,2,0,4,4,9,2,0,3,2,24,22.4
0,28,9,14,5,6,4,8,2,3,1,2,3,3,0,0,1,2,24,19
1,33,7,15,3,9,4,6,6,6,0,2,2,9,1,0,3,4,24,19.6
0,27,9,13,7,9,2,4,4,4,0,3,3,3,2,0,2,3,24,20.3
1,31,11,16,10,15,1,1,1,1,0,1,1,9,2,0,1,2,24,24
1,38,9,19,7,13,2,6,4,5,0,4,4,6,1,0,0,3,24,19.1
1,32,8,17,6,13,2,4,6,8,1,1,2,3,0,0,3,2,24,13.8
1,37,7,17,4,10,3,7,7,8,1,6,7,2,1,1,4,2,24,15.3
1,29,7,19,5,12,2,7,8,9,1,4,5,4,2,0,4,2,24,15
1,35,7,13,3,9,4,4,6,6,0,0,0,1,1,0,1,1,24,18
1,33,11,19,11,17,0,2,2,4,7,4,11,1,0,1,0,5,24,19.8
1,38,8,19,6,12,2,7,6,8,1,2,3,13,5,1,4,1,24,24.8
1,38,11,20,9,13,2,7,0,0,0,4,4,1,3,0,1,2,24,17.5
1,42,9,18,7,13,2,5,4,5,1,5,6,5,1,0,5,1,24,15.9
1,35,10,24,8,20,2,4,2,3,0,2,2,8,2,0,3,4,24,14.4
1,36,9,19,6,13,3,6,3,4,1,5,6,5,0,2,1,2,24,19.2
0,35,8,13,4,6,4,7,4,4,0,2,2,0,2,0,2,3,24,17.5
0,28,8,12,4,8,4,4,4,4,0,10,10,3,2,0,3,2,24,22.1
1,39,10,20,9,17,1,3,3,4,0,4,4,4,1,1,2,5,24,15.3
1,34,6,14,6,11,0,3,12,15,0,5,5,2,2,0,0,2,24,19.5
0,34,10,23,6,14,4,9,0,0,3,4,7,1,2,0,0,4,24,16.3
1,34,9,17,8,14,1,3,5,6,2,5,7,0,1,0,1,2,24,17.4
1,31,9,15,8,14,1,1,5,6,3,8,11,5,3,0,2,3,24,24.5
1,37,7,17,3,10,4,7,6,6,0,5,5,8,1,1,2,2,24,20.9
1,42,7,12,2,6,5,6,5,8,1,3,4,9,2,1,4,3,24,22.6
1,27,8,16,3,6,5,10,3,4,1,2,3,5,1,0,2,3,24,18.2
1,36,9,17,8,16,1,1,5,8,2,1,3,5,1,1,1,0,24,20.4
0,29,11,14,11,13,0,1,2,4,5,5,10,2,1,0,0,2,24,24.4
1,39,8,16,7,13,1,3,7,7,6,10,16,4,1,1,3,4,24,23.1
1,36,6,13,6,9,0,4,12,12,0,3,3,7,1,1,1,1,24,23.4
0,20,8,9,8,9,0,0,8,9,4,7,11,0,1,1,0,1,24,26.7
1,32,10,20,9,15,1,5,3,4,1,1,2,7,1,0,2,3,24,17.3
1,31,10,21,7,14,3,7,1,1,0,5,5,4,0,2,2,3,24,15.8
1,30,10,15,7,10,3,5,1,1,1,3,4,8,1,0,0,3,24,24.5
0,29,7,15,1,5,6,10,4,6,0,0,0,1,1,0,6,3,24,10
1,37,9,16,9,14,0,2,6,7,4,7,11,3,1,0,3,2,24,20.2
0,35,11,15,11,15,0,0,2,2,2,3,5,5,2,1,2,5,24,22.4
1,36,6,9,4,6,2,3,10,11,1,8,9,6,0,0,7,2,24,19.2
1,37,8,12,7,10,1,2,7,9,0,10,10,6,0,0,3,1,24,21.8
0,25,7,12,5,8,2,4,8,8,1,0,1,0,3,1,6,1,24,16.4
1,31,10,17,8,15,2,2,2,2,0,7,7,3,0,0,4,1,24,15.9
1,37,10,24,10,23,0,1,4,6,1,5,6,1,4,0,2,3,24,14.1
1,32,10,18,7,14,3,4,1,1,1,3,4,0,0,0,3,4,24,12.4
1,32,9,18,6,11,3,7,3,4,1,1,2,9,1,0,2,3,24,19.7
1,36,10,17,8,13,2,4,2,5,0,2,2,4,1,0,3,2,24,15.5
1,37,9,22,8,17,1,5,5,5,2,9,11,3,2,3,3,2,24,18.7
1,41,12,16,12,16,0,0,0,0,6,3,9,3,1,2,4,2,24,22.4
1,38,7,15,4,6,3,9,7,9,0,5,5,5,2,1,4,4,24,17.6
0,29,7,15,1,5,6,10,4,6,0,0,0,1,1,0,6,3,24,10
1,35,6,14,4,10,2,4,10,11,1,3,4,3,0,0,7,4,24,11.3
0,25,8,12,5,6,3,6,5,5,0,0,0,1,0,0,3,4,24,14.9
1,41,12,20,12,19,0,1,0,0,5,3,8,2,1,1,2,3,24,19.1
1,45,9,21,6,12,3,9,3,3,5,8,13,0,5,2,2,5,24,21.2
1,38,10,19,9,17,1,2,3,3,3,5,8,5,1,0,2,3,24,19.6
0,31,9,15,9,13,0,2,6,6,1,3,4,2,3,0,2,3,24,19.9
1,28,12,19,12,19,0,0,0,3,5,12,17,0,3,4,3,1,24,23.8
1,35,10,20,8,16,2,4,2,4,2,3,5,4,2,0,5,3,24,14.1
1,37,9,11,3,3,6,8,0,0,0,6,6,6,3,1,2,2,24,26.8
1,34,9,19,7,13,2,6,4,4,0,4,4,8,3,0,3,0,24,21.1
1,39,8,18,7,14,1,4,7,9,0,12,12,3,2,2,4,2,24,18.1
1,34,9,17,5,10,4,7,2,3,1,5,6,3,1,0,3,3,24,16.4
1,34,10,20,9,16,1,4,3,4,0,1,1,6,2,1,5,2,24,15
1,40,9,21,7,15,2,6,4,4,4,11,15,2,0,2,2,3,24,18.6
1,31,10,17,10,16,0,1,4,7,1,6,7,2,0,2,0,3,24,19
1,30,10,19,6,12,4,7,0,0,1,1,2,5,0,0,2,2,24,16.4
1,38,10,21,7,12,3,9,1,1,3,6,9,4,1,0,2,2,24,18.2
1,38,10,20,9,17,1,3,3,7,3,2,5,1,1,0,5,1,24,11.4
1,32,7,9,1,3,6,6,4,5,0,4,4,8,1,0,3,0,24,24.9
1,37,11,13,11,13,0,0,2,3,5,18,23,3,1,2,5,1,24,26.9
1,34,10,19,9,13,1,6,3,4,3,6,9,7,1,2,2,5,24,21.5
1,30,8,8,2,2,6,6,2,2,1,4,5,2,3,0,1,5,24,24.9
1,37,11,23,10,19,1,4,1,2,3,2,5,4,2,0,4,2,24,14.6
1,38,8,19,5,14,3,5,5,5,1,2,3,11,0,0,5,2,24,17.1
1,35,9,20,6,15,3,5,3,6,1,4,5,2,0,1,2,2,24,13.6
1,33,8,12,4,6,4,6,4,4,0,4,4,3,0,1,1,1,24,21.4
1,30,8,15,6,11,2,4,6,7,0,5,5,8,2,0,2,4,24,21.8
0,35,9,16,5,9,4,7,2,2,1,3,4,2,1,0,1,2,24,18.6
1,42,7,17,3,9,4,8,6,9,2,6,8,1,1,3,5,4,24,14.1
1,36,9,12,6,7,3,5,3,3,0,7,7,2,1,2,2,1,24,22.7
1,37,10,18,8,15,2,3,2,3,1,3,4,2,1,0,4,4,24,13.4
1,32,5,14,2,8,3,6,11,14,0,5,5,4,1,2,3,2,24,17.9
1,38,9,18,8,16,1,2,5,6,0,3,3,9,2,0,5,5,24,16.8
1,38,5,20,4,11,1,9,13,13,3,8,11,13,1,0,6,1,24,20.2
1,28,10,17,8,14,2,3,2,2,1,3,4,7,2,0,4,0,24,20.6
0,35,6,8,2,2,4,6,8,11,3,2,5,4,3,1,0,2,24,28
1,38,6,14,1,6,5,8,7,7,0,4,4,8,0,0,2,3,24,20.2
1,30,9,17,8,12,1,5,5,5,1,5,6,3,0,1,3,4,24,16.1
1,34,7,20,7,20,0,0,10,11,0,3,3,2,1,0,2,3,24,12.5
1,36,8,17,4,7,4,10,4,4,2,3,5,5,3,0,3,1,24,20.7
1,36,7,22,5,14,2,8,8,9,1,3,4,8,0,1,0,1,24,18.5
0,34,7,12,4,6,3,6,7,8,0,5,5,4,0,0,3,5,24,17.3
1,32,7,14,6,8,1,6,9,10,0,3,3,2,1,0,3,0,24,16.9
1,31,10,13,10,13,0,0,4,5,0,5,5,8,2,2,1,4,24,26.4
1,36,8,21,4,10,4,11,4,5,1,7,8,9,1,1,3,0,24,19.9
1,35,12,13,12,13,0,0,0,1,3,18,21,0,1,2,0,2,24,28.4
0,21,10,12,10,12,0,0,4,4,4,6,10,1,0,1,2,2,24,22.8
1,35,7,19,4,14,3,5,7,9,1,11,12,4,0,0,4,2,24,14.7
1,36,8,16,6,11,2,5,6,6,2,9,11,1,0,1,3,3,24,17.3
0,28,8,17,1,4,7,13,1,2,0,2,2,3,1,0,0,4,24,17
0,22,9,13,6,9,3,4,3,3,2,4,6,2,0,0,0,2,24,21.7
1,36,11,23,9,18,2,5,0,0,0,4,4,6,2,0,3,3,24,15.5
1,33,8,18,3,7,5,11,3,5,0,1,1,7,1,0,1,1,24,18.6
1,38,9,20,5,8,4,12,2,2,0,2,2,5,0,0,2,1,24,15.3
1,35,10,15,6,8,4,7,0,0,0,4,4,2,2,1,0,2,24,22
1,31,10,17,10,17,0,0,4,6,5,13,18,0,0,2,1,1,24,22.7
1,35,10,16,7,11,3,5,1,1,3,1,4,2,0,2,1,2,24,20.2
1,36,10,15,8,10,2,5,2,2,1,2,3,2,2,1,1,0,24,21.9
1,37,9,25,9,24,0,1,6,6,0,5,5,2,0,0,4,1,24,8.6
1,37,6,20,6,13,0,7,12,15,1,12,13,12,2,1,6,1,24,20.2
1,41,10,13,8,10,2,3,2,3,3,4,7,0,1,1,3,2,24,19.7
1,40,9,16,5,9,4,7,2,2,1,4,5,8,4,0,4,4,24,22.3
1,34,9,13,5,7,4,6,2,4,0,2,2,4,2,0,3,4,24,18.5
1,32,9,15,5,10,4,5,2,6,0,1,1,8,1,1,2,3,24,19.9
1,30,9,14,6,9,3,5,3,4,0,1,1,5,1,0,2,1,24,19.8
1,35,6,15,1,4,5,11,7,10,0,5,5,10,2,1,7,1,24,18.5
1,42,11,19,10,15,1,4,1,1,5,9,14,5,1,1,1,6,24,23.1
1,40,10,21,6,13,4,8,0,0,2,11,13,2,2,1,2,4,24,18.5
1,45,9,18,6,11,3,7,3,5,0,2,2,6,1,0,8,4,24,10.4
0,31,9,13,7,9,2,4,4,4,0,6,6,2,2,1,0,3,24,23.2
0,32,8,18,7,16,1,2,7,9,8,3,11,1,0,0,0,1,24,20.6
1,39,6,20,5,11,1,9,11,12,0,4,4,15,0,0,0,1,24,23.3
1,36,9,17,5,10,4,7,2,5,3,5,8,2,2,0,3,6,24,16.1
1,33,7,17,5,12,2,5,8,10,3,5,8,4,0,2,2,4,24,18.3
1,28,8,17,4,9,4,8,4,4,0,10,10,16,1,0,2,2,24,27.7
1,37,9,21,8,20,1,1,5,7,2,2,4,0,2,0,4,3,24,10.9
1,30,9,11,5,7,4,4,1,2,1,5,6,3,3,2,0,2,23,26.4
1,34,9,17,4,8,5,9,0,0,0,1,1,4,2,1,1,4,23,17.9
1,30,9,14,5,7,4,7,1,2,1,3,4,1,0,1,3,3,23,15.2
1,32,10,18,7,11,3,7,0,0,3,7,10,1,0,1,3,2,23,16.2
1,39,8,17,6,13,2,4,5,6,3,6,9,3,1,1,1,3,23,19.4
1,37,8,17,6,12,2,5,5,5,2,7,9,5,3,0,1,3,23,22.1
1,34,8,17,5,8,3,9,4,5,1,3,4,8,3,1,4,1,23,20.4
1,38,9,18,8,17,1,1,4,5,2,1,3,4,1,1,2,4,23,16.2
1,40,9,15,5,8,4,7,1,2,0,6,6,5,2,0,2,1,23,20.6
0,28,7,10,2,3,5,7,4,4,1,3,4,2,0,0,1,3,23,19.6
1,37,9,19,9,18,0,1,5,6,0,8,8,4,1,0,4,2,23,14.3
1,36,10,20,8,15,2,5,1,2,0,7,7,2,1,0,3,2,23,13.3
0,27,10,15,9,12,1,3,2,2,3,5,8,2,1,0,2,3,23,19.3
1,36,6,25,4,13,2,12,9,9,6,6,12,8,0,1,8,5,23,10.2
1,35,7,11,1,2,6,9,3,3,0,4,4,0,0,1,1,3,23,17.8
1,28,8,17,8,17,0,0,7,7,0,5,5,5,0,0,2,2,23,16.5
1,38,9,18,4,9,5,9,0,0,2,11,13,3,2,0,0,4,23,21.2
1,34,9,15,4,8,5,7,0,0,1,2,3,5,0,0,1,0,23,19.9
1,34,9,15,4,7,5,8,0,0,3,4,7,2,1,0,2,2,23,19
1,30,7,17,2,9,5,8,4,4,0,0,0,6,0,0,3,1,23,14.7
1,39,7,10,5,7,2,3,7,9,0,5,5,7,1,0,1,3,23,23.2
1,38,8,18,6,11,2,7,5,5,2,5,7,3,0,1,0,1,23,18.9
1,31,8,18,6,13,2,5,5,6,1,4,5,4,0,2,2,4,23,15.7
1,38,8,18,8,17,0,1,7,7,2,2,4,7,3,2,2,1,23,22.5
1,30,8,17,1,5,7,12,0,0,0,4,4,6,0,0,5,3,23,13.5
1,36,9,15,5,10,4,5,1,4,1,2,3,3,2,0,1,3,23,18.1
1,31,7,19,5,14,2,5,7,9,1,5,6,4,0,0,1,4,23,14.1
1,34,10,16,8,12,2,4,1,3,0,4,4,5,0,0,4,1,23,15.3
1,24,9,12,5,7,4,5,1,2,1,2,3,5,0,0,2,1,23,20.2
1,32,10,15,9,12,1,3,2,2,5,3,8,2,0,0,0,4,23,20.7
1,35,8,14,5,11,3,3,4,5,5,5,10,2,0,4,2,5,23,21.2
1,31,8,17,6,14,2,3,5,6,0,3,3,2,0,0,4,0,23,12.2
1,34,9,11,9,11,0,0,5,9,5,11,16,1,2,2,4,3,23,23
1,33,10,15,10,14,0,1,3,3,4,12,16,0,0,1,0,3,23,22.4
1,31,9,18,9,17,0,1,5,5,2,4,6,1,0,1,3,1,23,14.6
1,36,10,20,8,15,2,5,1,2,0,7,7,2,1,0,3,2,23,13.3
1,36,10,14,9,12,1,2,2,2,2,4,6,0,1,2,3,2,23,18.4
1,29,6,13,3,6,3,7,8,10,1,3,4,1,1,0,2,3,23,15.6
1,55,9,25,8,21,1,4,4,7,1,3,4,15,0,0,6,2,23,13.2
1,35,9,24,4,14,5,10,0,0,0,5,5,2,4,0,2,0,23,14.7
1,31,8,15,5,8,3,7,4,6,4,7,11,0,2,1,1,4,23,19.9
1,37,8,17,8,15,0,2,7,8,3,4,7,2,1,2,1,1,23,19.6
1,31,9,13,9,13,0,0,5,8,3,11,14,1,0,5,1,4,23,23.3
1,26,6,12,5,9,1,3,10,10,0,8,8,3,0,2,4,6,23,16.5
1,31,8,18,6,12,2,6,5,5,0,0,0,0,1,0,2,3,23,11.4
0,30,7,14,5,7,2,7,7,8,2,2,4,2,0,0,4,2,23,14.2
1,35,8,18,7,15,1,3,6,7,1,4,5,8,2,0,1,2,23,20.9
1,34,9,17,4,8,5,9,0,0,0,1,1,4,2,1,1,4,23,17.9
1,40,8,15,7,12,1,3,6,7,3,2,5,6,1,1,3,1,23,20.5
1,40,7,19,3,6,4,13,5,7,3,14,17,4,1,2,2,5,23,19.2
1,44,8,24,6,17,2,7,5,5,0,1,1,5,1,0,3,3,23,10
1,41,10,24,8,19,2,5,1,1,3,7,10,3,3,3,2,4,23,18
1,45,9,17,4,6,5,11,0,0,0,1,1,2,1,1,3,2,23,14.3
0,39,9,19,5,10,4,9,1,1,0,1,1,5,1,0,3,3,23,13.9
1,36,8,14,8,14,0,0,7,12,4,14,18,1,1,1,2,4,23,20.2
1,37,8,11,4,5,4,6,3,4,0,5,5,1,2,0,0,2,23,21.5
1,33,9,20,5,10,4,10,1,1,0,1,1,3,1,1,2,2,23,13.9
1,41,9,24,8,20,1,4,4,4,0,7,7,4,2,0,1,2,23,14.9
1,36,9,17,7,11,2,6,3,4,0,7,7,3,2,0,0,2,23,19.7
0,25,8,15,3,4,5,11,2,2,1,3,4,0,1,0,2,1,23,15.9
1,34,8,14,6,10,2,4,5,6,3,9,12,3,1,2,4,4,23,19.7
1,31,7,10,3,5,4,5,5,5,0,0,0,5,2,0,4,3,23,19.1
1,32,9,16,7,10,2,6,3,4,2,6,8,4,1,0,1,2,23,20.2
1,38,9,17,5,8,4,9,1,2,1,5,6,2,1,0,2,1,23,16.5
1,35,8,16,6,7,2,9,5,5,3,2,5,6,0,1,4,4,23,17
1,26,9,13,9,13,0,0,5,6,2,7,9,3,0,1,1,3,23,21.2
1,42,6,24,4,13,2,11,9,10,1,9,10,10,3,0,6,1,23,15.2
0,32,8,14,5,8,3,6,4,5,0,8,8,6,0,0,0,4,23,21
1,36,10,14,9,13,1,1,2,2,0,6,6,2,2,3,2,2,23,21.7
1,30,6,16,4,10,2,6,9,9,1,5,6,6,1,0,4,2,23,16.8
0,31,7,14,1,3,6,11,3,3,1,6,7,0,2,0,3,1,23,17.1
1,35,9,16,5,7,4,9,1,1,0,2,2,0,0,1,0,2,23,15.9
1,32,8,15,8,13,0,2,7,8,0,1,1,5,2,1,1,3,23,19.6
1,34,8,12,5,7,3,5,4,5,1,3,4,8,3,1,3,2,23,24.5
1,38,8,15,6,10,2,5,5,6,1,5,6,11,2,2,2,1,23,26.2
1,38,9,13,7,8,2,5,3,3,2,4,6,1,0,1,1,2,23,19.7
1,36,8,18,4,11,4,7,3,4,1,1,2,10,3,1,3,3,23,20.7
1,31,9,10,9,10,0,0,5,7,2,1,3,1,2,3,3,5,23,20.3
1,32,10,17,8,10,2,7,1,1,2,3,5,5,0,0,4,2,23,16.1
1,29,9,14,6,8,3,6,2,2,2,0,2,0,2,0,0,3,23,19
1,28,8,14,3,6,5,8,2,2,0,5,5,1,2,0,0,1,23,20.2
1,36,9,16,4,6,5,10,0,1,0,2,2,4,1,0,4,3,23,14.2
0,35,8,19,3,11,5,8,2,2,2,2,4,3,0,1,4,2,23,12.9
1,36,9,17,9,13,0,4,5,8,1,5,6,8,3,0,6,1,23,17.9
0,24,11,12,10,10,1,2,0,0,2,6,8,1,1,0,1,1,23,22.5
1,40,7,14,6,7,1,7,8,8,0,1,1,2,2,1,2,3,23,17.2
1,37,8,15,8,13,0,2,7,7,1,4,5,1,2,0,2,0,23,18.3
1,36,8,17,3,9,5,8,2,2,0,1,1,9,2,0,3,3,23,18.7
1,37,8,14,5,8,3,6,4,4,0,7,7,4,0,1,0,2,23,21.2
1,38,9,13,9,13,0,0,5,9,2,15,17,0,0,3,3,3,23,19.7
1,31,7,14,5,12,2,2,7,7,1,6,7,2,0,1,0,3,23,19.4
1,36,7,19,5,9,2,10,7,7,0,1,1,8,1,0,0,1,23,19
1,35,6,18,5,12,1,6,10,10,3,3,6,10,0,0,3,4,23,18.2
0,27,8,15,5,8,3,7,4,4,2,8,10,3,1,0,2,4,23,19
1,31,10,17,9,15,1,2,2,4,1,7,8,4,0,0,0,1,23,19.5
1,25,9,13,5,7,4,6,1,2,0,2,2,1,0,0,2,1,23,16
1,33,8,16,3,7,5,9,2,2,3,3,6,1,2,0,0,1,23,20.3
0,26,9,11,6,7,3,4,2,2,1,4,5,5,1,0,0,2,23,24.5
1,35,9,14,7,8,2,6,3,4,1,9,10,1,4,0,4,3,23,19.3
1,46,7,24,6,20,1,4,8,10,1,5,6,12,1,2,3,2,23,17.4
1,35,9,14,6,8,3,6,2,2,0,3,3,4,0,0,3,0,23,17.5
1,30,9,15,4,7,5,8,0,1,0,3,3,3,1,0,1,2,23,17.9
1,36,9,16,7,12,2,4,3,3,1,3,4,6,2,1,2,2,23,21.1
0,27,9,14,4,8,5,6,0,0,0,4,4,3,1,1,1,2,23,20
1,37,8,26,8,25,0,1,7,10,2,5,7,2,2,1,1,2,23,12
1,34,8,23,7,16,1,7,6,7,1,1,2,4,1,2,2,3,23,12.7
0,32,9,13,7,8,2,5,3,3,1,1,2,3,0,2,4,1,23,17.6
1,32,9,15,5,8,4,7,1,2,0,5,5,4,0,0,2,3,23,16.8
1,40,10,17,8,14,2,3,1,3,1,4,5,5,1,0,3,5,23,15.7
1,31,9,18,9,18,0,0,5,6,4,10,14,1,3,2,2,4,23,20.9
1,39,11,19,10,17,1,2,0,0,0,4,4,10,1,0,2,4,23,19.7
1,37,8,17,4,8,4,9,3,4,1,9,10,7,0,0,1,3,23,20
1,35,8,16,8,14,0,2,7,11,1,3,4,2,1,1,3,5,23,13.1
0,32,8,17,7,13,1,4,6,8,0,2,2,3,0,3,3,1,23,14.9
1,33,8,17,8,16,0,1,7,8,2,2,4,3,2,2,2,5,23,17.4
1,37,8,17,8,15,0,2,7,7,1,6,7,2,3,0,0,0,23,21.2
1,27,6,13,4,8,2,5,9,9,1,5,6,2,1,1,2,1,23,19.2
1,38,8,9,8,9,0,0,7,12,5,13,18,1,1,2,2,4,23,24.8
1,42,7,17,4,8,3,9,6,7,0,3,3,5,1,1,2,3,23,16.4
1,39,6,14,5,10,1,4,10,10,1,4,5,7,0,1,0,0,23,23.1
1,35,10,27,8,16,2,11,1,1,1,5,6,5,5,0,4,4,23,13.2
0,28,7,9,2,2,5,7,4,5,0,3,3,5,2,0,3,2,23,21.7
1,34,9,15,4,8,5,7,0,0,1,2,3,5,0,0,1,0,23,19.9
1,40,7,18,5,10,2,8,7,9,2,1,3,3,2,0,2,5,23,14.2
1,37,10,19,7,12,3,7,0,2,0,7,7,9,2,1,0,3,23,22.8
1,37,9,25,7,17,2,8,3,4,1,7,8,2,0,0,3,4,23,8.3
1,32,10,13,10,12,0,1,3,3,0,3,3,4,3,1,0,1,23,24.9
0,29,8,12,2,4,6,8,1,1,0,2,2,0,0,0,0,4,23,16.8
1,36,7,16,3,8,4,8,5,5,2,2,4,3,1,1,2,2,23,17.6
1,42,10,16,10,15,0,1,3,6,3,10,13,3,4,0,3,1,23,22.4
1,33,9,19,8,16,1,3,4,5,0,3,3,8,0,1,4,0,23,16.1
1,40,9,18,7,11,2,7,3,3,0,2,2,3,1,0,2,3,23,14.5
1,28,9,15,6,12,3,3,2,3,2,3,5,2,0,0,2,0,23,17.4
1,37,9,18,7,14,2,4,3,5,0,3,3,11,4,0,9,2,23,16
1,37,8,15,7,12,1,3,6,7,1,6,7,1,0,1,3,2,23,15.4
1,36,8,16,4,5,4,11,3,3,1,9,10,2,4,0,2,3,23,20.6
1,39,8,15,7,11,1,4,6,8,3,11,14,6,1,3,1,1,23,26.2
0,33,8,18,5,9,3,9,4,4,0,2,2,5,3,0,1,0,23,19.7
1,29,9,13,7,11,2,2,3,4,3,9,12,5,2,0,7,1,23,20
0,29,9,17,6,10,3,7,2,3,1,1,2,2,3,1,1,2,23,18.6
1,35,7,16,3,9,4,7,5,6,5,11,16,1,1,0,5,1,23,17.3
0,32,9,13,4,7,5,6,0,0,1,5,6,1,0,0,2,1,23,18
1,38,9,17,6,11,3,6,2,2,1,4,5,6,0,1,4,0,23,17.5
1,27,9,17,6,11,3,6,2,3,0,9,9,0,0,0,0,4,23,15.4
1,41,8,13,6,9,2,4,5,5,0,8,8,2,0,0,2,5,23,16.9
1,38,10,18,8,14,2,4,1,3,2,7,9,2,0,2,3,4,23,15.3
1,32,7,9,1,2,6,7,3,3,0,2,2,2,0,1,3,1,23,18.8
1,35,10,18,10,16,0,2,3,3,4,10,14,0,1,1,0,1,23,21.5
1,24,8,15,7,11,1,4,6,6,2,6,8,3,0,3,1,2,23,21.3
1,39,7,16,5,10,2,6,7,11,1,5,6,9,1,1,2,2,23,20.4
1,36,5,16,5,15,0,1,13,14,3,4,7,1,0,0,1,1,23,16
1,28,9,16,6,10,3,6,2,2,1,1,2,4,1,0,2,1,23,17.8
1,35,9,13,8,10,1,3,4,4,0,8,8,5,2,2,5,5,23,19.8
0,31,9,15,7,10,2,5,3,3,1,11,12,2,0,0,2,0,23,19.5
1,36,9,13,8,12,1,1,4,4,0,9,9,4,1,3,4,3,23,20.9
0,25,6,13,6,13,0,0,11,12,2,6,8,0,1,1,2,3,23,17.6
1,34,10,19,9,14,1,5,2,3,0,2,2,6,2,0,6,4,23,12.5
1,33,7,11,1,1,6,10,3,3,2,6,8,2,2,0,0,1,23,24.3
1,30,10,21,7,11,3,10,0,0,0,3,3,0,4,0,4,3,23,12
1,34,6,14,5,11,1,3,10,10,3,5,8,3,1,1,2,0,23,21
1,45,8,18,7,16,1,2,6,7,2,10,12,7,0,3,5,3,23,18.4
1,35,9,11,9,11,0,0,5,6,7,10,17,4,1,2,1,2,23,29.8
1,36,10,20,10,18,0,2,3,8,1,2,3,2,2,0,1,0,23,14.7
1,29,10,19,10,18,0,1,3,5,2,4,6,2,2,3,3,6,23,15.6
1,30,9,16,8,12,1,4,4,5,1,2,3,6,1,1,2,1,23,19.8
1,37,5,12,3,7,2,5,11,12,2,9,11,1,3,0,2,0,23,22
1,24,9,17,5,10,4,7,1,1,1,3,4,3,1,0,1,1,23,18
1,33,8,14,6,12,2,2,5,7,0,2,2,4,1,0,2,4,23,16.4
1,35,9,17,7,11,2,6,3,4,0,1,1,3,2,2,4,3,23,14.9
1,40,10,13,10,13,0,0,3,3,2,9,11,5,1,0,1,3,23,24.3
1,34,8,17,2,7,6,10,1,2,2,3,5,2,0,1,1,0,23,17.3
0,34,6,12,5,10,1,2,10,10,3,3,6,1,1,1,2,3,23,19.2
1,30,9,20,4,12,5,8,0,0,3,5,8,0,1,0,0,1,23,16.8
1,36,8,14,6,10,2,4,5,7,1,3,4,1,1,1,2,2,23,16.8
1,29,5,13,4,8,1,5,12,14,3,3,6,5,2,3,5,6,23,18.3
1,34,10,17,9,14,1,3,2,3,2,5,7,4,2,1,1,4,23,20.5
1,35,7,14,5,7,2,7,7,9,0,3,3,3,0,1,1,4,23,16.3
0,21,9,11,6,7,3,4,2,2,0,2,2,4,1,0,0,1,23,22.9
1,36,9,14,9,12,0,2,5,7,0,6,6,9,3,0,2,2,23,24.3
1,36,7,13,6,10,1,3,8,10,0,4,4,7,0,0,7,4,23,13.4
1,34,8,15,6,10,2,5,5,7,2,4,6,10,3,0,7,4,23,18.9
1,34,10,14,10,13,0,1,3,3,4,15,19,6,3,2,1,2,23,31.3
1,36,8,21,6,16,2,5,5,5,2,7,9,2,0,0,2,5,23,12.4
1,44,9,18,7,12,2,6,3,7,2,6,8,11,1,3,8,2,23,17.6
1,41,9,18,9,16,0,2,5,5,1,4,5,3,1,0,0,3,23,17.8
0,25,8,12,4,6,4,6,3,3,0,3,3,1,1,0,3,0,23,17.4
1,33,11,15,10,11,1,4,0,1,0,0,0,6,2,1,0,2,23,22.6
1,33,9,15,7,11,2,4,3,5,0,1,1,3,0,0,2,0,23,15.7
1,38,9,15,7,10,2,5,3,3,1,5,6,5,0,1,0,2,23,21.7
1,39,8,17,6,11,2,6,5,5,0,6,6,7,2,1,3,4,23,19.1
1,35,10,20,10,19,0,1,3,3,2,6,8,3,3,0,1,4,23,18.7
1,39,11,14,10,13,1,1,0,0,0,5,5,1,1,0,1,3,23,18.6
1,35,9,15,7,12,2,3,3,4,1,3,4,10,1,0,3,3,23,21.1
1,32,9,15,4,7,5,8,0,0,0,3,3,3,3,0,2,1,23,19.7
1,39,7,15,5,8,2,7,7,8,1,11,12,7,2,0,3,0,23,22.8
1,37,9,20,5,12,4,8,1,3,1,4,5,1,1,3,6,3,23,10.3
1,41,10,12,8,10,2,2,1,2,3,5,8,5,2,0,3,3,23,23.1
1,41,5,14,5,9,0,5,13,17,3,5,8,3,2,4,2,4,23,20.5
1,34,9,18,7,14,2,4,3,3,1,4,5,2,2,0,1,1,23,17.9
1,37,6,10,2,4,4,6,7,8,0,2,2,2,0,0,0,2,23,19.2
1,37,8,14,5,8,3,6,4,4,0,7,7,4,0,1,0,2,23,21.2
1,39,8,19,8,17,0,2,7,7,1,3,4,10,3,0,2,0,23,22.5
1,28,9,16,4,8,5,8,0,0,0,4,4,2,0,0,4,2,23,13.2
1,38,11,13,11,12,0,1,1,1,4,9,13,0,1,0,2,3,23,21.6
1,35,9,17,7,13,2,4,3,5,0,5,5,1,2,0,2,3,23,14.9
1,42,8,16,5,11,3,5,4,4,0,4,4,3,0,0,1,2,23,16.5
1,37,9,22,8,18,1,4,4,7,2,0,2,5,1,1,1,4,23,14
1,32,8,16,5,11,3,5,4,5,1,3,4,2,3,0,0,3,23,19.4
1,33,10,12,10,12,0,0,3,5,9,12,21,1,0,0,3,2,23,24.6
1,39,6,14,5,11,1,3,10,10,0,5,5,7,0,0,2,1,23,19.6
0,30,7,11,5,7,2,4,7,9,3,3,6,2,1,2,2,1,23,21.7
1,37,8,13,7,11,1,2,6,7,1,3,4,7,0,0,2,3,23,20
1,33,7,14,4,9,3,5,6,7,0,4,4,3,1,1,1,1,23,19.2
1,39,9,17,6,10,3,7,2,2,1,1,2,5,1,0,1,4,23,17.6
0,23,9,12,9,12,0,0,5,5,3,1,4,2,1,0,1,3,23,20.8
1,34,10,19,8,13,2,6,1,2,1,8,9,6,0,1,1,3,23,19.1
1,30,10,13,9,12,1,1,2,3,2,8,10,1,0,2,2,2,23,20.6
1,38,10,21,9,17,1,4,2,2,1,5,6,3,0,0,3,2,23,12.8
1,32,8,21,3,12,5,9,2,2,0,1,1,5,0,1,2,1,23,13.6
1,33,8,14,3,5,5,9,2,2,0,3,3,8,0,0,1,0,23,21.9
1,40,6,18,3,7,3,11,8,8,1,8,9,10,0,0,5,2,23,17.1
1,32,10,20,8,16,2,4,1,1,0,6,6,4,2,0,1,3,23,17.4
1,34,9,18,9,18,0,0,5,6,1,17,18,2,2,0,5,3,23,16.6
1,38,10,20,10,20,0,0,3,9,5,9,14,1,1,3,0,3,23,19.4
1,28,9,14,6,7,3,7,2,2,0,3,3,3,2,0,0,2,23,21
1,36,10,16,9,14,1,2,2,2,0,7,7,1,0,3,0,3,23,19.5
1,35,8,12,7,9,1,3,6,7,0,2,2,8,2,0,0,1,23,25.2
1,35,8,17,7,13,1,4,6,6,0,3,3,4,0,2,1,4,23,16.8
1,34,10,20,10,18,0,2,3,5,2,9,11,5,5,1,2,3,23,22.3
1,31,7,17,5,13,2,4,7,8,3,4,7,0,1,1,4,4,23,12.9
1,31,10,14,9,12,1,2,2,3,1,10,11,2,0,0,1,2,23,20.1
1,30,6,16,0,5,6,11,5,6,3,5,8,2,0,0,0,1,23,18.4
1,35,9,19,4,8,5,11,0,0,0,2,2,1,2,0,1,1,23,15.2
1,31,9,16,5,9,4,7,1,2,1,1,2,4,2,1,3,1,23,18.1
1,29,9,11,6,7,3,4,2,2,1,3,4,7,1,1,0,1,23,26.7
1,36,7,15,4,8,3,7,6,6,0,3,3,0,1,0,3,3,23,13
1,36,7,8,7,8,0,0,9,12,2,8,10,1,1,1,2,4,23,21.6
1,37,8,16,8,14,0,2,7,12,3,7,10,2,2,0,4,1,23,16.2
1,35,10,22,10,17,0,5,3,5,0,7,7,4,0,0,0,3,23,14.5
1,33,8,16,5,11,3,5,4,4,0,5,5,5,2,4,4,3,23,19.6
1,35,9,16,9,12,0,4,5,5,0,11,11,6,2,3,4,3,23,21.8
1,31,9,14,4,5,5,9,0,0,0,2,2,4,1,0,2,5,23,17.2
1,35,11,18,11,15,0,3,1,3,2,7,9,6,0,1,1,6,23,19
1,37,9,19,8,13,1,6,4,8,0,9,9,9,2,0,5,0,23,17.7
1,38,10,17,7,11,3,6,0,1,0,4,4,11,2,2,5,1,23,21.6
1,38,8,18,4,9,4,9,3,3,0,6,6,6,2,0,4,3,23,16.4
1,36,9,17,7,11,2,6,3,3,1,1,2,0,0,0,2,2,23,12.9
1,33,10,11,10,11,0,0,3,3,3,11,14,1,0,3,2,3,23,24.3
1,25,6,15,4,9,2,6,9,12,2,10,12,2,3,0,2,3,23,19.3
1,34,9,18,6,10,3,8,2,3,0,4,4,6,0,0,3,3,23,14.8
1,32,9,15,5,10,4,5,1,3,1,1,2,12,0,0,1,4,23,22.1
1,30,7,13,1,3,6,10,3,3,1,4,5,2,1,0,0,3,23,19.8
1,38,8,16,5,8,3,8,4,4,0,5,5,3,0,0,2,1,23,16.2
1,30,11,16,10,15,1,1,0,0,0,7,7,6,0,1,1,3,23,21
1,33,9,14,9,14,0,0,5,7,1,6,7,3,0,0,4,4,23,15
1,32,8,14,5,11,3,3,4,5,1,5,6,1,2,0,4,2,23,16.1
1,37,8,16,3,10,5,6,2,2,5,8,13,1,0,0,2,5,23,17.6
1,28,10,13,10,13,0,0,3,4,1,2,3,3,2,1,2,1,23,21.2
1,30,7,14,5,9,2,5,7,9,2,6,8,8,4,2,0,4,23,27.8
1,34,10,20,9,15,1,5,2,3,6,11,17,2,4,1,1,5,23,23.2
1,38,10,17,10,14,0,3,3,4,2,16,18,5,1,3,6,3,23,20.3
1,30,8,14,7,11,1,3,6,8,1,4,5,4,3,0,5,1,23,17.9
1,37,9,12,9,12,0,0,5,6,3,10,13,0,1,1,1,3,23,22.4
1,33,10,17,9,15,1,2,2,3,1,8,9,3,3,1,2,5,23,19.6
0,35,10,14,8,10,2,4,1,1,3,4,7,3,1,0,1,2,23,21.8
1,36,8,14,5,9,3,5,4,4,1,2,3,5,2,1,3,3,23,19.7
1,35,7,17,5,12,2,5,7,7,1,3,4,5,0,1,4,3,23,14.5
1,29,4,13,3,11,1,2,14,15,0,0,0,5,1,0,2,4,23,16
1,31,7,13,6,12,1,1,8,9,4,8,12,3,1,1,1,2,23,23.5
1,33,8,18,6,13,2,5,5,6,3,3,6,4,1,0,4,1,23,15.6
1,34,8,19,4,9,4,10,3,4,1,0,1,8,1,0,4,3,23,14.6
1,33,8,17,5,11,3,6,4,4,1,5,6,4,2,1,2,4,23,18.4
1,31,8,16,7,11,1,5,6,6,1,5,6,3,1,1,3,5,23,16
1,27,8,12,8,12,0,0,7,8,1,3,4,2,1,1,4,3,23,16.9
1,35,9,19,7,14,2,5,3,4,2,3,5,1,1,0,2,3,23,13.7
1,46,5,20,3,15,2,5,11,11,2,3,5,7,1,1,3,4,23,15.3
1,24,9,13,4,5,5,8,0,0,0,0,0,1,0,1,0,2,23,18.1
1,31,7,15,4,9,3,6,6,6,0,2,2,11,1,0,2,3,23,21.4
0,29,9,12,4,6,5,6,0,0,0,3,3,4,1,0,2,1,23,20.5
0,27,8,14,6,8,2,6,5,6,0,0,0,3,0,0,0,4,23,16.5
1,35,8,15,5,11,3,4,4,5,0,2,2,13,6,0,5,3,23,24.8
1,38,9,15,5,8,4,7,1,2,0,3,3,5,0,0,3,1,23,16.7
1,33,10,13,9,11,1,2,2,4,1,9,10,7,2,1,2,1,23,25.7
1,32,10,17,7,14,3,3,0,0,3,6,9,4,2,2,2,2,23,22.4
0,28,3,6,2,5,1,1,16,17,0,5,5,3,1,1,0,2,23,24.1
0,20,9,11,6,7,3,4,2,3,0,0,0,0,1,3,1,2,23,19.8
1,34,8,11,4,4,4,7,3,4,0,3,3,4,0,0,1,4,23,19.2
1,34,7,14,4,7,3,7,6,7,0,2,2,2,1,0,3,2,23,14.8
0,28,7,13,5,11,2,2,7,9,0,2,2,2,1,0,1,1,23,17.5
1,27,7,11,3,6,4,5,5,7,1,3,4,1,2,1,1,1,23,20.9
1,25,9,12,5,5,4,7,1,3,2,1,3,0,1,0,1,1,23,18.7
1,38,7,20,6,18,1,2,8,10,0,4,4,3,0,0,1,2,23,12.5
1,34,9,14,4,7,5,7,0,0,0,3,3,7,0,0,4,2,23,17.8
1,43,9,18,5,10,4,8,1,2,2,7,9,1,0,1,1,1,23,17.1
1,31,9,19,8,16,1,3,4,4,1,3,4,8,2,3,4,1,23,20.2
1,33,8,16,2,5,6,11,1,1,0,2,2,0,0,1,1,2,23,14.5
0,31,9,15,5,8,4,7,1,2,1,3,4,4,3,0,1,2,23,21.3
1,34,8,16,5,8,3,8,4,6,0,9,9,1,0,1,1,2,23,16.5
1,37,9,22,8,16,1,6,4,4,6,10,16,5,0,2,3,2,23,19.5
1,36,8,18,7,10,1,8,6,6,1,9,10,4,1,0,1,3,23,18.6
1,37,9,18,9,18,0,0,5,6,7,6,13,2,0,2,1,2,23,21.3
1,32,8,14,5,9,3,5,4,4,2,1,3,7,1,0,1,4,23,21.4
0,26,10,15,10,13,0,2,3,3,3,5,8,3,1,0,1,4,23,20.6
1,35,7,21,6,15,1,6,8,9,3,10,13,13,2,0,3,2,23,23.1
1,37,8,12,6,9,2,3,5,5,1,4,5,10,1,0,4,1,23,23.3
1,42,8,13,2,5,6,8,1,2,0,5,5,10,2,0,1,4,23,24.6
1,34,7,14,4,7,3,7,6,7,0,2,2,2,1,0,3,2,23,14.8
1,31,9,18,6,15,3,3,2,3,0,1,1,8,1,0,3,3,23,16.3
1,34,10,12,10,12,0,0,3,6,3,13,16,0,0,1,3,3,23,19.9
1,32,8,14,4,6,4,8,3,5,0,2,2,5,3,0,1,1,23,21.3
0,31,6,18,3,15,3,3,8,9,1,4,5,2,1,0,3,0,23,13.7
0,26,7,8,6,7,1,1,7,9,1,0,1,1,0,0,2,2,22,17
1,31,8,13,7,11,1,2,5,7,0,3,3,5,2,0,2,5,22,17.7
1,32,7,10,2,3,5,7,3,3,1,4,5,6,2,1,3,1,22,23.2
0,25,8,12,2,4,6,8,0,0,0,5,5,2,2,1,1,2,22,20.6
0,23,8,11,5,6,3,5,3,3,1,2,3,0,0,0,0,0,22,18.8
1,40,8,19,6,13,2,6,4,8,1,6,7,0,1,2,4,4,22,9.6
1,37,7,14,5,10,2,4,6,8,0,3,3,6,1,0,4,3,22,15.1
1,36,6,15,6,14,0,1,10,10,1,2,3,1,1,1,2,3,22,14.4
1,32,7,10,4,6,3,4,5,6,1,2,3,0,1,0,0,2,22,18.9
1,38,9,16,7,10,2,6,2,2,0,2,2,6,0,0,3,5,22,14.2
1,38,7,14,3,6,4,8,4,7,1,1,2,0,0,1,1,3,22,13.3
1,32,8,18,5,11,3,7,3,3,0,3,3,5,2,0,2,0,22,17
1,28,4,9,3,6,1,3,13,18,3,10,13,2,2,5,4,3,22,22.1
1,28,9,16,5,9,4,7,0,0,0,2,2,6,0,1,3,3,22,15.7
0,21,10,16,10,16,0,0,2,2,6,6,12,1,1,1,2,3,22,20
0,25,10,16,10,15,0,1,2,3,1,7,8,1,3,0,4,3,22,15.7
1,35,8,18,5,9,3,9,3,3,0,3,3,5,0,0,3,2,22,13.2
1,37,9,21,7,16,2,5,2,2,3,2,5,1,1,0,0,1,22,14.9
1,29,9,19,8,17,1,2,3,4,0,3,3,4,0,0,4,1,22,11.2
1,32,8,10,5,5,3,5,3,4,3,2,5,4,2,0,1,4,22,22.7
1,36,8,12,8,11,0,1,6,7,6,8,14,14,2,2,2,0,22,34.2
1,38,9,19,7,14,2,5,2,3,1,7,8,6,2,1,3,2,22,17.8
1,37,9,17,5,11,4,6,0,0,1,4,5,3,1,0,2,0,22,16.7
1,37,9,12,9,12,0,0,4,5,2,15,17,2,0,2,2,3,22,22.3
1,38,8,17,4,6,4,11,2,2,0,3,3,4,1,0,5,5,22,11
1,37,5,13,1,6,4,7,8,9,1,6,7,6,2,3,2,2,22,22.5
1,33,8,19,7,15,1,4,5,5,0,1,1,2,0,0,2,3,22,10.4
1,38,9,16,6,9,3,7,1,2,0,2,2,2,1,0,2,2,22,14.2
1,40,8,15,6,10,2,5,4,5,2,10,12,0,0,0,1,6,22,15.3
1,30,7,20,3,10,4,10,4,7,1,6,7,5,3,0,1,3,22,16.4
1,30,7,20,3,10,4,10,4,7,1,6,7,5,3,0,1,3,22,16.4
1,38,9,14,8,11,1,3,3,3,1,4,5,10,3,2,8,3,22,19.9
1,29,8,11,5,7,3,4,3,5,3,5,8,3,0,1,2,0,22,21.1
1,32,9,14,7,11,2,3,2,4,1,3,4,1,1,0,0,3,22,17.1
1,32,8,21,7,18,1,3,5,8,2,11,13,6,3,2,6,2,22,15.8
1,38,8,17,5,11,3,6,3,4,1,2,3,2,2,0,2,2,22,14.8
1,32,6,13,4,8,2,5,8,8,1,3,4,9,1,0,0,3,22,23
0,20,8,13,7,11,1,2,5,6,2,6,8,0,0,0,1,3,22,16.7
1,31,5,13,2,7,3,6,9,10,1,3,4,5,1,0,3,3,22,16.4
0,33,7,13,0,4,7,9,1,2,0,10,10,4,0,0,4,2,22,16.3
1,34,9,15,5,9,4,6,0,0,0,4,4,1,1,0,1,3,22,15.8
1,33,8,17,6,13,2,4,4,7,4,5,9,3,3,3,2,1,22,21.2
1,36,8,15,6,7,2,8,4,5,0,5,5,12,0,0,5,5,22,17.2
1,35,9,21,7,17,2,4,2,2,1,2,3,2,1,1,0,3,22,14.1
1,31,8,12,8,10,0,2,6,8,0,1,1,9,1,1,1,3,22,22.1
1,32,9,24,8,20,1,4,3,5,1,4,5,5,2,0,1,5,22,12.4
1,36,8,17,4,11,4,6,2,2,4,9,13,0,1,2,4,3,22,16
1,30,7,15,6,13,1,2,7,8,1,0,1,11,0,0,1,3,22,20.1
1,29,8,14,8,13,0,1,6,7,0,3,3,3,0,0,3,1,22,14.6
1,36,7,18,6,10,1,8,7,7,0,2,2,6,0,0,3,2,22,13.2
1,37,9,16,7,12,2,4,2,2,3,3,6,1,2,0,0,4,22,18.5
1,31,9,13,9,12,0,1,4,7,1,5,6,1,0,2,2,4,22,16
1,36,8,20,5,13,3,7,3,5,2,2,4,6,3,0,2,2,22,16.8
1,34,6,11,4,6,2,5,8,8,1,4,5,1,1,1,2,1,22,18.6
0,22,9,18,8,12,1,6,3,5,1,1,2,1,2,0,1,1,22,14.5
1,28,9,18,7,15,2,3,2,2,1,3,4,2,2,1,0,2,22,17.9
1,24,9,16,9,14,0,2,4,4,1,3,4,9,1,0,3,2,22,19.5
1,36,8,13,7,11,1,2,5,5,0,5,5,1,1,0,5,3,22,13.1
0,26,8,13,6,8,2,5,4,6,0,2,2,2,0,0,0,2,22,16.5
1,37,9,16,7,10,2,6,2,2,0,5,5,3,1,0,0,4,22,17.4
1,34,8,15,7,11,1,4,5,6,1,1,2,6,0,0,3,4,22,14.9
1,36,6,19,4,12,2,7,8,8,0,10,10,5,3,0,5,1,22,15.2
1,41,8,27,7,22,1,5,5,7,1,7,8,9,3,0,4,4,22,12
1,26,6,15,6,14,0,1,10,10,1,5,6,3,1,0,3,3,22,15
0,30,7,12,3,6,4,6,4,5,0,2,2,6,1,1,4,3,22,17.3
0,26,8,13,3,8,5,5,1,2,0,3,3,0,2,0,1,1,22,17.2
0,35,8,13,6,9,2,4,4,4,1,3,4,7,0,1,3,2,22,19.5
1,36,6,18,4,13,2,5,8,9,2,8,10,2,2,2,3,4,22,15.4
1,26,8,16,4,9,4,7,2,2,1,1,2,3,1,0,1,2,22,16.3
1,35,7,20,7,17,0,3,8,8,0,9,9,1,0,1,2,6,22,10.5
1,38,7,12,7,11,0,1,8,11,5,7,12,7,0,1,2,3,22,23.2
1,26,9,17,9,17,0,0,4,4,0,5,5,0,1,0,2,4,22,12.6
1,31,6,10,5,9,1,1,9,10,1,9,10,12,1,0,3,3,22,25.6
1,28,7,12,3,5,4,7,4,4,1,2,3,0,1,1,1,3,22,17.2
0,33,8,17,7,12,1,5,5,7,1,4,5,0,2,1,0,2,22,16.3
1,24,9,14,5,6,4,8,0,0,0,1,1,2,3,0,2,0,22,18.5
1,34,8,14,5,7,3,7,3,4,1,2,3,6,4,0,3,2,22,20.7
1,28,8,12,8,10,0,2,6,6,2,8,10,0,0,2,1,4,22,19.4
1,31,8,16,4,5,4,11,2,2,2,0,2,1,3,0,1,2,22,17.3
1,30,11,12,11,12,0,0,0,3,5,5,10,2,1,3,2,1,22,23.9
1,35,5,6,5,6,0,0,12,18,3,9,12,2,1,3,0,2,22,25.9
1,33,9,20,9,18,0,2,4,6,0,3,3,3,2,0,4,0,22,11.8
1,35,7,12,5,9,2,3,6,6,2,3,5,2,0,0,2,2,22,17.3
1,33,9,13,6,8,3,5,1,1,0,2,2,7,1,0,0,2,22,22.2
1,38,7,20,5,15,2,5,6,7,2,4,6,9,4,0,4,3,22,18.1
1,33,9,12,7,9,2,3,2,2,0,2,2,4,0,1,1,3,22,19.1
0,26,6,11,3,6,3,5,7,7,1,1,2,4,1,0,4,1,22,17.1
1,30,6,11,4,5,2,6,8,8,2,4,6,6,1,0,1,1,22,23.1
1,35,7,18,5,12,2,6,6,6,2,7,9,4,3,0,3,3,22,17.3
1,36,9,22,7,14,2,8,2,2,3,6,9,7,1,0,2,2,22,17.2
1,34,10,22,9,15,1,7,1,2,1,6,7,1,5,0,2,3,22,15.2
1,40,8,17,4,9,4,8,2,2,1,4,5,3,3,1,3,2,22,17.2
1,35,9,13,7,9,2,4,2,2,2,3,5,3,1,0,2,1,22,19.5
1,33,8,17,6,12,2,5,4,4,2,4,6,1,2,4,1,3,22,19.2
1,38,6,8,6,8,0,0,10,11,3,8,11,0,0,4,3,2,22,21.9
1,29,7,13,5,7,2,6,6,6,1,4,5,2,1,0,1,1,22,18.6
0,31,7,13,2,5,5,8,3,4,0,2,2,3,0,0,2,2,22,15.2
1,35,8,19,6,13,2,6,4,5,3,7,10,4,1,1,4,2,22,15.4
1,37,9,24,7,16,2,8,2,3,3,3,6,5,1,3,0,2,22,17.2
1,42,9,22,8,18,1,4,3,4,0,4,4,4,0,0,2,3,22,10.6
0,28,9,12,8,8,1,4,3,4,0,4,4,1,0,0,2,4,22,15.1
0,26,10,13,8,9,2,4,0,0,0,0,0,2,1,0,2,1,22,16.9
0,31,7,17,6,12,1,5,7,8,0,0,0,3,1,0,4,4,22,10
1,29,9,14,9,12,0,2,4,6,1,2,3,2,1,0,0,1,22,18.3
1,39,9,20,7,17,2,3,2,3,2,4,6,3,2,0,1,4,22,15.3
1,29,8,15,4,8,4,7,2,3,0,2,2,5,1,0,2,1,22,17
1,26,9,9,9,9,0,0,4,5,2,7,9,6,0,1,2,3,22,24.1
1,38,8,15,5,9,3,6,3,4,1,1,2,4,1,1,1,2,22,18
0,18,8,12,2,4,6,8,0,0,1,2,3,2,0,0,0,3,22,18.3
1,34,9,14,6,9,3,5,1,1,1,3,4,0,0,0,2,2,22,14.6
1,31,9,16,8,14,1,2,3,3,0,10,10,7,3,1,3,1,22,22.6
1,26,8,10,4,4,4,6,2,2,0,5,5,1,2,0,1,1,22,21
1,23,8,16,8,16,0,0,6,7,2,4,6,1,1,4,3,2,22,16.9
1,30,9,14,9,14,0,0,4,6,8,8,16,1,0,1,1,0,22,23.4
1,42,8,17,2,7,6,10,0,0,3,6,9,3,4,0,2,3,22,20.1
1,33,7,14,5,9,2,5,6,6,1,3,4,7,0,0,4,0,22,17.5
1,35,8,17,3,10,5,7,1,5,0,3,3,3,3,0,0,0,22,17.7
1,34,7,17,5,10,2,7,6,8,1,6,7,10,1,1,2,1,22,20.9
1,36,7,15,5,11,2,4,6,6,0,5,5,7,1,1,2,2,22,19.6
1,29,9,12,9,12,0,0,4,4,1,5,6,1,2,0,2,3,22,18.9
0,35,8,15,6,11,2,4,4,4,1,2,3,2,1,0,1,0,22,17.4
1,36,7,12,7,8,0,4,8,10,1,5,6,1,3,0,2,4,22,17.9
1,32,9,19,9,16,0,3,4,5,1,5,6,1,1,5,4,6,22,12.9
1,34,6,13,3,8,3,5,7,9,0,5,5,2,2,0,3,1,22,16
1,40,4,18,3,12,1,6,13,15,1,3,4,2,3,0,4,3,22,11
0,24,8,13,4,6,4,7,2,3,0,3,3,6,2,2,5,3,22,18
1,33,7,17,7,17,0,0,8,9,0,2,2,2,0,0,2,2,22,11.7
1,38,9,22,6,14,3,8,1,1,2,8,10,2,0,0,6,2,22,8.6
1,37,6,12,6,12,0,0,10,13,7,10,17,0,1,1,3,0,22,21.4
1,37,9,16,7,12,2,4,2,2,2,10,12,1,2,4,5,4,22,17.7
1,33,7,14,3,5,4,9,4,4,2,6,8,7,2,0,3,3,22,20.9
1,32,10,17,10,16,0,1,2,2,0,6,6,0,0,0,1,3,22,13.7
0,20,7,11,5,9,2,2,6,9,3,6,9,0,2,0,1,1,22,20.4
1,36,7,16,4,7,3,9,5,7,0,6,6,5,0,1,0,2,22,18
1,38,8,22,4,11,4,11,2,2,1,6,7,3,0,0,2,2,22,11.6
1,36,8,17,6,11,2,6,4,5,1,2,3,8,1,0,1,0,22,19.8
1,34,9,16,7,13,2,3,2,2,1,6,7,3,1,0,0,5,22,18
1,35,6,15,1,5,5,10,5,6,0,1,1,1,0,0,2,3,22,11.3
0,27,9,17,7,12,2,5,2,4,1,4,5,1,0,0,1,2,22,13.7
1,35,9,12,9,12,0,0,4,5,2,4,6,1,0,0,0,4,22,18.5
0,28,10,13,8,10,2,3,0,1,0,1,1,3,0,0,0,1,22,18.5
1,38,5,18,4,13,1,5,11,12,3,3,6,1,1,0,2,1,22,13.3
1,38,7,15,1,2,6,13,2,3,0,3,3,0,2,0,1,1,22,15.4
0,39,7,17,5,10,2,7,6,6,0,2,2,6,0,1,3,1,22,15
0,32,8,14,3,5,5,9,1,2,0,2,2,2,4,0,1,0,22,20
1,35,6,14,6,13,0,1,10,10,0,5,5,6,4,1,2,1,22,22.6
1,35,8,15,8,13,0,2,6,6,0,6,6,7,1,0,1,1,22,21
0,29,7,13,4,5,3,8,5,6,0,3,3,2,0,0,1,0,22,16.6
1,36,9,15,7,12,2,3,2,2,2,6,8,1,2,1,4,1,22,17.3
1,36,9,17,8,14,1,3,3,7,1,7,8,3,2,2,4,3,22,15.2
1,37,8,19,7,16,1,3,5,5,0,3,3,13,1,1,5,4,22,17
1,37,6,21,5,17,1,4,9,9,1,7,8,5,0,0,1,2,22,14.2
1,36,8,17,5,11,3,6,3,4,0,2,2,4,2,2,3,3,22,15.5
1,33,8,16,5,8,3,8,3,7,0,4,4,4,0,0,7,3,22,8.2
1,35,9,9,9,9,0,0,4,5,7,10,17,0,0,2,0,3,22,27
1,32,9,20,7,12,2,8,2,2,3,1,4,0,2,0,1,3,22,13.8
1,38,8,19,4,10,4,9,2,2,0,8,8,2,2,2,2,1,22,16.7
0,32,8,14,8,14,0,0,6,6,2,10,12,3,1,0,2,3,22,19.7
1,31,7,13,7,8,0,5,8,10,0,3,3,4,3,1,3,2,22,18.5
0,28,9,12,7,9,2,3,2,2,0,0,0,2,3,0,3,0,22,18.6
1,23,7,13,6,11,1,2,7,9,0,5,5,0,1,3,1,2,22,17.7
1,33,9,17,7,11,2,6,2,4,0,5,5,0,1,0,6,2,22,8.6
1,37,8,14,8,12,0,2,6,10,0,8,8,4,0,0,3,1,22,15.6
1,32,10,19,10,18,0,1,2,2,1,5,6,5,1,2,0,2,22,20
1,36,8,14,5,7,3,7,3,3,1,6,7,1,1,1,1,4,22,17.7
1,33,6,10,3,4,3,6,7,7,0,1,1,0,0,0,1,4,22,15.1
1,37,7,21,6,12,1,9,7,7,0,9,9,8,1,0,4,2,22,14.6
1,35,10,17,10,14,0,3,2,3,1,2,3,11,2,1,4,1,22,21
1,38,10,22,10,18,0,4,2,2,0,2,2,10,2,0,2,1,22,17.8
1,34,8,15,6,9,2,6,4,4,1,2,3,2,2,3,0,1,22,21.1
1,34,8,17,3,5,5,12,1,1,1,5,6,0,1,1,2,3,22,14
1,34,8,14,7,9,1,5,5,5,2,4,6,4,0,0,2,1,22,18.4
1,37,7,21,6,12,1,9,7,7,0,9,9,8,1,0,4,2,22,14.6
1,30,7,12,5,9,2,3,6,6,3,7,10,7,1,1,3,1,22,23.8
1,39,7,22,5,15,2,7,6,10,2,10,12,2,0,1,2,3,22,11.1
0,36,8,13,8,12,0,1,6,7,0,2,2,6,1,1,1,2,22,20.4
1,37,9,16,7,11,2,5,2,2,0,6,6,3,1,2,0,2,22,19.9
1,26,8,12,4,5,4,7,2,3,2,4,6,1,0,0,0,0,22,19.7
1,25,8,14,8,13,0,1,6,6,1,4,5,1,0,0,1,4,22,15.4
1,28,8,16,4,9,4,7,2,2,2,2,4,2,1,2,1,3,22,17.6
1,33,8,21,7,14,1,7,5,6,0,3,3,7,0,0,1,1,22,14.5
0,25,8,14,6,10,2,4,4,5,0,5,5,2,1,0,1,3,22,16.7
1,25,7,13,3,9,4,4,4,4,2,4,6,2,1,4,6,3,22,16.3
1,34,6,13,5,10,1,3,9,9,3,3,6,10,1,0,2,3,22,23.1
1,37,6,17,6,16,0,1,10,11,1,2,3,4,1,1,2,2,22,15.1
1,38,7,19,6,13,1,6,7,7,1,6,7,3,2,0,0,4,22,16.5
1,35,9,18,5,11,4,7,0,0,4,11,15,5,2,0,1,3,22,22.4
1,26,9,14,5,5,4,9,0,0,0,2,2,5,1,0,0,0,22,20.9
0,32,7,12,4,5,3,7,5,5,1,2,3,2,0,0,1,5,22,16.1
1,28,9,14,7,11,2,3,2,3,0,0,0,8,0,0,1,5,22,18
1,30,7,19,4,8,3,11,5,6,1,0,1,3,0,0,2,4,22,10.3
0,21,9,13,5,6,4,7,0,0,0,2,2,0,0,0,2,2,22,14.3
0,18,8,13,4,8,4,5,2,2,0,1,1,0,0,0,2,1,22,14
1,32,6,16,2,7,4,9,6,7,2,10,12,11,1,0,7,4,22,17.3
1,38,8,15,5,10,3,5,3,5,0,17,17,7,0,5,6,0,22,21.4
1,25,9,10,9,9,0,1,4,8,0,4,4,3,1,0,3,6,22,15.9
0,27,6,11,1,3,5,8,5,9,0,1,1,2,0,0,0,1,22,16.4
1,27,8,18,6,13,2,5,4,4,1,4,5,1,2,1,1,1,22,16.5
1,37,9,16,5,8,4,8,0,0,0,1,1,3,2,0,2,2,22,16
1,29,8,13,5,7,3,6,3,4,0,5,5,3,2,0,2,3,22,18.1
1,36,9,17,6,10,3,7,1,1,0,5,5,3,1,0,4,1,22,13.9
1,29,6,12,5,11,1,1,9,10,2,9,11,2,2,1,2,5,22,19.8
0,27,6,13,4,9,2,4,8,8,0,2,2,3,0,0,3,2,22,14.2
1,27,9,17,8,15,1,2,3,5,0,2,2,6,2,0,1,3,22,17.5
0,32,7,11,5,9,2,2,6,6,0,4,4,2,2,2,1,1,22,21.7
0,28,6,7,4,4,2,3,8,11,0,2,2,4,1,2,0,0,22,24.1
1,44,8,19,8,16,0,3,6,6,0,4,4,12,1,0,6,2,22,15.7
1,36,11,14,11,14,0,0,0,0,1,4,5,2,0,1,1,0,22,19.6
0,30,9,17,6,10,3,7,1,2,0,2,2,9,1,0,3,4,22,16.6
1,28,10,13,10,13,0,0,2,4,8,14,22,0,0,1,1,4,22,24
1,35,8,13,6,10,2,3,4,6,3,4,7,11,3,1,0,2,22,29.2
1,32,6,17,4,9,2,8,8,13,2,9,11,7,2,1,9,5,22,11.2
0,30,8,13,3,5,5,8,1,1,1,1,2,3,2,1,4,3,22,16.7
1,35,8,15,5,7,3,8,3,4,1,3,4,8,1,1,1,2,22,21.4
1,35,9,16,7,12,2,4,2,2,1,6,7,3,1,0,3,4,22,15.4
1,36,10,17,9,13,1,4,1,2,1,3,4,5,2,1,0,2,22,20.7
1,36,9,22,7,13,2,9,2,3,1,6,7,2,1,1,2,3,22,12.2
1,36,6,18,6,17,0,1,10,11,1,6,7,6,0,0,1,3,22,15.9
1,40,10,16,9,14,1,2,1,2,0,9,9,2,0,0,3,1,22,15.1
1,33,8,17,6,11,2,6,4,4,0,1,1,4,4,0,0,2,22,19.6
1,41,8,17,5,11,3,6,3,5,0,13,13,1,1,0,2,0,22,16.1
1,31,8,15,5,9,3,6,3,3,0,2,2,3,2,0,6,1,22,13
1,25,8,18,5,14,3,4,3,5,4,5,9,4,0,3,3,2,22,17.2
1,37,5,14,2,6,3,8,9,10,1,3,4,5,2,0,3,2,22,17.1
1,33,8,14,5,9,3,5,3,3,0,3,3,11,2,0,5,4,22,19.4
1,40,7,14,7,11,0,3,8,8,1,12,13,8,0,1,5,3,22,19.4
0,24,8,12,5,5,3,7,3,3,0,3,3,2,0,0,1,0,22,18.1
1,36,7,21,7,20,0,1,8,11,5,9,14,4,1,3,0,4,22,19.4
1,43,7,11,7,10,0,1,8,12,1,9,10,2,1,4,1,1,22,22.7
1,34,6,16,3,9,3,7,7,9,1,10,11,12,1,2,5,5,22,19.9
1,39,10,19,8,14,2,5,0,0,2,2,4,3,0,0,2,1,22,14.4
1,36,8,20,4,10,4,10,2,2,0,7,7,4,1,0,1,1,22,15.7
1,30,8,13,5,8,3,5,3,3,1,4,5,3,2,0,3,1,22,18.7
1,34,5,6,4,5,1,1,11,11,0,7,7,11,2,0,3,3,22,27.4
1,33,8,13,7,11,1,2,5,6,4,9,13,1,0,1,2,3,22,19.4
0,34,9,17,5,9,4,8,0,0,1,0,1,2,0,0,2,2,22,13
1,39,11,23,11,20,0,3,0,0,4,3,7,1,3,1,1,4,22,15.8
0,26,7,11,1,4,6,7,2,3,0,1,1,1,1,0,0,0,22,18.7
0,30,11,18,11,18,0,0,0,0,5,4,9,1,1,0,3,4,22,15.6
1,34,8,18,6,12,2,6,4,6,1,5,6,7,0,0,0,2,22,18.1
1,33,5,15,3,7,2,8,10,10,2,3,5,0,1,0,0,3,22,15.6
1,28,8,12,5,8,3,4,3,4,0,0,0,4,2,0,3,2,22,17.4
1,34,8,13,8,13,0,0,6,7,0,6,6,5,1,0,0,3,22,20.8
1,36,8,22,6,14,2,8,4,4,1,8,9,2,2,0,1,2,22,14.5
1,37,8,17,7,13,1,4,5,6,1,2,3,5,1,1,4,0,22,15.4
1,30,9,22,9,17,0,5,4,10,1,8,9,3,3,2,0,2,22,16.6
0,28,8,10,4,6,4,4,2,2,1,6,7,1,0,1,0,2,22,21.3
1,32,6,14,5,11,1,3,9,10,3,6,9,8,1,4,1,4,22,24.9
1,31,9,11,9,11,0,0,4,5,5,4,9,0,2,1,2,2,22,22.1
1,36,9,17,7,14,2,3,2,2,1,3,4,0,1,4,0,4,22,17.5
1,41,10,13,10,13,0,0,2,4,6,6,12,2,0,0,0,1,22,23.1
1,32,8,15,5,10,3,5,3,4,4,4,8,8,1,1,2,1,22,23.2
1,39,8,15,6,10,2,5,4,4,1,4,5,19,3,0,6,3,22,25.7
1,26,7,14,7,13,0,1,8,10,4,9,13,5,2,1,0,0,22,25.9
1,29,7,11,4,6,3,5,5,8,1,3,4,5,1,0,0,4,22,20.4
1,35,6,18,6,10,0,8,10,11,1,3,4,2,2,0,3,2,22,12.6
1,34,9,16,5,9,4,7,0,0,0,7,7,0,1,4,0,3,22,19.1
1,37,8,24,7,20,1,4,5,5,1,3,4,3,1,0,3,1,22,9.7
1,36,6,15,4,9,2,6,8,9,1,6,7,3,0,1,4,2,22,14
1,31,8,8,5,5,3,3,3,3,3,8,11,4,0,3,1,5,22,26
1,37,7,17,6,14,1,3,7,7,0,1,1,6,2,1,5,3,22,13.9
1,31,10,20,8,15,2,5,0,0,2,4,6,0,0,0,1,4,22,12
1,33,9,15,8,12,1,3,3,4,0,3,3,2,0,4,0,1,22,19.4
0,36,8,15,4,8,4,7,2,2,1,3,4,1,0,0,0,1,22,16.6
1,39,6,20,6,17,0,3,10,12,2,4,6,2,1,0,3,1,22,11.2
1,30,10,18,8,13,2,5,0,0,1,3,4,5,1,0,5,1,22,14.1
1,30,8,15,5,7,3,8,3,3,0,5,5,1,0,0,3,1,22,13.5
0,27,6,12,3,6,3,6,7,7,0,1,1,4,0,1,3,2,22,16
0,31,7,12,3,5,4,7,4,4,0,4,4,2,0,1,2,3,22,16.5
1,37,9,22,7,16,2,6,2,4,0,4,4,8,0,0,3,4,22,11.6
0,30,9,14,7,9,2,5,2,2,0,5,5,2,0,0,0,1,22,18.3
0,31,8,17,5,11,3,6,3,3,0,5,5,2,2,0,0,0,22,18.2
1,28,7,15,5,12,2,3,6,8,0,4,4,6,0,1,1,1,22,18.2
1,43,8,21,7,17,1,4,5,6,2,1,3,9,4,0,3,2,22,18.3
0,27,8,17,2,5,6,12,0,0,0,2,2,0,0,1,0,2,22,13.8
0,31,10,13,9,11,1,2,1,2,1,4,5,0,0,0,0,2,22,17.6
1,36,7,16,5,10,2,6,6,7,2,1,3,4,3,0,1,3,22,18.5
1,32,10,15,10,15,0,0,2,5,7,5,12,2,0,3,0,3,22,23
0,25,8,8,5,5,3,3,3,3,0,2,2,1,3,0,1,2,22,22.1
0,32,9,15,7,10,2,5,2,3,1,4,5,2,2,0,1,2,22,18.2
0,21,7,9,0,0,7,9,1,2,0,0,0,1,0,1,0,1,22,19.1
1,32,10,15,8,12,2,3,0,0,0,7,7,5,1,0,1,2,22,20.3
1,36,10,18,8,13,2,5,0,0,2,5,7,3,0,1,4,3,22,13.9
1,27,8,13,3,7,5,6,1,3,1,3,4,1,0,0,1,1,22,16.2
1,32,6,10,4,7,2,3,8,8,0,6,6,3,1,0,2,2,22,19.5
1,36,7,16,1,7,6,9,2,4,1,7,8,8,0,2,1,6,22,19.2
1,32,8,19,5,9,3,10,3,5,3,3,6,6,1,0,2,1,22,16.9
1,34,5,18,3,11,2,7,10,10,0,6,6,2,1,0,3,4,22,11
1,36,9,15,7,11,2,4,2,2,0,1,1,5,3,1,4,2,22,17.8
1,36,9,17,6,14,3,3,1,1,0,2,2,0,0,1,4,2,22,10.2
0,29,8,20,3,10,5,10,1,1,0,5,5,3,0,0,1,2,22,13
1,36,9,14,8,12,1,2,3,6,2,8,10,1,1,2,3,1,22,18.1
1,23,7,8,1,1,6,7,2,3,0,0,0,3,0,0,3,4,22,16.3
1,27,10,17,10,16,0,1,2,3,2,7,9,4,1,2,2,4,22,18.8
0,27,7,13,2,5,5,8,3,3,0,2,2,1,0,2,0,4,22,16.8
1,34,9,22,7,16,2,6,2,2,1,7,8,2,1,1,0,3,22,14.9
1,30,10,19,8,15,2,4,0,0,0,4,4,2,1,0,1,1,22,14.9
1,36,5,15,5,13,0,2,12,14,0,4,4,4,1,0,2,3,22,14.5
1,36,8,21,8,20,0,1,6,7,1,7,8,3,0,2,1,4,22,13.8
1,38,8,15,6,8,2,7,4,7,0,2,2,2,0,0,3,3,22,11.3
1,32,8,13,3,5,5,8,1,1,0,5,5,2,2,0,1,1,22,19.6
1,36,8,17,8,17,0,0,6,7,8,12,20,4,0,1,1,2,22,23.8
1,34,8,11,8,9,0,2,6,6,1,6,7,4,1,0,1,1,22,22.4
1,40,8,23,7,16,1,7,5,6,1,2,3,9,0,0,2,1,22,13.9
0,27,8,14,4,5,4,9,2,2,0,3,3,1,0,0,1,1,22,15.6
1,35,8,17,6,12,2,5,4,6,0,3,3,5,0,0,3,4,22,12.3
1,32,7,18,3,12,4,6,4,4,2,4,6,5,0,1,3,4,22,14.4
1,33,8,20,7,15,1,5,5,6,2,2,4,12,1,0,1,1,22,20.8
1,36,5,11,4,8,1,3,11,11,1,8,9,2,1,0,4,4,22,16.2
1,30,10,16,8,11,2,5,0,0,0,1,1,1,1,0,1,1,22,15.4
1,34,7,12,2,5,5,7,3,3,0,3,3,3,0,0,1,0,22,18.4
1,27,6,10,4,7,2,3,8,9,1,5,6,2,0,0,1,3,22,18.4
1,32,11,16,11,16,0,0,0,0,8,10,18,2,1,2,1,2,22,25.8
1,37,8,18,5,10,3,8,3,4,0,5,5,1,2,1,2,4,22,13.5
1,32,10,18,9,16,1,2,1,2,1,2,3,7,0,0,1,1,22,17.8
1,35,7,14,4,9,3,5,5,6,0,5,5,14,2,0,4,1,22,23.5
1,36,6,13,5,12,1,1,9,12,2,4,6,1,1,0,0,4,22,16.8
1,40,9,16,7,12,2,4,2,2,0,7,7,2,1,1,0,1,22,19.2
1,25,8,11,2,3,6,8,0,0,1,7,8,2,0,1,2,2,22,19.6
1,34,10,15,8,12,2,3,0,0,1,2,3,1,4,0,0,4,22,19.9
1,35,10,15,9,11,1,4,1,1,1,1,2,0,0,1,3,4,22,12.6
1,34,6,21,5,15,1,6,9,12,0,2,2,10,4,2,4,3,22,16.3
1,38,7,15,6,10,1,5,7,8,6,10,16,6,0,0,3,1,22,21.9
1,40,8,16,5,12,3,4,3,3,0,7,7,0,2,0,3,5,22,13.1
1,28,7,12,3,5,4,7,4,5,1,3,4,2,0,1,2,1,22,17.3
1,33,8,14,7,12,1,2,5,6,1,4,5,11,1,1,3,2,22,22.5
0,29,6,16,4,10,2,6,8,9,1,1,2,2,1,0,3,0,22,13.2
0,28,9,16,9,15,0,1,4,6,5,9,14,2,1,0,1,5,22,19.2
1,44,8,16,6,11,2,5,4,5,0,3,3,4,2,0,1,5,22,16.3
1,34,9,16,6,9,3,7,1,2,1,2,3,4,0,0,0,4,22,16.5
0,33,8,10,4,5,4,5,2,2,0,3,3,1,1,1,4,1,22,17.1
1,38,8,17,7,12,1,5,5,8,2,8,10,3,3,2,4,1,22,18
1,32,8,17,8,17,0,0,5,6,2,3,5,4,1,1,2,2,21,15.9
1,37,7,13,2,5,5,8,2,4,0,3,3,6,1,1,5,1,21,15.3
1,31,8,16,8,15,0,1,5,6,0,3,3,4,1,0,2,1,21,14.9
1,37,8,16,4,9,4,7,1,3,2,10,12,3,3,3,1,3,21,21.6
1,36,8,15,5,8,3,7,2,2,1,5,6,2,2,1,4,0,21,16
1,23,8,15,7,11,1,4,4,5,0,2,2,3,0,0,2,1,21,13.6
1,34,6,14,4,9,2,5,7,7,0,3,3,7,0,0,1,0,21,18.4
1,27,7,15,1,3,6,12,1,1,2,1,3,0,1,0,0,0,21,16
1,32,8,14,5,8,3,6,2,2,0,3,3,4,0,0,0,2,21,17.3
1,32,8,12,8,10,0,2,5,6,1,8,9,2,4,3,2,2,21,23.2
0,18,7,8,2,3,5,5,2,4,0,1,1,1,0,0,1,0,21,17.4
1,33,7,20,5,11,2,9,5,6,4,4,8,4,2,0,5,3,21,12
1,37,6,11,3,7,3,4,6,6,2,7,9,1,2,3,3,3,21,19.8
1,40,6,12,0,4,6,8,3,3,1,4,5,2,1,0,2,2,21,16.5
1,33,7,17,3,8,4,9,3,6,0,4,4,4,0,1,0,1,21,15
1,37,9,17,7,12,2,5,1,2,2,5,7,1,2,0,1,2,21,16.1
1,41,4,12,3,9,1,3,12,12,1,8,9,5,2,5,1,3,21,24.1
1,38,7,21,4,13,3,8,4,5,1,3,4,9,1,1,5,0,21,13.3
1,42,7,24,5,17,2,7,5,7,1,2,3,5,3,0,2,3,21,10.8
1,28,7,14,6,12,1,2,6,8,0,3,3,2,1,0,2,2,21,13.7
1,44,8,25,6,17,2,8,3,5,2,4,6,1,0,0,1,3,21,7
1,34,9,18,9,18,0,0,3,3,1,8,9,4,0,1,2,1,21,16.2
1,29,6,11,2,4,4,7,5,6,0,3,3,1,1,0,2,3,21,14.7
1,34,9,23,8,22,1,1,2,2,2,5,7,3,7,1,3,3,21,17
1,38,9,14,6,7,3,7,0,1,1,2,3,2,2,1,1,3,21,17.6
1,31,10,18,9,17,1,1,0,0,0,5,5,13,0,0,1,3,21,20.8
1,33,10,13,10,13,0,0,1,1,6,8,14,3,2,0,1,3,21,24.4
1,33,8,13,7,10,1,3,4,4,2,3,5,5,0,3,2,1,21,20.6
1,36,7,14,3,4,4,10,3,4,0,5,5,10,0,0,2,3,21,18.9
1,37,10,21,9,14,1,7,0,0,0,1,1,7,0,0,1,1,21,14.1
1,39,8,18,7,14,1,4,4,5,0,4,4,1,3,0,1,3,21,13.9
1,36,7,13,6,10,1,3,6,6,2,3,5,1,1,0,1,2,21,16.9
1,32,7,16,6,13,1,3,6,6,0,3,3,1,0,0,0,2,21,13.4
1,35,8,16,8,15,0,1,5,5,0,4,4,1,0,1,0,0,21,15.6
1,26,6,15,3,8,3,7,6,7,4,11,15,0,0,0,1,2,21,16.8
1,38,8,20,4,9,4,11,1,1,1,4,5,2,1,1,3,2,21,11.4
1,29,7,14,7,13,0,1,7,7,1,1,2,0,0,0,1,1,21,13.6
1,39,9,16,9,16,0,0,3,3,4,6,10,2,4,0,0,2,21,22.6
1,33,7,16,5,12,2,4,5,5,0,6,6,6,2,1,0,1,21,20.9
0,23,8,13,5,8,3,5,2,2,1,1,2,1,0,0,0,0,21,16.8
0,23,6,12,3,6,3,6,6,8,0,2,2,1,3,0,5,0,21,13.5
1,36,6,12,2,6,4,6,5,8,1,7,8,0,1,0,1,1,21,16.2
1,28,6,11,3,6,3,5,6,6,2,5,7,1,1,0,2,3,21,17.1
1,37,4,13,4,9,0,4,13,14,1,6,7,8,0,0,4,3,21,16
0,24,7,12,7,9,0,3,7,8,0,2,2,2,0,0,0,4,21,15.4
1,45,8,16,6,13,2,3,3,4,0,6,6,6,0,1,2,2,21,16.5
1,33,8,17,3,9,5,8,0,0,2,2,4,2,0,0,2,2,21,12.9
1,33,8,16,7,15,1,1,4,4,2,6,8,2,2,2,2,3,21,17.8
1,37,7,16,6,8,1,8,6,6,1,2,3,3,0,1,3,4,21,12.1
1,34,9,16,6,10,3,6,0,1,2,1,3,1,0,1,0,1,21,15.7
0,27,5,13,3,7,2,6,9,9,0,4,4,3,0,0,1,2,21,15.4
0,32,8,14,4,6,4,8,1,3,0,5,5,2,2,1,2,2,21,16.4
1,36,9,17,8,12,1,5,2,2,1,4,5,4,0,1,2,2,21,15.3
0,30,8,16,7,11,1,5,4,5,0,1,1,2,1,0,2,1,21,12.9
1,38,6,16,5,13,1,3,8,10,0,3,3,3,2,0,2,1,21,14
0,32,6,12,5,7,1,5,8,9,0,3,3,3,1,0,1,4,21,16
1,31,7,15,3,7,4,8,3,5,1,7,8,1,2,2,2,2,21,16.6
1,28,6,9,6,9,0,0,9,14,0,4,4,1,1,0,2,2,21,15.2
1,35,9,16,8,14,1,2,2,2,1,4,5,9,2,0,6,2,21,16.8
0,25,9,15,7,10,2,5,1,1,0,3,3,4,2,0,0,1,21,19.4
1,31,9,16,6,10,3,6,0,0,1,4,5,4,1,0,1,5,21,16.1
1,27,6,16,2,4,4,12,5,5,1,2,3,2,2,0,2,0,21,14.9
1,32,7,16,4,9,3,7,4,4,0,1,1,4,0,0,2,1,21,13.3
1,38,9,15,8,9,1,6,2,2,3,10,13,1,2,2,1,4,21,20.7
1,41,8,20,4,9,4,11,1,1,0,6,6,6,1,0,1,3,21,15
1,35,9,22,8,17,1,5,2,2,1,5,6,9,1,2,4,3,21,14.9
1,32,10,15,9,11,1,4,0,0,0,7,7,7,1,4,1,1,21,23.9
1,25,8,12,6,6,2,6,3,3,0,3,3,5,0,0,1,1,21,18.8
1,38,4,12,4,11,0,1,13,13,2,3,5,11,0,0,5,4,21,17.6
1,38,10,20,10,17,0,3,1,2,2,2,4,4,0,0,4,0,21,11.4
1,25,8,17,7,15,1,2,4,4,8,5,13,5,1,0,2,2,21,21.1
1,33,8,17,7,12,1,5,4,5,1,0,1,5,0,0,2,4,21,12.5
1,33,5,8,1,2,4,6,7,7,1,7,8,0,1,0,1,1,21,19.8
1,27,7,9,5,6,2,3,5,6,0,1,1,2,2,0,1,4,21,18.2
1,27,10,13,10,13,0,0,1,1,2,4,6,2,0,1,3,5,21,15.6
0,18,5,6,1,1,4,5,7,8,0,1,1,2,1,0,0,2,21,20.3
1,31,10,13,10,13,0,0,1,3,1,10,11,3,1,2,4,3,21,18.1
0,31,9,15,6,10,3,5,0,0,1,10,11,0,0,0,0,4,21,16.2
1,39,8,14,5,8,3,6,2,3,0,4,4,2,1,0,0,3,21,16.4
1,37,10,22,9,19,1,3,0,0,1,2,3,3,2,0,1,2,21,13.2
1,38,10,18,10,18,0,0,1,3,5,11,16,3,2,1,3,5,21,18.2
1,40,8,20,8,17,0,3,5,5,1,2,3,1,0,0,1,2,21,10.4
1,39,7,17,6,13,1,4,6,7,1,4,5,2,1,0,3,3,21,11.6
0,30,8,10,7,9,1,1,4,5,6,2,8,2,0,0,3,4,21,18.4
0,27,7,11,5,7,2,4,5,6,0,0,0,5,1,1,1,0,21,19.9
1,36,7,16,5,12,2,4,5,6,1,4,5,1,0,0,3,5,21,9.8
1,43,4,13,4,8,0,5,13,13,0,9,9,1,1,0,4,1,21,13.5
1,30,9,16,7,8,2,8,1,1,1,3,4,2,0,0,2,5,21,12.4
0,35,7,13,2,4,5,9,2,3,0,5,5,3,4,1,2,4,21,19
1,36,7,15,6,12,1,3,6,8,0,11,11,4,1,2,3,2,21,17.2
0,32,8,14,5,9,3,5,2,2,0,1,1,3,2,0,2,3,21,15.6
1,31,9,13,9,13,0,0,3,3,5,5,10,2,0,3,0,2,21,23.2
0,29,8,16,3,9,5,7,0,0,0,2,2,4,2,0,0,0,21,18.4
1,39,9,23,7,19,2,4,1,4,1,3,4,4,0,0,1,3,21,9.5
1,32,8,20,4,12,4,8,1,1,0,2,2,4,1,0,0,1,21,14.2
1,39,7,14,1,6,6,8,1,2,1,2,3,3,0,0,1,2,21,15.2
1,33,9,12,9,12,0,0,3,4,3,6,9,0,0,2,0,3,21,19.9
1,31,7,16,1,7,6,9,1,1,0,1,1,3,1,0,4,1,21,11.6
1,36,7,17,4,8,3,9,4,4,1,2,3,2,2,0,2,1,21,14.2
1,35,2,12,2,6,0,6,17,18,1,10,11,2,1,2,1,0,21,19.5
1,34,6,18,4,9,2,9,7,7,2,3,5,4,2,0,1,4,21,15.3
1,39,8,14,4,9,4,5,1,1,1,7,8,1,2,1,2,2,21,17.8
1,37,6,9,6,9,0,0,9,11,3,11,14,2,2,2,0,3,21,25.3
1,27,7,15,4,8,3,7,4,5,1,4,5,2,0,0,2,1,21,13.8
1,39,7,16,5,10,2,6,5,7,2,6,8,7,0,0,5,2,21,14.1
1,31,7,14,6,12,1,2,6,8,0,5,5,4,0,0,2,2,21,14.7
0,27,7,13,6,11,1,2,6,7,0,3,3,1,5,0,1,3,21,18.7
1,29,9,16,6,9,3,7,0,0,1,5,6,5,2,3,1,0,21,22.2
1,35,9,23,7,18,2,5,1,2,2,1,3,4,1,1,2,3,21,11.1
1,33,8,12,6,8,2,4,3,3,1,5,6,4,1,0,2,1,21,19.4
1,38,7,20,5,16,2,4,5,6,0,7,7,4,3,0,5,3,21,11.1
1,41,8,22,6,10,2,12,3,3,0,0,0,2,0,0,1,2,21,8.4
1,34,9,17,8,11,1,6,2,2,1,4,5,3,1,0,2,1,21,15.3
1,36,9,19,7,13,2,6,1,1,0,1,1,3,1,1,5,4,21,8.8
1,32,9,13,9,13,0,0,3,4,3,9,12,2,0,1,1,1,21,20.6
1,29,7,12,4,7,3,5,4,4,0,8,8,2,0,0,1,2,21,17.4
0,30,6,10,3,3,3,7,6,8,0,1,1,0,1,2,3,3,21,14.1
1,37,7,18,6,14,1,4,6,6,1,9,10,4,1,2,2,2,21,17
1,36,8,18,3,6,5,12,0,0,0,1,1,11,4,0,5,1,21,18.2
1,34,8,16,8,16,0,0,5,9,5,7,12,0,3,0,4,3,21,14.8
1,33,9,18,8,11,1,7,2,3,0,9,9,14,1,0,4,2,21,20.3
1,30,9,17,7,12,2,5,1,2,0,4,4,3,3,0,1,5,21,15.6
1,37,7,17,6,10,1,7,6,8,0,0,0,5,2,0,2,2,21,13.8
1,37,7,15,5,12,2,3,5,5,1,6,7,0,0,0,3,1,21,12.4
1,35,8,16,4,11,4,5,1,2,0,4,4,7,1,0,2,1,21,17.3
0,34,7,11,2,3,5,8,2,3,0,2,2,4,0,1,4,2,21,15
1,25,9,14,6,10,3,4,0,0,1,3,4,2,0,1,3,2,21,14.7
1,31,8,12,7,10,1,2,4,4,0,6,6,4,2,1,0,1,21,22.7
0,34,9,17,9,16,0,1,3,5,0,2,2,1,1,1,1,0,21,13.9
1,30,8,18,4,7,4,11,1,1,3,2,5,0,1,0,3,3,21,11.1
1,32,9,18,6,14,3,4,0,0,0,6,6,5,0,1,0,1,21,17.6
1,35,6,15,6,9,0,6,9,10,3,4,7,7,1,0,2,4,21,18.1
1,35,7,11,3,5,4,6,3,3,0,2,2,8,0,0,2,2,21,19.5
1,30,7,15,7,15,0,0,7,9,0,5,5,5,0,0,4,3,21,12.3
1,28,8,10,7,9,1,1,4,5,2,4,6,4,2,2,3,2,21,21.8
0,28,8,13,3,6,5,7,0,0,0,6,6,2,0,0,0,3,21,17.1
1,30,9,10,9,10,0,0,3,4,3,4,7,0,0,1,2,4,21,17.6
1,30,8,13,4,7,4,6,1,4,0,3,3,0,0,0,0,2,21,14
1,28,9,14,8,11,1,3,2,3,0,3,3,3,0,1,2,1,21,15.7
0,33,7,18,6,11,1,7,6,6,2,3,5,2,2,0,3,1,21,13.5
1,33,9,19,6,13,3,6,0,0,3,4,7,2,0,0,2,2,21,13.2
1,32,4,7,3,6,1,1,12,14,0,11,11,5,0,1,5,5,21,17.4
1,31,7,12,4,7,3,5,4,4,0,0,0,6,0,0,4,0,21,15.6
1,31,5,16,3,11,2,5,9,12,1,6,7,2,2,0,2,1,21,14.1
1,35,8,13,8,13,0,0,5,6,2,8,10,4,0,1,1,2,21,20.2
1,33,6,10,3,5,3,5,6,6,1,6,7,0,1,0,2,4,21,16.3
0,20,7,10,2,2,5,8,2,2,1,2,3,1,0,1,0,2,21,18.7
1,41,6,21,3,12,3,9,6,6,1,5,6,4,1,0,3,2,21,10.9
1,29,8,8,6,6,2,2,3,3,0,7,7,0,2,0,0,1,21,22.3
0,25,7,12,5,8,2,4,5,5,1,5,6,1,1,0,0,4,21,17.7
1,31,5,18,4,15,1,3,10,13,1,7,8,3,0,1,3,2,21,11
0,31,7,12,4,9,3,3,4,5,1,4,5,5,2,0,3,3,21,18.2
1,37,9,20,6,17,3,3,0,0,3,5,8,1,0,0,0,3,21,13.7
1,33,9,21,7,17,2,4,1,4,3,2,5,2,1,0,1,3,21,11.6
1,38,9,18,8,16,1,2,2,2,0,2,2,0,2,0,2,2,21,11.8
0,28,8,13,4,7,4,6,1,2,2,2,4,0,0,0,0,3,21,15.5
1,29,10,15,10,15,0,0,1,2,3,11,14,2,1,1,0,2,21,21.8
1,40,10,19,10,19,0,0,1,4,5,9,14,0,0,3,2,3,21,15.6
1,31,8,16,5,9,3,7,2,4,2,7,9,5,1,1,1,3,21,18.7
1,30,7,17,5,12,2,5,5,7,0,2,2,3,1,0,4,2,21,10
1,35,8,18,3,11,5,7,0,0,1,5,6,2,1,2,2,3,21,14.4
0,31,7,14,7,9,0,5,7,8,2,1,3,1,0,1,0,0,21,16.7
0,26,8,12,5,6,3,6,2,2,0,1,1,1,0,0,0,1,21,16.4
1,38,5,16,3,10,2,6,9,11,2,3,5,2,4,0,4,2,21,13.9
1,37,9,23,6,13,3,10,0,0,3,5,8,4,0,1,3,2,21,11.8
1,28,7,14,3,8,4,6,3,4,1,3,4,2,1,0,0,2,21,16.8
1,33,9,15,9,12,0,3,3,4,2,4,6,2,3,0,1,4,21,18.1
1,32,6,14,6,14,0,0,9,11,1,6,7,2,1,0,1,4,21,15.1
1,29,8,10,6,8,2,2,3,6,1,7,8,6,3,1,2,1,21,24.3
1,35,7,13,2,5,5,8,2,2,2,2,4,3,2,0,2,1,21,18.4
1,29,9,17,9,17,0,0,3,4,2,11,13,4,0,1,2,1,21,18.1
1,39,9,20,6,14,3,6,0,0,1,4,5,2,2,5,2,2,21,16.6
1,33,9,16,7,11,2,5,1,2,0,2,2,8,2,1,3,5,21,16.9
0,24,7,12,6,9,1,3,6,6,1,0,1,0,1,0,2,2,21,14.3
1,31,10,12,10,11,0,1,1,3,5,3,8,0,1,0,0,1,21,20.8
1,42,8,16,8,16,0,0,5,6,6,12,18,2,2,2,2,6,21,20.8
1,31,8,16,7,13,1,3,4,4,1,1,2,5,1,0,3,3,21,14.3
1,30,9,13,6,9,3,4,0,0,2,3,5,0,1,0,2,3,21,15.6
1,37,6,23,4,12,2,11,7,8,1,8,9,12,2,0,8,5,21,10.4
1,31,9,13,7,11,2,2,1,1,0,7,7,15,1,1,3,0,21,26.8
1,34,8,18,8,15,0,3,5,6,2,10,12,3,0,2,3,5,21,14.1
1,35,7,12,4,8,3,4,4,4,0,5,5,14,3,0,1,1,21,28.3
1,37,7,15,6,11,1,4,6,8,1,8,9,4,0,0,0,1,21,18
0,23,5,14,2,5,3,9,8,10,0,4,4,4,0,0,1,0,21,15.4
1,37,7,19,4,10,3,9,4,5,0,9,9,8,0,1,4,2,21,14.3
1,35,9,16,9,15,0,1,3,3,2,6,8,1,1,0,2,0,21,16.3
0,23,9,12,6,7,3,5,0,1,0,4,4,0,2,1,2,2,21,16.9
1,35,7,18,5,12,2,6,5,5,1,6,7,6,1,1,3,0,21,16.6
1,21,8,13,3,6,5,7,0,0,1,1,2,4,1,0,1,1,21,18.5
1,36,9,17,8,13,1,4,2,2,0,2,2,2,0,0,3,2,21,10.9
1,35,10,19,10,17,0,2,1,1,1,4,5,11,0,0,5,2,21,15.5
1,34,10,19,9,15,1,4,0,0,0,3,3,2,1,1,2,2,21,12.9
1,36,6,15,3,9,3,6,6,7,0,2,2,7,0,0,3,2,21,14.2
1,32,9,14,6,8,3,6,0,1,0,3,3,4,1,0,1,2,21,17.3
1,32,7,13,3,6,4,7,3,3,0,1,1,6,0,0,5,4,21,12.6
1,30,8,15,5,9,3,6,2,3,2,1,3,4,0,1,1,2,21,16.7
1,32,9,17,8,13,1,4,2,2,4,6,10,1,0,1,2,0,21,16.7
1,35,8,15,5,10,3,5,2,2,0,3,3,5,3,0,4,2,21,16.3
1,23,6,19,4,13,2,6,7,10,2,3,5,0,2,0,6,3,21,6
0,19,5,9,2,4,3,5,8,9,0,1,1,2,1,0,4,1,21,14.6
1,27,8,14,5,8,3,6,2,2,0,5,5,2,2,0,1,0,21,18.3
1,36,8,14,5,9,3,5,2,3,0,6,6,2,0,1,4,5,21,11.9
1,38,8,17,6,11,2,6,3,3,1,5,6,12,3,0,2,0,21,23.9
1,37,7,10,4,6,3,4,4,4,0,2,2,5,0,0,3,2,21,17.1
1,30,8,15,8,13,0,2,5,5,0,2,2,2,0,0,4,3,21,10.5
0,25,10,17,9,14,1,3,0,0,2,6,8,2,0,0,1,2,21,15.9
0,26,8,9,3,3,5,6,0,0,0,2,2,0,0,1,2,2,21,16.4
0,24,7,11,3,6,4,5,3,3,1,4,5,7,2,0,1,0,21,23.9
1,34,6,14,5,8,1,6,8,8,0,1,1,7,0,0,4,3,21,13.6
1,34,10,18,10,16,0,2,1,2,4,8,12,4,0,0,1,2,21,18.2
1,27,7,17,6,12,1,5,6,9,3,5,8,4,0,0,2,2,21,14.3
1,38,5,11,2,6,3,5,8,9,1,6,7,2,2,1,2,0,21,19.5
1,39,7,16,3,7,4,9,3,6,4,12,16,5,1,0,4,3,21,17.1
1,37,9,22,6,13,3,9,0,0,1,3,4,3,1,0,0,1,21,13.5
1,31,9,12,6,7,3,5,0,0,2,4,6,2,1,0,1,4,21,18.6
1,33,5,8,3,5,2,3,9,10,0,6,6,3,0,0,1,3,21,18.7
1,29,8,14,6,10,2,4,3,3,3,3,6,4,1,1,2,2,21,19.1
1,33,8,12,6,8,2,4,3,4,1,4,5,0,0,0,2,1,21,14.9
0,29,8,13,8,11,0,2,5,5,0,2,2,4,0,0,3,4,21,13.9
1,25,9,15,6,7,3,8,0,0,0,3,3,8,2,0,2,4,21,19
1,32,9,15,8,12,1,3,2,2,4,4,8,3,2,2,1,1,21,22.2
1,35,7,18,7,12,0,6,7,9,0,6,6,10,0,1,1,3,21,17.7
1,33,8,14,8,9,0,5,5,7,0,1,1,5,0,0,1,3,21,15.2
1,34,10,18,9,15,1,3,0,1,3,3,6,10,0,0,3,5,21,17
0,29,9,15,7,11,2,4,1,1,0,1,1,1,0,1,1,1,21,14.4
1,23,9,17,6,9,3,8,0,0,2,3,5,0,1,0,2,2,21,13.2
1,34,7,14,0,5,7,9,0,0,0,5,5,1,0,1,3,1,21,13.5
1,32,8,12,7,10,1,2,4,4,2,2,4,0,0,2,0,3,21,18
1,33,8,19,8,15,0,4,5,5,1,2,3,5,2,2,2,1,21,16.7
1,42,8,16,5,11,3,5,2,2,2,4,6,0,2,0,1,1,21,16.2
1,36,10,15,10,15,0,0,1,1,5,0,5,0,0,1,3,2,21,14.9
1,41,8,23,7,20,1,3,4,5,2,3,5,7,2,0,0,0,21,16.9
1,39,6,13,6,11,0,2,9,9,2,9,11,10,5,3,4,4,21,26.9
1,41,9,16,8,14,1,2,2,2,1,7,8,0,0,1,0,4,21,15.3
1,33,7,15,3,4,4,11,3,3,2,8,10,1,0,2,0,1,21,18.8
1,34,9,11,7,7,2,4,1,2,1,6,7,4,3,4,1,0,21,26.6
1,37,8,18,5,9,3,9,2,2,0,11,11,5,2,1,3,1,21,17.7
1,30,9,14,9,11,0,3,3,3,0,4,4,5,1,0,2,1,21,18.1
1,38,9,24,6,12,3,12,0,0,0,4,4,10,0,0,2,3,21,12.8
1,45,9,13,9,12,0,1,3,4,5,18,23,1,0,1,3,3,21,21.2
1,27,9,20,8,16,1,4,2,2,1,7,8,1,1,3,1,2,21,15.4
1,35,7,12,2,3,5,9,2,2,0,5,5,1,2,0,0,1,21,19.2
1,36,7,11,6,8,1,3,6,9,0,5,5,6,1,0,0,2,21,20.8
1,35,7,17,6,10,1,7,6,8,0,8,8,3,0,0,3,1,21,12.2
1,43,10,15,10,15,0,0,1,3,4,9,13,1,0,0,3,2,21,16.1
1,30,9,15,7,11,2,4,1,2,2,2,4,0,2,0,0,3,21,16.5
1,27,8,16,3,8,5,8,0,0,0,1,1,4,1,0,0,1,21,16.7
1,34,10,16,9,11,1,5,0,1,0,3,3,3,2,0,1,3,21,16.2
1,37,8,15,7,10,1,5,4,5,2,6,8,8,1,0,6,3,21,15.9
1,32,8,16,5,10,3,6,2,2,2,2,4,4,0,0,2,2,21,15
1,32,6,12,5,10,1,2,8,8,5,4,9,2,0,2,2,3,21,19.3
1,32,8,13,6,8,2,5,3,3,1,7,8,4,2,0,1,2,21,20.9
1,31,8,15,7,11,1,4,4,5,1,6,7,1,1,0,5,3,21,11.3
0,27,7,12,4,6,3,6,4,4,3,8,11,2,1,0,3,0,21,19.3
1,33,7,15,3,8,4,7,3,4,0,8,8,1,0,3,3,2,21,14.3
1,35,9,16,7,13,2,3,1,1,3,12,15,3,0,1,4,2,21,17.1
1,38,8,11,7,8,1,3,4,4,0,8,8,3,2,1,2,3,21,20.5
1,38,7,16,5,12,2,4,5,6,1,3,4,4,3,0,3,4,21,15
1,38,9,9,9,9,0,0,3,7,2,10,12,0,1,3,3,5,21,19.2
0,25,5,8,5,7,0,1,11,14,0,2,2,11,1,0,1,3,21,23.3
1,36,5,14,5,11,0,3,11,13,0,5,5,4,5,0,7,1,21,14.3
1,31,4,12,4,10,0,2,13,13,1,9,10,3,1,0,2,2,21,17.9
1,27,7,14,6,9,1,5,6,10,1,9,10,4,0,0,1,5,21,15.6
1,29,8,13,5,7,3,6,2,3,0,6,6,8,2,0,3,0,21,21.1
0,34,7,13,0,1,7,12,0,0,0,3,3,2,0,0,1,0,21,16
1,28,7,14,6,11,1,3,6,8,1,4,5,4,0,0,0,3,21,16.7
1,35,8,15,7,13,1,2,4,4,1,10,11,8,0,0,5,2,21,17.2
1,28,8,13,4,6,4,7,1,1,0,2,2,3,0,0,2,5,21,13.8
1,34,8,17,6,12,2,5,3,3,0,1,1,6,2,0,4,3,21,13.6
1,34,7,18,6,14,1,4,6,6,2,4,6,7,0,0,2,3,21,15.5
0,24,6,12,4,7,2,5,7,8,0,5,5,1,0,0,1,2,21,15
1,36,8,16,6,10,2,6,3,5,1,3,4,2,1,0,1,0,21,15.2
1,36,7,23,6,13,1,10,6,7,3,8,11,12,2,0,10,3,21,11
1,31,7,16,7,12,0,4,7,10,1,2,3,6,1,0,3,5,21,12.9
1,28,8,13,5,9,3,4,2,2,3,1,4,0,2,1,3,3,21,16
1,31,9,14,6,11,3,3,0,0,1,2,3,1,1,0,3,2,21,14
1,30,6,14,4,8,2,6,7,8,0,1,1,7,2,1,1,1,21,19.7
1,24,10,11,9,10,1,1,0,0,0,3,3,9,0,0,1,1,21,23.1
1,32,9,16,6,12,3,4,0,0,2,1,3,0,4,0,2,3,21,15.9
1,36,10,16,9,13,1,3,0,0,4,5,9,6,1,2,1,2,21,22.9
1,33,7,15,6,10,1,5,6,7,1,2,3,2,0,2,2,4,21,13.4
1,38,8,20,8,18,0,2,5,5,3,9,12,3,2,2,0,4,21,18.9
1,26,9,13,8,10,1,3,2,3,0,2,2,1,1,0,4,1,21,13
0,29,7,10,4,5,3,5,4,5,0,2,2,3,1,0,2,3,21,16.9
1,39,8,12,8,10,0,2,5,8,0,9,9,15,1,2,4,2,21,25.4
1,27,8,10,7,8,1,2,4,6,3,7,10,7,4,1,7,4,21,21.6
1,37,7,13,5,8,2,5,5,6,0,5,5,1,0,0,0,3,21,15.3
1,37,8,16,5,8,3,8,2,3,1,3,4,2,2,1,3,2,21,14.5
1,29,9,15,6,7,3,8,0,0,0,5,5,2,2,1,2,2,21,16.9
1,37,7,14,4,7,3,7,4,4,0,5,5,2,0,0,1,3,21,14.7
1,31,8,12,5,6,3,6,2,2,0,6,6,4,1,0,2,1,21,19
1,34,7,11,4,4,3,7,4,7,0,5,5,5,8,1,6,1,21,22.2
1,37,8,20,7,17,1,3,4,4,0,1,1,0,0,0,1,2,21,8.7
1,27,7,20,6,17,1,3,6,7,5,9,14,1,1,1,1,3,21,15.8
1,28,7,20,5,14,2,6,5,5,0,4,4,4,1,1,2,1,21,13.1
0,23,8,14,7,12,1,2,4,7,0,2,2,7,1,1,1,2,21,18.6
1,44,7,17,6,13,1,4,6,7,1,4,5,2,2,1,4,2,21,12.7
1,35,7,12,3,7,4,5,3,4,0,2,2,4,3,0,2,4,21,17.8
1,31,8,11,3,4,5,7,0,0,1,6,7,2,2,0,2,2,21,19.6
1,35,6,8,1,2,5,6,4,4,0,3,3,1,1,0,0,2,21,19.6
1,29,9,15,9,15,0,0,3,8,6,7,13,0,0,3,0,3,21,19.3
0,31,9,18,8,14,1,4,2,2,3,6,9,0,0,0,2,1,21,13.5
1,37,6,15,3,11,3,4,6,6,1,4,5,5,1,1,0,1,21,19.6
1,33,7,17,6,15,1,2,6,8,3,7,10,6,2,0,2,3,21,18.3
0,27,10,13,10,13,0,0,1,2,0,5,5,4,3,1,2,3,21,20.3
0,21,8,9,4,4,4,5,1,2,0,5,5,0,0,0,0,2,21,18.2
1,28,8,12,7,9,1,3,4,5,0,2,2,4,2,0,0,4,21,19.2
1,35,10,18,10,17,0,1,1,1,1,9,10,3,2,2,4,2,21,16.5
1,39,7,16,7,13,0,3,7,7,1,5,6,11,2,0,1,2,21,22.7
0,29,5,10,2,4,3,6,8,8,0,5,5,0,0,1,0,0,21,18.2
1,39,7,12,1,3,6,9,1,2,1,4,5,3,1,0,1,5,21,17
0,24,7,13,4,9,3,4,4,5,1,1,2,3,3,0,2,3,21,17.2
1,29,9,14,6,9,3,5,0,0,0,1,1,6,1,0,2,2,21,17.5
1,37,8,17,8,14,0,3,5,6,2,11,13,2,0,0,3,2,21,14.2
1,34,7,13,5,8,2,5,5,5,4,2,6,2,2,0,0,1,21,21.1
1,29,9,19,9,18,0,1,3,4,5,5,10,1,0,0,3,2,21,12.8
0,32,8,14,4,7,4,7,1,2,1,2,3,1,2,0,0,2,21,17.2
0,28,8,14,5,10,3,4,2,2,1,3,4,3,0,0,2,3,21,14.9
1,32,8,12,5,8,3,4,2,2,2,5,7,2,2,0,1,3,21,19.9
0,34,8,17,3,7,5,10,0,0,0,1,1,4,0,1,3,1,21,12.7
1,39,4,9,4,8,0,1,13,14,0,2,2,15,2,0,3,2,21,25.2
1,36,7,16,5,8,2,8,5,5,3,7,10,0,0,0,1,2,21,15
1,36,7,14,4,8,3,6,4,4,1,4,5,14,2,0,2,3,21,24.5
0,45,9,15,8,12,1,3,2,2,0,3,3,6,1,1,4,4,21,15.3
1,34,6,12,4,8,2,4,7,8,0,9,9,9,0,1,2,1,21,21.9
1,39,7,13,6,10,1,3,6,6,0,8,8,5,5,1,6,3,21,19.1
1,33,7,11,2,4,5,7,2,3,0,11,11,4,0,2,0,1,21,22.8
1,29,8,14,5,8,3,6,2,2,0,5,5,0,0,0,0,2,21,15.1
1,41,8,16,5,9,3,7,2,2,0,4,4,13,0,0,2,3,21,20.1
0,29,7,14,4,8,3,6,4,4,0,6,6,4,0,0,1,0,21,17.6
1,37,9,17,6,11,3,6,0,0,0,4,4,2,1,0,2,1,21,13.9
1,32,6,14,4,10,2,4,7,8,1,8,9,1,1,4,1,1,21,19.4
0,24,8,14,7,12,1,2,4,5,2,5,7,1,0,0,0,2,21,16.8
1,34,7,19,4,10,3,9,4,4,0,4,4,4,3,1,3,1,21,14.8
1,26,7,10,2,4,5,6,2,2,0,1,1,7,2,1,3,0,21,21.7
0,30,7,16,4,5,3,11,4,4,0,3,3,5,1,1,1,2,21,16.9
0,26,9,17,7,10,2,7,1,2,0,1,1,3,1,0,1,4,21,13.1
1,31,7,15,3,9,4,6,3,4,1,4,5,4,2,0,4,3,21,14.4
1,34,7,20,6,13,1,7,6,6,0,5,5,6,4,0,2,3,21,16.3
1,34,8,20,6,13,2,7,3,6,0,5,5,6,2,0,1,0,21,15.7
1,29,7,11,2,5,5,6,2,2,0,4,4,5,1,0,4,5,21,15.8
0,31,9,19,9,17,0,2,3,5,4,6,10,4,2,3,1,2,21,20.2
1,34,7,14,2,6,5,8,2,2,0,3,3,3,0,0,5,0,21,12
1,25,9,18,8,12,1,6,2,2,2,1,3,2,2,0,3,2,21,13.3
1,37,7,14,4,9,3,5,4,6,0,3,3,2,2,0,7,2,21,9.7
1,33,5,10,3,6,2,4,9,10,2,9,11,2,0,1,3,3,21,17.6
1,35,9,20,6,14,3,6,0,0,1,5,6,4,0,0,0,0,21,15.6
1,31,7,15,5,8,2,7,5,5,3,5,8,6,1,0,1,3,21,19.9
1,26,8,12,4,4,4,8,1,1,1,1,2,7,0,0,3,2,21,17.9
1,24,8,12,7,7,1,5,4,6,1,3,4,1,0,3,1,3,21,17.2
1,40,8,14,6,10,2,4,3,8,1,4,5,3,2,0,2,1,21,16
1,30,8,19,7,17,1,2,4,5,1,3,4,4,0,0,1,2,21,13.1
1,42,6,10,3,5,3,5,6,7,1,7,8,1,1,0,0,3,21,19.3
0,35,7,17,4,11,3,6,4,4,2,0,2,4,1,0,0,2,21,16.3
1,36,7,13,6,10,1,3,6,6,1,5,6,4,1,1,4,2,21,16.6
1,35,6,8,1,2,5,6,4,4,1,6,7,2,1,0,1,2,21,20.9
1,31,9,22,8,17,1,5,2,2,2,7,9,0,0,2,2,1,21,11.7
1,37,6,16,4,7,2,9,7,7,1,3,4,2,0,0,0,3,21,14
1,46,8,18,6,11,2,7,3,3,0,6,6,5,1,0,4,2,21,13.1
1,32,8,15,7,11,1,4,4,4,4,3,7,4,0,1,3,5,21,15.9
1,35,9,18,8,14,1,4,2,3,1,3,4,5,1,0,3,2,21,13.9
1,35,8,17,7,13,1,4,4,4,0,2,2,4,1,1,3,4,21,12.8
0,23,7,11,5,6,2,5,5,7,2,7,9,0,1,1,0,1,21,20.1
1,34,6,10,6,8,0,2,9,12,0,4,4,7,1,1,6,2,21,16.2
1,37,8,16,8,15,0,1,5,7,0,3,3,5,1,0,4,3,21,12.4
1,36,9,20,7,15,2,5,1,1,2,2,4,5,1,1,2,3,21,14.6
1,31,5,15,2,8,3,7,8,9,1,3,4,1,0,0,1,2,21,12.6
1,32,6,16,5,12,1,4,8,9,1,1,2,0,2,0,2,1,21,12.4
1,34,7,14,6,8,1,6,6,6,0,2,2,5,0,0,2,5,21,14.1
0,23,8,13,3,6,5,7,0,0,1,3,4,0,1,0,0,0,21,17.7
1,31,7,13,4,7,3,6,4,5,0,7,7,1,1,2,3,2,21,15.7
0,24,5,11,2,6,3,5,8,9,1,6,7,2,0,0,0,3,21,17.6
1,25,8,11,4,5,4,6,1,1,1,3,4,9,5,0,1,2,21,27.6
1,39,9,23,8,20,1,3,2,4,0,5,5,2,1,0,4,1,21,7.2
1,36,7,11,6,7,1,4,6,8,0,5,5,2,0,1,0,5,21,16.9
1,38,6,9,6,8,0,1,9,13,0,9,9,8,0,0,5,2,21,18
1,29,5,12,1,4,4,8,7,8,0,0,0,1,2,0,1,4,21,14.3
1,23,7,9,1,1,6,8,1,1,0,1,1,0,1,0,0,0,21,18.8
1,36,7,24,5,14,2,10,5,7,0,2,2,5,0,1,0,1,21,10.6