,Player,Age,Pos,Date,Tm,@,Opp,WL,GS,MP,FG,FGA,FG%,2P,2PA,2P%,3P,3PA,3P%,FT,FTA,FT%,ORB,DRB,TRB
1,Klay Thompson,26-301,G,12/5/16,GSW,,IND,W,1,29,21,33,0.636,13,19,0.684,8,14,0.571,10,11,0.909,0,2,2
2,Russell Westbrook,28-115,G,3/7/17,OKC,,POR,L,1,36,21,39,0.538,18,30,0.6,3,9,0.333,13,16,0.813,1,2,3
3,DeMarcus Cousins,26-129,C-F,12/20/16,SAC,,POR,W,1,41,17,28,0.607,12,20,0.6,5,8,0.625,16,17,0.941,1,12,13
4,James Harden,27-127,G,12/31/16,HOU,,NYK,W,1,42,14,26,0.538,5,10,0.5,9,16,0.563,16,18,0.889,3,13,16
5,Jimmy Butler,27-110,G-F,1/2/17,CHI,,CHO,W,1,38,15,24,0.625,14,20,0.7,1,4,0.25,21,22,0.955,3,9,12
6,Isaiah Thomas,27-327,G,12/30/16,BOS,,MIA,W,1,37,15,26,0.577,6,13,0.462,9,13,0.692,13,13,1,1,1,2
7,John Wall,26-091,G,12/6/16,WAS,,ORL,L,1,42,18,31,0.581,13,23,0.565,5,8,0.625,11,14,0.786,1,3,4
8,James Harden,27-154,G,1/27/17,HOU,@,PHI,W,1,39,16,28,0.571,10,17,0.588,6,11,0.545,13,14,0.929,1,12,13
9,Russell Westbrook,27-351,G,10/28/16,OKC,,PHO,W,1,45,17,44,0.386,15,34,0.441,2,10,0.2,15,20,0.75,3,10,13
10,Anthony Davis,23-229,F-C,10/26/16,NOP,,DEN,L,1,41,17,34,0.5,17,32,0.531,0,2,0,16,17,0.941,1,14,15
11,Kyrie Irving,24-306,G,1/23/17,CLE,@,NOP,L,1,42,15,28,0.536,7,14,0.5,8,14,0.571,11,11,1,0,2,2
12,Damian Lillard,26-247,G,3/19/17,POR,@,MIA,W,1,36,14,21,0.667,5,9,0.556,9,12,0.75,12,12,1,0,1,1
13,Russell Westbrook,28-054,G,1/5/17,OKC,@,HOU,L,1,38,16,34,0.471,8,19,0.421,8,15,0.533,9,11,0.818,1,7,8
14,Russell Westbrook,28-111,G,3/3/17,OKC,@,PHO,L,1,38,14,30,0.467,11,18,0.611,3,12,0.25,17,18,0.944,1,16,17
15,Karl-Anthony Towns,21-015,F-C,11/30/16,MIN,,NYK,L,1,42,15,22,0.682,15,19,0.789,0,3,0,17,20,0.85,3,15,18
16,Russell Westbrook,28-091,G,2/11/17,OKC,,GSW,L,1,37,14,26,0.538,11,16,0.688,3,10,0.3,16,18,0.889,1,10,11
17,Andrew Wiggins,21-264,F-G,11/13/16,MIN,,LAL,W,1,41,14,21,0.667,12,16,0.75,2,5,0.4,17,22,0.773,1,3,4
18,DeMarcus Cousins,26-170,C-F,1/30/17,SAC,@,PHI,L,1,32,11,16,0.688,7,10,0.7,4,6,0.667,20,22,0.909,4,11,15
19,Stephen Curry,28-238,G,11/7/16,GSW,,NOP,W,1,36,16,26,0.615,3,9,0.333,13,17,0.765,1,2,0.5,3,2,5
20,Anthony Davis,24-000,F-C,3/11/17,NOP,@,CHO,W,1,45,18,31,0.581,14,26,0.538,4,5,0.8,6,8,0.75,4,17,21
21,Kyrie Irving,24-361,G,3/19/17,CLE,@,LAL,W,1,38,15,21,0.714,9,11,0.818,6,10,0.6,10,10,1,0,2,2
22,Russell Westbrook,28-037,G,12/19/16,OKC,,ATL,L,1,35,16,33,0.485,13,23,0.565,3,10,0.3,11,13,0.846,2,9,11
23,Carmelo Anthony,32-245,F,1/29/17,NYK,@,ATL,L,1,46,18,36,0.5,15,27,0.556,3,9,0.333,6,7,0.857,0,6,6
24,Anthony Davis,23-231,F-C,10/28/16,NOP,,GSW,L,1,40,17,31,0.548,16,29,0.552,1,2,0.5,10,14,0.714,6,11,17
25,Anthony Davis,23-257,F-C,11/23/16,NOP,,MIN,W,1,39,17,27,0.63,15,23,0.652,2,4,0.5,9,10,0.9,1,9,10
26,Russell Westbrook,28-075,G,1/26/17,OKC,,DAL,W,1,35,16,29,0.552,12,21,0.571,4,8,0.5,9,11,0.818,1,7,8
27,Russell Westbrook,28-041,G,12/23/16,OKC,@,BOS,W,1,35,13,25,0.52,8,18,0.444,5,7,0.714,14,16,0.875,1,10,11
28,Russell Westbrook,28-110,G,3/2/17,OKC,@,POR,L,1,37,12,36,0.333,6,20,0.3,6,16,0.375,15,15,1,2,5,7
29,LeBron James,31-346,F-G,12/10/16,CLE,,CHO,W,1,42,17,24,0.708,12,14,0.857,5,10,0.5,5,9,0.556,1,8,9
30,Isaiah Thomas,27-317,G,12/20/16,BOS,@,MEM,W,1,38,10,16,0.625,3,6,0.5,7,10,0.7,17,17,1,0,3,3
31,Isaiah Thomas,27-360,G,2/1/17,BOS,,TOR,W,1,38,12,22,0.545,7,10,0.7,5,12,0.417,15,16,0.938,0,4,4
32,Stephen Curry,28-320,G,1/28/17,GSW,,LAC,W,1,29,15,23,0.652,6,8,0.75,9,15,0.6,4,4,1,0,9,9
33,DeMar DeRozan,27-201,G,2/24/17,TOR,,BOS,W,1,37,15,28,0.536,14,25,0.56,1,3,0.333,12,12,1,0,5,5
34,Blake Griffin,27-347,F,2/26/17,LAC,,CHO,W,1,42,15,26,0.577,12,22,0.545,3,4,0.75,10,16,0.625,4,6,10
35,Kyrie Irving,24-345,G,3/3/17,CLE,@,ATL,W,1,36,14,21,0.667,9,13,0.692,5,8,0.625,10,10,1,0,2,2
36,C.J. McCollum,25-104,G,1/1/17,POR,@,MIN,W,1,39,16,25,0.64,13,19,0.684,3,6,0.5,8,9,0.889,1,4,5
37,Russell Westbrook,28-108,G,2/28/17,OKC,,UTA,W,1,39,13,28,0.464,7,19,0.368,6,9,0.667,11,12,0.917,0,11,11
38,Bradley Beal,23-146,G,11/21/16,WAS,,PHO,W,1,40,14,22,0.636,9,12,0.75,5,10,0.5,9,11,0.818,1,3,4
39,Jimmy Butler,27-115,G-F,1/7/17,CHI,,TOR,W,1,44,10,25,0.4,6,17,0.353,4,8,0.5,18,20,0.9,4,6,10
40,DeMarcus Cousins,26-161,C-F,1/21/17,SAC,@,CHI,L,1,35,16,28,0.571,14,21,0.667,2,7,0.286,8,9,0.889,2,12,14
41,Anthony Davis,23-336,F-C,2/10/17,NOP,@,MIN,W,1,36,16,22,0.727,14,19,0.737,2,3,0.667,8,11,0.727,2,11,13
42,DeMar DeRozan,27-226,G,3/21/17,TOR,,CHI,W,1,43,17,38,0.447,16,33,0.485,1,5,0.2,7,11,0.636,4,3,7
43,Marc Gasol,31-362,C,1/25/17,MEM,,TOR,W,1,38,14,25,0.56,9,15,0.6,5,10,0.5,9,10,0.9,0,7,7
44,James Harden,27-161,G,2/3/17,HOU,,CHI,W,1,44,13,33,0.394,8,20,0.4,5,13,0.385,11,14,0.786,1,11,12
45,Damian Lillard,26-112,G,11/4/16,POR,@,DAL,W,1,37,12,18,0.667,7,12,0.583,5,6,0.833,13,14,0.929,0,4,4
46,Russell Westbrook,28-039,G,12/21/16,OKC,@,NOP,W,1,34,12,26,0.462,10,19,0.526,2,7,0.286,16,18,0.889,1,9,10
47,Russell Westbrook,28-085,G,2/5/17,OKC,,POR,W,1,35,16,34,0.471,15,28,0.536,1,6,0.167,9,11,0.818,1,3,4
48,Giannis Antetokounmpo,22-066,F-G,2/10/17,MIL,,LAL,L,1,42,11,20,0.55,10,14,0.714,1,6,0.167,18,21,0.857,1,7,8
49,Bradley Beal,23-223,G,2/6/17,WAS,,CLE,L,1,45,16,28,0.571,10,14,0.714,6,14,0.429,3,3,1,0,5,5
50,Bradley Beal,23-173,G,12/18/16,WAS,,LAC,W,1,38,13,23,0.565,7,13,0.538,6,10,0.6,9,11,0.818,0,3,3
51,Eric Bledsoe,27-054,G,2/1/17,PHO,,LAC,L,1,40,13,22,0.591,11,18,0.611,2,4,0.5,13,15,0.867,0,4,4
52,Eric Bledsoe,27-050,G,1/28/17,PHO,,DEN,L,1,45,12,27,0.444,9,19,0.474,3,8,0.375,14,15,0.933,2,4,6
53,DeMarcus Cousins,26-220,C-F,3/21/17,NOP,,MEM,W,1,37,14,27,0.519,9,18,0.5,5,9,0.556,8,9,0.889,4,13,17
54,Anthony Davis,23-263,F-C,11/29/16,NOP,,LAL,W,1,41,14,27,0.519,13,23,0.565,1,4,0.25,12,14,0.857,6,10,16
55,DeMar DeRozan,27-156,G,1/10/17,TOR,,BOS,W,1,38,16,29,0.552,15,27,0.556,1,2,0.5,8,9,0.889,2,11,13
56,James Harden,27-160,G,2/2/17,HOU,,ATL,L,1,39,10,23,0.435,5,11,0.455,5,12,0.417,16,21,0.762,2,6,8
57,James Harden,27-203,G,3/17/17,HOU,@,NOP,L,1,40,12,21,0.571,8,11,0.727,4,10,0.4,13,14,0.929,2,12,14
58,James Harden,27-067,G,11/1/16,HOU,@,CLE,L,1,38,13,20,0.65,8,11,0.727,5,9,0.556,10,14,0.714,1,6,7
59,Kawhi Leonard,25-206,F,1/21/17,SAS,@,CLE,W,1,46,15,30,0.5,12,22,0.545,3,8,0.375,8,8,1,0,6,6
60,Kyle Lowry,30-282,G,1/1/17,TOR,@,LAL,W,1,39,12,16,0.75,6,9,0.667,6,7,0.857,11,11,1,1,8,9
61,Isaiah Thomas,27-349,G,1/21/17,BOS,,POR,L,1,44,14,28,0.5,10,17,0.588,4,11,0.364,9,11,0.818,1,2,3
62,Isaiah Thomas,27-358,G,1/30/17,BOS,,DET,W,1,37,11,23,0.478,7,12,0.583,4,11,0.364,15,15,1,0,0,0
63,Karl-Anthony Towns,21-032,F-C,12/17/16,MIN,,HOU,L,1,43,15,28,0.536,14,24,0.583,1,4,0.25,10,12,0.833,2,14,16
64,Russell Westbrook,28-106,G,2/26/17,OKC,,NOP,W,1,37,14,29,0.483,12,21,0.571,2,8,0.25,11,12,0.917,2,9,11
65,Russell Westbrook,28-001,G,11/13/16,OKC,,ORL,L,1,38,14,21,0.667,14,18,0.778,0,3,0,13,18,0.722,2,10,12
66,Andrew Wiggins,21-357,F-G,2/14/17,MIN,,CLE,L,1,41,16,29,0.552,12,21,0.571,4,8,0.5,5,6,0.833,1,2,3
67,Andrew Wiggins,21-318,F-G,1/6/17,MIN,@,WAS,L,1,39,16,30,0.533,15,27,0.556,1,3,0.333,8,10,0.8,1,0,1
68,Bradley Beal,23-241,G,2/24/17,WAS,@,PHI,L,1,42,15,25,0.6,13,17,0.765,2,8,0.25,8,10,0.8,0,4,4
69,Eric Bledsoe,27-044,G,1/22/17,PHO,@,TOR,W,1,42,11,17,0.647,7,10,0.7,4,7,0.571,14,14,1,0,6,6
70,Jimmy Butler,27-105,G-F,12/28/16,CHI,,BRK,W,1,38,14,29,0.483,13,27,0.481,1,2,0.5,11,11,1,6,4,10
71,Jimmy Butler,27-067,G-F,11/20/16,CHI,@,LAL,W,1,40,14,23,0.609,14,22,0.636,0,1,0,12,14,0.857,4,3,7
72,Jimmy Butler,27-133,G-F,1/25/17,CHI,,ATL,L,1,40,13,22,0.591,9,14,0.643,4,8,0.5,10,10,1,2,2,4
73,DeMarcus Cousins,26-185,C-F,2/14/17,SAC,@,LAL,W,1,36,13,24,0.542,11,17,0.647,2,7,0.286,12,19,0.632,2,10,12
74,Stephen Curry,28-298,G,1/6/17,GSW,,MEM,L,1,42,15,27,0.556,10,14,0.714,5,13,0.385,5,5,1,0,3,3
75,Anthony Davis,23-304,F-C,1/9/17,NOP,@,NYK,W,1,29,14,22,0.636,13,21,0.619,1,1,1,11,12,0.917,4,14,18
76,DeMar DeRozan,27-087,G,11/2/16,TOR,@,WAS,W,1,37,14,23,0.609,13,21,0.619,1,2,0.5,11,16,0.688,1,4,5
77,DeMar DeRozan,27-080,G,10/26/16,TOR,,DET,W,1,34,17,27,0.63,17,25,0.68,0,2,0,6,6,1,1,3,4
78,Kevin Durant,28-111,F-G,1/18/17,GSW,,OKC,W,1,34,13,16,0.813,8,9,0.889,5,7,0.714,9,10,0.9,2,10,12
79,James Harden,27-169,G,2/11/17,HOU,,PHO,W,1,29,9,17,0.529,1,2,0.5,8,15,0.533,14,16,0.875,1,5,6
80,James Harden,27-137,G,1/10/17,HOU,,CHO,W,1,38,11,24,0.458,4,10,0.4,7,14,0.5,11,14,0.786,1,14,15
81,James Harden,27-135,G,1/8/17,HOU,@,TOR,W,1,38,13,26,0.5,9,17,0.529,4,9,0.444,10,10,1,3,7,10
82,James Harden,27-204,G,3/18/17,HOU,@,DEN,W,1,37,11,23,0.478,8,15,0.533,3,8,0.375,15,17,0.882,0,10,10
83,James Harden,27-144,G,1/17/17,HOU,@,MIA,L,1,39,12,30,0.4,8,15,0.533,4,15,0.267,12,13,0.923,1,11,12
84,Nikola Jokic,21-357,C-F,2/10/17,DEN,@,NYK,W,1,37,17,23,0.739,15,20,0.75,2,3,0.667,4,5,0.8,4,5,9
85,Zach LaVine,21-288,G,12/23/16,MIN,,SAC,L,1,39,13,21,0.619,6,9,0.667,7,12,0.583,7,7,1,0,6,6
86,Damian Lillard,26-131,G,11/23/16,POR,@,CLE,L,1,38,13,21,0.619,8,14,0.571,5,7,0.714,9,9,1,0,7,7
87,Damian Lillard,26-153,G,12/15/16,POR,@,DEN,L,1,38,13,22,0.591,9,14,0.643,4,8,0.5,10,11,0.909,0,3,3
88,Kevin Love,28-077,F,11/23/16,CLE,,POR,W,1,32,12,20,0.6,4,8,0.5,8,12,0.667,8,8,1,4,4,8
89,D'Angelo Russell,21-024,G,3/19/17,LAL,,CLE,L,1,41,14,22,0.636,7,10,0.7,7,12,0.583,5,7,0.714,0,2,2
90,Kemba Walker,26-187,G,11/11/16,CHO,,TOR,L,1,35,12,19,0.632,5,7,0.714,7,12,0.583,9,11,0.818,1,9,10
91,Andrew Wiggins,21-358,F-G,2/15/17,MIN,@,DEN,W,1,38,15,26,0.577,13,22,0.591,2,4,0.5,8,11,0.727,1,3,4
92,Lou Williams,30-037,G,12/3/16,LAL,@,MEM,L,0,32,11,20,0.55,7,12,0.583,4,8,0.5,14,14,1,0,2,2
93,Giannis Antetokounmpo,22-017,F-G,12/23/16,MIL,,WAS,W,1,33,12,19,0.632,12,18,0.667,0,1,0,15,17,0.882,1,7,8
94,Devin Booker,20-076,G,1/14/17,PHO,,SAS,W,1,37,12,22,0.545,9,17,0.529,3,5,0.6,12,12,1,2,0,2
95,Devin Booker,20-007,G,11/6/16,PHO,@,LAL,L,1,45,13,29,0.448,10,22,0.455,3,7,0.429,10,10,1,1,2,3
96,Devin Booker,20-074,G,1/12/17,PHO,,DAL,L,1,37,14,20,0.7,8,13,0.615,6,7,0.857,5,7,0.714,0,1,1
97,Jimmy Butler,27-056,G-F,11/9/16,CHI,@,ATL,L,1,39,13,24,0.542,9,15,0.6,4,9,0.444,9,12,0.75,1,3,4
98,Stephen Curry,28-324,G,2/1/17,GSW,,CHO,W,1,30,14,20,0.7,3,5,0.6,11,15,0.733,0,0,,1,4,5
99,Anthony Davis,23-351,F-C,2/25/17,NOP,@,DAL,L,1,39,17,34,0.5,16,30,0.533,1,4,0.25,4,9,0.444,3,11,14
100,Kevin Durant,28-035,F-G,11/3/16,GSW,,OKC,W,1,31,15,24,0.625,8,13,0.615,7,11,0.636,2,3,0.667,1,6,7
101,Kevin Durant,28-035,F-G,11/3/16,GSW,,OKC,W,1,31,15,24,0.625,8,13,0.615,7,11,0.636,2,3,0.667,1,6,7
102,Paul George,26-317,F,3/15/17,IND,,CHO,W,1,33,15,21,0.714,9,11,0.818,6,10,0.6,3,3,1,1,4,5
103,James Harden,27-192,G,3/6/17,HOU,@,SAS,L,1,36,13,20,0.65,7,11,0.636,6,9,0.667,7,8,0.875,1,2,3
104,James Harden,27-206,G,3/20/17,HOU,,DEN,W,1,40,13,29,0.448,9,18,0.5,4,11,0.364,9,11,0.818,1,6,7
105,Kyrie Irving,24-249,G,11/27/16,CLE,@,PHI,W,1,41,14,27,0.519,9,16,0.563,5,11,0.455,6,6,1,1,3,4
106,Kawhi Leonard,25-250,F,3/6/17,SAS,,HOU,W,1,39,12,18,0.667,8,13,0.615,4,5,0.8,11,11,1,0,6,6
107,Damian Lillard,26-240,G,3/12/17,POR,@,PHO,W,1,38,13,26,0.5,9,16,0.563,4,10,0.4,9,9,1,1,5,6
108,Damian Lillard,26-102,G,10/25/16,POR,,UTA,W,1,35,13,20,0.65,9,14,0.643,4,6,0.667,9,9,1,1,8,9
109,Kevin Love,28-152,F,2/6/17,CLE,@,WAS,W,1,42,11,17,0.647,5,7,0.714,6,10,0.6,11,11,1,4,8,12
110,Isaiah Thomas,27-346,G,1/18/17,BOS,,NYK,L,1,37,12,25,0.48,7,13,0.538,5,12,0.417,10,10,1,2,1,3
111,Karl-Anthony Towns,21-118,F-C,3/13/17,MIN,,WAS,W,1,35,17,26,0.654,15,22,0.682,2,4,0.5,3,3,1,3,10,13
112,John Wall,26-186,G,3/11/17,WAS,@,POR,W,1,40,13,23,0.565,10,18,0.556,3,5,0.6,10,12,0.833,0,2,2
113,Bradley Beal,23-255,G,3/10/17,WAS,@,SAC,W,1,43,13,24,0.542,8,15,0.533,5,9,0.556,7,7,1,2,8,10
114,Devin Booker,20-005,G,11/4/16,PHO,@,NOP,W,1,41,13,22,0.591,10,15,0.667,3,7,0.429,9,9,1,0,4,4
115,Kentavious Caldwell-Pope,23-349,G,2/1/17,DET,,NOP,W,1,39,12,18,0.667,4,7,0.571,8,11,0.727,6,8,0.75,0,4,4
116,Mike Conley,29-111,G,1/30/17,MEM,@,PHO,W,1,33,12,18,0.667,5,8,0.625,7,10,0.7,7,8,0.875,0,6,6
117,DeMarcus Cousins,26-097,C-F,11/18/16,SAC,,LAC,L,1,37,12,29,0.414,10,22,0.455,2,7,0.286,12,14,0.857,4,9,13
118,Anthony Davis,23-352,F-C,2/26/17,NOP,@,OKC,L,1,32,15,28,0.536,13,25,0.52,2,3,0.667,6,6,1,3,4,7
119,Anthony Davis,23-253,F-C,11/19/16,NOP,,CHO,W,1,42,15,27,0.556,13,22,0.591,2,5,0.4,6,8,0.75,2,14,16
120,Anthony Davis,23-252,F-C,11/18/16,NOP,,POR,W,1,37,14,22,0.636,12,17,0.706,2,5,0.4,8,10,0.8,0,9,9
121,Marc Gasol,31-327,C,12/21/16,MEM,@,DET,W,1,37,14,17,0.824,12,14,0.857,2,3,0.667,8,11,0.727,0,5,5
122,James Harden,27-145,G,1/18/17,HOU,,MIL,W,1,37,14,25,0.56,10,14,0.714,4,11,0.364,6,6,1,0,6,6
123,James Harden,27-198,G,3/12/17,HOU,,CLE,W,1,40,13,28,0.464,9,14,0.643,4,14,0.286,8,12,0.667,3,7,10
124,James Harden,27-173,G,2/15/17,HOU,,MIA,L,1,42,10,21,0.476,6,11,0.545,4,10,0.4,14,16,0.875,3,9,12
125,James Harden,27-093,G,11/27/16,HOU,@,POR,W,1,34,11,22,0.5,6,10,0.6,5,12,0.417,11,13,0.846,1,1,2
126,Gordon Hayward,26-362,F-G,3/20/17,UTA,@,IND,L,1,37,16,24,0.667,13,18,0.722,3,6,0.5,3,4,0.75,0,3,3
127,LeBron James,32-063,F-G,3/3/17,CLE,@,ATL,W,1,39,14,27,0.519,8,17,0.471,6,10,0.6,4,8,0.5,1,12,13
128,Sean Kilpatrick,26-328,G,11/29/16,BRK,,LAC,W,1,47,14,34,0.412,10,22,0.455,4,12,0.333,6,8,0.75,0,14,14
129,Kawhi Leonard,25-199,F,1/14/17,SAS,@,PHO,L,1,32,12,20,0.6,10,15,0.667,2,5,0.4,12,14,0.857,1,3,4
130,Damian Lillard,26-116,G,11/8/16,POR,,PHO,W,1,37,12,23,0.522,9,15,0.6,3,8,0.375,11,12,0.917,2,3,5
131,Isaiah Thomas,27-339,G,1/11/17,BOS,,WAS,W,1,38,14,29,0.483,9,18,0.5,5,11,0.455,5,6,0.833,3,2,5
132,Isaiah Thomas,27-353,G,1/25/17,BOS,,HOU,W,1,38,15,27,0.556,11,17,0.647,4,10,0.4,4,4,1,3,2,5
133,Isaiah Thomas,27-335,G,1/7/17,BOS,,NOP,W,1,38,13,24,0.542,7,13,0.538,6,11,0.545,6,6,1,1,2,3
134,Isaiah Thomas,27-362,G,2/3/17,BOS,,LAL,W,1,38,13,24,0.542,8,13,0.615,5,11,0.455,7,7,1,0,2,2
135,Russell Westbrook,28-072,G,1/23/17,OKC,@,UTA,W,1,36,11,29,0.379,8,22,0.364,3,7,0.429,13,17,0.765,1,10,11
136,Russell Westbrook,28-083,G,2/3/17,OKC,,MEM,W,1,38,8,20,0.4,3,13,0.231,5,7,0.714,17,17,1,2,11,13
137,Russell Westbrook,28-095,G,2/15/17,OKC,,NYK,W,1,38,13,22,0.591,10,17,0.588,3,5,0.6,9,13,0.692,3,11,14
138,Lou Williams,30-039,G,12/5/16,LAL,,UTA,L,0,34,13,27,0.481,9,18,0.5,4,9,0.444,8,9,0.889,0,6,6
139,Carmelo Anthony,32-272,F,2/25/17,NYK,,PHI,W,1,37,15,25,0.6,13,18,0.722,2,7,0.286,5,7,0.714,1,5,6
140,Eric Bledsoe,27-066,G,2/13/17,PHO,,NOP,L,1,39,11,22,0.5,8,15,0.533,3,7,0.429,12,14,0.857,1,1,2
141,Jimmy Butler,27-059,G-F,11/12/16,CHI,,WAS,W,1,38,11,23,0.478,10,20,0.5,1,3,0.333,14,14,1,2,6,8
142,Jimmy Butler,27-188,G-F,3/21/17,CHI,@,TOR,L,1,44,11,21,0.524,8,14,0.571,3,7,0.429,12,14,0.857,2,8,10
143,DeMarcus Cousins,26-075,C-F,10/27/16,SAC,,SAS,L,1,37,10,22,0.455,7,17,0.412,3,5,0.6,14,16,0.875,3,13,16
144,DeMarcus Cousins,26-106,C-F,11/27/16,SAC,@,BRK,W,1,36,13,24,0.542,9,19,0.474,4,5,0.8,7,9,0.778,2,9,11
145,Anthony Davis,23-268,F-C,12/4/16,NOP,@,OKC,L,1,43,14,32,0.438,14,31,0.452,0,1,0,9,11,0.818,5,10,15
146,DeMar DeRozan,27-094,G,11/9/16,TOR,@,OKC,W,1,39,13,22,0.591,13,20,0.65,0,2,0,11,15,0.733,0,4,4
147,DeMar DeRozan,27-204,G,2/27/17,TOR,@,NYK,W,1,37,13,25,0.52,12,22,0.545,1,3,0.333,10,13,0.769,3,5,8
148,Kevin Durant,28-031,F-G,10/30/16,GSW,@,PHO,W,1,38,10,16,0.625,8,12,0.667,2,4,0.5,15,16,0.938,0,4,4
149,Paul George,26-222,F,12/10/16,IND,,POR,W,1,36,13,27,0.481,8,17,0.471,5,10,0.5,6,7,0.857,1,4,5
150,James Harden,27-101,G,12/5/16,HOU,,BOS,W,1,35,8,14,0.571,5,9,0.556,3,5,0.6,18,18,1,1,7,8
151,Zach LaVine,21-244,G,11/9/16,MIN,@,ORL,W,1,36,14,22,0.636,7,13,0.538,7,9,0.778,2,3,0.667,0,4,4
152,Damian Lillard,26-106,G,10/29/16,POR,@,DEN,W,1,41,15,28,0.536,13,20,0.65,2,8,0.25,5,5,1,1,4,5
153,C.J. McCollum,25-048,G,11/6/16,POR,@,MEM,W,1,39,13,23,0.565,7,11,0.636,6,12,0.5,5,6,0.833,0,4,4
154,Paul Millsap,31-354,F,1/29/17,ATL,,NYK,W,1,60,13,29,0.448,10,21,0.476,3,8,0.375,8,10,0.8,8,11,19
155,Marcus Morris,27-179,F,2/28/17,DET,,POR,W,1,42,13,23,0.565,10,16,0.625,3,7,0.429,8,9,0.889,3,5,8
156,Isaiah Thomas,27-300,G,12/3/16,BOS,@,PHI,W,1,33,11,19,0.579,9,16,0.563,2,3,0.667,13,15,0.867,1,3,4
157,Isaiah Thomas,27-356,G,1/28/17,BOS,@,MIL,W,1,41,11,21,0.524,5,10,0.5,6,11,0.545,9,9,1,0,3,3
158,Isaiah Thomas,27-281,G,11/14/16,BOS,@,NOP,L,1,36,13,29,0.448,10,19,0.526,3,10,0.3,8,10,0.8,0,3,3
159,Karl-Anthony Towns,21-074,F-C,1/28/17,MIN,,BRK,W,1,36,15,26,0.577,13,23,0.565,2,3,0.667,5,8,0.625,4,9,13
160,Karl-Anthony Towns,21-065,F-C,1/19/17,MIN,@,LAC,W,1,41,17,24,0.708,16,22,0.727,1,2,0.5,2,2,1,5,7,12
161,Karl-Anthony Towns,21-102,F-C,2/25/17,MIN,@,HOU,L,1,37,16,24,0.667,15,22,0.682,1,2,0.5,4,4,1,9,13,22
162,Kemba Walker,26-237,G,12/31/16,CHO,,CLE,L,1,35,13,22,0.591,10,14,0.714,3,8,0.375,8,8,1,0,5,5
163,Russell Westbrook,28-029,G,12/11/16,OKC,,BOS,W,1,36,14,26,0.538,12,21,0.571,2,5,0.4,7,12,0.583,3,9,12
164,Devin Booker,20-132,G,3/11/17,PHO,@,DAL,W,1,35,12,20,0.6,10,15,0.667,2,5,0.4,10,10,1,1,4,5
165,Wilson Chandler,29-300,F,3/6/17,DEN,,SAC,W,1,43,13,23,0.565,8,13,0.615,5,10,0.5,5,7,0.714,2,9,11
166,Ian Clark,26-004,G,3/11/17,GSW,@,SAS,L,0,34,15,21,0.714,12,18,0.667,3,3,1,3,6,0.5,1,4,5
167,DeMarcus Cousins,26-107,C-F,11/28/16,SAC,@,WAS,L,1,40,16,34,0.471,15,28,0.536,1,6,0.167,3,10,0.3,4,16,20
168,DeMarcus Cousins,26-102,C-F,11/23/16,SAC,,OKC,W,1,35,14,28,0.5,11,23,0.478,3,5,0.6,5,6,0.833,2,11,13
169,DeMarcus Cousins,26-113,C-F,12/4/16,SAC,@,NYK,L,1,43,9,31,0.29,5,21,0.238,4,10,0.4,14,16,0.875,5,8,13
170,Anthony Davis,23-309,F-C,1/14/17,NOP,@,CHI,L,1,39,14,23,0.609,14,23,0.609,0,0,,8,10,0.8,3,11,14
171,Anthony Davis,23-302,F-C,1/7/17,NOP,@,BOS,L,1,38,14,21,0.667,13,20,0.65,1,1,1,7,9,0.778,3,13,16
172,Anthony Davis,23-324,F-C,1/29/17,NOP,,WAS,L,1,40,15,25,0.6,14,23,0.609,1,2,0.5,5,6,0.833,2,15,17
173,Anthony Davis,23-261,F-C,11/27/16,NOP,@,DAL,L,1,40,12,22,0.545,12,21,0.571,0,1,0,12,14,0.857,3,10,13
174,DeMar DeRozan,27-154,G,1/8/17,TOR,,HOU,L,1,39,13,21,0.619,13,21,0.619,0,0,,10,10,1,0,6,6
175,DeMar DeRozan,27-153,G,1/7/17,TOR,@,CHI,L,1,43,10,23,0.435,10,22,0.455,0,1,0,16,17,0.941,1,7,8
176,DeMar DeRozan,27-163,G,1/17/17,TOR,@,BRK,W,1,37,13,28,0.464,13,28,0.464,0,0,,10,10,1,2,9,11
177,Kevin Durant,28-087,F-G,12/25/16,GSW,@,CLE,L,1,38,11,23,0.478,9,15,0.6,2,8,0.25,12,12,1,0,15,15
178,Marc Gasol,31-314,C,12/8/16,MEM,,POR,W,1,34,13,24,0.542,9,18,0.5,4,6,0.667,6,9,0.667,2,7,9
179,Paul George,26-308,F,3/6/17,IND,@,CHO,L,1,36,15,25,0.6,9,11,0.818,6,14,0.429,0,0,,0,10,10
180,Tim Hardaway,24-352,G,3/3/17,ATL,,CLE,L,0,35,13,20,0.65,8,11,0.727,5,9,0.556,5,6,0.833,1,1,2
181,James Harden,27-108,G,12/12/16,HOU,,BRK,W,1,39,12,27,0.444,8,16,0.5,4,11,0.364,8,12,0.667,3,5,8
182,Gordon Hayward,26-323,F-G,2/9/17,UTA,@,DAL,L,1,43,13,27,0.481,9,17,0.529,4,10,0.4,6,7,0.857,1,3,4
183,LeBron James,32-007,F-G,1/6/17,CLE,@,BRK,W,1,35,14,20,0.7,14,19,0.737,0,1,0,8,10,0.8,0,9,9
184,Terrence Jones,25-014,F,1/23/17,NOP,,CLE,W,1,36,13,18,0.722,10,14,0.714,3,4,0.75,7,10,0.7,3,8,11
185,Kawhi Leonard,25-216,F,1/31/17,SAS,,OKC,W,1,36,13,26,0.5,12,22,0.545,1,4,0.25,9,11,0.818,1,7,8
186,Kawhi Leonard,25-228,F,2/12/17,SAS,@,NYK,L,1,36,13,27,0.481,12,20,0.6,1,7,0.143,9,11,0.818,2,7,9
187,Damian Lillard,26-119,G,11/11/16,POR,,SAC,W,1,42,12,19,0.632,7,9,0.778,5,10,0.5,7,9,0.778,0,1,1
188,Damian Lillard,26-243,G,3/15/17,POR,@,SAS,W,1,34,12,22,0.545,9,14,0.643,3,8,0.375,9,9,1,1,2,3
189,Brook Lopez,28-320,C,2/15/17,BRK,,MIL,L,1,35,12,20,0.6,6,10,0.6,6,10,0.6,6,8,0.75,2,2,4
190,Kyle Lowry,30-273,G,12/23/16,TOR,@,UTA,W,1,33,15,20,0.75,11,12,0.917,4,8,0.5,2,3,0.667,0,4,4
191,C.J. McCollum,25-092,G,12/20/16,POR,@,SAC,L,1,39,13,22,0.591,11,15,0.733,2,7,0.286,8,10,0.8,1,1,2
192,Marcus Morris,27-154,F,2/3/17,DET,,MIN,W,1,38,12,19,0.632,7,10,0.7,5,9,0.556,7,11,0.636,2,3,5
193,Klay Thompson,27-002,G,2/10/17,GSW,@,MEM,W,1,38,13,23,0.565,5,8,0.625,8,15,0.533,2,2,1,0,1,1
194,Karl-Anthony Towns,21-087,F-C,2/10/17,MIN,,NOP,L,1,38,13,22,0.591,12,17,0.706,1,5,0.2,9,9,1,4,4,8
195,John Wall,26-113,G,12/28/16,WAS,,IND,W,1,39,11,19,0.579,9,16,0.563,2,3,0.667,12,13,0.923,2,9,11
196,Russell Westbrook,28-064,G,1/15/17,OKC,@,SAC,W,1,36,11,21,0.524,7,16,0.438,4,5,0.8,10,11,0.909,2,9,11
197,Russell Westbrook,28-013,G,11/25/16,OKC,@,DEN,W,1,41,9,25,0.36,6,21,0.286,3,4,0.75,15,17,0.882,1,10,11
198,Russell Westbrook,27-363,G,11/9/16,OKC,,TOR,L,1,39,9,26,0.346,6,14,0.429,3,12,0.25,15,18,0.833,2,5,7
199,Andrew Wiggins,21-259,F-G,11/8/16,MIN,@,BRK,L,1,41,13,29,0.448,7,22,0.318,6,7,0.857,4,8,0.5,5,3,8
200,Giannis Antetokounmpo,22-025,F-G,12/31/16,MIL,@,CHI,W,1,41,13,19,0.684,12,18,0.667,1,1,1,8,11,0.727,3,6,9
201,Carmelo Anthony,32-191,F,12/6/16,NYK,@,MIA,W,1,36,13,27,0.481,10,18,0.556,3,9,0.333,6,7,0.857,1,2,3
201,Carmelo Anthony,32-191,F,12/6/16,NYK,@,MIA,W,1,36,13,27,0.481,10,18,0.556,3,9,0.333,6,7,0.857,1,2,3
202,Carmelo Anthony,32-205,F,12/20/16,NYK,,IND,W,1,37,13,25,0.52,6,14,0.429,7,11,0.636,2,2,1,0,4,4
202,Carmelo Anthony,32-205,F,12/20/16,NYK,,IND,W,1,37,13,25,0.52,6,14,0.429,7,11,0.636,2,2,1,0,4,4
203,Carmelo Anthony,32-180,F,11/25/16,NYK,,CHO,W,1,41,14,25,0.56,11,19,0.579,3,6,0.5,4,4,1,1,12,13
203,Carmelo Anthony,32-180,F,11/25/16,NYK,,CHO,W,1,41,14,25,0.56,11,19,0.579,3,6,0.5,4,4,1,1,12,13
204,Will Barton,26-069,G,3/16/17,DEN,,LAC,W,0,36,12,18,0.667,5,8,0.625,7,10,0.7,4,5,0.8,2,3,5
204,Will Barton,26-069,G,3/16/17,DEN,,LAC,W,0,36,12,18,0.667,5,8,0.625,7,10,0.7,4,5,0.8,2,3,5
205,Bradley Beal,23-197,G,1/11/17,WAS,@,BOS,L,1,37,13,26,0.5,7,16,0.438,6,10,0.6,3,4,0.75,2,0,2
205,Bradley Beal,23-197,G,1/11/17,WAS,@,BOS,L,1,37,13,26,0.5,7,16,0.438,6,10,0.6,3,4,0.75,2,0,2
206,Eric Bledsoe,26-354,G,11/27/16,PHO,,DEN,L,1,40,10,23,0.435,6,15,0.4,4,8,0.5,11,11,1,0,6,6
206,Eric Bledsoe,26-354,G,11/27/16,PHO,,DEN,L,1,40,10,23,0.435,6,15,0.4,4,8,0.5,11,11,1,0,6,6
207,Jimmy Butler,27-069,G-F,11/22/16,CHI,@,DEN,L,1,39,11,20,0.55,9,16,0.563,2,4,0.5,11,12,0.917,0,7,7
207,Jimmy Butler,27-069,G-F,11/22/16,CHI,@,DEN,L,1,39,11,20,0.55,9,16,0.563,2,4,0.5,11,12,0.917,0,7,7
208,DeMarcus Cousins,26-168,C-F,1/28/17,SAC,@,CHO,W,1,34,13,22,0.591,11,20,0.55,2,2,1,7,9,0.778,7,11,18
208,DeMarcus Cousins,26-168,C-F,1/28/17,SAC,@,CHO,W,1,34,13,22,0.591,11,20,0.55,2,2,1,7,9,0.778,7,11,18
209,Stephen Curry,28-327,G,2/4/17,GSW,@,SAC,L,1,42,11,20,0.55,3,6,0.5,8,14,0.571,5,6,0.833,0,4,4
209,Stephen Curry,28-327,G,2/4/17,GSW,@,SAC,L,1,42,11,20,0.55,3,6,0.5,8,14,0.571,5,6,0.833,0,4,4
210,Stephen Curry,28-346,G,2/23/17,GSW,,LAC,W,1,32,10,16,0.625,4,6,0.667,6,10,0.6,9,10,0.9,1,6,7
210,Stephen Curry,28-346,G,2/23/17,GSW,,LAC,W,1,32,10,16,0.625,4,6,0.667,6,10,0.6,9,10,0.9,1,6,7
211,Stephen Curry,28-296,G,1/4/17,GSW,,POR,W,1,36,12,25,0.48,7,12,0.583,5,13,0.385,6,8,0.75,1,6,7
211,Stephen Curry,28-296,G,1/4/17,GSW,,POR,W,1,36,12,25,0.48,7,12,0.583,5,13,0.385,6,8,0.75,1,6,7
212,Stephen Curry,28-247,G,11/16/16,GSW,@,TOR,W,1,37,10,19,0.526,7,10,0.7,3,9,0.333,12,13,0.923,2,1,3
212,Stephen Curry,28-247,G,11/16/16,GSW,@,TOR,W,1,37,10,19,0.526,7,10,0.7,3,9,0.333,12,13,0.923,2,1,3
213,Anthony Davis,23-235,F-C,11/1/16,NOP,,MIL,L,1,37,9,21,0.429,9,18,0.5,0,3,0,17,18,0.944,3,12,15
213,Anthony Davis,23-235,F-C,11/1/16,NOP,,MIL,L,1,37,9,21,0.429,9,18,0.5,0,3,0,17,18,0.944,3,12,15
214,Anthony Davis,23-279,F-C,12/15/16,NOP,,IND,W,1,39,11,24,0.458,9,21,0.429,2,3,0.667,11,15,0.733,2,14,16
214,Anthony Davis,23-279,F-C,12/15/16,NOP,,IND,W,1,39,11,24,0.458,9,21,0.429,2,3,0.667,11,15,0.733,2,14,16
215,James Harden,27-194,G,3/8/17,HOU,,UTA,L,1,37,10,22,0.455,10,14,0.714,0,8,0,15,16,0.938,0,4,4
215,James Harden,27-194,G,3/8/17,HOU,,UTA,L,1,37,10,22,0.455,10,14,0.714,0,8,0,15,16,0.938,0,4,4
216,Nikola Jokic,21-335,C-F,1/19/17,DEN,@,SAS,L,1,38,14,22,0.636,12,18,0.667,2,4,0.5,5,5,1,4,8,12
216,Nikola Jokic,21-335,C-F,1/19/17,DEN,@,SAS,L,1,38,14,22,0.636,12,18,0.667,2,4,0.5,5,5,1,4,8,12
217,Kawhi Leonard,25-118,F,10/25/16,SAS,@,GSW,W,1,32,10,21,0.476,10,18,0.556,0,3,0,15,15,1,3,2,5
217,Kawhi Leonard,25-118,F,10/25/16,SAS,@,GSW,W,1,32,10,21,0.476,10,18,0.556,0,3,0,15,15,1,3,2,5
218,C.J. McCollum,25-111,G,1/8/17,POR,,DET,L,1,44,16,28,0.571,13,19,0.684,3,9,0.333,0,0,,0,3,3
218,C.J. McCollum,25-111,G,1/8/17,POR,,DET,L,1,44,16,28,0.571,13,19,0.684,3,9,0.333,0,0,,0,3,3
219,C.J. McCollum,25-124,G,1/21/17,POR,@,BOS,W,1,46,11,21,0.524,8,15,0.533,3,6,0.5,10,13,0.769,0,2,2
219,C.J. McCollum,25-124,G,1/21/17,POR,@,BOS,W,1,46,11,21,0.524,8,15,0.533,3,6,0.5,10,13,0.769,0,2,2
220,C.J. McCollum,25-107,G,1/4/17,POR,@,GSW,L,1,38,13,31,0.419,9,20,0.45,4,11,0.364,5,5,1,2,7,9
220,C.J. McCollum,25-107,G,1/4/17,POR,@,GSW,L,1,38,13,31,0.419,9,20,0.45,4,11,0.364,5,5,1,2,7,9
221,Kristaps Porzingis,21-106,F-C,11/16/16,NYK,,DET,W,1,40,13,22,0.591,10,15,0.667,3,7,0.429,6,7,0.857,4,3,7
221,Kristaps Porzingis,21-106,F-C,11/16/16,NYK,,DET,W,1,40,13,22,0.591,10,15,0.667,3,7,0.429,6,7,0.857,4,3,7
222,Isaiah Thomas,27-344,G,1/16/17,BOS,,CHO,W,1,31,14,25,0.56,7,10,0.7,7,15,0.467,0,0,,1,4,5
222,Isaiah Thomas,27-344,G,1/16/17,BOS,,CHO,W,1,31,14,25,0.56,7,10,0.7,7,15,0.467,0,0,,1,4,5
223,Isaiah Thomas,28-026,G,3/5/17,BOS,@,PHO,L,1,32,10,25,0.4,5,13,0.385,5,12,0.417,10,11,0.909,0,2,2
223,Isaiah Thomas,28-026,G,3/5/17,BOS,@,PHO,L,1,32,10,25,0.4,5,13,0.385,5,12,0.417,10,11,0.909,0,2,2
224,Klay Thompson,27-007,G,2/15/17,GSW,,SAC,W,1,31,12,18,0.667,5,6,0.833,7,12,0.583,4,7,0.571,2,3,5
224,Klay Thompson,27-007,G,2/15/17,GSW,,SAC,W,1,31,12,18,0.667,5,6,0.833,7,12,0.583,4,7,0.571,2,3,5
225,Karl-Anthony Towns,21-083,F-C,2/6/17,MIN,,MIA,L,1,38,13,20,0.65,11,17,0.647,2,3,0.667,7,10,0.7,4,4,8
225,Karl-Anthony Towns,21-083,F-C,2/6/17,MIN,,MIA,L,1,38,13,20,0.65,11,17,0.647,2,3,0.667,7,10,0.7,4,4,8
226,Karl-Anthony Towns,21-116,F-C,3/11/17,MIN,@,MIL,L,1,40,14,21,0.667,11,16,0.688,3,5,0.6,4,6,0.667,4,10,14
226,Karl-Anthony Towns,21-116,F-C,3/11/17,MIN,@,MIL,L,1,40,14,21,0.667,11,16,0.688,3,5,0.6,4,6,0.667,4,10,14
227,Dwyane Wade,34-292,G,11/4/16,CHI,,NYK,L,1,33,12,20,0.6,7,13,0.538,5,7,0.714,6,8,0.75,2,8,10
227,Dwyane Wade,34-292,G,11/4/16,CHI,,NYK,L,1,33,12,20,0.6,7,13,0.538,5,7,0.714,6,8,0.75,2,8,10
228,Russell Westbrook,27-356,G,11/2/16,OKC,@,LAC,W,1,33,14,30,0.467,14,23,0.609,0,7,0,7,9,0.778,1,5,6
228,Russell Westbrook,27-356,G,11/2/16,OKC,@,LAC,W,1,33,14,30,0.467,14,23,0.609,0,7,0,7,9,0.778,1,5,6
229,Russell Westbrook,28-018,G,11/30/16,OKC,,WAS,W,1,41,12,35,0.343,11,29,0.379,1,6,0.167,10,10,1,4,10,14
229,Russell Westbrook,28-018,G,11/30/16,OKC,,WAS,W,1,41,12,35,0.343,11,29,0.379,1,6,0.167,10,10,1,4,10,14
230,Andrew Wiggins,21-268,F-G,11/17/16,MIN,,PHI,W,1,38,14,20,0.7,11,14,0.786,3,6,0.5,4,4,1,4,6,10
230,Andrew Wiggins,21-268,F-G,11/17/16,MIN,,PHI,W,1,38,14,20,0.7,11,14,0.786,3,6,0.5,4,4,1,4,6,10
231,Lou Williams,30-043,G,12/9/16,LAL,,PHO,L,0,35,10,19,0.526,4,7,0.571,6,12,0.5,9,11,0.818,0,5,5
231,Lou Williams,30-043,G,12/9/16,LAL,,PHO,L,0,35,10,19,0.526,4,7,0.571,6,12,0.5,9,11,0.818,0,5,5
232,Giannis Antetokounmpo,21-359,F-G,11/29/16,MIL,,CLE,W,1,35,13,19,0.684,12,17,0.706,1,2,0.5,7,10,0.7,1,11,12
232,Giannis Antetokounmpo,21-359,F-G,11/29/16,MIL,,CLE,W,1,35,13,19,0.684,12,17,0.706,1,2,0.5,7,10,0.7,1,11,12
233,Carmelo Anthony,32-235,F,1/19/17,NYK,,WAS,L,1,35,13,27,0.481,10,20,0.5,3,7,0.429,5,7,0.714,1,9,10
233,Carmelo Anthony,32-235,F,1/19/17,NYK,,WAS,L,1,35,13,27,0.481,10,20,0.5,3,7,0.429,5,7,0.714,1,9,10
234,Harrison Barnes,24-160,F,11/6/16,DAL,,MIL,W,1,48,13,26,0.5,11,21,0.524,2,5,0.4,6,7,0.857,3,5,8
234,Harrison Barnes,24-160,F,11/6/16,DAL,,MIL,W,1,48,13,26,0.5,11,21,0.524,2,5,0.4,6,7,0.857,3,5,8
235,Bradley Beal,23-144,G,11/19/16,WAS,,MIA,L,1,40,12,26,0.462,8,15,0.533,4,11,0.364,6,6,1,2,3,5
235,Bradley Beal,23-144,G,11/19/16,WAS,,MIA,L,1,40,12,26,0.462,8,15,0.533,4,11,0.364,6,6,1,2,3,5
236,Stephen Curry,28-257,G,11/26/16,GSW,,MIN,W,1,37,13,19,0.684,9,11,0.818,4,8,0.5,4,4,1,1,7,8
236,Stephen Curry,28-257,G,11/26/16,GSW,,MIN,W,1,37,13,19,0.684,9,11,0.818,4,8,0.5,4,4,1,1,7,8
237,Anthony Davis,23-285,F-C,12/21/16,NOP,,OKC,L,1,36,14,26,0.538,13,24,0.542,1,2,0.5,5,7,0.714,2,12,14
237,Anthony Davis,23-285,F-C,12/21/16,NOP,,OKC,L,1,36,14,26,0.538,13,24,0.542,1,2,0.5,5,7,0.714,2,12,14
238,Anthony Davis,23-246,F-C,11/12/16,NOP,,LAL,L,1,35,13,26,0.5,13,24,0.542,0,2,0,8,11,0.727,1,7,8
238,Anthony Davis,23-246,F-C,11/12/16,NOP,,LAL,L,1,35,13,26,0.5,13,24,0.542,0,2,0,8,11,0.727,1,7,8
239,Anthony Davis,23-332,F-C,2/6/17,NOP,,PHO,W,1,40,12,21,0.571,11,19,0.579,1,2,0.5,9,11,0.818,2,7,9
239,Anthony Davis,23-332,F-C,2/6/17,NOP,,PHO,W,1,40,12,21,0.571,11,19,0.579,1,2,0.5,9,11,0.818,2,7,9
240,Anthony Davis,23-242,F-C,11/8/16,NOP,@,SAC,L,1,37,14,22,0.636,14,20,0.7,0,2,0,6,7,0.857,1,7,8
240,Anthony Davis,23-242,F-C,11/8/16,NOP,@,SAC,L,1,37,14,22,0.636,14,20,0.7,0,2,0,6,7,0.857,1,7,8
241,DeMar DeRozan,27-101,G,11/16/16,TOR,,GSW,L,1,38,8,18,0.444,7,14,0.5,1,4,0.25,17,17,1,1,5,6
241,DeMar DeRozan,27-101,G,11/16/16,TOR,,GSW,L,1,38,8,18,0.444,7,14,0.5,1,4,0.25,17,17,1,1,5,6
242,DeMar DeRozan,27-131,G,12/16/16,TOR,,ATL,L,1,37,15,26,0.577,15,26,0.577,0,0,,4,6,0.667,0,5,5
242,DeMar DeRozan,27-131,G,12/16/16,TOR,,ATL,L,1,37,15,26,0.577,15,26,0.577,0,0,,4,6,0.667,0,5,5
243,DeMar DeRozan,27-096,G,11/11/16,TOR,@,CHO,W,1,36,14,26,0.538,14,25,0.56,0,1,0,6,7,0.857,0,3,3
243,DeMar DeRozan,27-096,G,11/11/16,TOR,@,CHO,W,1,36,14,26,0.538,14,25,0.56,0,1,0,6,7,0.857,0,3,3
244,DeMar DeRozan,27-089,G,11/4/16,TOR,,MIA,W,1,37,14,26,0.538,14,24,0.583,0,2,0,6,6,1,1,3,4
244,DeMar DeRozan,27-089,G,11/4/16,TOR,,MIA,W,1,37,14,26,0.538,14,24,0.583,0,2,0,6,6,1,1,3,4
245,Goran Dragic,30-220,G,12/12/16,MIA,,WAS,W,1,31,14,23,0.609,12,18,0.667,2,5,0.4,4,4,1,2,3,5
245,Goran Dragic,30-220,G,12/12/16,MIA,,WAS,W,1,31,14,23,0.609,12,18,0.667,2,5,0.4,4,4,1,2,3,5
246,Kevin Durant,28-135,F-G,2/11/17,GSW,@,OKC,W,1,33,12,21,0.571,9,15,0.6,3,6,0.5,7,7,1,1,8,9
246,Kevin Durant,28-135,F-G,2/11/17,GSW,@,OKC,W,1,33,12,21,0.571,9,15,0.6,3,6,0.5,7,7,1,1,8,9
247,Kevin Durant,28-079,F-G,12/17/16,GSW,,POR,W,1,31,11,13,0.846,7,8,0.875,4,5,0.8,8,10,0.8,1,10,11
247,Kevin Durant,28-079,F-G,12/17/16,GSW,,POR,W,1,31,11,13,0.846,7,8,0.875,4,5,0.8,8,10,0.8,1,10,11
248,Paul George,26-307,F,3/5/17,IND,@,ATL,W,1,38,12,19,0.632,6,10,0.6,6,9,0.667,4,5,0.8,0,5,5
248,Paul George,26-307,F,3/5/17,IND,@,ATL,W,1,38,12,19,0.632,6,10,0.6,6,9,0.667,4,5,0.8,0,5,5
249,Paul George,26-240,F,12/28/16,IND,@,WAS,L,1,37,10,20,0.5,4,10,0.4,6,10,0.6,8,8,1,0,3,3
249,Paul George,26-240,F,12/28/16,IND,@,WAS,L,1,37,10,20,0.5,4,10,0.4,6,10,0.6,8,8,1,0,3,3
250,James Harden,27-061,G,10/26/16,HOU,@,LAL,L,1,37,9,19,0.474,8,12,0.667,1,7,0.143,15,16,0.938,3,4,7
250,James Harden,27-061,G,10/26/16,HOU,@,LAL,L,1,37,9,19,0.474,8,12,0.667,1,7,0.143,15,16,0.938,3,4,7
251,James Harden,27-123,G,12/27/16,HOU,@,DAL,W,1,30,9,16,0.563,5,9,0.556,4,7,0.571,12,12,1,2,3,5
251,James Harden,27-123,G,12/27/16,HOU,@,DAL,W,1,30,9,16,0.563,5,9,0.556,4,7,0.571,12,12,1,2,3,5
252,George Hill,30-303,G,3/3/17,UTA,,BRK,W,1,32,10,12,0.833,7,9,0.778,3,3,1,11,12,0.917,0,2,2
252,George Hill,30-303,G,3/3/17,UTA,,BRK,W,1,32,10,12,0.833,7,9,0.778,3,3,1,11,12,0.917,0,2,2
253,Kyrie Irving,24-339,G,2/25/17,CLE,,CHI,L,1,35,13,25,0.52,11,15,0.733,2,10,0.2,6,7,0.857,0,9,9
253,Kyrie Irving,24-339,G,2/25/17,CLE,,CHI,L,1,35,13,25,0.52,11,15,0.733,2,10,0.2,6,7,0.857,0,9,9
254,LeBron James,31-356,F-G,12/20/16,CLE,@,MIL,W,1,47,12,25,0.48,7,16,0.438,5,9,0.556,5,6,0.833,3,9,12
254,LeBron James,31-356,F-G,12/20/16,CLE,@,MIL,W,1,47,12,25,0.48,7,16,0.438,5,9,0.556,5,6,0.833,3,9,12
255,LeBron James,32-079,F-G,3/19/17,CLE,@,LAL,W,1,38,13,22,0.591,10,14,0.714,3,8,0.375,5,8,0.625,0,6,6
255,LeBron James,32-079,F-G,3/19/17,CLE,@,LAL,W,1,38,13,22,0.591,10,14,0.714,3,8,0.375,5,8,0.625,0,6,6
256,LeBron James,31-341,F-G,12/5/16,CLE,@,TOR,W,1,42,12,26,0.462,10,19,0.526,2,7,0.286,8,9,0.889,3,5,8
256,LeBron James,31-341,F-G,12/5/16,CLE,@,TOR,W,1,42,12,26,0.462,10,19,0.526,2,7,0.286,8,9,0.889,3,5,8
257,Kawhi Leonard,25-204,F,1/19/17,SAS,,DEN,W,1,36,12,22,0.545,10,17,0.588,2,5,0.4,8,8,1,0,5,5
257,Kawhi Leonard,25-204,F,1/19/17,SAS,,DEN,W,1,36,12,22,0.545,10,17,0.588,2,5,0.4,8,8,1,0,5,5
258,Kawhi Leonard,25-248,F,3/4/17,SAS,,MIN,W,1,44,11,25,0.44,10,20,0.5,1,5,0.2,11,12,0.917,1,9,10
258,Kawhi Leonard,25-248,F,3/4/17,SAS,,MIN,W,1,44,11,25,0.44,10,20,0.5,1,5,0.2,11,12,0.917,1,9,10
259,Kawhi Leonard,25-133,F,11/9/16,SAS,,HOU,L,1,39,11,26,0.423,7,20,0.35,4,6,0.667,8,8,1,2,5,7
259,Kawhi Leonard,25-133,F,11/9/16,SAS,,HOU,L,1,39,11,26,0.423,7,20,0.35,4,6,0.667,8,8,1,2,5,7
260,Kawhi Leonard,25-202,F,1/17/17,SAS,,MIN,W,1,39,12,17,0.706,10,14,0.714,2,3,0.667,8,9,0.889,1,6,7
260,Kawhi Leonard,25-202,F,1/17/17,SAS,,MIN,W,1,39,12,17,0.706,10,14,0.714,2,3,0.667,8,9,0.889,1,6,7
261,Kawhi Leonard,25-259,F,3/15/17,SAS,,POR,L,1,37,12,21,0.571,8,14,0.571,4,7,0.571,6,7,0.857,0,9,9
261,Kawhi Leonard,25-259,F,3/15/17,SAS,,POR,L,1,37,12,21,0.571,8,14,0.571,4,7,0.571,6,7,0.857,0,9,9
262,Damian Lillard,26-228,G,2/28/17,POR,@,DET,L,1,41,13,25,0.52,10,17,0.588,3,8,0.375,5,6,0.833,1,10,11
262,Damian Lillard,26-228,G,2/28/17,POR,@,DET,L,1,41,13,25,0.52,10,17,0.588,3,8,0.375,5,6,0.833,1,10,11
263,Damian Lillard,26-182,G,1/13/17,POR,,ORL,L,1,37,12,26,0.462,10,15,0.667,2,11,0.182,8,9,0.889,1,7,8
263,Damian Lillard,26-182,G,1/13/17,POR,,ORL,L,1,37,12,26,0.462,10,15,0.667,2,11,0.182,8,9,0.889,1,7,8
264,Brook Lopez,28-215,C,11/2/16,BRK,,DET,W,1,29,12,21,0.571,8,13,0.615,4,8,0.5,6,9,0.667,2,9,11
264,Brook Lopez,28-215,C,11/2/16,BRK,,DET,W,1,29,12,21,0.571,8,13,0.615,4,8,0.5,6,9,0.667,2,9,11
265,Kyle Lowry,30-259,G,12/9/16,TOR,@,BOS,W,1,36,9,18,0.5,5,10,0.5,4,8,0.5,12,13,0.923,1,6,7
265,Kyle Lowry,30-259,G,12/9/16,TOR,@,BOS,W,1,36,9,18,0.5,5,10,0.5,4,8,0.5,12,13,0.923,1,6,7
266,C.J. McCollum,25-082,G,12/10/16,POR,@,IND,L,1,37,12,22,0.545,5,11,0.455,7,11,0.636,3,3,1,1,3,4
266,C.J. McCollum,25-082,G,12/10/16,POR,@,IND,L,1,37,12,22,0.545,5,11,0.455,7,11,0.636,3,3,1,1,3,4
267,C.J. McCollum,25-173,G,3/11/17,POR,,WAS,L,1,42,13,23,0.565,8,14,0.571,5,9,0.556,3,3,1,0,0,0
267,C.J. McCollum,25-173,G,3/11/17,POR,,WAS,L,1,42,13,23,0.565,8,14,0.571,5,9,0.556,3,3,1,0,0,0
268,Otto Porter,23-159,F,11/9/16,WAS,,BOS,W,1,38,14,19,0.737,11,14,0.786,3,5,0.6,3,3,1,7,7,14
268,Otto Porter,23-159,F,11/9/16,WAS,,BOS,W,1,38,14,19,0.737,11,14,0.786,3,5,0.6,3,3,1,7,7,14
269,Kristaps Porzingis,21-133,F-C,12/13/16,NYK,@,PHO,L,1,42,12,23,0.522,8,19,0.421,4,4,1,6,7,0.857,1,7,8
269,Kristaps Porzingis,21-133,F-C,12/13/16,NYK,@,PHO,L,1,42,12,23,0.522,8,19,0.421,4,4,1,6,7,0.857,1,7,8
270,Isaiah Thomas,27-320,G,12/23/16,BOS,,OKC,L,1,34,12,22,0.545,10,14,0.714,2,8,0.25,8,9,0.889,0,2,2
270,Isaiah Thomas,27-320,G,12/23/16,BOS,,OKC,L,1,34,12,22,0.545,10,14,0.714,2,8,0.25,8,9,0.889,0,2,2
271,Isaiah Thomas,28-002,G,2/9/17,BOS,@,POR,W,1,38,11,26,0.423,9,15,0.6,2,11,0.182,10,11,0.909,0,1,1
271,Isaiah Thomas,28-002,G,2/9/17,BOS,@,POR,W,1,38,11,26,0.423,9,15,0.6,2,11,0.182,10,11,0.909,0,1,1
272,Klay Thompson,27-040,G,3/20/17,GSW,@,OKC,W,1,32,12,21,0.571,5,6,0.833,7,15,0.467,3,3,1,1,5,6
272,Klay Thompson,27-040,G,3/20/17,GSW,@,OKC,W,1,32,12,21,0.571,5,6,0.833,7,15,0.467,3,3,1,1,5,6
273,Karl-Anthony Towns,21-055,F-C,1/9/17,MIN,,DAL,W,1,37,15,19,0.789,13,16,0.813,2,3,0.667,2,2,1,1,10,11
273,Karl-Anthony Towns,21-055,F-C,1/9/17,MIN,,DAL,W,1,37,15,19,0.789,13,16,0.813,2,3,0.667,2,2,1,1,10,11
274,Dwyane Wade,34-323,G,12/5/16,CHI,,POR,L,1,36,11,23,0.478,10,20,0.5,1,3,0.333,11,13,0.846,2,2,4
274,Dwyane Wade,34-323,G,12/5/16,CHI,,POR,L,1,36,11,23,0.478,10,20,0.5,1,3,0.333,11,13,0.846,2,2,4
275,Kemba Walker,26-239,G,1/2/17,CHO,@,CHI,L,1,38,13,20,0.65,7,12,0.583,6,8,0.75,2,2,1,0,9,9
275,Kemba Walker,26-239,G,1/2/17,CHO,@,CHI,L,1,38,13,20,0.65,7,12,0.583,6,8,0.75,2,2,1,0,9,9
276,Kemba Walker,26-294,G,2/26/17,CHO,@,LAC,L,1,43,11,19,0.579,5,9,0.556,6,10,0.6,6,8,0.75,0,2,2
276,Kemba Walker,26-294,G,2/26/17,CHO,@,LAC,L,1,43,11,19,0.579,5,9,0.556,6,10,0.6,6,8,0.75,0,2,2
277,Kemba Walker,26-291,G,2/23/17,CHO,@,DET,L,1,42,11,19,0.579,8,13,0.615,3,6,0.5,9,9,1,1,6,7
277,Kemba Walker,26-291,G,2/23/17,CHO,@,DET,L,1,42,11,19,0.579,8,13,0.615,3,6,0.5,9,9,1,1,6,7
278,John Wall,26-074,G,11/19/16,WAS,,MIA,L,1,37,12,23,0.522,7,17,0.412,5,6,0.833,5,8,0.625,1,2,3
278,John Wall,26-074,G,11/19/16,WAS,,MIA,L,1,37,12,23,0.522,7,17,0.412,5,6,0.833,5,8,0.625,1,2,3
279,Russell Westbrook,28-010,G,11/22/16,OKC,@,LAL,L,1,36,13,30,0.433,9,21,0.429,4,9,0.444,4,5,0.8,3,5,8
279,Russell Westbrook,28-010,G,11/22/16,OKC,@,LAL,L,1,36,13,30,0.433,9,21,0.429,4,9,0.444,4,5,0.8,3,5,8
280,LaMarcus Aldridge,31-159,F-C,12/25/16,SAS,,CHI,W,1,38,15,20,0.75,15,20,0.75,0,0,,3,6,0.5,3,6,9
280,LaMarcus Aldridge,31-159,F-C,12/25/16,SAS,,CHI,W,1,38,15,20,0.75,15,20,0.75,0,0,,3,6,0.5,3,6,9
281,Giannis Antetokounmpo,22-080,F-G,2/24/17,MIL,,UTA,L,1,34,10,16,0.625,8,12,0.667,2,4,0.5,11,15,0.733,4,8,12
281,Giannis Antetokounmpo,22-080,F-G,2/24/17,MIL,,UTA,L,1,34,10,16,0.625,8,12,0.667,2,4,0.5,11,15,0.733,4,8,12
282,Giannis Antetokounmpo,22-040,F-G,1/15/17,MIL,@,ATL,L,1,40,13,22,0.591,13,20,0.65,0,2,0,7,7,1,5,2,7
282,Giannis Antetokounmpo,22-040,F-G,1/15/17,MIL,@,ATL,L,1,40,13,22,0.591,13,20,0.65,0,2,0,7,7,1,5,2,7
283,Giannis Antetokounmpo,22-071,F-G,2/15/17,MIL,@,BRK,W,1,40,13,25,0.52,13,24,0.542,0,1,0,7,10,0.7,2,7,9
283,Giannis Antetokounmpo,22-071,F-G,2/15/17,MIL,@,BRK,W,1,40,13,25,0.52,13,24,0.542,0,1,0,7,10,0.7,2,7,9
284,Carmelo Anthony,32-194,F,12/9/16,NYK,@,SAC,W,1,36,9,22,0.409,6,12,0.5,3,10,0.3,12,14,0.857,0,7,7
284,Carmelo Anthony,32-194,F,12/9/16,NYK,@,SAC,W,1,36,9,22,0.409,6,12,0.5,3,10,0.3,12,14,0.857,0,7,7
285,Carmelo Anthony,32-257,F,2/10/17,NYK,,DEN,L,1,35,13,20,0.65,7,10,0.7,6,10,0.6,1,2,0.5,1,5,6
285,Carmelo Anthony,32-257,F,2/10/17,NYK,,DEN,L,1,35,13,20,0.65,7,10,0.7,6,10,0.6,1,2,0.5,1,5,6
286,Devin Booker,20-096,G,2/3/17,PHO,@,SAC,W,1,41,11,24,0.458,7,16,0.438,4,8,0.5,7,10,0.7,0,2,2
286,Devin Booker,20-096,G,2/3/17,PHO,@,SAC,W,1,41,11,24,0.458,7,16,0.438,4,8,0.5,7,10,0.7,0,2,2
287,Kentavious Caldwell-Pope,24-005,G,2/23/17,DET,,CHO,W,1,43,11,25,0.44,4,10,0.4,7,15,0.467,4,4,1,1,8,9
287,Kentavious Caldwell-Pope,24-005,G,2/23/17,DET,,CHO,W,1,43,11,25,0.44,4,10,0.4,7,15,0.467,4,4,1,1,8,9
288,DeMarcus Cousins,26-082,C-F,11/3/16,SAC,@,ORL,L,1,36,12,20,0.6,11,17,0.647,1,3,0.333,8,9,0.889,1,6,7
288,DeMarcus Cousins,26-082,C-F,11/3/16,SAC,@,ORL,L,1,36,12,20,0.6,11,17,0.647,1,3,0.333,8,9,0.889,1,6,7
289,DeMarcus Cousins,26-090,C-F,11/11/16,SAC,@,POR,L,1,39,12,22,0.545,9,15,0.6,3,7,0.429,6,9,0.667,2,7,9
289,DeMarcus Cousins,26-090,C-F,11/11/16,SAC,@,POR,L,1,39,12,22,0.545,9,15,0.6,3,7,0.429,6,9,0.667,2,7,9
290,DeMarcus Cousins,26-127,C-F,12/18/16,SAC,@,DAL,L,1,35,12,24,0.5,10,18,0.556,2,6,0.333,7,10,0.7,0,6,6
290,DeMarcus Cousins,26-127,C-F,12/18/16,SAC,@,DAL,L,1,35,12,24,0.5,10,18,0.556,2,6,0.333,7,10,0.7,0,6,6
291,Stephen Curry,28-241,G,11/10/16,GSW,@,DEN,W,1,30,10,17,0.588,3,4,0.75,7,13,0.538,6,6,1,1,4,5
291,Stephen Curry,28-241,G,11/10/16,GSW,@,DEN,W,1,30,10,17,0.588,3,4,0.75,7,13,0.538,6,6,1,1,4,5
292,Anthony Davis,23-355,F-C,3/1/17,NOP,,DET,W,1,36,11,17,0.647,11,15,0.733,0,2,0,11,11,1,1,13,14
292,Anthony Davis,23-355,F-C,3/1/17,NOP,,DET,W,1,36,11,17,0.647,11,15,0.733,0,2,0,11,11,1,1,13,14
293,Anthony Davis,23-241,F-C,11/7/16,NOP,@,GSW,L,1,35,11,18,0.611,10,16,0.625,1,2,0.5,10,13,0.769,1,12,13
293,Anthony Davis,23-241,F-C,11/7/16,NOP,@,GSW,L,1,35,11,18,0.611,10,16,0.625,1,2,0.5,10,13,0.769,1,12,13
294,DeMar DeRozan,27-203,G,2/26/17,TOR,,POR,W,1,36,9,16,0.563,9,14,0.643,0,2,0,15,16,0.938,0,6,6
294,DeMar DeRozan,27-203,G,2/26/17,TOR,,POR,W,1,36,9,16,0.563,9,14,0.643,0,2,0,15,16,0.938,0,6,6
295,DeMar DeRozan,27-085,G,10/31/16,TOR,,DEN,W,1,39,13,23,0.565,13,22,0.591,0,1,0,7,9,0.778,2,3,5
295,DeMar DeRozan,27-085,G,10/31/16,TOR,,DEN,W,1,39,13,23,0.565,13,22,0.591,0,1,0,7,9,0.778,2,3,5
296,DeMar DeRozan,27-097,G,11/12/16,TOR,,NYK,W,1,36,11,23,0.478,10,22,0.455,1,1,1,10,13,0.769,2,5,7
296,DeMar DeRozan,27-097,G,11/12/16,TOR,,NYK,W,1,36,11,23,0.478,10,22,0.455,1,1,1,10,13,0.769,2,5,7
297,Goran Dragic,30-276,G,2/6/17,MIA,@,MIN,W,1,35,13,17,0.765,6,8,0.75,7,9,0.778,0,0,,1,1,2
297,Goran Dragic,30-276,G,2/6/17,MIA,@,MIN,W,1,35,13,17,0.765,6,8,0.75,7,9,0.778,0,0,,1,1,2
298,Goran Dragic,30-313,G,3/15/17,MIA,,NOP,W,1,32,11,18,0.611,6,9,0.667,5,9,0.556,6,8,0.75,1,4,5
298,Goran Dragic,30-313,G,3/15/17,MIA,,NOP,W,1,32,11,18,0.611,6,9,0.667,5,9,0.556,6,8,0.75,1,4,5
299,Kevin Durant,28-122,F-G,1/29/17,GSW,@,POR,W,1,36,13,26,0.5,12,19,0.632,1,7,0.143,6,6,1,2,8,10
299,Kevin Durant,28-122,F-G,1/29/17,GSW,@,POR,W,1,36,13,26,0.5,12,19,0.632,1,7,0.143,6,6,1,2,8,10
300,Kevin Durant,28-118,F-G,1/25/17,GSW,@,CHO,W,1,37,11,20,0.55,10,16,0.625,1,4,0.25,10,10,1,0,5,5
300,Kevin Durant,28-118,F-G,1/25/17,GSW,@,CHO,W,1,37,11,20,0.55,10,16,0.625,1,4,0.25,10,10,1,0,5,5
301,Kevin Durant,28-051,F-G,11/19/16,GSW,@,MIL,W,1,36,10,17,0.588,5,9,0.556,5,8,0.625,8,11,0.727,0,6,6
302,Joel Embiid,22-277,C-F,12/18/16,PHI,,BRK,W,1,27,12,17,0.706,10,14,0.714,2,3,0.667,7,8,0.875,2,8,10
303,Paul George,26-272,F,1/29/17,IND,,HOU,W,1,37,13,23,0.565,10,16,0.625,3,7,0.429,4,4,1,0,9,9
304,Paul George,26-270,F,1/27/17,IND,,SAC,W,1,45,8,18,0.444,7,13,0.538,1,5,0.2,16,17,0.941,1,3,4
305,Aaron Gordon,21-089,F,12/14/16,ORL,,LAC,L,1,40,13,21,0.619,9,13,0.692,4,8,0.5,3,6,0.5,4,3,7
306,Tim Hardaway,24-323,G,2/2/17,ATL,@,HOU,W,1,33,12,18,0.667,8,9,0.889,4,9,0.444,5,7,0.714,0,6,6
307,James Harden,27-080,G,11/14/16,HOU,,PHI,W,1,33,12,20,0.6,8,12,0.667,4,8,0.5,5,5,1,1,6,7
308,James Harden,27-138,G,1/11/17,HOU,@,MIN,L,1,39,10,23,0.435,8,12,0.667,2,11,0.182,11,13,0.846,0,6,6
309,James Harden,27-190,G,3/4/17,HOU,,MEM,W,1,36,9,15,0.6,3,5,0.6,6,10,0.6,9,13,0.692,1,6,7
310,Gordon Hayward,26-318,F-G,2/4/17,UTA,,CHO,W,1,37,13,20,0.65,11,16,0.688,2,4,0.5,5,6,0.833,1,7,8
311,Jrue Holiday,26-225,G,1/23/17,NOP,,CLE,W,1,39,12,19,0.632,8,12,0.667,4,7,0.571,5,5,1,0,6,6
312,LeBron James,32-076,F-G,3/16/17,CLE,,UTA,W,1,38,13,20,0.65,11,15,0.733,2,5,0.4,5,10,0.5,0,10,10
313,Cory Joseph,25-150,G,1/17/17,TOR,@,BRK,W,1,37,15,22,0.682,14,18,0.778,1,4,0.25,2,2,1,2,2,4
314,Kawhi Leonard,25-177,F,12/23/16,SAS,@,POR,W,1,32,9,15,0.6,4,8,0.5,5,7,0.714,10,10,1,0,3,3
315,Damian Lillard,26-148,G,12/10/16,POR,@,IND,L,1,37,10,24,0.417,5,10,0.5,5,14,0.357,8,9,0.889,1,2,3
316,Damian Lillard,26-230,G,3/2/17,POR,,OKC,W,1,38,11,23,0.478,8,14,0.571,3,9,0.333,8,9,0.889,1,3,4
317,Damian Lillard,26-223,G,2/23/17,POR,@,ORL,W,1,32,12,23,0.522,8,16,0.5,4,7,0.571,5,6,0.833,0,5,5
318,Damian Lillard,26-239,G,3/11/17,POR,,WAS,L,1,36,13,27,0.481,9,16,0.563,4,11,0.364,3,4,0.75,0,3,3
319,Damian Lillard,26-196,G,1/27/17,POR,,MEM,W,1,40,9,21,0.429,4,10,0.4,5,11,0.455,10,11,0.909,1,4,5
320,Brook Lopez,28-271,C,12/28/16,BRK,@,CHI,L,1,34,12,20,0.6,7,14,0.5,5,6,0.833,4,4,1,1,2,3
321,Brook Lopez,28-299,C,1/25/17,BRK,,MIA,L,1,33,11,23,0.478,4,9,0.444,7,14,0.5,4,4,1,0,4,4
322,Kyle Lowry,30-286,G,1/5/17,TOR,,UTA,W,1,41,10,17,0.588,6,9,0.667,4,8,0.5,9,11,0.818,1,5,6
323,Kyle Lowry,30-312,G,1/31/17,TOR,,NOP,W,1,45,11,21,0.524,5,7,0.714,6,14,0.429,5,7,0.714,0,4,4
324,Kyle Lowry,30-310,G,1/29/17,TOR,,ORL,L,1,38,9,18,0.5,3,9,0.333,6,9,0.667,9,12,0.75,1,4,5
325,C.J. McCollum,25-050,G,11/8/16,POR,,PHO,W,1,37,11,18,0.611,7,12,0.583,4,6,0.667,7,8,0.875,0,6,6
326,C.J. McCollum,25-062,G,11/20/16,POR,@,BRK,W,1,31,12,19,0.632,6,9,0.667,6,10,0.6,3,3,1,0,4,4
327,Jabari Parker,21-240,F,11/10/16,MIL,,NOP,L,1,35,13,26,0.5,10,20,0.5,3,6,0.5,4,4,1,1,8,9
328,Chris Paul,31-311,G,3/13/17,LAC,@,UTA,L,1,35,11,21,0.524,6,10,0.6,5,11,0.455,6,6,1,1,5,6
329,Dennis Schroder,23-085,G,12/9/16,ATL,@,MIL,W,1,40,12,19,0.632,8,12,0.667,4,7,0.571,5,5,1,0,3,3
330,Isaiah Thomas,28-019,G,2/26/17,BOS,@,DET,W,1,35,10,23,0.435,5,11,0.455,5,12,0.417,8,9,0.889,0,2,2
331,Isaiah Thomas,28-008,G,2/15/17,BOS,,PHI,W,1,34,9,19,0.474,5,12,0.417,4,7,0.571,11,13,0.846,1,3,4
332,Karl-Anthony Towns,21-072,F-C,1/26/17,MIN,,IND,L,1,38,13,23,0.565,9,17,0.529,4,6,0.667,3,4,0.75,2,8,10
333,Karl-Anthony Towns,20-356,F-C,11/5/16,MIN,@,OKC,L,1,31,13,20,0.65,10,16,0.625,3,4,0.75,4,5,0.8,4,2,6
334,Karl-Anthony Towns,21-124,F-C,3/19/17,MIN,@,NOP,L,1,39,14,27,0.519,10,19,0.526,4,8,0.5,1,2,0.5,2,4,6
335,Dwyane Wade,35-008,G,1/25/17,CHI,,ATL,L,1,31,14,24,0.583,14,23,0.609,0,1,0,5,8,0.625,3,2,5
336,Dion Waiters,25-044,G,1/23/17,MIA,,GSW,W,1,33,13,20,0.65,7,12,0.583,6,8,0.75,1,1,1,1,4,5
337,Dion Waiters,25-042,G,1/21/17,MIA,,MIL,W,1,33,12,19,0.632,7,11,0.636,5,8,0.625,4,8,0.5,0,3,3
338,Kemba Walker,26-304,G,3/8/17,CHO,@,MIA,L,1,38,11,24,0.458,6,13,0.462,5,11,0.455,6,6,1,0,4,4
339,John Wall,26-149,G,2/2/17,WAS,,LAL,W,1,41,11,23,0.478,8,16,0.5,3,7,0.429,8,10,0.8,1,2,3
340,John Wall,26-057,G,11/2/16,WAS,,TOR,L,1,37,13,19,0.684,13,16,0.813,0,3,0,7,9,0.778,1,4,5
341,Russell Westbrook,28-053,G,1/4/17,OKC,@,CHO,L,1,34,10,31,0.323,8,19,0.421,2,12,0.167,11,13,0.846,3,12,15
342,Russell Westbrook,27-353,G,10/30/16,OKC,,LAL,W,1,34,11,21,0.524,6,15,0.4,5,6,0.833,6,6,1,4,7,11
343,Russell Westbrook,28-002,G,11/14/16,OKC,@,DET,L,1,34,11,21,0.524,11,19,0.579,0,2,0,11,12,0.917,2,13,15
344,Russell Westbrook,28-119,G,3/11/17,OKC,,UTA,W,1,36,9,26,0.346,6,16,0.375,3,10,0.3,12,13,0.923,1,10,11
345,Giannis Antetokounmpo,22-043,F-G,1/18/17,MIL,@,HOU,L,1,37,13,20,0.65,12,16,0.75,1,4,0.25,5,6,0.833,1,10,11
346,Giannis Antetokounmpo,22-092,F-G,3/8/17,MIL,,NYK,W,1,41,11,21,0.524,11,20,0.55,0,1,0,10,13,0.769,6,7,13
347,Bradley Beal,23-250,G,3/5/17,WAS,,ORL,W,1,41,12,21,0.571,9,16,0.563,3,5,0.6,5,5,1,1,2,3
348,Eric Bledsoe,27-002,G,12/11/16,PHO,,NOP,L,1,40,13,26,0.5,10,15,0.667,3,11,0.273,3,4,0.75,1,2,3
349,Jimmy Butler,27-083,G-F,12/6/16,CHI,@,DET,L,1,43,11,21,0.524,11,17,0.647,0,4,0,10,10,1,0,6,6
350,Wilson Chandler,29-199,F,11/25/16,DEN,,OKC,L,1,37,14,25,0.56,12,20,0.6,2,5,0.4,2,2,1,3,8,11
351,Mike Conley,29-125,G,2/13/17,MEM,@,BRK,W,1,37,10,16,0.625,8,12,0.667,2,4,0.5,10,11,0.909,1,0,1
352,Mike Conley,29-146,G,3/6/17,MEM,,BRK,L,1,39,9,15,0.6,6,10,0.6,3,5,0.6,11,14,0.786,0,3,3
353,DeMarcus Cousins,26-104,C-F,11/25/16,SAC,,HOU,L,1,30,12,22,0.545,7,13,0.538,5,9,0.556,3,5,0.6,0,9,9
354,DeMarcus Cousins,26-132,C-F,12/23/16,SAC,@,MIN,W,1,37,13,24,0.542,10,18,0.556,3,6,0.5,3,5,0.6,2,5,7
355,DeMarcus Cousins,26-175,C-F,2/4/17,SAC,,GSW,W,1,40,13,30,0.433,13,25,0.52,0,5,0,6,6,1,3,12,15
356,Anthony Davis,23-338,F-C,2/12/17,NOP,@,SAC,L,1,40,11,24,0.458,10,22,0.455,1,2,0.5,9,9,1,1,9,10
357,DeMar DeRozan,27-082,G,10/28/16,TOR,,CLE,L,1,38,12,28,0.429,12,27,0.444,0,1,0,8,8,1,2,5,7
358,DeMar DeRozan,27-208,G,3/3/17,TOR,@,WAS,W,1,38,10,17,0.588,7,14,0.5,3,3,1,9,12,0.75,2,11,13
359,Goran Dragic,30-258,G,1/19/17,MIA,,DAL,W,1,38,11,15,0.733,7,11,0.636,4,4,1,6,10,0.6,2,4,6
360,Kevin Durant,28-085,F-G,12/23/16,GSW,@,DET,W,1,32,13,18,0.722,10,14,0.714,3,4,0.75,3,4,0.75,0,8,8
361,Kevin Durant,28-113,F-G,1/20/17,GSW,@,HOU,W,1,34,12,19,0.632,10,12,0.833,2,7,0.286,6,7,0.857,0,4,4
362,Joel Embiid,22-317,C-F,1/27/17,PHI,,HOU,L,1,28,11,20,0.55,7,14,0.5,4,6,0.667,6,6,1,1,6,7
363,Yogi Ferrell,23-270,G,2/3/17,DAL,@,POR,W,1,39,11,17,0.647,2,6,0.333,9,11,0.818,1,2,0.5,0,2,2
364,Danilo Gallinari,28-173,F,1/28/17,DEN,@,PHO,W,1,37,9,14,0.643,6,9,0.667,3,5,0.6,11,11,1,1,7,8
365,Marc Gasol,31-358,C,1/21/17,MEM,,HOU,L,1,37,12,20,0.6,10,15,0.667,2,5,0.4,6,11,0.545,2,3,5
366,Marc Gasol,31-364,C,1/27/17,MEM,@,POR,L,1,40,12,21,0.571,10,16,0.625,2,5,0.4,6,6,1,1,7,8
367,Paul George,26-269,F,1/26/17,IND,@,MIN,W,1,37,12,22,0.545,9,18,0.5,3,4,0.75,5,6,0.833,1,3,4
368,Paul George,26-246,F,1/3/17,IND,@,DET,W,1,36,10,17,0.588,8,14,0.571,2,3,0.667,10,10,1,1,5,6
369,Paul George,26-242,F,12/30/16,IND,,CHI,W,1,37,10,20,0.5,7,10,0.7,3,10,0.3,9,9,1,0,4,4
370,Blake Griffin,27-329,F,2/8/17,LAC,@,NYK,W,1,36,11,23,0.478,9,20,0.45,2,3,0.667,8,11,0.727,3,5,8
371,James Harden,27-122,G,12/26/16,HOU,,PHO,W,1,30,9,18,0.5,7,9,0.778,2,9,0.222,12,15,0.8,1,4,5
372,James Harden,27-073,G,11/7/16,HOU,@,WAS,W,1,40,9,19,0.474,6,12,0.5,3,7,0.429,11,11,1,0,5,5
373,Gordon Hayward,26-255,F-G,12/3/16,UTA,,DEN,W,1,37,9,18,0.5,6,14,0.429,3,4,0.75,11,11,1,0,4,4
374,Gordon Hayward,26-253,F-G,12/1/16,UTA,,MIA,L,1,40,12,22,0.545,9,15,0.6,3,7,0.429,5,6,0.833,1,2,3
375,Kyrie Irving,24-348,G,3/6/17,CLE,,MIA,L,1,40,11,25,0.44,7,16,0.438,4,9,0.444,6,7,0.857,2,5,7
376,Kyrie Irving,24-289,G,1/6/17,CLE,@,BRK,W,1,36,10,26,0.385,7,17,0.412,3,9,0.333,9,9,1,0,3,3
377,Kyrie Irving,24-281,G,12/29/16,CLE,,BOS,W,1,42,12,17,0.706,10,12,0.833,2,5,0.4,6,7,0.857,2,3,5
378,Kyrie Irving,24-223,G,11/1/16,CLE,,HOU,W,1,35,10,19,0.526,6,13,0.462,4,6,0.667,8,8,1,1,1,2
379,LeBron James,32-038,F-G,2/6/17,CLE,@,WAS,W,1,42,12,18,0.667,6,10,0.6,6,8,0.75,2,5,0.4,0,7,7
380,LeBron James,32-036,F-G,2/4/17,CLE,@,NYK,W,1,40,12,20,0.6,8,12,0.667,4,8,0.5,4,5,0.8,0,5,5
381,LeBron James,32-001,F-G,12/31/16,CLE,@,CHO,W,1,36,12,25,0.48,8,17,0.471,4,8,0.5,4,6,0.667,2,4,6
382,Brandon Jennings,27-099,G,12/31/16,NYK,@,HOU,L,1,41,12,22,0.545,9,14,0.643,3,8,0.375,5,7,0.714,1,4,5
383,Tyler Johnson,24-227,G,12/20/16,MIA,,ORL,L,0,38,13,20,0.65,10,15,0.667,3,5,0.6,3,5,0.6,0,5,5
384,Brandon Knight,24-350,G,11/16/16,PHO,@,DEN,L,0,28,12,20,0.6,9,15,0.6,3,5,0.6,5,7,0.714,1,3,4
385,Skal Labissiere,20-362,F,3/15/17,SAC,@,PHO,W,0,30,11,15,0.733,10,14,0.714,1,1,1,9,11,0.818,2,9,11
386,Kawhi Leonard,25-229,F,2/13/17,SAS,@,IND,W,1,39,13,23,0.565,11,20,0.55,2,3,0.667,4,5,0.8,0,6,6
387,Kawhi Leonard,25-226,F,2/10/17,SAS,@,DET,W,1,33,11,22,0.5,8,14,0.571,3,8,0.375,7,9,0.778,0,6,6
388,Kawhi Leonard,25-224,F,2/8/17,SAS,@,PHI,W,1,37,9,18,0.5,6,11,0.545,3,7,0.429,11,11,1,1,5,6
389,Damian Lillard,26-121,G,11/13/16,POR,,DEN,W,1,33,7,18,0.389,4,11,0.364,3,7,0.429,15,15,1,2,6,8
390,Kyle Lowry,30-308,G,1/27/17,TOR,,MIL,W,1,39,9,18,0.5,6,12,0.5,3,6,0.5,11,14,0.786,2,1,3
391,Kyle Lowry,30-313,G,2/1/17,TOR,@,BOS,L,1,38,12,20,0.6,8,9,0.889,4,11,0.364,4,6,0.667,0,2,2
392,C.J. McCollum,25-141,G,2/7/17,POR,@,DAL,W,1,39,13,21,0.619,11,17,0.647,2,4,0.5,4,4,1,2,0,2
393,Paul Millsap,31-326,F,1/1/17,ATL,,SAS,W,1,47,11,23,0.478,8,17,0.471,3,6,0.5,7,10,0.7,3,10,13
394,Otto Porter,23-206,F,12/26/16,WAS,,MIL,W,1,41,13,18,0.722,8,9,0.889,5,9,0.556,1,2,0.5,0,13,13
395,Julius Randle,22-106,F,3/15/17,LAL,@,HOU,L,1,29,13,17,0.765,13,16,0.813,0,1,0,6,9,0.667,3,5,8
396,D'Angelo Russell,20-266,G,11/15/16,LAL,,BRK,W,1,31,11,20,0.55,4,7,0.571,7,13,0.538,3,4,0.75,1,7,8
397,Isaiah Thomas,28-027,G,3/6/17,BOS,@,LAC,L,1,35,10,19,0.526,6,11,0.545,4,8,0.5,8,9,0.889,0,2,2
398,Karl-Anthony Towns,20-354,F-C,11/3/16,MIN,,DEN,L,1,38,11,19,0.579,9,15,0.6,2,4,0.5,8,10,0.8,5,9,14
399,Karl-Anthony Towns,21-068,F-C,1/22/17,MIN,,DEN,W,1,40,13,19,0.684,13,19,0.684,0,0,,6,8,0.75,2,10,12
400,Jonas Valanciunas,24-173,C,10/26/16,TOR,,DET,W,1,35,10,15,0.667,10,15,0.667,0,0,,12,14,0.857,6,5,11
401,Kemba Walker,26-242,G,1/5/17,CHO,@,DET,L,1,36,12,24,0.5,8,15,0.533,4,9,0.444,4,5,0.8,1,6,7
402,Kemba Walker,26-257,G,1/20/17,CHO,,TOR,W,1,29,11,16,0.688,5,7,0.714,6,9,0.667,4,5,0.8,1,3,4
403,Russell Westbrook,27-349,G,10/26/16,OKC,@,PHI,W,1,36,11,21,0.524,10,19,0.526,1,2,0.5,9,11,0.818,1,11,12
404,Russell Westbrook,28-023,G,12/5/16,OKC,@,ATL,W,1,34,10,22,0.455,7,14,0.5,3,8,0.375,9,14,0.643,1,12,13
405,Russell Westbrook,28-056,G,1/7/17,OKC,,DEN,W,1,35,10,20,0.5,3,8,0.375,7,12,0.583,5,6,0.833,2,15,17
406,Hassan Whiteside,27-161,C,11/21/16,MIA,@,PHI,L,1,33,13,19,0.684,13,19,0.684,0,0,,6,8,0.75,7,6,13
407,Hassan Whiteside,27-190,C,12/20/16,MIA,,ORL,L,1,47,14,22,0.636,14,22,0.636,0,0,,4,6,0.667,4,11,15
408,Nick Young,31-199,G-F,12/17/16,LAL,@,CLE,L,1,38,12,19,0.632,4,5,0.8,8,14,0.571,0,0,,0,2,2
409,Ryan Anderson,28-231,F,12/23/16,HOU,@,MEM,L,1,35,10,18,0.556,2,4,0.5,8,14,0.571,3,3,1,1,6,7
410,Giannis Antetokounmpo,22-048,F-G,1/23/17,MIL,,HOU,W,1,36,11,17,0.647,9,14,0.643,2,3,0.667,7,8,0.875,3,4,7
411,Giannis Antetokounmpo,21-325,F-G,10/26/16,MIL,,CHO,L,1,39,13,21,0.619,12,19,0.632,1,2,0.5,4,6,0.667,1,8,9
412,Carmelo Anthony,32-175,F,11/20/16,NYK,,ATL,W,1,38,12,22,0.545,8,14,0.571,4,8,0.5,3,3,1,2,5,7
413,Carmelo Anthony,32-237,F,1/21/17,NYK,,PHO,L,1,41,9,17,0.529,4,11,0.364,5,6,0.833,8,10,0.8,1,6,7
414,Carmelo Anthony,32-167,F,11/12/16,NYK,@,TOR,L,1,38,10,21,0.476,7,14,0.5,3,7,0.429,8,9,0.889,0,6,6
415,Harrison Barnes,24-162,F,11/8/16,DAL,@,LAL,W,1,40,11,18,0.611,10,15,0.667,1,3,0.333,8,9,0.889,0,2,2
416,Harrison Barnes,24-241,F,1/26/17,DAL,@,OKC,L,1,39,13,26,0.5,11,24,0.458,2,2,1,3,3,1,0,2,2
417,Harrison Barnes,24-255,F,2/9/17,DAL,,UTA,W,1,43,12,20,0.6,10,17,0.588,2,3,0.667,5,7,0.714,0,4,4
418,Harrison Barnes,24-151,F,10/28/16,DAL,,HOU,L,1,39,13,23,0.565,11,19,0.579,2,4,0.5,3,3,1,1,4,5
419,Will Barton,26-031,G,2/6/17,DEN,,DAL,W,1,37,12,18,0.667,7,11,0.636,5,7,0.714,2,2,1,1,7,8
420,Nicolas Batum,28-074,F-G,2/26/17,CHO,@,LAC,L,1,43,9,18,0.5,1,5,0.2,8,13,0.615,5,5,1,0,8,8
421,Bradley Beal,23-155,G,11/30/16,WAS,@,OKC,L,1,42,10,21,0.476,6,11,0.545,4,10,0.4,7,10,0.7,1,4,5
422,Bradley Beal,23-153,G,11/28/16,WAS,,SAC,W,1,41,12,24,0.5,5,11,0.455,7,13,0.538,0,2,0,1,5,6
423,Bradley Beal,23-210,G,1/24/17,WAS,,BOS,W,1,35,12,18,0.667,10,13,0.769,2,5,0.4,5,5,1,0,2,2
424,Bradley Beal,23-225,G,2/8/17,WAS,@,BRK,W,1,41,12,25,0.48,9,19,0.474,3,6,0.5,4,4,1,2,4,6
425,Eric Bledsoe,27-038,G,1/16/17,PHO,,UTA,L,1,37,11,20,0.55,9,14,0.643,2,6,0.333,7,7,1,2,7,9
426,Eric Bledsoe,27-004,G,12/13/16,PHO,,NYK,W,1,39,9,21,0.429,8,17,0.471,1,4,0.25,12,12,1,2,4,6
427,Eric Bledsoe,26-335,G,11/8/16,PHO,@,POR,L,1,31,9,13,0.692,7,10,0.7,2,3,0.667,11,12,0.917,0,4,4
428,Eric Bledsoe,27-030,G,1/8/17,PHO,,CLE,L,1,39,12,18,0.667,8,10,0.8,4,8,0.5,3,3,1,0,2,2
429,Devin Booker,20-048,G,12/17/16,PHO,@,OKC,L,1,33,11,22,0.5,8,17,0.471,3,5,0.6,6,7,0.857,1,2,3
430,Devin Booker,20-097,G,2/4/17,PHO,,MIL,L,1,38,9,19,0.474,4,11,0.364,5,8,0.625,8,8,1,1,2,3
431,Avery Bradley,25-338,G,10/29/16,BOS,@,CHO,W,1,36,11,19,0.579,3,8,0.375,8,11,0.727,1,2,0.5,1,10,11
432,Jimmy Butler,27-087,G-F,12/10/16,CHI,,MIA,W,1,38,8,15,0.533,8,15,0.533,0,0,,15,16,0.938,1,6,7
433,Mike Conley,29-138,G,2/26/17,MEM,@,DEN,W,1,35,9,16,0.563,4,7,0.571,5,9,0.556,8,11,0.727,0,4,4
434,Mike Conley,29-041,G,11/21/16,MEM,@,CHO,W,1,37,11,21,0.524,6,13,0.462,5,8,0.625,4,4,1,0,4,4
435,DeMarcus Cousins,26-197,C-F,2/26/17,NOP,@,OKC,L,1,21,8,15,0.533,8,12,0.667,0,3,0,15,15,1,2,8,10
436,DeMarcus Cousins,26-143,C-F,1/3/17,SAC,@,DEN,W,1,34,10,25,0.4,7,18,0.389,3,7,0.429,8,8,1,0,6,6
437,DeMarcus Cousins,26-121,C-F,12/12/16,SAC,,LAL,W,1,35,12,22,0.545,10,19,0.526,2,3,0.667,5,7,0.714,2,15,17
438,DeMarcus Cousins,26-155,C-F,1/15/17,SAC,,OKC,L,1,34,8,20,0.4,7,14,0.5,1,6,0.167,14,17,0.824,6,5,11
439,Seth Curry,26-185,G,2/24/17,DAL,@,MIN,L,1,37,13,17,0.765,10,11,0.909,3,6,0.5,2,2,1,0,1,1
440,Stephen Curry,28-264,G,12/3/16,GSW,,PHO,W,1,30,10,15,0.667,5,8,0.625,5,7,0.714,6,6,1,0,2,2
441,Stephen Curry,28-254,G,11/23/16,GSW,,LAL,W,1,29,11,18,0.611,4,6,0.667,7,12,0.583,2,2,1,0,5,5
442,Stephen Curry,28-356,G,3/5/17,GSW,@,NYK,W,1,37,11,24,0.458,6,11,0.545,5,13,0.385,4,6,0.667,2,6,8
443,Troy Daniels,25-141,G,12/3/16,MEM,,LAL,W,0,34,12,23,0.522,6,11,0.545,6,12,0.5,1,3,0.333,1,1,2
444,Anthony Davis,23-327,F-C,2/1/17,NOP,@,DET,L,1,41,13,24,0.542,13,23,0.565,0,1,0,5,6,0.833,2,10,12
445,Anthony Davis,23-284,F-C,12/20/16,NOP,@,PHI,W,1,35,12,30,0.4,12,29,0.414,0,1,0,7,10,0.7,5,11,16
446,Anthony Davis,23-359,F-C,3/5/17,NOP,@,LAL,W,1,36,10,22,0.455,10,21,0.476,0,1,0,11,17,0.647,2,7,9
447,Anthony Davis,23-259,F-C,11/25/16,NOP,@,POR,L,1,43,10,17,0.588,8,13,0.615,2,4,0.5,9,13,0.692,0,13,13
448,DeMar DeRozan,27-183,G,2/6/17,TOR,,LAC,W,1,38,11,22,0.5,9,19,0.474,2,3,0.667,7,9,0.778,2,3,5
449,DeMar DeRozan,27-120,G,12/5/16,TOR,,CLE,L,1,39,12,23,0.522,12,21,0.571,0,2,0,7,7,1,0,4,4
450,DeMar DeRozan,27-133,G,12/18/16,TOR,@,ORL,W,1,30,13,21,0.619,12,18,0.667,1,3,0.333,4,4,1,0,5,5
451,DeMar DeRozan,27-129,G,12/14/16,TOR,@,PHI,W,1,30,11,18,0.611,11,17,0.647,0,1,0,9,11,0.818,2,3,5
452,DeMar DeRozan,27-147,G,1/1/17,TOR,@,LAL,W,1,35,10,25,0.4,10,25,0.4,0,0,,11,13,0.846,0,1,1
453,Goran Dragic,30-226,G,12/18/16,MIA,,BOS,L,1,37,12,21,0.571,7,15,0.467,5,6,0.833,2,4,0.5,0,4,4
454,Marc Gasol,32-005,C,2/3/17,MEM,@,OKC,L,1,42,14,24,0.583,14,20,0.7,0,4,0,3,3,1,0,4,4
455,Paul George,26-284,F,2/10/17,IND,@,WAS,L,1,36,12,23,0.522,10,17,0.588,2,6,0.333,5,7,0.714,1,3,4
456,Paul George,26-266,F,1/23/17,IND,,NYK,L,1,39,11,24,0.458,8,14,0.571,3,10,0.3,6,7,0.857,1,6,7
457,Eric Gordon,28-008,G,1/2/17,HOU,,WAS,W,0,36,11,18,0.611,5,6,0.833,6,12,0.5,3,4,0.75,0,2,2
458,Blake Griffin,27-323,F,2/2/17,LAC,,GSW,L,1,30,10,19,0.526,10,19,0.526,0,0,,11,13,0.846,5,3,8
459,James Harden,27-085,G,11/19/16,HOU,,UTA,W,1,35,10,24,0.417,6,14,0.429,4,10,0.4,7,9,0.778,0,4,4
460,James Harden,27-116,G,12/20/16,HOU,,SAS,L,1,37,10,26,0.385,9,15,0.6,1,11,0.091,10,10,1,2,8,10
461,Gordon Hayward,26-279,F-G,12/27/16,UTA,@,LAL,W,1,34,10,17,0.588,7,11,0.636,3,6,0.5,8,9,0.889,3,6,9
462,Gordon Hayward,26-325,F-G,2/11/17,UTA,,BOS,L,1,38,10,19,0.526,6,10,0.6,4,9,0.444,7,7,1,0,1,1
463,Gordon Hayward,26-251,F-G,11/29/16,UTA,,HOU,W,1,36,8,16,0.5,5,10,0.5,3,6,0.5,12,13,0.923,0,5,5
464,Dwight Howard,30-330,C,11/2/16,ATL,,LAL,L,1,32,12,16,0.75,12,16,0.75,0,0,,7,10,0.7,3,8,11
465,Serge Ibaka,27-056,F-C,11/13/16,ORL,@,OKC,W,1,37,13,19,0.684,11,17,0.647,2,2,1,3,3,1,3,6,9
466,Ersan Ilyasova,29-259,F,1/29/17,PHI,@,CHI,L,1,35,11,19,0.579,9,12,0.75,2,7,0.286,7,9,0.778,5,6,11
467,Kyrie Irving,24-273,G,12/21/16,CLE,,MIL,W,1,35,11,17,0.647,10,15,0.667,1,2,0.5,8,9,0.889,0,6,6
468,Reggie Jackson,26-267,G,1/8/17,DET,@,POR,W,1,47,13,26,0.5,11,20,0.55,2,6,0.333,3,4,0.75,1,0,1
469,LeBron James,31-361,F-G,12/25/16,CLE,,GSW,W,1,40,12,22,0.545,8,14,0.571,4,8,0.5,3,7,0.429,5,8,13
470,LeBron James,32-028,F-G,1/27/17,CLE,,BRK,W,1,34,13,18,0.722,12,15,0.8,1,3,0.333,4,7,0.571,0,5,5
471,LeBron James,32-005,F-G,1/4/17,CLE,,CHI,L,1,37,12,21,0.571,11,19,0.579,1,2,0.5,6,9,0.667,2,6,8
472,LeBron James,32-047,F-G,2/15/17,CLE,,IND,W,1,33,12,17,0.706,8,12,0.667,4,5,0.8,3,4,0.75,0,5,5
473,LeBron James,31-329,F-G,11/23/16,CLE,,POR,W,1,38,11,21,0.524,9,18,0.5,2,3,0.667,7,8,0.875,1,9,10
474,Nikola Jokic,22-013,C-F,3/4/17,DEN,,CHO,L,1,33,13,15,0.867,13,15,0.867,0,0,,5,8,0.625,3,11,14
475,Zach LaVine,21-236,G,11/1/16,MIN,,MEM,W,1,29,11,18,0.611,6,9,0.667,5,9,0.556,4,4,1,0,4,4
476,Zach LaVine,21-261,G,11/26/16,MIN,@,GSW,L,1,39,13,24,0.542,8,12,0.667,5,12,0.417,0,0,,0,3,3
477,Kawhi Leonard,25-257,F,3/13/17,SAS,,ATL,W,1,39,10,24,0.417,7,16,0.438,3,8,0.375,8,10,0.8,0,5,5
478,Kawhi Leonard,25-247,F,3/3/17,SAS,@,NOP,W,1,40,11,26,0.423,10,21,0.476,1,5,0.2,8,10,0.8,1,6,7
479,Kawhi Leonard,25-245,F,3/1/17,SAS,,IND,W,1,34,11,22,0.5,8,13,0.615,3,9,0.333,6,6,1,2,9,11
480,Kawhi Leonard,25-160,F,12/6/16,SAS,@,MIN,W,1,36,11,15,0.733,9,12,0.75,2,3,0.667,7,8,0.875,0,1,1
481,Kawhi Leonard,25-197,F,1/12/17,SAS,,LAL,W,1,26,10,13,0.769,7,8,0.875,3,5,0.6,8,9,0.889,0,2,2
482,Damian Lillard,26-249,G,3/21/17,POR,,MIL,L,1,40,13,26,0.5,11,17,0.647,2,9,0.222,3,6,0.5,1,4,5
483,Damian Lillard,26-109,G,11/1/16,POR,,GSW,L,1,32,8,19,0.421,4,9,0.444,4,10,0.4,11,13,0.846,0,1,1
484,C.J. McCollum,25-166,G,3/4/17,POR,,BRK,W,1,38,13,22,0.591,9,17,0.529,4,5,0.8,1,1,1,0,5,5
485,C.J. McCollum,25-053,G,11/11/16,POR,,SAC,W,1,39,13,24,0.542,11,16,0.688,2,8,0.25,3,4,0.75,0,1,1
486,Doug McDermott,25-012,F,1/15/17,CHI,@,MEM,W,0,33,9,16,0.563,6,10,0.6,3,6,0.5,10,11,0.909,0,6,6
487,Jabari Parker,21-288,F,12/28/16,MIL,@,DET,W,1,34,13,18,0.722,9,11,0.818,4,7,0.571,1,1,1,0,9,9
488,Kristaps Porzingis,21-112,F-C,11/22/16,NYK,,POR,W,1,40,13,23,0.565,10,15,0.667,3,8,0.375,2,2,1,3,6,9
489,Dennis Schroder,23-174,G,3/8/17,ATL,,BRK,W,1,36,10,21,0.476,9,17,0.529,1,4,0.25,10,10,1,0,2,2
490,Dennis Schroder,23-095,G,12/19/16,ATL,@,OKC,W,1,40,10,16,0.625,9,13,0.692,1,3,0.333,10,10,1,2,3,5
491,Dennis Schroder,23-076,G,11/30/16,ATL,@,PHO,L,1,36,13,23,0.565,11,17,0.647,2,6,0.333,3,3,1,1,3,4
492,Jeff Teague,28-195,G,12/22/16,IND,,BOS,L,1,35,9,15,0.6,7,11,0.636,2,4,0.5,11,11,1,1,3,4
493,Isaiah Thomas,28-022,G,3/1/17,BOS,,CLE,W,1,35,10,20,0.5,7,11,0.636,3,9,0.333,8,12,0.667,1,1,2
494,Isaiah Thomas,27-326,G,12/29/16,BOS,@,CLE,L,1,34,8,13,0.615,6,8,0.75,2,5,0.4,13,13,1,1,2,3
495,Karl-Anthony Towns,21-122,F-C,3/17/17,MIN,@,MIA,L,1,38,11,17,0.647,10,14,0.714,1,3,0.333,8,8,1,6,5,11
496,Dwyane Wade,35-020,G,2/6/17,CHI,@,SAC,W,1,30,12,18,0.667,12,18,0.667,0,0,,7,10,0.7,0,6,6
497,Kemba Walker,26-264,G,1/27/17,CHO,@,NYK,L,1,37,13,29,0.448,11,18,0.611,2,11,0.182,3,4,0.75,2,8,10
498,Russell Westbrook,28-011,G,11/23/16,OKC,@,SAC,L,1,35,7,18,0.389,6,13,0.462,1,5,0.2,16,19,0.842,1,10,11
499,Russell Westbrook,28-043,G,12/25/16,OKC,,MIN,W,1,33,11,25,0.44,10,21,0.476,1,4,0.25,8,9,0.889,3,4,7
500,Russell Westbrook,28-008,G,11/20/16,OKC,,IND,L,1,40,13,34,0.382,11,26,0.423,2,8,0.25,3,5,0.6,5,6,11
501,Andrew Wiggins,21-336,F-G,1/24/17,MIN,@,PHO,W,1,39,11,22,0.5,9,18,0.5,2,4,0.5,7,8,0.875,2,4,6
502,Andrew Wiggins,21-351,F-G,2/8/17,MIN,,TOR,W,1,38,11,19,0.579,10,17,0.588,1,2,0.5,8,9,0.889,2,3,5
503,Andrew Wiggins,21-311,F-G,12/30/16,MIN,,MIL,W,1,39,10,18,0.556,10,15,0.667,0,3,0,11,13,0.846,1,4,5
504,Lou Williams,30-090,G,1/25/17,LAL,@,POR,L,0,28,10,20,0.5,4,9,0.444,6,11,0.545,5,5,1,0,4,4
505,Giannis Antetokounmpo,21-349,F-G,11/19/16,MIL,,GSW,L,1,41,10,23,0.435,9,20,0.45,1,3,0.333,9,11,0.818,0,4,4
506,Giannis Antetokounmpo,22-060,F-G,2/4/17,MIL,@,PHO,W,1,34,12,20,0.6,12,17,0.706,0,3,0,6,9,0.667,2,10,12
507,Giannis Antetokounmpo,22-009,F-G,12/15/16,MIL,,CHI,W,1,39,13,27,0.481,11,23,0.478,2,4,0.5,2,2,1,3,11,14
508,Giannis Antetokounmpo,22-006,F-G,12/12/16,MIL,@,TOR,L,1,39,13,23,0.565,13,20,0.65,0,3,0,4,6,0.667,5,4,9
509,Carmelo Anthony,32-241,F,1/25/17,NYK,@,DAL,L,1,39,13,24,0.542,10,17,0.588,3,7,0.429,1,2,0.5,1,7,8
510,Carmelo Anthony,32-220,F,1/4/17,NYK,,MIL,L,1,37,10,23,0.435,6,13,0.462,4,10,0.4,6,8,0.75,1,10,11
511,Carmelo Anthony,32-232,F,1/16/17,NYK,,ATL,L,1,35,10,16,0.625,8,12,0.667,2,4,0.5,8,11,0.727,2,5,7
512,Carmelo Anthony,32-262,F,2/15/17,NYK,@,OKC,L,1,39,11,20,0.55,5,13,0.385,6,7,0.857,2,2,1,0,4,4
513,Harrison Barnes,24-224,F,1/9/17,DAL,@,MIN,L,1,34,13,23,0.565,9,18,0.5,4,5,0.8,0,0,,0,2,2
514,Eric Bledsoe,27-088,G,3/7/17,PHO,,WAS,L,1,27,9,18,0.5,5,9,0.556,4,9,0.444,8,8,1,0,3,3
515,Eric Bledsoe,27-000,G,12/9/16,PHO,@,LAL,W,1,33,10,18,0.556,7,13,0.538,3,5,0.6,7,8,0.875,0,4,4
516,Devin Booker,20-022,G,11/21/16,PHO,@,WAS,L,1,37,12,26,0.462,6,17,0.353,6,9,0.667,0,0,,1,1,2
517,Devin Booker,20-028,G,11/27/16,PHO,,DEN,L,1,36,11,27,0.407,7,17,0.412,4,10,0.4,4,5,0.8,0,3,3
518,Jordan Clarkson,24-278,G,3/12/17,LAL,,PHI,L,0,34,10,16,0.625,10,14,0.714,0,2,0,10,11,0.909,2,4,6
519,Mike Conley,29-143,G,3/3/17,MEM,@,DAL,L,1,36,9,15,0.6,6,9,0.667,3,6,0.5,9,10,0.9,0,2,2
520,Mike Conley,29-036,G,11/16/16,MEM,@,LAC,W,1,38,9,12,0.75,2,3,0.667,7,9,0.778,5,6,0.833,0,5,5
521,Mike Conley,29-024,G,11/4/16,MEM,,LAC,L,1,37,9,20,0.45,2,9,0.222,7,11,0.636,5,7,0.714,0,2,2
522,DeMarcus Cousins,26-135,C-F,12/26/16,SAC,,PHI,W,1,34,10,20,0.5,8,16,0.5,2,4,0.5,8,9,0.889,2,5,7
523,DeMarcus Cousins,26-080,C-F,11/1/16,SAC,@,MIA,L,1,35,8,16,0.5,8,16,0.5,0,0,,14,18,0.778,1,6,7
524,Allen Crabbe,24-274,G-F,1/8/17,POR,,DET,L,0,43,12,15,0.8,7,10,0.7,5,5,1,1,1,1,0,1,1
525,Stephen Curry,28-274,G,12/13/16,GSW,@,NOP,W,1,34,11,23,0.478,6,14,0.429,5,9,0.556,3,4,0.75,2,2,4
526,Stephen Curry,28-244,G,11/13/16,GSW,,PHO,W,1,37,9,17,0.529,4,8,0.5,5,9,0.556,7,7,1,0,6,6
527,Stephen Curry,28-300,G,1/8/17,GSW,@,SAC,W,1,37,11,22,0.5,6,11,0.545,5,11,0.455,3,3,1,2,2,4
528,Anthony Davis,23-244,F-C,11/10/16,NOP,@,MIL,W,1,41,11,24,0.458,11,24,0.458,0,0,,8,8,1,3,5,8
529,Sam Dekker,22-260,F,1/21/17,HOU,@,MEM,W,1,35,12,19,0.632,6,8,0.75,6,11,0.545,0,0,,0,5,5
530,DeMar DeRozan,27-103,G,11/18/16,TOR,@,DEN,W,1,36,12,25,0.48,12,24,0.5,0,1,0,6,10,0.6,0,5,5
531,DeMar DeRozan,27-127,G,12/12/16,TOR,,MIL,W,1,32,7,11,0.636,6,10,0.6,1,1,1,15,15,1,1,2,3
532,DeMar DeRozan,27-185,G,2/8/17,TOR,@,MIN,L,1,38,12,25,0.48,11,21,0.524,1,4,0.25,5,7,0.714,1,3,4
533,Goran Dragic,30-281,G,2/11/17,MIA,@,PHI,L,1,37,12,21,0.571,10,17,0.588,2,4,0.5,4,4,1,0,5,5
534,Kevin Durant,28-029,F-G,10/28/16,GSW,@,NOP,W,1,39,9,19,0.474,9,16,0.563,0,3,0,12,12,1,0,17,17
535,Kevin Durant,28-097,F-G,1/4/17,GSW,,POR,W,1,38,9,16,0.563,6,8,0.75,3,8,0.375,9,9,1,0,5,5
536,Kevin Durant,28-048,F-G,11/16/16,GSW,@,TOR,W,1,36,11,21,0.524,8,13,0.615,3,8,0.375,5,6,0.833,2,7,9
537,Rudy Gay,30-076,F,11/1/16,SAC,@,MIA,L,1,42,11,24,0.458,9,20,0.45,2,4,0.5,6,6,1,0,12,12
538,Paul George,26-183,F,11/1/16,IND,,LAL,W,1,37,8,16,0.5,6,11,0.545,2,5,0.4,12,12,1,2,5,7
539,Aaron Gordon,21-101,F,12/26/16,ORL,,MEM,W,1,34,11,14,0.786,7,10,0.7,4,4,1,4,5,0.8,1,1,2
540,Blake Griffin,28-004,F,3/20/17,LAC,,NYK,W,1,31,12,19,0.632,9,15,0.6,3,4,0.75,3,7,0.429,3,3,6
541,James Harden,27-068,G,11/2/16,HOU,@,NYK,W,1,34,9,16,0.563,4,4,1,5,12,0.417,7,8,0.875,1,5,6
542,James Harden,27-126,G,12/30/16,HOU,,LAC,W,1,34,10,15,0.667,8,10,0.8,2,5,0.4,8,9,0.889,1,12,13
543,James Harden,27-152,G,1/25/17,HOU,@,BOS,L,1,37,6,18,0.333,4,7,0.571,2,11,0.182,16,19,0.842,0,6,6
544,James Harden,27-167,G,2/9/17,HOU,@,CHO,W,1,39,8,21,0.381,4,12,0.333,4,9,0.444,10,12,0.833,1,10,11
545,James Harden,27-071,G,11/5/16,HOU,@,ATL,L,1,37,10,19,0.526,6,11,0.545,4,8,0.5,6,7,0.857,1,8,9
546,Gordon Hayward,26-320,F-G,2/6/17,UTA,@,ATL,W,1,30,12,18,0.667,10,13,0.769,2,5,0.4,4,5,0.8,2,5,7
547,Gordon Hayward,26-340,F-G,2/26/17,UTA,@,WAS,W,1,40,11,22,0.5,7,16,0.438,4,6,0.667,4,8,0.5,2,7,9
548,Gordon Hayward,26-285,F-G,1/2/17,UTA,@,BRK,W,1,35,9,18,0.5,6,14,0.429,3,4,0.75,9,9,1,0,4,4
549,George Hill,30-262,G,1/21/17,UTA,,IND,W,1,34,9,16,0.563,6,11,0.545,3,5,0.6,9,11,0.818,1,5,6
550,Solomon Hill,25-364,F,3/17/17,NOP,,HOU,W,1,38,8,13,0.615,2,4,0.5,6,9,0.667,8,9,0.889,1,5,6
551,Jrue Holiday,26-239,G,2/6/17,NOP,,PHO,W,1,37,11,22,0.5,8,15,0.533,3,7,0.429,5,6,0.833,2,8,10
552,Jrue Holiday,26-233,G,1/31/17,NOP,@,TOR,L,1,41,13,21,0.619,10,16,0.625,3,5,0.6,1,2,0.5,1,1,2
553,LeBron James,32-066,F-G,3/6/17,CLE,,MIA,L,1,39,11,22,0.5,9,17,0.529,2,5,0.4,6,10,0.6,3,14,17
554,LeBron James,31-309,F-G,11/3/16,CLE,,BOS,W,1,36,12,22,0.545,11,18,0.611,1,4,0.25,5,5,1,1,6,7
555,LeBron James,32-072,F-G,3/12/17,CLE,@,HOU,L,1,40,12,20,0.6,8,9,0.889,4,11,0.364,2,3,0.667,0,7,7
556,Nikola Jokic,21-332,C-F,1/16/17,DEN,,ORL,W,1,36,13,19,0.684,12,17,0.706,1,2,0.5,3,5,0.6,3,8,11
557,Kawhi Leonard,25-120,F,10/27/16,SAS,@,SAC,W,1,35,11,21,0.524,10,16,0.625,1,5,0.2,7,7,1,0,3,3
558,Kawhi Leonard,25-164,F,12/10/16,SAS,,BRK,W,1,27,10,18,0.556,6,11,0.545,4,7,0.571,6,6,1,1,6,7
559,Kawhi Leonard,25-147,F,11/23/16,SAS,@,CHO,W,1,37,14,21,0.667,12,14,0.857,2,7,0.286,0,1,0,2,3,5
560,Kawhi Leonard,25-125,F,11/1/16,SAS,,UTA,L,1,36,10,18,0.556,5,11,0.455,5,7,0.714,5,5,1,0,7,7
561,Kawhi Leonard,25-195,F,1/10/17,SAS,,MIL,L,1,36,10,16,0.625,8,13,0.615,2,3,0.667,8,10,0.8,2,5,7
562,Damian Lillard,26-189,G,1/20/17,POR,@,PHI,L,1,36,12,25,0.48,10,18,0.556,2,7,0.286,4,5,0.8,2,3,5
563,Damian Lillard,26-145,G,12/7/16,POR,@,MIL,L,1,39,8,18,0.444,3,5,0.6,5,13,0.385,9,9,1,0,7,7
564,Damian Lillard,26-143,G,12/5/16,POR,@,CHI,W,1,34,11,24,0.458,8,18,0.444,3,6,0.5,5,5,1,0,3,3
565,Brook Lopez,28-315,C,2/10/17,BRK,,MIA,L,1,31,10,17,0.588,9,14,0.643,1,3,0.333,9,12,0.75,3,5,8
566,Brook Lopez,28-228,C,11/15/16,BRK,@,LAL,L,1,31,10,25,0.4,6,14,0.429,4,11,0.364,6,7,0.857,3,7,10
567,Kevin Love,28-113,F,12/29/16,CLE,,BOS,W,1,34,10,22,0.455,4,6,0.667,6,16,0.375,4,4,1,3,12,15
568,Kyle Lowry,30-305,G,1/24/17,TOR,,SAS,L,1,42,9,23,0.391,8,16,0.5,1,7,0.143,11,12,0.917,0,5,5
569,Khris Middleton,25-217,F-G,3/17/17,MIL,@,LAL,W,1,33,11,18,0.611,11,16,0.688,0,2,0,8,9,0.889,0,2,2
570,Paul Millsap,31-313,F,12/19/16,ATL,@,OKC,W,1,39,12,18,0.667,9,13,0.692,3,5,0.6,3,3,1,2,9,11
571,Emmanuel Mudiay,20-246,G,11/6/16,DEN,@,BOS,W,1,39,11,18,0.611,8,13,0.615,3,5,0.6,5,5,1,2,6,8
572,Jabari Parker,21-280,F,12/20/16,MIL,,CLE,L,1,46,13,25,0.52,13,23,0.565,0,2,0,4,7,0.571,3,6,9
573,Chris Paul,31-309,G,3/11/17,LAC,,PHI,W,1,34,11,16,0.688,7,12,0.583,4,4,1,4,4,1,0,3,3
574,Derrick Rose,28-055,G,11/28/16,NYK,,OKC,L,1,38,10,20,0.5,10,18,0.556,0,2,0,10,10,1,2,5,7
575,Derrick Rose,28-106,G,1/18/17,NYK,@,BOS,W,1,33,13,24,0.542,13,24,0.542,0,0,,4,4,1,4,6,10
576,Jeff Teague,28-152,G,11/9/16,IND,,PHI,W,1,41,10,16,0.625,9,13,0.692,1,3,0.333,9,10,0.9,0,2,2
577,Jeff Teague,28-163,G,11/20/16,IND,@,OKC,W,1,40,9,16,0.563,6,12,0.5,3,4,0.75,9,9,1,0,5,5
578,Isaiah Thomas,27-283,G,11/16/16,BOS,,DAL,W,1,33,7,18,0.389,4,13,0.308,3,5,0.6,13,16,0.813,2,2,4
579,Isaiah Thomas,27-273,G,11/6/16,BOS,,DEN,L,1,33,9,17,0.529,8,13,0.615,1,4,0.25,11,12,0.917,0,1,1
580,Isaiah Thomas,27-270,G,11/3/16,BOS,@,CLE,L,1,34,8,19,0.421,8,13,0.615,0,6,0,14,14,1,0,3,3
581,Klay Thompson,26-279,G,11/13/16,GSW,,PHO,W,1,33,11,18,0.611,6,10,0.6,5,8,0.625,3,3,1,0,2,2
582,Klay Thompson,26-307,G,12/11/16,GSW,@,MIN,W,1,39,11,21,0.524,7,9,0.778,4,12,0.333,4,4,1,2,4,6
583,Klay Thompson,27-030,G,3/10/17,GSW,@,MIN,L,1,36,12,22,0.545,9,16,0.563,3,6,0.5,3,4,0.75,0,5,5
584,Myles Turner,20-216,F-C,10/26/16,IND,,DAL,W,1,37,13,19,0.684,12,17,0.706,1,2,0.5,3,5,0.6,6,10,16
585,Nikola Vucevic,26-081,C,1/13/17,ORL,@,POR,W,1,32,13,18,0.722,13,18,0.722,0,0,,4,4,1,1,9,10
586,Dwyane Wade,35-004,G,1/21/17,CHI,,SAC,W,1,35,9,20,0.45,9,18,0.5,0,2,0,12,15,0.8,3,3,6
587,Kemba Walker,26-180,G,11/4/16,CHO,@,BRK,W,1,32,11,22,0.5,8,14,0.571,3,8,0.375,5,8,0.625,1,6,7
588,Kemba Walker,26-296,G,2/28/17,CHO,@,LAL,W,1,34,9,18,0.5,4,9,0.444,5,9,0.556,7,7,1,0,5,5
589,Kemba Walker,26-191,G,11/15/16,CHO,@,MIN,W,1,35,12,19,0.632,10,16,0.625,2,3,0.667,4,4,1,0,5,5
590,John Wall,26-183,G,3/8/17,WAS,@,DEN,W,1,35,12,19,0.632,10,13,0.769,2,6,0.333,4,5,0.8,1,2,3
591,John Wall,26-097,G,12/12/16,WAS,@,MIA,L,1,38,12,26,0.462,11,21,0.524,1,5,0.2,5,6,0.833,2,4,6
592,John Wall,26-178,G,3/3/17,WAS,,TOR,L,1,38,9,24,0.375,5,16,0.313,4,8,0.5,8,10,0.8,2,6,8
593,T.J. Warren,23-053,F,10/28/16,PHO,@,OKC,L,1,46,13,18,0.722,12,16,0.75,1,2,0.5,3,4,0.75,1,8,9
594,Russell Westbrook,28-006,G,11/18/16,OKC,,BRK,W,1,34,13,21,0.619,13,20,0.65,0,1,0,4,5,0.8,3,7,10
595,Russell Westbrook,28-004,G,11/16/16,OKC,,HOU,W,1,36,9,20,0.45,7,16,0.438,2,4,0.5,10,11,0.909,1,6,7
596,Russell Westbrook,28-051,G,1/2/17,OKC,@,MIL,L,1,36,9,28,0.321,7,18,0.389,2,10,0.2,10,11,0.909,0,7,7
597,Hassan Whiteside,27-236,C,2/4/17,MIA,,PHI,W,1,27,14,17,0.824,14,17,0.824,0,0,,2,3,0.667,6,14,20
598,Andrew Wiggins,22-002,F-G,2/25/17,MIN,@,HOU,L,1,37,11,22,0.5,10,17,0.588,1,5,0.2,7,8,0.875,2,0,2
599,Lou Williams,30-139,G,3/15/17,HOU,,LAL,W,0,32,11,17,0.647,4,8,0.5,7,9,0.778,1,1,1,0,4,4
600,LaMarcus Aldridge,31-182,F-C,1/17/17,SAS,,MIN,W,1,36,12,20,0.6,12,19,0.632,0,1,0,5,6,0.833,1,3,4
601,Ryan Anderson,28-209,F,12/1/16,HOU,@,GSW,W,1,45,9,17,0.529,4,7,0.571,5,10,0.5,6,7,0.857,2,3,5
602,Giannis Antetokounmpo,21-355,F-G,11/25/16,MIL,,TOR,L,1,35,12,17,0.706,12,16,0.75,0,1,0,5,6,0.833,0,6,6
603,Carmelo Anthony,32-210,F,12/25/16,NYK,,BOS,L,1,39,9,24,0.375,7,17,0.412,2,7,0.286,9,9,1,2,5,7
604,Carmelo Anthony,32-187,F,12/2/16,NYK,,MIN,W,1,34,9,20,0.45,4,10,0.4,5,10,0.5,6,6,1,0,5,5
605,Carmelo Anthony,32-202,F,12/17/16,NYK,@,DEN,L,1,36,10,14,0.714,8,12,0.667,2,2,1,7,8,0.875,1,3,4
606,Harrison Barnes,24-189,F,12/5/16,DAL,,CHO,L,1,38,10,21,0.476,8,17,0.471,2,4,0.5,7,7,1,4,3,7
607,Bradley Beal,23-167,G,12/12/16,WAS,@,MIA,L,1,35,11,20,0.55,9,12,0.75,2,8,0.25,5,5,1,0,2,2
608,Eric Bledsoe,26-348,G,11/21/16,PHO,@,WAS,L,1,40,10,25,0.4,7,16,0.438,3,9,0.333,6,7,0.857,2,7,9
609,Bojan Bogdanovic,27-211,G-F,11/15/16,BRK,@,LAL,L,1,30,11,18,0.611,9,13,0.692,2,5,0.4,5,5,1,0,3,3
610,Bojan Bogdanovic,27-323,G-F,3/7/17,WAS,@,PHO,W,0,29,5,9,0.556,2,3,0.667,3,6,0.5,16,16,1,2,7,9
611,Jimmy Butler,27-155,G-F,2/16/17,CHI,,BOS,W,1,40,9,20,0.45,7,15,0.467,2,5,0.4,9,9,1,2,2,4
612,Willie Cauley-Stein,23-189,F-C,2/23/17,SAC,,DEN,W,0,35,14,22,0.636,14,22,0.636,0,0,,1,1,1,3,7,10
613,Mike Conley,29-140,G,2/28/17,MEM,,PHO,W,1,39,10,19,0.526,7,13,0.538,3,6,0.5,6,8,0.75,1,2,3
614,DeMarcus Cousins,26-077,C-F,10/29/16,SAC,,MIN,W,1,33,9,16,0.563,9,14,0.643,0,2,0,11,14,0.786,5,2,7
615,Seth Curry,26-188,G,2/27/17,DAL,,MIA,W,1,36,10,17,0.588,5,10,0.5,5,7,0.714,4,4,1,0,1,1
616,Stephen Curry,28-325,G,2/2/17,GSW,@,LAC,W,1,37,11,23,0.478,8,13,0.615,3,10,0.3,4,4,1,1,2,3
617,Stephen Curry,29-000,G,3/14/17,GSW,,PHI,W,1,37,8,23,0.348,3,10,0.3,5,13,0.385,8,8,1,2,4,6
618,Troy Daniels,25-143,G,12/5/16,MEM,@,NOP,W,0,44,10,20,0.5,3,9,0.333,7,11,0.636,2,2,1,0,0,0
619,Anthony Davis,23-349,F-C,2/23/17,NOP,,HOU,L,1,33,8,21,0.381,8,19,0.421,0,2,0,13,16,0.813,3,6,9
620,Anthony Davis,23-357,F-C,3/3/17,NOP,,SAS,L,1,42,7,18,0.389,6,15,0.4,1,3,0.333,14,16,0.875,1,7,8
621,DeMar DeRozan,27-143,G,12/28/16,TOR,@,GSW,L,1,39,10,23,0.435,10,22,0.455,0,1,0,9,10,0.9,1,4,5
622,Goran Dragic,30-214,G,12/6/16,MIA,,NYK,L,1,40,11,17,0.647,7,13,0.538,4,4,1,3,4,0.75,1,3,4
623,Kevin Durant,28-045,F-G,11/13/16,GSW,,PHO,W,1,38,10,21,0.476,8,16,0.5,2,5,0.4,7,7,1,0,9,9
624,Kevin Durant,28-057,F-G,11/25/16,GSW,@,LAL,W,1,33,11,19,0.579,8,13,0.615,3,6,0.5,4,6,0.667,1,5,6
625,Tyreke Evans,27-115,G-F,1/12/17,NOP,@,BRK,W,0,28,10,15,0.667,8,11,0.727,2,4,0.5,7,7,1,0,4,4
626,Evan Fournier,24-005,G-F,11/3/16,ORL,,SAC,W,1,36,10,15,0.667,7,8,0.875,3,7,0.429,6,7,0.857,0,1,1
627,Rudy Gay,30-086,F,11/11/16,SAC,@,POR,L,1,43,9,18,0.5,7,14,0.5,2,4,0.5,9,10,0.9,4,10,14
628,Eric Gordon,27-357,G,12/16/16,HOU,,NOP,W,0,28,10,17,0.588,3,5,0.6,7,12,0.583,2,2,1,0,1,1
629,JaMychal Green,26-228,F,2/4/17,MEM,@,MIN,W,1,30,8,11,0.727,7,9,0.778,1,2,0.5,12,12,1,2,5,7
630,Blake Griffin,27-345,F,2/24/17,LAC,,SAS,L,1,38,9,17,0.529,9,15,0.6,0,2,0,11,11,1,2,7,9
631,Blake Griffin,27-247,F,11/18/16,LAC,@,SAC,W,1,37,7,15,0.467,7,14,0.5,0,1,0,15,16,0.938,2,5,7
632,Blake Griffin,27-322,F,2/1/17,LAC,@,PHO,W,1,34,10,14,0.714,10,14,0.714,0,0,,9,10,0.9,1,7,8
633,Tim Hardaway,24-291,G,1/1/17,ATL,,SAS,W,0,31,11,13,0.846,5,6,0.833,6,7,0.857,1,2,0.5,1,4,5
634,James Harden,27-112,G,12/16/16,HOU,,NOP,W,1,34,7,15,0.467,1,3,0.333,6,12,0.5,9,11,0.818,2,9,11
635,James Harden,27-097,G,12/1/16,HOU,@,GSW,W,1,46,8,23,0.348,6,12,0.5,2,11,0.182,11,14,0.786,1,14,15
636,James Harden,27-148,G,1/21/17,HOU,@,MEM,W,1,34,7,9,0.778,3,3,1,4,6,0.667,11,12,0.917,1,5,6
637,James Harden,27-089,G,11/23/16,HOU,,TOR,L,1,41,7,13,0.538,4,5,0.8,3,8,0.375,12,12,1,0,6,6
638,Montrezl Harrell,22-339,F-C,12/30/16,HOU,,LAC,W,0,30,10,14,0.714,10,14,0.714,0,0,,9,11,0.818,2,0,2
639,Gordon Hayward,26-338,F-G,2/24/17,UTA,@,MIL,W,1,34,11,17,0.647,10,13,0.769,1,4,0.25,6,7,0.857,1,2,3
640,Gordon Hayward,26-231,F-G,11/9/16,UTA,@,CHO,L,1,36,10,19,0.526,7,11,0.636,3,8,0.375,6,6,1,0,7,7
641,Serge Ibaka,27-086,F-C,12/13/16,ORL,@,ATL,W,1,32,11,18,0.611,7,10,0.7,4,8,0.5,3,3,1,0,3,3
642,Kyrie Irving,24-312,G,1/29/17,CLE,,OKC,W,1,35,12,22,0.545,10,16,0.625,2,6,0.333,3,3,1,0,3,3
643,Kyrie Irving,24-216,G,10/25/16,CLE,,NYK,W,1,30,12,22,0.545,8,15,0.533,4,7,0.571,1,1,1,1,1,2
644,Kyrie Irving,24-233,G,11/11/16,CLE,@,WAS,W,1,36,11,23,0.478,7,14,0.5,4,9,0.444,3,4,0.75,0,2,2
645,Kyrie Irving,24-230,G,11/8/16,CLE,,ATL,L,1,39,11,27,0.407,10,20,0.5,1,7,0.143,6,7,0.857,0,1,1
646,Kyrie Irving,24-304,G,1/21/17,CLE,,SAS,L,1,41,13,22,0.591,10,14,0.714,3,8,0.375,0,1,0,1,2,3
647,Kyrie Irving,24-322,G,2/8/17,CLE,@,IND,W,1,34,12,22,0.545,12,17,0.706,0,5,0,5,5,1,0,0,0
648,LeBron James,32-069,F-G,3/9/17,CLE,@,DET,L,1,39,12,22,0.545,12,16,0.75,0,6,0,5,8,0.625,4,10,14
649,LeBron James,32-011,F-G,1/10/17,CLE,@,UTA,L,1,37,10,20,0.5,7,14,0.5,3,6,0.5,6,7,0.857,1,5,6
650,LeBron James,31-357,F-G,12/21/16,CLE,,MIL,W,1,34,12,24,0.5,8,17,0.471,4,7,0.571,1,1,1,1,8,9
651,LeBron James,32-022,F-G,1/21/17,CLE,,SAS,L,1,45,11,16,0.688,9,11,0.818,2,5,0.4,5,7,0.714,0,6,6
652,Joe Johnson,35-118,G-F,10/25/16,UTA,@,POR,L,1,31,12,16,0.75,9,12,0.75,3,4,0.75,2,2,1,0,4,4
653,Nikola Jokic,21-342,C-F,1/26/17,DEN,,PHO,W,1,36,12,21,0.571,12,19,0.632,0,2,0,5,6,0.833,8,6,14
654,Nikola Jokic,21-333,C-F,1/17/17,DEN,@,LAL,W,1,34,12,22,0.545,11,17,0.647,1,5,0.2,4,6,0.667,7,8,15
655,DeAndre Jordan,28-182,C,1/19/17,LAC,,MIN,L,1,39,12,15,0.8,12,15,0.8,0,0,,5,12,0.417,6,10,16
656,Enes Kanter,24-240,C,1/15/17,OKC,@,SAC,W,0,32,10,18,0.556,10,17,0.588,0,1,0,9,11,0.818,7,5,12
657,Kyle Korver,35-328,G-F,2/8/17,CLE,@,IND,W,0,26,10,12,0.833,2,3,0.667,8,9,0.889,1,1,1,0,5,5
658,Zach LaVine,21-273,G,12/8/16,MIN,@,TOR,L,1,39,12,20,0.6,9,12,0.75,3,8,0.375,2,2,1,2,0,2
659,Kawhi Leonard,25-128,F,11/4/16,SAS,@,UTA,W,1,32,9,18,0.5,8,13,0.615,1,5,0.2,10,10,1,4,7,11
660,Damian Lillard,26-104,G,10/27/16,POR,,LAC,L,1,36,11,24,0.458,9,19,0.474,2,5,0.4,5,7,0.714,1,9,10
661,Damian Lillard,26-207,G,2/7/17,POR,@,DAL,W,1,40,12,22,0.545,7,13,0.538,5,9,0.556,0,0,,1,4,5
662,Damian Lillard,26-159,G,12/21/16,POR,,DAL,L,1,39,10,23,0.435,7,14,0.5,3,9,0.333,6,6,1,0,3,3
663,Damian Lillard,26-205,G,2/5/17,POR,@,OKC,L,1,36,9,22,0.409,5,13,0.385,4,9,0.444,7,7,1,0,7,7
664,Damian Lillard,26-242,G,3/14/17,POR,@,NOP,L,1,31,8,18,0.444,4,11,0.364,4,7,0.571,9,9,1,1,3,4
665,Brook Lopez,28-354,C,3/21/17,BRK,,DET,W,1,33,13,24,0.542,10,15,0.667,3,9,0.333,0,2,0,2,5,7
666,Kevin Love,28-097,F,12/13/16,CLE,,MEM,W,1,35,9,17,0.529,6,11,0.545,3,6,0.5,8,8,1,3,10,13
667,Kyle Lowry,30-306,G,1/25/17,TOR,@,MEM,L,1,40,11,21,0.524,7,11,0.636,4,10,0.4,3,3,1,2,2,4
668,Kyle Lowry,30-220,G,10/31/16,TOR,,DEN,W,1,36,10,20,0.5,9,15,0.6,1,5,0.2,8,10,0.8,0,5,5
669,Kyle Lowry,30-250,G,11/30/16,TOR,,MEM,W,1,37,8,13,0.615,4,6,0.667,4,7,0.571,9,10,0.9,0,3,3
670,C.J. McCollum,25-102,G,12/30/16,POR,@,SAS,L,1,33,10,19,0.526,9,15,0.6,1,4,0.25,8,8,1,0,2,2
671,C.J. McCollum,25-098,G,12/26/16,POR,,TOR,L,1,34,12,23,0.522,9,16,0.563,3,7,0.429,2,2,1,2,1,3
672,Victor Oladipo,24-196,G,11/16/16,OKC,,HOU,W,1,40,12,18,0.667,7,11,0.636,5,7,0.714,0,0,,1,9,10
673,Kristaps Porzingis,21-120,F-C,11/30/16,NYK,@,MIN,W,1,39,11,20,0.55,8,13,0.615,3,7,0.429,4,5,0.8,3,5,8
674,J.J. Redick,32-145,G,11/16/16,LAC,,MEM,L,1,30,9,17,0.529,2,5,0.4,7,12,0.583,4,5,0.8,0,2,2
675,D'Angelo Russell,21-001,G,2/24/17,LAL,@,OKC,L,1,36,12,26,0.462,9,14,0.643,3,12,0.25,2,3,0.667,1,3,4
676,Dario Saric,22-338,F,3/12/17,PHI,@,LAL,W,1,35,10,20,0.5,7,13,0.538,3,7,0.429,6,9,0.667,0,7,7
677,Isaiah Thomas,28-009,G,2/16/17,BOS,@,CHI,L,1,34,8,18,0.444,4,9,0.444,4,9,0.444,9,9,1,0,3,3
678,Isaiah Thomas,28-006,G,2/13/17,BOS,@,DAL,W,1,34,9,19,0.474,5,9,0.556,4,10,0.4,7,9,0.778,0,1,1
679,Isaiah Thomas,28-004,G,2/11/17,BOS,@,UTA,W,1,35,9,16,0.563,5,9,0.556,4,7,0.571,7,9,0.778,0,2,2
680,Isaiah Thomas,27-278,G,11/11/16,BOS,,NYK,W,1,28,9,17,0.529,6,12,0.5,3,5,0.6,8,8,1,2,1,3
681,Isaiah Thomas,27-331,G,1/3/17,BOS,,UTA,W,1,35,10,18,0.556,5,10,0.5,5,8,0.625,4,4,1,0,4,4
682,Isaiah Thomas,27-288,G,11/21/16,BOS,@,MIN,W,1,32,9,20,0.45,7,11,0.636,2,9,0.222,9,10,0.9,0,2,2
683,Klay Thompson,26-285,G,11/19/16,GSW,@,MIL,W,1,38,9,17,0.529,4,7,0.571,5,10,0.5,6,6,1,0,3,3
684,Klay Thompson,27-025,G,3/5/17,GSW,@,NYK,W,1,37,8,21,0.381,4,12,0.333,4,9,0.444,9,9,1,2,2,4
685,Klay Thompson,26-326,G,12/30/16,GSW,,DAL,W,1,36,11,19,0.579,6,8,0.75,5,11,0.455,2,2,1,0,4,4
686,Klay Thompson,27-036,G,3/16/17,GSW,,ORL,W,1,29,12,20,0.6,7,11,0.636,5,9,0.556,0,0,,0,4,4
687,Klay Thompson,26-359,G,2/1/17,GSW,,CHO,W,1,33,10,19,0.526,4,9,0.444,6,10,0.6,3,3,1,1,4,5
688,Karl-Anthony Towns,21-059,F-C,1/13/17,MIN,,OKC,W,1,37,11,17,0.647,11,15,0.733,0,2,0,7,7,1,2,15,17
689,Karl-Anthony Towns,21-113,F-C,3/8/17,MIN,,LAC,W,1,35,14,21,0.667,13,16,0.813,1,5,0.2,0,0,,4,10,14
690,Karl-Anthony Towns,21-085,F-C,2/8/17,MIN,,TOR,W,1,37,8,14,0.571,8,12,0.667,0,2,0,13,13,1,6,8,14
691,Karl-Anthony Towns,21-104,F-C,2/27/17,MIN,@,SAC,W,1,38,13,19,0.684,12,18,0.667,1,1,1,2,5,0.4,8,9,17
692,Dion Waiters,25-086,G,3/6/17,MIA,@,CLE,W,1,35,12,24,0.5,7,15,0.467,5,9,0.556,0,0,,0,2,2
693,Kemba Walker,26-281,G,2/13/17,CHO,,PHI,L,1,38,10,18,0.556,9,14,0.643,1,4,0.25,8,10,0.8,0,7,7
694,Kemba Walker,26-174,G,10/29/16,CHO,,BOS,L,1,36,10,16,0.625,6,8,0.75,4,8,0.5,5,6,0.833,0,2,2
695,John Wall,26-135,G,1/19/17,WAS,@,NYK,W,1,37,11,21,0.524,10,18,0.556,1,3,0.333,6,8,0.75,0,5,5
696,John Wall,26-101,G,12/16/16,WAS,,DET,W,1,35,8,14,0.571,4,10,0.4,4,4,1,9,12,0.75,0,2,2
697,John Wall,26-171,G,2/24/17,WAS,@,PHI,L,1,41,8,21,0.381,8,18,0.444,0,3,0,13,14,0.929,2,6,8
698,Russell Westbrook,28-089,G,2/9/17,OKC,,CLE,W,1,35,11,27,0.407,9,21,0.429,2,6,0.333,5,5,1,1,11,12
699,Russell Westbrook,27-365,G,11/11/16,OKC,,LAC,L,1,35,9,25,0.36,6,20,0.3,3,5,0.6,8,9,0.889,1,13,14
700,Russell Westbrook,28-045,G,12/27/16,OKC,@,MIA,W,1,37,11,22,0.5,11,21,0.524,0,1,0,7,10,0.7,0,17,17
701,Russell Westbrook,28-113,G,3/5/17,OKC,@,DAL,L,1,34,8,24,0.333,6,14,0.429,2,10,0.2,11,13,0.846,0,6,6
702,Andrew Wiggins,21-353,F-G,2/10/17,MIN,,NOP,L,1,37,11,17,0.647,10,14,0.714,1,3,0.333,6,7,0.857,2,2,4
703,Andrew Wiggins,21-284,F-G,12/3/16,MIN,@,CHO,W,1,37,11,20,0.55,9,13,0.692,2,7,0.286,5,5,1,0,1,1
704,Andrew Wiggins,21-249,F-G,10/29/16,MIN,@,SAC,L,1,37,10,20,0.5,9,15,0.6,1,5,0.2,8,11,0.727,0,1,1
705,Andrew Wiggins,21-266,F-G,11/15/16,MIN,,CHO,L,1,42,10,24,0.417,7,18,0.389,3,6,0.5,6,9,0.667,0,2,2
706,Andrew Wiggins,21-260,F-G,11/9/16,MIN,@,ORL,W,1,39,10,18,0.556,8,14,0.571,2,4,0.5,7,9,0.778,1,3,4
707,Lou Williams,30-110,G,2/14/17,LAL,,SAC,L,0,24,10,18,0.556,6,7,0.857,4,11,0.364,5,5,1,0,1,1
708,LaMarcus Aldridge,31-170,F-C,1/5/17,SAS,@,DEN,W,1,33,11,18,0.611,10,17,0.588,1,1,1,5,6,0.833,1,3,4
709,Ryan Anderson,28-225,F,12/17/16,HOU,@,MIN,W,1,36,9,19,0.474,2,3,0.667,7,16,0.438,3,4,0.75,3,3,6
710,Giannis Antetokounmpo,22-015,F-G,12/21/16,MIL,@,CLE,L,1,32,7,13,0.538,6,9,0.667,1,4,0.25,13,14,0.929,1,4,5
711,Giannis Antetokounmpo,22-082,F-G,2/26/17,MIL,,PHO,W,1,36,11,13,0.846,11,13,0.846,0,0,,6,7,0.857,1,7,8
712,Giannis Antetokounmpo,22-004,F-G,12/10/16,MIL,@,WAS,L,1,41,11,18,0.611,10,16,0.625,1,2,0.5,5,7,0.714,3,10,13
713,Carmelo Anthony,32-161,F,11/6/16,NYK,,UTA,L,1,35,12,20,0.6,12,14,0.857,0,6,0,4,6,0.667,1,8,9
714,Carmelo Anthony,32-227,F,1/11/17,NYK,@,PHI,L,1,37,11,25,0.44,9,19,0.474,2,6,0.333,4,4,1,1,1,2
715,Carmelo Anthony,32-255,F,2/8/17,NYK,,LAC,L,1,37,10,20,0.5,7,13,0.538,3,7,0.429,5,6,0.833,2,7,9
716,Harrison Barnes,24-205,F,12/21/16,DAL,@,POR,W,1,36,10,22,0.455,10,20,0.5,0,2,0,8,8,1,1,6,7
717,Harrison Barnes,24-170,F,11/16/16,DAL,@,BOS,L,1,41,12,24,0.5,12,23,0.522,0,1,0,4,5,0.8,0,2,2
718,Nicolas Batum,28-021,F-G,1/4/17,CHO,,OKC,W,1,36,7,18,0.389,6,13,0.462,1,5,0.2,13,15,0.867,1,2,3
719,Bradley Beal,23-217,G,1/31/17,WAS,,NYK,W,1,32,12,18,0.667,10,12,0.833,2,6,0.333,2,2,1,1,1,2
720,Bradley Beal,23-129,G,11/4/16,WAS,,ATL,W,1,39,6,16,0.375,3,8,0.375,3,8,0.375,13,14,0.929,1,1,2
721,Michael Beasley,28-001,F,1/10/17,MIL,@,SAS,W,0,34,11,18,0.611,10,17,0.588,1,1,1,5,6,0.833,1,4,5
722,Eric Bledsoe,27-048,G,1/26/17,PHO,@,DEN,L,1,28,9,19,0.474,6,12,0.5,3,7,0.429,7,9,0.778,2,2,4
723,Eric Bledsoe,27-086,G,3/5/17,PHO,,BOS,W,1,35,9,20,0.45,7,15,0.467,2,5,0.4,8,8,1,0,6,6
724,Devin Booker,20-070,G,1/8/17,PHO,,CLE,L,1,45,12,24,0.5,10,17,0.588,2,7,0.286,2,4,0.5,3,2,5
725,Devin Booker,20-052,G,12/21/16,PHO,,HOU,L,1,36,11,25,0.44,9,21,0.429,2,4,0.5,4,5,0.8,2,4,6
726,Devin Booker,20-133,G,3/12/17,PHO,,POR,L,1,41,13,26,0.5,13,26,0.5,0,0,,2,4,0.5,1,4,5
727,Jimmy Butler,27-140,G-F,2/1/17,CHI,@,OKC,W,1,30,11,17,0.647,11,16,0.688,0,1,0,6,8,0.75,2,2,4
728,Jimmy Butler,27-122,G-F,1/14/17,CHI,,NOP,W,1,39,9,16,0.563,6,12,0.5,3,4,0.75,7,10,0.7,1,7,8
729,Jimmy Butler,27-137,G-F,1/29/17,CHI,,PHI,W,1,39,8,18,0.444,8,18,0.444,0,0,,12,15,0.8,1,7,8
730,Jimmy Butler,27-184,G-F,3/17/17,CHI,@,WAS,L,1,38,10,17,0.588,8,14,0.571,2,3,0.667,6,8,0.75,2,3,5
731,Wilson Chandler,29-190,F,11/16/16,DEN,,PHO,W,0,35,11,22,0.5,9,19,0.474,2,3,0.667,4,4,1,3,8,11
732,Mike Conley,29-096,G,1/15/17,MEM,,CHI,L,1,37,9,17,0.529,6,8,0.75,3,9,0.333,7,7,1,0,5,5
733,DeMarcus Cousins,26-111,C-F,12/2/16,SAC,@,BOS,L,1,34,10,26,0.385,8,19,0.421,2,7,0.286,6,8,0.75,3,6,9
734,DeMarcus Cousins,26-089,C-F,11/10/16,SAC,,LAL,L,1,36,10,25,0.4,7,19,0.368,3,6,0.5,5,8,0.625,3,6,9
735,DeMarcus Cousins,26-087,C-F,11/8/16,SAC,,NOP,W,1,33,11,20,0.55,11,17,0.647,0,3,0,6,8,0.75,1,3,4
736,DeMarcus Cousins,26-137,C-F,12/28/16,SAC,@,POR,L,1,35,8,19,0.421,5,13,0.385,3,6,0.5,9,10,0.9,1,7,8
737,DeMarcus Cousins,26-118,C-F,12/9/16,SAC,,NYK,L,1,36,9,25,0.36,9,19,0.474,0,6,0,10,12,0.833,3,9,12
738,DeMarcus Cousins,26-183,C-F,2/12/17,SAC,,NOP,W,1,36,7,14,0.5,7,10,0.7,0,4,0,14,16,0.875,2,12,14
739,DeMarcus Cousins,26-165,C-F,1/25/17,SAC,@,CLE,W,1,39,11,30,0.367,11,25,0.44,0,5,0,6,9,0.667,2,9,11
740,Stephen Curry,28-232,G,11/1/16,GSW,@,POR,W,1,30,10,21,0.476,5,11,0.455,5,10,0.5,3,4,0.75,1,3,4
741,Stephen Curry,28-262,G,12/1/16,GSW,,HOU,L,1,38,9,22,0.409,5,9,0.556,4,13,0.308,6,6,1,1,2,3
742,Stephen Curry,28-230,G,10/30/16,GSW,@,PHO,W,1,34,9,17,0.529,4,9,0.444,5,8,0.625,5,5,1,0,1,1
743,Stephen Curry,29-004,G,3/18/17,GSW,,MIL,W,1,30,9,13,0.692,3,5,0.6,6,8,0.75,4,4,1,0,4,4
744,Stephen Curry,28-289,G,12/28/16,GSW,,TOR,W,1,36,9,18,0.5,6,12,0.5,3,6,0.5,7,7,1,1,6,7
745,Stephen Curry,28-317,G,1/25/17,GSW,@,CHO,W,1,36,11,23,0.478,5,11,0.455,6,12,0.5,0,0,,0,2,2
746,Anthony Davis,23-277,F-C,12/13/16,NOP,,GSW,L,1,36,10,14,0.714,9,13,0.692,1,1,1,7,8,0.875,0,8,8
747,Anthony Davis,23-290,F-C,12/26/16,NOP,,DAL,W,1,37,8,14,0.571,8,13,0.615,0,1,0,12,14,0.857,5,11,16
748,Anthony Davis,23-287,F-C,12/23/16,NOP,,MIA,W,1,37,10,17,0.588,8,14,0.571,2,3,0.667,6,9,0.667,7,15,22
749,Anthony Davis,23-269,F-C,12/5/16,NOP,,MEM,L,1,48,10,27,0.37,9,23,0.391,1,4,0.25,7,7,1,0,16,16
750,Anthony Davis,24-008,F-C,3/19/17,NOP,,MIN,W,1,35,11,16,0.688,11,14,0.786,0,2,0,6,6,1,5,7,12
751,DeMar DeRozan,27-159,G,1/13/17,TOR,,BRK,W,1,30,11,22,0.5,11,21,0.524,0,1,0,6,8,0.75,2,2,4
752,DeMar DeRozan,27-215,G,3/10/17,TOR,@,ATL,L,1,37,12,30,0.4,11,22,0.5,1,8,0.125,3,4,0.75,1,7,8
753,Andre Drummond,23-173,C,1/30/17,DET,@,BOS,L,1,41,12,19,0.632,12,19,0.632,0,0,,4,7,0.571,7,15,22
754,Andre Drummond,23-151,C,1/8/17,DET,@,POR,W,1,52,13,20,0.65,13,20,0.65,0,0,,2,3,0.667,2,12,14
755,Kevin Durant,28-058,F-G,11/26/16,GSW,,MIN,W,1,38,10,17,0.588,7,13,0.538,3,4,0.75,5,5,1,3,7,10
756,Kevin Durant,28-041,F-G,11/9/16,GSW,,DAL,W,1,35,10,16,0.625,6,9,0.667,4,7,0.571,4,5,0.8,0,10,10
757,Kevin Durant,28-055,F-G,11/23/16,GSW,,LAL,W,1,30,11,15,0.733,9,11,0.818,2,4,0.5,4,5,0.8,1,5,6
758,Kevin Durant,28-103,F-G,1/10/17,GSW,,MIA,W,1,37,10,21,0.476,7,15,0.467,3,6,0.5,5,5,1,1,7,8
759,Kevin Durant,28-101,F-G,1/8/17,GSW,@,SAC,W,1,36,9,15,0.6,7,11,0.636,2,4,0.5,8,9,0.889,0,7,7
760,Evan Fournier,24-033,G-F,12/1/16,ORL,@,MEM,L,1,36,11,14,0.786,8,9,0.889,3,5,0.6,3,4,0.75,0,0,0
761,Marc Gasol,31-311,C,12/5/16,MEM,@,NOP,W,1,46,11,25,0.44,8,19,0.421,3,6,0.5,3,4,0.75,1,10,11
762,Marc Gasol,31-357,C,1/20/17,MEM,,SAC,W,1,33,9,19,0.474,6,13,0.462,3,6,0.5,7,7,1,1,8,9
763,Marc Gasol,31-355,C,1/18/17,MEM,@,WAS,L,1,39,9,16,0.563,9,13,0.692,0,3,0,10,11,0.909,1,1,2
764,Marc Gasol,32-030,C,2/28/17,MEM,,PHO,W,1,31,10,16,0.625,5,11,0.455,5,5,1,3,4,0.75,3,4,7
765,Marc Gasol,31-302,C,11/26/16,MEM,@,MIA,W,1,35,11,16,0.688,9,12,0.75,2,4,0.5,4,4,1,0,3,3
766,Rudy Gay,30-073,F,10/29/16,SAC,,MIN,W,1,33,11,20,0.55,11,20,0.55,0,0,,6,8,0.75,2,4,6
767,Paul George,26-191,F,11/9/16,IND,,PHI,W,1,32,13,22,0.591,11,15,0.733,2,7,0.286,0,0,,1,6,7
768,Paul George,26-314,F,3/12/17,IND,,MIA,W,1,37,9,19,0.474,8,15,0.533,1,4,0.25,9,9,1,0,10,10
769,Aaron Gordon,21-117,F,1/11/17,ORL,@,LAC,L,1,39,11,17,0.647,7,9,0.778,4,8,0.5,2,4,0.5,1,2,3
770,Blake Griffin,27-234,F,11/5/16,LAC,@,SAS,W,1,29,13,19,0.684,13,17,0.765,0,2,0,2,3,0.667,1,4,5
771,Tim Hardaway,24-331,G,2/10/17,ATL,@,SAC,L,1,36,9,17,0.529,6,8,0.75,3,9,0.333,7,8,0.875,0,4,4
772,James Harden,27-087,G,11/21/16,HOU,@,DET,W,1,38,6,17,0.353,4,8,0.5,2,9,0.222,14,19,0.737,2,6,8
773,James Harden,27-113,G,12/17/16,HOU,@,MIN,W,1,43,8,20,0.4,5,9,0.556,3,11,0.273,9,11,0.818,0,9,9
774,James Harden,27-065,G,10/30/16,HOU,,DAL,W,1,39,8,23,0.348,5,14,0.357,3,9,0.333,9,12,0.75,1,6,7
775,Montrezl Harrell,22-348,F-C,1/8/17,HOU,@,TOR,W,0,26,12,13,0.923,12,13,0.923,0,0,,4,6,0.667,3,2,5
776,Gary Harris,22-187,G,3/20/17,DEN,@,HOU,L,1,39,10,16,0.625,7,10,0.7,3,6,0.5,5,6,0.833,1,1,2
777,Tobias Harris,24-239,F,3/11/17,DET,,NYK,W,1,33,11,21,0.524,8,13,0.615,3,8,0.375,3,5,0.6,2,5,7
778,Gordon Hayward,26-228,F-G,11/6/16,UTA,@,NYK,W,1,36,6,17,0.353,4,9,0.444,2,8,0.25,14,14,1,1,4,5
779,Gordon Hayward,26-258,F-G,12/6/16,UTA,,PHO,W,1,36,8,16,0.5,6,13,0.462,2,3,0.667,10,13,0.769,0,5,5
780,Gordon Hayward,26-293,F-G,1/10/17,UTA,,CLE,W,1,37,10,12,0.833,6,7,0.857,4,5,0.8,4,5,0.8,0,9,9
781,Gordon Hayward,26-273,F-G,12/21/16,UTA,,SAC,L,1,40,9,18,0.5,7,13,0.538,2,5,0.4,8,9,0.889,1,9,10
782,Rodney Hood,24-136,G-F,3/5/17,UTA,@,SAC,W,1,33,10,17,0.588,6,9,0.667,4,8,0.5,4,5,0.8,1,3,4
783,Serge Ibaka,27-142,F-C,2/7/17,ORL,@,HOU,L,1,41,13,20,0.65,11,16,0.688,2,4,0.5,0,0,,1,7,8
784,Kyrie Irving,24-354,G,3/12/17,CLE,@,HOU,L,1,37,10,23,0.435,7,13,0.538,3,10,0.3,5,6,0.833,0,3,3
785,Kyrie Irving,24-253,G,12/1/16,CLE,,LAC,L,1,34,8,19,0.421,7,15,0.467,1,4,0.25,11,12,0.917,0,2,2
786,Kyrie Irving,24-272,G,12/20/16,CLE,@,MIL,W,1,45,8,23,0.348,5,16,0.313,3,7,0.429,9,9,1,0,5,5
787,Kyrie Irving,24-310,G,1/27/17,CLE,,BRK,W,1,31,10,17,0.588,7,12,0.583,3,5,0.6,5,5,1,0,4,4
788,Kyrie Irving,24-323,G,2/9/17,CLE,@,OKC,L,1,34,11,18,0.611,7,13,0.538,4,5,0.8,2,2,1,0,1,1
789,Kyrie Irving,24-343,G,3/1/17,CLE,@,BOS,L,1,32,10,19,0.526,8,13,0.615,2,6,0.333,6,6,1,0,2,2
790,Kyrie Irving,24-259,G,12/7/16,CLE,@,NYK,W,1,30,9,17,0.529,5,11,0.455,4,6,0.667,6,6,1,0,3,3
791,LeBron James,31-321,F-G,11/15/16,CLE,,TOR,W,1,38,10,15,0.667,8,10,0.8,2,5,0.4,6,10,0.6,0,9,9
792,LeBron James,32-009,F-G,1/8/17,CLE,@,PHO,W,1,40,11,17,0.647,9,13,0.692,2,4,0.5,4,6,0.667,3,5,8
793,LeBron James,32-061,F-G,3/1/17,CLE,@,BOS,L,1,40,10,21,0.476,7,15,0.467,3,6,0.5,5,8,0.625,5,8,13
794,DeAndre Jordan,28-202,C,2/8/17,LAC,@,NYK,W,1,31,12,14,0.857,12,14,0.857,0,0,,4,9,0.444,5,10,15
795,Zach LaVine,21-299,G,1/3/17,MIN,@,PHI,L,1,40,11,20,0.55,8,12,0.667,3,8,0.375,3,4,0.75,0,4,4
796,Zach LaVine,21-263,G,11/28/16,MIN,,UTA,L,1,44,9,17,0.529,7,11,0.636,2,6,0.333,8,9,0.889,1,7,8
797,Damian Lillard,26-138,G,11/30/16,POR,,IND,W,1,35,11,18,0.611,10,12,0.833,1,6,0.167,5,7,0.714,0,5,5
798,Damian Lillard,26-190,G,1/21/17,POR,@,BOS,W,1,37,9,21,0.429,7,14,0.5,2,7,0.286,8,8,1,0,1,1
799,Damian Lillard,26-209,G,2/9/17,POR,,BOS,L,1,40,8,20,0.4,6,13,0.462,2,7,0.286,10,11,0.909,2,4,6
800,Damian Lillard,26-226,G,2/26/17,POR,@,TOR,L,1,36,10,20,0.5,6,13,0.462,4,7,0.571,4,5,0.8,0,6,6
801,Brook Lopez,28-291,C,1/17/17,BRK,,TOR,L,1,32,11,23,0.478,11,20,0.55,0,3,0,6,6,1,5,4,9
802,Brook Lopez,28-265,C,12/22/16,BRK,,GSW,L,1,31,9,16,0.563,5,7,0.714,4,9,0.444,6,6,1,0,8,8
803,Kevin Love,28-093,F,12/9/16,CLE,,MIA,W,1,31,11,18,0.611,8,10,0.8,3,8,0.375,3,4,0.75,5,10,15
804,Kevin Love,28-115,F,12/31/16,CLE,@,CHO,W,1,39,8,20,0.4,4,12,0.333,4,8,0.5,8,8,1,2,8,10
805,Kevin Love,28-089,F,12/5/16,CLE,@,TOR,W,1,38,8,18,0.444,2,7,0.286,6,11,0.545,6,6,1,2,12,14
806,Kyle Lowry,30-235,G,11/15/16,TOR,@,CLE,L,1,40,11,23,0.478,7,15,0.467,4,8,0.5,2,2,1,3,2,5
807,C.J. McCollum,25-137,G,2/3/17,POR,,DAL,L,1,35,11,20,0.55,9,13,0.692,2,7,0.286,4,4,1,2,5,7
808,C.J. McCollum,25-069,G,11/27/16,POR,,HOU,L,1,37,9,19,0.474,5,9,0.556,4,10,0.4,6,6,1,0,3,3
809,C.J. McCollum,25-132,G,1/29/17,POR,,GSW,L,1,38,10,16,0.625,5,9,0.556,5,7,0.714,3,4,0.75,1,6,7
810,Paul Millsap,31-260,F,10/27/16,ATL,,WAS,W,1,31,11,20,0.55,8,14,0.571,3,6,0.5,3,4,0.75,2,5,7
811,Greg Monroe,26-235,C-F,1/25/17,MIL,,PHI,L,0,30,11,17,0.647,11,17,0.647,0,0,,6,7,0.857,6,3,9
812,Marcus Morris,27-100,F,12/11/16,DET,,PHI,L,1,37,10,16,0.625,6,9,0.667,4,7,0.571,4,5,0.8,1,1,2
813,Jusuf Nurkic,22-198,C,3/9/17,POR,,PHI,W,1,38,9,18,0.5,9,18,0.5,0,0,,10,13,0.769,7,13,20
814,Jahlil Okafor,21-072,C-F,2/25/17,PHI,@,NYK,L,1,29,11,19,0.579,11,19,0.579,0,0,,6,6,1,6,4,10
815,Jabari Parker,21-249,F,11/19/16,MIL,,GSW,L,1,37,11,18,0.611,10,16,0.625,1,2,0.5,5,6,0.833,3,2,5
816,Jabari Parker,21-299,F,1/8/17,MIL,,WAS,L,1,41,9,21,0.429,6,15,0.4,3,6,0.5,7,9,0.778,3,5,8
817,Jabari Parker,21-314,F,1/23/17,MIL,,HOU,W,1,39,11,19,0.579,9,14,0.643,2,5,0.4,4,4,1,0,8,8
818,Jabari Parker,21-275,F,12/15/16,MIL,,CHI,W,1,35,11,19,0.579,8,14,0.571,3,5,0.6,3,7,0.429,1,4,5
819,Elfrid Payton,22-327,G,1/14/17,ORL,@,UTA,L,1,39,10,17,0.588,9,14,0.643,1,3,0.333,7,11,0.636,3,6,9
820,Kristaps Porzingis,21-096,F-C,11/6/16,NYK,,UTA,L,1,33,10,18,0.556,7,11,0.636,3,7,0.429,5,5,1,1,7,8
821,Zach Randolph,35-196,F,1/28/17,MEM,@,UTA,W,0,34,12,20,0.6,12,19,0.632,0,1,0,4,4,1,3,6,9
822,Austin Rivers,24-156,G,1/4/17,LAC,,MEM,W,1,44,10,16,0.625,8,12,0.667,2,4,0.5,6,7,0.857,0,4,4
823,Derrick Rose,28-152,G,3/5/17,NYK,,GSW,L,1,35,9,18,0.5,9,17,0.529,0,1,0,10,11,0.909,0,1,1
824,D'Angelo Russell,21-014,G,3/9/17,LAL,@,PHO,W,1,34,10,20,0.5,4,11,0.364,6,9,0.667,2,2,1,1,3,4
825,D'Angelo Russell,20-313,G,1/1/17,LAL,,TOR,L,1,31,9,18,0.5,3,6,0.5,6,12,0.5,4,6,0.667,1,3,4
826,Dario Saric,22-335,F,3/9/17,PHI,@,POR,L,1,41,11,16,0.688,7,9,0.778,4,7,0.571,2,3,0.667,2,7,9
827,Dennis Schroder,23-054,G,11/8/16,ATL,@,CLE,W,1,32,10,16,0.625,7,10,0.7,3,6,0.5,5,5,1,1,1,2
828,Dennis Schroder,23-123,G,1/16/17,ATL,@,NYK,W,1,34,13,16,0.813,12,14,0.857,1,2,0.5,1,1,1,1,2,3
829,Isaiah Thomas,27-341,G,1/13/17,BOS,@,ATL,W,1,36,9,21,0.429,4,8,0.5,5,13,0.385,5,5,1,1,3,4
830,Isaiah Thomas,27-319,G,12/22/16,BOS,@,IND,W,1,32,9,21,0.429,7,10,0.7,2,11,0.182,8,9,0.889,0,1,1
831,Isaiah Thomas,27-364,G,2/5/17,BOS,,LAC,W,1,36,7,18,0.389,4,7,0.571,3,11,0.273,11,12,0.917,0,2,2
832,Klay Thompson,26-284,G,11/18/16,GSW,@,BOS,W,1,31,12,21,0.571,9,15,0.6,3,6,0.5,1,1,1,1,3,4
833,Klay Thompson,27-000,G,2/8/17,GSW,,CHI,W,1,29,10,18,0.556,4,9,0.444,6,9,0.667,2,2,1,0,5,5
834,Klay Thompson,26-263,G,10/28/16,GSW,@,NOP,W,1,39,11,21,0.524,9,12,0.75,2,9,0.222,4,4,1,0,2,2
835,Klay Thompson,27-034,G,3/14/17,GSW,,PHI,W,1,38,10,22,0.455,5,13,0.385,5,9,0.556,3,3,1,1,1,2
836,Karl-Anthony Towns,21-034,F-C,12/19/16,MIN,,PHO,W,1,35,11,18,0.611,10,15,0.667,1,3,0.333,5,5,1,4,11,15
837,Dwyane Wade,34-307,G,11/19/16,CHI,@,LAC,L,1,36,9,20,0.45,4,11,0.364,5,9,0.556,5,6,0.833,3,5,8
838,Dwyane Wade,34-328,G,12/10/16,CHI,,MIA,W,1,35,11,24,0.458,11,22,0.5,0,2,0,6,7,0.857,0,3,3
839,Dion Waiters,24-352,G,11/26/16,MIA,,MEM,L,1,36,10,19,0.526,6,14,0.429,4,5,0.8,4,6,0.667,0,5,5
840,Kemba Walker,26-226,G,12/20/16,CHO,,LAL,W,1,41,11,26,0.423,7,16,0.438,4,10,0.4,2,2,1,5,3,8
841,Kemba Walker,26-202,G,11/26/16,CHO,,NYK,W,1,40,9,21,0.429,7,15,0.467,2,6,0.333,8,11,0.727,0,2,2
842,Kemba Walker,26-302,G,3/6/17,CHO,,IND,W,1,35,10,22,0.455,6,13,0.462,4,9,0.444,4,4,1,2,4,6
843,John Wall,26-066,G,11/11/16,WAS,,CLE,L,1,35,12,24,0.5,11,21,0.524,1,3,0.333,3,5,0.6,1,1,2
844,Russell Westbrook,28-126,G,3/18/17,OKC,,SAC,W,1,36,9,20,0.45,5,11,0.455,4,9,0.444,6,7,0.857,3,5,8
845,Russell Westbrook,28-022,G,12/4/16,OKC,,NOP,W,1,38,10,23,0.435,8,15,0.533,2,8,0.25,6,9,0.667,1,16,17
846,Russell Westbrook,28-081,G,2/1/17,OKC,,CHI,L,1,29,10,23,0.435,8,16,0.5,2,7,0.286,6,8,0.75,1,4,5
847,Russell Westbrook,27-359,G,11/5/16,OKC,,MIN,W,1,28,9,18,0.5,5,13,0.385,4,5,0.8,6,8,0.75,2,4,6
848,Hassan Whiteside,27-173,C,12/3/16,MIA,@,POR,L,1,41,12,16,0.75,12,16,0.75,0,0,,4,6,0.667,3,13,16
849,Andrew Wiggins,21-323,F-G,1/11/17,MIN,,HOU,W,1,38,11,20,0.55,9,16,0.563,2,4,0.5,4,5,0.8,0,4,4
850,Lou Williams,30-123,G,2/27/17,HOU,,IND,L,0,28,8,15,0.533,3,5,0.6,5,10,0.5,7,8,0.875,1,2,3
851,LaMarcus Aldridge,31-166,F-C,1/1/17,SAS,@,ATL,L,1,43,12,17,0.706,11,16,0.688,1,1,1,2,2,1,3,10,13
852,LaMarcus Aldridge,31-162,F-C,12/28/16,SAS,,PHO,W,1,33,10,12,0.833,10,12,0.833,0,0,,7,9,0.778,3,5,8
853,Ryan Anderson,28-268,F,1/29/17,HOU,@,IND,L,1,35,9,16,0.563,4,7,0.571,5,9,0.556,4,5,0.8,1,6,7
854,Giannis Antetokounmpo,22-029,F-G,1/4/17,MIL,@,NYK,W,1,39,10,18,0.556,9,14,0.643,1,4,0.25,6,7,0.857,1,12,13
855,Giannis Antetokounmpo,21-342,F-G,11/12/16,MIL,,MEM,W,1,38,9,13,0.692,9,12,0.75,0,1,0,9,13,0.692,0,6,6
856,Giannis Antetokounmpo,21-333,F-G,11/3/16,MIL,,IND,W,1,34,11,18,0.611,11,16,0.688,0,2,0,5,7,0.714,2,5,7
857,Carmelo Anthony,32-287,F,3/12/17,NYK,@,BRK,L,1,37,10,26,0.385,9,21,0.429,1,5,0.2,6,7,0.857,1,6,7
858,Trevor Ariza,31-120,F,10/28/16,HOU,@,DAL,W,1,36,8,12,0.667,3,5,0.6,5,7,0.714,6,6,1,0,4,4
859,Bradley Beal,23-188,G,1/2/17,WAS,@,HOU,L,1,35,9,18,0.5,4,8,0.5,5,10,0.5,4,4,1,0,3,3
860,Bradley Beal,23-215,G,1/29/17,WAS,@,NOP,W,1,39,11,16,0.688,8,10,0.8,3,6,0.5,2,3,0.667,0,6,6
861,Bradley Beal,23-252,G,3/7/17,WAS,@,PHO,W,1,33,10,20,0.5,8,15,0.533,2,5,0.4,5,7,0.714,1,2,3
862,Bradley Beal,23-248,G,3/3/17,WAS,,TOR,L,1,36,10,21,0.476,7,13,0.538,3,8,0.375,4,5,0.8,4,3,7
863,Eric Bledsoe,26-360,G,12/3/16,PHO,@,GSW,L,1,30,10,19,0.526,5,11,0.455,5,8,0.625,2,2,1,0,5,5
864,Eric Bledsoe,27-010,G,12/19/16,PHO,@,MIN,L,1,33,9,20,0.45,6,16,0.375,3,4,0.75,6,9,0.667,0,1,1
865,Eric Bledsoe,26-346,G,11/19/16,PHO,@,PHI,L,1,30,12,24,0.5,11,20,0.55,1,4,0.25,2,2,1,2,3,5
866,Bojan Bogdanovic,27-321,G-F,3/5/17,WAS,,ORL,W,0,27,9,12,0.75,1,2,0.5,8,10,0.8,1,1,1,1,1,2
867,Bojan Bogdanovic,27-317,G-F,3/1/17,WAS,@,TOR,W,0,25,9,12,0.75,3,5,0.6,6,7,0.857,3,3,1,0,2,2
868,Devin Booker,20-103,G,2/10/17,PHO,,CHI,W,1,33,10,19,0.526,8,15,0.533,2,4,0.5,5,6,0.833,3,2,5
869,Devin Booker,20-065,G,1/3/17,PHO,,MIA,W,1,35,9,19,0.474,6,13,0.462,3,6,0.5,6,7,0.857,1,1,2
870,Devin Booker,20-117,G,2/24/17,PHO,@,CHI,L,1,41,10,21,0.476,8,17,0.471,2,4,0.5,5,8,0.625,0,3,3
871,Trey Burke,24-048,G,12/30/16,WAS,,BRK,W,0,30,10,12,0.833,5,7,0.714,5,5,1,2,2,1,0,2,2
872,Jimmy Butler,27-062,G-F,11/15/16,CHI,@,POR,W,1,34,9,16,0.563,8,15,0.533,1,1,1,8,8,1,3,9,12
873,Jimmy Butler,27-173,G-F,3/6/17,CHI,@,DET,L,1,39,7,16,0.438,6,10,0.6,1,6,0.167,12,13,0.923,3,6,9
874,Jimmy Butler,27-090,G-F,12/13/16,CHI,,MIN,L,1,39,9,22,0.409,8,20,0.4,1,2,0.5,8,9,0.889,1,8,9
875,Kentavious Caldwell-Pope,23-265,G,11/9/16,DET,@,PHO,L,1,42,9,22,0.409,4,12,0.333,5,10,0.5,4,5,0.8,1,5,6
876,Wilson Chandler,29-211,F,12/7/16,DEN,@,BRK,L,0,35,10,24,0.417,4,13,0.308,6,11,0.545,1,3,0.333,5,10,15
877,Marquese Chriss,19-217,F,2/4/17,PHO,,MIL,L,1,24,9,15,0.6,6,10,0.6,3,5,0.6,6,9,0.667,3,3,6
878,Mike Conley,29-087,G,1/6/17,MEM,@,GSW,W,1,41,10,19,0.526,7,10,0.7,3,9,0.333,4,5,0.8,0,4,4
879,Mike Conley,29-155,G,3/15/17,MEM,@,CHI,W,1,36,8,12,0.667,3,4,0.75,5,8,0.625,6,6,1,0,9,9
880,DeMarcus Cousins,26-194,C-F,2/23/17,NOP,,HOU,L,1,35,11,19,0.579,10,14,0.714,1,5,0.2,4,5,0.8,4,10,14
881,Jamal Crawford,36-310,G,1/24/17,LAC,@,PHI,L,0,33,9,14,0.643,3,5,0.6,6,9,0.667,3,3,1,0,1,1
882,Stephen Curry,28-314,G,1/22/17,GSW,@,ORL,W,1,30,8,15,0.533,1,2,0.5,7,13,0.538,4,4,1,1,3,4
883,Stephen Curry,28-348,G,2/25/17,GSW,,BRK,W,1,35,9,21,0.429,4,11,0.364,5,10,0.5,4,4,1,1,4,5
884,Anthony Davis,24-004,F-C,3/15/17,NOP,@,MIA,L,1,35,7,17,0.412,7,16,0.438,0,1,0,13,18,0.722,2,6,8
885,DeMar DeRozan,27-123,G,12/8/16,TOR,,MIN,W,1,37,7,20,0.35,6,19,0.316,1,1,1,12,13,0.923,1,7,8
886,Goran Dragic,30-209,G,12/1/16,MIA,@,UTA,W,1,37,10,21,0.476,8,18,0.444,2,3,0.667,5,7,0.714,2,2,4
887,Goran Dragic,30-206,G,11/28/16,MIA,,BOS,L,1,38,8,15,0.533,8,13,0.615,0,2,0,11,12,0.917,0,2,2
888,Goran Dragic,30-271,G,2/1/17,MIA,,ATL,W,1,30,8,13,0.615,4,8,0.5,4,5,0.8,7,9,0.778,0,5,5
889,Kevin Durant,28-151,F-G,2/27/17,GSW,@,PHI,W,1,33,8,17,0.471,7,13,0.538,1,4,0.25,10,11,0.909,3,5,8
890,Kevin Durant,28-075,F-G,12/13/16,GSW,@,NOP,W,1,37,10,19,0.526,9,16,0.563,1,3,0.333,6,7,0.857,0,2,2
891,Kevin Durant,28-026,F-G,10/25/16,GSW,,SAS,L,1,37,11,18,0.611,10,15,0.667,1,3,0.333,4,5,0.8,0,10,10
892,Kevin Durant,28-036,F-G,11/4/16,GSW,@,LAL,L,1,35,10,16,0.625,8,12,0.667,2,4,0.5,5,8,0.625,1,4,5
893,Kevin Durant,28-099,F-G,1/6/17,GSW,,MEM,L,1,43,7,17,0.412,7,12,0.583,0,5,0,13,18,0.722,2,11,13
894,Kevin Durant,28-116,F-G,1/23/17,GSW,@,MIA,L,1,36,12,23,0.522,11,15,0.733,1,8,0.125,2,2,1,0,6,6
895,Joel Embiid,22-282,C-F,12/23/16,PHI,@,PHO,L,1,28,8,15,0.533,7,12,0.583,1,3,0.333,10,11,0.909,0,7,7
896,Evan Fournier,24-029,G-F,11/27/16,ORL,,MIL,L,1,38,11,21,0.524,8,11,0.727,3,10,0.3,2,3,0.667,2,4,6
897,Danilo Gallinari,28-129,F,12/15/16,DEN,,POR,W,1,36,8,13,0.615,5,7,0.714,3,6,0.5,8,8,1,0,4,4
898,Marc Gasol,31-299,C,11/23/16,MEM,@,PHI,W,1,45,10,20,0.5,8,15,0.533,2,5,0.4,5,6,0.833,3,1,4
899,Marc Gasol,32-045,C,3/15/17,MEM,@,CHI,W,1,37,10,21,0.476,7,15,0.467,3,6,0.5,4,5,0.8,0,6,6
900,Paul George,26-287,F,2/13/17,IND,,SAS,L,1,37,8,15,0.533,4,8,0.5,4,7,0.571,7,8,0.875,0,6,6
901,Paul George,26-231,F,12/19/16,IND,,WAS,W,1,40,10,21,0.476,8,15,0.533,2,6,0.333,5,6,0.833,2,7,9
902,Rudy Gobert,24-208,C,1/20/17,UTA,@,DAL,W,1,41,8,11,0.727,8,11,0.727,0,0,,11,17,0.647,10,15,25
903,Eric Gordon,27-323,G,11/12/16,HOU,,SAS,L,0,32,10,16,0.625,3,4,0.75,7,12,0.583,0,0,,0,5,5
904,Blake Griffin,27-261,F,12/2/16,LAC,@,NOP,W,1,34,12,22,0.545,11,20,0.55,1,2,0.5,2,3,0.667,1,8,9
905,Blake Griffin,27-225,F,10/27/16,LAC,@,POR,W,1,37,9,22,0.409,8,19,0.421,1,3,0.333,8,9,0.889,5,8,13
906,James Harden,27-117,G,12/21/16,HOU,@,PHO,W,1,35,8,18,0.444,3,7,0.429,5,11,0.455,6,8,0.75,1,4,5
907,James Harden,27-140,G,1/13/17,HOU,,MEM,L,1,37,6,14,0.429,4,7,0.571,2,7,0.286,13,14,0.929,0,3,3
908,Gordon Hayward,26-355,F-G,3/13/17,UTA,,LAC,W,1,36,9,18,0.5,5,13,0.385,4,5,0.8,5,7,0.714,0,3,3
909,Gordon Hayward,26-315,F-G,2/1/17,UTA,,MIL,W,1,32,8,13,0.615,5,7,0.714,3,6,0.5,8,10,0.8,1,3,4
910,Gordon Hayward,26-304,F-G,1/21/17,UTA,,IND,W,1,31,8,13,0.615,6,10,0.6,2,3,0.667,9,10,0.9,0,2,2
911,Juan Hernangomez,21-138,F,2/13/17,DEN,,GSW,W,1,43,9,17,0.529,3,7,0.429,6,10,0.6,3,4,0.75,3,7,10
912,Rodney Hood,24-085,G-F,1/13/17,UTA,,DET,W,1,29,10,14,0.714,3,6,0.5,7,8,0.875,0,0,,0,4,4
913,Al Horford,30-289,C-F,3/19/17,BOS,@,PHI,L,1,33,11,16,0.688,10,14,0.714,1,2,0.5,4,5,0.8,1,7,8
914,Dwight Howard,31-008,C,12/16/16,ATL,@,TOR,W,1,34,10,13,0.769,10,13,0.769,0,0,,7,10,0.7,7,8,15
915,Kyrie Irving,24-351,G,3/9/17,CLE,@,DET,L,1,40,11,22,0.5,10,16,0.625,1,6,0.167,4,6,0.667,1,4,5
916,Kyrie Irving,24-325,G,2/11/17,CLE,,DEN,W,1,35,10,24,0.417,5,13,0.385,5,11,0.455,2,2,1,1,3,4
917,Kyrie Irving,24-291,G,1/8/17,CLE,@,PHO,W,1,40,10,20,0.5,6,13,0.462,4,7,0.571,3,3,1,1,1,2
918,Reggie Jackson,26-260,G,1/1/17,DET,@,MIA,W,1,33,10,17,0.588,8,12,0.667,2,5,0.4,5,5,1,0,2,2
919,LeBron James,32-033,F-G,2/1/17,CLE,,MIN,W,1,34,11,14,0.786,10,12,0.833,1,2,0.5,4,7,0.571,0,8,8
920,LeBron James,31-345,F-G,12/9/16,CLE,,MIA,W,1,37,12,22,0.545,11,19,0.579,1,3,0.333,2,4,0.5,2,6,8
921,LeBron James,32-043,F-G,2/11/17,CLE,,DEN,W,1,33,11,16,0.688,10,15,0.667,1,1,1,4,4,1,0,5,5
922,LeBron James,31-338,F-G,12/2/16,CLE,@,CHI,L,1,45,13,22,0.591,12,19,0.632,1,3,0.333,0,0,,0,5,5
923,LeBron James,31-317,F-G,11/11/16,CLE,@,WAS,W,1,38,9,18,0.5,6,14,0.429,3,4,0.75,6,9,0.667,0,10,10
924,Joe Johnson,35-224,G-F,2/8/17,UTA,@,NOP,W,0,24,10,14,0.714,4,6,0.667,6,8,0.75,1,1,1,1,2,3
925,Tyler Johnson,24-214,G,12/7/16,MIA,@,ATL,L,0,35,8,16,0.5,4,11,0.364,4,5,0.8,7,8,0.875,0,2,2
926,Nikola Jokic,21-304,C-F,12/19/16,DEN,,DAL,W,1,38,13,17,0.765,12,16,0.75,1,1,1,0,0,,3,12,15
927,Nikola Jokic,21-358,C-F,2/11/17,DEN,@,CLE,L,1,38,9,18,0.5,8,16,0.5,1,2,0.5,8,10,0.8,6,7,13
928,Nikola Jokic,21-297,C-F,12/12/16,DEN,@,DAL,L,0,26,10,12,0.833,10,12,0.833,0,0,,7,7,1,7,4,11
929,Frank Kaminsky,23-317,F-C,2/15/17,CHO,@,TOR,L,1,37,11,18,0.611,8,11,0.727,3,7,0.429,2,2,1,0,5,5
930,Enes Kanter,24-192,C,11/28/16,OKC,@,NYK,W,0,28,12,17,0.706,12,16,0.75,0,1,0,3,5,0.6,6,4,10
931,Sean Kilpatrick,27-061,G,3/8/17,BRK,@,ATL,L,0,30,8,14,0.571,5,7,0.714,3,7,0.429,8,9,0.889,0,4,4
932,Kawhi Leonard,25-176,F,12/22/16,SAS,@,LAC,L,1,34,8,19,0.421,7,16,0.438,1,3,0.333,10,11,0.909,4,5,9
933,Kawhi Leonard,25-123,F,10/30/16,SAS,@,MIA,W,1,30,8,16,0.5,7,13,0.538,1,3,0.333,10,12,0.833,0,2,2
934,Damian Lillard,26-110,G,11/2/16,POR,@,PHO,L,1,40,9,22,0.409,8,14,0.571,1,8,0.125,8,10,0.8,0,5,5
935,Damian Lillard,26-200,G,1/31/17,POR,,CHO,W,1,31,10,18,0.556,8,13,0.615,2,5,0.4,5,5,1,0,4,4
936,Damian Lillard,26-135,G,11/27/16,POR,,HOU,L,1,38,7,20,0.35,5,12,0.417,2,8,0.25,11,13,0.846,1,4,5
937,Damian Lillard,26-133,G,11/25/16,POR,,NOP,W,1,36,9,19,0.474,6,12,0.5,3,7,0.429,6,7,0.857,0,4,4
938,Damian Lillard,26-246,G,3/18/17,POR,@,ATL,W,1,34,9,17,0.529,6,12,0.5,3,5,0.6,6,6,1,0,5,5
939,Damian Lillard,26-126,G,11/18/16,POR,@,NOP,L,1,36,8,24,0.333,4,13,0.308,4,11,0.364,7,7,1,2,1,3
940,Brook Lopez,28-352,C,3/19/17,BRK,,DAL,L,1,33,8,18,0.444,5,12,0.417,3,6,0.5,8,10,0.8,4,3,7
941,Brook Lopez,28-242,C,11/29/16,BRK,,LAC,W,1,43,11,20,0.55,7,11,0.636,4,9,0.444,1,1,1,3,5,8
942,Kevin Love,28-101,F,12/17/16,CLE,,LAL,W,1,33,11,20,0.55,8,13,0.615,3,7,0.429,2,3,0.667,3,14,17
943,Kevin Love,28-079,F,11/25/16,CLE,,DAL,W,1,28,8,14,0.571,1,5,0.2,7,9,0.778,4,4,1,1,9,10
944,Kevin Love,28-070,F,11/16/16,CLE,@,IND,L,1,33,11,23,0.478,7,13,0.538,4,10,0.4,1,4,0.25,3,13,16
945,Kyle Lowry,30-278,G,12/28/16,TOR,@,GSW,L,1,40,9,22,0.409,4,10,0.4,5,12,0.417,4,5,0.8,2,4,6
946,Kyle Lowry,30-276,G,12/26/16,TOR,@,POR,W,1,40,8,18,0.444,3,5,0.6,5,13,0.385,6,7,0.857,1,5,6
947,Kyle Lowry,30-241,G,11/21/16,TOR,@,LAC,L,1,42,8,18,0.444,5,11,0.455,3,7,0.429,8,9,0.889,0,6,6
948,Kyle Lowry,30-288,G,1/7/17,TOR,@,CHI,L,1,44,7,17,0.412,5,8,0.625,2,9,0.222,11,14,0.786,2,7,9
949,Kyle Lowry,30-266,G,12/16/16,TOR,,ATL,L,1,37,9,16,0.563,3,8,0.375,6,8,0.75,3,6,0.5,0,2,2
950,Wesley Matthews,30-112,G,2/3/17,DAL,@,POR,W,1,40,8,17,0.471,5,11,0.455,3,6,0.5,8,9,0.889,0,6,6
951,C.J. McCollum,25-108,G,1/5/17,POR,,LAL,W,1,35,11,21,0.524,8,10,0.8,3,11,0.273,2,2,1,1,3,4
952,C.J. McCollum,25-114,G,1/11/17,POR,,CLE,W,1,32,11,20,0.55,6,10,0.6,5,10,0.5,0,0,,0,4,4
953,Paul Millsap,32-021,F,3/3/17,ATL,,CLE,L,1,37,9,16,0.563,8,12,0.667,1,4,0.25,8,10,0.8,2,7,9
954,Jabari Parker,21-325,F,2/3/17,MIL,@,DEN,L,1,35,10,20,0.5,8,13,0.615,2,7,0.286,5,5,1,1,10,11
955,Jabari Parker,21-291,F,12/31/16,MIL,@,CHI,W,1,40,10,15,0.667,9,12,0.75,1,3,0.333,6,6,1,0,5,5
956,Jabari Parker,21-272,F,12/12/16,MIL,@,TOR,L,1,35,11,17,0.647,9,14,0.643,2,3,0.667,3,5,0.6,2,1,3
957,Jabari Parker,21-233,F,11/3/16,MIL,,IND,W,1,33,11,17,0.647,7,11,0.636,4,6,0.667,1,1,1,3,5,8
958,Jabari Parker,21-269,F,12/9/16,MIL,,ATL,L,1,39,11,24,0.458,8,17,0.471,3,7,0.429,2,4,0.5,2,2,4
959,Jabari Parker,21-267,F,12/7/16,MIL,,POR,W,1,34,11,23,0.478,10,18,0.556,1,5,0.2,4,5,0.8,0,3,3
960,Jabari Parker,21-281,F,12/21/16,MIL,@,CLE,L,1,29,11,20,0.55,7,15,0.467,4,5,0.8,1,1,1,0,1,1
961,Chris Paul,31-182,G,11/4/16,LAC,@,MEM,W,1,33,6,16,0.375,5,8,0.625,1,8,0.125,14,15,0.933,1,3,4
962,Chris Paul,31-319,G,3/21/17,LAC,@,LAL,W,1,25,9,15,0.6,5,7,0.714,4,8,0.5,5,5,1,2,6,8
963,Chris Paul,31-174,G,10/27/16,LAC,@,POR,W,1,33,9,19,0.474,6,11,0.545,3,8,0.375,6,7,0.857,0,5,5
964,Mason Plumlee,26-290,C-F,12/20/16,POR,@,SAC,L,1,36,10,13,0.769,10,12,0.833,0,1,0,7,11,0.636,4,9,13
965,Kristaps Porzingis,21-094,F-C,11/4/16,NYK,@,CHI,W,1,33,10,15,0.667,6,8,0.75,4,7,0.571,3,5,0.6,2,3,5
966,Kristaps Porzingis,21-190,F-C,2/8/17,NYK,,LAC,L,1,27,10,19,0.526,6,12,0.5,4,7,0.571,3,4,0.75,4,2,6
967,Zach Randolph,35-174,F,1/6/17,MEM,@,GSW,W,0,35,12,17,0.706,11,16,0.688,1,1,1,2,2,1,4,7,11
968,J.J. Redick,32-179,G,12/20/16,LAC,,DEN,W,1,26,10,16,0.625,3,7,0.429,7,9,0.778,0,0,,0,3,3
969,Austin Rivers,24-175,G,1/23/17,LAC,@,ATL,W,1,41,10,21,0.476,5,11,0.455,5,10,0.5,2,2,1,0,4,4
970,Derrick Rose,28-044,G,11/17/16,NYK,@,WAS,L,1,39,8,18,0.444,5,13,0.385,3,5,0.6,8,8,1,2,0,2
971,Dennis Schroder,23-104,G,12/28/16,ATL,,NYK,W,1,40,11,21,0.524,10,18,0.556,1,3,0.333,4,6,0.667,0,0,0
972,Dennis Schroder,23-099,G,12/23/16,ATL,@,DEN,W,1,36,9,19,0.474,7,15,0.467,2,4,0.5,7,7,1,0,6,6
973,Isaiah Thomas,27-322,G,12/25/16,BOS,@,NYK,W,1,33,9,23,0.391,6,10,0.6,3,13,0.231,6,8,0.75,0,3,3
974,Isaiah Thomas,27-297,G,11/30/16,BOS,,DET,L,1,33,10,20,0.5,7,13,0.538,3,7,0.429,4,4,1,0,0,0
975,Isaiah Thomas,27-338,G,1/10/17,BOS,@,TOR,L,1,37,8,19,0.421,5,11,0.455,3,8,0.375,8,9,0.889,0,1,1
976,Isaiah Thomas,28-036,G,3/15/17,BOS,,MIN,W,1,32,8,15,0.533,4,6,0.667,4,9,0.444,7,7,1,0,3,3
977,Klay Thompson,26-356,G,1/29/17,GSW,@,POR,W,1,35,6,21,0.286,4,15,0.267,2,6,0.333,13,15,0.867,1,5,6
978,Karl-Anthony Towns,21-006,F-C,11/21/16,MIN,,BOS,L,1,38,11,19,0.579,9,15,0.6,2,4,0.5,3,6,0.5,6,12,18
979,Karl-Anthony Towns,21-018,F-C,12/3/16,MIN,@,CHO,W,1,34,10,22,0.455,10,20,0.5,0,2,0,7,7,1,4,11,15
980,Karl-Anthony Towns,21-081,F-C,2/4/17,MIN,,MEM,L,1,38,8,15,0.533,6,11,0.545,2,4,0.5,9,10,0.9,5,10,15
981,Karl-Anthony Towns,21-063,F-C,1/17/17,MIN,@,SAS,L,1,43,10,18,0.556,8,16,0.5,2,2,1,5,5,1,4,12,16
982,Dion Waiters,24-340,G,11/14/16,MIA,@,SAS,L,1,36,12,26,0.462,9,20,0.45,3,6,0.5,0,0,,0,2,2
983,Kemba Walker,26-300,G,3/4/17,CHO,@,DEN,W,1,38,8,21,0.381,3,12,0.25,5,9,0.556,6,6,1,1,3,4
984,John Wall,26-119,G,1/3/17,WAS,@,DAL,L,1,39,10,19,0.526,9,16,0.563,1,3,0.333,6,6,1,0,4,4
985,John Wall,26-071,G,11/16/16,WAS,@,PHI,L,1,24,8,19,0.421,7,16,0.438,1,3,0.333,10,12,0.833,0,4,4
986,John Wall,26-188,G,3/13/17,WAS,@,MIN,L,1,38,6,16,0.375,5,13,0.385,1,3,0.333,14,19,0.737,0,2,2
987,John Wall,26-140,G,1/24/17,WAS,,BOS,W,1,38,11,20,0.55,10,18,0.556,1,2,0.5,4,5,0.8,0,7,7
988,T.J. Warren,23-058,F,11/2/16,PHO,,POR,W,1,38,11,22,0.5,11,22,0.5,0,0,,5,5,1,4,3,7
989,Russell Westbrook,28-027,G,12/9/16,OKC,,HOU,L,1,36,8,25,0.32,8,18,0.444,0,7,0,11,12,0.917,1,9,10
990,Russell Westbrook,28-074,G,1/25/17,OKC,@,NOP,W,1,36,7,22,0.318,3,13,0.231,4,9,0.444,9,12,0.75,1,11,12
991,Russell Westbrook,28-086,G,2/6/17,OKC,@,IND,L,1,37,10,27,0.37,6,17,0.353,4,10,0.4,3,4,0.75,2,16,18
992,Russell Westbrook,28-067,G,1/18/17,OKC,@,GSW,L,1,35,8,23,0.348,7,17,0.412,1,6,0.167,10,11,0.909,4,11,15
993,Russell Westbrook,28-016,G,11/28/16,OKC,@,NYK,W,1,36,9,23,0.391,7,20,0.35,2,3,0.667,7,7,1,5,12,17
994,Russell Westbrook,28-032,G,12/14/16,OKC,@,UTA,L,1,31,7,25,0.28,5,20,0.25,2,5,0.4,11,13,0.846,1,5,6
995,Russell Westbrook,28-080,G,1/31/17,OKC,@,SAS,L,1,34,7,17,0.412,4,10,0.4,3,7,0.429,10,10,1,1,5,6
996,Hassan Whiteside,27-139,C,10/30/16,MIA,,SAS,L,1,35,10,15,0.667,10,15,0.667,0,0,,7,10,0.7,1,14,15
997,Andrew Wiggins,21-355,F-G,2/12/17,MIN,,CHI,W,1,34,10,19,0.526,8,14,0.571,2,5,0.4,5,6,0.833,2,4,6
998,Andrew Wiggins,21-349,F-G,2/6/17,MIN,,MIA,L,1,37,11,23,0.478,9,19,0.474,2,4,0.5,3,3,1,1,3,4
999,Andrew Wiggins,22-004,F-G,2/27/17,MIN,@,SAC,W,1,35,10,22,0.455,9,19,0.474,1,3,0.333,6,8,0.75,2,2,4
1000,Andrew Wiggins,21-331,F-G,1/19/17,MIN,@,LAC,W,1,38,9,19,0.474,8,17,0.471,1,2,0.5,8,10,0.8,1,3,4
1001,Andrew Wiggins,22-001,F-G,2/24/17,MIN,,DAL,W,1,38,11,21,0.524,10,18,0.556,1,3,0.333,4,5,0.8,2,5,7
1002,Andrew Wiggins,21-342,F-G,1/30/17,MIN,,ORL,W,1,41,10,21,0.476,9,18,0.5,1,3,0.333,6,8,0.75,2,1,3
1003,Lou Williams,30-119,G,2/23/17,HOU,@,NOP,W,0,25,9,16,0.563,2,5,0.4,7,11,0.636,2,2,1,1,1,2
1004,Lou Williams,30-056,G,12/22/16,LAL,@,MIA,L,0,28,8,17,0.471,5,10,0.5,3,7,0.429,8,8,1,0,2,2
1005,Lou Williams,30-085,G,1/20/17,LAL,,IND,W,0,30,7,15,0.467,3,7,0.429,4,8,0.5,9,10,0.9,0,4,4
1006,Marvin Williams,30-265,F,3/11/17,CHO,,NOP,L,1,40,12,20,0.6,10,12,0.833,2,8,0.25,1,1,1,3,7,10
1007,LaMarcus Aldridge,31-098,F-C,10/25/16,SAS,@,GSW,W,1,35,10,20,0.5,9,19,0.474,1,1,1,5,6,0.833,8,6,14
1008,LaMarcus Aldridge,31-245,F-C,3/21/17,SAS,@,MIN,W,1,38,12,24,0.5,12,24,0.5,0,0,,2,2,1,3,2,5
1009,Al-Farouq Aminu,26-141,F,2/9/17,POR,,BOS,L,0,31,8,12,0.667,5,7,0.714,3,5,0.6,7,9,0.778,0,5,5
1010,Giannis Antetokounmpo,22-101,F-G,3/17/17,MIL,@,LAL,W,1,35,11,16,0.688,10,15,0.667,1,1,1,3,6,0.5,2,6,8
1011,Giannis Antetokounmpo,21-346,F-G,11/16/16,MIL,@,ATL,L,1,40,11,22,0.5,11,20,0.55,0,2,0,4,6,0.667,4,11,15
1012,Giannis Antetokounmpo,22-027,F-G,1/2/17,MIL,,OKC,W,1,41,10,19,0.526,9,16,0.563,1,3,0.333,5,10,0.5,2,8,10
1013,Carmelo Anthony,32-247,F,1/31/17,NYK,@,WAS,L,1,32,10,17,0.588,9,14,0.643,1,3,0.333,5,5,1,1,4,5
1014,Carmelo Anthony,32-215,F,12/30/16,NYK,@,NOP,L,1,40,8,22,0.364,7,17,0.412,1,5,0.2,9,10,0.9,1,12,13
1015,Carmelo Anthony,32-239,F,1/23/17,NYK,@,IND,W,1,34,9,17,0.529,8,14,0.571,1,3,0.333,7,8,0.875,1,4,5
1016,Carmelo Anthony,32-253,F,2/6/17,NYK,,LAL,L,1,37,10,17,0.588,10,15,0.667,0,2,0,6,8,0.75,0,3,3
1017,Carmelo Anthony,32-222,F,1/6/17,NYK,@,MIL,W,1,39,8,20,0.4,4,15,0.267,4,5,0.8,6,9,0.667,0,6,6
1018,Harrison Barnes,24-253,F,2/7/17,DAL,,POR,L,1,38,10,19,0.526,9,16,0.563,1,3,0.333,5,8,0.625,0,5,5
1019,Harrison Barnes,24-218,F,1/3/17,DAL,,WAS,W,1,35,8,18,0.444,6,14,0.429,2,4,0.5,8,9,0.889,0,7,7
1020,Will Barton,26-011,G,1/17/17,DEN,@,LAL,W,1,35,9,16,0.563,4,11,0.364,5,5,1,3,5,0.6,1,3,4
1021,Bradley Beal,23-194,G,1/8/17,WAS,@,MIL,W,1,36,10,19,0.526,8,9,0.889,2,10,0.2,4,5,0.8,1,3,4
1022,Bradley Beal,23-256,G,3/11/17,WAS,@,POR,W,1,33,9,18,0.5,4,8,0.5,5,10,0.5,3,4,0.75,0,1,1
1023,Bradley Beal,23-163,G,12/8/16,WAS,,DEN,W,1,37,8,15,0.533,4,8,0.5,4,7,0.571,6,6,1,0,3,3
1024,Eric Bledsoe,27-027,G,1/5/17,PHO,@,DAL,W,1,30,9,16,0.563,7,9,0.778,2,7,0.286,6,7,0.857,0,0,0
1025,Bojan Bogdanovic,27-194,G-F,10/29/16,BRK,@,MIL,L,1,31,9,15,0.6,7,9,0.778,2,6,0.333,6,6,1,2,6,8
1026,Bojan Bogdanovic,27-252,G-F,12/26/16,BRK,,CHO,W,0,27,7,11,0.636,3,4,0.75,4,7,0.571,8,9,0.889,1,3,4
1027,Devin Booker,20-086,G,1/24/17,PHO,,MIN,L,1,43,9,23,0.391,5,16,0.313,4,7,0.571,4,4,1,0,2,2
1028,Devin Booker,20-083,G,1/21/17,PHO,@,NYK,W,1,37,10,21,0.476,7,17,0.412,3,4,0.75,3,3,1,1,0,1
1029,Avery Bradley,25-343,G,11/3/16,BOS,@,CLE,L,1,39,11,20,0.55,9,14,0.643,2,6,0.333,2,2,1,1,9,10
1030,Avery Bradley,26-041,G,1/6/17,BOS,,PHI,W,1,36,10,24,0.417,4,13,0.308,6,11,0.545,0,0,,2,7,9
1031,Jimmy Butler,27-051,G-F,11/4/16,CHI,,NYK,L,1,37,7,15,0.467,6,11,0.545,1,4,0.25,11,11,1,2,3,5
1032,Jimmy Butler,27-100,G-F,12/23/16,CHI,@,CHO,L,1,39,11,19,0.579,9,15,0.6,2,4,0.5,2,2,1,0,4,4
1033,Jimmy Butler,27-082,G-F,12/5/16,CHI,,POR,L,1,37,8,16,0.5,6,12,0.5,2,4,0.5,8,8,1,2,5,7
1034,Jimmy Butler,27-080,G-F,12/3/16,CHI,@,DAL,L,1,36,8,18,0.444,8,15,0.533,0,3,0,10,12,0.833,1,8,9
1035,Jimmy Butler,27-079,G-F,12/2/16,CHI,,CLE,W,1,42,8,20,0.4,8,17,0.471,0,3,0,10,12,0.833,3,5,8
1036,Jimmy Butler,27-108,G-F,12/31/16,CHI,,MIL,L,1,38,7,16,0.438,5,10,0.5,2,6,0.333,10,15,0.667,3,4,7
1037,Jimmy Butler,27-072,G-F,11/25/16,CHI,@,PHI,W,1,31,10,15,0.667,9,13,0.692,1,2,0.5,5,6,0.833,1,3,4
1038,Kentavious Caldwell-Pope,24-014,G,3/4/17,DET,@,PHI,W,1,31,9,11,0.818,6,6,1,3,5,0.6,5,6,0.833,1,2,3
1039,Kentavious Caldwell-Pope,23-277,G,11/21/16,DET,,HOU,L,1,38,9,15,0.6,6,9,0.667,3,6,0.5,5,7,0.714,0,1,1
1040,Kentavious Caldwell-Pope,23-325,G,1/8/17,DET,@,POR,W,1,48,9,14,0.643,5,7,0.714,4,7,0.571,4,5,0.8,2,2,4
1041,DeMarre Carroll,30-165,F,1/8/17,TOR,,HOU,L,1,34,7,12,0.583,1,2,0.5,6,10,0.6,6,6,1,0,8,8
1042,Wilson Chandler,29-266,F,1/31/17,DEN,@,LAL,L,0,36,10,20,0.5,6,14,0.429,4,6,0.667,2,2,1,4,5,9
1043,Darren Collison,29-157,G,1/27/17,SAC,@,IND,L,1,46,10,17,0.588,6,11,0.545,4,6,0.667,2,2,1,1,3,4
1044,Darren Collison,29-169,G,2/8/17,SAC,,BOS,W,1,38,12,21,0.571,10,17,0.588,2,4,0.5,0,0,,0,1,1
1045,Darren Collison,29-133,G,1/3/17,SAC,@,DEN,W,1,36,10,16,0.625,8,11,0.727,2,5,0.4,4,4,1,1,1,2
1046,DeMarcus Cousins,26-204,C-F,3/5/17,NOP,@,LAL,W,1,31,9,21,0.429,6,16,0.375,3,5,0.6,5,6,0.833,4,11,15
1047,DeMarcus Cousins,26-095,C-F,11/16/16,SAC,,SAS,L,1,37,7,16,0.438,6,12,0.5,1,4,0.25,11,14,0.786,3,14,17
1048,DeMarcus Cousins,26-140,C-F,12/31/16,SAC,,MEM,L,1,38,7,18,0.389,7,15,0.467,0,3,0,12,13,0.923,2,2,4
1049,DeMarcus Cousins,26-153,C-F,1/13/17,SAC,,CLE,L,1,39,9,16,0.563,8,11,0.727,1,5,0.2,7,9,0.778,0,7,7
1050,DeMarcus Cousins,26-167,C-F,1/27/17,SAC,@,IND,L,1,39,8,17,0.471,7,12,0.583,1,5,0.2,9,14,0.643,3,13,16
1051,Robert Covington,26-000,F,12/14/16,PHI,,TOR,L,1,31,10,20,0.5,7,13,0.538,3,7,0.429,3,4,0.75,7,5,12
1052,Jamal Crawford,36-278,G,12/23/16,LAC,,DAL,L,0,30,10,16,0.625,7,11,0.636,3,5,0.6,3,3,1,0,1,1
1053,Stephen Curry,28-334,G,2/11/17,GSW,@,OKC,W,1,34,9,19,0.474,5,8,0.625,4,11,0.364,4,4,1,3,5,8
1054,Stephen Curry,28-225,G,10/25/16,GSW,,SAS,L,1,34,9,18,0.5,6,8,0.75,3,10,0.3,5,6,0.833,0,3,3
1055,Stephen Curry,28-361,G,3/10/17,GSW,@,MIN,L,1,35,10,27,0.37,9,19,0.474,1,8,0.125,5,5,1,3,3,6
1056,Stephen Curry,28-269,G,12/8/16,GSW,@,UTA,W,1,36,7,16,0.438,4,7,0.571,3,9,0.333,9,9,1,0,5,5
1057,Anthony Davis,23-272,F-C,12/8/16,NOP,,PHI,L,1,41,8,21,0.381,8,19,0.421,0,2,0,10,12,0.833,1,10,11
1058,DeMar DeRozan,27-189,G,2/12/17,TOR,,DET,L,1,38,10,21,0.476,10,20,0.5,0,1,0,6,7,0.857,1,6,7
1059,DeMar DeRozan,27-110,G,11/25/16,TOR,@,MIL,W,1,35,9,18,0.5,9,16,0.563,0,2,0,8,10,0.8,1,6,7
1060,DeMar DeRozan,27-149,G,1/3/17,TOR,@,SAS,L,1,32,12,21,0.571,12,21,0.571,0,0,,2,3,0.667,1,3,4
1061,DeMar DeRozan,27-100,G,11/15/16,TOR,@,CLE,L,1,34,10,27,0.37,8,22,0.364,2,5,0.4,4,8,0.5,1,5,6
1062,Goran Dragic,30-266,G,1/27/17,MIA,@,CHI,W,1,34,12,20,0.6,11,16,0.688,1,4,0.25,1,1,1,1,4,5
1063,Andre Drummond,23-119,C,12/7/16,DET,@,CHO,L,1,34,11,14,0.786,11,14,0.786,0,0,,4,7,0.571,2,18,20
1064,Kevin Durant,28-126,F-G,2/2/17,GSW,@,LAC,W,1,37,8,18,0.444,6,11,0.545,2,7,0.286,8,8,1,0,8,8
1065,Kevin Durant,28-084,F-G,12/22/16,GSW,@,BRK,W,1,34,10,23,0.435,9,16,0.563,1,7,0.143,5,6,0.833,0,9,9
1066,Joel Embiid,22-308,C-F,1/18/17,PHI,,TOR,W,1,27,6,13,0.462,4,8,0.5,2,5,0.4,12,14,0.857,0,9,9
1067,Joel Embiid,22-248,C-F,11/19/16,PHI,,PHO,W,1,20,9,14,0.643,6,9,0.667,3,5,0.6,5,6,0.833,0,7,7
1068,Tyreke Evans,27-170,G-F,3/8/17,SAC,@,SAS,L,1,29,9,13,0.692,6,9,0.667,3,4,0.75,5,7,0.714,1,1,2
1069,Raymond Felton,32-187,G,12/30/16,LAC,@,HOU,L,0,31,10,20,0.5,6,13,0.462,4,7,0.571,2,2,1,1,4,5
1070,Evan Fournier,24-052,G-F,12/20/16,ORL,@,MIA,W,1,44,11,22,0.5,8,17,0.471,3,5,0.6,1,2,0.5,0,5,5
1071,Langston Galloway,24-362,G,12/5/16,NOP,,MEM,L,0,36,9,18,0.5,3,5,0.6,6,13,0.462,2,2,1,0,1,1
1072,Marc Gasol,31-333,C,12/27/16,MEM,@,BOS,L,1,38,9,20,0.45,6,14,0.429,3,6,0.5,5,6,0.833,0,4,4
1073,Marc Gasol,31-312,C,12/6/16,MEM,,PHI,W,1,34,9,17,0.529,9,15,0.6,0,2,0,8,10,0.8,1,11,12
1074,Marc Gasol,31-292,C,11/16/16,MEM,@,LAC,W,1,37,10,21,0.476,6,16,0.375,4,5,0.8,2,3,0.667,2,4,6
1075,Paul George,26-193,F,11/11/16,IND,@,PHI,L,1,40,9,20,0.45,8,16,0.5,1,4,0.25,7,7,1,3,5,8
1076,Paul George,26-248,F,1/5/17,IND,,BRK,W,1,31,10,18,0.556,8,14,0.571,2,4,0.5,4,6,0.667,0,1,1
1077,Paul George,26-229,F,12/17/16,IND,@,DET,W,1,34,11,21,0.524,9,15,0.6,2,6,0.333,2,3,0.667,1,6,7
1078,Jonathan Gibson,29-011,G,11/19/16,DAL,@,ORL,L,0,32,8,16,0.5,3,7,0.429,5,9,0.556,5,6,0.833,0,6,6
1079,Rudy Gobert,24-220,C,2/1/17,UTA,,MIL,W,1,34,9,13,0.692,9,13,0.692,0,0,,8,10,0.8,5,10,15
1080,Eric Gordon,27-338,G,11/27/16,HOU,@,POR,W,0,30,9,15,0.6,3,6,0.5,6,9,0.667,2,3,0.667,1,4,5
1081,Eric Gordon,27-348,G,12/7/16,HOU,,LAL,W,0,24,9,13,0.692,1,1,1,8,12,0.667,0,0,,0,4,4
1082,Blake Griffin,27-334,F,2/13/17,LAC,@,UTA,W,1,34,11,18,0.611,10,17,0.588,1,1,1,3,4,0.75,2,8,10
1083,Blake Griffin,27-355,F,3/6/17,LAC,,BOS,W,1,36,8,15,0.533,7,12,0.583,1,3,0.333,9,10,0.9,2,6,8
1084,Blake Griffin,27-277,F,12/18/16,LAC,@,WAS,L,1,38,10,21,0.476,10,21,0.476,0,0,,6,8,0.75,1,6,7
1085,Blake Griffin,27-327,F,2/6/17,LAC,@,TOR,L,1,37,11,19,0.579,9,16,0.563,2,3,0.667,2,3,0.667,4,7,11
1086,Blake Griffin,27-250,F,11/21/16,LAC,,TOR,W,1,36,10,17,0.588,10,17,0.588,0,0,,6,8,0.75,1,6,7
1087,Blake Griffin,27-271,F,12/12/16,LAC,,POR,W,1,40,12,25,0.48,12,25,0.48,0,0,,2,3,0.667,4,8,12
1088,Blake Griffin,27-248,F,11/19/16,LAC,,CHI,W,1,39,8,15,0.533,8,15,0.533,0,0,,10,10,1,2,11,13
1089,Tim Hardaway,24-231,G,11/2/16,ATL,,LAL,L,0,21,8,10,0.8,3,3,1,5,7,0.714,5,7,0.714,0,0,0
1090,James Harden,27-187,G,3/1/17,HOU,@,LAC,W,1,36,7,15,0.467,3,6,0.5,4,9,0.444,8,8,1,0,3,3
1091,James Harden,27-132,G,1/5/17,HOU,,OKC,W,1,38,6,16,0.375,4,9,0.444,2,7,0.286,12,14,0.857,1,7,8
1092,James Harden,27-083,G,11/17/16,HOU,,POR,W,1,32,7,17,0.412,4,9,0.444,3,8,0.375,9,11,0.818,1,11,12
1093,James Harden,27-063,G,10/28/16,HOU,@,DAL,W,1,36,9,18,0.5,5,9,0.556,4,9,0.444,4,5,0.8,1,6,7
1094,James Harden,27-095,G,11/29/16,HOU,@,UTA,L,1,35,8,23,0.348,6,17,0.353,2,6,0.333,8,10,0.8,3,2,5
1095,James Harden,27-150,G,1/23/17,HOU,@,MIL,L,1,40,6,10,0.6,4,6,0.667,2,4,0.5,12,14,0.857,0,8,8
1096,Gary Harris,22-175,G,3/8/17,DEN,,WAS,L,1,37,10,15,0.667,4,6,0.667,6,9,0.667,0,0,,1,1,2
1097,Tobias Harris,24-161,F,12/23/16,DET,,GSW,L,0,32,8,14,0.571,4,8,0.5,4,6,0.667,6,6,1,0,7,7
1098,Gordon Hayward,26-262,F-G,12/10/16,UTA,,SAC,W,1,32,9,19,0.474,6,12,0.5,3,7,0.429,5,5,1,0,7,7
1099,Gordon Hayward,26-303,F-G,1/20/17,UTA,@,DAL,W,1,38,8,22,0.364,5,15,0.333,3,7,0.429,7,8,0.875,2,5,7
1100,Jrue Holiday,26-231,G,1/29/17,NOP,,WAS,L,1,39,11,19,0.579,7,12,0.583,4,7,0.571,0,0,,2,2,4
1101,Jrue Holiday,26-231,G,1/29/17,NOP,,WAS,L,1,39,11,19,0.579,7,12,0.583,4,7,0.571,0,0,,2,2,4
1102,Rodney Hood,24-005,G-F,10/25/16,UTA,@,POR,L,1,38,9,17,0.529,6,10,0.6,3,7,0.429,5,5,1,0,2,2
1103,Al Horford,30-182,C-F,12/2/16,BOS,,SAC,W,1,36,10,18,0.556,6,11,0.545,4,7,0.571,2,2,1,2,6,8
1104,Kyrie Irving,24-302,G,1/19/17,CLE,,PHO,W,1,33,10,20,0.5,8,13,0.615,2,7,0.286,4,5,0.8,0,2,2
1105,Kyrie Irving,24-356,G,3/14/17,CLE,,DET,W,1,30,9,14,0.643,5,10,0.5,4,4,1,4,4,1,1,0,1
1106,Kyrie Irving,24-296,G,1/13/17,CLE,@,SAC,W,1,35,10,22,0.455,8,15,0.533,2,7,0.286,4,4,1,1,3,4
1107,Kyrie Irving,24-219,G,10/28/16,CLE,@,TOR,W,1,38,10,23,0.435,5,14,0.357,5,9,0.556,1,1,1,1,5,6
1108,Kyrie Irving,24-329,G,2/15/17,CLE,,IND,W,1,34,7,17,0.412,4,10,0.4,3,7,0.429,9,9,1,0,2,2
1109,Reggie Jackson,26-324,G,3/6/17,DET,,CHI,W,1,31,11,16,0.688,9,13,0.692,2,3,0.667,2,2,1,0,2,2
1110,Reggie Jackson,26-277,G,1/18/17,DET,,ATL,W,1,32,10,20,0.5,8,16,0.5,2,4,0.5,4,4,1,2,3,5
1111,LeBron James,32-024,F-G,1/23/17,CLE,@,NOP,L,1,44,11,21,0.524,10,17,0.588,1,4,0.25,3,4,0.75,2,8,10
1112,LeBron James,31-353,F-G,12/17/16,CLE,,LAL,W,1,39,9,18,0.5,7,13,0.538,2,5,0.4,6,11,0.545,1,6,7
1113,LeBron James,31-333,F-G,11/27/16,CLE,@,PHI,W,1,42,9,19,0.474,8,15,0.533,1,4,0.25,7,9,0.778,2,8,10
1114,LeBron James,32-003,F-G,1/2/17,CLE,,NOP,W,1,39,9,21,0.429,9,17,0.529,0,4,0,8,10,0.8,2,5,7
1115,James Johnson,29-357,F,2/11/17,MIA,@,PHI,L,0,36,8,15,0.533,7,12,0.583,1,3,0.333,9,13,0.692,1,3,4
1116,James Johnson,29-356,F,2/10/17,MIA,@,BRK,W,0,35,11,17,0.647,11,15,0.733,0,2,0,4,4,1,1,7,8
1117,Terrence Jones,24-312,F,11/16/16,NOP,@,ORL,L,1,38,9,20,0.45,7,16,0.438,2,4,0.5,6,7,0.857,0,9,9
1118,Jeremy Lamb,24-287,G-F,3/13/17,CHO,,CHI,L,1,31,10,17,0.588,7,12,0.583,3,5,0.6,3,4,0.75,2,2,4
1119,Zach LaVine,21-258,G,11/23/16,MIN,@,NOP,L,1,37,9,22,0.409,8,17,0.471,1,5,0.2,7,8,0.875,0,1,1
1120,Kawhi Leonard,25-168,F,12/14/16,SAS,,BOS,W,1,37,9,17,0.529,8,12,0.667,1,5,0.2,7,7,1,1,2,3
1121,Brook Lopez,28-282,C,1/8/17,BRK,,PHI,L,1,32,8,16,0.5,5,9,0.556,3,7,0.429,7,7,1,1,1,2
1122,Brook Lopez,28-337,C,3/4/17,BRK,@,POR,L,1,32,11,19,0.579,9,14,0.643,2,5,0.4,2,4,0.5,0,5,5
1123,Brook Lopez,28-221,C,11/8/16,BRK,,MIN,W,1,28,10,16,0.625,7,9,0.778,3,7,0.429,3,3,1,0,3,3
1124,Brook Lopez,28-255,C,12/12/16,BRK,@,HOU,L,1,32,9,17,0.529,9,15,0.6,0,2,0,8,8,1,1,0,1
1125,Kevin Love,28-057,F,11/3/16,CLE,,BOS,W,1,33,5,15,0.333,1,7,0.143,4,8,0.5,12,13,0.923,2,6,8
1126,Wesley Matthews,30-050,G,12/3/16,DAL,,CHI,W,1,35,9,17,0.529,2,6,0.333,7,11,0.636,1,1,1,0,3,3
1127,Wesley Matthews,30-047,G,11/30/16,DAL,,SAS,L,1,37,8,19,0.421,3,8,0.375,5,11,0.455,5,6,0.833,0,2,2
1128,Wesley Matthews,30-057,G,12/10/16,DAL,@,HOU,L,1,35,8,22,0.364,3,9,0.333,5,13,0.385,5,7,0.714,1,2,3
1129,Wesley Matthews,30-056,G,12/9/16,DAL,,IND,W,1,36,8,16,0.5,3,6,0.5,5,10,0.5,5,8,0.625,0,4,4
1130,C.J. McCollum,25-177,G,3/15/17,POR,@,SAS,W,1,39,8,16,0.5,6,14,0.429,2,2,1,8,8,1,1,3,4
1131,C.J. McCollum,25-116,G,1/13/17,POR,,ORL,L,1,37,10,21,0.476,6,15,0.4,4,6,0.667,2,2,1,1,2,3
1132,C.J. McCollum,25-174,G,3/12/17,POR,@,PHO,W,1,39,11,20,0.55,10,16,0.625,1,4,0.25,3,4,0.75,1,3,4
1133,C.J. McCollum,25-147,G,2/13/17,POR,,ATL,L,1,41,9,24,0.375,6,16,0.375,3,8,0.375,5,6,0.833,2,5,7
1134,C.J. McCollum,25-059,G,11/17/16,POR,@,HOU,L,1,35,11,19,0.579,10,15,0.667,1,4,0.25,3,3,1,2,1,3
1135,Khris Middleton,25-221,F-G,3/21/17,MIL,@,POR,W,1,33,11,22,0.5,8,19,0.421,3,3,1,1,1,1,0,3,3
1136,Paul Millsap,31-324,F,12/30/16,ATL,,DET,W,1,37,9,20,0.45,8,16,0.5,1,4,0.25,7,8,0.875,3,3,6
1137,Marcus Morris,27-164,F,2/13/17,DET,@,MIL,L,1,40,10,17,0.588,6,9,0.667,4,8,0.5,2,2,1,0,5,5
1138,Markieff Morris,27-161,F,2/10/17,WAS,,IND,W,1,31,11,18,0.611,8,12,0.667,3,6,0.5,1,2,0.5,2,8,10
1139,Dirk Nowitzki,38-204,F,1/9/17,DAL,@,MIN,L,1,31,8,16,0.5,3,6,0.5,5,10,0.5,5,7,0.714,0,5,5
1140,Jahlil Okafor,21-030,C-F,1/14/17,PHI,@,WAS,L,1,35,10,16,0.625,10,16,0.625,0,0,,6,11,0.545,5,4,9
1141,Victor Oladipo,24-205,G,11/25/16,OKC,@,DEN,W,1,42,11,19,0.579,9,13,0.692,2,6,0.333,2,2,1,1,3,4
1142,Victor Oladipo,24-198,G,11/18/16,OKC,,BRK,W,1,36,11,17,0.647,8,11,0.727,3,6,0.5,1,1,1,1,4,5
1143,Kelly Olynyk,25-269,C-F,1/13/17,BOS,@,ATL,W,0,32,9,11,0.818,5,6,0.833,4,5,0.8,4,4,1,2,6,8
1144,Chris Paul,31-199,G,11/21/16,LAC,,TOR,W,1,35,8,14,0.571,5,6,0.833,3,8,0.375,7,7,1,0,3,3
1145,Chris Paul,31-207,G,11/29/16,LAC,@,BRK,L,1,45,11,26,0.423,7,19,0.368,4,7,0.571,0,0,,3,7,10
1146,Elfrid Payton,22-295,G,12/13/16,ORL,@,ATL,W,0,35,9,12,0.75,6,9,0.667,3,3,1,5,7,0.714,1,2,3
1147,Kristaps Porzingis,21-131,F-C,12/11/16,NYK,@,LAL,W,1,39,8,15,0.533,5,11,0.455,3,4,0.75,7,9,0.778,3,10,13
1148,J.J. Redick,32-147,G,11/18/16,LAC,@,SAC,W,1,26,8,12,0.667,2,4,0.5,6,8,0.75,4,4,1,1,1,2
1149,Derrick Rose,28-109,G,1/21/17,NYK,,PHO,L,1,36,12,26,0.462,12,25,0.48,0,1,0,2,2,1,3,0,3
1150,Derrick Rose,28-155,G,3/8/17,NYK,@,MIL,L,1,39,13,16,0.813,13,16,0.813,0,0,,0,0,,0,1,1
1151,Derrick Rose,28-085,G,12/28/16,NYK,@,ATL,L,1,43,9,28,0.321,9,26,0.346,0,2,0,8,9,0.889,2,5,7
1152,Dario Saric,22-307,F,2/9/17,PHI,@,ORL,W,0,28,8,15,0.533,5,10,0.5,3,5,0.6,7,8,0.875,3,5,8
1153,Dennis Schroder,23-176,G,3/10/17,ATL,,TOR,W,1,35,9,18,0.5,8,14,0.571,1,4,0.25,7,8,0.875,1,5,6
1154,Isaiah Thomas,28-001,G,2/8/17,BOS,@,SAC,L,1,33,6,16,0.375,2,5,0.4,4,11,0.364,10,10,1,0,4,4
1155,Isaiah Thomas,27-313,G,12/16/16,BOS,,CHO,W,1,35,9,20,0.45,7,14,0.5,2,6,0.333,6,7,0.857,1,2,3
1156,Klay Thompson,26-299,G,12/3/16,GSW,,PHO,W,1,34,10,17,0.588,4,10,0.4,6,7,0.857,0,0,,1,4,5
1157,Klay Thompson,26-362,G,2/4/17,GSW,@,SAC,L,1,43,10,25,0.4,6,14,0.429,4,11,0.364,2,2,1,3,2,5
1158,Klay Thompson,26-343,G,1/16/17,GSW,,CLE,W,1,31,8,17,0.471,3,6,0.5,5,11,0.455,5,5,1,0,4,4
1159,Klay Thompson,26-289,G,11/23/16,GSW,,LAL,W,1,24,9,14,0.643,5,7,0.714,4,7,0.571,4,4,1,0,2,2
1160,Klay Thompson,27-003,G,2/11/17,GSW,@,OKC,W,1,33,7,12,0.583,2,4,0.5,5,8,0.625,7,8,0.875,1,0,1
1161,Karl-Anthony Towns,21-101,F-C,2/24/17,MIN,,DAL,W,1,39,12,18,0.667,12,18,0.667,0,0,,2,3,0.667,4,14,18
1162,Karl-Anthony Towns,21-078,F-C,2/1/17,MIN,@,CLE,L,1,39,11,19,0.579,9,17,0.529,2,2,1,2,2,1,3,9,12
1163,Karl-Anthony Towns,21-091,F-C,2/14/17,MIN,,CLE,L,1,39,11,19,0.579,10,15,0.667,1,4,0.25,3,3,1,2,6,8
1164,Karl-Anthony Towns,21-040,F-C,12/25/16,MIN,@,OKC,L,1,32,10,20,0.5,10,18,0.556,0,2,0,6,6,1,2,6,8
1165,Myles Turner,20-266,F-C,12/15/16,IND,@,NOP,L,1,30,11,14,0.786,11,14,0.786,0,0,,4,5,0.8,2,6,8
1166,Nikola Vucevic,26-147,C,3/20/17,ORL,,PHI,W,1,37,10,23,0.435,10,22,0.455,0,1,0,6,6,1,5,8,13
1167,Nikola Vucevic,26-057,C,12/20/16,ORL,@,MIA,W,0,40,11,20,0.55,10,19,0.526,1,1,1,3,5,0.6,1,11,12
1168,Dwyane Wade,34-313,G,11/25/16,CHI,@,PHI,W,1,29,11,18,0.611,10,15,0.667,1,3,0.333,3,5,0.6,1,4,5
1169,Kemba Walker,26-265,G,1/28/17,CHO,,SAC,L,1,39,8,16,0.5,5,10,0.5,3,6,0.5,7,8,0.875,1,2,3
1170,Kemba Walker,26-199,G,11/23/16,CHO,,SAS,L,1,32,9,16,0.563,5,12,0.417,4,4,1,4,4,1,3,6,9
1171,Kemba Walker,26-262,G,1/25/17,CHO,,GSW,L,1,38,9,23,0.391,7,16,0.438,2,7,0.286,6,6,1,1,2,3
1172,Kemba Walker,26-298,G,3/2/17,CHO,@,PHO,L,1,36,10,24,0.417,7,13,0.538,3,11,0.273,3,4,0.75,0,4,4
1173,John Wall,26-080,G,11/25/16,WAS,@,ORL,W,1,39,10,18,0.556,9,14,0.643,1,4,0.25,5,6,0.833,0,7,7
1174,John Wall,26-157,G,2/10/17,WAS,,IND,W,1,37,7,16,0.438,5,11,0.455,2,5,0.4,10,15,0.667,0,3,3
1175,John Wall,26-126,G,1/10/17,WAS,,CHI,W,1,40,11,21,0.524,10,19,0.526,1,2,0.5,3,4,0.75,0,6,6
1176,John Wall,26-190,G,3/15/17,WAS,,DAL,L,1,36,10,20,0.5,8,15,0.533,2,5,0.4,4,6,0.667,0,1,1
1177,T.J. Warren,23-193,F,3/17/17,PHO,,ORL,L,1,37,8,13,0.615,8,12,0.667,0,1,0,10,10,1,2,3,5
1178,T.J. Warren,23-055,F,10/30/16,PHO,,GSW,L,1,37,10,21,0.476,8,16,0.5,2,5,0.4,4,4,1,3,3,6
1179,Russell Westbrook,28-035,G,12/17/16,OKC,,PHO,W,1,34,9,17,0.529,8,15,0.533,1,2,0.5,7,7,1,0,11,11
1180,Hassan Whiteside,27-211,C,1/10/17,MIA,@,GSW,L,1,37,12,17,0.706,12,17,0.706,0,0,,2,3,0.667,3,17,20
1181,Hassan Whiteside,27-184,C,12/14/16,MIA,,IND,W,1,34,10,16,0.625,10,16,0.625,0,0,,6,11,0.545,6,16,22
1182,Hassan Whiteside,27-272,C,3/12/17,MIA,@,IND,L,1,34,11,21,0.524,11,21,0.524,0,0,,4,5,0.8,10,11,21
1183,Andrew Wiggins,21-300,F-G,12/19/16,MIN,,PHO,W,1,39,11,20,0.55,10,18,0.556,1,2,0.5,3,4,0.75,0,4,4
1184,Andrew Wiggins,22-022,F-G,3/17/17,MIN,@,MIA,L,1,39,10,23,0.435,9,21,0.429,1,2,0.5,5,6,0.833,1,2,3
1185,Lou Williams,30-080,G,1/15/17,LAL,,DET,L,0,27,7,14,0.5,2,5,0.4,5,9,0.556,7,8,0.875,0,3,3
1186,Nick Young,31-254,G-F,2/10/17,LAL,@,MIL,W,1,29,8,11,0.727,3,3,1,5,8,0.625,5,5,1,1,1,2
1187,Nick Young,31-214,G-F,1/1/17,LAL,,TOR,L,1,30,8,14,0.571,1,5,0.2,7,9,0.778,3,3,1,0,2,2
1188,LaMarcus Aldridge,31-196,F-C,1/31/17,SAS,,OKC,W,1,28,8,15,0.533,7,13,0.538,1,2,0.5,8,9,0.889,1,5,6
1189,Ryan Anderson,28-239,F,12/31/16,HOU,,NYK,W,1,35,8,12,0.667,4,4,1,4,8,0.5,5,6,0.833,2,4,6
1190,Ryan Anderson,28-270,F,1/31/17,HOU,,SAC,W,1,27,7,14,0.5,1,2,0.5,6,12,0.5,5,8,0.625,3,8,11
1191,Giannis Antetokounmpo,22-014,F-G,12/20/16,MIL,,CLE,L,1,44,5,13,0.385,3,10,0.3,2,3,0.667,13,15,0.867,2,11,13
1192,Giannis Antetokounmpo,22-024,F-G,12/30/16,MIL,@,MIN,L,1,32,11,14,0.786,11,14,0.786,0,0,,3,4,0.75,2,4,6
1193,Giannis Antetokounmpo,22-031,F-G,1/6/17,MIL,,NYK,L,1,38,9,21,0.429,7,16,0.438,2,5,0.4,5,6,0.833,2,3,5
1194,Carmelo Anthony,32-159,F,11/4/16,NYK,@,CHI,W,1,36,9,22,0.409,7,16,0.438,2,6,0.333,5,5,1,3,4,7
1195,Carmelo Anthony,32-259,F,2/12/17,NYK,,SAS,W,1,40,9,21,0.429,6,16,0.375,3,5,0.6,4,6,0.667,1,6,7
1196,Harrison Barnes,24-275,F,3/1/17,DAL,@,ATL,L,1,38,9,19,0.474,6,15,0.4,3,4,0.75,4,4,1,0,4,4
1197,Harrison Barnes,24-214,F,12/30/16,DAL,@,GSW,L,1,28,11,18,0.611,8,11,0.727,3,7,0.429,0,0,,0,3,3
1198,Harrison Barnes,24-163,F,11/9/16,DAL,@,GSW,L,1,34,8,20,0.4,7,17,0.412,1,3,0.333,8,8,1,2,6,8
1199,Harrison Barnes,24-193,F,12/9/16,DAL,,IND,W,1,36,10,17,0.588,7,14,0.5,3,3,1,2,4,0.5,2,5,7
1200,Nicolas Batum,28-059,F-G,2/11/17,CHO,,LAC,L,1,37,7,13,0.538,3,6,0.5,4,7,0.571,7,8,0.875,1,5,6
1201,Kent Bazemore,27-130,G-F,11/8/16,ATL,@,CLE,W,1,33,8,13,0.615,4,7,0.571,4,6,0.667,5,7,0.714,1,5,6
1202,Kent Bazemore,27-206,G-F,1/23/17,ATL,,LAC,L,1,33,9,21,0.429,6,12,0.5,3,9,0.333,4,5,0.8,1,2,3
1203,Bradley Beal,23-171,G,12/16/16,WAS,,DET,W,1,34,10,16,0.625,8,8,1,2,8,0.25,3,3,1,0,2,2
1204,Bradley Beal,23-189,G,1/3/17,WAS,@,DAL,L,1,35,10,26,0.385,7,15,0.467,3,11,0.273,2,3,0.667,0,4,4
1205,Bradley Beal,23-245,G,2/28/17,WAS,,GSW,W,1,39,8,17,0.471,4,7,0.571,4,10,0.4,5,5,1,2,2,4
1206,Bradley Beal,23-151,G,11/26/16,WAS,,SAS,L,1,38,11,23,0.478,8,14,0.571,3,9,0.333,0,0,,2,4,6
1207,Bradley Beal,23-202,G,1/16/17,WAS,,POR,W,1,29,7,11,0.636,4,8,0.5,3,3,1,8,8,1,1,1,2
1208,Eric Bledsoe,27-068,G,2/15/17,PHO,,LAL,W,1,36,7,14,0.5,4,8,0.5,3,6,0.5,8,9,0.889,2,8,10
1209,Devin Booker,20-128,G,3/7/17,PHO,,WAS,L,1,38,8,18,0.444,4,11,0.364,4,7,0.571,5,6,0.833,1,3,4
1210,Devin Booker,20-078,G,1/16/17,PHO,,UTA,L,1,46,10,22,0.455,9,17,0.529,1,5,0.2,4,4,1,0,0,0
1211,Avery Bradley,26-018,G,12/14/16,BOS,@,SAS,L,1,35,10,16,0.625,7,10,0.7,3,6,0.5,2,2,1,1,9,10
1212,Jimmy Butler,27-107,G-F,12/30/16,CHI,@,IND,L,1,38,8,17,0.471,8,14,0.571,0,3,0,9,11,0.818,0,6,6
1213,Kentavious Caldwell-Pope,23-309,G,12/23/16,DET,,GSW,L,1,41,9,18,0.5,5,6,0.833,4,12,0.333,3,4,0.75,1,0,1
1214,Kentavious Caldwell-Pope,23-286,G,11/30/16,DET,@,BOS,W,1,35,10,17,0.588,8,13,0.615,2,4,0.5,3,4,0.75,2,3,5
1215,Wilson Chandler,29-201,F,11/27/16,DEN,@,PHO,W,1,39,8,17,0.471,5,11,0.455,3,6,0.5,6,6,1,2,6,8
1216,Wilson Chandler,29-192,F,11/18/16,DEN,,TOR,L,0,36,9,17,0.529,6,12,0.5,3,5,0.6,4,6,0.667,4,6,10
1217,Jordan Clarkson,24-141,G,10/26/16,LAL,,HOU,W,0,25,8,12,0.667,6,9,0.667,2,3,0.667,7,7,1,1,2,3
1218,Jordan Clarkson,24-196,G,12/20/16,LAL,@,CHO,L,0,31,9,13,0.692,2,4,0.5,7,9,0.778,0,0,,0,3,3
1219,Mike Conley,29-043,G,11/23/16,MEM,@,PHI,W,1,45,7,20,0.35,4,13,0.308,3,7,0.429,8,10,0.8,0,9,9
1220,DeMarcus Cousins,26-158,C-F,1/18/17,SAC,,IND,L,1,38,7,19,0.368,6,17,0.353,1,2,0.5,10,14,0.714,1,11,12
1221,DeMarcus Cousins,26-207,C-F,3/8/17,NOP,,TOR,L,1,39,8,23,0.348,5,15,0.333,3,8,0.375,6,7,0.857,2,8,10
1222,DeMarcus Cousins,26-146,C-F,1/6/17,SAC,,LAC,L,1,36,9,19,0.474,6,11,0.545,3,8,0.375,4,6,0.667,2,9,11
1223,Robert Covington,26-072,F,2/24/17,PHI,,WAS,W,1,39,9,14,0.643,4,5,0.8,5,9,0.556,2,2,1,2,9,11
1224,Jamal Crawford,36-349,G,3/4/17,LAC,@,CHI,W,0,26,10,17,0.588,8,12,0.667,2,5,0.4,3,3,1,1,1,2
1225,Stephen Curry,28-351,G,2/28/17,GSW,@,WAS,L,1,34,9,20,0.45,7,11,0.636,2,9,0.222,5,6,0.833,4,3,7
1226,Stephen Curry,29-002,G,3/16/17,GSW,,ORL,W,1,28,8,15,0.533,6,8,0.75,2,7,0.286,7,7,1,0,1,1
1227,Stephen Curry,28-259,G,11/28/16,GSW,,ATL,W,1,38,6,17,0.353,2,6,0.333,4,11,0.364,9,11,0.818,0,3,3
1228,Stephen Curry,28-284,G,12/23/16,GSW,@,DET,W,1,35,7,16,0.438,2,6,0.333,5,10,0.5,6,6,1,0,3,3
1229,Stephen Curry,28-281,G,12/20/16,GSW,,UTA,W,1,30,8,18,0.444,4,9,0.444,4,9,0.444,5,5,1,0,3,3
1230,Anthony Davis,23-330,F-C,2/4/17,NOP,@,WAS,L,1,39,11,17,0.647,11,17,0.647,0,0,,3,4,0.75,2,8,10
1231,Anthony Davis,23-248,F-C,11/14/16,NOP,,BOS,W,1,38,7,22,0.318,7,21,0.333,0,1,0,11,13,0.846,1,15,16
1232,DeMar DeRozan,27-106,G,11/21/16,TOR,@,LAC,L,1,36,11,21,0.524,11,20,0.55,0,1,0,3,4,0.75,1,3,4
1233,DeMar DeRozan,27-218,G,3/13/17,TOR,,DAL,W,1,32,10,17,0.588,9,15,0.6,1,2,0.5,4,4,1,1,5,6
1234,DeMar DeRozan,27-164,G,1/18/17,TOR,@,PHI,L,1,38,11,21,0.524,11,21,0.524,0,0,,3,4,0.75,1,2,3
1235,Goran Dragic,30-260,G,1/21/17,MIA,,MIL,W,1,33,8,13,0.615,5,8,0.625,3,5,0.6,6,7,0.857,0,1,1
1236,Goran Dragic,30-179,G,11/1/16,MIA,,SAC,W,1,41,8,14,0.571,3,6,0.5,5,8,0.625,4,7,0.571,1,6,7
1237,Goran Dragic,30-177,G,10/30/16,MIA,,SAS,L,1,34,9,17,0.529,6,10,0.6,3,7,0.429,4,6,0.667,0,3,3
1238,Andre Drummond,23-144,C,1/1/17,DET,@,MIA,W,1,36,12,19,0.632,12,19,0.632,0,0,,1,6,0.167,6,12,18
1239,Kevin Durant,28-060,F-G,11/28/16,GSW,,ATL,W,1,36,8,16,0.5,7,13,0.538,1,3,0.333,8,8,1,0,14,14
1240,Kevin Durant,28-147,F-G,2/23/17,GSW,,LAC,W,1,34,8,15,0.533,4,9,0.444,4,6,0.667,5,6,0.833,1,14,15
1241,Kevin Durant,28-105,F-G,1/12/17,GSW,,DET,W,1,31,10,15,0.667,7,10,0.7,3,5,0.6,2,2,1,0,6,6
1242,Kevin Durant,28-137,F-G,2/13/17,GSW,@,DEN,L,1,27,10,16,0.625,8,11,0.727,2,5,0.4,3,3,1,1,3,4
1243,Joel Embiid,22-240,C-F,11/11/16,PHI,,IND,W,1,26,6,18,0.333,5,15,0.333,1,3,0.333,12,14,0.857,3,4,7
1244,Joel Embiid,22-261,C-F,12/2/16,PHI,,ORL,L,1,27,10,21,0.476,7,16,0.438,3,5,0.6,2,2,1,4,6,10
1245,Joel Embiid,22-285,C-F,12/26/16,PHI,@,SAC,L,1,29,8,17,0.471,7,13,0.538,1,4,0.25,8,9,0.889,4,4,8
1246,Joel Embiid,22-293,C-F,1/3/17,PHI,,MIN,W,1,30,8,20,0.4,7,17,0.412,1,3,0.333,8,11,0.727,5,3,8
1247,Kenneth Faried,27-028,F,12/17/16,DEN,,NYK,W,0,29,10,11,0.909,10,11,0.909,0,0,,5,10,0.5,5,2,7
1248,Evan Fournier,24-128,G-F,3/6/17,ORL,,NYK,L,1,34,9,17,0.529,5,8,0.625,4,9,0.444,3,4,0.75,0,2,2
1249,Evan Fournier,24-139,G-F,3/17/17,ORL,@,PHO,W,1,35,8,19,0.421,5,10,0.5,3,9,0.333,6,7,0.857,0,3,3
1250,Evan Fournier,24-025,G-F,11/23/16,ORL,,PHO,L,1,35,9,20,0.45,6,12,0.5,3,8,0.375,4,6,0.667,1,2,3
1251,Danilo Gallinari,28-171,F,1/26/17,DEN,,PHO,W,1,35,7,16,0.438,5,9,0.556,2,7,0.286,9,12,0.75,1,6,7
1252,Marc Gasol,31-307,C,12/1/16,MEM,,ORL,W,1,32,8,14,0.571,6,11,0.545,2,3,0.667,7,7,1,0,2,2
1253,Marc Gasol,31-335,C,12/29/16,MEM,,OKC,W,1,33,9,20,0.45,9,17,0.529,0,3,0,7,9,0.778,0,8,8
1254,Paul George,26-177,F,10/26/16,IND,,DAL,W,1,43,7,14,0.5,3,9,0.333,4,5,0.8,7,8,0.875,0,8,8
1255,Paul George,26-219,F,12/7/16,IND,@,PHO,W,1,38,8,18,0.444,7,13,0.538,1,5,0.2,8,10,0.8,2,11,13
1256,Eric Gordon,28-024,G,1/18/17,HOU,,MIL,W,0,32,9,20,0.45,2,3,0.667,7,17,0.412,0,0,,1,3,4
1257,Blake Griffin,27-240,F,11/11/16,LAC,@,OKC,W,1,36,10,20,0.5,10,19,0.526,0,1,0,5,7,0.714,2,4,6
1258,Blake Griffin,27-245,F,11/16/16,LAC,,MEM,L,1,38,8,15,0.533,8,14,0.571,0,1,0,9,12,0.75,1,7,8
1259,Tim Hardaway,24-334,G,2/13/17,ATL,@,POR,W,1,43,8,19,0.421,4,10,0.4,4,9,0.444,5,5,1,0,7,7
1260,James Harden,27-185,G,2/27/17,HOU,,IND,L,1,39,5,17,0.294,4,8,0.5,1,9,0.111,14,17,0.824,1,6,7
1261,James Harden,27-078,G,11/12/16,HOU,,SAS,L,1,39,7,18,0.389,5,9,0.556,2,9,0.222,9,11,0.818,5,6,11
1262,James Harden,27-165,G,2/7/17,HOU,,ORL,W,1,36,6,21,0.286,3,11,0.273,3,10,0.3,10,14,0.714,1,5,6
1263,James Harden,27-103,G,12/7/16,HOU,,LAL,W,1,30,8,14,0.571,4,7,0.571,4,7,0.571,5,6,0.833,0,6,6
1264,Gary Harris,22-163,G,2/24/17,DEN,,BRK,W,1,27,9,15,0.6,5,9,0.556,4,6,0.667,3,3,1,0,2,2
1265,Tobias Harris,24-109,F,11/1/16,DET,,NYK,W,1,36,8,12,0.667,6,9,0.667,2,3,0.667,7,8,0.875,1,9,10
1266,Tobias Harris,24-223,F,2/23/17,DET,,CHO,W,0,37,9,17,0.529,5,9,0.556,4,8,0.5,3,3,1,2,5,7
1267,Tobias Harris,24-174,F,1/5/17,DET,,CHO,W,0,31,10,16,0.625,7,8,0.875,3,8,0.375,2,2,1,0,2,2
1268,Gordon Hayward,26-242,F-G,11/20/16,UTA,@,DEN,L,1,33,9,21,0.429,7,16,0.438,2,5,0.4,5,6,0.833,1,6,7
1269,Gordon Hayward,26-234,F-G,11/12/16,UTA,@,MIA,W,1,35,10,20,0.5,9,16,0.563,1,4,0.25,4,5,0.8,1,8,9
1270,Gordon Hayward,26-357,F-G,3/15/17,UTA,@,DET,W,1,34,9,17,0.529,5,10,0.5,4,7,0.571,3,3,1,2,7,9
1271,George Hill,30-182,G,11/2/16,UTA,,DAL,W,1,35,9,15,0.6,5,9,0.556,4,6,0.667,3,3,1,1,5,6
1272,George Hill,30-276,G,2/4/17,UTA,,CHO,W,1,32,8,11,0.727,3,3,1,5,8,0.625,4,4,1,0,1,1
1273,Jrue Holiday,26-243,G,2/10/17,NOP,@,MIN,W,1,38,10,14,0.714,9,12,0.75,1,2,0.5,4,4,1,2,4,6
1274,Rodney Hood,24-055,G-F,12/14/16,UTA,,OKC,W,1,31,9,14,0.643,4,5,0.8,5,9,0.556,2,2,1,0,1,1
1275,Rodney Hood,24-030,G-F,11/19/16,UTA,@,HOU,L,1,34,8,13,0.615,3,5,0.6,5,8,0.625,4,4,1,0,4,4
1276,Ersan Ilyasova,29-263,F,2/2/17,PHI,@,SAS,L,1,39,8,17,0.471,6,11,0.545,2,6,0.333,7,8,0.875,2,7,9
1277,Kyrie Irving,24-328,G,2/14/17,CLE,@,MIN,W,1,37,10,27,0.37,8,17,0.471,2,10,0.2,3,3,1,0,1,1
1278,Kyrie Irving,24-247,G,11/25/16,CLE,,DAL,W,1,28,10,13,0.769,6,8,0.75,4,5,0.8,1,1,1,0,1,1
1279,Kyrie Irving,24-240,G,11/18/16,CLE,,DET,W,1,29,11,15,0.733,8,11,0.727,3,4,0.75,0,0,,0,2,2
1280,Kyrie Irving,24-341,G,2/27/17,CLE,,MIL,W,1,37,10,20,0.5,8,16,0.5,2,4,0.5,3,3,1,0,4,4
1281,Kyrie Irving,24-277,G,12/25/16,CLE,,GSW,W,1,44,11,27,0.407,9,22,0.409,2,5,0.4,1,1,1,3,3,6
1282,LeBron James,32-030,F-G,1/29/17,CLE,,OKC,W,1,37,9,18,0.5,9,16,0.563,0,2,0,7,10,0.7,1,13,14
1283,LeBron James,32-046,F-G,2/14/17,CLE,@,MIN,W,1,40,10,14,0.714,8,11,0.727,2,3,0.667,3,6,0.5,1,7,8
1284,LeBron James,31-343,F-G,12/7/16,CLE,@,NYK,W,1,32,7,10,0.7,6,8,0.75,1,2,0.5,10,14,0.714,2,4,6
1285,LeBron James,32-040,F-G,2/8/17,CLE,@,IND,W,1,38,9,16,0.563,8,14,0.571,1,2,0.5,6,8,0.75,1,5,6
1286,LeBron James,31-311,F-G,11/5/16,CLE,@,PHI,W,1,36,9,23,0.391,8,18,0.444,1,5,0.2,6,7,0.857,1,7,8
1287,Nikola Jokic,21-315,C-F,12/30/16,DEN,,PHI,L,1,22,9,13,0.692,9,13,0.692,0,0,,7,9,0.778,2,5,7
1288,Zach LaVine,21-276,G,12/11/16,MIN,,GSW,L,1,42,8,19,0.421,3,10,0.3,5,9,0.556,4,4,1,0,3,3
1289,Zach LaVine,21-271,G,12/6/16,MIN,,SAS,L,1,38,9,16,0.563,5,8,0.625,4,8,0.5,3,4,0.75,0,2,2
1290,Courtney Lee,31-143,G,2/23/17,NYK,@,CLE,L,1,36,10,15,0.667,7,10,0.7,3,5,0.6,2,2,1,1,5,6
1291,Kawhi Leonard,25-188,F,1/3/17,SAS,,TOR,W,1,28,8,12,0.667,3,5,0.6,5,7,0.714,4,5,0.8,1,3,4
1292,Kawhi Leonard,25-149,F,11/25/16,SAS,@,BOS,W,1,35,8,18,0.444,5,11,0.455,3,7,0.429,6,6,1,2,8,10
1293,Kawhi Leonard,25-179,F,12/25/16,SAS,,CHI,W,1,38,7,14,0.5,4,9,0.444,3,5,0.6,8,8,1,4,6,10
1294,Kawhi Leonard,25-242,F,2/26/17,SAS,@,LAL,W,1,26,9,18,0.5,7,11,0.636,2,7,0.286,5,6,0.833,1,2,3
1295,Brook Lopez,28-347,C,3/14/17,BRK,,OKC,L,1,29,9,15,0.6,6,9,0.667,3,6,0.5,4,4,1,0,5,5
1296,Brook Lopez,28-345,C,3/12/17,BRK,,NYK,W,1,29,8,17,0.471,2,8,0.25,6,9,0.667,3,4,0.75,2,4,6
1297,Brook Lopez,28-248,C,12/5/16,BRK,,WAS,L,1,31,8,15,0.533,6,11,0.545,2,4,0.5,7,9,0.778,4,2,6
1298,Brook Lopez,28-302,C,1/28/17,BRK,@,MIN,L,1,30,10,15,0.667,7,9,0.778,3,6,0.5,2,3,0.667,1,6,7
1299,Brook Lopez,28-210,C,10/28/16,BRK,,IND,W,1,26,10,18,0.556,10,14,0.714,0,4,0,5,6,0.833,3,2,5
1300,Robin Lopez,28-350,C,3/17/17,CHI,@,WAS,L,1,33,12,16,0.75,12,15,0.8,0,1,0,1,1,1,7,5,12
1301,Kevin Love,28-081,F,11/27/16,CLE,@,PHI,W,1,28,6,13,0.462,2,5,0.4,4,8,0.5,9,9,1,3,8,11
1302,Kevin Love,28-123,F,1/8/17,CLE,@,PHO,W,1,36,8,17,0.471,5,7,0.714,3,10,0.3,6,6,1,5,5,10
1303,Kyle Lowry,30-258,G,12/8/16,TOR,,MIN,W,1,38,8,14,0.571,3,7,0.429,5,7,0.714,4,6,0.667,1,1,2
1304,Kyle Lowry,30-240,G,11/20/16,TOR,@,SAC,L,1,36,7,17,0.412,5,10,0.5,2,7,0.286,9,10,0.9,1,7,8
1305,Wesley Matthews,30-016,G,10/30/16,DAL,@,HOU,L,1,41,9,25,0.36,6,10,0.6,3,15,0.2,4,4,1,1,3,4
1306,Wesley Matthews,30-059,G,12/12/16,DAL,,DEN,W,1,32,10,14,0.714,5,7,0.714,5,7,0.714,0,0,,0,4,4
1307,C.J. McCollum,25-162,G,2/28/17,POR,@,DET,L,1,44,10,17,0.588,6,10,0.6,4,7,0.571,1,1,1,0,4,4
1308,C.J. McCollum,25-084,G,12/12/16,POR,@,LAC,L,1,33,9,17,0.529,7,13,0.538,2,4,0.5,5,5,1,0,5,5
1309,C.J. McCollum,25-036,G,10/25/16,POR,,UTA,W,1,35,8,16,0.5,6,14,0.429,2,2,1,7,7,1,1,1,2
1310,C.J. McCollum,25-113,G,1/10/17,POR,@,LAL,W,1,34,10,18,0.556,8,13,0.615,2,5,0.4,3,4,0.75,0,1,1
1311,Paul Millsap,32-000,F,2/10/17,ATL,@,SAC,L,1,38,7,13,0.538,5,7,0.714,2,6,0.333,9,11,0.818,2,4,6
1312,Greg Monroe,26-256,C-F,2/15/17,MIL,@,BRK,W,0,34,12,16,0.75,12,16,0.75,0,0,,1,2,0.5,2,6,8
1313,Greg Monroe,26-254,C-F,2/13/17,MIL,,DET,W,0,31,12,15,0.8,12,15,0.8,0,0,,1,1,1,2,11,13
1314,Marcus Morris,27-141,F,1/21/17,DET,,WAS,W,1,38,7,17,0.412,4,11,0.364,3,6,0.5,8,9,0.889,6,5,11
1315,Emmanuel Mudiay,20-258,G,11/18/16,DEN,,TOR,L,1,46,10,18,0.556,10,11,0.909,0,7,0,5,7,0.714,0,6,6
1316,Dirk Nowitzki,38-233,F,2/7/17,DAL,,POR,L,1,30,7,16,0.438,3,9,0.333,4,7,0.571,7,7,1,0,5,5
1317,Dirk Nowitzki,38-261,F,3/7/17,DAL,,LAL,W,1,24,9,13,0.692,6,9,0.667,3,4,0.75,4,4,1,0,11,11
1318,Victor Oladipo,24-210,G,11/30/16,OKC,,WAS,W,1,45,10,16,0.625,5,7,0.714,5,9,0.556,0,0,,0,6,6
1319,Jabari Parker,21-297,F,1/6/17,MIL,,NYK,L,1,38,10,18,0.556,6,12,0.5,4,6,0.667,1,4,0.25,1,3,4
1320,Jabari Parker,21-311,F,1/20/17,MIL,@,ORL,L,1,38,8,17,0.471,5,11,0.455,3,6,0.5,6,7,0.857,2,4,6
1321,Elfrid Payton,22-288,G,12/6/16,ORL,@,WAS,W,0,35,9,12,0.75,6,9,0.667,3,3,1,4,4,1,1,0,1
1322,Elfrid Payton,22-305,G,12/23/16,ORL,,LAL,W,0,30,11,16,0.688,8,10,0.8,3,6,0.5,0,0,,0,3,3
1323,Otto Porter,23-248,F,2/6/17,WAS,,CLE,L,1,45,8,11,0.727,3,4,0.75,5,7,0.714,4,5,0.8,0,6,6
1324,Otto Porter,23-229,F,1/18/17,WAS,,MEM,W,1,34,9,12,0.75,3,4,0.75,6,8,0.75,1,1,1,2,5,7
1325,Otto Porter,23-258,F,2/16/17,WAS,@,IND,W,1,35,9,15,0.6,3,5,0.6,6,10,0.6,1,1,1,1,7,8
1326,Kristaps Porzingis,21-116,F-C,11/26/16,NYK,@,CHO,L,1,37,7,16,0.438,5,11,0.455,2,5,0.4,9,11,0.818,0,6,6
1327,Julius Randle,22-028,F,12/27/16,LAL,,UTA,L,1,31,9,12,0.75,8,11,0.727,1,1,1,6,8,0.75,6,6,12
1328,Julius Randle,22-017,F,12/16/16,LAL,@,PHI,W,1,33,10,13,0.769,10,13,0.769,0,0,,5,6,0.833,1,8,9
1329,J.J. Redick,32-198,G,1/8/17,LAC,,MIA,W,1,33,9,19,0.474,5,11,0.455,4,8,0.5,3,4,0.75,1,6,7
1330,Austin Rivers,24-135,G,12/14/16,LAC,@,ORL,W,1,38,9,12,0.75,2,2,1,7,10,0.7,0,1,0,0,4,4
1331,Derrick Rose,28-082,G,12/25/16,NYK,,BOS,L,1,38,10,19,0.526,10,19,0.526,0,0,,5,6,0.833,3,2,5
1332,Derrick Rose,28-099,G,1/11/17,NYK,@,PHI,L,1,32,11,16,0.688,11,16,0.688,0,0,,3,4,0.75,0,2,2
1333,Derrick Rose,28-134,G,2/15/17,NYK,@,OKC,L,1,38,11,21,0.524,11,21,0.524,0,0,,3,3,1,1,3,4
1334,Derrick Rose,28-068,G,12/11/16,NYK,@,LAL,W,1,34,12,16,0.75,12,15,0.8,0,1,0,1,2,0.5,0,3,3
1335,Terrence Ross,25-311,F-G,12/12/16,TOR,,MIL,W,0,21,10,17,0.588,6,11,0.545,4,6,0.667,1,3,0.333,0,5,5
1336,Dario Saric,22-340,F,3/14/17,PHI,@,GSW,L,1,37,11,20,0.55,9,14,0.643,2,6,0.333,1,2,0.5,1,8,9
1337,Dennis Schroder,23-127,G,1/20/17,ATL,,CHI,W,1,27,11,14,0.786,9,11,0.818,2,3,0.667,1,1,1,1,2,3
1338,Jeff Teague,28-173,G,11/30/16,IND,@,POR,L,1,34,7,13,0.538,6,11,0.545,1,2,0.5,10,12,0.833,0,5,5
1339,Jeff Teague,28-262,G,2/27/17,IND,@,HOU,W,1,36,5,13,0.385,2,6,0.333,3,7,0.429,12,12,1,1,6,7
1340,Mirza Teletovic,31-083,F,12/10/16,MIL,@,WAS,L,0,26,8,12,0.667,3,6,0.5,5,6,0.833,4,4,1,0,3,3
1341,Isaiah Thomas,27-263,G,10/27/16,BOS,@,CHI,L,1,35,10,15,0.667,7,8,0.875,3,7,0.429,2,6,0.333,0,3,3
1342,Isaiah Thomas,27-262,G,10/26/16,BOS,,BRK,W,1,33,7,14,0.5,5,7,0.714,2,7,0.286,9,9,1,0,6,6
1343,Isaiah Thomas,28-041,G,3/20/17,BOS,,WAS,W,1,35,7,19,0.368,5,9,0.556,2,10,0.2,9,11,0.818,1,3,4
1344,Isaiah Thomas,27-295,G,11/28/16,BOS,@,MIA,W,1,35,7,23,0.304,5,13,0.385,2,10,0.2,9,9,1,0,4,4
1345,Isaiah Thomas,27-352,G,1/24/17,BOS,@,WAS,L,1,35,7,19,0.368,6,13,0.462,1,6,0.167,10,11,0.909,0,1,1
1346,Isaiah Thomas,28-029,G,3/8/17,BOS,@,GSW,W,1,34,7,20,0.35,3,10,0.3,4,10,0.4,7,7,1,0,0,0
1347,Klay Thompson,27-028,G,3/8/17,GSW,,BOS,L,1,34,11,23,0.478,9,15,0.6,2,8,0.25,1,2,0.5,1,5,6
1348,Klay Thompson,26-287,G,11/21/16,GSW,@,IND,W,1,26,10,18,0.556,6,8,0.75,4,10,0.4,1,2,0.5,0,1,1
1349,Klay Thompson,26-311,G,12/15/16,GSW,,NYK,W,1,32,10,17,0.588,6,7,0.857,4,10,0.4,1,1,1,2,3,5
1350,Klay Thompson,26-329,G,1/2/17,GSW,,DEN,W,1,37,9,19,0.474,5,12,0.417,4,7,0.571,3,3,1,0,5,5
1351,Karl-Anthony Towns,21-126,F-C,3/21/17,MIN,,SAS,L,1,39,8,17,0.471,7,15,0.467,1,2,0.5,8,9,0.889,6,8,14
1352,Karl-Anthony Towns,21-002,F-C,11/17/16,MIN,,PHI,W,1,38,12,18,0.667,11,16,0.688,1,2,0.5,0,0,,3,7,10
1353,Karl-Anthony Towns,21-026,F-C,12/11/16,MIN,,GSW,L,1,39,9,15,0.6,8,12,0.667,1,3,0.333,6,8,0.75,7,11,18
1354,Myles Turner,20-287,F-C,1/5/17,IND,,BRK,W,1,32,9,15,0.6,7,13,0.538,2,2,1,5,5,1,3,12,15
1355,Jonas Valanciunas,24-306,C,3/8/17,TOR,@,NOP,W,1,34,9,13,0.692,9,13,0.692,0,0,,7,11,0.636,3,9,12
1356,Nikola Vucevic,26-130,C,3/3/17,ORL,,MIA,W,1,32,11,18,0.611,10,16,0.625,1,2,0.5,2,3,0.667,2,7,9
1357,Nikola Vucevic,26-122,C,2/23/17,ORL,,POR,L,1,33,8,20,0.4,7,18,0.389,1,2,0.5,8,10,0.8,1,8,9
1358,Nikola Vucevic,26-097,C,1/29/17,ORL,@,TOR,W,1,33,9,17,0.529,6,13,0.462,3,4,0.75,4,4,1,2,8,10
1359,Dwyane Wade,34-297,G,11/9/16,CHI,@,ATL,L,1,34,10,17,0.588,8,12,0.667,2,5,0.4,3,4,0.75,2,1,3
1360,Kemba Walker,26-195,G,11/19/16,CHO,@,NOP,L,1,37,10,25,0.4,8,16,0.5,2,9,0.222,3,3,1,1,6,7
1361,Kemba Walker,26-213,G,12/7/16,CHO,,DET,W,1,34,9,22,0.409,7,17,0.412,2,5,0.4,5,6,0.833,0,3,3
1362,Kemba Walker,26-247,G,1/10/17,CHO,@,HOU,L,1,36,9,21,0.429,4,9,0.444,5,12,0.417,2,3,0.667,1,5,6
1363,John Wall,26-134,G,1/18/17,WAS,,MEM,W,1,37,7,18,0.389,6,13,0.462,1,5,0.2,10,10,1,1,1,2
1364,John Wall,26-185,G,3/10/17,WAS,@,SAC,W,1,41,11,25,0.44,10,21,0.476,1,4,0.25,2,2,1,0,4,4
1365,John Wall,26-099,G,12/14/16,WAS,,CHO,W,1,36,9,19,0.474,9,17,0.529,0,2,0,7,8,0.875,2,4,6
1366,John Wall,26-130,G,1/14/17,WAS,,PHI,W,1,30,9,17,0.529,6,13,0.462,3,4,0.75,4,5,0.8,2,5,7
1367,John Wall,26-182,G,3/7/17,WAS,@,PHO,W,1,37,9,20,0.45,9,17,0.529,0,3,0,7,12,0.583,1,3,4
1368,John Wall,26-090,G,12/5/16,WAS,@,BRK,W,1,36,10,19,0.526,9,14,0.643,1,5,0.2,4,4,1,0,1,1
1369,Russell Westbrook,28-122,G,3/14/17,OKC,@,BRK,W,1,35,6,18,0.333,4,11,0.364,2,7,0.286,11,13,0.846,1,11,12
1370,Hassan Whiteside,27-170,C,11/30/16,MIA,@,DEN,W,1,32,11,17,0.647,11,17,0.647,0,0,,3,5,0.6,4,12,16
1371,Hassan Whiteside,27-168,C,11/28/16,MIA,,BOS,L,1,37,10,13,0.769,10,13,0.769,0,0,,5,10,0.5,3,14,17
1372,Andrew Wiggins,22-024,F-G,3/19/17,MIN,@,NOP,L,1,37,10,19,0.526,10,16,0.625,0,3,0,5,7,0.714,1,1,2
1373,Andrew Wiggins,21-254,F-G,11/3/16,MIN,,DEN,L,1,35,9,18,0.5,7,15,0.467,2,3,0.667,5,5,1,1,2,3
1374,Andrew Wiggins,21-246,F-G,10/26/16,MIN,@,MEM,L,1,34,7,14,0.5,6,13,0.462,1,1,1,10,14,0.714,4,3,7
1375,Andrew Wiggins,21-292,F-G,12/11/16,MIN,,GSW,L,1,41,8,14,0.571,6,11,0.545,2,3,0.667,7,10,0.7,0,5,5
1376,Andrew Wiggins,21-309,F-G,12/28/16,MIN,@,DEN,L,1,36,11,20,0.55,9,16,0.563,2,4,0.5,1,4,0.25,1,4,5
1377,Andrew Wiggins,21-276,F-G,11/25/16,MIN,@,PHO,W,1,41,7,18,0.389,6,15,0.4,1,3,0.333,10,11,0.909,0,5,5
1378,Andrew Wiggins,21-289,F-G,12/8/16,MIN,@,TOR,L,1,36,10,19,0.526,9,15,0.6,1,4,0.25,4,6,0.667,3,2,5
1379,Deron Williams,32-122,G,10/26/16,DAL,@,IND,L,1,40,10,18,0.556,5,10,0.5,5,8,0.625,0,0,,1,2,3
1380,Lou Williams,30-024,G,11/20/16,LAL,,CHI,L,0,30,8,14,0.571,3,8,0.375,5,6,0.833,4,6,0.667,1,0,1
1381,Ivica Zubac,19-360,C,3/13/17,LAL,@,DEN,L,1,30,12,15,0.8,12,15,0.8,0,0,,1,4,0.25,4,7,11
1382,Steven Adams,23-142,C,12/9/16,OKC,,HOU,L,1,29,8,9,0.889,8,9,0.889,0,0,,8,9,0.889,2,8,10
1383,LaMarcus Aldridge,31-130,F-C,11/26/16,SAS,@,WAS,W,1,34,9,17,0.529,8,14,0.571,1,3,0.333,5,6,0.833,2,5,7
1384,Giannis Antetokounmpo,21-331,F-G,11/1/16,MIL,@,NOP,W,1,34,10,19,0.526,9,13,0.692,1,6,0.167,3,4,0.75,3,6,9
1385,Giannis Antetokounmpo,22-087,F-G,3/3/17,MIL,,LAC,W,1,31,10,13,0.769,10,13,0.769,0,0,,4,5,0.8,0,5,5
1386,Giannis Antetokounmpo,22-046,F-G,1/21/17,MIL,@,MIA,L,1,38,8,19,0.421,6,14,0.429,2,5,0.4,6,8,0.75,4,6,10
1387,Giannis Antetokounmpo,22-090,F-G,3/6/17,MIL,@,PHI,W,1,35,7,13,0.538,6,11,0.545,1,2,0.5,9,12,0.75,1,7,8
1388,Carmelo Anthony,32-156,F,11/1/16,NYK,@,DET,L,1,35,8,17,0.471,6,11,0.545,2,6,0.333,6,7,0.857,0,2,2
1389,Carmelo Anthony,32-274,F,2/27/17,NYK,,TOR,L,1,39,9,26,0.346,7,17,0.412,2,9,0.222,4,4,1,1,3,4
1390,Carmelo Anthony,32-169,F,11/14/16,NYK,,DAL,W,1,33,8,18,0.444,5,12,0.417,3,6,0.5,5,6,0.833,2,6,8
1391,Harrison Barnes,24-207,F,12/23/16,DAL,@,LAC,W,1,38,11,19,0.579,11,17,0.647,0,2,0,2,3,0.667,2,4,6
1392,Harrison Barnes,24-273,F,2/27/17,DAL,,MIA,W,1,36,9,18,0.5,9,17,0.529,0,1,0,6,6,1,1,3,4
1393,Harrison Barnes,24-245,F,1/30/17,DAL,,CLE,W,1,37,9,16,0.563,9,14,0.643,0,2,0,6,7,0.857,4,7,11
1394,Will Barton,26-073,G,3/20/17,DEN,@,HOU,L,0,30,8,13,0.615,4,8,0.5,4,5,0.8,4,5,0.8,0,7,7
1395,Will Barton,26-038,G,2/13/17,DEN,,GSW,W,1,41,9,19,0.474,5,11,0.455,4,8,0.5,2,2,1,2,8,10
1396,Nicolas Batum,28-087,F-G,3/11/17,CHO,,NOP,L,1,41,9,21,0.429,5,8,0.625,4,13,0.308,2,3,0.667,0,6,6
1397,Nicolas Batum,28-012,F-G,12/26/16,CHO,@,BRK,L,1,37,7,16,0.438,5,10,0.5,2,6,0.333,8,8,1,0,5,5
1398,Nicolas Batum,27-340,F-G,11/18/16,CHO,,ATL,W,1,33,8,17,0.471,4,9,0.444,4,8,0.5,4,4,1,1,9,10
1399,Kent Bazemore,27-198,G-F,1/15/17,ATL,,MIL,W,1,28,8,13,0.615,4,6,0.667,4,7,0.571,4,5,0.8,2,1,3
1400,Kent Bazemore,27-212,G-F,1/29/17,ATL,,NYK,W,1,50,9,15,0.6,5,10,0.5,4,5,0.8,2,2,1,2,8,10
1401,Bradley Beal,23-262,G,3/17/17,WAS,,CHI,W,1,32,10,18,0.556,7,14,0.5,3,4,0.75,1,1,1,1,3,4
1402,Bradley Beal,23-260,G,3/15/17,WAS,,DAL,L,1,38,9,20,0.45,5,8,0.625,4,12,0.333,2,2,1,0,2,2
1403,Nemanja Bjelica,28-188,F,11/13/16,MIN,,LAL,W,1,41,9,15,0.6,4,7,0.571,5,8,0.625,1,1,1,2,6,8
1404,Eric Bledsoe,27-017,G,12/26/16,PHO,@,HOU,L,1,27,8,20,0.4,7,12,0.583,1,8,0.125,7,9,0.778,0,6,6
1405,Eric Bledsoe,27-014,G,12/23/16,PHO,,PHI,W,1,37,7,12,0.583,5,7,0.714,2,5,0.4,8,11,0.727,1,1,2
1406,Bojan Bogdanovic,27-229,G-F,12/3/16,BRK,@,MIL,L,1,32,8,17,0.471,6,13,0.462,2,4,0.5,6,8,0.75,1,1,2
1407,Devin Booker,20-017,G,11/16/16,PHO,@,DEN,L,1,37,10,18,0.556,8,15,0.533,2,3,0.667,2,3,0.667,1,3,4
1408,Devin Booker,20-088,G,1/26/17,PHO,@,DEN,L,1,33,9,17,0.529,8,11,0.727,1,6,0.167,5,6,0.833,0,0,0
1409,Jimmy Butler,27-043,G-F,10/27/16,CHI,,BOS,W,1,37,6,17,0.353,2,11,0.182,4,6,0.667,8,12,0.667,3,4,7
1410,Jimmy Butler,27-125,G-F,1/17/17,CHI,,DAL,L,1,40,5,12,0.417,5,11,0.455,0,1,0,14,16,0.875,2,7,9
1411,Kentavious Caldwell-Pope,23-302,G,12/16/16,DET,@,WAS,L,1,34,9,17,0.529,5,10,0.5,4,7,0.571,2,3,0.667,1,5,6
1412,Clint Capela,22-290,F-C,3/4/17,HOU,,MEM,W,1,29,8,14,0.571,8,14,0.571,0,0,,8,10,0.8,4,7,11
1413,Vince Carter,40-046,G-F,3/13/17,MEM,,MIL,W,1,30,8,8,1,2,2,1,6,6,1,2,2,1,1,4,5
1414,Wilson Chandler,29-290,F,2/24/17,DEN,,BRK,W,0,29,11,21,0.524,9,15,0.6,2,6,0.333,0,0,,2,1,3
1415,Wilson Chandler,29-242,F,1/7/17,DEN,@,OKC,L,0,32,10,18,0.556,8,14,0.571,2,4,0.5,2,4,0.5,0,8,8
1416,Wilson Chandler,29-206,F,12/2/16,DEN,,HOU,L,0,29,10,19,0.526,7,12,0.583,3,7,0.429,1,3,0.333,2,3,5
1417,Wilson Chandler,29-274,F,2/8/17,DEN,@,ATL,L,1,36,9,17,0.529,5,10,0.5,4,7,0.571,2,5,0.4,3,5,8
1418,Marquese Chriss,19-262,F,3/21/17,PHO,@,MIA,L,1,38,7,9,0.778,5,7,0.714,2,2,1,8,10,0.8,1,6,7
1419,Mike Conley,29-073,G,12/23/16,MEM,,HOU,W,1,29,9,17,0.529,6,11,0.545,3,6,0.5,3,4,0.75,0,3,3
1420,Mike Conley,29-019,G,10/30/16,MEM,,WAS,W,1,38,8,19,0.421,5,14,0.357,3,5,0.6,5,5,1,1,2,3
1421,Mike Conley,29-015,G,10/26/16,MEM,,MIN,W,1,30,8,14,0.571,4,9,0.444,4,5,0.8,4,5,0.8,0,1,1
1422,DeMarcus Cousins,26-116,C-F,12/7/16,SAC,@,DAL,W,1,33,10,16,0.625,8,14,0.571,2,2,1,2,3,0.667,2,11,13
1423,DeMarcus Cousins,26-150,C-F,1/10/17,SAC,,DET,W,1,30,8,14,0.571,4,9,0.444,4,5,0.8,4,7,0.571,4,9,13
1424,DeMarcus Cousins,26-074,C-F,10/26/16,SAC,@,PHO,W,1,25,6,10,0.6,6,9,0.667,0,1,0,12,16,0.75,1,5,6
1425,Robert Covington,26-085,F,3/9/17,PHI,@,POR,L,1,40,10,21,0.476,6,13,0.462,4,8,0.5,0,0,,2,11,13
1426,Robert Covington,26-096,F,3/20/17,PHI,@,ORL,L,1,45,9,22,0.409,6,13,0.462,3,9,0.333,3,3,1,5,8,13
1427,Allen Crabbe,24-277,G-F,1/11/17,POR,,CLE,W,0,31,9,11,0.818,6,6,1,3,5,0.6,3,4,0.75,0,4,4
1428,Jamal Crawford,36-281,G,12/26/16,LAC,,DEN,L,1,36,11,23,0.478,9,18,0.5,2,5,0.4,0,0,,0,4,4
1429,Jae Crowder,26-254,F,3/17/17,BOS,@,BRK,W,1,35,7,11,0.636,3,4,0.75,4,7,0.571,6,7,0.857,0,12,12
1430,Seth Curry,26-159,G,1/29/17,DAL,@,SAS,W,1,37,10,20,0.5,6,11,0.545,4,9,0.444,0,0,,1,9,10
1431,Seth Curry,26-192,G,3/3/17,DAL,,MEM,W,1,37,8,15,0.533,6,8,0.75,2,7,0.286,6,6,1,0,5,5
1432,Stephen Curry,28-304,G,1/12/17,GSW,,DET,W,1,30,9,17,0.529,6,8,0.75,3,9,0.333,3,3,1,0,2,2
1433,Stephen Curry,28-240,G,11/9/16,GSW,,DAL,W,1,31,8,12,0.667,4,4,1,4,8,0.5,4,4,1,0,3,3
1434,Stephen Curry,28-256,G,11/25/16,GSW,@,LAL,W,1,36,8,17,0.471,4,7,0.571,4,10,0.4,4,4,1,2,3,5
1435,Stephen Curry,28-302,G,1/10/17,GSW,,MIA,W,1,36,8,21,0.381,4,10,0.4,4,11,0.364,4,5,0.8,1,7,8
1436,Stephen Curry,28-357,G,3/6/17,GSW,@,ATL,W,1,35,8,20,0.4,2,5,0.4,6,15,0.4,2,3,0.667,1,3,4
1437,Stephen Curry,28-312,G,1/20/17,GSW,@,HOU,W,1,33,8,18,0.444,3,7,0.429,5,11,0.455,3,5,0.6,0,1,1
1438,Stephen Curry,28-310,G,1/18/17,GSW,,OKC,W,1,34,9,19,0.474,7,13,0.538,2,6,0.333,4,4,1,0,4,4
1439,Troy Daniels,25-158,G,12/20/16,MEM,,BOS,L,0,35,8,13,0.615,4,6,0.667,4,7,0.571,4,4,1,0,2,2
1440,Anthony Davis,23-339,F-C,2/13/17,NOP,@,PHO,W,1,40,8,16,0.5,8,15,0.533,0,1,0,8,8,1,1,9,10
1441,Anthony Davis,24-006,F-C,3/17/17,NOP,,HOU,W,1,38,10,18,0.556,10,17,0.588,0,1,0,4,5,0.8,1,14,15
1442,DeMar DeRozan,27-115,G,11/30/16,TOR,,MEM,W,1,36,6,9,0.667,4,6,0.667,2,3,0.667,10,11,0.909,1,8,9
1443,DeMar DeRozan,27-144,G,12/29/16,TOR,@,PHO,L,1,35,8,18,0.444,8,15,0.533,0,3,0,8,10,0.8,0,3,3
1444,DeMar DeRozan,27-124,G,12/9/16,TOR,@,BOS,W,1,37,9,25,0.36,9,24,0.375,0,1,0,6,6,1,0,5,5
1445,DeMar DeRozan,27-108,G,11/23/16,TOR,@,HOU,W,1,36,8,19,0.421,6,16,0.375,2,3,0.667,6,7,0.857,2,3,5
1446,DeMar DeRozan,27-206,G,3/1/17,TOR,,WAS,L,1,34,7,20,0.35,7,20,0.35,0,0,,10,11,0.909,0,3,3
1447,DeMar DeRozan,27-138,G,12/23/16,TOR,@,UTA,W,1,37,10,24,0.417,10,23,0.435,0,1,0,4,6,0.667,1,5,6
1448,Goran Dragic,30-242,G,1/3/17,MIA,@,PHO,L,1,38,9,18,0.5,8,16,0.5,1,2,0.5,5,6,0.833,0,3,3
1449,Goran Dragic,30-297,G,2/27/17,MIA,@,DAL,L,1,37,10,21,0.476,8,16,0.5,2,5,0.4,2,3,0.667,3,2,5
1450,Goran Dragic,30-247,G,1/8/17,MIA,@,LAC,L,1,42,9,18,0.5,7,13,0.538,2,5,0.4,4,5,0.8,1,5,6
1451,Andre Drummond,23-182,C,2/8/17,DET,,LAL,W,1,28,12,19,0.632,12,19,0.632,0,0,,0,3,0,5,12,17
1452,Andre Drummond,23-213,C,3/11/17,DET,,NYK,W,1,30,10,12,0.833,10,12,0.833,0,0,,4,10,0.4,5,10,15
1453,Kevin Durant,28-134,F-G,2/10/17,GSW,@,MEM,W,1,32,5,14,0.357,2,8,0.25,3,6,0.5,11,14,0.786,0,5,5
1454,Joel Embiid,22-303,C-F,1/13/17,PHI,,CHO,W,1,28,6,12,0.5,6,7,0.857,0,5,0,12,14,0.857,0,8,8
1455,Evan Fournier,24-107,G-F,2/13/17,ORL,@,MIA,W,1,36,10,17,0.588,8,13,0.615,2,4,0.5,2,5,0.4,0,2,2
1456,Evan Fournier,24-046,G-F,12/14/16,ORL,,LAC,L,1,33,9,17,0.529,7,13,0.538,2,4,0.5,4,4,1,1,0,1
1457,Evan Fournier,24-103,G-F,2/9/17,ORL,,PHI,L,1,43,8,21,0.381,5,15,0.333,3,6,0.5,5,5,1,2,7,9
1458,Evan Fournier,24-042,G-F,12/10/16,ORL,,DEN,L,1,38,9,19,0.474,7,13,0.538,2,6,0.333,4,5,0.8,0,4,4
1459,Danilo Gallinari,28-148,F,1/3/17,DEN,,SAC,L,1,33,8,12,0.667,4,6,0.667,4,6,0.667,4,4,1,0,4,4
1460,Danilo Gallinari,28-202,F,2/26/17,DEN,,MEM,L,1,35,6,16,0.375,4,9,0.444,2,7,0.286,10,11,0.909,0,4,4
1461,Danilo Gallinari,28-119,F,12/5/16,DEN,@,PHI,W,1,38,5,12,0.417,2,5,0.4,3,7,0.429,11,12,0.917,1,3,4
1462,Marc Gasol,31-352,C,1/15/17,MEM,,CHI,L,1,40,10,21,0.476,8,16,0.5,2,5,0.4,2,2,1,1,10,11
1463,Marc Gasol,32-003,C,2/1/17,MEM,@,DEN,W,1,24,9,15,0.6,6,11,0.545,3,4,0.75,3,3,1,0,5,5
1464,Marc Gasol,31-326,C,12/20/16,MEM,,BOS,L,1,37,8,22,0.364,5,18,0.278,3,4,0.75,5,5,1,1,6,7
1465,Pau Gasol,36-133,F-C,11/16/16,SAS,@,SAC,W,1,31,10,17,0.588,10,16,0.625,0,1,0,4,7,0.571,1,6,7
1466,Paul George,26-261,F,1/18/17,IND,@,SAC,W,1,42,8,15,0.533,6,10,0.6,2,5,0.4,6,6,1,0,4,4
1467,Paul George,26-277,F,2/3/17,IND,@,BRK,W,1,37,9,22,0.409,8,17,0.471,1,5,0.2,5,5,1,2,9,11
1468,Eric Gordon,27-362,G,12/21/16,HOU,@,PHO,W,0,28,8,17,0.471,1,4,0.25,7,13,0.538,1,2,0.5,0,2,2
1469,Eric Gordon,27-340,G,11/29/16,HOU,@,UTA,L,0,32,8,17,0.471,4,8,0.5,4,9,0.444,4,5,0.8,0,2,2
1470,Eric Gordon,27-353,G,12/12/16,HOU,,BRK,W,0,29,7,15,0.467,1,5,0.2,6,10,0.6,4,6,0.667,0,0,0
1471,Eric Gordon,28-021,G,1/15/17,HOU,@,BRK,W,0,28,9,14,0.643,5,6,0.833,4,8,0.5,2,3,0.667,1,2,3
1472,Blake Griffin,27-263,F,12/4/16,LAC,,IND,L,1,34,10,21,0.476,10,21,0.476,0,0,,4,7,0.571,4,12,16
1473,Blake Griffin,27-254,F,11/25/16,LAC,@,DET,L,1,36,9,17,0.529,8,16,0.5,1,1,1,5,8,0.625,2,1,3
1474,Tim Hardaway,24-354,G,3/5/17,ATL,,IND,L,0,35,9,16,0.563,5,9,0.556,4,7,0.571,2,2,1,1,3,4
1475,James Harden,27-075,G,11/9/16,HOU,@,SAS,W,1,41,9,19,0.474,8,14,0.571,1,5,0.2,5,7,0.714,2,10,12
1476,James Harden,27-183,G,2/25/17,HOU,,MIN,W,1,35,6,15,0.4,1,4,0.25,5,11,0.455,7,10,0.7,0,5,5
1477,Gary Harris,22-178,G,3/11/17,DEN,@,SAC,W,1,36,10,15,0.667,8,10,0.8,2,5,0.4,2,2,1,1,2,3
1478,Gary Harris,22-096,G,12/19/16,DEN,,DAL,W,1,34,9,13,0.692,5,7,0.714,4,6,0.667,2,4,0.5,0,2,2
1479,Tobias Harris,24-212,F,2/12/17,DET,@,TOR,W,0,31,9,13,0.692,7,9,0.778,2,4,0.5,4,4,1,0,6,6
1480,Tobias Harris,24-249,F,3/21/17,DET,@,BRK,L,1,36,10,15,0.667,10,12,0.833,0,3,0,4,5,0.8,2,3,5
1481,Tobias Harris,24-137,F,11/29/16,DET,@,CHO,W,1,36,9,12,0.75,6,7,0.857,3,5,0.6,3,3,1,0,7,7
1482,Gordon Hayward,26-250,F-G,11/28/16,UTA,@,MIN,W,1,34,6,14,0.429,6,11,0.545,0,3,0,12,15,0.8,0,5,5
1483,Gordon Hayward,26-247,F-G,11/25/16,UTA,,ATL,W,1,31,8,14,0.571,7,13,0.538,1,1,1,7,7,1,1,6,7
1484,Gordon Hayward,26-309,F-G,1/26/17,UTA,,LAL,W,1,32,7,14,0.5,6,8,0.75,1,6,0.167,9,10,0.9,0,3,3
1485,George Hill,30-208,G,11/28/16,UTA,@,MIN,W,1,34,7,15,0.467,7,12,0.583,0,3,0,10,11,0.909,1,7,8
1486,Richaun Holmes,23-156,F-C,3/20/17,PHI,@,ORL,L,1,42,11,19,0.579,10,15,0.667,1,4,0.25,1,1,1,5,9,14
1487,Richaun Holmes,23-147,F-C,3/11/17,PHI,@,LAC,L,0,27,10,14,0.714,8,11,0.727,2,3,0.667,2,4,0.5,0,9,9
1488,Dwight Howard,31-056,C,2/2/17,ATL,@,HOU,W,1,37,11,13,0.846,11,13,0.846,0,0,,2,3,0.667,5,18,23
1489,Andre Iguodala,33-037,G-F,3/6/17,GSW,@,ATL,W,0,35,6,8,0.75,2,2,1,4,6,0.667,8,11,0.727,3,2,5
1490,Ersan Ilyasova,29-250,F,1/20/17,PHI,,POR,W,1,29,9,14,0.643,4,8,0.5,5,6,0.833,1,2,0.5,2,4,6
1491,Kyrie Irving,24-238,G,11/16/16,CLE,@,IND,L,1,32,10,20,0.5,9,15,0.6,1,5,0.2,3,4,0.75,1,1,2
1492,Kyrie Irving,24-257,G,12/5/16,CLE,@,TOR,W,1,37,9,18,0.5,7,12,0.583,2,6,0.333,4,4,1,1,1,2
1493,Kyrie Irving,24-237,G,11/15/16,CLE,,TOR,W,1,35,10,20,0.5,8,16,0.5,2,4,0.5,2,4,0.5,2,3,5
1494,Reggie Jackson,26-287,G,1/28/17,DET,@,MIA,L,1,31,10,17,0.588,8,15,0.533,2,2,1,2,2,1,0,7,7
1495,LeBron James,32-059,F-G,2/27/17,CLE,,MIL,W,1,37,8,12,0.667,7,10,0.7,1,2,0.5,7,9,0.778,0,10,10
1496,LeBron James,32-071,F-G,3/11/17,CLE,@,ORL,W,1,38,8,14,0.571,6,9,0.667,2,5,0.4,6,10,0.6,0,12,12
1497,LeBron James,32-026,F-G,1/25/17,CLE,,SAC,L,1,45,8,15,0.533,8,12,0.667,0,3,0,8,11,0.727,4,9,13
1498,James Johnson,30-027,F,3/19/17,MIA,,POR,L,0,31,9,13,0.692,7,10,0.7,2,3,0.667,4,5,0.8,1,6,7
1499,James Johnson,29-285,F,12/1/16,MIA,@,UTA,W,0,24,11,15,0.733,9,11,0.818,2,4,0.5,0,0,,3,3,6
1500,Tyler Johnson,24-298,G,3/1/17,MIA,,PHI,W,0,28,8,12,0.667,6,9,0.667,2,3,0.667,6,8,0.75,0,2,2
1501,Nikola Jokic,21-311,C-F,12/26/16,DEN,@,LAC,W,1,32,11,16,0.688,9,13,0.692,2,3,0.667,0,1,0,2,8,10
1502,Terrence Jones,25-003,F,1/12/17,NOP,@,BRK,W,1,38,10,17,0.588,9,15,0.6,1,2,0.5,3,9,0.333,2,10,12
1503,DeAndre Jordan,28-177,C,1/14/17,LAC,,LAL,W,1,35,12,13,0.923,12,13,0.923,0,0,,0,1,0,3,18,21
1504,Frank Kaminsky,23-330,F-C,2/28/17,CHO,@,LAL,W,1,36,8,15,0.533,4,8,0.5,4,7,0.571,4,4,1,1,11,12
1505,Frank Kaminsky,23-303,F-C,2/1/17,CHO,@,GSW,L,0,24,9,14,0.643,7,8,0.875,2,6,0.333,4,4,1,0,7,7
1506,Enes Kanter,24-171,C,11/7/16,OKC,,MIA,W,0,21,10,12,0.833,10,12,0.833,0,0,,4,4,1,4,6,10
1507,Sean Kilpatrick,26-301,G,11/2/16,BRK,,DET,W,0,28,8,12,0.667,4,8,0.5,4,4,1,4,4,1,0,10,10
1508,Zach LaVine,21-282,G,12/17/16,MIN,,HOU,L,1,45,9,18,0.5,6,11,0.545,3,7,0.429,3,5,0.6,0,2,2
1509,Zach LaVine,21-278,G,12/13/16,MIN,@,CHI,W,1,43,10,18,0.556,9,14,0.643,1,4,0.25,3,4,0.75,1,5,6
1510,Zach LaVine,21-295,G,12/30/16,MIN,,MIL,W,1,39,9,17,0.529,3,8,0.375,6,9,0.667,0,0,,0,2,2
1511,Zach LaVine,21-303,G,1/7/17,MIN,,UTA,L,1,38,10,21,0.476,7,12,0.583,3,9,0.333,1,1,1,3,6,9
1512,Kawhi Leonard,25-162,F,12/8/16,SAS,@,CHI,L,1,38,10,19,0.526,9,17,0.529,1,2,0.5,3,3,1,3,5,8
1513,Kawhi Leonard,25-145,F,11/21/16,SAS,,DAL,W,1,34,8,19,0.421,7,18,0.389,1,1,1,7,8,0.875,2,7,9
1514,Kawhi Leonard,25-138,F,11/14/16,SAS,,MIA,W,1,35,7,19,0.368,4,14,0.286,3,5,0.6,7,9,0.778,1,11,12
1515,Kawhi Leonard,25-214,F,1/29/17,SAS,,DAL,L,1,37,7,17,0.412,4,10,0.4,3,7,0.429,7,8,0.875,1,6,7
1516,Kawhi Leonard,25-190,F,1/5/17,SAS,@,DEN,W,1,36,9,19,0.474,6,13,0.462,3,6,0.5,3,4,0.75,1,5,6
1517,Jon Leuer,27-265,F,2/3/17,DET,,MIN,W,1,35,8,16,0.5,4,9,0.444,4,7,0.571,4,5,0.8,2,2,4
1518,Damian Lillard,26-158,G,12/20/16,POR,@,SAC,L,1,39,6,20,0.3,5,11,0.455,1,9,0.111,11,12,0.917,0,4,4
1519,Damian Lillard,26-150,G,12/12/16,POR,@,LAC,L,1,37,7,17,0.412,3,10,0.3,4,7,0.571,6,6,1,0,5,5
1520,Damian Lillard,26-194,G,1/25/17,POR,,LAL,W,1,35,8,20,0.4,7,15,0.467,1,5,0.2,7,7,1,0,4,4
1521,Damian Lillard,26-237,G,3/9/17,POR,,PHI,W,1,41,6,21,0.286,6,15,0.4,0,6,0,12,12,1,0,4,4
1522,Jeremy Lin,28-203,G,3/14/17,BRK,,OKC,L,1,26,8,15,0.533,6,11,0.545,2,4,0.5,6,6,1,0,2,2
1523,Brook Lopez,28-250,C,12/7/16,BRK,,DEN,W,1,33,7,17,0.412,5,12,0.417,2,5,0.4,8,10,0.8,3,5,8
1524,Brook Lopez,28-295,C,1/21/17,BRK,@,CHO,L,1,31,10,21,0.476,7,14,0.5,3,7,0.429,1,1,1,0,5,5
1525,Brook Lopez,28-334,C,3/1/17,BRK,@,SAC,W,1,30,9,17,0.529,8,12,0.667,1,5,0.2,5,7,0.714,3,5,8
1526,Brook Lopez,28-349,C,3/16/17,BRK,@,NYK,W,1,30,9,17,0.529,8,13,0.615,1,4,0.25,5,5,1,1,5,6
1527,Kevin Love,28-055,F,11/1/16,CLE,,HOU,W,1,31,9,16,0.563,8,14,0.571,1,2,0.5,5,5,1,1,4,5
1528,Kevin Love,28-062,F,11/8/16,CLE,,ATL,L,1,38,7,17,0.412,7,13,0.538,0,4,0,10,11,0.909,6,6,12
1529,Kyle Lowry,30-255,G,12/5/16,TOR,,CLE,L,1,40,7,14,0.5,3,5,0.6,4,9,0.444,6,7,0.857,1,2,3
1530,Kyle Lowry,30-318,G,2/6/17,TOR,,LAC,W,1,38,6,14,0.429,1,6,0.167,5,8,0.625,7,7,1,0,4,4
1531,Kyle Lowry,30-236,G,11/16/16,TOR,,GSW,L,1,38,6,17,0.353,3,11,0.273,3,6,0.5,9,12,0.75,2,3,5
1532,Kyle Lowry,30-252,G,12/2/16,TOR,,LAL,W,1,31,8,12,0.667,2,3,0.667,6,9,0.667,2,2,1,0,4,4
1533,Kyle Lowry,30-301,G,1/20/17,TOR,@,CHO,L,1,34,7,18,0.389,4,8,0.5,3,10,0.3,7,7,1,0,1,1
1534,Kyle Lowry,30-248,G,11/28/16,TOR,,PHI,W,1,32,7,9,0.778,1,3,0.333,6,6,1,4,5,0.8,0,4,4
1535,Kyle Lowry,30-299,G,1/18/17,TOR,@,PHI,L,1,40,5,13,0.385,2,5,0.4,3,8,0.375,11,16,0.688,3,1,4
1536,Kyle Lowry,30-279,G,12/29/16,TOR,@,PHO,L,1,38,7,15,0.467,4,6,0.667,3,9,0.333,7,9,0.778,0,5,5
1537,Kyle Lowry,30-291,G,1/10/17,TOR,,BOS,W,1,42,7,12,0.583,2,6,0.333,5,6,0.833,5,8,0.625,1,3,4
1538,C.J. McCollum,25-067,G,11/25/16,POR,,NOP,W,1,36,9,19,0.474,5,11,0.455,4,8,0.5,2,2,1,0,1,1
1539,C.J. McCollum,25-080,G,12/8/16,POR,@,MEM,L,1,35,7,13,0.538,3,9,0.333,4,4,1,6,6,1,0,0,0
1540,C.J. McCollum,25-128,G,1/25/17,POR,,LAL,W,1,33,9,16,0.563,7,13,0.538,2,3,0.667,4,4,1,0,4,4
1541,C.J. McCollum,25-060,G,11/18/16,POR,@,NOP,L,1,36,7,18,0.389,3,10,0.3,4,8,0.5,6,6,1,1,3,4
1542,C.J. McCollum,25-077,G,12/5/16,POR,@,CHI,W,1,30,10,19,0.526,6,12,0.5,4,7,0.571,0,0,,1,1,2
1543,C.J. McCollum,25-044,G,11/2/16,POR,@,PHO,L,1,39,8,18,0.444,5,12,0.417,3,6,0.5,5,5,1,0,4,4
1544,Khris Middleton,25-204,F-G,3/4/17,MIL,,TOR,W,1,30,9,14,0.643,8,10,0.8,1,4,0.25,5,6,0.833,0,3,3
1545,Paul Millsap,32-026,F,3/8/17,ATL,,BRK,W,1,39,10,21,0.476,10,17,0.588,0,4,0,4,5,0.8,2,2,4
1546,Paul Millsap,31-299,F,12/5/16,ATL,,OKC,L,1,39,8,14,0.571,7,10,0.7,1,4,0.25,7,11,0.636,0,5,5
1547,Nikola Mirotic,26-030,F,3/13/17,CHI,@,CHO,W,0,29,8,16,0.5,3,4,0.75,5,12,0.417,3,3,1,3,8,11
1548,Greg Monroe,26-272,C-F,3/3/17,MIL,,LAC,W,0,35,11,15,0.733,11,15,0.733,0,0,,2,2,1,2,3,5
1549,Marcus Morris,27-078,F,11/19/16,DET,,BOS,L,1,33,10,16,0.625,6,9,0.667,4,7,0.571,0,0,,1,4,5
1550,Markieff Morris,27-151,F,1/31/17,WAS,,NYK,W,1,34,9,14,0.643,7,9,0.778,2,5,0.4,4,4,1,2,8,10
1551,Markieff Morris,27-071,F,11/12/16,WAS,@,CHI,L,1,44,9,19,0.474,9,18,0.5,0,1,0,6,6,1,4,11,15
1552,Dejounte Murray,20-122,G,1/19/17,SAS,,DEN,W,1,34,7,11,0.636,4,6,0.667,3,5,0.6,7,7,1,0,2,2
1553,Jamal Murray,19-273,G,11/22/16,DEN,,CHI,W,0,22,9,13,0.692,6,9,0.667,3,4,0.75,3,3,1,2,4,6
1554,Dirk Nowitzki,38-241,F,2/15/17,DAL,@,DET,L,1,30,9,19,0.474,5,13,0.385,4,6,0.667,2,2,1,0,10,10
1555,Victor Oladipo,24-277,G,2/5/17,OKC,,POR,W,1,39,8,18,0.444,7,14,0.5,1,4,0.25,7,9,0.778,0,12,12
1556,Jabari Parker,21-304,F,1/13/17,MIL,,MIA,W,1,35,9,20,0.45,6,15,0.4,3,5,0.6,3,6,0.5,1,4,5
1557,Chris Paul,31-185,G,11/7/16,LAC,,DET,W,1,25,8,10,0.8,3,5,0.6,5,5,1,3,4,0.75,0,6,6
1558,Chris Paul,31-178,G,10/31/16,LAC,,PHO,W,1,30,8,15,0.533,6,11,0.545,2,4,0.5,6,7,0.857,0,5,5
1559,Kristaps Porzingis,21-157,F-C,1/6/17,NYK,@,MIL,W,1,30,9,14,0.643,6,10,0.6,3,4,0.75,3,4,0.75,0,6,6
1560,Kristaps Porzingis,21-148,F-C,12/28/16,NYK,@,ATL,L,1,42,7,17,0.412,3,9,0.333,4,8,0.5,6,9,0.667,2,6,8
1561,Kristaps Porzingis,21-215,F-C,3/5/17,NYK,,GSW,L,1,40,9,21,0.429,7,15,0.467,2,6,0.333,4,4,1,4,11,15
1562,Kristaps Porzingis,21-104,F-C,11/14/16,NYK,,DAL,W,1,36,8,16,0.5,6,11,0.545,2,5,0.4,6,6,1,2,9,11
1563,Zach Randolph,35-230,F,3/3/17,MEM,@,DAL,L,0,29,11,14,0.786,11,13,0.846,0,1,0,2,4,0.5,5,5,10
1564,J.J. Redick,32-154,G,11/25/16,LAC,@,DET,L,1,33,9,14,0.643,6,8,0.75,3,6,0.5,3,3,1,0,3,3
1565,J.J. Redick,32-270,G,3/21/17,LAC,@,LAL,W,1,18,7,9,0.778,3,4,0.75,4,5,0.8,6,6,1,0,3,3
1566,Austin Rivers,24-158,G,1/6/17,LAC,@,SAC,W,1,36,9,15,0.6,5,8,0.625,4,7,0.571,2,3,0.667,2,4,6
1567,Rajon Rondo,31-027,G,3/21/17,CHI,@,TOR,L,1,40,9,16,0.563,5,9,0.556,4,7,0.571,2,2,1,1,4,5
1568,Derrick Rose,28-077,G,12/20/16,NYK,,IND,W,1,36,9,18,0.5,9,18,0.5,0,0,,6,7,0.857,0,4,4
1569,Derrick Rose,28-059,G,12/2/16,NYK,,MIN,W,1,34,9,15,0.6,9,14,0.643,0,1,0,6,10,0.6,1,4,5
1570,Terrence Ross,26-020,F-G,2/25/17,ORL,,ATL,W,1,35,10,15,0.667,6,8,0.75,4,7,0.571,0,0,,0,4,4
1571,Terrence Ross,25-327,F-G,12/28/16,TOR,@,GSW,L,0,34,10,23,0.435,6,14,0.429,4,9,0.444,0,0,,3,4,7
1572,Dennis Schroder,23-146,G,2/8/17,ATL,,DEN,W,1,35,10,19,0.526,10,15,0.667,0,4,0,4,4,1,1,4,5
1573,Dennis Schroder,23-092,G,12/16/16,ATL,@,TOR,W,1,29,8,12,0.667,6,8,0.75,2,4,0.5,6,7,0.857,1,1,2
1574,Dennis Schroder,23-074,G,11/28/16,ATL,@,GSW,L,1,34,10,20,0.5,9,16,0.563,1,4,0.25,3,4,0.75,0,1,1
1575,Dennis Schroder,23-132,G,1/25/17,ATL,@,CHI,W,1,33,7,15,0.467,3,9,0.333,4,6,0.667,6,6,1,0,2,2
1576,Nik Stauskas,23-148,G,3/4/17,PHI,,DET,L,1,37,10,15,0.667,6,8,0.75,4,7,0.571,0,0,,0,5,5
1577,Jeff Teague,28-238,G,2/3/17,IND,@,BRK,W,1,34,6,10,0.6,4,8,0.5,2,2,1,10,13,0.769,1,2,3
1578,Isaiah Thomas,27-292,G,11/25/16,BOS,,SAS,L,1,36,9,21,0.429,6,12,0.5,3,9,0.333,3,4,0.75,0,1,1
1579,Isaiah Thomas,27-334,G,1/6/17,BOS,,PHI,W,1,35,6,14,0.429,4,10,0.4,2,4,0.5,10,11,0.909,1,3,4
1580,Isaiah Thomas,27-286,G,11/19/16,BOS,@,DET,W,1,36,7,22,0.318,5,14,0.357,2,8,0.25,8,9,0.889,1,3,4
1581,Isaiah Thomas,27-265,G,10/29/16,BOS,@,CHO,W,1,35,9,20,0.45,7,13,0.538,2,7,0.286,4,7,0.571,0,1,1
1582,Klay Thompson,27-017,G,2/25/17,GSW,,BRK,W,1,31,8,18,0.444,6,13,0.462,2,5,0.4,6,6,1,0,4,4
1583,Klay Thompson,26-321,G,12/25/16,GSW,@,CLE,L,1,41,9,16,0.563,4,5,0.8,5,11,0.455,1,2,0.5,0,2,2
1584,Klay Thompson,26-273,G,11/7/16,GSW,,NOP,W,1,38,11,20,0.55,9,13,0.692,2,7,0.286,0,0,,0,4,4
1585,Klay Thompson,26-303,G,12/7/16,GSW,@,LAC,W,1,35,8,18,0.444,5,12,0.417,3,6,0.5,5,5,1,2,2,4
1586,Karl-Anthony Towns,21-080,F-C,2/3/17,MIN,@,DET,L,1,33,11,19,0.579,11,17,0.647,0,2,0,2,4,0.5,7,4,11
1587,Karl-Anthony Towns,21-092,F-C,2/15/17,MIN,@,DEN,W,1,39,8,19,0.421,7,17,0.412,1,2,0.5,7,8,0.875,4,15,19
1588,Karl-Anthony Towns,20-363,F-C,11/12/16,MIN,,LAC,L,1,33,10,18,0.556,9,15,0.6,1,3,0.333,3,4,0.75,4,6,10
1589,Karl-Anthony Towns,21-109,F-C,3/4/17,MIN,@,SAS,L,1,46,9,16,0.563,9,14,0.643,0,2,0,6,8,0.75,6,8,14
1590,Evan Turner,28-099,G,2/3/17,POR,,DAL,L,1,32,10,17,0.588,9,13,0.692,1,4,0.25,3,3,1,0,4,4
1591,Nikola Vucevic,26-016,C,11/9/16,ORL,,MIN,L,1,30,11,19,0.579,10,18,0.556,1,1,1,1,2,0.5,6,8,14
1592,Nikola Vucevic,26-008,C,11/1/16,ORL,@,PHI,W,1,31,11,16,0.688,11,16,0.688,0,0,,2,3,0.667,5,9,14
1593,Dwyane Wade,34-320,G,12/2/16,CHI,,CLE,W,1,37,11,23,0.478,10,19,0.526,1,4,0.25,1,2,0.5,3,2,5
1594,Dwyane Wade,34-343,G,12/25/16,CHI,@,SAS,L,1,28,9,16,0.563,8,13,0.615,1,3,0.333,5,5,1,2,1,3
1595,Dion Waiters,25-046,G,1/25/17,MIA,@,BRK,W,1,36,10,18,0.556,8,15,0.533,2,3,0.667,2,4,0.5,0,5,5
1596,Dion Waiters,25-088,G,3/8/17,MIA,,CHO,W,1,27,8,16,0.5,3,6,0.5,5,10,0.5,3,4,0.75,1,2,3
1597,Kemba Walker,26-173,G,10/28/16,CHO,@,MIA,W,1,31,7,18,0.389,5,13,0.385,2,5,0.4,8,9,0.889,0,1,1
1598,Kemba Walker,26-307,G,3/11/17,CHO,,NOP,L,1,40,9,24,0.375,5,9,0.556,4,15,0.267,2,2,1,0,8,8
1599,Kemba Walker,26-216,G,12/10/16,CHO,@,CLE,L,1,30,9,14,0.643,6,9,0.667,3,5,0.6,3,4,0.75,0,1,1
1600,Kemba Walker,26-253,G,1/16/17,CHO,@,BOS,L,1,38,8,21,0.381,5,14,0.357,3,7,0.429,5,5,1,2,2,4
1601,Kemba Walker,26-173,G,10/28/16,CHO,@,MIA,W,1,31,7,18,0.389,5,13,0.385,2,5,0.4,8,9,0.889,0,1,1
1602,Kemba Walker,26-307,G,3/11/17,CHO,,NOP,L,1,40,9,24,0.375,5,9,0.556,4,15,0.267,2,2,1,0,8,8
1603,John Wall,26-139,G,1/23/17,WAS,@,CHO,W,1,38,9,20,0.45,9,19,0.474,0,1,0,6,7,0.857,0,4,4
1604,John Wall,26-151,G,2/4/17,WAS,,NOP,W,1,38,8,19,0.421,6,12,0.5,2,7,0.286,6,8,0.75,1,2,3
1605,John Wall,26-132,G,1/16/17,WAS,,POR,W,1,28,10,17,0.588,8,14,0.571,2,3,0.667,2,2,1,1,3,4
1606,John Wall,26-095,G,12/10/16,WAS,,MIL,W,1,39,8,20,0.4,7,16,0.438,1,4,0.25,7,8,0.875,0,4,4
1607,T.J. Warren,23-191,F,3/15/17,PHO,,SAC,L,1,41,12,16,0.75,12,16,0.75,0,0,,0,0,,6,3,9
1608,T.J. Warren,23-119,F,1/2/17,PHO,@,LAC,L,1,41,12,20,0.6,12,19,0.632,0,1,0,0,0,,5,3,8
1609,Russell Westbrook,28-060,G,1/11/17,OKC,,MEM,W,1,37,6,20,0.3,6,13,0.462,0,7,0,12,15,0.8,1,12,13
1610,Russell Westbrook,28-124,G,3/16/17,OKC,@,TOR,W,1,28,8,17,0.471,4,9,0.444,4,8,0.5,4,4,1,0,10,10
1611,Russell Westbrook,28-065,G,1/16/17,OKC,@,LAC,L,1,29,7,19,0.368,5,12,0.417,2,7,0.286,8,9,0.889,1,4,5
1612,Isaiah Whitehead,22-002,G,3/10/17,BRK,@,DAL,L,0,25,8,12,0.667,5,6,0.833,3,6,0.5,5,5,1,0,0,0
1613,Andrew Wiggins,22-015,F-G,3/10/17,MIN,,GSW,W,1,37,9,21,0.429,8,20,0.4,1,1,1,5,7,0.714,2,2,4
1614,Andrew Wiggins,21-334,F-G,1/22/17,MIN,,DEN,W,1,39,10,20,0.5,9,17,0.529,1,3,0.333,3,4,0.75,0,4,4
1615,Andrew Wiggins,21-313,F-G,1/1/17,MIN,,POR,L,1,38,10,20,0.5,9,17,0.529,1,3,0.333,3,7,0.429,3,2,5
1616,Deron Williams,32-183,G,12/26/16,DAL,@,NOP,L,1,32,9,18,0.5,6,11,0.545,3,7,0.429,3,4,0.75,1,1,2
1617,Lou Williams,30-082,G,1/17/17,LAL,,DEN,L,0,31,8,17,0.471,6,11,0.545,2,6,0.333,6,6,1,1,3,4
1618,Lou Williams,30-022,G,11/18/16,LAL,,SAS,L,0,27,9,13,0.692,7,9,0.778,2,4,0.5,4,4,1,0,3,3
1619,Lou Williams,30-045,G,12/11/16,LAL,,NYK,L,0,26,6,13,0.462,4,6,0.667,2,7,0.286,10,10,1,0,6,6
1620,Lou Williams,30-041,G,12/7/16,LAL,@,HOU,L,0,25,7,12,0.583,5,8,0.625,2,4,0.5,8,8,1,1,0,1
1621,Lou Williams,30-071,G,1/6/17,LAL,,MIA,W,0,24,9,19,0.474,4,9,0.444,5,10,0.5,1,1,1,0,1,1
1622,Nick Young,31-202,G-F,12/20/16,LAL,@,CHO,L,1,27,9,18,0.5,4,8,0.5,5,10,0.5,1,1,1,0,2,2
1623,Thaddeus Young,28-172,F,12/10/16,IND,,POR,W,1,40,9,13,0.692,3,5,0.6,6,8,0.75,0,0,,3,6,9
1624,Thaddeus Young,28-155,F,11/23/16,IND,,ATL,L,1,41,10,13,0.769,8,10,0.8,2,3,0.667,2,3,0.667,3,4,7
1625,LaMarcus Aldridge,31-122,F-C,11/18/16,SAS,@,LAL,W,1,36,10,14,0.714,9,13,0.692,1,1,1,2,2,1,0,6,6
1626,LaMarcus Aldridge,31-211,F-C,2/15/17,SAS,@,ORL,W,1,28,10,13,0.769,10,13,0.769,0,0,,3,4,0.75,1,2,3
1627,LaMarcus Aldridge,31-168,F-C,1/3/17,SAS,,TOR,W,1,30,11,16,0.688,10,15,0.667,1,1,1,0,0,,0,7,7
1628,LaMarcus Aldridge,31-127,F-C,11/23/16,SAS,@,CHO,W,1,37,8,17,0.471,8,15,0.533,0,2,0,7,8,0.875,3,4,7
1629,Al-Farouq Aminu,26-164,F,3/4/17,POR,,BRK,W,0,32,9,13,0.692,4,7,0.571,5,6,0.833,0,0,,1,5,6
1630,Ryan Anderson,28-185,F,11/7/16,HOU,@,WAS,W,1,34,9,15,0.6,4,7,0.571,5,8,0.625,0,0,,3,4,7
1631,Ryan Anderson,28-299,F,3/1/17,HOU,@,LAC,W,1,30,6,16,0.375,0,5,0,6,11,0.545,5,6,0.833,3,5,8
1632,Giannis Antetokounmpo,22-041,F-G,1/16/17,MIL,,PHI,L,1,29,10,19,0.526,10,18,0.556,0,1,0,3,5,0.6,2,4,6
1633,Giannis Antetokounmpo,22-022,F-G,12/28/16,MIL,@,DET,W,1,35,8,18,0.444,7,15,0.467,1,3,0.333,6,7,0.857,1,4,5
1634,Giannis Antetokounmpo,21-361,F-G,12/1/16,MIL,@,BRK,W,1,30,7,14,0.5,5,9,0.556,2,5,0.4,7,9,0.778,2,6,8
1635,Giannis Antetokounmpo,22-059,F-G,2/3/17,MIL,@,DEN,L,1,35,9,13,0.692,8,10,0.8,1,3,0.333,4,4,1,0,8,8
1636,Carmelo Anthony,32-228,F,1/12/17,NYK,,CHI,W,1,34,10,19,0.526,8,13,0.615,2,6,0.333,1,2,0.5,1,8,9
1637,Trevor Ariza,31-199,F,1/15/17,HOU,@,BRK,W,1,33,7,11,0.636,1,1,1,6,10,0.6,3,3,1,2,6,8
1638,J.J. Barea,32-131,G,11/4/16,DAL,,POR,L,1,30,7,17,0.412,2,9,0.222,5,8,0.625,4,4,1,0,0,0
1639,Harrison Barnes,24-285,F,3/11/17,DAL,,PHO,L,1,36,5,16,0.313,5,15,0.333,0,1,0,13,14,0.929,3,4,7
1640,Harrison Barnes,24-181,F,11/27/16,DAL,,NOP,W,1,41,9,24,0.375,8,20,0.4,1,4,0.25,4,4,1,0,7,7
1641,Harrison Barnes,24-240,F,1/25/17,DAL,,NYK,W,1,37,8,15,0.533,8,13,0.615,0,2,0,7,7,1,1,4,5
1642,Will Barton,25-355,G,12/26/16,DEN,@,LAC,W,0,32,8,14,0.571,5,8,0.625,3,6,0.5,4,5,0.8,0,8,8
1643,Nicolas Batum,28-006,F-G,12/20/16,CHO,,LAL,W,1,37,8,12,0.667,6,9,0.667,2,3,0.667,5,5,1,1,4,5
1644,Bradley Beal,23-246,G,3/1/17,WAS,@,TOR,W,1,32,9,17,0.529,8,11,0.727,1,6,0.167,4,4,1,0,1,1
1645,Bradley Beal,23-157,G,12/2/16,WAS,@,SAS,L,1,30,7,11,0.636,2,6,0.333,5,5,1,4,5,0.8,0,0,0
1646,Bradley Beal,23-219,G,2/2/17,WAS,,LAL,W,1,34,9,17,0.529,4,8,0.5,5,9,0.556,0,0,,0,1,1
1647,Bradley Beal,23-253,G,3/8/17,WAS,@,DEN,W,1,34,9,15,0.6,4,8,0.5,5,7,0.714,0,0,,1,2,3
1648,Michael Beasley,28-035,F,2/13/17,MIL,,DET,W,1,32,10,13,0.769,10,12,0.833,0,1,0,3,3,1,0,3,3
1649,Eric Bledsoe,27-063,G,2/10/17,PHO,,CHI,W,1,33,9,19,0.474,8,16,0.5,1,3,0.333,4,5,0.8,0,3,3
1650,Eric Bledsoe,27-043,G,1/21/17,PHO,@,NYK,W,1,39,6,14,0.429,5,10,0.5,1,4,0.25,10,10,1,1,4,5
1651,Eric Bledsoe,26-352,G,11/25/16,PHO,,MIN,L,1,34,8,15,0.533,6,10,0.6,2,5,0.4,5,7,0.714,2,4,6
1652,Bojan Bogdanovic,27-263,G-F,1/6/17,BRK,,CLE,L,1,31,9,14,0.643,4,5,0.8,5,9,0.556,0,0,,0,2,2
1653,Bojan Bogdanovic,27-277,G-F,1/20/17,BRK,@,NOP,W,1,27,6,13,0.462,4,8,0.5,2,5,0.4,9,9,1,1,5,6
1654,Bojan Bogdanovic,27-240,G-F,12/14/16,BRK,,LAL,W,1,29,6,13,0.462,3,6,0.5,3,7,0.429,8,10,0.8,1,3,4
1655,Bojan Bogdanovic,27-270,G-F,1/13/17,BRK,@,TOR,L,1,28,9,16,0.563,4,8,0.5,5,8,0.625,0,0,,0,4,4
1656,Devin Booker,20-108,G,2/15/17,PHO,,LAL,W,1,30,9,14,0.643,5,7,0.714,4,7,0.571,1,2,0.5,1,3,4
1657,Devin Booker,20-130,G,3/9/17,PHO,,LAL,L,1,38,10,21,0.476,9,17,0.529,1,4,0.25,2,2,1,1,5,6
1658,Devin Booker,20-009,G,11/8/16,PHO,@,POR,L,1,31,8,18,0.444,6,12,0.5,2,6,0.333,5,5,1,0,0,0
1659,Devin Booker,20-090,G,1/28/17,PHO,,DEN,L,1,35,8,16,0.5,8,14,0.571,0,2,0,7,11,0.636,1,3,4
1660,Devin Booker,20-054,G,12/23/16,PHO,,PHI,W,1,38,8,18,0.444,4,9,0.444,4,9,0.444,3,3,1,0,6,6
1661,Avery Bradley,26-011,G,12/7/16,BOS,@,ORL,W,1,33,7,14,0.5,4,9,0.444,3,5,0.6,6,7,0.857,0,4,4
1662,Avery Bradley,26-033,G,12/29/16,BOS,@,CLE,L,1,30,10,21,0.476,7,11,0.636,3,10,0.3,0,0,,0,3,3
1663,Avery Bradley,26-031,G,12/27/16,BOS,,MEM,W,1,34,10,17,0.588,9,14,0.643,1,3,0.333,2,3,0.667,2,5,7
1664,Jimmy Butler,27-180,G-F,3/13/17,CHI,@,CHO,W,1,38,8,15,0.533,6,10,0.6,2,5,0.4,5,6,0.833,1,5,6
1665,Jimmy Butler,27-049,G-F,11/2/16,CHI,@,BOS,L,1,36,8,21,0.381,6,16,0.375,2,5,0.4,5,5,1,2,7,9
1666,Jimmy Butler,27-129,G-F,1/21/17,CHI,,SAC,W,1,39,6,14,0.429,5,11,0.455,1,3,0.333,10,10,1,0,5,5
1667,Jimmy Butler,27-185,G-F,3/18/17,CHI,,UTA,W,1,38,8,18,0.444,8,17,0.471,0,1,0,7,7,1,2,2,4
1668,Kentavious Caldwell-Pope,23-288,G,12/2/16,DET,@,ATL,W,1,30,9,20,0.45,4,12,0.333,5,8,0.625,0,0,,3,5,8
1669,Kentavious Caldwell-Pope,23-318,G,1/1/17,DET,@,MIA,W,1,40,9,15,0.6,5,8,0.625,4,7,0.571,1,2,0.5,0,6,6
1670,Kentavious Caldwell-Pope,24-029,G,3/19/17,DET,,PHO,W,1,33,8,14,0.571,3,5,0.6,5,9,0.556,2,2,1,0,3,3
1671,Michael Carter-Williams,25-116,G,2/3/17,CHI,@,HOU,L,1,35,11,18,0.611,11,15,0.733,0,3,0,1,3,0.333,2,7,9
1672,Wilson Chandler,29-304,F,3/10/17,DEN,,BOS,W,1,34,8,16,0.5,5,8,0.625,3,8,0.375,4,6,0.667,0,9,9
1673,Wilson Chandler,29-269,F,2/3/17,DEN,,MIL,W,1,41,5,14,0.357,5,9,0.556,0,5,0,13,17,0.765,3,5,8
1674,Ian Clark,25-285,G,12/17/16,GSW,,POR,W,0,21,9,11,0.818,6,7,0.857,3,4,0.75,2,2,1,0,2,2
1675,Jordan Clarkson,24-158,G,11/12/16,LAL,@,NOP,W,0,25,8,12,0.667,4,6,0.667,4,6,0.667,3,3,1,0,3,3
1676,Darren Collison,29-155,G,1/25/17,SAC,@,CLE,W,1,36,8,14,0.571,5,9,0.556,3,5,0.6,4,4,1,1,2,3
1677,Mike Conley,29-109,G,1/28/17,MEM,@,UTA,W,1,28,9,14,0.643,6,7,0.857,3,7,0.429,2,2,1,0,3,3
1678,Mike Conley,29-120,G,2/8/17,MEM,,PHO,W,1,31,7,10,0.7,3,5,0.6,4,5,0.8,5,5,1,0,0,0
1679,Mike Conley,29-144,G,3/4/17,MEM,@,HOU,L,1,39,8,17,0.471,6,11,0.545,2,6,0.333,5,5,1,0,6,6
1680,Robert Covington,25-331,F,11/9/16,PHI,@,IND,L,1,33,8,16,0.5,3,7,0.429,5,9,0.556,2,2,1,3,3,6
1681,Robert Covington,26-047,F,1/30/17,PHI,,SAC,W,1,36,8,16,0.5,4,5,0.8,4,11,0.364,3,3,1,1,9,10
1682,Allen Crabbe,24-293,G-F,1/27/17,POR,,MEM,W,0,29,8,12,0.667,2,4,0.5,6,8,0.75,1,1,1,0,2,2
1683,Allen Crabbe,24-332,G-F,3/7/17,POR,@,OKC,W,0,28,7,10,0.7,2,3,0.667,5,7,0.714,4,4,1,1,3,4
1684,Jamal Crawford,36-322,G,2/5/17,LAC,@,BOS,L,0,33,8,18,0.444,5,9,0.556,3,9,0.333,4,4,1,0,2,2
1685,Jae Crowder,26-203,F,1/25/17,BOS,,HOU,W,1,36,8,18,0.444,7,10,0.7,1,8,0.125,6,6,1,1,9,10
1686,Seth Curry,26-077,G,11/8/16,DAL,@,LAL,W,0,31,9,15,0.6,5,8,0.625,4,7,0.571,1,2,0.5,1,3,4
1687,Seth Curry,26-090,G,11/21/16,DAL,@,SAS,L,1,36,9,16,0.563,4,6,0.667,5,10,0.5,0,1,0,0,2,2
1688,Stephen Curry,28-359,G,3/8/17,GSW,,BOS,L,1,35,8,16,0.5,6,7,0.857,2,9,0.222,5,5,1,3,2,5
1689,Stephen Curry,28-353,G,3/2/17,GSW,@,CHI,L,1,35,10,27,0.37,8,16,0.5,2,11,0.182,1,1,1,1,5,6
1690,Stephen Curry,29-006,G,3/20/17,GSW,@,OKC,W,1,30,8,17,0.471,1,5,0.2,7,12,0.583,0,0,,0,4,4
1691,Stephen Curry,28-228,G,10/28/16,GSW,@,NOP,W,1,34,8,19,0.421,4,9,0.444,4,10,0.4,3,4,0.75,1,0,1
1692,Anthony Davis,23-294,F-C,12/30/16,NOP,,NYK,W,1,34,9,18,0.5,9,18,0.5,0,0,,5,6,0.833,1,17,18
1693,DeMar DeRozan,27-161,G,1/15/17,TOR,,NYK,W,1,28,8,17,0.471,8,17,0.471,0,0,,7,7,1,0,5,5
1694,DeMar DeRozan,27-091,G,11/6/16,TOR,,SAC,L,1,38,7,20,0.35,6,18,0.333,1,2,0.5,8,10,0.8,0,4,4
1695,DeMar DeRozan,27-151,G,1/5/17,TOR,,UTA,W,1,37,8,26,0.308,8,25,0.32,0,1,0,7,10,0.7,2,5,7
1696,DeMar DeRozan,27-166,G,1/20/17,TOR,@,CHO,L,1,31,8,17,0.471,6,14,0.429,2,3,0.667,5,6,0.833,0,3,3
1697,Goran Dragic,30-231,G,12/23/16,MIA,@,NOP,L,1,34,10,16,0.625,8,12,0.667,2,4,0.5,1,3,0.333,0,4,4
1698,Goran Dragic,30-267,G,1/28/17,MIA,,DET,W,1,33,8,14,0.571,6,12,0.5,2,2,1,5,7,0.714,0,2,2
1699,Goran Dragic,30-302,G,3/4/17,MIA,,CLE,W,1,24,9,12,0.75,5,7,0.714,4,5,0.8,1,2,0.5,1,2,3
1700,Kevin Durant,28-050,F-G,11/18/16,GSW,@,BOS,W,1,33,10,13,0.769,9,11,0.818,1,2,0.5,2,4,0.5,1,9,10
1701,Kevin Durant,28-121,F-G,1/28/17,GSW,,LAC,W,1,29,9,11,0.818,6,7,0.857,3,4,0.75,2,2,1,1,3,4
1702,Joel Embiid,22-296,C-F,1/6/17,PHI,@,BOS,L,1,26,6,12,0.5,5,9,0.556,1,3,0.333,10,10,1,0,8,8
1703,Joel Embiid,22-289,C-F,12/30/16,PHI,@,DEN,W,1,29,5,13,0.385,4,8,0.5,1,5,0.2,12,14,0.857,3,3,6
1704,Evan Fournier,24-045,G-F,12/13/16,ORL,@,ATL,W,1,33,11,15,0.733,10,11,0.909,1,4,0.25,0,1,0,0,0,0
1705,Danilo Gallinari,28-140,F,12/26/16,DEN,@,LAC,W,1,37,5,12,0.417,3,7,0.429,2,5,0.4,11,12,0.917,2,9,11
1706,Langston Galloway,24-346,G,11/19/16,NOP,,CHO,W,0,31,7,14,0.5,1,3,0.333,6,11,0.545,3,3,1,1,6,7
1707,Marc Gasol,32-028,C,2/26/17,MEM,@,DEN,W,1,38,9,17,0.529,6,11,0.545,3,6,0.5,2,2,1,1,4,5
1708,Marc Gasol,31-343,C,1/6/17,MEM,@,GSW,W,1,41,9,18,0.5,9,16,0.563,0,2,0,5,5,1,1,4,5
1709,Marc Gasol,31-341,C,1/4/17,MEM,@,LAC,L,1,36,9,16,0.563,7,12,0.583,2,4,0.5,3,3,1,1,3,4
1710,Rudy Gay,30-081,F,11/6/16,SAC,@,TOR,W,1,35,9,19,0.474,7,14,0.5,2,5,0.4,3,4,0.75,2,3,5
1711,Rudy Gay,30-095,F,11/20/16,SAC,,TOR,W,1,36,9,13,0.692,8,12,0.667,1,1,1,4,4,1,0,9,9
1712,Rudy Gay,30-149,F,1/13/17,SAC,,CLE,L,1,35,8,14,0.571,5,11,0.455,3,3,1,4,5,0.8,5,5,10
1713,Rudy Gay,30-144,F,1/8/17,SAC,,GSW,L,1,35,9,17,0.529,7,11,0.636,2,6,0.333,3,4,0.75,0,1,1
1714,Paul George,26-185,F,11/3/16,IND,@,MIL,L,1,37,9,20,0.45,5,12,0.417,4,8,0.5,1,3,0.333,1,4,5
1715,Taj Gibson,31-161,F,12/2/16,CHI,,CLE,W,1,40,10,13,0.769,10,13,0.769,0,0,,3,3,1,2,9,11
1716,Rudy Gobert,24-255,C,3/8/17,UTA,@,HOU,W,1,36,7,8,0.875,7,8,0.875,0,0,,9,12,0.75,2,8,10
1717,Eric Gordon,27-342,G,12/1/16,HOU,@,GSW,W,0,39,9,19,0.474,5,10,0.5,4,9,0.444,1,1,1,0,1,1
1718,Blake Griffin,28-002,F,3/18/17,LAC,,CLE,W,1,31,10,17,0.588,9,15,0.6,1,2,0.5,2,4,0.5,1,7,8
1719,Blake Griffin,27-273,F,12/14/16,LAC,@,ORL,W,1,33,9,14,0.643,9,14,0.643,0,0,,5,7,0.714,1,6,7
1720,Blake Griffin,27-326,F,2/5/17,LAC,@,BOS,L,1,37,9,19,0.474,9,18,0.5,0,1,0,5,6,0.833,0,8,8
1721,Tim Hardaway,24-303,G,1/13/17,ATL,,BOS,L,0,29,9,17,0.529,6,10,0.6,3,7,0.429,2,3,0.667,1,1,2
1722,James Harden,27-091,G,11/25/16,HOU,@,SAC,W,1,40,6,18,0.333,3,7,0.429,3,11,0.273,8,8,1,1,8,9
1723,James Harden,27-129,G,1/2/17,HOU,,WAS,W,1,42,6,24,0.25,4,13,0.308,2,11,0.182,9,10,0.9,1,9,10
1724,Maurice Harkless,23-203,F-G,11/30/16,POR,,IND,W,1,29,9,14,0.643,6,8,0.75,3,6,0.5,2,2,1,2,0,2
1725,Maurice Harkless,23-169,F-G,10/27/16,POR,,LAC,L,1,32,10,15,0.667,9,12,0.75,1,3,0.333,2,2,1,5,3,8
1726,Gary Harris,22-162,G,2/23/17,DEN,@,SAC,L,1,35,9,19,0.474,4,8,0.5,5,11,0.455,0,0,,0,2,2
1727,Tobias Harris,24-110,F,11/2/16,DET,@,BRK,L,1,36,8,14,0.571,6,10,0.6,2,4,0.5,5,7,0.714,1,3,4
1728,Tobias Harris,24-184,F,1/15/17,DET,@,LAL,W,1,38,8,18,0.444,6,11,0.545,2,7,0.286,5,5,1,2,5,7
1729,Tobias Harris,24-166,F,12/28/16,DET,,MIL,L,0,31,9,15,0.6,7,10,0.7,2,5,0.4,3,3,1,1,11,12
1730,Gordon Hayward,26-286,F-G,1/3/17,UTA,@,BOS,L,1,34,7,14,0.5,4,7,0.571,3,7,0.429,6,7,0.857,0,2,2
1731,Gordon Hayward,26-297,F-G,1/14/17,UTA,,ORL,W,1,39,7,10,0.7,5,7,0.714,2,3,0.667,7,9,0.778,0,5,5
1732,Gordon Hayward,26-350,F-G,3/8/17,UTA,@,HOU,W,1,37,8,14,0.571,5,8,0.625,3,6,0.5,4,4,1,0,7,7
1733,Gordon Hayward,26-348,F-G,3/6/17,UTA,,NOP,W,1,36,10,20,0.5,8,15,0.533,2,5,0.4,1,2,0.5,0,7,7
1734,Gordon Hayward,26-257,F-G,12/5/16,UTA,@,LAL,W,1,36,7,16,0.438,4,10,0.4,3,6,0.5,6,9,0.667,1,5,6
1735,Gordon Hayward,26-275,F-G,12/23/16,UTA,,TOR,L,1,38,8,16,0.5,7,11,0.636,1,5,0.2,6,7,0.857,1,0,1
1736,Gordon Hayward,26-347,F-G,3/5/17,UTA,@,SAC,W,1,40,7,21,0.333,5,14,0.357,2,7,0.286,7,9,0.778,2,4,6
1737,George Hill,30-177,G,10/28/16,UTA,,LAL,W,1,35,7,14,0.5,5,7,0.714,2,7,0.286,7,9,0.778,0,3,3
1738,George Hill,30-205,G,11/25/16,UTA,,ATL,W,1,28,8,14,0.571,3,6,0.5,5,8,0.625,2,2,1,0,5,5
1739,George Hill,30-186,G,11/6/16,UTA,@,NYK,W,1,35,8,12,0.667,7,9,0.778,1,3,0.333,6,7,0.857,0,2,2
1740,Solomon Hill,25-334,F,2/15/17,NOP,@,MEM,W,1,37,8,11,0.727,4,5,0.8,4,6,0.667,3,4,0.75,0,5,5
1741,Jrue Holiday,26-182,G,12/11/16,NOP,@,PHO,W,1,40,7,18,0.389,5,10,0.5,2,8,0.25,7,9,0.778,2,1,3
1742,Jrue Holiday,26-192,G,12/21/16,NOP,,OKC,L,1,35,9,15,0.6,7,12,0.583,2,3,0.667,3,4,0.75,1,3,4
1743,Jrue Holiday,26-229,G,1/27/17,NOP,,SAS,W,1,38,10,17,0.588,7,11,0.636,3,6,0.5,0,1,0,0,4,4
1744,Al Horford,30-203,C-F,12/23/16,BOS,,OKC,L,1,33,8,17,0.471,5,11,0.455,3,6,0.5,4,4,1,1,5,6
1745,Dwight Howard,30-351,C,11/23/16,ATL,@,IND,W,1,33,10,12,0.833,10,12,0.833,0,0,,3,5,0.6,9,12,21
1746,Dwight Howard,30-365,C,12/7/16,ATL,,MIA,W,1,35,9,11,0.818,9,11,0.818,0,0,,5,6,0.833,7,10,17
1747,Serge Ibaka,27-095,F-C,12/22/16,ORL,@,NYK,L,1,32,10,18,0.556,7,11,0.636,3,7,0.429,0,0,,3,7,10
1748,Ersan Ilyasova,29-229,F,12/30/16,PHI,@,DEN,W,1,37,8,16,0.5,3,10,0.3,5,6,0.833,2,2,1,5,8,13
1749,Ersan Ilyasova,29-207,F,12/8/16,PHI,@,NOP,W,1,32,9,16,0.563,7,10,0.7,2,6,0.333,3,4,0.75,2,6,8
1750,Ersan Ilyasova,29-205,F,12/6/16,PHI,@,MEM,L,1,40,7,19,0.368,3,6,0.5,4,13,0.308,5,7,0.714,3,14,17
1751,Ersan Ilyasova,29-307,F,3/18/17,ATL,,POR,L,1,27,7,11,0.636,3,6,0.5,4,5,0.8,5,7,0.714,1,3,4
1752,Kyrie Irving,24-320,G,2/6/17,CLE,@,WAS,W,1,44,8,24,0.333,6,17,0.353,2,7,0.286,5,5,1,0,1,1
1753,Kyrie Irving,24-337,G,2/23/17,CLE,,NYK,W,1,30,9,16,0.563,8,12,0.667,1,4,0.25,4,5,0.8,1,2,3
1754,Kyrie Irving,24-225,G,11/3/16,CLE,,BOS,W,1,34,9,18,0.5,6,10,0.6,3,8,0.375,2,3,0.667,0,4,4
1755,Kyrie Irving,24-261,G,12/9/16,CLE,,MIA,W,1,33,9,15,0.6,7,11,0.636,2,4,0.5,3,5,0.6,0,1,1
1756,LeBron James,31-349,F-G,12/13/16,CLE,,MEM,W,1,36,9,17,0.529,9,13,0.692,0,4,0,5,8,0.625,1,5,6
1757,LeBron James,31-365,F-G,12/29/16,CLE,,BOS,W,1,44,9,18,0.5,7,12,0.583,2,6,0.333,3,7,0.429,2,6,8
1758,LeBron James,32-031,F-G,1/30/17,CLE,@,DAL,L,1,37,9,19,0.474,8,13,0.615,1,6,0.167,4,8,0.5,0,9,9
1759,LeBron James,31-304,F-G,10/29/16,CLE,,ORL,W,1,39,7,16,0.438,5,10,0.5,2,6,0.333,7,11,0.636,1,5,6
1760,LeBron James,31-314,F-G,11/8/16,CLE,,ATL,L,1,37,8,17,0.471,6,12,0.5,2,5,0.4,5,5,1,2,7,9
1761,Brandon Jennings,27-134,G,2/4/17,NYK,,CLE,L,1,42,8,13,0.615,2,5,0.4,6,8,0.75,1,2,0.5,0,5,5
1762,Amir Johnson,29-185,F,11/2/16,BOS,,CHI,W,1,30,9,11,0.818,5,7,0.714,4,4,1,1,2,0.5,1,5,6
1763,Tyler Johnson,24-257,G,1/19/17,MIA,,DAL,W,0,28,7,13,0.538,5,11,0.455,2,2,1,7,9,0.778,0,2,2
1764,Tyler Johnson,24-314,G,3/17/17,MIA,,MIN,W,0,32,9,13,0.692,7,8,0.875,2,5,0.4,3,3,1,1,1,2
1765,Tyler Johnson,24-242,G,1/4/17,MIA,@,SAC,W,0,30,7,11,0.636,5,7,0.714,2,4,0.5,7,9,0.778,3,3,6
1766,Tyler Johnson,24-293,G,2/24/17,MIA,@,ATL,W,0,26,9,11,0.818,6,7,0.857,3,4,0.75,2,2,1,1,4,5
1767,Nikola Jokic,21-253,C-F,10/29/16,DEN,,POR,L,1,34,10,20,0.5,9,15,0.6,1,5,0.2,2,3,0.667,6,11,17
1768,Nikola Jokic,21-340,C-F,1/24/17,DEN,,UTA,W,1,35,9,16,0.563,9,12,0.75,0,4,0,5,5,1,0,11,11
1769,Frank Kaminsky,23-231,F-C,11/21/16,CHO,,MEM,L,0,20,9,11,0.818,6,7,0.857,3,4,0.75,2,3,0.667,0,0,0
1770,Frank Kaminsky,23-327,F-C,2/25/17,CHO,@,SAC,W,1,38,9,18,0.5,4,9,0.444,5,9,0.556,0,0,,2,11,13
1771,Enes Kanter,24-225,C,12/31/16,OKC,,LAC,W,0,25,6,13,0.462,6,13,0.462,0,0,,11,12,0.917,2,6,8
1772,Michael Kidd-Gilchrist,23-030,F,10/26/16,CHO,@,MIL,W,1,35,10,18,0.556,10,16,0.625,0,2,0,3,3,1,4,10,14
1773,Sean Kilpatrick,26-322,G,11/23/16,BRK,,BOS,L,0,32,8,17,0.471,7,13,0.538,1,4,0.25,6,8,0.75,0,2,2
1774,Sean Kilpatrick,26-355,G,12/26/16,BRK,,CHO,W,1,32,9,15,0.6,5,8,0.625,4,7,0.571,1,2,0.5,0,5,5
1775,Sean Kilpatrick,27-059,G,3/6/17,BRK,@,MEM,W,0,28,3,6,0.5,2,5,0.4,1,1,1,16,17,0.941,0,5,5
1776,Brandon Knight,24-364,G,11/30/16,PHO,,ATL,W,0,31,6,18,0.333,3,15,0.2,3,3,1,8,9,0.889,1,4,5
1777,Zach LaVine,21-322,G,1/26/17,MIN,,IND,L,1,42,7,17,0.412,4,8,0.5,3,9,0.333,6,7,0.857,0,3,3
1778,Zach LaVine,21-267,G,12/2/16,MIN,@,NYK,L,1,40,9,18,0.5,7,11,0.636,2,7,0.286,3,3,1,0,2,2
1779,Zach LaVine,21-284,G,12/19/16,MIN,,PHO,W,1,36,7,16,0.438,3,8,0.375,4,8,0.5,5,5,1,2,2,4
1780,Courtney Lee,31-114,G,1/25/17,NYK,@,DAL,L,1,38,9,13,0.692,7,8,0.875,2,5,0.4,3,3,1,2,4,6
1781,Kawhi Leonard,25-142,F,11/18/16,SAS,@,LAL,W,1,39,7,15,0.467,5,8,0.625,2,7,0.286,7,8,0.875,1,11,12
1782,Kawhi Leonard,25-156,F,12/2/16,SAS,,WAS,W,1,34,9,18,0.5,7,14,0.5,2,4,0.5,3,3,1,1,4,5
1783,Kawhi Leonard,25-212,F,1/27/17,SAS,@,NOP,L,1,30,6,16,0.375,4,10,0.4,2,6,0.333,9,9,1,1,5,6
1784,Brook Lopez,28-294,C,1/20/17,BRK,@,NOP,W,1,24,8,15,0.533,7,11,0.636,1,4,0.25,6,6,1,2,6,8
1785,Brook Lopez,28-350,C,3/17/17,BRK,,BOS,L,1,31,8,18,0.444,6,13,0.462,2,5,0.4,5,6,0.833,1,4,5
1786,Brook Lopez,28-308,C,2/3/17,BRK,,IND,L,1,31,9,18,0.5,9,17,0.529,0,1,0,5,5,1,2,4,6
1787,Kevin Love,28-150,F,2/4/17,CLE,@,NYK,W,1,35,7,16,0.438,3,9,0.333,4,7,0.571,5,6,0.833,5,11,16
1788,Kevin Love,28-048,F,10/25/16,CLE,,NYK,W,1,25,6,15,0.4,4,9,0.444,2,6,0.333,9,12,0.75,2,10,12
1789,Kyle Lowry,30-270,G,12/20/16,TOR,,BRK,W,1,34,8,12,0.667,5,7,0.714,3,5,0.6,4,5,0.8,1,3,4
1790,Wesley Matthews,30-116,G,2/7/17,DAL,,POR,L,1,39,9,17,0.529,6,10,0.6,3,7,0.429,2,2,1,1,1,2
1791,C.J. McCollum,25-171,G,3/9/17,POR,,PHI,W,1,42,8,16,0.5,5,11,0.455,3,5,0.6,4,4,1,0,4,4
1792,C.J. McCollum,25-079,G,12/7/16,POR,@,MIL,L,1,38,9,15,0.6,5,8,0.625,4,7,0.571,1,2,0.5,0,3,3
1793,C.J. McCollum,25-087,G,12/15/16,POR,@,DEN,L,1,35,8,17,0.471,7,13,0.538,1,4,0.25,6,6,1,0,3,3
1794,C.J. McCollum,25-040,G,10/29/16,POR,@,DEN,W,1,41,10,24,0.417,8,19,0.421,2,5,0.4,1,1,1,3,7,10
1795,Doug McDermott,24-300,F,10/29/16,CHI,,IND,W,0,27,9,14,0.643,4,8,0.5,5,6,0.833,0,0,,0,4,4
1796,Jodie Meeks,29-134,G,1/2/17,ORL,@,NYK,W,1,32,7,9,0.778,1,2,0.5,6,7,0.857,3,3,1,0,2,2
1797,C.J. Miles,29-299,G-F,2/11/17,IND,,MIL,L,1,33,8,16,0.5,2,5,0.4,6,11,0.545,1,1,1,0,2,2
1798,C.J. Miles,29-203,G-F,11/7/16,IND,@,CHO,L,0,25,8,15,0.533,3,4,0.75,5,11,0.455,2,2,1,1,3,4
1799,C.J. Miles,29-296,G-F,2/8/17,IND,,CLE,L,1,35,7,11,0.636,1,2,0.5,6,9,0.667,3,3,1,0,4,4
1800,Patty Mills,28-134,G,12/23/16,SAS,@,POR,W,0,28,7,9,0.778,2,2,1,5,7,0.714,4,5,0.8,0,3,3
1801,Patty Mills,28-111,G,11/30/16,SAS,@,DAL,W,0,29,9,12,0.75,4,6,0.667,5,6,0.833,0,0,,0,3,3
1802,Paul Millsap,32-023,F,3/5/17,ATL,,IND,L,1,37,8,16,0.5,8,14,0.571,0,2,0,7,12,0.583,3,7,10
1803,Paul Millsap,31-364,F,2/8/17,ATL,,DEN,W,1,38,9,15,0.6,7,10,0.7,2,5,0.4,3,3,1,1,5,6
1804,Paul Millsap,31-269,F,11/5/16,ATL,,HOU,W,1,34,10,20,0.5,10,18,0.556,0,2,0,3,5,0.6,2,9,11
1805,Paul Millsap,31-303,F,12/9/16,ATL,@,MIL,W,1,39,8,15,0.533,7,11,0.636,1,4,0.25,6,8,0.75,3,11,14
1806,Paul Millsap,31-338,F,1/13/17,ATL,,BOS,L,1,40,8,15,0.533,7,12,0.583,1,3,0.333,6,7,0.857,3,2,5
1807,Marcus Morris,27-135,F,1/15/17,DET,@,LAL,W,1,43,9,18,0.5,5,10,0.5,4,8,0.5,1,2,0.5,2,7,9
1808,Marcus Morris,27-061,F,11/2/16,DET,@,BRK,L,1,32,8,16,0.5,5,11,0.455,3,5,0.6,4,5,0.8,1,3,4
1809,Markieff Morris,27-164,F,2/13/17,WAS,,OKC,W,1,32,8,14,0.571,5,11,0.455,3,3,1,4,5,0.8,1,5,6
1810,Markieff Morris,27-143,F,1/23/17,WAS,@,CHO,W,1,41,8,13,0.615,6,9,0.667,2,4,0.5,5,5,1,0,8,8
1811,Markieff Morris,27-107,F,12/18/16,WAS,,LAC,W,1,33,10,17,0.588,9,15,0.6,1,2,0.5,2,3,0.667,1,8,9
1812,Emmanuel Mudiay,20-248,G,11/8/16,DEN,@,MEM,L,1,36,7,13,0.538,6,10,0.6,1,3,0.333,8,10,0.8,0,4,4
1813,Jamal Murray,19-274,G,11/23/16,DEN,@,UTA,L,0,35,8,19,0.421,3,11,0.273,5,8,0.625,2,2,1,2,2,4
1814,Jameer Nelson,35-004,G,2/13/17,DEN,,GSW,W,1,34,9,14,0.643,4,7,0.571,5,7,0.714,0,0,,0,3,3
1815,Dirk Nowitzki,38-273,F,3/19/17,DAL,@,BRK,W,1,27,9,17,0.529,6,11,0.545,3,6,0.5,2,3,0.667,0,9,9
1816,Dirk Nowitzki,38-265,F,3/11/17,DAL,,PHO,L,1,31,10,14,0.714,9,12,0.75,1,2,0.5,2,3,0.667,1,10,11
1817,Jusuf Nurkic,22-064,C,10/26/16,DEN,@,NOP,W,1,26,9,13,0.692,9,13,0.692,0,0,,5,6,0.833,2,7,9
1818,Kyle O'Quinn,26-355,F-C,3/16/17,NYK,,BRK,L,0,26,10,15,0.667,10,13,0.769,0,2,0,3,3,1,3,5,8
1819,Jahlil Okafor,21-087,C-F,3/12/17,PHI,@,LAL,W,1,27,8,12,0.667,8,12,0.667,0,0,,7,8,0.875,1,3,4
1820,Victor Oladipo,24-281,G,2/9/17,OKC,,CLE,W,1,36,9,17,0.529,7,11,0.636,2,6,0.333,3,4,0.75,0,7,7
1821,Victor Oladipo,24-316,G,3/16/17,OKC,@,TOR,W,1,28,9,15,0.6,6,12,0.5,3,3,1,2,3,0.667,2,3,5
1822,Victor Oladipo,24-256,G,1/15/17,OKC,@,SAC,W,1,40,7,14,0.5,6,7,0.857,1,7,0.143,8,8,1,0,1,1
1823,Jabari Parker,21-246,F,11/16/16,MIL,@,ATL,L,1,35,10,20,0.5,10,19,0.526,0,1,0,3,3,1,2,6,8
1824,Jabari Parker,21-307,F,1/16/17,MIL,,PHI,L,1,35,9,17,0.529,7,13,0.538,2,4,0.5,3,5,0.6,0,5,5
1825,Jabari Parker,21-265,F,12/5/16,MIL,,SAS,L,1,34,6,14,0.429,5,11,0.455,1,3,0.333,10,10,1,3,5,8
1826,Chris Paul,31-304,G,3/6/17,LAC,,BOS,W,1,30,8,14,0.571,7,11,0.636,1,3,0.333,6,8,0.75,1,4,5
1827,Elfrid Payton,22-265,G,11/13/16,ORL,@,OKC,W,1,37,10,19,0.526,7,12,0.583,3,7,0.429,0,2,0,0,7,7
1828,Elfrid Payton,22-335,G,1/22/17,ORL,,GSW,L,1,39,11,19,0.579,10,17,0.588,1,2,0.5,0,0,,0,4,4
1829,Otto Porter,23-152,F,11/2/16,WAS,,TOR,L,1,38,11,13,0.846,11,12,0.917,0,1,0,1,1,1,4,9,13
1830,Otto Porter,23-230,F,1/19/17,WAS,@,NYK,W,1,30,7,13,0.538,1,3,0.333,6,10,0.6,3,3,1,1,4,5
1831,Julius Randle,22-091,F,2/28/17,LAL,,CHO,L,1,34,10,14,0.714,10,13,0.769,0,1,0,3,3,1,4,15,19
1832,Zach Randolph,35-227,F,2/28/17,MEM,,PHO,W,0,27,10,15,0.667,9,12,0.75,1,3,0.333,2,2,1,3,5,8
1833,J.J. Redick,32-160,G,12/1/16,LAC,@,CLE,W,1,25,9,13,0.692,5,7,0.714,4,6,0.667,1,2,0.5,0,2,2
1834,Austin Rivers,24-207,G,2/24/17,LAC,,SAS,L,0,27,8,14,0.571,6,8,0.75,2,6,0.333,5,6,0.833,0,0,0
1835,Ricky Rubio,26-145,G,3/15/17,MIN,@,BOS,L,1,32,8,14,0.571,5,9,0.556,3,5,0.6,4,4,1,2,1,3
1836,D'Angelo Russell,20-253,G,11/2/16,LAL,@,ATL,W,1,31,9,19,0.474,8,16,0.5,1,3,0.333,4,4,1,1,3,4
1837,D'Angelo Russell,21-005,G,2/28/17,LAL,,CHO,L,1,36,8,17,0.471,3,9,0.333,5,8,0.625,2,2,1,0,1,1
1838,Dario Saric,22-345,F,3/19/17,PHI,,BOS,W,1,32,10,20,0.5,8,16,0.5,2,4,0.5,1,1,1,0,6,6
1839,Dennis Schroder,23-136,G,1/29/17,ATL,,NYK,W,1,55,9,25,0.36,8,21,0.381,1,4,0.25,4,7,0.571,1,3,4
1840,Dennis Schroder,23-172,G,3/6/17,ATL,,GSW,L,1,24,9,17,0.529,5,10,0.5,4,7,0.571,1,1,1,1,3,4
1841,Dennis Schroder,23-112,G,1/5/17,ATL,@,NOP,W,1,33,8,18,0.444,6,13,0.462,2,5,0.4,5,6,0.833,3,3,6
1842,J.R. Smith,31-095,G-F,12/13/16,CLE,,MEM,W,1,34,8,17,0.471,2,7,0.286,6,10,0.6,1,2,0.5,2,3,5
1843,Marreese Speights,29-165,C-F,1/16/17,LAC,,OKC,W,0,27,8,15,0.533,5,8,0.625,3,7,0.429,4,4,1,2,8,10
1844,Jeff Teague,28-192,G,12/19/16,IND,,WAS,W,1,39,8,19,0.421,8,17,0.471,0,2,0,7,7,1,1,3,4
1845,Isaiah Thomas,27-276,G,11/9/16,BOS,@,WAS,L,1,35,6,18,0.333,5,12,0.417,1,6,0.167,10,10,1,3,3,6
1846,Isaiah Thomas,27-290,G,11/23/16,BOS,@,BRK,W,1,32,8,21,0.381,3,12,0.25,5,9,0.556,2,2,1,0,1,1
1847,Isaiah Thomas,27-315,G,12/18/16,BOS,@,MIA,W,1,28,9,16,0.563,6,10,0.6,3,6,0.5,2,2,1,1,1,2
1848,Isaiah Thomas,27-269,G,11/2/16,BOS,,CHI,W,1,36,8,18,0.444,4,11,0.364,4,7,0.571,3,4,0.75,1,1,2
1849,Isaiah Thomas,27-279,G,11/12/16,BOS,@,IND,W,1,29,4,13,0.308,3,11,0.273,1,2,0.5,14,15,0.933,0,0,0
1850,Klay Thompson,26-292,G,11/26/16,GSW,,MIN,W,1,38,9,17,0.529,5,8,0.625,4,9,0.444,1,2,0.5,1,5,6
1851,Klay Thompson,26-339,G,1/12/17,GSW,,DET,W,1,36,9,15,0.6,5,10,0.5,4,5,0.8,1,4,0.25,1,2,3
1852,Klay Thompson,26-318,G,12/22/16,GSW,@,BRK,W,1,35,9,24,0.375,4,14,0.286,5,10,0.5,0,0,,0,5,5
1853,Klay Thompson,27-041,G,3/21/17,GSW,@,DAL,W,1,32,9,15,0.6,4,7,0.571,5,8,0.625,0,0,,0,3,3
1854,Karl-Anthony Towns,21-076,F-C,1/30/17,MIN,,ORL,W,1,45,8,18,0.444,7,16,0.438,1,2,0.5,6,7,0.857,2,10,12
1855,Karl-Anthony Towns,21-115,F-C,3/10/17,MIN,,GSW,W,1,38,10,18,0.556,8,14,0.571,2,4,0.5,1,3,0.333,2,7,9
1856,Karl-Anthony Towns,21-057,F-C,1/11/17,MIN,,HOU,W,1,38,10,17,0.588,10,14,0.714,0,3,0,3,4,0.75,2,16,18
1857,Karl-Anthony Towns,21-049,F-C,1/3/17,MIN,@,PHI,L,1,37,9,22,0.409,8,16,0.5,1,6,0.167,4,4,1,6,10,16
1858,Myles Turner,20-308,F-C,1/26/17,IND,@,MIN,W,1,36,10,14,0.714,9,12,0.75,1,2,0.5,2,2,1,2,4,6
1859,Myles Turner,20-283,F-C,1/1/17,IND,,ORL,W,1,31,7,13,0.538,6,12,0.5,1,1,1,8,9,0.889,4,8,12
1860,Jonas Valanciunas,24-198,C,11/20/16,TOR,@,SAC,L,1,37,9,18,0.5,9,18,0.5,0,0,,5,6,0.833,7,6,13
1861,Nikola Vucevic,26-140,C,3/13/17,ORL,@,SAC,L,1,32,10,17,0.588,7,14,0.5,3,3,1,0,0,,3,6,9
1862,Dwyane Wade,35-038,G,2/24/17,CHI,,PHO,W,1,33,8,17,0.471,8,16,0.5,0,1,0,7,8,0.875,2,2,4
1863,Dwyane Wade,35-055,G,3/13/17,CHI,@,CHO,W,1,32,8,15,0.533,8,13,0.615,0,2,0,7,8,0.875,0,1,1
1864,Dion Waiters,24-343,G,11/17/16,MIA,,MIL,W,1,35,10,22,0.455,10,17,0.588,0,5,0,3,5,0.6,0,7,7
1865,Dion Waiters,25-067,G,2/15/17,MIA,@,HOU,W,1,37,8,17,0.471,4,8,0.5,4,9,0.444,3,4,0.75,1,9,10
1866,Dion Waiters,25-065,G,2/13/17,MIA,,ORL,L,1,34,10,19,0.526,9,14,0.643,1,5,0.2,2,3,0.667,0,2,2
1867,Kemba Walker,26-306,G,3/10/17,CHO,,ORL,W,1,24,9,13,0.692,4,5,0.8,5,8,0.625,0,0,,0,0,0
1868,Kemba Walker,26-205,G,11/29/16,CHO,,DET,L,1,31,9,16,0.563,5,9,0.556,4,7,0.571,1,2,0.5,1,1,2
1869,Kemba Walker,26-255,G,1/18/17,CHO,,POR,W,1,32,8,14,0.571,4,6,0.667,4,8,0.5,3,5,0.6,0,2,2
1870,John Wall,26-155,G,2/8/17,WAS,@,BRK,W,1,46,7,24,0.292,6,20,0.3,1,4,0.25,8,10,0.8,1,5,6
1871,John Wall,26-106,G,12/21/16,WAS,@,CHI,W,1,36,9,14,0.643,9,12,0.75,0,2,0,5,7,0.714,0,6,6
1872,John Wall,26-072,G,11/17/16,WAS,,NYK,W,1,31,7,15,0.467,4,9,0.444,3,6,0.5,6,6,1,0,2,2
1873,John Wall,26-173,G,2/26/17,WAS,,UTA,L,1,37,9,18,0.5,7,14,0.5,2,4,0.5,3,5,0.6,0,3,3
1874,T.J. Warren,23-174,F,2/26/17,PHO,@,MIL,L,1,39,11,14,0.786,10,13,0.769,1,1,1,0,0,,0,5,5
1875,T.J. Warren,23-114,F,12/28/16,PHO,@,SAS,L,0,34,6,12,0.5,5,10,0.5,1,2,0.5,10,10,1,3,3,6
1876,Russell Westbrook,28-117,G,3/9/17,OKC,,SAS,W,1,35,7,21,0.333,6,15,0.4,1,6,0.167,8,9,0.889,3,10,13
1877,Hassan Whiteside,27-154,C,11/14/16,MIA,@,SAS,L,1,34,9,11,0.818,9,11,0.818,0,0,,5,9,0.556,5,11,16
1878,Hassan Whiteside,27-240,C,2/8/17,MIA,@,MIL,W,1,34,10,12,0.833,10,12,0.833,0,0,,3,6,0.5,3,13,16
1879,Hassan Whiteside,27-277,C,3/17/17,MIA,,MIN,W,1,33,10,11,0.909,10,11,0.909,0,0,,3,3,1,3,11,14
1880,Hassan Whiteside,27-192,C,12/22/16,MIA,,LAL,W,1,37,9,12,0.75,9,12,0.75,0,0,,5,6,0.833,3,10,13
1881,Hassan Whiteside,27-176,C,12/6/16,MIA,,NYK,L,1,38,10,20,0.5,10,20,0.5,0,0,,3,9,0.333,5,9,14
1882,Hassan Whiteside,27-247,C,2/15/17,MIA,@,HOU,W,1,31,9,13,0.692,9,13,0.692,0,0,,5,8,0.625,3,11,14
1883,Hassan Whiteside,27-188,C,12/18/16,MIA,,BOS,L,1,38,9,13,0.692,9,13,0.692,0,0,,5,9,0.556,2,15,17
1884,Hassan Whiteside,27-281,C,3/21/17,MIA,,PHO,W,1,31,9,18,0.5,9,18,0.5,0,0,,5,6,0.833,4,10,14
1885,Andrew Wiggins,21-340,F-G,1/28/17,MIN,,BRK,W,1,38,9,18,0.5,8,17,0.471,1,1,1,4,5,0.8,2,1,3
1886,Andrew Wiggins,21-306,F-G,12/25/16,MIN,@,OKC,L,1,36,10,20,0.5,10,18,0.556,0,2,0,3,8,0.375,1,2,3
1887,Andrew Wiggins,21-347,F-G,2/4/17,MIN,,MEM,L,1,37,9,22,0.409,8,18,0.444,1,4,0.25,4,7,0.571,2,0,2
1888,Andrew Wiggins,21-344,F-G,2/1/17,MIN,@,CLE,L,1,36,9,17,0.529,7,11,0.636,2,6,0.333,3,3,1,1,1,2
1889,Andrew Wiggins,21-294,F-G,12/13/16,MIN,@,CHI,W,1,39,8,17,0.471,6,13,0.462,2,4,0.5,5,6,0.833,3,6,9
1890,Deron Williams,32-200,G,1/12/17,DAL,@,PHO,W,1,32,9,15,0.6,5,10,0.5,4,5,0.8,1,3,0.333,1,1,2
1891,Deron Williams,32-178,G,12/21/16,DAL,@,POR,W,1,32,10,17,0.588,8,10,0.8,2,7,0.286,1,1,1,2,3,5
1892,Deron Williams,32-176,G,12/19/16,DAL,@,DEN,L,1,31,9,18,0.5,6,15,0.4,3,3,1,2,3,0.667,0,1,1
1893,Justise Winslow,20-271,F,12/22/16,MIA,,LAL,W,1,42,10,16,0.625,10,15,0.667,0,1,0,3,6,0.5,3,10,13
1894,Nick Young,31-244,G-F,1/31/17,LAL,,DEN,W,1,30,9,15,0.6,4,7,0.571,5,8,0.625,0,1,0,0,3,3
1895,Cody Zeller,24-044,F-C,11/18/16,CHO,,ATL,W,1,31,9,10,0.9,9,10,0.9,0,0,,5,7,0.714,2,1,3
1896,Steven Adams,23-158,C,12/25/16,OKC,,MIN,W,1,29,9,12,0.75,9,12,0.75,0,0,,4,4,1,1,5,6
1897,Steven Adams,23-173,C,1/9/17,OKC,@,CHI,W,1,36,11,14,0.786,11,14,0.786,0,0,,0,0,,1,4,5
1898,LaMarcus Aldridge,31-152,F-C,12/18/16,SAS,,NOP,W,1,26,6,15,0.4,6,14,0.429,0,1,0,10,10,1,1,5,6
1899,Tony Allen,35-002,G-F,1/13/17,MEM,@,HOU,W,1,25,9,10,0.9,9,9,1,0,1,0,4,8,0.5,0,4,4
1900,Ryan Anderson,28-222,F,12/14/16,HOU,,SAC,W,1,26,8,12,0.667,4,5,0.8,4,7,0.571,2,3,0.667,2,4,6
1901,Ryan Anderson,28-235,F,12/27/16,HOU,@,DAL,W,1,28,7,12,0.583,3,5,0.6,4,7,0.571,4,4,1,1,2,3
1902,Giannis Antetokounmpo,22-020,F-G,12/26/16,MIL,@,WAS,L,1,38,7,12,0.583,7,11,0.636,0,1,0,8,11,0.727,5,7,12
1903,Giannis Antetokounmpo,22-105,F-G,3/21/17,MIL,@,POR,W,1,36,8,21,0.381,8,20,0.4,0,1,0,6,7,0.857,1,7,8
1904,Giannis Antetokounmpo,21-365,F-G,12/5/16,MIL,,SAS,L,1,29,6,12,0.5,5,11,0.455,1,1,1,9,10,0.9,2,9,11
1905,Giannis Antetokounmpo,22-064,F-G,2/8/17,MIL,,MIA,L,1,36,9,15,0.6,7,12,0.583,2,3,0.667,2,2,1,2,6,8
1906,Giannis Antetokounmpo,22-010,F-G,12/16/16,MIL,@,CHI,W,1,35,8,13,0.615,6,10,0.6,2,3,0.667,4,6,0.667,3,4,7
1907,Carmelo Anthony,32-289,F,3/14/17,NYK,,IND,W,1,41,8,17,0.471,5,11,0.455,3,6,0.5,3,5,0.6,0,13,13
1908,Carmelo Anthony,32-164,F,11/9/16,NYK,,BRK,W,1,34,9,22,0.409,7,16,0.438,2,6,0.333,2,2,1,1,7,8
1909,Carmelo Anthony,32-171,F,11/16/16,NYK,,DET,W,1,37,9,17,0.529,5,11,0.455,4,6,0.667,0,0,,1,4,5
1910,J.J. Barea,32-122,G,10/26/16,DAL,@,IND,L,0,39,7,17,0.412,5,10,0.5,2,7,0.286,6,6,1,0,2,2
1911,Harrison Barnes,24-227,F,1/12/17,DAL,@,PHO,W,1,36,10,17,0.588,9,13,0.692,1,4,0.25,1,2,0.5,1,3,4
1912,Harrison Barnes,24-177,F,11/23/16,DAL,,LAC,L,1,30,10,19,0.526,8,15,0.533,2,4,0.5,0,0,,0,4,4
1913,Harrison Barnes,24-289,F,3/15/17,DAL,@,WAS,W,1,40,10,16,0.625,9,14,0.643,1,2,0.5,1,2,0.5,0,9,9
1914,Harrison Barnes,24-187,F,12/3/16,DAL,,CHI,W,1,37,9,21,0.429,7,16,0.438,2,5,0.4,2,2,1,3,2,5
1915,Will Barton,25-294,G,10/26/16,DEN,@,NOP,W,1,35,7,12,0.583,5,9,0.556,2,3,0.667,6,6,1,2,3,5
1916,Will Barton,25-334,G,12/5/16,DEN,@,PHI,W,1,36,9,17,0.529,8,14,0.571,1,3,0.333,3,7,0.429,1,7,8
1917,Will Barton,25-349,G,12/20/16,DEN,@,LAC,L,0,32,9,15,0.6,7,10,0.7,2,5,0.4,2,3,0.667,1,4,5
1918,Will Barton,26-066,G,3/13/17,DEN,,LAL,W,0,30,7,12,0.583,3,6,0.5,4,6,0.667,4,5,0.8,0,2,2
1919,Nicolas Batum,28-002,F-G,12/16/16,CHO,@,BOS,L,1,36,6,19,0.316,4,12,0.333,2,7,0.286,8,8,1,0,10,10
1920,Kent Bazemore,27-152,G-F,11/30/16,ATL,@,PHO,L,1,40,8,17,0.471,4,9,0.444,4,8,0.5,2,2,1,1,4,5
1921,Bradley Beal,23-174,G,12/19/16,WAS,@,IND,L,1,30,7,19,0.368,4,8,0.5,3,11,0.273,5,6,0.833,1,0,1
1922,Bradley Beal,23-192,G,1/6/17,WAS,,MIN,W,1,34,7,12,0.583,2,5,0.4,5,7,0.714,3,3,1,0,3,3
1923,Bradley Beal,23-243,G,2/26/17,WAS,,UTA,L,1,34,9,16,0.563,6,9,0.667,3,7,0.429,1,2,0.5,1,2,3
1924,Bradley Beal,23-181,G,12/26/16,WAS,,MIL,W,1,37,5,14,0.357,2,6,0.333,3,8,0.375,9,10,0.9,1,3,4
1925,Bradley Beal,23-230,G,2/13/17,WAS,,OKC,W,1,23,7,8,0.875,1,1,1,6,7,0.857,2,3,0.667,0,0,0
1926,Michael Beasley,28-046,F,2/24/17,MIL,,UTA,L,1,32,10,17,0.588,10,16,0.625,0,1,0,2,2,1,0,6,6
1927,Marco Belinelli,30-239,G-F,11/19/16,CHO,@,NOP,L,0,33,7,13,0.538,0,4,0,7,9,0.778,1,2,0.5,0,10,10
1928,Eric Bledsoe,27-024,G,1/2/17,PHO,@,LAC,L,1,41,8,27,0.296,7,22,0.318,1,5,0.2,5,7,0.714,1,7,8
1929,Eric Bledsoe,27-041,G,1/19/17,PHO,@,CLE,L,1,38,7,20,0.35,5,15,0.333,2,5,0.4,6,7,0.857,2,4,6
1930,Eric Bledsoe,27-020,G,12/29/16,PHO,,TOR,W,1,38,9,14,0.643,8,11,0.727,1,3,0.333,3,3,1,1,4,5
1931,Bojan Bogdanovic,27-295,G-F,2/7/17,BRK,@,CHO,L,1,30,8,15,0.533,5,7,0.714,3,8,0.375,3,3,1,0,5,5
1932,Devin Booker,20-092,G,1/30/17,PHO,,MEM,L,1,39,6,20,0.3,6,17,0.353,0,3,0,10,12,0.833,2,4,6
1933,Devin Booker,20-067,G,1/5/17,PHO,@,DAL,W,1,36,9,17,0.529,6,14,0.429,3,3,1,1,1,1,0,2,2
1934,Avery Bradley,25-363,G,11/23/16,BOS,@,BRK,W,1,34,10,22,0.455,9,15,0.6,1,7,0.143,1,2,0.5,1,6,7
1935,Malcolm Brogdon,24-028,G,1/8/17,MIL,,WAS,L,1,36,9,15,0.6,7,11,0.636,2,4,0.5,2,2,1,0,1,1
1936,Jimmy Butler,27-066,G-F,11/19/16,CHI,@,LAC,L,1,38,5,18,0.278,4,13,0.308,1,5,0.2,11,12,0.917,3,3,6
1937,Jimmy Butler,27-163,G-F,2/24/17,CHI,,PHO,W,1,43,8,21,0.381,7,17,0.412,1,4,0.25,5,6,0.833,2,1,3
1938,Jimmy Butler,27-047,G-F,10/31/16,CHI,@,BRK,W,1,27,6,10,0.6,4,7,0.571,2,3,0.667,8,9,0.889,1,5,6
1939,Jimmy Butler,27-077,G-F,11/30/16,CHI,,LAL,L,1,40,4,18,0.222,3,12,0.25,1,6,0.167,13,15,0.867,1,3,4
1940,Jimmy Butler,27-169,G-F,3/2/17,CHI,,GSW,W,1,35,6,14,0.429,6,13,0.462,0,1,0,10,10,1,0,5,5
1941,Kentavious Caldwell-Pope,23-279,G,11/23/16,DET,,MIA,W,1,29,7,13,0.538,5,7,0.714,2,6,0.333,6,6,1,1,4,5
1942,Clint Capela,22-247,F-C,1/20/17,HOU,,GSW,L,0,21,10,16,0.625,10,16,0.625,0,0,,2,2,1,6,6,12
1943,Clint Capela,22-260,F-C,2/2/17,HOU,,ATL,L,1,31,9,11,0.818,9,11,0.818,0,0,,4,5,0.8,5,4,9
1944,Tyson Chandler,34-109,C,1/19/17,PHO,@,CLE,L,1,30,9,14,0.643,9,14,0.643,0,0,,4,6,0.667,8,8,16
1945,Tyson Chandler,34-114,C,1/24/17,PHO,,MIN,L,1,35,9,9,1,9,9,1,0,0,,4,5,0.8,7,10,17
1946,Wilson Chandler,29-180,F,11/6/16,DEN,@,BOS,W,0,25,8,14,0.571,6,10,0.6,2,4,0.5,4,5,0.8,0,5,5
1947,Ian Clark,25-239,G,11/1/16,GSW,@,POR,W,0,25,8,8,1,5,5,1,3,3,1,3,3,1,0,2,2
1948,Jordan Clarkson,24-232,G,1/25/17,LAL,@,POR,L,0,35,8,15,0.533,6,11,0.545,2,4,0.5,4,4,1,1,2,3
1949,Jordan Clarkson,24-154,G,11/8/16,LAL,,DAL,L,0,28,9,12,0.75,7,9,0.778,2,3,0.667,2,2,1,0,0,0
1950,Jordan Clarkson,24-273,G,3/7/17,LAL,@,DAL,L,0,34,9,17,0.529,5,9,0.556,4,8,0.5,0,0,,1,0,1
1951,Darren Collison,29-171,G,2/10/17,SAC,,ATL,W,1,44,8,16,0.5,6,11,0.545,2,5,0.4,4,5,0.8,0,3,3
1952,Mike Conley,29-092,G,1/11/17,MEM,@,OKC,L,1,36,8,20,0.4,5,13,0.385,3,7,0.429,3,5,0.6,2,2,4
1953,Mike Conley,29-156,G,3/16/17,MEM,@,ATL,W,1,33,8,20,0.4,7,15,0.467,1,5,0.2,5,6,0.833,2,2,4
1954,Mike Conley,29-081,G,12/31/16,MEM,@,SAC,W,1,29,8,11,0.727,5,7,0.714,3,4,0.75,3,5,0.6,3,5,8
1955,DeMarcus Cousins,26-181,C-F,2/10/17,SAC,,ATL,W,1,32,6,17,0.353,4,9,0.444,2,8,0.25,8,13,0.615,2,9,11
1956,DeMarcus Cousins,26-163,C-F,1/23/17,SAC,@,DET,W,1,32,8,21,0.381,7,18,0.389,1,3,0.333,5,8,0.625,2,11,13
1957,DeMarcus Cousins,26-174,C-F,2/3/17,SAC,,PHO,L,1,34,6,16,0.375,3,9,0.333,3,7,0.429,7,9,0.778,1,10,11
1958,DeMarcus Cousins,26-125,C-F,12/16/16,SAC,@,MEM,W,1,35,7,20,0.35,7,17,0.412,0,3,0,8,8,1,0,9,9
1959,DeMarcus Cousins,26-085,C-F,11/6/16,SAC,@,TOR,W,1,36,7,21,0.333,7,20,0.35,0,1,0,8,11,0.727,5,9,14
1960,DeMarcus Cousins,26-213,C-F,3/14/17,NOP,,POR,W,1,30,9,22,0.409,9,17,0.529,0,5,0,4,10,0.4,1,8,9
1961,Robert Covington,26-037,F,1/20/17,PHI,,POR,W,1,34,8,17,0.471,3,5,0.6,5,12,0.417,1,1,1,1,5,6
1962,Jamal Crawford,36-265,G,12/10/16,LAC,,NOP,W,0,26,10,13,0.769,8,9,0.889,2,4,0.5,0,0,,0,0,0
1963,Jamal Crawford,36-280,G,12/25/16,LAC,@,LAL,L,0,31,7,17,0.412,6,12,0.5,1,5,0.2,7,8,0.875,0,0,0
1964,Jamal Crawford,36-328,G,2/11/17,LAC,@,CHO,W,0,27,6,11,0.545,1,3,0.333,5,8,0.625,5,9,0.556,0,1,1
1965,Jamal Crawford,36-290,G,1/4/17,LAC,,MEM,W,0,27,6,12,0.5,3,6,0.5,3,6,0.5,7,7,1,0,1,1
1966,Jordan Crawford,28-147,G,3/19/17,NOP,,MIN,W,0,21,9,13,0.692,5,6,0.833,4,7,0.571,0,0,,0,2,2
1967,Seth Curry,26-162,G,2/1/17,DAL,,PHI,W,1,34,8,14,0.571,5,7,0.714,3,7,0.429,3,4,0.75,1,2,3
1968,Seth Curry,26-194,G,3/5/17,DAL,,OKC,W,1,30,10,16,0.625,8,11,0.727,2,5,0.4,0,0,,0,1,1
1969,Stephen Curry,28-252,G,11/21/16,GSW,@,IND,W,1,30,6,11,0.545,4,5,0.8,2,6,0.333,8,8,1,2,4,6
1970,Stephen Curry,28-294,G,1/2/17,GSW,,DEN,W,1,35,8,18,0.444,5,9,0.556,3,9,0.333,3,3,1,0,3,3
1971,Stephen Curry,28-272,G,12/11/16,GSW,@,MIN,W,1,32,6,13,0.462,4,8,0.5,2,5,0.4,8,8,1,1,3,4
1972,Troy Daniels,25-167,G,12/29/16,MEM,,OKC,W,0,18,8,12,0.667,2,4,0.5,6,8,0.75,0,0,,1,2,3
1973,Anthony Davis,23-315,F-C,1/20/17,NOP,,BRK,L,1,27,10,17,0.588,10,16,0.625,0,1,0,2,3,0.667,2,7,9
1974,Anthony Davis,23-238,F-C,11/4/16,NOP,,PHO,L,1,43,7,11,0.636,7,10,0.7,0,1,0,8,12,0.667,1,9,10
1975,Luol Deng,31-239,F,12/11/16,LAL,,NYK,L,1,32,8,13,0.615,3,5,0.6,5,8,0.625,1,1,1,0,5,5
1976,DeMar DeRozan,27-224,G,3/19/17,TOR,,IND,W,1,29,9,19,0.474,8,17,0.471,1,2,0.5,3,4,0.75,0,3,3
1977,DeMar DeRozan,27-175,G,1/29/17,TOR,,ORL,L,1,36,6,18,0.333,6,17,0.353,0,1,0,10,11,0.909,1,6,7
1978,DeMar DeRozan,27-221,G,3/16/17,TOR,,OKC,L,1,29,8,14,0.571,8,13,0.615,0,1,0,6,7,0.857,0,3,3
1979,DeMar DeRozan,27-168,G,1/22/17,TOR,,PHO,L,1,37,6,17,0.353,6,16,0.375,0,1,0,10,11,0.909,1,2,3
1980,Goran Dragic,30-306,G,3/8/17,MIA,,CHO,W,1,34,6,13,0.462,5,10,0.5,1,3,0.333,9,9,1,3,3,6
1981,Goran Dragic,30-197,G,11/19/16,MIA,@,WAS,W,1,37,7,14,0.5,5,10,0.5,2,4,0.5,6,8,0.75,0,3,3
1982,Goran Dragic,30-283,G,2/13/17,MIA,,ORL,L,1,36,6,15,0.4,6,14,0.429,0,1,0,10,10,1,1,2,3
1983,Andre Drummond,23-121,C,12/9/16,DET,@,MIN,W,1,28,10,13,0.769,10,13,0.769,0,0,,2,4,0.5,8,14,22
1984,Kevin Durant,28-082,F-G,12/20/16,GSW,,UTA,W,1,25,8,14,0.571,8,13,0.615,0,1,0,6,6,1,1,4,5
1985,Kevin Durant,28-132,F-G,2/8/17,GSW,,CHI,W,1,31,9,16,0.563,8,14,0.571,1,2,0.5,3,3,1,0,10,10
1986,Kevin Durant,28-073,F-G,12/11/16,GSW,@,MIN,W,1,37,6,21,0.286,5,17,0.294,1,4,0.25,9,9,1,1,7,8
1987,Kevin Durant,28-090,F-G,12/28/16,GSW,,TOR,W,1,38,8,15,0.533,5,10,0.5,3,5,0.6,3,5,0.6,0,17,17
1988,Kevin Durant,28-039,F-G,11/7/16,GSW,,NOP,W,1,37,8,17,0.471,7,13,0.538,1,4,0.25,5,6,0.833,1,2,3
1989,Wayne Ellington,29-088,G,1/25/17,MIA,@,BRK,W,0,36,8,15,0.533,4,8,0.5,4,7,0.571,2,2,1,1,3,4
1990,Wayne Ellington,29-032,G,11/30/16,MIA,@,DEN,W,0,32,8,14,0.571,3,5,0.6,5,9,0.556,1,2,0.5,0,2,2
1991,Joel Embiid,22-234,C-F,11/5/16,PHI,,CLE,L,1,25,7,13,0.538,3,9,0.333,4,4,1,4,4,1,2,4,6
1992,Joel Embiid,22-256,C-F,11/27/16,PHI,,CLE,L,1,25,8,18,0.444,5,14,0.357,3,4,0.75,3,5,0.6,4,5,9
1993,Joel Embiid,22-306,C-F,1/16/17,PHI,@,MIL,W,1,28,4,9,0.444,3,6,0.5,1,3,0.333,13,18,0.722,3,10,13
1994,Joel Embiid,22-250,C-F,11/21/16,PHI,,MIA,W,1,23,7,13,0.538,6,11,0.545,1,2,0.5,7,9,0.778,0,5,5
1995,Dante Exum,21-241,G,3/11/17,UTA,@,OKC,L,0,26,7,8,0.875,6,7,0.857,1,1,1,7,9,0.778,1,0,1
1996,Evan Fournier,24-000,G-F,10/29/16,ORL,@,CLE,L,1,38,9,16,0.563,7,10,0.7,2,6,0.333,2,2,1,0,2,2
1997,Evan Fournier,24-123,G-F,3/1/17,ORL,,NYK,L,1,38,8,15,0.533,6,8,0.75,2,7,0.286,4,7,0.571,0,2,2
1998,Danilo Gallinari,28-208,F,3/4/17,DEN,,CHO,L,1,33,5,15,0.333,3,7,0.429,2,8,0.25,10,10,1,2,3,5
1999,Danilo Gallinari,28-205,F,3/1/17,DEN,@,MIL,W,1,34,6,11,0.545,4,6,0.667,2,5,0.4,8,8,1,1,4,5
2000,Danilo Gallinari,28-204,F,2/28/17,DEN,@,CHI,W,1,32,7,10,0.7,4,6,0.667,3,4,0.75,5,6,0.833,1,2,3
2001,Marc Gasol,31-340,C,1/3/17,MEM,@,LAL,L,1,35,8,15,0.533,8,13,0.615,0,2,0,6,6,1,0,6,6
2002,Marc Gasol,31-290,C,11/14/16,MEM,@,UTA,W,1,33,9,17,0.529,7,11,0.636,2,6,0.333,2,4,0.5,0,5,5
2003,Pau Gasol,36-190,F-C,1/12/17,SAS,,LAL,W,1,26,9,9,1,9,9,1,0,0,,4,5,0.8,2,7,9
2004,Pau Gasol,36-256,F-C,3/19/17,SAS,,SAC,W,0,20,7,11,0.636,5,9,0.556,2,2,1,6,9,0.667,3,6,9
2005,Rudy Gay,30-151,F,1/15/17,SAC,,OKC,L,1,36,6,18,0.333,4,13,0.308,2,5,0.4,8,9,0.889,2,8,10
2006,Rudy Gay,30-075,F,10/31/16,SAC,@,ATL,L,1,31,8,13,0.615,7,11,0.636,1,2,0.5,5,7,0.714,0,3,3
2007,Rudy Gay,30-109,F,12/4/16,SAC,@,NYK,L,1,35,7,18,0.389,5,12,0.417,2,6,0.333,6,6,1,2,7,9
2008,Rudy Gay,30-070,F,10/26/16,SAC,@,PHO,W,1,33,9,15,0.6,8,12,0.667,1,3,0.333,3,4,0.75,0,3,3
2009,Rudy Gay,30-102,F,11/27/16,SAC,@,BRK,W,1,32,8,15,0.533,5,10,0.5,3,5,0.6,3,4,0.75,4,4,8
2010,Paul George,26-221,F,12/9/16,IND,@,DAL,L,1,40,8,16,0.5,5,12,0.417,3,4,0.75,3,3,1,0,7,7
2011,Paul George,26-303,F,3/1/17,IND,@,SAS,L,1,34,5,18,0.278,3,11,0.273,2,7,0.286,10,10,1,0,6,6
2012,Paul George,26-282,F,2/8/17,IND,,CLE,L,1,38,9,19,0.474,7,14,0.5,2,5,0.4,2,3,0.667,1,7,8
2013,Paul George,26-316,F,3/14/17,IND,@,NYK,L,1,38,9,22,0.409,6,14,0.429,3,8,0.375,1,1,1,2,8,10
2014,Paul George,26-226,F,12/14/16,IND,@,MIA,L,1,38,8,22,0.364,4,11,0.364,4,11,0.364,2,2,1,1,6,7
2015,Paul George,26-179,F,10/28/16,IND,@,BRK,L,1,36,8,22,0.364,6,14,0.429,2,8,0.25,4,4,1,1,8,9
2016,Paul George,26-224,F,12/12/16,IND,,CHO,W,1,36,9,17,0.529,6,10,0.6,3,7,0.429,1,1,1,0,5,5
2017,Rudy Gobert,24-163,C,12/6/16,UTA,,PHO,W,1,38,6,8,0.75,6,8,0.75,0,0,,10,11,0.909,3,8,11
2018,Aaron Gordon,21-108,F,1/2/17,ORL,@,NYK,W,1,32,8,19,0.421,5,9,0.556,3,10,0.3,3,5,0.6,3,3,6
2019,Eric Gordon,28-011,G,1/5/17,HOU,,OKC,W,0,29,8,20,0.4,3,10,0.3,5,10,0.5,1,1,1,0,5,5
2020,Draymond Green,26-278,F,12/7/16,GSW,@,LAC,W,1,32,8,10,0.8,5,5,1,3,5,0.6,3,4,0.75,3,2,5
2021,Blake Griffin,27-238,F,11/9/16,LAC,,POR,W,1,26,7,14,0.5,7,13,0.538,0,1,0,8,10,0.8,4,9,13
2022,Tim Hardaway,24-297,G,1/7/17,ATL,@,DAL,W,0,31,7,13,0.538,2,5,0.4,5,8,0.625,3,4,0.75,0,2,2
2023,Tim Hardaway,25-002,G,3/18/17,ATL,,POR,L,0,29,6,16,0.375,4,10,0.4,2,6,0.333,8,9,0.889,1,1,2
2024,James Harden,27-142,G,1/15/17,HOU,@,BRK,W,1,32,6,16,0.375,2,7,0.286,4,9,0.444,6,7,0.857,2,10,12
2025,Gary Harris,22-154,G,2/15/17,DEN,,MIN,L,1,38,8,17,0.471,5,11,0.455,3,6,0.5,3,4,0.75,1,2,3
2026,Gary Harris,22-130,G,1/22/17,DEN,@,MIN,L,1,35,9,13,0.692,7,9,0.778,2,4,0.5,2,2,1,2,3,5
2027,Tobias Harris,24-122,F,11/14/16,DET,,OKC,W,1,37,9,16,0.563,7,11,0.636,2,5,0.4,2,2,1,0,6,6
2028,Tobias Harris,24-103,F,10/26/16,DET,@,TOR,L,1,36,8,13,0.615,7,11,0.636,1,2,0.5,5,5,1,0,5,5
2029,Tobias Harris,24-236,F,3/8/17,DET,@,IND,L,0,27,9,17,0.529,7,12,0.583,2,5,0.4,2,4,0.5,1,4,5
2030,Tobias Harris,24-144,F,12/6/16,DET,,CHI,W,1,40,9,16,0.563,7,12,0.583,2,4,0.5,2,2,1,0,7,7
2031,Tobias Harris,24-172,F,1/3/17,DET,,IND,L,0,30,9,14,0.643,7,9,0.778,2,5,0.4,2,2,1,0,5,5
2032,Gordon Hayward,26-329,F-G,2/15/17,UTA,,POR,W,1,34,8,18,0.444,6,12,0.5,2,6,0.333,4,6,0.667,1,5,6
2033,Gordon Hayward,26-245,F-G,11/23/16,UTA,,DEN,W,1,36,7,15,0.467,5,11,0.455,2,4,0.5,6,6,1,0,5,5
2034,Gordon Hayward,26-291,F-G,1/8/17,UTA,@,MEM,L,1,34,6,13,0.462,3,8,0.375,3,5,0.6,7,9,0.778,0,5,5
2035,Gordon Hayward,26-270,F-G,12/18/16,UTA,@,MEM,W,1,37,5,13,0.385,1,6,0.167,4,7,0.571,8,9,0.889,1,6,7
2036,George Hill,30-283,G,2/11/17,UTA,,BOS,L,1,36,7,16,0.438,5,10,0.5,2,6,0.333,6,7,0.857,2,1,3
2037,George Hill,30-181,G,11/1/16,UTA,@,SAS,W,1,33,9,13,0.692,6,8,0.75,3,5,0.6,1,1,1,0,2,2
2038,George Hill,30-278,G,2/6/17,UTA,@,ATL,W,1,35,8,15,0.533,5,7,0.714,3,8,0.375,3,4,0.75,1,3,4
2039,George Hill,30-254,G,1/13/17,UTA,,DET,W,1,27,8,13,0.615,3,7,0.429,5,6,0.833,1,3,0.333,1,3,4
2040,George Hill,30-203,G,11/23/16,UTA,,DEN,W,1,29,8,13,0.615,5,7,0.714,3,6,0.5,3,4,0.75,0,5,5
2041,Jrue Holiday,26-194,G,12/23/16,NOP,,MIA,W,1,27,9,17,0.529,8,15,0.533,1,2,0.5,3,5,0.6,0,2,2
2042,Jrue Holiday,26-170,G,11/29/16,NOP,,LAL,W,1,29,8,15,0.533,4,8,0.5,4,7,0.571,2,3,0.667,0,2,2
2043,Jrue Holiday,26-262,G,3/1/17,NOP,,DET,W,1,30,10,18,0.556,8,13,0.615,2,5,0.4,0,0,,1,3,4
2044,Jrue Holiday,26-234,G,2/1/17,NOP,@,DET,L,1,35,10,17,0.588,10,14,0.714,0,3,0,2,3,0.667,1,2,3
2045,Jrue Holiday,26-160,G,11/19/16,NOP,,CHO,W,0,30,9,17,0.529,6,10,0.6,3,7,0.429,1,2,0.5,0,2,2
2046,Rodney Hood,24-013,G-F,11/2/16,UTA,,DAL,W,1,35,9,16,0.563,7,12,0.583,2,4,0.5,2,2,1,1,6,7
2047,Al Horford,30-235,C-F,1/24/17,BOS,@,WAS,L,1,33,9,12,0.75,7,9,0.778,2,3,0.667,2,2,1,0,2,2
2048,Al Horford,30-227,C-F,1/16/17,BOS,,CHO,W,1,34,8,14,0.571,7,9,0.778,1,5,0.2,5,5,1,2,4,6
2049,Serge Ibaka,27-164,F-C,3/1/17,TOR,,WAS,L,1,36,8,17,0.471,4,11,0.364,4,6,0.667,2,2,1,4,9,13
2050,Serge Ibaka,27-106,F-C,1/2/17,ORL,@,NYK,W,1,31,10,20,0.5,8,15,0.533,2,5,0.4,0,0,,2,4,6
2051,Serge Ibaka,27-083,F-C,12/10/16,ORL,,DEN,L,1,36,9,17,0.529,7,14,0.5,2,3,0.667,2,2,1,1,3,4
2052,Andre Iguodala,33-013,G-F,2/10/17,GSW,@,MEM,W,0,28,6,7,0.857,4,4,1,2,3,0.667,8,11,0.727,0,2,2
2053,Ersan Ilyasova,29-217,F,12/18/16,PHI,,BRK,W,0,31,7,12,0.583,3,5,0.6,4,7,0.571,4,4,1,0,4,4
2054,Ersan Ilyasova,29-192,F,11/23/16,PHI,,MEM,L,1,40,8,15,0.533,6,10,0.6,2,5,0.4,4,5,0.8,2,10,12
2055,Brandon Ingram,19-177,F,2/26/17,LAL,,SAS,L,1,35,10,15,0.667,9,11,0.818,1,4,0.25,1,1,1,1,1,2
2056,Kyrie Irving,24-353,G,3/11/17,CLE,@,ORL,W,1,36,9,22,0.409,7,14,0.5,2,8,0.25,2,2,1,3,6,9
2057,Reggie Jackson,26-305,G,2/15/17,DET,,DAL,W,1,28,8,12,0.667,5,8,0.625,3,4,0.75,3,4,0.75,0,0,0
2058,Reggie Jackson,26-264,G,1/5/17,DET,,CHO,W,1,30,7,15,0.467,6,13,0.462,1,2,0.5,7,8,0.875,1,0,1
2059,LeBron James,31-335,F-G,11/29/16,CLE,@,MIL,L,1,33,8,16,0.5,5,8,0.625,3,8,0.375,3,7,0.429,0,4,4
2060,James Johnson,29-314,F,12/30/16,MIA,@,BOS,L,0,24,8,13,0.615,4,6,0.667,4,7,0.571,2,3,0.667,0,3,3
2061,Tyler Johnson,24-178,G,11/1/16,MIA,,SAC,W,0,32,7,11,0.636,5,9,0.556,2,2,1,6,6,1,0,4,4
2062,Tyler Johnson,24-202,G,11/25/16,MIA,@,MEM,W,0,33,8,17,0.471,7,12,0.583,1,5,0.2,5,7,0.714,1,4,5
2063,Nikola Jokic,22-029,C-F,3/20/17,DEN,@,HOU,L,1,40,7,14,0.5,7,11,0.636,0,3,0,8,8,1,1,12,13
2064,Nikola Jokic,21-328,C-F,1/12/17,DEN,,IND,W,1,30,7,12,0.583,5,9,0.556,2,3,0.667,6,6,1,3,7,10
2065,DeAndre Jordan,28-237,C,3/15/17,LAC,,MIL,L,1,37,9,12,0.75,9,12,0.75,0,0,,4,5,0.8,2,15,17
2066,DeAndre Jordan,28-146,C,12/14/16,LAC,@,ORL,W,1,35,5,6,0.833,5,6,0.833,0,0,,12,18,0.667,3,9,12
2067,Frank Kaminsky,23-281,F-C,1/10/17,CHO,@,HOU,L,0,27,8,14,0.571,4,5,0.8,4,9,0.444,2,2,1,0,3,3
2068,Enes Kanter,24-229,C,1/4/17,OKC,@,CHO,L,0,20,8,13,0.615,7,11,0.636,1,2,0.5,5,6,0.833,2,6,8
2069,Enes Kanter,24-243,C,1/18/17,OKC,@,GSW,L,0,30,11,18,0.611,11,18,0.611,0,0,,0,0,,5,4,9
2070,Michael Kidd-Gilchrist,23-168,F,3/13/17,CHO,,CHI,L,1,35,9,12,0.75,9,12,0.75,0,0,,4,5,0.8,2,4,6
2071,Sean Kilpatrick,26-336,G,12/7/16,BRK,,DEN,W,1,32,6,10,0.6,4,7,0.571,2,3,0.667,8,8,1,0,6,6
2072,Sean Kilpatrick,26-326,G,11/27/16,BRK,,SAC,L,1,30,8,13,0.615,5,8,0.625,3,5,0.6,3,3,1,1,4,5
2073,Sean Kilpatrick,26-343,G,12/14/16,BRK,,LAL,W,1,31,5,13,0.385,2,7,0.286,3,6,0.5,9,10,0.9,1,3,4
2074,Kyle Korver,35-288,G-F,12/30/16,ATL,,DET,W,0,29,7,13,0.538,4,5,0.8,3,8,0.375,5,6,0.833,0,3,3
2075,Kyle Korver,35-335,G-F,2/15/17,CLE,,IND,W,0,25,8,12,0.667,2,4,0.5,6,8,0.75,0,0,,0,5,5
2076,Zach LaVine,21-254,G,11/19/16,MIN,@,MEM,L,1,37,9,16,0.563,5,8,0.625,4,8,0.5,0,0,,0,1,1
2077,Ty Lawson,29-095,G,2/6/17,SAC,,CHI,L,0,35,8,13,0.615,6,9,0.667,2,4,0.5,4,4,1,1,3,4
2078,Kawhi Leonard,25-231,F,2/15/17,SAS,@,ORL,W,1,27,8,18,0.444,6,13,0.462,2,5,0.4,4,4,1,1,4,5
2079,Kawhi Leonard,25-265,F,3/21/17,SAS,@,MIN,W,1,31,7,13,0.538,7,8,0.875,0,5,0,8,10,0.8,0,3,3
2080,Kawhi Leonard,25-262,F,3/18/17,SAS,@,MEM,L,1,36,6,15,0.4,4,9,0.444,2,6,0.333,8,9,0.889,1,6,7
2081,Jon Leuer,27-230,F,12/30/16,DET,@,ATL,L,1,37,9,16,0.563,7,12,0.583,2,4,0.5,2,2,1,3,3,6
2082,Jon Leuer,27-291,F,3/1/17,DET,@,NOP,L,1,39,11,23,0.478,11,20,0.55,0,3,0,0,0,,4,3,7
2083,Damian Lillard,26-235,G,3/7/17,POR,@,OKC,W,1,36,8,17,0.471,6,11,0.545,2,6,0.333,4,5,0.8,1,2,3
2084,Damian Lillard,26-130,G,11/22/16,POR,@,NYK,L,1,35,8,18,0.444,6,12,0.5,2,6,0.333,4,4,1,0,5,5
2085,Damian Lillard,26-185,G,1/16/17,POR,@,WAS,L,1,28,6,17,0.353,2,9,0.222,4,8,0.5,6,6,1,2,5,7
2086,Brook Lopez,28-231,C,11/18/16,BRK,@,OKC,L,1,28,8,16,0.5,4,9,0.444,4,7,0.571,2,2,1,2,2,4
2087,Brook Lopez,28-261,C,12/18/16,BRK,@,PHI,L,1,32,6,14,0.429,5,11,0.455,1,3,0.333,9,10,0.9,3,6,9
2088,Brook Lopez,28-259,C,12/16/16,BRK,@,ORL,L,1,32,9,19,0.474,9,16,0.563,0,3,0,4,5,0.8,1,5,6
2089,Kevin Love,28-138,F,1/23/17,CLE,@,NOP,L,1,38,7,15,0.467,6,10,0.6,1,5,0.2,7,8,0.875,6,10,16
2090,Kevin Love,28-094,F,12/10/16,CLE,,CHO,W,1,36,7,12,0.583,7,8,0.875,0,4,0,8,10,0.8,1,5,6
2091,Kyle Lowry,30-326,G,2/14/17,TOR,@,CHI,L,1,38,8,17,0.471,4,6,0.667,4,11,0.364,2,2,1,0,3,3
2092,Wesley Matthews,30-033,G,11/16/16,DAL,@,BOS,L,1,38,7,15,0.467,1,2,0.5,6,13,0.462,2,3,0.667,0,3,3
2093,C.J. McCollum,25-180,G,3/18/17,POR,@,ATL,W,1,32,10,19,0.526,10,18,0.556,0,1,0,2,2,1,1,5,6
2094,C.J. McCollum,25-157,G,2/23/17,POR,@,ORL,W,1,37,7,17,0.412,6,14,0.429,1,3,0.333,7,7,1,0,1,1
2095,Ben McLemore,23-365,G,2/10/17,SAC,,ATL,W,1,42,8,17,0.471,2,7,0.286,6,10,0.6,0,0,,3,6,9
2096,Paul Millsap,31-282,F,11/18/16,ATL,@,CHO,L,1,33,8,13,0.615,7,11,0.636,1,2,0.5,5,6,0.833,4,9,13
2097,Paul Millsap,31-346,F,1/21/17,ATL,,PHI,W,1,36,9,14,0.643,8,12,0.667,1,2,0.5,3,6,0.5,2,8,10
2098,Marcus Morris,27-183,F,3/4/17,DET,@,PHI,W,1,34,8,15,0.533,6,9,0.667,2,6,0.333,4,4,1,1,2,3
2099,Marcus Morris,27-060,F,11/1/16,DET,,NYK,W,1,32,9,14,0.643,7,11,0.636,2,3,0.667,2,4,0.5,1,3,4
2100,Markieff Morris,27-055,F,10/27/16,WAS,@,ATL,L,1,28,9,18,0.5,7,15,0.467,2,3,0.667,2,2,1,1,3,4
2101,Markieff Morris,27-179,F,2/28/17,WAS,,GSW,W,1,33,8,17,0.471,6,12,0.5,2,5,0.4,4,4,1,2,4,6
2102,Emmanuel Mudiay,20-287,G,12/17/16,DEN,,NYK,W,1,32,10,15,0.667,8,12,0.667,2,3,0.667,0,0,,0,7,7
2103,Emmanuel Mudiay,20-300,G,12/30/16,DEN,,PHI,L,1,29,7,11,0.636,4,6,0.667,3,5,0.6,5,8,0.625,1,3,4
2104,Shabazz Muhammad,24-087,F-G,2/8/17,MIN,,TOR,W,0,26,8,13,0.615,6,8,0.75,2,5,0.4,4,6,0.667,0,2,2
2105,Shabazz Muhammad,24-047,F-G,12/30/16,MIN,,MIL,W,0,18,8,13,0.615,4,8,0.5,4,5,0.8,2,2,1,0,1,1
2106,Jamal Murray,19-286,G,12/5/16,DEN,@,PHI,W,0,24,8,12,0.667,5,5,1,3,7,0.429,3,3,1,0,3,3
2107,Jamal Murray,20-018,G,3/13/17,DEN,,LAL,W,0,30,8,13,0.615,3,5,0.6,5,8,0.625,1,1,1,1,1,2
2108,Dirk Nowitzki,38-129,F,10/26/16,DAL,@,IND,L,1,38,8,19,0.421,4,10,0.4,4,9,0.444,2,2,1,0,8,8
2109,Kyle O'Quinn,26-262,F-C,12/13/16,NYK,@,PHO,L,0,28,9,16,0.563,9,15,0.6,0,1,0,4,6,0.667,5,9,14
2110,Jahlil Okafor,21-089,C-F,3/14/17,PHI,@,GSW,L,1,23,8,16,0.5,8,16,0.5,0,0,,6,7,0.857,2,4,6
2111,Victor Oladipo,24-311,G,3/11/17,OKC,,UTA,W,1,38,8,15,0.533,5,9,0.556,3,6,0.5,3,4,0.75,1,1,2
2112,Jabari Parker,21-251,F,11/21/16,MIL,,ORL,W,1,35,8,17,0.471,3,10,0.3,5,7,0.714,1,5,0.2,0,3,3
2113,Jabari Parker,21-301,F,1/10/17,MIL,@,SAS,W,1,34,9,16,0.563,7,13,0.538,2,3,0.667,2,2,1,1,6,7
2114,Jabari Parker,21-261,F,12/1/16,MIL,@,BRK,W,1,29,9,14,0.643,9,12,0.75,0,2,0,4,6,0.667,1,2,3
2115,Tony Parker,34-229,G,1/1/17,SAS,@,ATL,L,1,32,10,18,0.556,9,16,0.563,1,2,0.5,1,2,0.5,1,2,3
2116,Elfrid Payton,22-302,G,12/20/16,ORL,@,MIA,W,0,36,8,13,0.615,8,12,0.667,0,1,0,6,7,0.857,0,2,2
2117,Elfrid Payton,23-014,G,3/8/17,ORL,,CHI,W,1,36,8,12,0.667,8,11,0.727,0,1,0,6,7,0.857,6,8,14
2118,Otto Porter,23-278,F,3/8/17,WAS,@,DEN,W,1,34,10,15,0.667,8,12,0.667,2,3,0.667,0,0,,1,2,3
2119,Otto Porter,23-208,F,12/28/16,WAS,,IND,W,1,33,6,10,0.6,3,4,0.75,3,6,0.5,7,7,1,0,1,1
2120,Bobby Portis,22-036,F,3/18/17,CHI,,UTA,W,0,31,10,13,0.769,9,11,0.818,1,2,0.5,1,2,0.5,1,4,5
2121,Kristaps Porzingis,21-137,F-C,12/17/16,NYK,@,DEN,L,1,38,7,19,0.368,6,13,0.462,1,6,0.167,7,7,1,1,6,7
2122,Kristaps Porzingis,21-145,F-C,12/25/16,NYK,,BOS,L,1,37,9,16,0.563,7,12,0.583,2,4,0.5,2,2,1,2,10,12
2123,Julius Randle,22-044,F,1/12/17,LAL,@,SAS,L,1,34,8,13,0.615,8,13,0.615,0,0,,6,7,0.857,0,6,6
2124,Zach Randolph,35-106,F,10/30/16,MEM,,WAS,W,0,25,10,16,0.625,10,15,0.667,0,1,0,2,3,0.667,1,7,8
2125,J.J. Redick,32-265,G,3/16/17,LAC,@,DEN,L,1,26,8,10,0.8,4,4,1,4,6,0.667,2,2,1,0,5,5
2126,J.J. Redick,32-192,G,1/2/17,LAC,,PHO,W,1,34,9,14,0.643,6,9,0.667,3,5,0.6,1,1,1,1,3,4
2127,J.J. Redick,32-247,G,2/26/17,LAC,,CHO,W,1,38,9,16,0.563,6,9,0.667,3,7,0.429,1,2,0.5,0,2,2
2128,J.J. Redick,32-184,G,12/25/16,LAC,@,LAL,L,1,26,8,16,0.5,4,9,0.444,4,7,0.571,2,2,1,1,1,2
2129,J.J. Redick,32-201,G,1/11/17,LAC,,ORL,W,1,36,7,16,0.438,4,7,0.571,3,9,0.333,5,7,0.714,0,6,6
2130,J.J. Redick,32-214,G,1/24/17,LAC,@,PHI,L,1,35,6,15,0.4,1,5,0.2,5,10,0.5,5,6,0.833,0,1,1
2131,Willie Reed,26-235,F-C,1/6/17,MIA,@,LAL,L,1,32,10,15,0.667,10,15,0.667,0,0,,2,5,0.4,7,5,12
2132,Willie Reed,26-232,F-C,1/3/17,MIA,@,PHO,L,1,32,11,16,0.688,11,16,0.688,0,0,,0,0,,8,10,18
2133,Josh Richardson,23-103,G,12/27/16,MIA,,OKC,L,1,37,9,16,0.563,7,10,0.7,2,6,0.333,2,2,1,0,5,5
2134,Austin Rivers,24-189,G,2/6/17,LAC,@,TOR,L,1,38,7,14,0.5,3,6,0.5,4,8,0.5,4,7,0.571,1,1,2
2135,Austin Rivers,24-149,G,12/28/16,LAC,@,NOP,L,1,32,9,20,0.45,7,12,0.583,2,8,0.25,2,2,1,3,1,4
2136,Austin Rivers,24-114,G,11/23/16,LAC,@,DAL,W,0,26,7,11,0.636,1,4,0.25,6,7,0.857,2,3,0.667,0,1,1
2137,Derrick Rose,28-163,G,3/16/17,NYK,,BRK,L,1,33,7,17,0.412,7,17,0.412,0,0,,8,9,0.889,0,2,2
2138,Terrence Ross,25-297,F-G,11/28/16,TOR,,PHI,W,0,23,8,11,0.727,5,6,0.833,3,5,0.6,3,3,1,1,2,3
2139,Ricky Rubio,26-143,G,3/13/17,MIN,,WAS,W,1,39,8,15,0.533,6,10,0.6,2,5,0.4,4,4,1,1,4,5
2140,Ricky Rubio,26-141,G,3/11/17,MIN,@,MIL,L,1,28,9,14,0.643,7,11,0.636,2,3,0.667,2,3,0.667,0,0,0
2141,Ricky Rubio,26-101,G,1/30/17,MIN,,ORL,W,1,36,7,16,0.438,1,7,0.143,6,9,0.667,2,4,0.5,1,7,8
2142,D'Angelo Russell,20-343,G,1/31/17,LAL,,DEN,W,1,34,7,17,0.412,5,10,0.5,2,7,0.286,6,8,0.75,1,6,7
2143,D'Angelo Russell,20-263,G,11/12/16,LAL,@,NOP,W,1,28,9,16,0.563,5,9,0.556,4,7,0.571,0,0,,0,2,2
2144,D'Angelo Russell,20-317,G,1/5/17,LAL,@,POR,L,1,35,6,18,0.333,6,10,0.6,0,8,0,10,11,0.909,1,3,4
2145,D'Angelo Russell,21-012,G,3/7/17,LAL,@,DAL,L,1,33,8,17,0.471,6,11,0.545,2,6,0.333,4,4,1,0,1,1
2146,Dennis Schroder,23-151,G,2/13/17,ATL,@,POR,W,1,42,9,22,0.409,8,18,0.444,1,4,0.25,3,4,0.75,0,4,4
2147,Dennis Schroder,23-179,G,3/13/17,ATL,@,SAS,L,1,38,10,22,0.455,10,18,0.556,0,4,0,2,2,1,0,2,2
2148,Marcus Smart,22-307,G,1/7/17,BOS,,NOP,W,1,32,7,10,0.7,2,3,0.667,5,7,0.714,3,3,1,1,4,5
2149,Jeff Teague,28-222,G,1/18/17,IND,@,SAC,W,1,34,5,6,0.833,4,5,0.8,1,1,1,11,11,1,0,7,7
2150,Jeff Teague,28-243,G,2/8/17,IND,,CLE,L,1,35,7,14,0.5,4,9,0.444,3,5,0.6,5,6,0.833,0,5,5
2151,Mirza Teletovic,31-048,F,11/5/16,MIL,,SAC,W,0,21,7,9,0.778,0,0,,7,9,0.778,1,2,0.5,0,0,0
2152,Isaiah Thomas,28-033,G,3/12/17,BOS,,CHI,W,1,24,9,14,0.643,5,6,0.833,4,8,0.5,0,0,,0,1,1
2153,Hollis Thompson,25-212,G-F,11/1/16,PHI,,ORL,L,0,28,8,10,0.8,4,6,0.667,4,4,1,2,2,1,1,6,7
2154,Klay Thompson,26-350,G,1/23/17,GSW,@,MIA,L,1,37,8,18,0.444,5,10,0.5,3,8,0.375,3,4,0.75,0,5,5
2155,Tristan Thompson,25-330,F-C,2/6/17,CLE,@,WAS,W,1,41,10,13,0.769,10,13,0.769,0,0,,2,4,0.5,6,6,12
2156,Karl-Anthony Towns,21-010,F-C,11/25/16,MIN,@,PHO,W,1,35,8,19,0.421,6,13,0.462,2,6,0.333,4,5,0.8,3,7,10
2157,Karl-Anthony Towns,21-041,F-C,12/26/16,MIN,,ATL,W,1,31,8,8,1,5,5,1,3,3,1,3,3,1,3,8,11
2158,Karl-Anthony Towns,21-089,F-C,2/12/17,MIN,,CHI,W,1,34,8,11,0.727,8,9,0.889,0,2,0,6,6,1,1,6,7
2159,Karl-Anthony Towns,20-364,F-C,11/13/16,MIN,,LAL,W,1,39,7,22,0.318,5,15,0.333,2,7,0.286,6,10,0.6,2,10,12
2160,Myles Turner,20-239,F-C,11/18/16,IND,,PHO,L,1,31,9,13,0.692,9,12,0.75,0,1,0,4,7,0.571,1,5,6
2161,Myles Turner,20-305,F-C,1/23/17,IND,,NYK,L,1,28,8,12,0.667,8,10,0.8,0,2,0,6,6,1,2,8,10
2162,Myles Turner,20-263,F-C,12/12/16,IND,,CHO,W,1,34,9,16,0.563,5,9,0.556,4,7,0.571,0,0,,0,7,7
2163,Myles Turner,20-326,F-C,2/13/17,IND,,SAS,L,1,36,6,13,0.462,5,12,0.417,1,1,1,9,12,0.75,2,4,6
2164,Jonas Valanciunas,24-275,C,2/5/17,TOR,@,BRK,W,1,26,9,17,0.529,9,17,0.529,0,0,,4,4,1,0,5,5
2165,Rashad Vaughn,20-074,G,10/29/16,MIL,,BRK,W,0,27,8,17,0.471,2,5,0.4,6,12,0.5,0,0,,0,2,2
2166,Dwyane Wade,34-361,G,1/12/17,CHI,@,NYK,L,1,33,9,20,0.45,9,18,0.5,0,2,0,4,6,0.667,0,3,3
2167,Dwyane Wade,34-358,G,1/9/17,CHI,,OKC,L,1,28,7,15,0.467,5,12,0.417,2,3,0.667,6,8,0.75,0,4,4
2168,Dwyane Wade,34-284,G,10/27/16,CHI,,BOS,W,1,32,7,18,0.389,3,12,0.25,4,6,0.667,4,4,1,2,4,6
2169,Dwyane Wade,34-310,G,11/22/16,CHI,@,DEN,L,1,35,9,21,0.429,7,17,0.412,2,4,0.5,2,2,1,1,2,3
2170,Dwyane Wade,34-363,G,1/14/17,CHI,,NOP,W,1,32,9,24,0.375,8,20,0.4,1,4,0.25,3,5,0.6,1,4,5
2171,Dion Waiters,25-077,G,2/25/17,MIA,,IND,W,1,31,8,15,0.533,5,9,0.556,3,6,0.5,3,3,1,0,2,2
2172,Kemba Walker,26-178,G,11/2/16,CHO,,PHI,W,1,33,7,14,0.5,5,9,0.556,2,5,0.4,6,6,1,1,3,4
2173,Kemba Walker,26-209,G,12/3/16,CHO,,MIN,L,1,37,9,22,0.409,7,16,0.438,2,6,0.333,2,4,0.5,0,4,4
2174,Kemba Walker,26-235,G,12/29/16,CHO,,MIA,W,1,36,8,20,0.4,4,10,0.4,4,10,0.4,2,2,1,0,7,7
2175,Kemba Walker,26-268,G,1/31/17,CHO,@,POR,L,1,32,8,18,0.444,5,11,0.455,3,7,0.429,3,3,1,0,3,3
2176,John Wall,26-054,G,10/30/16,WAS,@,MEM,L,1,37,8,19,0.421,7,16,0.438,1,3,0.333,5,5,1,0,3,3
2177,John Wall,26-153,G,2/6/17,WAS,,CLE,L,1,44,8,19,0.421,8,16,0.5,0,3,0,6,6,1,0,4,4
2178,T.J. Warren,23-062,F,11/6/16,PHO,@,LAL,L,1,39,9,20,0.45,7,17,0.412,2,3,0.667,2,3,0.667,2,4,6
2179,Hassan Whiteside,27-257,C,2/25/17,MIA,,IND,W,1,37,6,12,0.5,6,12,0.5,0,0,,10,13,0.769,7,10,17
2180,Andrew Wiggins,21-263,F-G,11/12/16,MIN,,LAC,L,1,37,8,24,0.333,7,20,0.35,1,4,0.25,5,5,1,1,3,4
2181,Andrew Wiggins,22-026,F-G,3/21/17,MIN,,SAS,L,1,36,5,15,0.333,5,13,0.385,0,2,0,12,14,0.857,0,4,4
2182,Lou Williams,30-061,G,12/27/16,LAL,,UTA,L,0,27,6,13,0.462,4,9,0.444,2,4,0.5,8,8,1,0,2,2
2183,Lou Williams,30-102,G,2/6/17,LAL,@,NYK,W,0,26,6,11,0.545,3,6,0.5,3,5,0.6,7,7,1,1,1,2
2184,Nick Young,31-170,G-F,11/18/16,LAL,,SAS,L,1,28,7,12,0.583,3,5,0.6,4,7,0.571,4,5,0.8,1,3,4
2185,Nick Young,31-230,G-F,1/17/17,LAL,,DEN,L,1,31,8,16,0.5,4,5,0.8,4,11,0.364,2,2,1,2,0,2
2186,Nick Young,31-158,G-F,11/6/16,LAL,,PHO,W,1,36,8,14,0.571,5,7,0.714,3,7,0.429,3,3,1,1,6,7
2187,LaMarcus Aldridge,31-189,F-C,1/24/17,SAS,@,TOR,W,1,32,6,14,0.429,6,14,0.429,0,0,,9,11,0.818,1,6,7
2188,LaMarcus Aldridge,31-227,F-C,3/3/17,SAS,@,NOP,W,1,40,10,19,0.526,10,19,0.526,0,0,,1,4,0.25,5,9,14
2189,LaMarcus Aldridge,31-105,F-C,11/1/16,SAS,,UTA,L,1,35,8,16,0.5,8,15,0.533,0,1,0,5,5,1,0,4,4
2190,LaMarcus Aldridge,31-242,F-C,3/18/17,SAS,@,MEM,L,1,34,9,18,0.5,9,18,0.5,0,0,,3,3,1,1,8,9
2191,LaMarcus Aldridge,31-120,F-C,11/16/16,SAS,@,SAC,W,1,33,8,16,0.5,7,15,0.467,1,1,1,4,4,1,2,6,8
2192,Ryan Anderson,28-308,F,3/10/17,HOU,@,CHI,W,1,27,7,15,0.467,1,3,0.333,6,12,0.5,1,1,1,2,1,3
2193,Giannis Antetokounmpo,22-088,F-G,3/4/17,MIL,,TOR,W,1,35,8,13,0.615,8,13,0.615,0,0,,5,6,0.833,2,8,10
2194,Giannis Antetokounmpo,21-328,F-G,10/29/16,MIL,,BRK,W,1,35,10,18,0.556,10,17,0.588,0,1,0,1,1,1,1,9,10
2195,Giannis Antetokounmpo,22-094,F-G,3/10/17,MIL,,IND,W,1,39,7,13,0.538,6,10,0.6,1,3,0.333,6,6,1,0,8,8
2196,Giannis Antetokounmpo,22-053,F-G,1/28/17,MIL,,BOS,L,1,45,8,16,0.5,6,13,0.462,2,3,0.667,3,4,0.75,0,6,6
2197,Giannis Antetokounmpo,21-351,F-G,11/21/16,MIL,,ORL,W,1,39,6,13,0.462,6,11,0.545,0,2,0,9,9,1,2,9,11
2198,Carmelo Anthony,32-157,F,11/2/16,NYK,,HOU,L,1,31,8,15,0.533,7,11,0.636,1,4,0.25,4,5,0.8,1,6,7
2199,D.J. Augustin,29-080,G,1/29/17,ORL,@,TOR,W,0,29,7,10,0.7,4,5,0.8,3,5,0.6,4,5,0.8,0,2,2
2200,Leandro Barbosa,34-011,G,12/9/16,PHO,@,LAL,W,0,29,8,16,0.5,3,9,0.333,5,7,0.714,0,0,,0,2,2
2201,J.J. Barea,32-133,G,11/6/16,DAL,,MIL,W,1,46,8,18,0.444,6,11,0.545,2,7,0.286,3,3,1,0,6,6
2202,Harrison Barnes,24-222,F,1/7/17,DAL,,ATL,L,1,30,9,15,0.6,7,11,0.636,2,4,0.5,1,2,0.5,2,2,4
2203,Harrison Barnes,24-200,F,12/16/16,DAL,@,UTA,L,1,37,10,22,0.455,9,19,0.474,1,3,0.333,0,0,,1,2,3
2204,Harrison Barnes,24-284,F,3/10/17,DAL,,BRK,W,1,37,7,15,0.467,5,12,0.417,2,3,0.667,5,5,1,1,6,7
2205,Harrison Barnes,24-211,F,12/27/16,DAL,,HOU,L,1,32,7,16,0.438,6,13,0.462,1,3,0.333,6,6,1,0,3,3
2206,Will Barton,26-001,G,1/7/17,DEN,@,OKC,L,1,28,6,11,0.545,3,6,0.5,3,5,0.6,6,6,1,2,5,7
2207,Nicolas Batum,28-082,F-G,3/6/17,CHO,,IND,W,1,34,7,19,0.368,4,10,0.4,3,9,0.333,4,4,1,0,4,4
2208,Nicolas Batum,28-080,F-G,3/4/17,CHO,@,DEN,W,1,35,7,11,0.636,3,5,0.6,4,6,0.667,3,3,1,0,2,2
2209,Kent Bazemore,27-149,G-F,11/27/16,ATL,@,LAL,L,1,27,8,16,0.5,3,8,0.375,5,8,0.625,0,0,,0,1,1
2210,Bradley Beal,23-176,G,12/21/16,WAS,@,CHI,W,1,37,7,17,0.412,6,10,0.6,1,7,0.143,6,8,0.75,0,0,0
2211,Davis Bertans,24-056,F,1/7/17,SAS,,CHO,W,0,18,5,6,0.833,1,1,1,4,5,0.8,7,8,0.875,0,1,1
2212,Eric Bledsoe,26-336,G,11/9/16,PHO,,DET,W,1,35,8,15,0.533,7,13,0.538,1,2,0.5,4,4,1,1,10,11
2213,Eric Bledsoe,26-326,G,10/30/16,PHO,,GSW,L,1,36,7,11,0.636,6,8,0.75,1,3,0.333,6,9,0.667,0,5,5
2214,Bojan Bogdanovic,27-296,G-F,2/8/17,BRK,,WAS,L,1,34,6,18,0.333,4,9,0.444,2,9,0.222,7,7,1,2,3,5
2215,Bojan Bogdanovic,27-191,G-F,10/26/16,BRK,@,BOS,L,1,23,9,17,0.529,6,9,0.667,3,8,0.375,0,0,,2,3,5
2216,Devin Booker,20-037,G,12/6/16,PHO,@,UTA,L,1,26,9,13,0.692,8,10,0.8,1,3,0.333,2,3,0.667,0,2,2
2217,Devin Booker,20-034,G,12/3/16,PHO,@,GSW,L,1,33,8,17,0.471,7,12,0.583,1,5,0.2,4,5,0.8,1,0,1
2218,Devin Booker,19-364,G,10/28/16,PHO,@,OKC,L,1,44,8,25,0.32,6,17,0.353,2,8,0.25,3,5,0.6,2,4,6
2219,Devin Booker,20-081,G,1/19/17,PHO,@,CLE,L,1,37,4,13,0.308,4,9,0.444,0,4,0,13,14,0.929,1,6,7
2220,Devin Booker,20-106,G,2/13/17,PHO,,NOP,L,1,36,9,19,0.474,7,13,0.538,2,6,0.333,1,1,1,0,1,1
2221,Avery Bradley,25-349,G,11/9/16,BOS,@,WAS,L,1,38,9,14,0.643,6,7,0.857,3,7,0.429,0,1,0,1,2,3
2222,Alec Burks,25-234,G,3/11/17,UTA,@,OKC,L,0,24,5,11,0.455,2,6,0.333,3,5,0.6,8,9,0.889,1,6,7
2223,Jimmy Butler,27-092,G-F,12/15/16,CHI,@,MIL,L,1,38,6,16,0.375,5,13,0.385,1,3,0.333,8,10,0.8,0,3,3
2224,Jimmy Butler,27-175,G-F,3/8/17,CHI,@,ORL,L,1,38,7,21,0.333,4,13,0.308,3,8,0.375,4,5,0.8,1,3,4
2225,Kentavious Caldwell-Pope,23-327,G,1/10/17,DET,@,SAC,L,1,40,6,12,0.5,0,4,0,6,8,0.75,3,3,1,1,4,5
2226,Kentavious Caldwell-Pope,23-272,G,11/16/16,DET,@,NYK,L,1,37,9,22,0.409,6,13,0.462,3,9,0.333,0,0,,1,3,4
2227,Kentavious Caldwell-Pope,23-255,G,10/30/16,DET,,MIL,W,1,34,7,13,0.538,5,8,0.625,2,5,0.4,5,5,1,4,2,6
2228,Kentavious Caldwell-Pope,23-360,G,2/12/17,DET,@,TOR,W,1,41,8,22,0.364,6,10,0.6,2,12,0.167,3,3,1,0,0,0
2229,Clint Capela,22-193,F-C,11/27/16,HOU,@,POR,W,1,33,9,12,0.75,9,12,0.75,0,0,,3,4,0.75,3,6,9
2230,Michael Carter-Williams,25-119,G,2/6/17,CHI,@,SAC,W,1,31,8,12,0.667,7,10,0.7,1,2,0.5,4,4,1,0,6,6
2231,Wilson Chandler,29-179,F,11/5/16,DEN,@,DET,L,0,31,9,18,0.5,8,14,0.571,1,4,0.25,2,2,1,3,6,9
2232,Wilson Chandler,29-247,F,1/12/17,DEN,,IND,W,1,32,8,13,0.615,6,8,0.75,2,5,0.4,3,3,1,1,7,8
2233,Wilson Chandler,29-302,F,3/8/17,DEN,,WAS,L,1,34,10,16,0.625,9,11,0.818,1,5,0.2,0,1,0,0,3,3
2234,Wilson Chandler,29-237,F,1/2/17,DEN,@,GSW,L,1,37,8,16,0.5,5,8,0.625,3,8,0.375,2,3,0.667,1,3,4
2235,Ian Clark,25-261,G,11/23/16,GSW,,LAL,W,0,18,7,8,0.875,2,3,0.667,5,5,1,2,4,0.5,0,1,1
2236,Jordan Clarkson,24-212,G,1/5/17,LAL,@,POR,L,0,32,8,14,0.571,4,7,0.571,4,7,0.571,1,2,0.5,1,2,3
2237,Jordan Clarkson,24-283,G,3/17/17,LAL,,MIL,L,1,38,8,20,0.4,4,9,0.444,4,11,0.364,1,1,1,1,4,5
2238,Jordan Clarkson,24-221,G,1/14/17,LAL,@,LAC,L,0,28,8,14,0.571,5,10,0.5,3,4,0.75,2,2,1,1,3,4
2239,Darren Collison,29-145,G,1/15/17,SAC,,OKC,L,1,27,7,9,0.778,5,6,0.833,2,3,0.667,5,6,0.833,0,1,1
2240,Darren Collison,29-092,G,11/23/16,SAC,,OKC,W,1,31,7,12,0.583,4,7,0.571,3,5,0.6,4,4,1,0,0,0
2241,Mike Conley,29-084,G,1/3/17,MEM,@,LAL,L,1,32,7,16,0.438,4,9,0.444,3,7,0.429,4,4,1,0,1,1
2242,Mike Conley,29-046,G,11/26/16,MEM,@,MIA,W,1,34,6,14,0.429,4,9,0.444,2,5,0.4,7,7,1,0,3,3
2243,DeMarcus Cousins,26-130,C-F,12/21/16,SAC,@,UTA,W,1,31,5,18,0.278,4,15,0.267,1,3,0.333,10,13,0.769,1,7,8
2244,Robert Covington,26-046,F,1/29/17,PHI,@,CHI,L,1,37,8,16,0.5,4,9,0.444,4,7,0.571,1,3,0.333,2,10,12
2245,Allen Crabbe,24-297,G-F,1/31/17,POR,,CHO,W,0,29,5,10,0.5,2,4,0.5,3,6,0.5,8,8,1,0,5,5
2246,Jamal Crawford,36-262,G,12/7/16,LAC,,GSW,L,0,35,7,17,0.412,4,11,0.364,3,6,0.5,4,4,1,2,0,2
2247,Jamal Crawford,36-257,G,12/2/16,LAC,@,NOP,W,0,29,9,15,0.6,7,11,0.636,2,4,0.5,1,1,1,0,1,1
2248,Jamal Crawford,36-319,G,2/2/17,LAC,,GSW,L,0,34,7,11,0.636,2,3,0.667,5,8,0.625,2,3,0.667,0,2,2
2249,Jae Crowder,26-208,F,1/30/17,BOS,,DET,W,1,36,6,12,0.5,2,6,0.333,4,6,0.667,5,8,0.625,1,7,8
2250,Jae Crowder,26-181,F,1/3/17,BOS,,UTA,W,1,35,6,8,0.75,1,2,0.5,5,6,0.833,4,4,1,0,3,3
2251,Jae Crowder,26-196,F,1/18/17,BOS,,NYK,L,1,37,7,13,0.538,5,8,0.625,2,5,0.4,5,6,0.833,0,5,5
2252,Jae Crowder,26-112,F,10/26/16,BOS,,BRK,W,1,29,9,15,0.6,6,7,0.857,3,8,0.375,0,0,,0,5,5
2253,Seth Curry,26-190,G,3/1/17,DAL,@,ATL,L,1,35,7,13,0.538,2,5,0.4,5,8,0.625,2,2,1,2,2,4
2254,Stephen Curry,28-315,G,1/23/17,GSW,@,MIA,L,1,37,7,19,0.368,4,10,0.4,3,9,0.333,4,5,0.8,0,9,9
2255,Stephen Curry,28-234,G,11/3/16,GSW,,OKC,W,1,30,6,14,0.429,4,8,0.5,2,6,0.333,7,8,0.875,0,1,1
2256,Anthony Davis,23-266,F-C,12/2/16,NOP,,LAC,L,1,32,8,17,0.471,8,17,0.471,0,0,,5,6,0.833,2,3,5
2257,Anthony Davis,23-313,F-C,1/18/17,NOP,,ORL,W,1,29,9,17,0.529,9,17,0.529,0,0,,3,4,0.75,2,11,13
2258,DeMar DeRozan,27-118,G,12/3/16,TOR,,ATL,W,1,31,8,16,0.5,8,15,0.533,0,1,0,5,6,0.833,0,3,3
2259,Gorgui Dieng,26-363,C,1/15/17,MIN,@,DAL,L,1,31,10,12,0.833,10,11,0.909,0,1,0,1,3,0.333,5,3,8
2260,Goran Dragic,30-224,G,12/16/16,MIA,,LAC,L,1,39,7,16,0.438,7,13,0.538,0,3,0,7,7,1,1,5,6
2261,Goran Dragic,30-280,G,2/10/17,MIA,@,BRK,W,1,35,9,18,0.5,8,14,0.571,1,4,0.25,2,3,0.667,1,3,4
2262,Goran Dragic,30-218,G,12/10/16,MIA,@,CHI,L,1,35,10,19,0.526,10,17,0.588,0,2,0,1,1,1,1,4,5
2263,Goran Dragic,30-295,G,2/25/17,MIA,,IND,W,1,28,8,12,0.667,7,9,0.778,1,3,0.333,4,5,0.8,0,2,2
2264,Goran Dragic,30-256,G,1/17/17,MIA,,HOU,W,1,37,8,15,0.533,7,10,0.7,1,5,0.2,4,5,0.8,2,6,8
2265,Goran Dragic,30-215,G,12/7/16,MIA,@,ATL,L,1,35,8,17,0.471,7,13,0.538,1,4,0.25,4,4,1,0,2,2
2266,Goran Dragic,30-230,G,12/22/16,MIA,,LAL,W,1,36,6,15,0.4,3,9,0.333,3,6,0.5,6,7,0.857,0,2,2
2267,Goran Dragic,30-285,G,2/15/17,MIA,@,HOU,W,1,33,8,14,0.571,8,9,0.889,0,5,0,5,7,0.714,0,1,1
2268,Goran Dragic,30-304,G,3/6/17,MIA,@,CLE,W,1,34,8,17,0.471,6,12,0.5,2,5,0.4,3,3,1,0,1,1
2269,Andre Drummond,23-187,C,2/13/17,DET,@,MIL,L,1,34,8,16,0.5,8,16,0.5,0,0,,5,9,0.556,5,7,12
2270,Kevin Durant,28-139,F-G,2/15/17,GSW,,SAC,W,1,32,10,15,0.667,9,11,0.818,1,4,0.25,0,0,,0,7,7
2271,Kevin Durant,28-072,F-G,12/10/16,GSW,@,MEM,L,1,31,7,13,0.538,4,7,0.571,3,6,0.5,4,5,0.8,0,7,7
2272,Kevin Durant,28-070,F-G,12/8/16,GSW,@,UTA,W,1,36,7,15,0.467,6,12,0.5,1,3,0.333,6,8,0.75,0,11,11
2273,Kevin Durant,28-095,F-G,1/2/17,GSW,,DEN,W,1,34,10,19,0.526,9,15,0.6,1,4,0.25,0,0,,0,3,3
2274,Kevin Durant,28-109,F-G,1/16/17,GSW,,CLE,W,1,29,9,16,0.563,6,9,0.667,3,7,0.429,0,0,,1,5,6
2275,Joel Embiid,22-301,C-F,1/11/17,PHI,,NYK,W,1,27,7,20,0.35,6,17,0.353,1,3,0.333,6,7,0.857,5,9,14
2276,Kenneth Faried,27-070,F,1/28/17,DEN,@,PHO,W,1,37,6,9,0.667,6,9,0.667,0,0,,9,11,0.818,2,11,13
2277,Evan Fournier,24-101,G-F,2/7/17,ORL,@,HOU,L,1,37,7,16,0.438,6,8,0.75,1,8,0.125,6,6,1,1,2,3
2278,Evan Fournier,24-013,G-F,11/11/16,ORL,,UTA,L,1,38,7,16,0.438,5,12,0.417,2,4,0.5,5,6,0.833,1,3,4
2279,Evan Fournier,24-054,G-F,12/22/16,ORL,@,NYK,L,1,36,9,17,0.529,8,12,0.667,1,5,0.2,2,2,1,1,4,5
2280,Evan Fournier,24-135,G-F,3/13/17,ORL,@,SAC,L,1,30,8,18,0.444,4,7,0.571,4,11,0.364,1,1,1,3,2,5
2281,Evan Fournier,24-048,G-F,12/16/16,ORL,,BRK,W,1,31,5,15,0.333,2,8,0.25,3,7,0.429,8,9,0.889,1,3,4
2282,Evan Fournier,24-015,G-F,11/13/16,ORL,@,OKC,W,1,37,7,10,0.7,4,6,0.667,3,4,0.75,4,4,1,0,2,2
2283,Tim Frazier,25-362,G,10/28/16,NOP,,GSW,L,1,34,10,18,0.556,9,15,0.6,1,3,0.333,0,1,0,3,3,6
2284,Tim Frazier,26-021,G,11/22/16,NOP,@,ATL,W,1,35,7,12,0.583,4,8,0.5,3,4,0.75,4,4,1,0,5,5
2285,Channing Frye,33-273,C-F,2/14/17,CLE,@,MIN,W,1,33,7,15,0.467,3,4,0.75,4,11,0.364,3,3,1,2,8,10
2286,Channing Frye,33-291,C-F,3/4/17,CLE,@,MIA,L,0,23,9,12,0.75,6,7,0.857,3,5,0.6,0,1,0,0,4,4
2287,Channing Frye,33-182,C-F,11/15/16,CLE,,TOR,W,0,20,7,10,0.7,2,2,1,5,8,0.625,2,2,1,1,2,3
2288,Danilo Gallinari,28-092,F,11/8/16,DEN,@,MEM,L,1,38,5,11,0.455,2,6,0.333,3,5,0.6,8,9,0.889,1,6,7
2289,Danilo Gallinari,28-124,F,12/10/16,DEN,@,ORL,W,1,33,5,8,0.625,3,5,0.6,2,3,0.667,9,10,0.9,0,6,6
2290,Danilo Gallinari,28-102,F,11/18/16,DEN,,TOR,L,1,43,4,13,0.308,4,8,0.5,0,5,0,13,13,1,0,9,9
2291,Danilo Gallinari,28-137,F,12/23/16,DEN,,ATL,L,1,33,5,10,0.5,3,6,0.5,2,4,0.5,9,10,0.9,2,9,11
2292,Langston Galloway,24-341,G,11/14/16,NOP,,BOS,W,0,32,8,14,0.571,5,9,0.556,3,5,0.6,2,2,1,0,1,1
2293,Marc Gasol,31-282,C,11/6/16,MEM,,POR,L,1,28,7,14,0.5,6,12,0.5,1,2,0.5,6,8,0.75,0,3,3
2294,Marc Gasol,31-280,C,11/4/16,MEM,,LAC,L,1,37,7,18,0.389,6,14,0.429,1,4,0.25,6,6,1,1,9,10
2295,Pau Gasol,36-169,F-C,12/22/16,SAS,@,LAC,L,1,32,6,12,0.5,5,10,0.5,1,2,0.5,8,8,1,5,4,9
2296,Pau Gasol,36-128,F-C,11/11/16,SAS,,DET,W,1,36,10,16,0.625,9,13,0.692,1,3,0.333,0,0,,4,5,9
2297,Rudy Gay,30-083,F,11/8/16,SAC,,NOP,W,1,33,7,16,0.438,5,12,0.417,2,4,0.5,5,5,1,0,6,6
2298,Rudy Gay,30-154,F,1/18/17,SAC,,IND,L,1,28,8,13,0.615,5,9,0.556,3,4,0.75,2,2,1,3,1,4
2299,Paul George,26-217,F,12/5/16,IND,@,GSW,L,1,31,4,12,0.333,4,10,0.4,0,2,0,13,13,1,1,9,10
2300,Paul George,26-280,F,2/6/17,IND,,OKC,W,1,33,7,20,0.35,5,11,0.455,2,9,0.222,5,6,0.833,4,4,8
2301,Paul George,26-280,F,2/6/17,IND,,OKC,W,1,33,7,20,0.35,5,11,0.455,2,9,0.222,5,6,0.833,4,4,8
2302,Paul George,26-198,F,11/16/16,IND,,CLE,W,1,37,8,18,0.444,5,9,0.556,3,9,0.333,2,2,1,0,11,11
2303,Paul George,26-263,F,1/20/17,IND,@,LAL,L,1,36,8,15,0.533,5,8,0.625,3,7,0.429,2,2,1,1,5,6
2304,Paul George,26-278,F,2/4/17,IND,,DET,W,1,32,9,14,0.643,6,8,0.75,3,6,0.5,0,1,0,0,3,3
2305,Rudy Gobert,24-175,C,12/18/16,UTA,@,MEM,W,1,38,9,9,1,9,9,1,0,0,,3,7,0.429,2,10,12
2306,Aaron Gordon,21-168,F,3/3/17,ORL,,MIA,W,1,32,9,17,0.529,8,13,0.615,1,4,0.25,2,2,1,4,6,10
2307,Aaron Gordon,21-120,F,1/14/17,ORL,@,UTA,L,1,39,8,14,0.571,5,8,0.625,3,6,0.5,2,3,0.667,0,4,4
2308,Eric Gordon,28-027,G,1/21/17,HOU,@,MEM,W,0,30,7,16,0.438,4,5,0.8,3,11,0.273,4,4,1,0,3,3
2309,Eric Gordon,27-313,G,11/2/16,HOU,@,NYK,W,1,29,6,11,0.545,2,4,0.5,4,7,0.571,5,6,0.833,0,3,3
2310,Eric Gordon,28-040,G,2/3/17,HOU,,CHI,W,0,34,8,17,0.471,3,7,0.429,5,10,0.5,0,0,,0,1,1
2311,Marcin Gortat,32-306,C-F,12/19/16,WAS,@,IND,L,1,43,10,15,0.667,10,15,0.667,0,0,,1,3,0.333,4,9,13
2312,Marcin Gortat,32-289,C-F,12/2/16,WAS,@,SAS,L,1,42,8,16,0.5,8,16,0.5,0,0,,5,6,0.833,6,12,18
2313,Marcin Gortat,32-351,C-F,2/2/17,WAS,,LAL,W,1,33,10,13,0.769,10,13,0.769,0,0,,1,1,1,6,8,14
2314,JaMychal Green,26-134,F,11/2/16,MEM,,NOP,W,1,31,9,12,0.75,6,7,0.857,3,5,0.6,0,0,,2,4,6
2315,Blake Griffin,27-229,F,10/31/16,LAC,,PHO,W,1,32,4,7,0.571,3,6,0.5,1,1,1,12,14,0.857,0,11,11
2316,Blake Griffin,27-352,F,3/3/17,LAC,@,MIL,L,1,38,6,9,0.667,6,8,0.75,0,1,0,9,13,0.692,0,9,9
2317,Justin Hamilton,26-222,C,11/9/16,BRK,@,NYK,L,0,23,8,13,0.615,3,6,0.5,5,7,0.714,0,0,,1,3,4
2318,Tim Hardaway,24-325,G,2/4/17,ATL,,ORL,W,1,27,8,14,0.571,5,8,0.625,3,6,0.5,2,2,1,0,5,5
2319,Tim Hardaway,24-225,G,10/27/16,ATL,,WAS,W,0,23,8,13,0.615,5,8,0.625,3,5,0.6,2,2,1,1,1,2
2320,Tim Hardaway,24-259,G,11/30/16,ATL,@,PHO,L,0,26,9,17,0.529,7,10,0.7,2,7,0.286,1,2,0.5,0,1,1
2321,Tim Hardaway,24-276,G,12/17/16,ATL,,CHO,L,1,33,7,17,0.412,3,8,0.375,4,9,0.444,3,6,0.5,0,4,4
2322,James Harden,27-105,G,12/9/16,HOU,@,OKC,W,1,37,6,23,0.261,4,12,0.333,2,11,0.182,7,8,0.875,1,8,9
2323,Tobias Harris,24-138,F,11/30/16,DET,@,BOS,W,1,35,9,20,0.45,6,14,0.429,3,6,0.5,0,0,,1,5,6
2324,Tobias Harris,24-134,F,11/26/16,DET,@,OKC,L,1,39,8,18,0.444,7,14,0.5,1,4,0.25,4,5,0.8,0,4,4
2325,Tobias Harris,24-164,F,12/26/16,DET,,CLE,W,0,29,7,14,0.5,4,8,0.5,3,6,0.5,4,4,1,0,6,6
2326,Andrew Harrison,22-033,G,11/30/16,MEM,@,TOR,L,1,35,7,12,0.583,3,7,0.429,4,5,0.8,3,4,0.75,0,2,2
2327,Buddy Hield,22-364,G,12/15/16,NOP,,IND,W,1,33,8,17,0.471,3,9,0.333,5,8,0.625,0,0,,2,2,4
2328,Nene Hilario,34-136,F-C,1/27/17,HOU,@,PHI,W,1,27,10,13,0.769,10,13,0.769,0,0,,1,1,1,2,4,6
2329,George Hill,30-239,G,12/29/16,UTA,,PHI,W,1,29,8,10,0.8,6,8,0.75,2,2,1,3,6,0.5,1,7,8
2330,George Hill,30-298,G,2/26/17,UTA,@,WAS,W,1,37,7,13,0.538,2,5,0.4,5,8,0.625,2,4,0.5,0,3,3
2331,Jrue Holiday,26-214,G,1/12/17,NOP,@,BRK,W,1,31,7,15,0.467,3,9,0.333,4,6,0.667,3,4,0.75,1,4,5
2332,Jrue Holiday,26-159,G,11/18/16,NOP,,POR,W,0,23,8,14,0.571,7,12,0.583,1,2,0.5,4,7,0.571,0,2,2
2333,Jrue Holiday,26-280,G,3/19/17,NOP,,MIN,W,1,35,8,16,0.5,4,11,0.364,4,5,0.8,1,2,0.5,0,3,3
2334,Al Horford,30-214,C-F,1/3/17,BOS,,UTA,W,1,31,9,16,0.563,6,10,0.6,3,6,0.5,0,0,,1,4,5
2335,Al Horford,30-210,C-F,12/30/16,BOS,,MIA,W,1,31,8,12,0.667,5,6,0.833,3,6,0.5,2,2,1,0,6,6
2336,Al Horford,30-185,C-F,12/5/16,BOS,@,HOU,L,1,35,9,22,0.409,8,17,0.471,1,5,0.2,2,2,1,1,5,6
2337,Serge Ibaka,27-064,F-C,11/21/16,ORL,@,MIL,L,1,37,6,11,0.545,3,7,0.429,3,4,0.75,6,6,1,2,7,9
2338,Serge Ibaka,27-077,F-C,12/4/16,ORL,@,DET,W,1,34,9,11,0.818,7,7,1,2,4,0.5,1,2,0.5,1,6,7
2339,Serge Ibaka,27-044,F-C,11/1/16,ORL,@,PHI,W,1,32,8,12,0.667,7,10,0.7,1,2,0.5,4,4,1,2,2,4
2340,Ersan Ilyasova,29-174,F,11/5/16,PHI,,CLE,L,0,28,8,13,0.615,4,7,0.571,4,6,0.667,1,2,0.5,2,2,4
2341,Ersan Ilyasova,29-251,F,1/21/17,PHI,@,ATL,L,1,30,8,15,0.533,5,9,0.556,3,6,0.5,2,3,0.667,2,1,3
2342,Ersan Ilyasova,29-265,F,2/4/17,PHI,@,MIA,L,1,27,7,15,0.467,4,8,0.5,3,7,0.429,4,5,0.8,1,4,5
2343,Joe Ingles,29-067,F-G,12/8/16,UTA,,GSW,L,0,35,7,13,0.538,2,4,0.5,5,9,0.556,2,3,0.667,0,5,5
2344,Brandon Ingram,19-200,F,3/21/17,LAL,,LAC,L,1,40,8,14,0.571,6,10,0.6,2,4,0.5,3,8,0.375,1,4,5
2345,Kyrie Irving,24-269,G,12/17/16,CLE,,LAL,W,1,38,8,17,0.471,6,11,0.545,2,6,0.333,3,3,1,1,5,6
2346,Kyrie Irving,24-358,G,3/16/17,CLE,,UTA,W,1,30,8,19,0.421,7,17,0.412,1,2,0.5,4,5,0.8,1,3,4
2347,Reggie Jackson,26-327,G,3/9/17,DET,,CLE,W,1,31,8,16,0.5,7,13,0.538,1,3,0.333,4,4,1,1,1,2
2348,Reggie Jackson,26-322,G,3/4/17,DET,@,PHI,W,1,25,9,14,0.643,6,10,0.6,3,4,0.75,0,0,,1,3,4
2349,LeBron James,31-324,F-G,11/18/16,CLE,,DET,W,1,28,9,14,0.643,8,11,0.727,1,3,0.333,2,3,0.667,0,3,3
2350,LeBron James,31-303,F-G,10/28/16,CLE,@,TOR,W,1,39,7,16,0.438,5,10,0.5,2,6,0.333,5,7,0.714,2,6,8
2351,LeBron James,32-020,F-G,1/19/17,CLE,,PHO,W,1,39,8,12,0.667,8,10,0.8,0,2,0,5,8,0.625,0,9,9
2352,Brandon Jennings,27-130,G,1/31/17,NYK,@,WAS,L,1,38,5,16,0.313,3,10,0.3,2,6,0.333,9,11,0.818,2,3,5
2353,Nikola Jokic,22-019,C-F,3/10/17,DEN,,BOS,W,1,27,8,10,0.8,7,8,0.875,1,2,0.5,4,6,0.667,3,7,10
2354,Nikola Jokic,21-318,C-F,1/2/17,DEN,@,GSW,L,1,25,8,17,0.471,7,15,0.467,1,2,0.5,4,4,1,8,5,13
2355,Terrence Jones,25-030,F,2/8/17,NOP,,UTA,L,1,35,9,16,0.563,9,15,0.6,0,1,0,3,3,1,2,6,8
2356,Terrence Jones,24-347,F,12/21/16,NOP,,OKC,L,0,34,9,17,0.529,9,16,0.563,0,1,0,3,5,0.6,0,2,2
2357,Terrence Jones,25-018,F,1/27/17,NOP,,SAS,W,0,24,8,14,0.571,7,12,0.583,1,2,0.5,4,5,0.8,2,5,7
2358,DeAndre Jordan,28-131,C,11/29/16,LAC,@,BRK,L,1,45,9,13,0.692,9,12,0.75,0,1,0,3,4,0.75,5,18,23
2359,Frank Kaminsky,23-243,F-C,12/3/16,CHO,,MIN,L,1,31,8,16,0.5,5,9,0.556,3,7,0.429,2,4,0.5,2,7,9
2360,Enes Kanter,24-238,C,1/13/17,OKC,@,MIN,L,0,30,8,10,0.8,7,9,0.778,1,1,1,4,5,0.8,6,2,8
2361,Sean Kilpatrick,26-334,G,12/5/16,BRK,,WAS,L,1,33,8,12,0.667,6,8,0.75,2,4,0.5,3,3,1,1,5,6
2362,Brandon Knight,25-017,G,12/19/16,PHO,@,MIN,L,0,29,8,13,0.615,8,11,0.727,0,2,0,5,5,1,0,2,2
2363,Brandon Knight,25-024,G,12/26/16,PHO,@,HOU,L,0,24,6,12,0.5,4,7,0.571,2,5,0.4,7,8,0.875,0,5,5
2364,Jeremy Lamb,24-182,G-F,11/28/16,CHO,@,MEM,W,0,23,7,11,0.636,5,6,0.833,2,5,0.4,5,7,0.714,2,7,9
2365,Zach LaVine,21-233,G,10/29/16,MIN,@,SAC,L,1,37,7,14,0.5,4,7,0.571,3,7,0.429,4,4,1,0,5,5
2366,Zach LaVine,21-291,G,12/26/16,MIN,,ATL,W,1,31,7,16,0.438,1,7,0.143,6,9,0.667,1,1,1,0,1,1
2367,Kawhi Leonard,25-154,F,11/30/16,SAS,@,DAL,W,1,31,5,16,0.313,3,11,0.273,2,5,0.4,9,12,0.75,1,6,7
2368,Kawhi Leonard,25-153,F,11/29/16,SAS,,ORL,L,1,32,6,16,0.375,5,12,0.417,1,4,0.25,8,9,0.889,1,1,2
2369,Kawhi Leonard,25-159,F,12/5/16,SAS,@,MIL,W,1,31,9,22,0.409,8,17,0.471,1,5,0.2,2,2,1,2,7,9
2370,Kawhi Leonard,25-174,F,12/20/16,SAS,@,HOU,W,1,36,5,14,0.357,5,11,0.455,0,3,0,11,13,0.846,0,5,5
2371,Kawhi Leonard,25-240,F,2/24/17,SAS,@,LAC,W,1,31,7,16,0.438,7,12,0.583,0,4,0,7,10,0.7,1,2,3
2372,Damian Lillard,26-213,G,2/13/17,POR,,ATL,L,1,41,6,21,0.286,3,12,0.25,3,9,0.333,6,6,1,1,5,6
2373,Damian Lillard,26-174,G,1/5/17,POR,,LAL,W,1,36,7,14,0.5,3,4,0.75,4,10,0.4,3,4,0.75,0,5,5
2374,Damian Lillard,26-187,G,1/18/17,POR,@,CHO,L,1,35,7,18,0.389,5,12,0.417,2,6,0.333,5,5,1,1,6,7
2375,Jeremy Lin,28-066,G,10/28/16,BRK,,IND,W,1,34,6,12,0.5,4,8,0.5,2,4,0.5,7,8,0.875,0,9,9
2376,Brook Lopez,28-233,C,11/20/16,BRK,,POR,L,1,29,8,14,0.571,6,10,0.6,2,4,0.5,3,3,1,3,3,6
2377,Brook Lopez,28-269,C,12/26/16,BRK,,CHO,W,1,33,8,13,0.615,7,10,0.7,1,3,0.333,4,4,1,2,3,5
2378,Brook Lopez,28-222,C,11/9/16,BRK,@,NYK,L,1,24,8,12,0.667,7,7,1,1,5,0.2,4,6,0.667,1,3,4
2379,Robin Lopez,28-291,C,1/17/17,CHI,,DAL,L,1,36,10,15,0.667,10,15,0.667,0,0,,1,1,1,5,0,5
2380,Robin Lopez,28-303,C,1/29/17,CHI,,PHI,W,1,31,9,13,0.692,9,13,0.692,0,0,,3,3,1,5,5,10
2381,Kevin Love,28-140,F,1/25/17,CLE,,SAC,L,1,39,7,16,0.438,3,7,0.429,4,9,0.444,3,6,0.5,4,12,16
2382,Kevin Love,28-091,F,12/7/16,CLE,@,NYK,W,1,27,6,16,0.375,2,4,0.5,4,12,0.333,5,5,1,1,2,3
2383,Kevin Love,28-193,F,3/19/17,CLE,@,LAL,W,1,26,6,15,0.4,3,8,0.375,3,7,0.429,6,7,0.857,4,11,15
2384,Kyle Lowry,30-327,G,2/15/17,TOR,,CHO,W,1,41,8,20,0.4,4,9,0.444,4,11,0.364,1,1,1,0,6,6
2385,Trey Lyles,21-014,F,11/19/16,UTA,@,HOU,L,1,33,8,12,0.667,6,8,0.75,2,4,0.5,3,4,0.75,1,4,5
2386,Wesley Matthews,30-108,G,1/30/17,DAL,,CLE,W,1,37,6,16,0.375,4,7,0.571,2,9,0.222,7,7,1,1,3,4
2387,Wesley Matthews,30-044,G,11/27/16,DAL,,NOP,W,1,39,7,14,0.5,1,6,0.167,6,8,0.75,1,2,0.5,1,2,3
2388,C.J. McCollum,25-055,G,11/13/16,POR,,DEN,W,1,35,9,23,0.391,7,18,0.389,2,5,0.4,1,2,0.5,2,1,3
2389,C.J. McCollum,25-169,G,3/7/17,POR,@,OKC,W,1,37,8,20,0.4,7,17,0.412,1,3,0.333,4,4,1,0,1,1
2390,C.J. McCollum,25-183,G,3/21/17,POR,,MIL,L,1,36,9,17,0.529,8,13,0.615,1,4,0.25,2,2,1,0,2,2
2391,Doug McDermott,25-074,F,3/18/17,OKC,,SAC,W,0,21,8,9,0.889,4,4,1,4,5,0.8,1,2,0.5,0,5,5
2392,Jordan McRae,25-282,G,1/4/17,CLE,,CHI,L,1,33,7,15,0.467,6,10,0.6,1,5,0.2,6,7,0.857,1,2,3
2393,Khris Middleton,25-201,F-G,3/1/17,MIL,,DEN,L,0,31,7,12,0.583,4,9,0.444,3,3,1,4,5,0.8,1,4,5
2394,Khris Middleton,25-210,F-G,3/10/17,MIL,,IND,W,1,37,7,14,0.5,4,9,0.444,3,5,0.6,4,6,0.667,0,3,3
2395,Patty Mills,28-212,G,3/11/17,SAS,,GSW,W,1,21,8,13,0.615,3,6,0.5,5,7,0.714,0,0,,1,1,2
2396,Paul Millsap,31-360,F,2/4/17,ATL,,ORL,W,1,28,7,14,0.5,6,11,0.545,1,3,0.333,6,8,0.75,1,4,5
2397,Paul Millsap,31-272,F,11/8/16,ATL,@,CLE,W,1,36,7,16,0.438,5,12,0.417,2,4,0.5,5,6,0.833,1,4,5
2398,Paul Millsap,31-343,F,1/18/17,ATL,@,DET,L,1,27,7,17,0.412,6,12,0.5,1,5,0.2,6,9,0.667,3,5,8
2399,Paul Millsap,32-014,F,2/24/17,ATL,,MIA,L,1,28,6,9,0.667,6,9,0.667,0,0,,9,14,0.643,0,4,4
2400,Paul Millsap,32-028,F,3/10/17,ATL,,TOR,W,1,36,7,13,0.538,6,10,0.6,1,3,0.333,6,6,1,1,5,6
2401,Paul Millsap,32-003,F,2/13/17,ATL,@,POR,W,1,41,4,12,0.333,3,9,0.333,1,3,0.333,12,12,1,1,8,9
2402,Paul Millsap,31-301,F,12/7/16,ATL,,MIA,W,1,32,8,12,0.667,8,10,0.8,0,2,0,5,6,0.833,1,8,9
2403,Paul Millsap,31-280,F,11/16/16,ATL,,MIL,W,1,38,8,11,0.727,7,8,0.875,1,3,0.333,4,4,1,0,8,8
2404,Paul Millsap,31-350,F,1/25/17,ATL,@,CHI,W,1,36,8,14,0.571,5,9,0.556,3,5,0.6,2,3,0.667,0,6,6
2405,Marcus Morris,27-132,F,1/12/17,DET,@,GSW,L,1,34,9,17,0.529,8,11,0.727,1,6,0.167,2,2,1,1,4,5
2406,Marcus Morris,27-093,F,12/4/16,DET,,ORL,L,1,35,7,12,0.583,2,3,0.667,5,9,0.556,2,2,1,0,5,5
2407,Markieff Morris,27-149,F,1/29/17,WAS,@,NOP,W,1,37,9,20,0.45,6,17,0.353,3,3,1,0,0,,3,5,8
2408,Markieff Morris,27-167,F,2/16/17,WAS,@,IND,W,1,32,8,12,0.667,5,8,0.625,3,4,0.75,2,2,1,2,5,7
2409,Anthony Morrow,31-060,G,11/26/16,OKC,,DET,W,0,26,8,12,0.667,5,6,0.833,3,6,0.5,2,2,1,0,1,1
2410,Emmanuel Mudiay,20-238,G,10/29/16,DEN,,POR,L,1,38,7,20,0.35,5,16,0.313,2,4,0.5,5,6,0.833,0,7,7
2411,Shabazz Muhammad,24-122,F-G,3/15/17,MIN,@,BOS,L,0,31,7,14,0.5,7,9,0.778,0,5,0,7,8,0.875,2,1,3
2412,Jameer Nelson,34-292,G,11/27/16,DEN,@,PHO,W,1,28,8,13,0.615,4,6,0.667,4,7,0.571,1,1,1,0,2,2
2413,Jameer Nelson,34-290,G,11/25/16,DEN,,OKC,L,1,41,8,16,0.5,5,9,0.556,3,7,0.429,2,2,1,0,4,4
2414,Jusuf Nurkic,22-208,C,3/19/17,POR,@,MIA,W,1,29,9,15,0.6,9,15,0.6,0,0,,3,8,0.375,6,6,12
2415,Victor Oladipo,24-314,G,3/14/17,OKC,@,BRK,W,1,32,9,16,0.563,6,12,0.5,3,4,0.75,0,0,,2,1,3
2416,Victor Oladipo,24-177,G,10/28/16,OKC,,PHO,W,1,44,7,17,0.412,6,13,0.462,1,4,0.25,6,7,0.857,1,4,5
2417,Victor Oladipo,24-287,G,2/15/17,OKC,,NYK,W,1,37,9,17,0.529,6,11,0.545,3,6,0.5,0,0,,0,4,4
2418,Victor Oladipo,24-183,G,11/3/16,OKC,@,GSW,L,1,30,8,13,0.615,4,7,0.571,4,6,0.667,1,4,0.25,0,3,3
2419,Jabari Parker,21-318,F,1/27/17,MIL,@,TOR,L,1,37,8,17,0.471,8,14,0.571,0,3,0,5,6,0.833,2,11,13
2420,Jabari Parker,21-283,F,12/23/16,MIL,,WAS,W,1,32,9,15,0.6,8,12,0.667,1,3,0.333,2,2,1,4,4,8
2421,Jabari Parker,21-231,F,11/1/16,MIL,@,NOP,W,1,29,7,14,0.5,7,13,0.538,0,1,0,7,7,1,1,1,2
2422,Tony Parker,34-233,G,1/5/17,SAS,@,DEN,W,1,24,10,11,0.909,9,10,0.9,1,1,1,0,0,,0,3,3
2423,Chris Paul,31-192,G,11/14/16,LAC,,BRK,W,1,25,8,11,0.727,4,5,0.8,4,6,0.667,1,1,1,1,3,4
2424,Chris Paul,31-220,G,12/12/16,LAC,,POR,W,1,36,7,14,0.5,4,8,0.5,3,6,0.5,4,4,1,1,4,5
2425,Chris Paul,31-301,G,3/3/17,LAC,@,MIL,L,1,29,7,11,0.636,2,5,0.4,5,6,0.833,2,2,1,0,4,4
2426,Chris Paul,31-236,G,12/28/16,LAC,@,NOP,L,1,31,7,15,0.467,5,8,0.625,2,7,0.286,5,5,1,3,5,8
2427,Elfrid Payton,22-343,G,1/30/17,ORL,@,MIN,L,1,30,9,17,0.529,7,12,0.583,2,5,0.4,1,2,0.5,0,4,4
2428,Otto Porter,23-238,F,1/27/17,WAS,@,ATL,W,1,33,7,11,0.636,2,4,0.5,5,7,0.714,2,3,0.667,0,11,11
2429,Otto Porter,23-167,F,11/17/16,WAS,,NYK,W,1,39,8,14,0.571,4,9,0.444,4,5,0.8,1,1,1,1,7,8
2430,Kristaps Porzingis,21-088,F-C,10/29/16,NYK,,MEM,W,1,36,7,11,0.636,6,7,0.857,1,4,0.25,6,8,0.75,0,5,5
2431,Kristaps Porzingis,21-102,F-C,11/12/16,NYK,@,TOR,L,1,30,9,16,0.563,7,8,0.875,2,8,0.25,1,1,1,1,3,4
2432,Kristaps Porzingis,21-118,F-C,11/28/16,NYK,,OKC,L,1,39,9,20,0.45,6,14,0.429,3,6,0.5,0,0,,1,4,5
2433,Kristaps Porzingis,21-150,F-C,12/30/16,NYK,@,NOP,L,1,38,8,20,0.4,8,18,0.444,0,2,0,5,5,1,3,9,12
2434,Kristaps Porzingis,21-099,F-C,11/9/16,NYK,,BRK,W,1,31,7,15,0.467,3,7,0.429,4,8,0.5,3,5,0.6,1,7,8
2435,Kristaps Porzingis,21-140,F-C,12/20/16,NYK,,IND,W,1,33,7,15,0.467,3,8,0.375,4,7,0.571,3,4,0.75,0,8,8
2436,Norman Powell,23-235,G,1/15/17,TOR,,NYK,W,0,24,7,12,0.583,6,9,0.667,1,3,0.333,6,6,1,1,0,1
2437,Norman Powell,23-245,G,1/25/17,TOR,@,MEM,L,1,33,9,21,0.429,7,17,0.412,2,4,0.5,1,4,0.25,3,2,5
2438,Norman Powell,23-282,G,3/3/17,TOR,@,WAS,W,0,25,7,12,0.583,5,8,0.625,2,4,0.5,5,5,1,1,5,6
2439,Norman Powell,23-209,G,12/20/16,TOR,,BRK,W,0,27,7,13,0.538,6,11,0.545,1,2,0.5,6,7,0.857,0,3,3
2440,Julius Randle,22-008,F,12/7/16,LAL,@,HOU,L,1,29,9,19,0.474,9,18,0.5,0,1,0,3,4,0.75,5,5,10
2441,Julius Randle,22-103,F,3/12/17,LAL,,PHI,L,1,34,8,18,0.444,8,15,0.533,0,3,0,5,6,0.833,2,10,12
2442,Zach Randolph,35-166,F,12/29/16,MEM,,OKC,W,0,25,10,17,0.588,9,14,0.643,1,3,0.333,0,0,,2,6,8
2443,Sergio Rodriguez,30-194,G,12/23/16,PHI,@,PHO,L,1,26,8,12,0.667,4,4,1,4,8,0.5,1,1,1,1,1,2
2444,Derrick Rose,28-039,G,11/12/16,NYK,@,TOR,L,1,38,10,20,0.5,10,17,0.588,0,3,0,1,2,0.5,2,2,4
2445,Derrick Rose,28-088,G,12/31/16,NYK,@,HOU,L,1,41,8,23,0.348,7,20,0.35,1,3,0.333,4,5,0.8,2,3,5
2446,Terrence Ross,25-354,F-G,1/24/17,TOR,,SAS,L,0,30,6,10,0.6,3,3,1,3,7,0.429,6,8,0.75,0,1,1
2447,Ricky Rubio,26-088,G,1/17/17,MIN,@,SAS,L,1,39,4,9,0.444,4,8,0.5,0,1,0,13,14,0.929,0,2,2
2448,D'Angelo Russell,20-358,G,2/15/17,LAL,@,PHO,L,1,28,7,20,0.35,5,14,0.357,2,6,0.333,5,5,1,0,4,4
2449,Dario Saric,22-329,F,3/3/17,PHI,,NYK,W,1,27,7,14,0.5,6,9,0.667,1,5,0.2,6,10,0.6,1,9,10
2450,Dario Saric,22-239,F,12/3/16,PHI,,BOS,L,0,27,7,12,0.583,4,6,0.667,3,6,0.5,4,4,1,3,8,11
2451,Dario Saric,22-207,F,11/1/16,PHI,,ORL,L,1,31,9,14,0.643,6,11,0.545,3,3,1,0,0,,1,2,3
2452,Dario Saric,22-325,F,2/27/17,PHI,,GSW,L,1,35,6,15,0.4,6,9,0.667,0,6,0,9,10,0.9,3,4,7
2453,Dennis Schroder,23-130,G,1/23/17,ATL,,LAC,L,1,34,7,18,0.389,6,14,0.429,1,4,0.25,6,6,1,2,4,6
2454,Dennis Schroder,23-097,G,12/21/16,ATL,,MIN,L,1,37,10,21,0.476,9,14,0.643,1,7,0.143,0,0,,0,1,1
2455,Dennis Schroder,23-144,G,2/6/17,ATL,,UTA,L,1,30,8,15,0.533,8,13,0.615,0,2,0,5,5,1,0,2,2
2456,Dennis Schroder,23-165,G,2/27/17,ATL,@,BOS,W,1,30,9,14,0.643,9,11,0.818,0,3,0,3,3,1,0,4,4
2457,Marcus Smart,22-346,G,2/15/17,BOS,,PHI,W,1,34,7,11,0.636,4,4,1,3,7,0.429,4,7,0.571,0,5,5
2458,Marcus Smart,23-000,G,3/6/17,BOS,@,LAC,L,0,32,6,12,0.5,5,7,0.714,1,5,0.2,8,9,0.889,0,3,3
2459,Tony Snell,25-116,G-F,3/6/17,MIL,@,PHI,W,1,31,8,11,0.727,3,4,0.75,5,7,0.714,0,0,,1,6,7
2460,Nik Stauskas,23-043,G,11/19/16,PHI,,PHO,W,0,26,8,9,0.889,3,3,1,5,6,0.833,0,0,,0,2,2
2461,Lance Stephenson,26-058,G-F,11/2/16,NOP,@,MEM,L,0,45,9,15,0.6,8,12,0.667,1,3,0.333,2,2,1,0,3,3
2462,Rodney Stuckey,30-214,G,11/21/16,IND,,GSW,L,0,24,7,12,0.583,7,9,0.778,0,3,0,7,8,0.875,0,2,2
2463,Jeff Teague,28-188,G,12/15/16,IND,@,NOP,L,1,35,7,18,0.389,7,12,0.583,0,6,0,7,9,0.778,0,6,6
2464,Jeff Teague,28-148,G,11/5/16,IND,,CHI,W,1,29,9,14,0.643,6,9,0.667,3,5,0.6,0,0,,0,1,1
2465,Jeff Teague,28-283,G,3/20/17,IND,,UTA,W,1,37,6,15,0.4,3,11,0.273,3,4,0.75,6,6,1,1,4,5
2466,Jeff Teague,28-161,G,11/18/16,IND,,PHO,L,1,34,6,10,0.6,6,8,0.75,0,2,0,9,12,0.75,0,4,4
2467,Jeff Teague,28-209,G,1/5/17,IND,,BRK,W,1,31,9,13,0.692,7,11,0.636,2,2,1,1,1,1,0,7,7
2468,Isaiah Thomas,27-324,G,12/27/16,BOS,,MEM,W,1,34,6,14,0.429,5,8,0.625,1,6,0.167,8,8,1,0,1,1
2469,Isaiah Thomas,27-355,G,1/27/17,BOS,,ORL,W,1,25,9,15,0.6,6,7,0.857,3,8,0.375,0,0,,0,3,3
2470,Isaiah Thomas,28-031,G,3/10/17,BOS,@,DEN,L,1,34,7,14,0.5,6,8,0.75,1,6,0.167,6,6,1,0,2,2
2471,Lance Thomas,28-313,F,3/3/17,NYK,@,PHI,L,1,42,8,16,0.5,5,11,0.455,3,5,0.6,2,2,1,2,4,6
2472,Klay Thompson,26-349,G,1/22/17,GSW,@,ORL,W,1,34,7,14,0.5,0,5,0,7,9,0.778,0,0,,0,5,5
2473,Klay Thompson,27-038,G,3/18/17,GSW,,MIL,W,1,34,9,16,0.563,6,10,0.6,3,6,0.5,0,1,0,2,1,3
2474,Klay Thompson,26-324,G,12/28/16,GSW,,TOR,W,1,35,8,18,0.444,3,11,0.273,5,7,0.714,0,0,,1,5,6
2475,Klay Thompson,26-360,G,2/2/17,GSW,@,LAC,W,1,33,9,19,0.474,6,13,0.462,3,6,0.5,0,0,,3,4,7
2476,Klay Thompson,27-019,G,2/27/17,GSW,@,PHI,W,1,36,7,17,0.412,4,8,0.5,3,9,0.333,4,4,1,1,2,3
2477,Karl-Anthony Towns,20-359,F-C,11/8/16,MIN,@,BRK,L,1,32,8,15,0.533,7,11,0.636,1,4,0.25,4,4,1,4,3,7
2478,Karl-Anthony Towns,21-106,F-C,3/1/17,MIN,@,UTA,W,1,35,9,16,0.563,7,13,0.538,2,3,0.667,1,1,1,3,12,15
2479,Karl-Anthony Towns,21-000,F-C,11/15/16,MIN,,CHO,L,1,37,9,23,0.391,6,13,0.462,3,10,0.3,0,0,,3,5,8
2480,Karl-Anthony Towns,20-346,F-C,10/26/16,MIN,@,MEM,L,1,36,9,20,0.45,7,15,0.467,2,5,0.4,1,1,1,2,2,4
2481,P.J. Tucker,31-206,F,11/27/16,PHO,,DEN,L,1,42,6,10,0.6,3,5,0.6,3,5,0.6,6,7,0.857,1,7,8
2482,Myles Turner,20-271,F-C,12/20/16,IND,@,NYK,L,1,32,6,14,0.429,4,10,0.4,2,4,0.5,7,8,0.875,1,8,9
2483,Jonas Valanciunas,24-276,C,2/6/17,TOR,,LAC,W,1,32,9,13,0.692,9,13,0.692,0,0,,3,4,0.75,3,9,12
2484,Nikola Vucevic,26-108,C,2/9/17,ORL,,PHI,L,1,31,10,13,0.769,10,13,0.769,0,0,,1,3,0.333,1,10,11
2485,Nikola Vucevic,26-053,C,12/16/16,ORL,,BRK,W,0,31,9,19,0.474,9,17,0.529,0,2,0,3,5,0.6,4,6,10
2486,Nikola Vucevic,26-065,C,12/28/16,ORL,,CHO,L,0,27,10,13,0.769,10,13,0.769,0,0,,1,2,0.5,0,5,5
2487,Nikola Vucevic,26-030,C,11/23/16,ORL,,PHO,L,1,29,10,15,0.667,10,15,0.667,0,0,,1,2,0.5,3,11,14
2488,Dwyane Wade,35-007,G,1/24/17,CHI,@,ORL,W,1,34,9,23,0.391,8,22,0.364,1,1,1,2,2,1,2,5,7
2489,Dwyane Wade,35-052,G,3/10/17,CHI,,HOU,L,1,25,9,18,0.5,8,12,0.667,1,6,0.167,2,2,1,2,1,3
2490,Dwyane Wade,34-344,G,12/26/16,CHI,,IND,W,1,33,8,19,0.421,8,15,0.533,0,4,0,5,5,1,1,2,3
2491,Dion Waiters,25-056,G,2/4/17,MIA,,PHI,W,1,26,7,10,0.7,2,4,0.5,5,6,0.833,2,2,1,0,1,1
2492,Kemba Walker,26-260,G,1/23/17,CHO,,WAS,L,1,36,7,24,0.292,5,14,0.357,2,10,0.2,5,7,0.714,0,2,2
2493,Kemba Walker,26-194,G,11/18/16,CHO,,ATL,W,1,34,8,20,0.4,6,13,0.462,2,7,0.286,3,6,0.5,0,5,5
2494,Kemba Walker,26-309,G,3/13/17,CHO,,CHI,L,1,38,9,24,0.375,6,12,0.5,3,12,0.25,0,0,,0,4,4
2495,Kemba Walker,26-189,G,11/13/16,CHO,@,CLE,L,1,32,8,20,0.4,4,12,0.333,4,8,0.5,1,1,1,0,2,2
2496,Kemba Walker,26-204,G,11/28/16,CHO,@,MEM,W,1,34,7,14,0.5,2,6,0.333,5,8,0.625,2,2,1,0,3,3
2497,Kemba Walker,26-234,G,12/28/16,CHO,@,ORL,W,1,25,8,12,0.667,6,6,1,2,6,0.333,3,3,1,0,3,3
2498,Kemba Walker,26-185,G,11/9/16,CHO,,UTA,W,1,34,7,20,0.35,6,13,0.462,1,7,0.143,6,6,1,0,5,5
2499,John Wall,26-081,G,11/26/16,WAS,,SAS,L,1,37,8,16,0.5,8,15,0.533,0,1,0,5,7,0.714,0,3,3
2500,John Wall,26-062,G,11/7/16,WAS,,HOU,L,1,35,9,16,0.563,8,14,0.571,1,2,0.5,2,2,1,1,4,5
2501,John Wall,26-059,G,11/4/16,WAS,,ATL,W,1,33,7,17,0.412,6,15,0.4,1,2,0.5,6,8,0.75,3,7,10
2502,T.J. Warren,23-151,F,2/3/17,PHO,@,SAC,W,1,36,7,13,0.538,6,10,0.6,1,3,0.333,6,6,1,2,3,5
2503,T.J. Warren,23-143,F,1/26/17,PHO,@,DEN,L,1,41,9,16,0.563,8,14,0.571,1,2,0.5,2,2,1,1,7,8
2504,Russell Westbrook,28-058,G,1/9/17,OKC,@,CHI,W,1,33,9,18,0.5,8,11,0.727,1,7,0.143,2,3,0.667,0,9,9
2505,Russell Westbrook,28-047,G,12/29/16,OKC,@,MEM,L,1,23,6,19,0.316,4,13,0.308,2,6,0.333,7,10,0.7,2,3,5
2506,Russell Westbrook,28-062,G,1/13/17,OKC,@,MIN,L,1,36,7,23,0.304,6,13,0.462,1,10,0.1,6,7,0.857,3,8,11
2507,Hassan Whiteside,27-144,C,11/4/16,MIA,@,TOR,L,1,38,10,18,0.556,10,18,0.556,0,0,,1,3,0.333,5,11,16
2508,Andrew Wiggins,21-307,F-G,12/26/16,MIN,,ATL,W,1,28,7,14,0.5,3,8,0.375,4,6,0.667,3,4,0.75,1,3,4
2509,Andrew Wiggins,21-338,F-G,1/26/17,MIN,,IND,L,1,39,7,17,0.412,6,13,0.462,1,4,0.25,6,7,0.857,1,4,5
2510,Andrew Wiggins,22-020,F-G,3/15/17,MIN,@,BOS,L,1,39,9,23,0.391,7,19,0.368,2,4,0.5,1,4,0.25,1,3,4
2511,Andrew Wiggins,21-346,F-G,2/3/17,MIN,@,DET,L,1,40,8,20,0.4,8,17,0.471,0,3,0,5,5,1,1,2,3
2512,Deron Williams,32-191,G,1/3/17,DAL,,WAS,W,1,32,7,13,0.538,3,6,0.5,4,7,0.571,3,3,1,0,1,1
2513,Lou Williams,30-099,G,2/3/17,LAL,@,BOS,L,0,23,5,14,0.357,2,5,0.4,3,9,0.333,8,10,0.8,0,4,4
2514,Lou Williams,30-096,G,1/31/17,LAL,,DEN,W,0,24,7,11,0.636,3,6,0.5,4,5,0.8,3,3,1,1,4,5
2515,Lou Williams,30-111,G,2/15/17,LAL,@,PHO,L,0,24,7,13,0.538,4,9,0.444,3,4,0.75,4,5,0.8,1,1,2
2516,Lou Williams,30-016,G,11/12/16,LAL,@,NOP,W,0,25,9,15,0.6,7,10,0.7,2,5,0.4,1,1,1,0,3,3
2517,Lou Williams,30-031,G,11/27/16,LAL,,ATL,W,0,27,5,13,0.385,3,7,0.429,2,6,0.333,9,9,1,0,4,4
2518,Lou Williams,30-014,G,11/10/16,LAL,@,SAC,W,0,23,6,12,0.5,3,6,0.5,3,6,0.5,6,8,0.75,0,2,2
2519,Lou Williams,30-106,G,2/10/17,LAL,@,MIL,W,0,19,5,9,0.556,2,4,0.5,3,5,0.6,8,9,0.889,0,1,1
2520,Marvin Williams,30-211,F,1/16/17,CHO,@,BOS,L,1,29,8,14,0.571,5,8,0.625,3,6,0.5,2,2,1,0,5,5
2521,Thaddeus Young,28-182,F,12/20/16,IND,@,NYK,L,1,37,9,17,0.529,7,12,0.583,2,5,0.4,1,2,0.5,2,5,7
2522,Steven Adams,23-125,C,11/22/16,OKC,@,LAL,L,1,31,9,13,0.692,9,13,0.692,0,0,,2,2,1,4,2,6
2523,Steven Adams,23-189,C,1/25/17,OKC,@,NOP,W,1,32,9,16,0.563,9,15,0.6,0,1,0,2,4,0.5,5,6,11
2524,Steven Adams,23-204,C,2/9/17,OKC,,CLE,W,1,39,9,14,0.643,9,14,0.643,0,0,,2,3,0.667,9,4,13
2525,Steven Adams,23-166,C,1/2/17,OKC,@,MIL,L,1,34,9,11,0.818,9,11,0.818,0,0,,2,2,1,3,5,8
2526,Ryan Anderson,28-187,F,11/9/16,HOU,@,SAS,W,1,36,5,11,0.455,1,5,0.2,4,6,0.667,6,7,0.857,1,8,9
2527,Giannis Antetokounmpo,22-067,F-G,2/11/17,MIL,@,IND,W,1,34,4,9,0.444,4,8,0.5,0,1,0,12,14,0.857,2,6,8
2528,Carmelo Anthony,32-270,F,2/23/17,NYK,@,CLE,L,1,40,9,25,0.36,7,17,0.412,2,8,0.25,0,0,,1,4,5
2529,Carmelo Anthony,32-189,F,12/4/16,NYK,,SAC,W,1,36,8,20,0.4,5,12,0.417,3,8,0.375,1,2,0.5,0,4,4
2530,Carmelo Anthony,32-153,F,10/29/16,NYK,,MEM,W,1,36,5,15,0.333,4,10,0.4,1,5,0.2,9,12,0.75,0,6,6
2531,Trevor Ariza,31-258,F,3/15/17,HOU,,LAL,W,1,28,7,9,0.778,3,3,1,4,6,0.667,2,3,0.667,1,2,3
2532,Trevor Ariza,31-169,F,12/16/16,HOU,,NOP,W,1,30,7,18,0.389,2,4,0.5,5,14,0.357,1,2,0.5,0,5,5
2533,Trevor Ariza,31-222,F,2/7/17,HOU,,ORL,W,1,36,7,15,0.467,3,6,0.5,4,9,0.444,2,3,0.667,3,4,7
2534,J.J. Barea,32-266,G,3/19/17,DAL,@,BRK,W,0,27,8,12,0.667,7,8,0.875,1,4,0.25,3,5,0.6,0,1,1
2535,Harrison Barnes,24-270,F,2/24/17,DAL,@,MIN,L,1,37,9,17,0.529,8,13,0.615,1,4,0.25,1,2,0.5,3,3,6
2536,Harrison Barnes,24-168,F,11/14/16,DAL,@,NYK,L,1,35,8,17,0.471,8,15,0.533,0,2,0,4,6,0.667,0,3,3
2537,Harrison Barnes,24-232,F,1/17/17,DAL,@,CHI,W,1,38,8,17,0.471,6,14,0.429,2,3,0.667,2,2,1,1,3,4
2538,Harrison Barnes,24-194,F,12/10/16,DAL,@,HOU,L,1,32,7,13,0.538,6,12,0.5,1,1,1,5,5,1,2,2,4
2539,Harrison Barnes,24-175,F,11/21/16,DAL,@,SAS,L,1,42,9,18,0.5,9,16,0.563,0,2,0,2,4,0.5,4,5,9
2540,Matt Barnes,36-297,F,12/31/16,SAC,,MEM,L,1,33,5,8,0.625,0,1,0,5,7,0.714,5,7,0.714,1,7,8
2541,Will Barton,25-332,G,12/3/16,DEN,@,UTA,L,1,34,8,15,0.533,5,11,0.455,3,4,0.75,1,2,0.5,0,5,5
2542,Nicolas Batum,28-000,F-G,12/14/16,CHO,@,WAS,L,1,37,7,14,0.5,4,6,0.667,3,8,0.375,3,3,1,0,5,5
2543,Nicolas Batum,28-014,F-G,12/28/16,CHO,@,ORL,W,1,30,8,12,0.667,5,8,0.625,3,4,0.75,1,1,1,0,9,9
2544,Nicolas Batum,28-009,F-G,12/23/16,CHO,,CHI,W,1,40,7,15,0.467,6,10,0.6,1,5,0.2,5,6,0.833,2,9,11
2545,Nicolas Batum,27-324,F-G,11/2/16,CHO,,PHI,W,1,34,7,15,0.467,3,6,0.5,4,9,0.444,2,2,1,2,5,7
2546,Aron Baynes,29-341,C,11/14/16,DET,,OKC,W,1,34,8,13,0.615,8,13,0.615,0,0,,4,4,1,1,7,8
2547,Kent Bazemore,27-127,G-F,11/5/16,ATL,,HOU,W,1,32,7,12,0.583,4,8,0.5,3,4,0.75,3,3,1,0,4,4
2548,Bradley Beal,23-132,G,11/7/16,WAS,,HOU,L,1,34,8,18,0.444,6,12,0.5,2,6,0.333,2,2,1,1,1,2
2549,Bradley Beal,23-258,G,3/13/17,WAS,@,MIN,L,1,38,7,21,0.333,4,10,0.4,3,11,0.273,3,3,1,2,5,7
2550,Bradley Beal,23-169,G,12/14/16,WAS,,CHO,W,1,37,6,16,0.375,3,9,0.333,3,7,0.429,5,6,0.833,0,4,4
2551,Bradley Beal,23-200,G,1/14/17,WAS,,PHI,W,1,27,8,15,0.533,6,12,0.5,2,3,0.667,2,2,1,0,4,4
2552,Bradley Beal,23-165,G,12/10/16,WAS,,MIL,W,1,37,6,15,0.4,5,11,0.455,1,4,0.25,7,8,0.875,0,0,0
2553,Bradley Beal,23-227,G,2/10/17,WAS,,IND,W,1,35,6,15,0.4,3,5,0.6,3,10,0.3,5,8,0.625,1,2,3
2554,Eric Bledsoe,26-329,G,11/2/16,PHO,,POR,W,1,40,7,20,0.35,6,16,0.375,1,4,0.25,5,5,1,3,4,7
2555,Eric Bledsoe,27-081,G,2/28/17,PHO,@,MEM,L,1,31,7,17,0.412,5,12,0.417,2,5,0.4,4,6,0.667,0,4,4
2556,Eric Bledsoe,26-340,G,11/13/16,PHO,@,GSW,L,1,28,6,13,0.462,5,9,0.556,1,4,0.25,7,7,1,1,2,3
2557,Eric Bledsoe,27-056,G,2/3/17,PHO,@,SAC,W,1,34,4,12,0.333,1,6,0.167,3,6,0.5,9,12,0.75,2,4,6
2558,Bojan Bogdanovic,27-236,G-F,12/10/16,BRK,@,SAS,L,1,27,7,13,0.538,5,9,0.556,2,4,0.5,4,5,0.8,0,4,4
2559,Devin Booker,20-062,G,12/31/16,PHO,@,UTA,L,1,36,9,19,0.474,8,16,0.5,1,3,0.333,1,1,1,0,3,3
2560,Devin Booker,20-094,G,2/1/17,PHO,,LAC,L,1,35,7,19,0.368,6,16,0.375,1,3,0.333,5,5,1,2,2,4
2561,Devin Booker,20-101,G,2/8/17,PHO,@,MEM,L,1,32,6,13,0.462,6,10,0.6,0,3,0,8,10,0.8,0,1,1
2562,Devin Booker,20-084,G,1/22/17,PHO,@,TOR,W,1,37,6,14,0.429,1,6,0.167,5,8,0.625,3,4,0.75,0,4,4
2563,Avery Bradley,26-007,G,12/3/16,BOS,@,PHI,W,1,32,9,16,0.563,8,10,0.8,1,6,0.167,1,2,0.5,2,7,9
2564,Avery Bradley,26-022,G,12/18/16,BOS,@,MIA,W,1,34,9,16,0.563,7,12,0.583,2,4,0.5,0,0,,1,4,5
2565,Avery Bradley,26-114,G,3/20/17,BOS,,WAS,W,1,34,8,16,0.5,4,8,0.5,4,8,0.5,0,0,,3,6,9
2566,Malcolm Brogdon,24-078,G,2/27/17,MIL,@,CLE,L,0,31,8,15,0.533,5,8,0.625,3,7,0.429,1,3,0.333,0,3,3
2567,Jaylen Brown,20-095,F,1/27/17,BOS,,ORL,W,1,30,6,13,0.462,4,8,0.5,2,5,0.4,6,8,0.75,1,7,8
2568,Jimmy Butler,27-064,G-F,11/17/16,CHI,@,UTA,W,1,41,7,19,0.368,5,15,0.333,2,4,0.5,4,6,0.667,2,10,12
2569,Jimmy Butler,27-098,G-F,12/21/16,CHI,,WAS,L,1,39,6,20,0.3,6,16,0.375,0,4,0,8,9,0.889,5,6,11
2570,Jimmy Butler,27-112,G-F,1/4/17,CHI,@,CLE,W,1,38,7,20,0.35,4,12,0.333,3,8,0.375,3,4,0.75,3,3,6
2571,Jimmy Butler,27-132,G-F,1/24/17,CHI,@,ORL,W,1,39,7,14,0.5,7,11,0.636,0,3,0,6,7,0.857,2,6,8
2572,Jimmy Butler,27-149,G-F,2/10/17,CHI,@,PHO,L,1,30,6,16,0.375,6,13,0.462,0,3,0,8,9,0.889,2,1,3
2573,Jimmy Butler,27-057,G-F,11/10/16,CHI,@,MIA,W,1,38,5,11,0.455,4,9,0.444,1,2,0.5,9,10,0.9,1,3,4
2574,Jimmy Butler,27-054,G-F,11/7/16,CHI,,ORL,W,1,31,5,13,0.385,5,11,0.455,0,2,0,10,10,1,2,3,5
2575,Kentavious Caldwell-Pope,23-303,G,12/17/16,DET,,IND,L,1,36,6,18,0.333,1,8,0.125,5,10,0.5,3,3,1,2,3,5
2576,Clint Capela,22-185,F-C,11/19/16,HOU,,UTA,W,1,31,10,19,0.526,10,19,0.526,0,0,,0,2,0,3,5,8
2577,DeMarre Carroll,30-119,F,11/23/16,TOR,@,HOU,W,1,27,9,14,0.643,7,9,0.778,2,5,0.4,0,0,,2,1,3
2578,DeMarre Carroll,30-172,F,1/15/17,TOR,,NYK,W,1,27,7,13,0.538,6,7,0.857,1,6,0.167,5,5,1,1,1,2
2579,Vince Carter,39-293,G-F,11/14/16,MEM,@,UTA,W,0,31,6,11,0.545,3,6,0.5,3,5,0.6,5,6,0.833,1,6,7
2580,Vince Carter,39-287,G-F,11/8/16,MEM,,DEN,W,0,31,8,13,0.615,5,6,0.833,3,7,0.429,1,2,0.5,0,3,3
2581,Willie Cauley-Stein,23-204,F-C,3/10/17,SAC,,WAS,L,1,42,7,12,0.583,7,12,0.583,0,0,,6,8,0.75,2,11,13
2582,Wilson Chandler,29-207,F,12/3/16,DEN,@,UTA,L,0,41,7,14,0.5,4,8,0.5,3,6,0.5,3,3,1,0,5,5
2583,Wilson Chandler,29-294,F,2/28/17,DEN,@,CHI,W,1,29,6,13,0.462,5,8,0.625,1,5,0.2,7,8,0.875,1,2,3
2584,Marquese Chriss,19-212,F,1/30/17,PHO,,MEM,L,1,34,8,12,0.667,6,8,0.75,2,4,0.5,2,4,0.5,3,3,6
2585,Jordan Clarkson,24-164,G,11/18/16,LAL,,SAS,L,0,31,7,15,0.467,4,11,0.364,3,4,0.75,3,4,0.75,1,2,3
2586,Jordan Clarkson,24-240,G,2/2/17,LAL,@,WAS,L,0,29,9,13,0.692,7,7,1,2,6,0.333,0,0,,0,2,2
2587,Jordan Clarkson,24-171,G,11/25/16,LAL,,GSW,L,1,38,6,15,0.4,2,6,0.333,4,9,0.444,4,5,0.8,0,2,2
2588,Jordan Clarkson,24-269,G,3/3/17,LAL,,BOS,L,0,30,7,19,0.368,6,11,0.545,1,8,0.125,5,5,1,0,4,4
2589,Jordan Clarkson,24-193,G,12/17/16,LAL,@,CLE,L,0,31,7,12,0.583,3,5,0.6,4,7,0.571,2,2,1,2,3,5
2590,Darren Collison,29-111,G,12/12/16,SAC,,LAL,W,1,32,7,11,0.636,3,4,0.75,4,7,0.571,2,6,0.333,0,0,0
2591,Darren Collison,29-173,G,2/12/17,SAC,,NOP,W,1,41,7,16,0.438,5,12,0.417,2,4,0.5,4,5,0.8,0,6,6
2592,Darren Collison,29-136,G,1/6/17,SAC,,LAC,L,1,35,7,13,0.538,4,7,0.571,3,6,0.5,3,3,1,1,4,5
2593,Darren Collison,29-080,G,11/11/16,SAC,@,POR,L,0,38,9,16,0.563,9,14,0.643,0,2,0,2,2,1,0,5,5
2594,Mike Conley,29-122,G,2/10/17,MEM,,GSW,L,1,33,6,16,0.375,2,10,0.2,4,6,0.667,4,4,1,2,3,5
2595,Mike Conley,29-022,G,11/2/16,MEM,,NOP,W,1,38,6,14,0.429,4,9,0.444,2,5,0.4,6,6,1,0,1,1
2596,Mike Conley,29-116,G,2/4/17,MEM,@,MIN,W,1,36,5,16,0.313,5,11,0.455,0,5,0,10,12,0.833,0,2,2
2597,Mike Conley,29-099,G,1/18/17,MEM,@,WAS,L,1,31,5,13,0.385,3,8,0.375,2,5,0.4,8,9,0.889,1,2,3
2598,Mike Conley,29-153,G,3/13/17,MEM,,MIL,W,1,36,7,14,0.5,4,5,0.8,3,9,0.333,3,4,0.75,0,1,1
2599,Robert Covington,26-073,F,2/25/17,PHI,@,NYK,L,1,39,7,19,0.368,5,8,0.625,2,11,0.182,4,4,1,0,10,10
2600,Robert Covington,25-350,F,11/28/16,PHI,@,TOR,L,1,32,7,11,0.636,1,2,0.5,6,9,0.667,0,0,,2,3,5
2601,Jamal Crawford,36-325,G,2/8/17,LAC,@,NYK,W,0,30,7,12,0.583,4,8,0.5,3,4,0.75,3,3,1,2,1,3
2602,Jae Crowder,26-189,F,1/11/17,BOS,,WAS,W,1,34,7,10,0.7,3,4,0.75,4,6,0.667,2,2,1,0,6,6
2603,Jae Crowder,26-206,F,1/28/17,BOS,@,MIL,W,1,38,5,13,0.385,1,3,0.333,4,10,0.4,6,6,1,1,5,6
2604,Seth Curry,26-155,G,1/25/17,DAL,,NYK,W,1,34,8,19,0.421,6,13,0.462,2,6,0.333,2,2,1,0,5,5
2605,Stephen Curry,28-308,G,1/16/17,GSW,,CLE,W,1,31,7,20,0.35,2,8,0.25,5,12,0.417,1,2,0.5,0,2,2
2606,Stephen Curry,28-250,G,11/19/16,GSW,@,MIL,W,1,35,7,21,0.333,6,10,0.6,1,11,0.091,5,5,1,0,5,5
2607,Troy Daniels,25-152,G,12/14/16,MEM,,CLE,W,0,22,7,13,0.538,3,5,0.6,4,8,0.5,2,2,1,1,1,2
2608,Anthony Davis,23-360,F-C,3/6/17,NOP,@,UTA,L,1,37,7,17,0.412,6,14,0.429,1,3,0.333,5,6,0.833,5,7,12
2609,Anthony Davis,23-300,F-C,1/5/17,NOP,,ATL,L,1,37,7,20,0.35,7,20,0.35,0,0,,6,8,0.75,7,11,18
2610,Anthony Davis,23-297,F-C,1/2/17,NOP,@,CLE,L,1,40,10,27,0.37,10,26,0.385,0,1,0,0,2,0,6,10,16
2611,Anthony Davis,23-292,F-C,12/28/16,NOP,,LAC,W,1,37,8,16,0.5,8,14,0.571,0,2,0,4,8,0.5,1,4,5
2612,DeMar DeRozan,27-141,G,12/26/16,TOR,@,POR,W,1,37,8,22,0.364,8,21,0.381,0,1,0,4,7,0.571,5,5,10
2613,Gorgui Dieng,26-308,C,11/21/16,MIN,,BOS,L,1,40,10,16,0.625,10,16,0.625,0,0,,0,2,0,6,4,10
2614,Gorgui Dieng,26-345,C,12/28/16,MIN,@,DEN,L,1,39,9,11,0.818,9,11,0.818,0,0,,2,2,1,2,6,8
2615,Goran Dragic,30-269,G,1/30/17,MIA,,BRK,W,1,33,6,13,0.462,5,11,0.455,1,2,0.5,7,11,0.636,1,2,3
2616,Andre Drummond,23-093,C,11/11/16,DET,@,SAS,L,1,33,8,10,0.8,7,9,0.778,1,1,1,3,3,1,6,11,17
2617,Andre Drummond,23-211,C,3/9/17,DET,,CLE,W,1,36,10,14,0.714,10,14,0.714,0,0,,0,1,0,7,9,16
2618,Andre Drummond,23-101,C,11/19/16,DET,,BOS,L,1,31,9,16,0.563,9,16,0.563,0,0,,2,6,0.333,3,14,17
2619,Andre Drummond,23-146,C,1/3/17,DET,,IND,L,1,35,9,16,0.563,9,16,0.563,0,0,,2,2,1,7,7,14
2620,Andre Drummond,23-081,C,10/30/16,DET,,MIL,W,1,37,8,16,0.5,8,16,0.5,0,0,,4,8,0.5,8,15,23
2621,Andre Drummond,23-112,C,11/30/16,DET,@,BOS,W,1,35,8,13,0.615,8,13,0.615,0,0,,4,7,0.571,8,9,17
2622,Mike Dunleavy,36-122,F-G,1/15/17,ATL,,MIL,W,0,23,6,10,0.6,2,5,0.4,4,5,0.8,4,5,0.8,1,2,3
2623,Kevin Durant,28-067,F-G,12/5/16,GSW,,IND,W,1,22,9,14,0.643,9,12,0.75,0,2,0,2,3,0.667,1,7,8
2624,Kevin Durant,28-033,F-G,11/1/16,GSW,@,POR,W,1,31,9,15,0.6,9,12,0.75,0,3,0,2,3,0.667,1,4,5
2625,Kevin Durant,28-065,F-G,12/3/16,GSW,,PHO,W,1,32,5,7,0.714,4,6,0.667,1,1,1,9,9,1,0,4,4
2626,Joel Embiid,22-224,C-F,10/26/16,PHI,,OKC,L,1,22,6,16,0.375,5,13,0.385,1,3,0.333,7,8,0.875,0,7,7
2627,Joel Embiid,22-298,C-F,1/8/17,PHI,@,BRK,W,1,24,8,14,0.571,8,11,0.727,0,3,0,4,5,0.8,1,4,5
2628,Kenneth Faried,27-059,F,1/17/17,DEN,@,LAL,W,1,30,9,10,0.9,9,10,0.9,0,0,,2,4,0.5,1,6,7
2629,Kenneth Faried,26-363,F,11/16/16,DEN,,PHO,W,1,26,8,12,0.667,8,12,0.667,0,0,,4,5,0.8,6,9,15
2630,Kenneth Faried,27-058,F,1/16/17,DEN,,ORL,W,1,33,10,12,0.833,10,11,0.909,0,1,0,0,0,,1,4,5
2631,Derrick Favors,25-206,F-C,2/6/17,UTA,@,ATL,W,1,26,10,12,0.833,10,11,0.909,0,1,0,0,0,,3,7,10
2632,Yogi Ferrell,23-280,G,2/13/17,DAL,,BOS,L,0,33,8,11,0.727,6,7,0.857,2,4,0.5,2,2,1,0,2,2
2633,Evan Fournier,23-363,G-F,10/26/16,ORL,,MIA,L,1,39,7,19,0.368,5,13,0.385,2,6,0.333,4,7,0.571,1,3,4
2634,Evan Fournier,24-097,G-F,2/3/17,ORL,,TOR,W,1,36,5,12,0.417,3,8,0.375,2,4,0.5,8,10,0.8,3,7,10
2635,Evan Fournier,24-117,G-F,2/23/17,ORL,,POR,L,1,38,7,17,0.412,6,13,0.462,1,4,0.25,5,8,0.625,2,3,5
2636,Evan Fournier,24-130,G-F,3/8/17,ORL,,CHI,W,1,34,7,17,0.412,4,12,0.333,3,5,0.6,3,4,0.75,3,6,9
2637,Tim Frazier,26-039,G,12/10/16,NOP,@,LAC,L,1,35,6,13,0.462,5,11,0.455,1,2,0.5,7,8,0.875,0,1,1
2638,Tim Frazier,26-000,G,11/1/16,NOP,,MIL,L,1,37,7,12,0.583,6,9,0.667,1,3,0.333,5,6,0.833,1,2,3
2639,Channing Frye,33-180,C-F,11/13/16,CLE,,CHO,W,0,25,7,15,0.467,1,3,0.333,6,12,0.5,0,0,,0,3,3
2640,Danilo Gallinari,28-200,F,2/24/17,DEN,,BRK,W,1,25,8,13,0.615,5,7,0.714,3,6,0.5,1,2,0.5,1,7,8
2641,Danilo Gallinari,28-214,F,3/10/17,DEN,,BOS,W,1,34,6,12,0.5,3,7,0.429,3,5,0.6,5,5,1,2,3,5
2642,Langston Galloway,25-029,G,1/7/17,NOP,@,BOS,L,0,22,6,13,0.462,2,4,0.5,4,9,0.444,4,5,0.8,0,4,4
2643,Langston Galloway,25-004,G,12/13/16,NOP,,GSW,L,0,28,6,14,0.429,1,2,0.5,5,12,0.417,3,3,1,1,5,6
2644,Marc Gasol,32-039,C,3/9/17,MEM,,LAC,L,1,33,8,16,0.5,7,12,0.583,1,4,0.25,3,3,1,0,5,5
2645,Marc Gasol,31-275,C,10/30/16,MEM,,WAS,W,1,29,6,14,0.429,2,8,0.25,4,6,0.667,4,6,0.667,1,9,10
2646,Marc Gasol,31-322,C,12/16/16,MEM,,SAC,L,1,36,6,18,0.333,6,14,0.429,0,4,0,8,8,1,0,5,5
2647,Marc Gasol,31-274,C,10/29/16,MEM,@,NYK,L,1,31,5,15,0.333,4,11,0.364,1,4,0.25,9,9,1,2,4,6
2648,Pau Gasol,36-116,F-C,10/30/16,SAS,@,MIA,W,1,31,9,18,0.5,8,16,0.5,1,2,0.5,1,2,0.5,3,8,11
2649,Rudy Gay,30-115,F,12/10/16,SAC,@,UTA,L,1,33,7,15,0.467,4,11,0.364,3,4,0.75,3,4,0.75,0,5,5
2650,Paul George,26-180,F,10/29/16,IND,@,CHI,L,1,24,8,12,0.667,4,7,0.571,4,5,0.8,0,0,,0,1,1
2651,Taj Gibson,31-224,F,2/3/17,CHI,@,HOU,L,1,36,9,13,0.692,9,12,0.75,0,1,0,2,3,0.667,3,3,6
2652,Rudy Gobert,24-165,C,12/8/16,UTA,,GSW,L,1,35,8,8,1,8,8,1,0,0,,4,7,0.571,2,15,17
2653,Rudy Gobert,24-263,C,3/16/17,UTA,@,CLE,L,1,37,10,13,0.769,10,13,0.769,0,0,,0,1,0,5,14,19
2654,Aaron Gordon,21-077,F,12/2/16,ORL,@,PHI,W,1,25,9,14,0.643,7,10,0.7,2,4,0.5,0,0,,0,2,2
2655,Aaron Gordon,21-175,F,3/10/17,ORL,@,CHO,L,1,28,8,14,0.571,8,13,0.615,0,1,0,4,5,0.8,0,5,5
2656,Eric Gordon,27-330,G,11/19/16,HOU,,UTA,W,0,37,7,16,0.438,3,8,0.375,4,8,0.5,2,2,1,2,5,7
2657,Eric Gordon,27-358,G,12/17/16,HOU,@,MIN,W,0,36,7,15,0.467,3,5,0.6,4,10,0.4,2,2,1,1,5,6
2658,Draymond Green,27-010,F,3/14/17,GSW,,PHI,W,1,38,4,13,0.308,3,9,0.333,1,4,0.25,11,14,0.786,3,6,9
2659,Draymond Green,26-272,F,12/1/16,GSW,,HOU,L,1,47,9,15,0.6,9,13,0.692,0,2,0,2,5,0.4,5,10,15
2660,JaMychal Green,26-256,F,3/4/17,MEM,@,HOU,L,1,29,9,11,0.818,9,10,0.9,0,1,0,2,2,1,5,5,10
2661,JaMychal Green,26-263,F,3/11/17,MEM,,ATL,L,1,26,8,12,0.667,7,11,0.636,1,1,1,3,3,1,7,4,11
2662,Jeff Green,30-100,F,12/6/16,ORL,@,WAS,W,0,25,6,9,0.667,5,7,0.714,1,2,0.5,7,8,0.875,0,3,3
2663,Blake Griffin,27-243,F,11/14/16,LAC,,BRK,W,1,26,9,15,0.6,9,14,0.643,0,1,0,2,3,0.667,1,5,6
2664,Blake Griffin,27-241,F,11/12/16,LAC,@,MIN,W,1,37,7,17,0.412,7,17,0.412,0,0,,6,8,0.75,1,10,11
2665,Blake Griffin,27-332,F,2/11/17,LAC,@,CHO,W,1,35,8,19,0.421,8,17,0.471,0,2,0,4,5,0.8,4,8,12
2666,Blake Griffin,27-275,F,12/16/16,LAC,@,MIA,W,1,38,9,15,0.6,9,15,0.6,0,0,,2,2,1,2,6,8
2667,Blake Griffin,27-318,F,1/28/17,LAC,@,GSW,L,1,23,9,14,0.643,9,13,0.692,0,1,0,2,3,0.667,2,2,4
2668,Tim Hardaway,24-241,G,11/12/16,ATL,,PHI,W,0,18,7,13,0.538,2,3,0.667,5,10,0.5,1,2,0.5,0,3,3
2669,Tim Hardaway,24-359,G,3/10/17,ATL,,TOR,W,1,34,8,13,0.615,5,8,0.625,3,5,0.6,1,1,1,1,1,2
2670,Tim Hardaway,24-306,G,1/16/17,ATL,@,NYK,W,1,35,9,16,0.563,7,9,0.778,2,7,0.286,0,0,,1,2,3
2671,James Harden,27-098,G,12/2/16,HOU,@,DEN,W,1,33,6,16,0.375,5,11,0.455,1,5,0.2,7,8,0.875,1,6,7
2672,Maurice Harkless,23-181,F-G,11/8/16,POR,,PHO,W,1,33,8,11,0.727,6,6,1,2,5,0.4,2,2,1,1,5,6
2673,Gary Harris,22-183,G,3/16/17,DEN,,LAC,W,1,41,6,9,0.667,3,4,0.75,3,5,0.6,5,5,1,0,2,2
2674,Gary Harris,22-145,G,2/6/17,DEN,,DAL,W,1,37,5,12,0.417,1,7,0.143,4,5,0.8,6,6,1,2,3,5
2675,Tobias Harris,24-232,F,3/4/17,DET,@,PHI,W,0,32,8,16,0.5,6,12,0.5,2,4,0.5,2,2,1,0,9,9
2676,Gordon Hayward,26-281,F-G,12/29/16,UTA,,PHI,W,1,32,6,14,0.429,3,8,0.375,3,6,0.5,5,5,1,0,4,4
2677,Gordon Hayward,26-296,F-G,1/13/17,UTA,,DET,W,1,26,8,12,0.667,5,5,1,3,7,0.429,1,2,0.5,0,4,4
2678,Gordon Hayward,26-229,F-G,11/7/16,UTA,@,PHI,W,1,30,9,17,0.529,9,15,0.6,0,2,0,2,2,1,1,6,7
2679,Gordon Hayward,26-233,F-G,11/11/16,UTA,@,ORL,W,1,39,6,17,0.353,4,9,0.444,2,8,0.25,6,6,1,2,8,10
2680,Gerald Henderson,29-047,G,1/25/17,PHI,@,MIL,W,0,24,7,11,0.636,5,7,0.714,2,4,0.5,4,4,1,0,2,2
2681,Gerald Henderson,29-077,G,2/24/17,PHI,,WAS,W,1,31,5,14,0.357,2,6,0.333,3,8,0.375,7,8,0.875,0,5,5
2682,John Henson,25-335,C-F,11/27/16,MIL,@,ORL,W,1,29,8,13,0.615,8,13,0.615,0,0,,4,6,0.667,2,5,7
2683,John Henson,25-341,C-F,12/3/16,MIL,,BRK,W,1,27,7,11,0.636,7,11,0.636,0,0,,6,7,0.857,1,6,7
2684,Buddy Hield,23-016,G,1/2/17,NOP,@,CLE,L,1,35,6,13,0.462,2,7,0.286,4,6,0.667,4,4,1,0,5,5
2685,Jrue Holiday,26-266,G,3/5/17,NOP,@,LAL,W,1,36,7,12,0.583,6,9,0.667,1,3,0.333,5,6,0.833,0,5,5
2686,Rondae Hollis-Jefferson,21-314,F,11/12/16,BRK,@,PHO,W,1,30,5,12,0.417,5,12,0.417,0,0,,10,11,0.909,0,13,13
2687,Rondae Hollis-Jefferson,22-072,F,3/16/17,BRK,@,NYK,W,1,25,7,11,0.636,7,10,0.7,0,1,0,6,6,1,5,5,10
2688,Rodney Hood,24-070,G-F,12/29/16,UTA,,PHI,W,1,32,7,11,0.636,3,5,0.6,4,6,0.667,2,2,1,0,1,1
2689,Rodney Hood,24-020,G-F,11/9/16,UTA,@,CHO,L,1,33,7,14,0.5,3,4,0.75,4,10,0.4,2,4,0.5,0,4,4
2690,Rodney Hood,24-100,G-F,1/28/17,UTA,,MEM,L,1,31,7,12,0.583,3,6,0.5,4,6,0.667,2,2,1,0,4,4
2691,Al Horford,30-285,C-F,3/15/17,BOS,,MIN,W,1,30,9,12,0.75,8,10,0.8,1,2,0.5,1,1,1,2,7,9
2692,Al Horford,30-171,C-F,11/21/16,BOS,@,MIN,W,1,36,9,20,0.45,7,13,0.538,2,7,0.286,0,0,,4,2,6
2693,Al Horford,30-236,C-F,1/25/17,BOS,,HOU,W,1,34,9,15,0.6,7,13,0.538,2,2,1,0,0,,0,3,3
2694,Dwight Howard,31-005,C,12/13/16,ATL,,ORL,L,1,29,9,10,0.9,9,10,0.9,0,0,,2,3,0.667,9,7,16
2695,Dwight Howard,30-333,C,11/5/16,ATL,,HOU,W,1,29,8,10,0.8,8,10,0.8,0,0,,4,10,0.4,7,8,15
2696,Dwight Howard,30-332,C,11/4/16,ATL,@,WAS,L,1,29,7,12,0.583,7,12,0.583,0,0,,6,12,0.5,5,7,12
2697,Dwight Howard,31-018,C,12/26/16,ATL,@,MIN,L,1,21,9,9,1,9,9,1,0,0,,2,3,0.667,6,6,12
2698,Serge Ibaka,27-093,F-C,12/20/16,ORL,@,MIA,W,1,40,8,15,0.533,4,10,0.4,4,5,0.8,0,0,,3,6,9
2699,Serge Ibaka,27-138,F-C,2/3/17,ORL,,TOR,W,1,35,8,12,0.667,6,9,0.667,2,3,0.667,2,2,1,1,11,12
2700,Serge Ibaka,27-101,F-C,12/28/16,ORL,,CHO,L,1,30,9,14,0.643,7,9,0.778,2,5,0.4,0,0,,2,5,7
2701,Serge Ibaka,27-101,F-C,12/28/16,ORL,,CHO,L,1,30,9,14,0.643,7,9,0.778,2,5,0.4,0,0,,2,5,7
2702,Ersan Ilyasova,29-236,F,1/6/17,PHI,@,BOS,L,1,32,8,21,0.381,4,7,0.571,4,14,0.286,0,0,,0,2,2
2703,Joe Ingles,29-043,F-G,11/14/16,UTA,,MEM,L,1,33,7,11,0.636,3,4,0.75,4,7,0.571,2,2,1,0,4,4
2704,Kyrie Irving,24-254,G,12/2/16,CLE,@,CHI,L,1,38,9,21,0.429,9,18,0.5,0,3,0,2,3,0.667,4,2,6
2705,Kyrie Irving,24-251,G,11/29/16,CLE,@,MIL,L,1,31,5,12,0.417,3,7,0.429,2,5,0.4,8,8,1,0,2,2
2706,Kyrie Irving,24-293,G,1/10/17,CLE,@,UTA,L,1,39,5,18,0.278,3,10,0.3,2,8,0.25,8,8,1,2,2,4
2707,Kyrie Irving,24-308,G,1/25/17,CLE,,SAC,L,1,42,9,19,0.474,8,15,0.533,1,4,0.25,1,2,0.5,0,1,1
2708,Kyrie Irving,24-245,G,11/23/16,CLE,,POR,W,1,33,8,15,0.533,5,9,0.556,3,6,0.5,1,2,0.5,0,2,2
2709,Kyrie Irving,24-220,G,10/29/16,CLE,,ORL,W,1,37,7,18,0.389,5,12,0.417,2,6,0.333,4,4,1,0,4,4
2710,Reggie Jackson,26-242,G,12/14/16,DET,@,DAL,W,1,30,8,16,0.5,7,12,0.583,1,4,0.25,3,4,0.75,0,2,2
2711,Reggie Jackson,26-258,G,12/30/16,DET,@,ATL,L,1,32,7,17,0.412,5,10,0.5,2,7,0.286,4,4,1,2,2,4
2712,Reggie Jackson,26-335,G,3/17/17,DET,,TOR,L,1,28,6,14,0.429,6,13,0.462,0,1,0,8,10,0.8,0,0,0
2713,Reggie Jackson,26-262,G,1/3/17,DET,,IND,L,1,32,8,18,0.444,5,14,0.357,3,4,0.75,1,1,1,4,3,7
2714,LeBron James,32-012,F-G,1/11/17,CLE,@,POR,L,1,31,5,12,0.417,3,7,0.429,2,5,0.4,8,9,0.889,1,10,11
2715,LeBron James,32-017,F-G,1/16/17,CLE,@,GSW,L,1,35,6,18,0.333,5,14,0.357,1,4,0.25,7,10,0.7,2,6,8
2716,Al Jefferson,32-016,C-F,1/20/17,IND,@,LAL,L,0,17,7,15,0.467,7,15,0.467,0,0,,6,6,1,1,5,6
2717,Al Jefferson,32-014,C-F,1/18/17,IND,@,SAC,W,0,17,9,12,0.75,9,12,0.75,0,0,,2,2,1,2,1,3
2718,Brandon Jennings,27-108,G,1/9/17,NYK,,NOP,L,1,29,8,14,0.571,4,5,0.8,4,9,0.444,0,0,,1,4,5
2719,James Johnson,29-321,F,1/6/17,MIA,@,LAL,L,0,34,7,11,0.636,3,4,0.75,4,7,0.571,2,4,0.5,1,4,5
2720,James Johnson,29-354,F,2/8/17,MIA,@,MIL,W,0,30,7,12,0.583,5,7,0.714,2,5,0.4,4,5,0.8,1,3,4
2721,James Johnson,29-316,F,1/1/17,MIA,,DET,L,0,34,6,13,0.462,2,8,0.25,4,5,0.8,4,4,1,1,6,7
2722,Nikola Jokic,22-020,C-F,3/11/17,DEN,@,SAC,W,1,30,7,12,0.583,6,9,0.667,1,3,0.333,5,5,1,3,11,14
2723,Nikola Jokic,21-350,C-F,2/3/17,DEN,,MIL,W,1,32,8,15,0.533,6,11,0.545,2,4,0.5,2,2,1,6,6,12
2724,DeAndre Jordan,28-230,C,3/8/17,LAC,@,MIN,L,1,30,9,11,0.818,9,11,0.818,0,0,,2,5,0.4,5,8,13
2725,DeAndre Jordan,28-169,C,1/6/17,LAC,@,SAC,W,1,37,9,10,0.9,9,10,0.9,0,0,,2,3,0.667,1,8,9
2726,DeAndre Jordan,28-162,C,12/30/16,LAC,@,HOU,L,1,30,9,11,0.818,9,11,0.818,0,0,,2,2,1,4,9,13
2727,DeAndre Jordan,28-220,C,2/26/17,LAC,,CHO,W,1,43,9,10,0.9,9,10,0.9,0,0,,2,4,0.5,9,10,19
2728,Frank Kaminsky,23-345,F-C,3/15/17,CHO,@,IND,L,0,31,7,15,0.467,6,7,0.857,1,8,0.125,5,7,0.714,0,4,4
2729,Frank Kaminsky,23-313,F-C,2/11/17,CHO,,LAC,L,1,36,7,16,0.438,4,10,0.4,3,6,0.5,3,4,0.75,1,7,8
2730,Frank Kaminsky,23-225,F-C,11/15/16,CHO,@,MIN,W,0,27,8,14,0.571,5,7,0.714,3,7,0.429,1,1,1,0,4,4
2731,Enes Kanter,24-169,C,11/5/16,OKC,,MIN,W,0,21,9,14,0.643,9,13,0.692,0,1,0,2,4,0.5,3,7,10
2732,Enes Kanter,24-217,C,12/23/16,OKC,@,BOS,W,0,23,8,13,0.615,8,13,0.615,0,0,,4,6,0.667,4,2,6
2733,Enes Kanter,24-282,C,2/26/17,OKC,,NOP,W,0,24,6,9,0.667,6,9,0.667,0,0,,8,10,0.8,3,6,9
2734,Enes Kanter,24-234,C,1/9/17,OKC,@,CHI,W,0,28,9,11,0.818,9,11,0.818,0,0,,2,3,0.667,4,7,11
2735,Enes Kanter,24-219,C,12/25/16,OKC,,MIN,W,0,29,8,10,0.8,8,9,0.889,0,1,0,4,7,0.571,0,4,4
2736,Sean Kilpatrick,27-057,G,3/4/17,BRK,@,POR,L,0,27,7,14,0.5,1,7,0.143,6,7,0.857,0,0,,1,1,2
2737,Kyle Korver,35-321,G-F,2/1/17,CLE,,MIN,W,0,24,8,11,0.727,4,4,1,4,7,0.571,0,0,,0,1,1
2738,Kyle Korver,35-343,G-F,2/23/17,CLE,,NYK,W,0,31,7,12,0.583,1,2,0.5,6,10,0.6,0,0,,0,2,2
2739,Zach LaVine,21-324,G,1/28/17,MIN,,BRK,W,1,37,6,11,0.545,3,5,0.6,3,6,0.5,5,7,0.714,0,6,6
2740,Zach LaVine,21-330,G,2/3/17,MIN,@,DET,L,1,32,9,13,0.692,9,11,0.818,0,2,0,2,3,0.667,1,3,4
2741,Courtney Lee,31-154,G,3/6/17,NYK,@,ORL,W,1,41,6,16,0.375,6,13,0.462,0,3,0,8,8,1,0,3,3
2742,Kawhi Leonard,25-140,F,11/16/16,SAS,@,SAC,W,1,32,7,14,0.5,3,5,0.6,4,9,0.444,2,2,1,2,4,6
2743,Kawhi Leonard,25-122,F,10/29/16,SAS,,NOP,W,1,28,6,12,0.5,4,8,0.5,2,4,0.5,6,6,1,0,4,4
2744,Kawhi Leonard,25-136,F,11/12/16,SAS,@,HOU,W,1,38,9,16,0.563,9,11,0.818,0,5,0,2,2,1,0,2,2
2745,Jon Leuer,27-270,F,2/8/17,DET,,LAL,W,1,34,9,17,0.529,9,15,0.6,0,2,0,2,2,1,1,2,3
2746,Jon Leuer,27-277,F,2/15/17,DET,,DAL,W,1,34,5,7,0.714,5,7,0.714,0,0,,10,10,1,1,7,8
2747,Damian Lillard,26-179,G,1/10/17,POR,@,LAL,W,1,31,7,21,0.333,6,15,0.4,1,6,0.167,5,6,0.833,3,5,8
2748,Damian Lillard,26-177,G,1/8/17,POR,,DET,L,1,43,7,16,0.438,4,7,0.571,3,9,0.333,3,4,0.75,0,9,9
2749,Damian Lillard,26-155,G,12/17/16,POR,@,GSW,L,1,30,8,15,0.533,7,12,0.583,1,3,0.333,3,3,1,0,2,2
2750,Brook Lopez,28-312,C,2/7/17,BRK,@,CHO,L,1,29,8,17,0.471,7,13,0.538,1,4,0.25,3,5,0.6,1,3,4
2751,Brook Lopez,28-310,C,2/5/17,BRK,,TOR,L,1,30,6,17,0.353,5,13,0.385,1,4,0.25,7,8,0.875,2,4,6
2752,Brook Lopez,28-257,C,12/14/16,BRK,,LAL,W,1,33,8,19,0.421,7,12,0.583,1,7,0.143,3,5,0.6,3,4,7
2753,Brook Lopez,28-238,C,11/25/16,BRK,@,IND,L,1,24,8,13,0.615,6,10,0.6,2,3,0.667,2,3,0.667,1,3,4
2754,Brook Lopez,28-287,C,1/13/17,BRK,@,TOR,L,1,29,6,17,0.353,6,14,0.429,0,3,0,8,10,0.8,0,3,3
2755,Brook Lopez,28-286,C,1/12/17,BRK,,NOP,L,1,32,9,18,0.5,8,12,0.667,1,6,0.167,1,2,0.5,1,5,6
2756,Brook Lopez,28-284,C,1/10/17,BRK,,ATL,L,1,32,8,14,0.571,6,8,0.75,2,6,0.333,2,4,0.5,0,2,2
2757,Brook Lopez,28-313,C,2/8/17,BRK,,WAS,L,1,32,8,17,0.471,8,13,0.615,0,4,0,4,4,1,1,5,6
2758,Kevin Love,28-059,F,11/5/16,CLE,@,PHI,W,1,38,8,16,0.5,6,11,0.545,2,5,0.4,2,3,0.667,1,10,11
2759,Kevin Love,28-109,F,12/25/16,CLE,,GSW,W,1,32,5,13,0.385,2,6,0.333,3,7,0.429,7,8,0.875,1,5,6
2760,Kyle Lowry,30-294,G,1/13/17,TOR,,BRK,W,1,36,8,14,0.571,5,7,0.714,3,7,0.429,1,2,0.5,2,4,6
2761,Kyle Lowry,30-320,G,2/8/17,TOR,@,MIN,L,1,37,6,19,0.316,2,6,0.333,4,13,0.308,4,5,0.8,2,0,2
2762,Kyle Lowry,30-264,G,12/14/16,TOR,@,PHI,W,1,37,6,12,0.5,1,2,0.5,5,10,0.5,3,3,1,1,3,4
2763,Wesley Matthews,30-038,G,11/21/16,DAL,@,SAS,L,1,40,6,13,0.462,3,6,0.5,3,7,0.429,5,7,0.714,1,4,5
2764,Wesley Matthews,30-120,G,2/11/17,DAL,,ORL,W,1,25,7,10,0.7,1,2,0.5,6,8,0.75,0,0,,0,4,4
2765,Wesley Matthews,30-076,G,12/29/16,DAL,@,LAL,W,1,35,6,14,0.429,2,5,0.4,4,9,0.444,4,6,0.667,1,5,6
2766,C.J. McCollum,25-143,G,2/9/17,POR,,BOS,L,1,37,8,18,0.444,8,12,0.667,0,6,0,4,5,0.8,1,3,4
2767,C.J. McCollum,25-100,G,12/28/16,POR,,SAC,W,1,35,6,18,0.333,4,12,0.333,2,6,0.333,6,7,0.857,0,2,2
2768,Doug McDermott,25-042,F,2/14/17,CHI,,TOR,W,0,32,8,13,0.615,6,9,0.667,2,4,0.5,2,2,1,0,5,5
2769,Jordan McRae,25-278,G,12/31/16,CLE,@,CHO,W,1,31,8,12,0.667,5,8,0.625,3,4,0.75,1,1,1,0,4,4
2770,Jodie Meeks,29-114,G,12/13/16,ORL,@,ATL,W,0,26,7,10,0.7,3,4,0.75,4,6,0.667,2,4,0.5,0,4,4
2771,Khris Middleton,25-187,F-G,2/15/17,MIL,@,BRK,W,0,26,7,13,0.538,6,12,0.5,1,1,1,5,5,1,0,3,3
2772,C.J. Miles,29-269,G-F,1/12/17,IND,@,DEN,L,0,20,7,13,0.538,1,6,0.167,6,7,0.857,0,0,,2,2,4
2773,C.J. Miles,29-201,G-F,11/5/16,IND,,CHI,W,0,22,8,14,0.571,4,7,0.571,4,7,0.571,0,0,,0,4,4
2774,Patty Mills,28-165,G,1/23/17,SAS,@,BRK,W,0,20,7,13,0.538,3,7,0.429,4,6,0.667,2,3,0.667,1,2,3
2775,Paul Millsap,31-311,F,12/17/16,ATL,,CHO,L,1,34,8,17,0.471,6,14,0.429,2,3,0.667,2,2,1,0,5,5
2776,Paul Millsap,32-024,F,3/6/17,ATL,,GSW,L,1,39,6,16,0.375,4,12,0.333,2,4,0.5,6,6,1,4,6,10
2777,Paul Millsap,31-317,F,12/23/16,ATL,@,DEN,W,1,38,5,15,0.333,3,10,0.3,2,5,0.4,8,10,0.8,1,7,8
2778,Nikola Mirotic,26-013,F,2/24/17,CHI,,PHO,W,0,37,5,10,0.5,1,3,0.333,4,7,0.571,6,7,0.857,0,8,8
2779,Nikola Mirotic,25-319,F,12/26/16,CHI,,IND,W,0,30,7,13,0.538,4,4,1,3,9,0.333,3,4,0.75,4,3,7
2780,E'Twaun Moore,27-256,G,11/10/16,NOP,@,MIL,W,1,32,8,18,0.444,6,13,0.462,2,5,0.4,2,2,1,0,2,2
2781,Marcus Morris,27-125,F,1/5/17,DET,,CHO,W,1,36,5,15,0.333,2,9,0.222,3,6,0.5,7,8,0.875,3,8,11
2782,Marcus Morris,27-089,F,11/30/16,DET,@,BOS,W,1,38,8,13,0.615,6,8,0.75,2,5,0.4,2,2,1,1,3,4
2783,Markieff Morris,27-128,F,1/8/17,WAS,@,MIL,W,1,38,9,15,0.6,8,12,0.667,1,3,0.333,1,2,0.5,5,5,10
2784,Markieff Morris,27-070,F,11/11/16,WAS,,CLE,L,1,33,6,14,0.429,5,11,0.455,1,3,0.333,7,7,1,1,4,5
2785,Timofey Mozgov,30-122,C,11/15/16,LAL,,BRK,W,1,29,7,11,0.636,7,11,0.636,0,0,,6,6,1,2,4,6
2786,Shabazz Muhammad,24-059,F-G,1/11/17,MIN,,HOU,W,0,30,7,11,0.636,5,8,0.625,2,3,0.667,4,4,1,1,6,7
2787,Shabazz Muhammad,24-126,F-G,3/19/17,MIN,@,NOP,L,0,24,8,13,0.615,7,10,0.7,1,3,0.333,3,5,0.6,2,4,6
2788,Shabazz Muhammad,24-070,F-G,1/22/17,MIN,,DEN,W,0,33,9,14,0.643,7,9,0.778,2,5,0.4,0,0,,3,2,5
2789,Jamal Murray,19-347,G,2/4/17,DEN,@,SAS,L,0,23,8,12,0.667,6,8,0.75,2,4,0.5,2,2,1,0,3,3
2790,Jamal Murray,19-276,G,11/25/16,DEN,,OKC,L,0,34,5,16,0.313,3,9,0.333,2,7,0.286,8,10,0.8,1,6,7
2791,Dirk Nowitzki,38-235,F,2/9/17,DAL,,UTA,W,1,37,8,17,0.471,8,15,0.533,0,2,0,4,5,0.8,1,6,7
2792,Dirk Nowitzki,38-269,F,3/15/17,DAL,@,WAS,W,1,32,7,15,0.467,4,8,0.5,3,7,0.429,3,5,0.6,0,4,4
2793,Kyle O'Quinn,26-251,F-C,12/2/16,NYK,,MIN,W,1,31,9,11,0.818,9,11,0.818,0,0,,2,2,1,7,7,14
2794,Jahlil Okafor,21-055,C-F,2/8/17,PHI,,SAS,L,1,25,5,10,0.5,5,10,0.5,0,0,,10,11,0.909,4,4,8
2795,Victor Oladipo,24-259,G,1/18/17,OKC,@,GSW,L,1,37,8,17,0.471,4,9,0.444,4,8,0.5,0,0,,1,2,3
2796,Victor Oladipo,24-179,G,10/30/16,OKC,,LAL,W,1,38,7,20,0.35,4,13,0.308,3,7,0.429,3,3,1,0,1,1
2797,Victor Oladipo,24-309,G,3/9/17,OKC,,SAS,W,1,28,8,15,0.533,5,11,0.455,3,4,0.75,1,1,1,0,4,4
2798,Victor Oladipo,24-283,G,2/11/17,OKC,,GSW,L,1,35,9,15,0.6,7,11,0.636,2,4,0.5,0,0,,1,3,4
2799,Jabari Parker,21-290,F,12/30/16,MIL,@,MIN,L,1,38,8,14,0.571,6,10,0.6,2,4,0.5,2,4,0.5,3,3,6
2800,Jabari Parker,21-316,F,1/25/17,MIL,,PHI,L,1,38,8,16,0.5,8,12,0.667,0,4,0,4,5,0.8,1,3,4
2801,Tony Parker,34-225,G,12/28/16,SAS,,PHO,W,1,29,10,16,0.625,10,15,0.667,0,1,0,0,1,0,0,1,1
2802,Tony Parker,34-193,G,11/26/16,SAS,@,WAS,W,1,27,8,13,0.615,7,12,0.583,1,1,1,3,3,1,1,0,1
2803,Chris Paul,31-218,G,12/10/16,LAC,,NOP,W,1,30,8,16,0.5,5,10,0.5,3,6,0.5,1,2,0.5,0,5,5
2804,Chris Paul,31-253,G,1/14/17,LAC,,LAL,W,1,31,7,15,0.467,5,9,0.556,2,6,0.333,4,4,1,2,3,5
2805,Elfrid Payton,22-333,G,1/20/17,ORL,,MIL,W,1,37,6,11,0.545,4,8,0.5,2,3,0.667,6,6,1,1,3,4
2806,Elfrid Payton,22-329,G,1/16/17,ORL,@,DEN,L,1,29,9,17,0.529,9,17,0.529,0,0,,2,3,0.667,2,2,4
2807,Elfrid Payton,22-357,G,2/13/17,ORL,@,MIA,W,0,31,7,15,0.467,7,15,0.467,0,0,,6,7,0.857,0,5,5
2808,Otto Porter,23-250,F,2/8/17,WAS,@,BRK,W,1,39,6,13,0.462,3,5,0.6,3,8,0.375,5,6,0.833,5,5,10
2809,Otto Porter,23-222,F,1/11/17,WAS,@,BOS,L,1,37,9,12,0.75,7,10,0.7,2,2,1,0,0,,2,4,6
2810,Otto Porter,23-157,F,11/7/16,WAS,,HOU,L,1,39,6,13,0.462,4,8,0.5,2,5,0.4,6,6,1,3,5,8
2811,Kristaps Porzingis,21-211,F-C,3/1/17,NYK,@,ORL,W,1,33,6,15,0.4,4,8,0.5,2,7,0.286,6,8,0.75,3,6,9
2812,Norman Powell,23-198,G,12/9/16,TOR,@,BOS,W,1,36,7,10,0.7,4,6,0.667,3,4,0.75,3,4,0.75,0,3,3
2813,Julius Randle,21-341,F,11/4/16,LAL,,GSW,W,1,30,10,18,0.556,10,17,0.588,0,1,0,0,0,,6,8,14
2814,Julius Randle,21-336,F,10/30/16,LAL,@,OKC,L,1,32,7,10,0.7,7,9,0.778,0,1,0,6,9,0.667,1,8,9
2815,Zach Randolph,35-188,F,1/20/17,MEM,,SAC,W,0,24,7,14,0.5,5,11,0.455,2,3,0.667,4,5,0.8,2,8,10
2816,Zach Randolph,35-225,F,2/26/17,MEM,@,DEN,W,0,26,9,18,0.5,9,16,0.563,0,2,0,2,2,1,4,7,11
2817,J.J. Redick,32-206,G,1/16/17,LAC,,OKC,W,1,27,7,15,0.467,2,5,0.4,5,10,0.5,1,1,1,0,1,1
2818,J.J. Redick,32-136,G,11/7/16,LAC,,DET,W,1,24,6,9,0.667,3,5,0.6,3,4,0.75,5,5,1,0,1,1
2819,J.J. Redick,32-150,G,11/21/16,LAC,,TOR,W,1,29,4,7,0.571,1,3,0.333,3,4,0.75,9,9,1,0,2,2
2820,Willie Reed,26-256,F-C,1/27/17,MIA,@,CHI,W,1,37,9,11,0.818,9,11,0.818,0,0,,2,2,1,2,3,5
2821,Josh Richardson,23-105,G,12/29/16,MIA,@,CHO,L,1,33,8,14,0.571,5,9,0.556,3,5,0.6,1,1,1,0,4,4
2822,Austin Rivers,24-220,G,3/9/17,LAC,@,MEM,W,0,32,7,10,0.7,6,6,1,1,4,0.25,5,6,0.833,1,4,5
2823,Austin Rivers,24-176,G,1/24/17,LAC,@,PHI,L,1,39,7,15,0.467,3,8,0.375,4,7,0.571,2,4,0.5,1,1,2
2824,Austin Rivers,24-171,G,1/19/17,LAC,,MIN,L,1,36,7,14,0.5,5,10,0.5,2,4,0.5,4,5,0.8,0,1,1
2825,Glenn Robinson,22-322,G-F,11/25/16,IND,,BRK,W,1,40,6,10,0.6,2,4,0.5,4,6,0.667,4,6,0.667,1,5,6
2826,Rajon Rondo,31-019,G,3/13/17,CHI,@,CHO,W,1,36,8,15,0.533,5,9,0.556,3,6,0.5,1,1,1,3,3,6
2827,Derrick Rose,28-111,G,1/23/17,NYK,@,IND,W,1,40,7,16,0.438,7,15,0.467,0,1,0,6,6,1,0,3,3
2828,Derrick Rose,28-107,G,1/19/17,NYK,,WAS,L,1,32,7,16,0.438,7,16,0.438,0,0,,6,6,1,2,3,5
2829,Derrick Rose,28-127,G,2/8/17,NYK,,LAC,L,1,37,10,16,0.625,10,15,0.667,0,1,0,0,0,,2,5,7
2830,Derrick Rose,28-150,G,3/3/17,NYK,@,PHI,L,1,38,5,13,0.385,5,13,0.385,0,0,,10,13,0.769,1,3,4
2831,Derrick Rose,28-061,G,12/4/16,NYK,,SAC,W,1,34,9,14,0.643,9,14,0.643,0,0,,2,3,0.667,2,4,6
2832,Derrick Rose,28-087,G,12/30/16,NYK,@,NOP,L,1,38,9,21,0.429,8,19,0.421,1,2,0.5,1,1,1,0,2,2
2833,Terrence Ross,26-028,F-G,3/5/17,ORL,@,WAS,L,1,32,8,18,0.444,4,8,0.5,4,10,0.4,0,0,,0,4,4
2834,Terrence Ross,25-273,F-G,11/4/16,TOR,,MIA,W,0,21,8,15,0.533,5,8,0.625,3,7,0.429,1,1,1,0,4,4
2835,Ricky Rubio,26-147,G,3/17/17,MIN,@,MIA,L,1,33,8,14,0.571,8,14,0.571,0,0,,4,4,1,0,0,0
2836,D'Angelo Russell,20-250,G,10/30/16,LAL,@,OKC,L,1,32,7,20,0.35,3,11,0.273,4,9,0.444,2,2,1,1,4,5
2837,D'Angelo Russell,20-246,G,10/26/16,LAL,,HOU,W,1,29,7,16,0.438,3,6,0.5,4,10,0.4,2,3,0.667,0,1,1
2838,D'Angelo Russell,20-327,G,1/15/17,LAL,,DET,L,1,26,9,17,0.529,9,13,0.692,0,4,0,2,2,1,1,6,7
2839,D'Angelo Russell,20-346,G,2/3/17,LAL,@,BOS,L,1,32,8,20,0.4,6,11,0.545,2,9,0.222,2,2,1,1,5,6
2840,Domantas Sabonis,20-234,F,12/23/16,OKC,@,BOS,W,1,25,8,11,0.727,4,5,0.8,4,6,0.667,0,0,,0,1,1
2841,Dario Saric,22-306,F,2/8/17,PHI,,SAS,L,0,21,8,11,0.727,4,6,0.667,4,5,0.8,0,0,,0,1,1
2842,Dario Saric,22-322,F,2/24/17,PHI,,WAS,W,1,33,10,19,0.526,10,15,0.667,0,4,0,0,0,,1,10,11
2843,Dario Saric,22-313,F,2/15/17,PHI,@,BOS,L,0,33,9,18,0.5,8,10,0.8,1,8,0.125,1,1,1,1,10,11
2844,Dennis Schroder,23-186,G,3/20/17,ATL,@,CHO,L,1,31,8,17,0.471,5,10,0.5,3,7,0.429,1,1,1,2,1,3
2845,Dennis Schroder,23-114,G,1/7/17,ATL,@,DAL,W,1,29,7,15,0.467,4,10,0.4,3,5,0.6,3,4,0.75,0,3,3
2846,Dennis Schroder,23-050,G,11/4/16,ATL,@,WAS,L,1,33,7,16,0.438,7,13,0.538,0,3,0,6,8,0.75,1,6,7
2847,Dennis Schroder,23-148,G,2/10/17,ATL,@,SAC,L,1,33,6,12,0.5,4,8,0.5,2,4,0.5,6,7,0.857,0,2,2
2848,Thabo Sefolosha,32-191,G-F,11/9/16,ATL,,CHI,W,0,29,8,9,0.889,6,6,1,2,3,0.667,2,2,1,1,4,5
2849,Jonathon Simmons,27-041,G-F,10/25/16,SAS,@,GSW,W,0,28,8,14,0.571,5,9,0.556,3,5,0.6,1,3,0.333,1,3,4
2850,Marcus Smart,22-248,G,11/9/16,BOS,@,WAS,L,0,36,7,18,0.389,3,9,0.333,4,9,0.444,2,5,0.4,0,3,3
2851,Tony Snell,25-046,G-F,12/26/16,MIL,@,WAS,L,1,29,7,14,0.5,1,3,0.333,6,11,0.545,0,0,,1,3,4
2852,Nik Stauskas,23-164,G,3/20/17,PHI,@,ORL,L,0,39,6,17,0.353,3,8,0.375,3,9,0.333,5,6,0.833,1,4,5
2853,Jeff Teague,28-138,G,10/26/16,IND,,DAL,W,1,37,5,15,0.333,5,12,0.417,0,3,0,10,13,0.769,0,2,2
2854,Jeff Teague,28-230,G,1/26/17,IND,@,MIN,W,1,35,7,13,0.538,4,8,0.5,3,5,0.6,3,3,1,0,8,8
2855,Jeff Teague,28-159,G,11/16/16,IND,,CLE,W,1,35,7,12,0.583,5,8,0.625,2,4,0.5,4,4,1,0,4,4
2856,Jeff Teague,28-155,G,11/12/16,IND,,BOS,L,1,35,4,15,0.267,3,11,0.273,1,4,0.25,11,12,0.917,1,2,3
2857,Garrett Temple,30-220,G,12/14/16,SAC,@,HOU,L,1,30,7,13,0.538,2,4,0.5,5,9,0.556,1,1,1,1,1,2
2858,Isaiah Thomas,28-017,G,2/24/17,BOS,@,TOR,L,1,35,6,17,0.353,3,7,0.429,3,10,0.3,5,6,0.833,1,2,3
2859,Isaiah Thomas,27-302,G,12/5/16,BOS,@,HOU,L,1,33,7,19,0.368,4,12,0.333,3,7,0.429,3,3,1,0,2,2
2860,Isaiah Thomas,27-299,G,12/2/16,BOS,,SAC,W,1,34,6,21,0.286,6,16,0.375,0,5,0,8,9,0.889,1,2,3
2861,Klay Thompson,26-294,G,11/28/16,GSW,,ATL,W,1,37,8,18,0.444,5,12,0.417,3,6,0.5,1,1,1,2,2,4
2862,Klay Thompson,26-275,G,11/9/16,GSW,,DAL,W,1,29,8,13,0.615,4,6,0.667,4,7,0.571,0,0,,0,2,2
2863,Karl-Anthony Towns,21-038,F-C,12/23/16,MIN,,SAC,L,1,38,7,15,0.467,6,10,0.6,1,5,0.2,5,6,0.833,5,8,13
2864,Karl-Anthony Towns,21-017,F-C,12/2/16,MIN,@,NYK,L,1,30,5,18,0.278,2,13,0.154,3,5,0.6,7,8,0.875,3,5,8
2865,Karl-Anthony Towns,20-360,F-C,11/9/16,MIN,@,ORL,W,1,41,7,16,0.438,6,13,0.462,1,3,0.333,5,5,1,4,7,11
2866,Evan Turner,28-070,G,1/5/17,POR,,LAL,W,0,28,7,11,0.636,6,9,0.667,1,2,0.5,5,6,0.833,0,1,1
2867,Myles Turner,20-219,F-C,10/29/16,IND,@,CHI,L,1,22,8,12,0.667,8,12,0.667,0,0,,4,5,0.8,1,3,4
2868,Myles Turner,20-258,F-C,12/7/16,IND,@,PHO,W,1,28,7,11,0.636,4,7,0.571,3,4,0.75,3,4,0.75,2,2,4
2869,Myles Turner,20-270,F-C,12/19/16,IND,,WAS,W,1,33,8,13,0.615,7,11,0.636,1,2,0.5,3,5,0.6,1,7,8
2870,Tyler Ulis,21-059,G,3/5/17,PHO,,BOS,W,0,33,8,12,0.667,7,11,0.636,1,1,1,3,3,1,0,2,2
2871,Jonas Valanciunas,24-216,C,12/8/16,TOR,,MIN,W,1,29,9,15,0.6,9,15,0.6,0,0,,2,2,1,6,4,10
2872,Jonas Valanciunas,24-270,C,1/31/17,TOR,,NOP,W,1,32,9,17,0.529,9,17,0.529,0,0,,2,2,1,5,7,12
2873,Nikola Vucevic,26-092,C,1/24/17,ORL,,CHI,L,1,33,8,16,0.5,8,15,0.533,0,1,0,4,5,0.8,2,6,8
2874,Nikola Vucevic,26-138,C,3/11/17,ORL,,CLE,L,1,28,9,19,0.474,9,18,0.5,0,1,0,2,4,0.5,6,9,15
2875,Dwyane Wade,35-039,G,2/25/17,CHI,@,CLE,W,1,34,9,18,0.5,8,15,0.533,1,3,0.333,1,3,0.333,1,8,9
2876,Dwyane Wade,34-356,G,1/7/17,CHI,,TOR,W,1,39,6,19,0.316,5,17,0.294,1,2,0.5,7,7,1,1,3,4
2877,Dwyane Wade,34-333,G,12/15/16,CHI,@,MIL,L,1,33,8,13,0.615,8,10,0.8,0,3,0,4,6,0.667,0,3,3
2878,Dwyane Wade,34-348,G,12/30/16,CHI,@,IND,L,1,30,8,18,0.444,7,16,0.438,1,2,0.5,3,4,0.75,0,2,2
2879,Dwyane Wade,34-326,G,12/8/16,CHI,,SAS,W,1,34,5,13,0.385,4,10,0.4,1,3,0.333,9,13,0.692,1,4,5
2880,Dion Waiters,25-053,G,2/1/17,MIA,,ATL,W,1,30,9,15,0.6,7,11,0.636,2,4,0.5,0,0,,2,5,7
2881,Dion Waiters,25-092,G,3/12/17,MIA,@,IND,L,1,36,8,18,0.444,5,11,0.455,3,7,0.429,1,3,0.333,0,8,8
2882,Dion Waiters,24-327,G,11/1/16,MIA,,SAC,W,1,42,7,14,0.5,6,11,0.545,1,3,0.333,5,7,0.714,0,4,4
2883,Dion Waiters,25-091,G,3/11/17,MIA,,TOR,W,1,33,6,10,0.6,2,4,0.5,4,6,0.667,4,8,0.5,0,1,1
2884,Kemba Walker,26-241,G,1/4/17,CHO,,OKC,W,1,33,5,13,0.385,4,9,0.444,1,4,0.25,9,9,1,2,2,4
2885,Kemba Walker,26-229,G,12/23/16,CHO,,CHI,W,1,32,6,16,0.375,4,13,0.308,2,3,0.667,6,6,1,2,3,5
2886,John Wall,26-163,G,2/16/17,WAS,@,IND,W,1,37,8,20,0.4,8,18,0.444,0,2,0,4,4,1,0,2,2
2887,T.J. Warren,23-154,F,2/6/17,PHO,@,NOP,L,1,33,9,16,0.563,9,13,0.692,0,3,0,2,2,1,2,2,4
2888,T.J. Warren,23-069,F,11/13/16,PHO,@,GSW,L,1,33,10,18,0.556,10,17,0.588,0,1,0,0,0,,1,2,3
2889,Russell Westbrook,28-031,G,12/13/16,OKC,@,POR,L,1,27,7,19,0.368,5,14,0.357,2,5,0.4,4,4,1,2,4,6
2890,Russell Westbrook,28-078,G,1/29/17,OKC,@,CLE,L,1,36,7,26,0.269,6,20,0.3,1,6,0.167,5,8,0.625,5,7,12
2891,Russell Westbrook,27-357,G,11/3/16,OKC,@,GSW,L,1,29,4,15,0.267,2,11,0.182,2,4,0.5,10,14,0.714,1,5,6
2892,Hassan Whiteside,27-137,C,10/28/16,MIA,,CHO,L,1,27,8,11,0.727,8,11,0.727,0,0,,4,7,0.571,5,10,15
2893,Hassan Whiteside,27-264,C,3/4/17,MIA,,CLE,W,1,28,9,14,0.643,9,14,0.643,0,0,,2,2,1,4,9,13
2894,Hassan Whiteside,27-180,C,12/10/16,MIA,@,CHI,L,1,33,9,19,0.474,9,19,0.474,0,0,,2,4,0.5,3,5,8
2895,Hassan Whiteside,27-150,C,11/10/16,MIA,,CHI,L,1,37,8,18,0.444,8,18,0.444,0,0,,4,4,1,8,12,20
2896,Hassan Whiteside,27-275,C,3/15/17,MIA,,NOP,W,1,35,9,11,0.818,9,11,0.818,0,0,,2,2,1,4,13,17
2897,Andrew Wiggins,22-013,F-G,3/8/17,MIN,,LAC,W,1,36,5,17,0.294,5,14,0.357,0,3,0,10,10,1,1,1,2
2898,Andrew Wiggins,22-006,F-G,3/1/17,MIN,@,UTA,W,1,31,7,16,0.438,6,15,0.4,1,1,1,5,6,0.833,1,1,2
2899,Deron Williams,32-164,G,12/7/16,DAL,,SAC,L,1,32,6,8,0.75,3,3,1,3,5,0.6,5,5,1,0,2,2
2900,Deron Williams,32-193,G,1/5/17,DAL,,PHO,L,1,33,8,14,0.571,6,9,0.667,2,5,0.4,2,3,0.667,0,4,4
2901,Lou Williams,30-091,G,1/26/17,LAL,@,UTA,L,0,25,6,9,0.667,5,6,0.833,1,3,0.333,7,7,1,0,5,5
2902,Lou Williams,30-008,G,11/4/16,LAL,,GSW,W,0,26,7,14,0.5,5,8,0.625,2,6,0.333,4,5,0.8,0,2,2
2903,Nick Young,31-216,G-F,1/3/17,LAL,,MEM,W,1,27,6,11,0.545,0,0,,6,11,0.545,2,4,0.5,0,0,0
2904,Nick Young,31-204,G-F,12/22/16,LAL,@,MIA,L,1,36,7,14,0.5,2,3,0.667,5,11,0.455,1,1,1,0,0,0
2905,Nick Young,31-160,G-F,11/8/16,LAL,,DAL,L,1,29,7,12,0.583,4,6,0.667,3,6,0.5,3,3,1,0,2,2
2906,Thaddeus Young,28-152,F,11/20/16,IND,@,OKC,W,1,38,9,18,0.5,7,13,0.538,2,5,0.4,0,3,0,4,7,11
2907,Alex Abrines,23-207,G-F,2/24/17,OKC,,LAL,W,1,29,7,13,0.538,2,2,1,5,11,0.455,0,0,,0,3,3
2908,Steven Adams,23-228,C,3/5/17,OKC,@,DAL,L,1,25,8,10,0.8,8,10,0.8,0,0,,3,5,0.6,3,2,5
2909,Steven Adams,23-150,C,12/17/16,OKC,,PHO,W,1,29,8,13,0.615,8,13,0.615,0,0,,3,5,0.6,4,3,7
2910,Arron Afflalo,31-080,G,1/3/17,SAC,@,DEN,W,0,30,8,11,0.727,6,7,0.857,2,4,0.5,1,1,1,0,2,2
2911,LaMarcus Aldridge,31-239,F-C,3/15/17,SAS,,POR,L,1,32,9,24,0.375,9,23,0.391,0,1,0,1,1,1,4,3,7
2912,LaMarcus Aldridge,31-209,F-C,2/13/17,SAS,@,IND,W,1,36,7,22,0.318,7,22,0.318,0,0,,5,5,1,3,4,7
2913,LaMarcus Aldridge,31-136,F-C,12/2/16,SAS,,WAS,W,1,37,8,14,0.571,8,14,0.571,0,0,,3,6,0.5,2,3,5
2914,LaMarcus Aldridge,31-206,F-C,2/10/17,SAS,@,DET,W,1,32,8,18,0.444,8,18,0.444,0,0,,3,4,0.75,3,8,11
2915,LaMarcus Aldridge,31-109,F-C,11/5/16,SAS,,LAC,L,1,25,7,13,0.538,4,10,0.4,3,3,1,2,2,1,1,5,6
2916,LaMarcus Aldridge,31-108,F-C,11/4/16,SAS,@,UTA,W,1,29,7,13,0.538,7,13,0.538,0,0,,5,6,0.833,1,5,6
2917,Tony Allen,34-334,G-F,12/10/16,MEM,,GSW,W,1,38,7,12,0.583,6,11,0.545,1,1,1,4,4,1,0,4,4
2918,Tony Allen,34-329,G-F,12/5/16,MEM,@,NOP,W,1,42,9,14,0.643,9,13,0.692,0,1,0,1,2,0.5,4,9,13
2919,Justin Anderson,23-107,G,3/6/17,PHI,,MIL,L,0,23,9,16,0.563,9,10,0.9,0,6,0,1,2,0.5,3,3,6
2920,Justin Anderson,23-064,G,1/22/17,DAL,,LAL,W,0,16,5,11,0.455,2,5,0.4,3,6,0.5,6,6,1,1,4,5
2921,Justin Anderson,23-104,G,3/3/17,PHI,,NYK,W,0,24,8,12,0.667,5,6,0.833,3,6,0.5,0,0,,3,2,5
2922,Justin Anderson,23-118,G,3/17/17,PHI,,DAL,W,0,26,7,11,0.636,5,6,0.833,2,5,0.4,3,3,1,1,7,8
2923,Ryan Anderson,28-220,F,12/12/16,HOU,,BRK,W,1,31,6,11,0.545,3,4,0.75,3,7,0.429,4,5,0.8,2,4,6
2924,Ryan Anderson,28-245,F,1/6/17,HOU,@,ORL,W,1,33,7,12,0.583,2,3,0.667,5,9,0.556,0,0,,0,4,4
2925,Ryan Anderson,28-264,F,1/25/17,HOU,@,BOS,L,1,36,5,8,0.625,2,4,0.5,3,4,0.75,6,7,0.857,3,2,5
2926,Giannis Antetokounmpo,22-038,F-G,1/13/17,MIL,,MIA,W,1,36,8,12,0.667,8,12,0.667,0,0,,3,4,0.75,1,7,8
2927,Giannis Antetokounmpo,22-052,F-G,1/27/17,MIL,@,TOR,L,1,33,7,15,0.467,7,15,0.467,0,0,,5,8,0.625,0,6,6
2928,Carmelo Anthony,32-218,F,1/2/17,NYK,,ORL,L,1,35,6,17,0.353,6,13,0.462,0,4,0,7,8,0.875,1,6,7
2929,Carmelo Anthony,32-149,F,10/25/16,NYK,@,CLE,L,1,30,8,18,0.444,7,14,0.5,1,4,0.25,2,2,1,1,4,5
2930,Carmelo Anthony,32-172,F,11/17/16,NYK,@,WAS,L,1,35,7,17,0.412,6,9,0.667,1,8,0.125,4,4,1,0,3,3
2931,D.J. Augustin,29-057,G,1/6/17,ORL,,HOU,L,0,29,5,9,0.556,1,2,0.5,4,7,0.571,5,5,1,0,1,1
2932,D.J. Augustin,29-001,G,11/11/16,ORL,,UTA,L,0,24,6,10,0.6,3,4,0.75,3,6,0.5,4,5,0.8,0,0,0
2933,Harrison Barnes,24-149,F,10/26/16,DAL,@,IND,L,1,35,8,14,0.571,5,8,0.625,3,6,0.5,0,0,,3,6,9
2934,Harrison Barnes,24-198,F,12/14/16,DAL,,DET,L,1,37,9,18,0.5,8,13,0.615,1,5,0.2,0,0,,2,3,5
2935,Harrison Barnes,24-244,F,1/29/17,DAL,@,SAS,W,1,35,8,20,0.4,7,16,0.438,1,4,0.25,2,2,1,1,2,3
2936,Harrison Barnes,24-259,F,2/13/17,DAL,,BOS,L,1,35,7,16,0.438,5,12,0.417,2,4,0.5,3,5,0.6,0,3,3
2937,Harrison Barnes,24-293,F,3/19/17,DAL,@,BRK,W,1,36,8,15,0.533,7,14,0.5,1,1,1,2,2,1,1,5,6
2938,Harrison Barnes,24-220,F,1/5/17,DAL,,PHO,L,1,39,8,13,0.615,8,13,0.615,0,0,,3,4,0.75,2,4,6
2939,Harrison Barnes,24-203,F,12/19/16,DAL,@,DEN,L,1,34,9,15,0.6,8,12,0.667,1,3,0.333,0,0,,0,2,2
2940,Harrison Barnes,24-235,F,1/20/17,DAL,,UTA,L,1,40,7,16,0.438,6,14,0.429,1,2,0.5,4,6,0.667,1,4,5
2941,Harrison Barnes,24-271,F,2/25/17,DAL,,NOP,W,1,34,7,15,0.467,5,13,0.385,2,2,1,3,3,1,1,2,3
2942,Matt Barnes,36-334,F,2/6/17,SAC,,CHI,L,0,33,7,10,0.7,4,6,0.667,3,4,0.75,2,2,1,1,8,9
2943,Nicolas Batum,28-019,F-G,1/2/17,CHO,@,CHI,L,1,36,7,16,0.438,6,13,0.462,1,3,0.333,4,4,1,2,4,6
2944,Nicolas Batum,28-030,F-G,1/13/17,CHO,@,PHI,L,1,32,7,14,0.5,6,11,0.545,1,3,0.333,4,4,1,1,4,5
2945,Nicolas Batum,28-045,F-G,1/28/17,CHO,,SAC,L,1,40,6,11,0.545,3,5,0.6,3,6,0.5,4,4,1,1,6,7
2946,Kent Bazemore,27-140,G-F,11/18/16,ATL,@,CHO,L,1,30,8,15,0.533,7,10,0.7,1,5,0.2,2,2,1,1,1,2
2947,Bradley Beal,23-233,G,2/16/17,WAS,@,IND,W,1,36,7,14,0.5,3,7,0.429,4,7,0.571,1,2,0.5,1,2,3
2948,Bradley Beal,23-265,G,3/20/17,WAS,@,BOS,L,1,33,6,15,0.4,3,8,0.375,3,7,0.429,4,4,1,0,4,4
2949,Bradley Beal,23-161,G,12/6/16,WAS,,ORL,L,1,37,7,18,0.389,4,12,0.333,3,6,0.5,2,4,0.5,1,2,3
2950,Bradley Beal,23-196,G,1/10/17,WAS,,CHI,W,1,37,7,15,0.467,4,9,0.444,3,6,0.5,2,3,0.667,0,4,4
2951,Michael Beasley,27-308,F,11/12/16,MIL,,MEM,W,0,19,6,8,0.75,5,7,0.714,1,1,1,6,7,0.857,1,3,4
2952,Marco Belinelli,30-245,G-F,11/25/16,CHO,@,NYK,L,0,33,7,11,0.636,2,5,0.4,5,6,0.833,0,0,,1,1,2
2953,Marco Belinelli,30-267,G-F,12/17/16,CHO,@,ATL,W,0,30,8,11,0.727,5,7,0.714,3,4,0.75,0,0,,0,3,3
2954,Patrick Beverley,28-214,G,2/11/17,HOU,,PHO,W,1,25,6,10,0.6,2,6,0.333,4,4,1,3,3,1,2,7,9
2955,Eric Bledsoe,27-093,G,3/12/17,PHO,,POR,L,1,31,7,19,0.368,4,15,0.267,3,4,0.75,2,4,0.5,1,2,3
2956,Eric Bledsoe,27-022,G,12/31/16,PHO,@,UTA,L,1,30,7,20,0.35,5,14,0.357,2,6,0.333,3,3,1,1,7,8
2957,Eric Bledsoe,26-333,G,11/6/16,PHO,@,LAL,L,1,30,7,14,0.5,7,10,0.7,0,4,0,5,6,0.833,1,1,2
2958,Bojan Bogdanovic,27-331,G-F,3/15/17,WAS,,DAL,L,0,24,4,5,0.8,1,1,1,3,4,0.75,8,9,0.889,0,3,3
2959,Bojan Bogdanovic,27-233,G-F,12/7/16,BRK,,DEN,W,1,34,8,11,0.727,7,9,0.778,1,2,0.5,2,2,1,1,0,1
2960,Devin Booker,20-060,G,12/29/16,PHO,,TOR,W,1,38,6,19,0.316,5,15,0.333,1,4,0.25,6,7,0.857,0,5,5
2961,Devin Booker,20-136,G,3/15/17,PHO,,SAC,L,1,40,6,26,0.231,3,17,0.176,3,9,0.333,4,4,1,1,2,3
2962,Devin Booker,20-014,G,11/13/16,PHO,@,GSW,L,1,32,6,18,0.333,5,13,0.385,1,5,0.2,6,6,1,1,3,4
2963,Trevor Booker,28-353,F,11/12/16,BRK,@,PHO,W,1,26,7,10,0.7,6,9,0.667,1,1,1,4,4,1,4,4,8
2964,Avery Bradley,25-354,G,11/14/16,BOS,@,NOP,L,1,34,7,17,0.412,4,9,0.444,3,8,0.375,2,2,1,1,9,10
2965,Avery Bradley,25-365,G,11/25/16,BOS,,SAS,L,1,38,8,15,0.533,5,11,0.455,3,4,0.75,0,0,,1,7,8
2966,Avery Bradley,26-013,G,12/9/16,BOS,,TOR,L,1,34,7,11,0.636,2,4,0.5,5,7,0.714,0,0,,0,5,5
2967,Aaron Brooks,31-347,G,12/26/16,IND,@,CHI,L,0,24,6,8,0.75,3,4,0.75,3,4,0.75,4,4,1,1,3,4
2968,Jaylen Brown,20-010,F,11/3/16,BOS,@,CLE,L,1,35,8,16,0.5,5,10,0.5,3,6,0.5,0,1,0,3,2,5
2969,Jimmy Butler,27-096,G-F,12/19/16,CHI,,DET,W,1,30,6,7,0.857,5,6,0.833,1,1,1,6,6,1,1,2,3
2970,Jimmy Butler,27-128,G-F,1/20/17,CHI,@,ATL,L,1,29,6,8,0.75,4,6,0.667,2,2,1,5,5,1,0,0,0
2971,Jimmy Butler,27-153,G-F,2/14/17,CHI,,TOR,W,1,38,2,10,0.2,2,7,0.286,0,3,0,15,19,0.789,1,1,2
2972,Jimmy Butler,27-102,G-F,12/25/16,CHI,@,SAS,L,1,36,8,19,0.421,7,16,0.438,1,3,0.333,2,2,1,1,4,5
2973,Kentavious Caldwell-Pope,23-257,G,11/1/16,DET,,NYK,W,1,34,7,11,0.636,3,5,0.6,4,6,0.667,1,1,1,0,3,3
2974,Kentavious Caldwell-Pope,24-031,G,3/21/17,DET,@,BRK,L,1,35,7,17,0.412,4,9,0.444,3,8,0.375,2,2,1,0,4,4
2975,Clint Capela,22-294,F-C,3/8/17,HOU,,UTA,L,1,32,9,13,0.692,9,13,0.692,0,0,,1,6,0.167,6,6,12
2976,DeMarre Carroll,30-196,F,2/8/17,TOR,@,MIN,L,1,34,7,9,0.778,2,4,0.5,5,5,1,0,0,,1,8,9
2977,Wilson Chandler,29-276,F,2/10/17,DEN,@,NYK,W,1,37,9,14,0.643,8,12,0.667,1,2,0.5,0,0,,1,3,4
2978,Wilson Chandler,29-177,F,11/3/16,DEN,@,MIN,W,0,27,8,12,0.667,8,10,0.8,0,2,0,3,5,0.6,2,4,6
2979,Wilson Chandler,29-227,F,12/23/16,DEN,,ATL,L,1,27,9,17,0.529,8,13,0.615,1,4,0.25,0,3,0,1,10,11
2980,Jordan Clarkson,24-264,G,2/26/17,LAL,,SAS,L,0,27,8,16,0.5,7,13,0.538,1,3,0.333,2,2,1,0,2,2
2981,Jordan Clarkson,24-279,G,3/13/17,LAL,@,DEN,L,1,33,7,18,0.389,4,11,0.364,3,7,0.429,2,3,0.667,0,2,2
2982,Jordan Clarkson,24-275,G,3/9/17,LAL,@,PHO,W,0,35,7,18,0.389,6,12,0.5,1,6,0.167,4,5,0.8,0,2,2
2983,Jordan Clarkson,24-224,G,1/17/17,LAL,,DEN,L,0,36,7,16,0.438,5,11,0.455,2,5,0.4,3,3,1,0,0,0
2984,Jordan Clarkson,24-285,G,3/19/17,LAL,,CLE,L,1,41,8,18,0.444,6,11,0.545,2,7,0.286,1,1,1,2,1,3
2985,Darren Collison,29-106,G,12/7/16,SAC,@,DAL,W,1,30,5,10,0.5,3,6,0.5,2,4,0.5,7,8,0.875,1,2,3
2986,Darren Collison,29-202,G,3/13/17,SAC,,ORL,W,1,33,5,9,0.556,3,5,0.6,2,4,0.5,7,7,1,0,2,2
2987,Darren Collison,29-164,G,2/3/17,SAC,,PHO,L,1,38,8,16,0.5,5,12,0.417,3,4,0.75,0,0,,0,2,2
2988,Mike Conley,29-070,G,12/20/16,MEM,,BOS,L,1,36,6,16,0.375,3,8,0.375,3,8,0.375,4,6,0.667,1,4,5
2989,Mike Conley,29-089,G,1/8/17,MEM,,UTA,W,1,35,8,18,0.444,7,14,0.5,1,4,0.25,2,3,0.667,0,2,2
2990,Mike Conley,29-158,G,3/18/17,MEM,,SAS,W,1,36,5,12,0.417,2,6,0.333,3,6,0.5,6,7,0.857,0,7,7
2991,DeMarcus Cousins,26-202,C-F,3/3/17,NOP,,SAS,L,1,43,7,18,0.389,6,12,0.5,1,6,0.167,4,5,0.8,4,20,24
2992,DeMarcus Cousins,26-214,C-F,3/15/17,NOP,@,MIA,L,1,30,8,17,0.471,6,14,0.429,2,3,0.667,1,3,0.333,1,8,9
2993,DeMarcus Cousins,26-160,C-F,1/20/17,SAC,@,MEM,L,1,28,5,11,0.455,3,8,0.375,2,3,0.667,7,10,0.7,1,9,10
2994,DeMarcus Cousins,26-099,C-F,11/20/16,SAC,,TOR,W,1,30,7,22,0.318,4,16,0.25,3,6,0.5,2,3,0.667,2,8,10
2995,Robert Covington,26-059,F,2/11/17,PHI,,MIA,W,1,31,6,12,0.5,1,6,0.167,5,6,0.833,2,2,1,0,7,7
2996,Robert Covington,25-345,F,11/23/16,PHI,,MEM,L,1,46,6,10,0.6,2,3,0.667,4,7,0.571,3,5,0.6,1,9,10
2997,Robert Covington,26-077,F,3/1/17,PHI,@,MIA,L,1,26,5,11,0.455,2,4,0.5,3,7,0.429,6,8,0.75,0,5,5
2998,Robert Covington,26-016,F,12/30/16,PHI,@,DEN,W,1,28,6,12,0.5,3,6,0.5,3,6,0.5,4,5,0.8,2,4,6
2999,Jamal Crawford,36-340,G,2/23/17,LAC,@,GSW,L,0,34,6,15,0.4,4,11,0.364,2,4,0.5,5,7,0.714,1,0,1
3000,Jamal Crawford,36-236,G,11/11/16,LAC,@,OKC,W,0,21,7,11,0.636,4,7,0.571,3,4,0.75,2,4,0.5,1,2,3
3001,Jamal Crawford,36-351,G,3/6/17,LAC,,BOS,W,0,29,6,13,0.462,2,8,0.25,4,5,0.8,3,4,0.75,0,1,1
3002,Jamal Crawford,36-309,G,1/23/17,LAC,@,ATL,W,0,27,9,20,0.45,8,18,0.444,1,2,0.5,0,1,0,0,2,2
3003,Jordan Crawford,28-134,G,3/6/17,NOP,@,UTA,L,0,20,8,15,0.533,5,8,0.625,3,7,0.429,0,0,,0,1,1
3004,Jordan Crawford,28-139,G,3/11/17,NOP,@,CHO,W,0,27,7,12,0.583,2,5,0.4,5,7,0.714,0,0,,0,1,1
3005,Jae Crowder,26-233,F,2/24/17,BOS,@,TOR,L,1,31,6,12,0.5,2,3,0.667,4,9,0.444,3,4,0.75,1,3,4
3006,Jae Crowder,26-205,F,1/27/17,BOS,,ORL,W,1,27,7,11,0.636,2,4,0.5,5,7,0.714,0,0,,2,4,6
3007,Seth Curry,26-164,G,2/3/17,DAL,@,POR,W,1,29,7,12,0.583,6,9,0.667,1,3,0.333,4,4,1,0,3,3
3008,Seth Curry,26-204,G,3/15/17,DAL,@,WAS,W,1,34,6,10,0.6,3,3,1,3,7,0.429,4,6,0.667,0,0,0
3009,Stephen Curry,28-278,G,12/17/16,GSW,,POR,W,1,27,6,11,0.545,1,3,0.333,5,8,0.625,2,2,1,0,3,3
3010,Stephen Curry,28-350,G,2/27/17,GSW,@,PHI,W,1,35,7,23,0.304,7,12,0.583,0,11,0,5,5,1,2,2,4
3011,Stephen Curry,28-268,G,12/7/16,GSW,@,LAC,W,1,33,7,16,0.438,7,8,0.875,0,8,0,5,5,1,0,4,4
3012,Troy Daniels,25-139,G,12/1/16,MEM,,ORL,W,0,29,6,9,0.667,3,4,0.75,3,5,0.6,4,5,0.8,0,2,2
3013,Troy Daniels,25-138,G,11/30/16,MEM,@,TOR,L,0,21,6,12,0.5,2,4,0.5,4,8,0.5,3,3,1,1,0,1
3014,Anthony Davis,24-010,F-C,3/21/17,NOP,,MEM,W,1,40,9,18,0.5,9,16,0.563,0,2,0,1,2,0.5,3,10,13
3015,Anthony Davis,23-280,F-C,12/16/16,NOP,@,HOU,L,1,23,9,17,0.529,9,16,0.563,0,1,0,1,3,0.333,1,4,5
3016,Sam Dekker,22-222,F,12/14/16,HOU,,SAC,W,0,22,8,10,0.8,6,7,0.857,2,3,0.667,1,1,1,2,5,7
3017,Luol Deng,31-265,F,1/6/17,LAL,,MIA,W,1,30,8,12,0.667,5,8,0.625,3,4,0.75,0,0,,3,11,14
3018,Cheick Diallo,20-088,F,12/10/16,NOP,@,LAC,L,0,31,8,15,0.533,8,15,0.533,0,0,,3,6,0.5,3,7,10
3019,Spencer Dinwiddie,23-315,G,2/15/17,BRK,,MIL,L,1,27,7,12,0.583,6,9,0.667,1,3,0.333,4,4,1,1,4,5
3020,Goran Dragic,30-228,G,12/20/16,MIA,,ORL,L,1,45,6,17,0.353,3,11,0.273,3,6,0.5,4,6,0.667,0,4,4
3021,Goran Dragic,30-262,G,1/23/17,MIA,,GSW,W,1,36,5,14,0.357,4,9,0.444,1,5,0.2,8,13,0.615,2,2,4
3022,Goran Dragic,30-243,G,1/4/17,MIA,@,SAC,W,1,30,5,12,0.417,5,10,0.5,0,2,0,9,9,1,0,1,1
3023,Goran Dragic,30-315,G,3/17/17,MIA,,MIN,W,1,33,7,16,0.438,6,12,0.5,1,4,0.25,4,5,0.8,1,4,5
3024,Goran Dragic,30-252,G,1/13/17,MIA,@,MIL,L,1,34,6,13,0.462,5,8,0.625,1,5,0.2,6,6,1,0,3,3
3025,Andre Drummond,23-087,C,11/5/16,DET,,DEN,W,1,34,6,11,0.545,6,11,0.545,0,0,,7,11,0.636,3,16,19
3026,Andre Drummond,23-202,C,2/28/17,DET,,POR,W,1,30,8,14,0.571,8,14,0.571,0,0,,3,8,0.375,8,7,15
3027,Jared Dudley,31-122,F-G,11/9/16,PHO,,DET,W,0,30,6,9,0.667,2,3,0.667,4,6,0.667,3,4,0.75,0,5,5
3028,Kevin Durant,28-092,F-G,12/30/16,GSW,,DAL,W,1,35,7,14,0.5,5,7,0.714,2,7,0.286,3,4,0.75,0,11,11
3029,Wayne Ellington,29-134,G,3/12/17,MIA,@,IND,L,0,27,7,13,0.538,2,2,1,5,11,0.455,0,0,,0,1,1
3030,Wayne Ellington,29-039,G,12/7/16,MIA,@,ATL,L,1,41,7,15,0.467,3,6,0.5,4,9,0.444,1,1,1,0,3,3
3031,Wayne Ellington,29-091,G,1/28/17,MIA,,DET,W,0,34,7,10,0.7,2,3,0.667,5,7,0.714,0,0,,0,0,0
3032,Wayne Ellington,29-137,G,3/15/17,MIA,,NOP,W,0,22,7,10,0.7,2,2,1,5,8,0.625,0,0,,0,2,2
3033,Monta Ellis,31-000,G,10/26/16,IND,,DAL,W,1,44,7,11,0.636,6,9,0.667,1,2,0.5,4,4,1,0,7,7
3034,Monta Ellis,31-016,G,11/11/16,IND,@,PHI,L,0,36,8,19,0.421,8,17,0.471,0,2,0,3,3,1,0,6,6
3035,Monta Ellis,31-028,G,11/23/16,IND,,ATL,L,1,34,8,16,0.5,6,12,0.5,2,4,0.5,1,2,0.5,0,3,3
3036,Kenneth Faried,27-021,F,12/10/16,DEN,@,ORL,W,0,24,9,10,0.9,9,10,0.9,0,0,,1,3,0.333,3,7,10
3037,Kenneth Faried,27-076,F,2/3/17,DEN,,MIL,W,1,25,6,8,0.75,6,8,0.75,0,0,,7,12,0.583,6,5,11
3038,Derrick Favors,25-231,F-C,3/3/17,UTA,,BRK,W,1,34,8,9,0.889,7,8,0.875,1,1,1,2,3,0.667,1,11,12
3039,Derrick Favors,25-224,F-C,2/24/17,UTA,@,MIL,W,1,26,9,14,0.643,9,14,0.643,0,0,,1,1,1,2,5,7
3040,Yogi Ferrell,23-266,G,1/30/17,DAL,,CLE,W,1,38,7,15,0.467,4,9,0.444,3,6,0.5,2,2,1,0,5,5
3041,Evan Fournier,24-071,G-F,1/8/17,ORL,@,LAL,L,1,34,6,16,0.375,4,12,0.333,2,4,0.5,5,7,0.714,1,4,5
3042,Evan Fournier,24-142,G-F,3/20/17,ORL,,PHI,W,1,37,6,12,0.5,5,7,0.714,1,5,0.2,6,10,0.6,1,3,4
3043,Danilo Gallinari,28-097,F,11/13/16,DEN,@,POR,L,1,29,7,13,0.538,4,8,0.5,3,5,0.6,2,2,1,2,5,7
3044,Danilo Gallinari,28-147,F,1/2/17,DEN,@,GSW,L,1,32,7,15,0.467,5,8,0.625,2,7,0.286,3,4,0.75,1,7,8
3045,Danilo Gallinari,28-087,F,11/3/16,DEN,@,MIN,W,1,37,6,9,0.667,2,2,1,4,7,0.571,3,3,1,0,5,5
3046,Langston Galloway,24-365,G,12/8/16,NOP,,PHI,L,0,28,8,16,0.5,5,10,0.5,3,6,0.5,0,1,0,1,3,4
3047,Marc Gasol,32-015,C,2/13/17,MEM,@,BRK,W,1,37,6,17,0.353,6,13,0.462,0,4,0,7,7,1,1,9,10
3048,Marc Gasol,31-309,C,12/3/16,MEM,,LAL,W,1,34,9,18,0.5,8,15,0.533,1,3,0.333,0,0,,0,3,3
3049,Marc Gasol,32-010,C,2/8/17,MEM,,PHO,W,1,35,6,11,0.545,5,9,0.556,1,2,0.5,6,6,1,1,6,7
3050,Marc Gasol,31-304,C,11/28/16,MEM,,CHO,L,1,32,8,15,0.533,6,11,0.545,2,4,0.5,1,1,1,1,7,8
3051,Marc Gasol,31-316,C,12/10/16,MEM,,GSW,W,1,32,6,12,0.5,5,9,0.556,1,3,0.333,6,7,0.857,1,7,8
3052,Marc Gasol,31-284,C,11/8/16,MEM,,DEN,W,1,30,9,14,0.643,9,13,0.692,0,1,0,1,3,0.333,0,2,2
3053,Pau Gasol,36-149,F-C,12/2/16,SAS,,WAS,W,1,34,8,16,0.5,7,14,0.5,1,2,0.5,2,8,0.25,4,6,10
3054,Rudy Gay,30-112,F,12/7/16,SAC,@,DAL,W,1,31,8,14,0.571,7,11,0.636,1,3,0.333,2,2,1,1,2,3
3055,Paul George,26-259,F,1/16/17,IND,,NOP,W,1,34,6,17,0.353,4,11,0.364,2,6,0.333,5,5,1,0,5,5
3056,Paul George,26-234,F,12/22/16,IND,,BOS,L,1,41,5,16,0.313,5,13,0.385,0,3,0,9,10,0.9,1,7,8
3057,Paul George,26-322,F,3/20/17,IND,,UTA,W,1,36,6,20,0.3,4,13,0.308,2,7,0.286,5,5,1,0,8,8
3058,Paul George,26-250,F,1/7/17,IND,,NYK,W,1,28,7,16,0.438,6,12,0.5,1,4,0.25,4,4,1,0,3,3
3059,Paul George,26-244,F,1/1/17,IND,,ORL,W,1,31,5,13,0.385,2,8,0.25,3,5,0.6,6,7,0.857,1,4,5
3060,Paul George,26-264,F,1/21/17,IND,@,UTA,L,1,29,8,16,0.5,5,11,0.455,3,5,0.6,0,0,,0,4,4
3061,Taj Gibson,31-174,F,12/15/16,CHI,@,MIL,L,1,24,7,11,0.636,7,11,0.636,0,0,,5,6,0.833,2,2,4
3062,Manu Ginobili,39-223,G,3/8/17,SAS,,SAC,W,0,25,7,15,0.467,4,8,0.5,3,7,0.429,2,2,1,0,4,4
3063,Rudy Gobert,24-150,C,11/23/16,UTA,,DEN,W,1,32,6,8,0.75,6,8,0.75,0,0,,7,12,0.583,2,11,13
3064,Rudy Gobert,24-209,C,1/21/17,UTA,,IND,W,1,33,8,10,0.8,8,10,0.8,0,0,,3,5,0.6,5,6,11
3065,Rudy Gobert,24-202,C,1/14/17,UTA,,ORL,W,1,36,7,9,0.778,7,9,0.778,0,0,,5,7,0.714,5,14,19
3066,Eric Gordon,27-306,G,10/26/16,HOU,@,LAL,L,1,34,7,15,0.467,5,7,0.714,2,8,0.25,3,4,0.75,0,5,5
3067,Eric Gordon,28-014,G,1/8/17,HOU,@,TOR,W,0,33,7,16,0.438,6,7,0.857,1,9,0.111,4,4,1,0,4,4
3068,Eric Gordon,28-060,G,2/23/17,HOU,@,NOP,W,0,30,5,16,0.313,1,2,0.5,4,14,0.286,5,5,1,0,1,1
3069,Eric Gordon,27-346,G,12/5/16,HOU,,BOS,W,0,31,6,11,0.545,2,2,1,4,9,0.444,3,4,0.75,0,1,1
3070,Eric Gordon,28-005,G,12/30/16,HOU,,LAC,W,0,24,5,7,0.714,1,2,0.5,4,5,0.8,5,5,1,0,4,4
3071,Marcin Gortat,32-317,C-F,12/30/16,WAS,,BRK,W,1,31,8,13,0.615,8,13,0.615,0,0,,3,4,0.75,2,11,13
3072,Marcin Gortat,32-324,C-F,1/6/17,WAS,,MIN,W,1,33,9,9,1,9,9,1,0,0,,1,2,0.5,2,8,10
3073,Draymond Green,26-341,F,2/8/17,GSW,,CHI,W,1,32,6,8,0.75,1,2,0.5,5,6,0.833,2,2,1,0,8,8
3074,Gerald Green,30-336,G-F,12/27/16,BOS,,MEM,W,0,19,7,10,0.7,4,5,0.8,3,5,0.6,2,2,1,3,2,5
3075,JaMychal Green,26-151,F,11/19/16,MEM,,MIN,W,1,28,6,9,0.667,6,8,0.75,0,1,0,7,8,0.875,3,5,8
3076,Jeff Green,30-108,F,12/14/16,ORL,,LAC,L,0,27,7,11,0.636,3,6,0.5,4,5,0.8,1,1,1,0,3,3
3077,Justin Hamilton,26-208,C,10/26/16,BRK,@,BOS,L,0,25,7,12,0.583,4,6,0.667,3,6,0.5,2,3,0.667,6,4,10
3078,Tim Hardaway,24-319,G,1/29/17,ATL,,NYK,W,1,58,5,20,0.25,5,11,0.455,0,9,0,9,12,0.75,0,5,5
3079,Tim Hardaway,24-355,G,3/6/17,ATL,,GSW,L,0,33,7,15,0.467,6,9,0.667,1,6,0.167,4,6,0.667,2,2,4
3080,James Harden,27-196,G,3/10/17,HOU,@,CHI,W,1,33,6,16,0.375,3,7,0.429,3,9,0.333,4,5,0.8,0,7,7
3081,Maurice Harkless,23-190,F-G,11/17/16,POR,@,HOU,L,1,31,8,12,0.667,5,8,0.625,3,4,0.75,0,0,,2,4,6
3082,Maurice Harkless,23-198,F-G,11/25/16,POR,,NOP,W,1,29,8,13,0.615,7,10,0.7,1,3,0.333,2,4,0.5,5,6,11
3083,Gary Harris,22-165,G,2/26/17,DEN,,MEM,L,1,34,8,16,0.5,5,8,0.625,3,8,0.375,0,0,,2,1,3
3084,Joe Harris,25-102,G,12/18/16,BRK,@,PHI,L,0,28,7,13,0.538,2,4,0.5,5,9,0.556,0,0,,0,2,2
3085,Joe Harris,25-066,G,11/12/16,BRK,@,PHO,W,0,24,6,10,0.6,1,2,0.5,5,8,0.625,2,2,1,2,0,2
3086,Tobias Harris,24-124,F,11/16/16,DET,@,NYK,L,1,39,6,13,0.462,5,9,0.556,1,4,0.25,6,6,1,2,8,10
3087,Tobias Harris,24-187,F,1/18/17,DET,,ATL,W,1,27,7,12,0.583,3,6,0.5,4,6,0.667,1,2,0.5,0,5,5
3088,Tobias Harris,24-120,F,11/12/16,DET,@,DEN,W,1,36,8,15,0.533,7,13,0.538,1,2,0.5,2,2,1,1,3,4
3089,Tobias Harris,24-201,F,2/1/17,DET,,NOP,W,0,28,9,13,0.692,9,11,0.818,0,2,0,1,1,1,0,8,8
3090,Tobias Harris,24-127,F,11/19/16,DET,,BOS,L,1,42,7,16,0.438,6,12,0.5,1,4,0.25,4,4,1,0,2,2
3091,Tobias Harris,24-208,F,2/8/17,DET,,LAL,W,0,24,7,12,0.583,5,9,0.556,2,3,0.667,3,5,0.6,0,5,5
3092,Gordon Hayward,26-342,F-G,2/28/17,UTA,@,OKC,L,1,33,7,17,0.412,4,11,0.364,3,6,0.5,2,2,1,1,1,2
3093,Gerald Henderson,28-348,G,11/21/16,PHI,,MIA,W,1,32,6,8,0.75,3,5,0.6,3,3,1,4,4,1,0,3,3
3094,George Hill,30-248,G,1/7/17,UTA,@,MIN,W,1,33,5,12,0.417,3,8,0.375,2,4,0.5,7,7,1,2,3,5
3095,George Hill,30-280,G,2/8/17,UTA,@,NOP,W,1,25,6,11,0.545,4,5,0.8,2,6,0.333,5,8,0.625,0,1,1
3096,George Hill,30-174,G,10/25/16,UTA,@,POR,L,1,39,7,18,0.389,6,12,0.5,1,6,0.167,4,4,1,0,2,2
3097,George Hill,30-296,G,2/24/17,UTA,@,MIL,W,1,34,4,6,0.667,1,2,0.5,3,4,0.75,8,8,1,0,1,1
3098,George Hill,30-287,G,2/15/17,UTA,,POR,W,1,31,7,15,0.467,5,10,0.5,2,5,0.4,3,4,0.75,0,5,5
3099,George Hill,30-313,G,3/13/17,UTA,,LAC,W,1,37,7,15,0.467,5,11,0.455,2,4,0.5,3,5,0.6,0,8,8
3100,Jrue Holiday,26-278,G,3/17/17,NOP,,HOU,W,1,28,9,17,0.529,9,12,0.75,0,5,0,1,2,0.5,0,3,3
3101,Jrue Holiday,26-248,G,2/15/17,NOP,@,MEM,W,1,33,8,13,0.615,6,10,0.6,2,3,0.667,1,4,0.25,2,5,7
3102,Rondae Hollis-Jefferson,21-352,F,12/20/16,BRK,@,TOR,L,0,20,8,15,0.533,7,14,0.5,1,1,1,2,3,0.667,1,5,6
3103,Rodney Hood,24-040,G-F,11/29/16,UTA,,HOU,W,1,20,7,15,0.467,4,9,0.444,3,6,0.5,2,2,1,0,2,2
3104,Rodney Hood,24-139,G-F,3/8/17,UTA,@,HOU,W,1,35,8,14,0.571,6,9,0.667,2,5,0.4,1,1,1,1,5,6
3105,Rodney Hood,24-012,G-F,11/1/16,UTA,@,SAS,W,1,33,6,13,0.462,2,5,0.4,4,8,0.5,3,3,1,0,5,5
3106,Al Horford,30-191,C-F,12/11/16,BOS,@,OKC,L,1,33,8,17,0.471,5,9,0.556,3,8,0.375,0,0,,1,3,4
3107,Al Horford,30-189,C-F,12/9/16,BOS,,TOR,L,1,32,5,14,0.357,2,6,0.333,3,8,0.375,6,9,0.667,1,6,7
3108,Al Horford,30-217,C-F,1/6/17,BOS,,PHI,W,1,32,7,15,0.467,3,8,0.375,4,7,0.571,1,2,0.5,5,7,12
3109,Dwight Howard,31-052,C,1/29/17,ATL,,NYK,W,1,38,8,11,0.727,8,11,0.727,0,0,,3,7,0.429,4,8,12
3110,Dwight Howard,31-067,C,2/13/17,ATL,@,POR,W,1,38,5,7,0.714,5,6,0.833,0,1,0,9,16,0.563,4,12,16
3111,Dwight Howard,30-355,C,11/27/16,ATL,@,LAL,L,1,33,9,13,0.692,9,13,0.692,0,0,,1,5,0.2,3,6,9
3112,Serge Ibaka,27-041,F-C,10/29/16,ORL,@,CLE,L,1,31,7,12,0.583,7,12,0.583,0,0,,5,7,0.714,3,4,7
3113,Serge Ibaka,27-070,F-C,11/27/16,ORL,,MIL,L,1,33,8,17,0.471,7,13,0.538,1,4,0.25,2,2,1,0,6,6
3114,Serge Ibaka,27-068,F-C,11/25/16,ORL,,WAS,L,1,31,8,13,0.615,6,9,0.667,2,4,0.5,1,1,1,2,6,8
3115,Serge Ibaka,27-096,F-C,12/23/16,ORL,,LAL,W,1,30,8,15,0.533,7,11,0.636,1,4,0.25,2,3,0.667,3,8,11
3116,Serge Ibaka,27-112,F-C,1/8/17,ORL,@,LAL,L,1,38,8,17,0.471,7,14,0.5,1,3,0.333,2,2,1,6,4,10
3117,Serge Ibaka,27-167,F-C,3/4/17,TOR,@,MIL,L,1,36,7,11,0.636,5,9,0.556,2,2,1,3,3,1,0,5,5
3118,Ersan Ilyasova,29-233,F,1/3/17,PHI,,MIN,W,1,32,7,14,0.5,4,6,0.667,3,8,0.375,2,2,1,1,4,5
3119,Kyrie Irving,24-235,G,11/13/16,CLE,,CHO,W,1,27,8,17,0.471,7,12,0.583,1,5,0.2,2,2,1,2,1,3
3120,Reggie Jackson,26-269,G,1/10/17,DET,@,SAC,L,1,31,8,15,0.533,5,10,0.5,3,5,0.6,0,1,0,0,2,2
3121,Reggie Jackson,26-245,G,12/17/16,DET,,IND,L,1,29,6,15,0.4,5,11,0.455,1,4,0.25,6,6,1,0,3,3
3122,Reggie Jackson,26-280,G,1/21/17,DET,,WAS,W,1,32,8,21,0.381,7,17,0.412,1,4,0.25,2,2,1,0,3,3
3123,Reggie Jackson,26-329,G,3/11/17,DET,,NYK,W,1,30,7,14,0.5,3,8,0.375,4,6,0.667,1,1,1,0,3,3
3124,LeBron James,31-300,F-G,10/25/16,CLE,,NYK,W,1,32,9,14,0.643,9,11,0.818,0,3,0,1,2,0.5,3,8,11
3125,LeBron James,31-319,F-G,11/13/16,CLE,,CHO,W,1,39,8,21,0.381,6,16,0.375,2,5,0.4,1,2,0.5,0,8,8
3126,LeBron James,31-331,F-G,11/25/16,CLE,,DAL,W,1,29,6,13,0.462,4,8,0.5,2,5,0.4,5,5,1,0,5,5
3127,LeBron James,31-307,F-G,11/1/16,CLE,,HOU,W,1,36,6,12,0.5,5,9,0.556,1,3,0.333,6,10,0.6,3,10,13
3128,LeBron James,31-359,F-G,12/23/16,CLE,,BRK,W,1,27,7,16,0.438,7,13,0.538,0,3,0,5,6,0.833,1,4,5
3129,Brandon Jennings,27-079,G,12/11/16,NYK,@,LAL,W,0,23,5,11,0.455,2,7,0.286,3,4,0.75,6,6,1,0,3,3
3130,Brandon Jennings,27-072,G,12/4/16,NYK,,SAC,W,0,26,5,7,0.714,3,3,1,2,4,0.5,7,7,1,0,1,1
3131,James Johnson,29-306,F,12/22/16,MIA,,LAL,W,0,26,8,11,0.727,5,6,0.833,3,5,0.6,0,2,0,0,8,8
3132,James Johnson,30-011,F,3/3/17,MIA,@,ORL,L,0,34,9,14,0.643,8,11,0.727,1,3,0.333,0,0,,3,1,4
3133,Tyler Johnson,24-237,G,12/30/16,MIA,@,BOS,L,0,29,8,13,0.615,7,10,0.7,1,3,0.333,2,2,1,0,4,4
3134,Nikola Jokic,21-337,C-F,1/21/17,DEN,,LAC,W,1,21,8,11,0.727,6,8,0.75,2,3,0.667,1,1,1,3,7,10
3135,Nikola Jokic,22-009,C-F,2/28/17,DEN,@,CHI,W,1,33,6,10,0.6,3,7,0.429,3,3,1,4,4,1,2,14,16
3136,Nikola Jokic,21-321,C-F,1/5/17,DEN,,SAS,L,1,27,8,10,0.8,8,10,0.8,0,0,,3,4,0.75,5,6,11
3137,Terrence Jones,24-300,F,11/4/16,NOP,,PHO,L,1,28,9,14,0.643,8,11,0.727,1,3,0.333,0,4,0,2,5,7
3138,DeAndre Jordan,28-179,C,1/16/17,LAC,,OKC,W,1,30,7,8,0.875,7,8,0.875,0,0,,5,8,0.625,5,10,15
3139,DeAndre Jordan,28-102,C,10/31/16,LAC,,PHO,W,1,31,8,10,0.8,8,10,0.8,0,0,,3,6,0.5,3,8,11
3140,DeAndre Jordan,28-233,C,3/11/17,LAC,,PHI,W,1,36,6,7,0.857,6,7,0.857,0,0,,7,10,0.7,5,15,20
3141,DeAndre Jordan,28-142,C,12/10/16,LAC,,NOP,W,1,23,9,11,0.818,9,11,0.818,0,0,,1,1,1,5,4,9
3142,Cory Joseph,25-213,G,3/21/17,TOR,,CHI,W,1,43,6,11,0.545,5,7,0.714,1,4,0.25,6,7,0.857,1,0,1
3143,Enes Kanter,24-208,C,12/14/16,OKC,@,UTA,L,0,18,6,11,0.545,6,11,0.545,0,0,,7,8,0.875,1,1,2
3144,Enes Kanter,24-223,C,12/29/16,OKC,@,MEM,L,0,24,7,11,0.636,7,10,0.7,0,1,0,5,7,0.714,0,5,5
3145,Enes Kanter,24-236,C,1/11/17,OKC,,MEM,W,0,30,8,18,0.444,8,16,0.5,0,2,0,3,3,1,3,9,12
3146,Enes Kanter,24-221,C,12/27/16,OKC,@,MIA,W,0,33,9,16,0.563,9,15,0.6,0,1,0,1,4,0.25,5,3,8
3147,Sean Kilpatrick,26-332,G,12/3/16,BRK,@,MIL,L,1,29,3,13,0.231,2,8,0.25,1,5,0.2,12,13,0.923,0,1,1
3148,Sean Kilpatrick,26-311,G,11/12/16,BRK,@,PHO,W,1,32,7,16,0.438,4,8,0.5,3,8,0.375,2,3,0.667,0,9,9
3149,Sean Kilpatrick,26-303,G,11/4/16,BRK,,CHO,L,0,33,5,15,0.333,3,8,0.375,2,7,0.286,7,10,0.7,0,4,4
3150,Brandon Knight,24-331,G,10/28/16,PHO,@,OKC,L,0,35,7,18,0.389,6,12,0.5,1,6,0.167,4,4,1,1,5,6
3151,Kyle Korver,35-274,G-F,12/16/16,ATL,@,TOR,W,0,23,6,10,0.6,0,0,,6,10,0.6,1,1,1,0,3,3
3152,Mindaugas Kuzminskas,27-085,F,1/12/17,NYK,,CHI,W,0,30,8,15,0.533,6,11,0.545,2,4,0.5,1,1,1,3,1,4
3153,Jeremy Lamb,24-272,G-F,2/26/17,CHO,@,LAC,L,0,37,5,10,0.5,4,7,0.571,1,3,0.333,8,8,1,1,5,6
3154,Zach LaVine,21-230,G,10/26/16,MIN,@,MEM,L,1,34,6,14,0.429,3,8,0.375,3,6,0.5,4,5,0.8,0,5,5
3155,Zach LaVine,21-250,G,11/15/16,MIN,,CHO,L,1,33,7,16,0.438,2,6,0.333,5,10,0.5,0,0,,0,2,2
3156,Ty Lawson,29-081,G,1/23/17,SAC,@,DET,W,0,23,7,11,0.636,6,9,0.667,1,2,0.5,4,4,1,2,1,3
3157,Ty Lawson,29-122,G,3/5/17,SAC,,UTA,L,1,37,7,13,0.538,6,10,0.6,1,3,0.333,4,5,0.8,0,4,4
3158,Ty Lawson,29-048,G,12/21/16,SAC,@,UTA,W,0,26,7,11,0.636,7,10,0.7,0,1,0,5,8,0.625,0,5,5
3159,Kawhi Leonard,25-150,F,11/26/16,SAS,@,WAS,W,1,36,5,14,0.357,4,8,0.5,1,6,0.167,8,10,0.8,0,1,1
3160,Kawhi Leonard,25-220,F,2/4/17,SAS,,DEN,W,1,32,6,13,0.462,5,7,0.714,1,6,0.167,6,8,0.75,1,5,6
3161,Kawhi Leonard,25-218,F,2/2/17,SAS,,PHI,W,1,25,8,17,0.471,8,15,0.533,0,2,0,3,5,0.6,4,4,8
3162,Kawhi Leonard,25-192,F,1/7/17,SAS,,CHO,W,1,33,7,18,0.389,4,8,0.5,3,10,0.3,2,2,1,0,2,2
3163,Kawhi Leonard,25-253,F,3/9/17,SAS,@,OKC,L,1,26,6,15,0.4,6,13,0.462,0,2,0,7,7,1,1,1,2
3164,Jon Leuer,27-214,F,12/14/16,DET,@,DAL,W,0,31,8,9,0.889,8,9,0.889,0,0,,3,3,1,1,4,5
3165,Caris LeVert,22-134,G-F,1/6/17,BRK,,CLE,L,0,27,7,12,0.583,5,5,1,2,7,0.286,3,3,1,0,4,4
3166,Damian Lillard,26-232,G,3/4/17,POR,,BRK,W,1,36,7,16,0.438,5,10,0.5,2,6,0.333,3,4,0.75,0,5,5
3167,Damian Lillard,26-146,G,12/8/16,POR,@,MEM,L,1,36,6,18,0.333,4,11,0.364,2,7,0.286,5,7,0.714,1,2,3
3168,Damian Lillard,26-114,G,11/6/16,POR,@,MEM,W,1,33,3,11,0.273,1,3,0.333,2,8,0.25,11,11,1,1,6,7
3169,Damian Lillard,26-141,G,12/3/16,POR,,MIA,W,1,35,6,19,0.316,4,13,0.308,2,6,0.333,5,6,0.833,0,4,4
3170,Damian Lillard,26-198,G,1/29/17,POR,,GSW,L,1,36,6,14,0.429,4,9,0.444,2,5,0.4,5,5,1,0,2,2
3171,Damian Lillard,26-123,G,11/15/16,POR,,CHI,L,1,38,7,22,0.318,6,17,0.353,1,5,0.2,4,4,1,1,4,5
3172,Robin Lopez,28-329,C,2/24/17,CHI,,PHO,W,1,36,8,15,0.533,8,15,0.533,0,0,,3,3,1,1,5,6
3173,Kevin Love,28-052,F,10/29/16,CLE,,ORL,W,1,33,6,17,0.353,6,12,0.5,0,5,0,7,7,1,3,2,5
3174,Kevin Love,28-069,F,11/15/16,CLE,,TOR,W,1,35,5,16,0.313,4,9,0.444,1,7,0.143,8,9,0.889,4,9,13
3175,Kyle Lowry,30-231,G,11/11/16,TOR,@,CHO,W,1,36,7,16,0.438,5,8,0.625,2,8,0.25,3,3,1,1,7,8
3176,Kyle Lowry,30-245,G,11/25/16,TOR,@,MIL,W,1,37,7,15,0.467,3,7,0.429,4,8,0.5,1,1,1,1,4,5
3177,Kyle Lowry,30-229,G,11/9/16,TOR,@,OKC,W,1,43,6,20,0.3,1,9,0.111,5,11,0.455,2,2,1,2,7,9
3178,Trey Lyles,21-048,F,12/23/16,UTA,,TOR,L,0,30,6,13,0.462,2,7,0.286,4,6,0.667,3,4,0.75,1,6,7
3179,Shelvin Mack,26-230,G,12/8/16,UTA,,GSW,L,1,37,6,16,0.375,5,8,0.625,1,8,0.125,6,6,1,0,2,2
3180,Wesley Matthews,30-074,G,12/27/16,DAL,,HOU,L,1,29,7,13,0.538,4,6,0.667,3,7,0.429,2,2,1,0,1,1
3181,Wesley Matthews,30-093,G,1/15/17,DAL,,MIN,W,1,35,7,15,0.467,3,7,0.429,4,8,0.5,1,2,0.5,0,7,7
3182,Patrick McCaw,21-111,G,2/13/17,GSW,@,DEN,L,1,35,8,13,0.615,7,8,0.875,1,5,0.2,2,2,1,0,1,1
3183,C.J. McCollum,25-072,G,11/30/16,POR,,IND,W,1,34,7,18,0.389,5,12,0.417,2,6,0.333,3,3,1,3,2,5
3184,C.J. McCollum,25-139,G,2/5/17,POR,@,OKC,L,1,31,7,15,0.467,5,9,0.556,2,6,0.333,3,3,1,0,8,8
3185,Khris Middleton,25-203,F-G,3/3/17,MIL,,LAC,W,1,33,6,13,0.462,5,9,0.556,1,4,0.25,6,6,1,0,4,4
3186,C.J. Miles,29-199,G-F,11/3/16,IND,@,MIL,L,0,24,6,10,0.6,4,6,0.667,2,4,0.5,5,6,0.833,1,2,3
3187,C.J. Miles,29-248,G-F,12/22/16,IND,,BOS,L,0,27,7,13,0.538,5,7,0.714,2,6,0.333,3,4,0.75,0,2,2
3188,C.J. Miles,29-317,G-F,3/1/17,IND,@,SAS,L,1,28,7,15,0.467,3,5,0.6,4,10,0.4,1,1,1,1,5,6
3189,Patty Mills,28-106,G,11/25/16,SAS,@,BOS,W,0,24,6,8,0.75,4,5,0.8,2,3,0.667,5,5,1,0,1,1
3190,Paul Millsap,31-284,F,11/20/16,ATL,@,NYK,L,1,38,8,17,0.471,6,13,0.462,2,4,0.5,1,3,0.333,1,6,7
3191,Paul Millsap,31-348,F,1/23/17,ATL,,LAC,L,1,38,5,16,0.313,3,9,0.333,2,7,0.286,7,8,0.875,2,6,8
3192,Greg Monroe,26-216,C-F,1/6/17,MIL,,NYK,L,0,28,6,11,0.545,6,11,0.545,0,0,,7,10,0.7,2,5,7
3193,Marcus Morris,27-157,F,2/6/17,DET,,PHI,W,1,39,9,16,0.563,9,13,0.692,0,3,0,1,1,1,3,5,8
3194,Marcus Morris,27-155,F,2/4/17,DET,@,IND,L,1,34,5,11,0.455,2,8,0.25,3,3,1,6,6,1,1,5,6
3195,Markieff Morris,27-130,F,1/10/17,WAS,,CHI,W,1,22,8,12,0.667,5,9,0.556,3,3,1,0,0,,1,4,5
3196,Markieff Morris,27-144,F,1/24/17,WAS,,BOS,W,1,34,6,14,0.429,5,10,0.5,1,4,0.25,6,7,0.857,2,9,11
3197,Markieff Morris,27-141,F,1/21/17,WAS,@,DET,L,1,38,7,17,0.412,5,12,0.417,2,5,0.4,3,4,0.75,4,5,9
3198,Markieff Morris,27-075,F,11/16/16,WAS,@,PHI,L,1,31,7,15,0.467,4,10,0.4,3,5,0.6,2,2,1,2,2,4
3199,Markieff Morris,27-089,F,11/30/16,WAS,@,OKC,L,1,37,7,16,0.438,7,14,0.5,0,2,0,5,8,0.625,1,6,7
3200,Timofey Mozgov,30-162,C,12/25/16,LAL,,LAC,W,1,25,8,11,0.727,8,11,0.727,0,0,,3,4,0.75,2,1,3
3201,Emmanuel Mudiay,20-267,G,11/27/16,DEN,@,PHO,W,1,37,5,13,0.385,4,10,0.4,1,3,0.333,8,10,0.8,1,3,4
3202,Emmanuel Mudiay,20-252,G,11/12/16,DEN,,DET,L,1,26,6,14,0.429,2,6,0.333,4,8,0.5,3,4,0.75,2,3,5
3203,Jamal Murray,19-264,G,11/13/16,DEN,@,POR,L,1,28,6,12,0.5,1,3,0.333,5,9,0.556,2,3,0.667,0,5,5
3204,Nerlens Noel,22-307,C-F,2/11/17,PHI,,MIA,W,1,32,9,12,0.75,9,11,0.818,0,1,0,1,3,0.333,3,0,3
3205,Nerlens Noel,22-289,C-F,1/24/17,PHI,,LAC,W,1,29,8,10,0.8,8,10,0.8,0,0,,3,3,1,1,7,8
3206,Dirk Nowitzki,38-220,F,1/25/17,DAL,,NYK,W,1,25,8,12,0.667,8,10,0.8,0,2,0,3,3,1,2,2,4
3207,Dirk Nowitzki,38-214,F,1/19/17,DAL,@,MIA,L,1,29,7,16,0.438,5,10,0.5,2,6,0.333,3,5,0.6,0,4,4
3208,Jusuf Nurkic,22-189,C,2/28/17,POR,@,DET,L,1,35,7,12,0.583,7,12,0.583,0,0,,5,7,0.714,3,4,7
3209,Jahlil Okafor,20-337,C-F,11/16/16,PHI,,WAS,W,1,20,8,11,0.727,8,11,0.727,0,0,,3,4,0.75,0,5,5
3210,Victor Oladipo,24-254,G,1/13/17,OKC,@,MIN,L,1,33,8,18,0.444,7,14,0.5,1,4,0.25,2,2,1,2,3,5
3211,Kelly Olynyk,25-206,C-F,11/11/16,BOS,,NYK,W,1,30,6,11,0.545,3,6,0.5,3,5,0.6,4,4,1,2,5,7
3212,Kelly Olynyk,25-298,C-F,2/11/17,BOS,@,UTA,W,0,27,8,11,0.727,5,6,0.833,3,5,0.6,0,2,0,0,7,7
3213,Kelly Olynyk,25-225,C-F,11/30/16,BOS,,DET,L,0,26,7,9,0.778,4,5,0.8,3,4,0.75,2,2,1,1,2,3
3214,Kelly Oubre,21-001,F,12/10/16,WAS,,MIL,W,0,29,7,11,0.636,4,5,0.8,3,6,0.5,2,2,1,1,8,9
3215,Jabari Parker,21-293,F,1/2/17,MIL,,OKC,W,1,41,7,17,0.412,5,13,0.385,2,4,0.5,3,4,0.75,2,4,6
3216,Jabari Parker,21-235,F,11/5/16,MIL,,SAC,W,1,25,6,14,0.429,6,12,0.5,0,2,0,7,7,1,3,3,6
3217,Tony Parker,34-293,G,3/6/17,SAS,,HOU,W,1,28,7,14,0.5,4,8,0.5,3,6,0.5,2,2,1,0,5,5
3218,Chris Paul,31-187,G,11/9/16,LAC,,POR,W,1,23,7,14,0.5,4,8,0.5,3,6,0.5,2,2,1,1,3,4
3219,Chris Paul,31-197,G,11/19/16,LAC,,CHI,W,1,34,7,14,0.5,4,9,0.444,3,5,0.6,2,3,0.667,3,1,4
3220,Chris Paul,31-230,G,12/22/16,LAC,,SAS,W,1,23,6,11,0.545,4,9,0.444,2,2,1,5,6,0.833,0,6,6
3221,Chris Paul,31-307,G,3/9/17,LAC,@,MEM,W,1,27,8,15,0.533,5,9,0.556,3,6,0.5,0,0,,1,3,4
3222,Chris Paul,31-190,G,11/12/16,LAC,@,MIN,W,1,32,4,7,0.571,1,3,0.333,3,4,0.75,8,8,1,0,4,4
3223,Chris Paul,31-247,G,1/8/17,LAC,,MIA,W,1,29,7,11,0.636,6,8,0.75,1,3,0.333,4,5,0.8,1,5,6
3224,Elfrid Payton,22-326,G,1/13/17,ORL,@,POR,W,1,35,8,18,0.444,7,15,0.467,1,3,0.333,2,2,1,2,2,4
3225,Mason Plumlee,26-285,C-F,12/15/16,POR,@,DEN,L,1,28,8,10,0.8,8,10,0.8,0,0,,3,7,0.429,3,4,7
3226,Mason Plumlee,26-263,C-F,11/23/16,POR,@,CLE,L,1,23,9,10,0.9,9,10,0.9,0,0,,1,2,0.5,2,2,4
3227,Mason Plumlee,26-326,C-F,1/25/17,POR,,LAL,W,1,34,8,15,0.533,8,15,0.533,0,0,,3,6,0.5,2,11,13
3228,Mason Plumlee,27-003,C-F,3/8/17,DEN,,WAS,L,1,31,7,13,0.538,7,13,0.538,0,0,,5,7,0.714,6,4,10
3229,Mason Plumlee,26-244,C-F,11/4/16,POR,@,DAL,W,1,34,7,9,0.778,7,9,0.778,0,0,,5,5,1,1,3,4
3230,Otto Porter,23-175,F,11/25/16,WAS,@,ORL,W,1,34,8,15,0.533,5,7,0.714,3,8,0.375,0,0,,2,5,7
3231,Bobby Portis,22-006,F,2/16/17,CHI,,BOS,W,0,26,8,13,0.615,7,9,0.778,1,4,0.25,2,2,1,1,7,8
3232,Kristaps Porzingis,21-110,F-C,11/20/16,NYK,,ATL,W,1,31,8,15,0.533,7,10,0.7,1,5,0.2,2,4,0.5,1,10,11
3233,Kristaps Porzingis,21-183,F-C,2/1/17,NYK,@,BRK,W,1,26,7,15,0.467,6,11,0.545,1,4,0.25,4,7,0.571,4,8,12
3234,Kristaps Porzingis,21-222,F-C,3/12/17,NYK,@,BRK,L,1,34,7,16,0.438,5,10,0.5,2,6,0.333,3,4,0.75,2,8,10
3235,Norman Powell,23-171,G,11/12/16,TOR,,NYK,W,1,29,4,10,0.4,1,4,0.25,3,6,0.5,8,8,1,0,5,5
3236,Norman Powell,23-292,G,3/13/17,TOR,,DAL,W,1,31,6,8,0.75,4,4,1,2,4,0.5,5,5,1,0,5,5
3237,Norman Powell,23-247,G,1/27/17,TOR,,MIL,W,1,31,7,15,0.467,5,12,0.417,2,3,0.667,3,3,1,1,5,6
3238,Julius Randle,22-040,F,1/8/17,LAL,,ORL,W,1,34,6,12,0.5,5,11,0.455,1,1,1,6,8,0.75,1,8,9
3239,Julius Randle,22-035,F,1/3/17,LAL,,MEM,W,1,37,9,15,0.6,9,15,0.6,0,0,,1,4,0.25,2,12,14
3240,Julius Randle,22-112,F,3/21/17,LAL,,LAC,L,1,31,7,13,0.538,6,11,0.545,1,2,0.5,4,5,0.8,3,4,7
3241,Zach Randolph,35-102,F,10/26/16,MEM,,MIN,W,0,25,7,12,0.583,6,10,0.6,1,2,0.5,4,6,0.667,1,10,11
3242,J.J. Redick,32-171,G,12/12/16,LAC,,POR,W,1,28,5,11,0.455,4,7,0.571,1,4,0.25,8,8,1,0,0,0
3243,J.J. Redick,32-196,G,1/6/17,LAC,@,SAC,W,1,32,6,13,0.462,1,4,0.25,5,9,0.556,2,3,0.667,0,4,4
3244,J.J. Redick,32-194,G,1/4/17,LAC,,MEM,W,1,37,5,13,0.385,3,5,0.6,2,8,0.25,7,8,0.875,0,3,3
3245,Josh Richardson,23-061,G,11/15/16,MIA,,ATL,L,1,38,8,14,0.571,7,11,0.636,1,3,0.333,2,2,1,1,3,4
3246,Josh Richardson,23-106,G,12/30/16,MIA,@,BOS,L,1,35,8,17,0.471,6,12,0.5,2,5,0.4,1,1,1,2,4,6
3247,Austin Rivers,24-206,G,2/23/17,LAC,@,GSW,L,1,37,7,16,0.438,3,7,0.429,4,9,0.444,1,2,0.5,0,2,2
3248,Austin Rivers,24-090,G,10/30/16,LAC,,UTA,W,0,29,8,11,0.727,6,7,0.857,2,4,0.5,1,2,0.5,0,2,2
3249,Austin Rivers,24-147,G,12/26/16,LAC,,DEN,L,1,42,8,17,0.471,6,11,0.545,2,6,0.333,1,1,1,0,3,3
3250,Andre Roberson,25-082,G-F,2/24/17,OKC,,LAL,W,1,29,8,9,0.889,5,6,0.833,3,3,1,0,2,0,2,5,7
3251,Glenn Robinson,23-038,G-F,2/15/17,IND,@,CLE,L,1,26,7,10,0.7,4,5,0.8,3,5,0.6,2,2,1,2,4,6
3252,Rajon Rondo,31-006,G,2/28/17,CHI,,DEN,L,0,24,8,15,0.533,7,12,0.583,1,3,0.333,2,2,1,1,3,4
3253,Derrick Rose,28-148,G,3/1/17,NYK,@,ORL,W,1,33,8,14,0.571,8,13,0.615,0,1,0,3,5,0.6,2,6,8
3254,Derrick Rose,28-028,G,11/1/16,NYK,@,DET,L,1,32,8,17,0.471,8,16,0.5,0,1,0,3,3,1,1,4,5
3255,Derrick Rose,28-079,G,12/22/16,NYK,,ORL,W,1,26,7,16,0.438,6,14,0.429,1,2,0.5,4,4,1,1,4,5
3256,D'Angelo Russell,20-318,G,1/6/17,LAL,,MIA,W,1,26,7,17,0.412,6,13,0.462,1,4,0.25,4,6,0.667,3,3,6
3257,Dario Saric,22-323,F,2/25/17,PHI,@,NYK,L,1,40,7,17,0.412,6,12,0.5,1,5,0.2,4,6,0.667,6,9,15
3258,Dario Saric,22-309,F,2/11/17,PHI,,MIA,W,0,26,7,15,0.467,6,10,0.6,1,5,0.2,4,4,1,2,4,6
3259,Dario Saric,22-330,F,3/4/17,PHI,,DET,L,1,29,7,15,0.467,6,12,0.5,1,3,0.333,4,4,1,1,5,6
3260,Dennis Schroder,23-089,G,12/13/16,ATL,,ORL,L,1,34,7,16,0.438,4,11,0.364,3,5,0.6,2,2,1,0,1,1
3261,Dennis Schroder,23-117,G,1/10/17,ATL,@,BRK,W,1,30,7,14,0.5,5,10,0.5,2,4,0.5,3,3,1,0,1,1
3262,Jonathon Simmons,27-107,G-F,12/30/16,SAS,,POR,W,0,30,5,12,0.417,3,8,0.375,2,4,0.5,7,8,0.875,1,2,3
3263,Marcus Smart,22-344,G,2/13/17,BOS,@,DAL,W,1,35,6,11,0.545,3,4,0.75,3,7,0.429,4,4,1,0,3,3
3264,Marcus Smart,22-355,G,2/24/17,BOS,@,TOR,L,0,32,6,15,0.4,5,8,0.625,1,7,0.143,6,7,0.857,1,4,5
3265,Ish Smith,28-148,G,11/30/16,DET,@,BOS,W,1,36,9,12,0.75,9,11,0.818,0,1,0,1,2,0.5,0,8,8
3266,Tony Snell,25-121,G-F,3/11/17,MIL,,MIN,W,1,28,6,9,0.667,2,2,1,4,7,0.571,3,4,0.75,1,5,6
3267,Marreese Speights,29-157,C-F,1/8/17,LAC,,MIA,W,0,14,6,8,0.75,3,3,1,3,5,0.6,4,4,1,1,0,1
3268,Jeff Teague,28-180,G,12/7/16,IND,@,PHO,W,1,36,6,15,0.4,5,11,0.455,1,4,0.25,6,8,0.75,1,4,5
3269,Jeff Teague,28-211,G,1/7/17,IND,,NYK,W,1,31,4,7,0.571,2,4,0.5,2,3,0.667,9,9,1,1,3,4
3270,Jeff Teague,28-190,G,12/17/16,IND,@,DET,W,1,31,6,10,0.6,5,8,0.625,1,2,0.5,6,8,0.75,0,9,9
3271,Jeff Teague,28-225,G,1/21/17,IND,@,UTA,L,1,38,6,13,0.462,5,12,0.417,1,1,1,6,8,0.75,0,4,4
3272,Jeff Teague,28-201,G,12/28/16,IND,@,WAS,L,1,38,6,12,0.5,5,9,0.556,1,3,0.333,6,7,0.857,1,1,2
3273,Mirza Teletovic,31-139,F,2/4/17,MIL,@,PHO,W,0,25,6,10,0.6,4,5,0.8,2,5,0.4,5,5,1,0,3,3
3274,Mirza Teletovic,31-146,F,2/11/17,MIL,@,IND,W,0,17,6,10,0.6,1,1,1,5,9,0.556,2,3,0.667,0,2,2
3275,Garrett Temple,30-181,G,11/5/16,SAC,@,MIL,L,0,28,7,10,0.7,2,4,0.5,5,6,0.833,0,0,,0,3,3
3276,Isaiah Thomas,28-020,G,2/27/17,BOS,,ATL,L,1,30,4,21,0.19,3,15,0.2,1,6,0.167,10,10,1,2,5,7
3277,Hollis Thompson,25-220,G-F,11/9/16,PHI,@,IND,L,0,26,7,12,0.583,4,6,0.667,3,6,0.5,2,2,1,2,4,6
3278,Klay Thompson,26-276,G,11/10/16,GSW,@,DEN,W,1,32,7,14,0.5,4,10,0.4,3,4,0.75,2,2,1,0,2,2
3279,Klay Thompson,26-352,G,1/25/17,GSW,@,CHO,W,1,32,5,14,0.357,3,6,0.5,2,8,0.25,7,7,1,1,4,5
3280,Tristan Thompson,25-322,F-C,1/29/17,CLE,,OKC,W,1,34,7,15,0.467,7,15,0.467,0,0,,5,5,1,6,6,12
3281,Anthony Tolliver,31-285,F-C,3/13/17,SAC,,ORL,W,0,28,6,9,0.667,1,2,0.5,5,7,0.714,2,2,1,0,6,6
3282,Karl-Anthony Towns,21-013,F-C,11/28/16,MIN,,UTA,L,1,34,8,19,0.421,7,16,0.438,1,3,0.333,2,2,1,3,9,12
3283,Evan Turner,28-024,G,11/20/16,POR,@,BRK,W,0,30,8,12,0.667,8,11,0.727,0,1,0,3,3,1,0,4,4
3284,Myles Turner,20-251,F-C,11/30/16,IND,@,POR,L,1,31,7,12,0.583,7,12,0.583,0,0,,5,5,1,3,7,10
3285,Tyler Ulis,21-071,G,3/17/17,PHO,,ORL,L,1,40,8,17,0.471,8,15,0.533,0,2,0,3,4,0.75,1,3,4
3286,Denzel Valentine,23-055,G,1/10/17,CHI,@,WAS,L,0,30,7,15,0.467,2,4,0.5,5,11,0.455,0,0,,0,2,2
3287,Nikola Vucevic,26-076,C,1/8/17,ORL,@,LAL,L,0,26,8,17,0.471,7,13,0.538,1,4,0.25,2,4,0.5,2,5,7
3288,Dwyane Wade,35-017,G,2/3/17,CHI,@,HOU,L,1,36,8,22,0.364,6,18,0.333,2,4,0.5,1,1,1,0,9,9
3289,Dwyane Wade,35-042,G,2/28/17,CHI,,DEN,L,1,28,8,14,0.571,6,12,0.5,2,2,1,1,1,1,1,3,4
3290,Dwyane Wade,34-303,G,11/15/16,CHI,@,POR,W,1,31,8,18,0.444,8,18,0.444,0,0,,3,5,0.6,2,3,5
3291,Dwyane Wade,34-324,G,12/6/16,CHI,@,DET,L,1,34,5,13,0.385,5,11,0.455,0,2,0,9,10,0.9,0,3,3
3292,Dwyane Wade,34-339,G,12/21/16,CHI,,WAS,L,1,32,7,20,0.35,7,19,0.368,0,1,0,5,6,0.833,0,3,3
3293,Dion Waiters,24-347,G,11/21/16,MIA,@,PHI,L,1,33,6,15,0.4,4,9,0.444,2,6,0.333,5,6,0.833,0,3,3
3294,Dion Waiters,25-051,G,1/30/17,MIA,,BRK,W,1,36,7,18,0.389,4,12,0.333,3,6,0.5,2,4,0.5,0,6,6
3295,Dion Waiters,25-048,G,1/27/17,MIA,@,CHI,W,1,34,6,18,0.333,3,13,0.231,3,5,0.6,4,5,0.8,0,5,5
3296,Kemba Walker,26-211,G,12/5/16,CHO,@,DAL,W,1,35,8,15,0.533,8,13,0.615,0,2,0,3,4,0.75,0,3,3
3297,John Wall,26-143,G,1/27/17,WAS,@,ATL,W,1,30,7,17,0.412,6,15,0.4,1,2,0.5,4,6,0.667,1,5,6
3298,John Wall,26-180,G,3/5/17,WAS,,ORL,W,1,37,6,17,0.353,5,14,0.357,1,3,0.333,6,7,0.857,0,6,6
3299,John Wall,26-193,G,3/18/17,WAS,@,CHO,L,1,35,5,16,0.313,4,12,0.333,1,4,0.25,8,11,0.727,0,3,3
3300,John Wall,26-137,G,1/21/17,WAS,@,DET,L,1,39,6,15,0.4,6,13,0.462,0,2,0,7,9,0.778,2,5,7
3301,John Wall,26-104,G,12/19/16,WAS,@,IND,L,1,38,6,14,0.429,6,9,0.667,0,5,0,7,8,0.875,1,4,5
3302,John Wall,26-064,G,11/9/16,WAS,,BOS,W,1,31,6,16,0.375,5,13,0.385,1,3,0.333,6,7,0.857,0,3,3
3303,John Wall,26-083,G,11/28/16,WAS,,SAC,W,1,43,6,16,0.375,5,13,0.385,1,3,0.333,6,6,1,0,5,5
3304,John Wall,26-115,G,12/30/16,WAS,,BRK,W,1,32,7,14,0.5,6,10,0.6,1,4,0.25,4,4,1,0,2,2
3305,T.J. Warren,23-109,F,12/23/16,PHO,,PHI,W,0,32,7,16,0.438,5,11,0.455,2,5,0.4,3,6,0.5,3,2,5
3306,T.J. Warren,23-107,F,12/21/16,PHO,,HOU,L,0,29,9,17,0.529,8,14,0.571,1,3,0.333,0,0,,1,4,5
3307,Isaiah Whitehead,21-321,G,1/23/17,BRK,,SAS,L,0,29,6,15,0.4,4,11,0.364,2,4,0.5,5,5,1,0,1,1
3308,Hassan Whiteside,27-155,C,11/15/16,MIA,,ATL,L,1,38,6,15,0.4,6,15,0.4,0,0,,7,8,0.875,10,15,25
3309,Hassan Whiteside,27-238,C,2/6/17,MIA,@,MIN,W,1,36,8,14,0.571,8,14,0.571,0,0,,3,4,0.75,2,11,13
3310,Hassan Whiteside,27-259,C,2/27/17,MIA,@,DAL,L,1,38,9,16,0.563,9,16,0.563,0,0,,1,2,0.5,7,12,19
3311,Hassan Whiteside,27-214,C,1/13/17,MIA,@,MIL,L,1,31,7,12,0.583,7,12,0.583,0,0,,5,6,0.833,2,7,9
3312,Andrew Wiggins,21-281,F-G,11/30/16,MIN,,NYK,L,1,40,8,20,0.4,5,16,0.313,3,4,0.75,0,1,0,2,5,7
3313,Andrew Wiggins,21-327,F-G,1/15/17,MIN,@,DAL,L,1,38,8,15,0.533,7,12,0.583,1,3,0.333,2,2,1,1,7,8
3314,Andrew Wiggins,21-325,F-G,1/13/17,MIN,,OKC,W,1,36,9,22,0.409,9,19,0.474,0,3,0,1,1,1,1,5,6
3315,Andrew Wiggins,21-302,F-G,12/21/16,MIN,@,ATL,W,1,39,9,19,0.474,9,16,0.563,0,3,0,1,1,1,3,4,7
3316,Andrew Wiggins,21-283,F-G,12/2/16,MIN,@,NYK,L,1,36,6,14,0.429,6,12,0.5,0,2,0,7,8,0.875,1,2,3
3317,Lou Williams,30-005,G,11/1/16,LAL,@,IND,L,0,27,7,14,0.5,4,6,0.667,3,8,0.375,2,2,1,0,0,0
3318,Marvin Williams,30-143,F,11/9/16,CHO,,UTA,W,1,30,7,11,0.636,2,4,0.5,5,7,0.714,0,0,,1,7,8
3319,Marvin Williams,30-200,F,1/5/17,CHO,@,DET,L,1,29,6,11,0.545,4,8,0.5,2,3,0.667,5,7,0.714,1,6,7
3320,Marvin Williams,30-256,F,3/2/17,CHO,@,PHO,L,1,29,5,9,0.556,2,6,0.333,3,3,1,6,8,0.75,1,3,4
3321,Marvin Williams,30-181,F,12/17/16,CHO,@,ATL,W,1,30,7,10,0.7,3,4,0.75,4,6,0.667,1,2,0.5,1,5,6
3322,Nick Young,31-277,G-F,3/5/17,LAL,,NOP,L,1,28,7,12,0.583,3,4,0.75,4,8,0.5,1,1,1,1,3,4
3323,Nick Young,31-207,G-F,12/25/16,LAL,,LAC,W,1,30,6,9,0.667,1,2,0.5,5,7,0.714,2,2,1,0,2,2
3324,Thaddeus Young,28-214,F,1/21/17,IND,@,UTA,L,1,38,8,11,0.727,6,9,0.667,2,2,1,1,2,0.5,2,7,9
3325,Thaddeus Young,28-129,F,10/28/16,IND,@,BRK,L,1,36,7,12,0.583,5,9,0.556,2,3,0.667,3,4,0.75,3,4,7
3326,Cody Zeller,24-164,F-C,3/18/17,CHO,,WAS,W,1,33,8,10,0.8,8,10,0.8,0,0,,3,5,0.6,1,4,5
3327,Alex Abrines,23-142,G-F,12/21/16,OKC,@,NOP,W,0,30,6,12,0.5,1,1,1,5,11,0.455,1,2,0.5,0,3,3
3328,Quincy Acy,26-148,F,3/3/17,BRK,@,UTA,L,0,18,5,7,0.714,3,4,0.75,2,3,0.667,6,8,0.75,0,2,2
3329,Steven Adams,23-168,C,1/4/17,OKC,@,CHO,L,1,36,8,10,0.8,8,10,0.8,0,0,,2,2,1,4,8,12
3330,Arron Afflalo,31-146,G,3/10/17,SAC,,WAS,L,1,34,6,10,0.6,4,7,0.571,2,3,0.667,4,5,0.8,0,3,3
3331,Arron Afflalo,31-017,G,11/1/16,SAC,@,MIA,L,1,41,7,17,0.412,6,12,0.5,1,5,0.2,3,3,1,0,3,3
3332,LaMarcus Aldridge,31-243,F-C,3/19/17,SAS,,SAC,W,1,22,8,13,0.615,6,11,0.545,2,2,1,0,0,,5,3,8
3333,LaMarcus Aldridge,31-157,F-C,12/23/16,SAS,@,POR,W,1,37,7,18,0.389,7,18,0.389,0,0,,4,4,1,6,8,14
3334,LaMarcus Aldridge,31-139,F-C,12/5/16,SAS,@,MIL,W,1,36,7,14,0.5,6,13,0.462,1,1,1,3,4,0.75,3,6,9
3335,LaMarcus Aldridge,31-118,F-C,11/14/16,SAS,,MIA,W,1,36,8,14,0.571,8,14,0.571,0,0,,2,2,1,1,2,3
3336,LaMarcus Aldridge,31-228,F-C,3/4/17,SAS,,MIN,W,1,44,8,24,0.333,8,24,0.333,0,0,,2,3,0.667,4,6,10
3337,Lavoy Allen,28-000,F-C,2/4/17,IND,,DET,W,1,32,8,15,0.533,8,15,0.533,0,0,,2,2,1,5,6,11
3338,Ryan Anderson,28-210,F,12/2/16,HOU,@,DEN,W,1,25,4,7,0.571,0,1,0,4,6,0.667,6,6,1,2,4,6
3339,Ryan Anderson,28-250,F,1/11/17,HOU,@,MIN,L,1,38,6,16,0.375,1,2,0.5,5,14,0.357,1,1,1,2,5,7
3340,Ryan Anderson,28-295,F,2/25/17,HOU,,MIN,W,1,24,5,15,0.333,1,2,0.5,4,13,0.308,4,5,0.8,1,1,2
3341,Giannis Antetokounmpo,22-097,F-G,3/13/17,MIL,@,MEM,L,1,28,6,14,0.429,5,10,0.5,1,4,0.25,5,7,0.714,0,5,5
3342,Giannis Antetokounmpo,22-095,F-G,3/11/17,MIL,,MIN,W,1,40,6,15,0.4,6,14,0.429,0,1,0,6,7,0.857,0,4,4
3343,Giannis Antetokounmpo,21-357,F-G,11/27/16,MIL,@,ORL,W,1,31,7,11,0.636,6,10,0.6,1,1,1,3,4,0.75,1,8,9
3344,Carmelo Anthony,32-183,F,11/28/16,NYK,,OKC,L,1,34,4,19,0.211,4,18,0.222,0,1,0,10,11,0.909,1,7,8
3345,Carmelo Anthony,32-231,F,1/15/17,NYK,@,TOR,L,1,26,7,14,0.5,4,9,0.444,3,5,0.6,1,2,0.5,0,1,1
3346,Carmelo Anthony,32-181,F,11/26/16,NYK,@,CHO,L,1,34,7,25,0.28,5,18,0.278,2,7,0.286,2,2,1,1,7,8
3347,Carmelo Anthony,32-243,F,1/27/17,NYK,,CHO,W,1,35,8,26,0.308,7,19,0.368,1,7,0.143,1,3,0.333,0,11,11
3348,Carmelo Anthony,32-225,F,1/9/17,NYK,,NOP,L,1,26,7,15,0.467,5,12,0.417,2,3,0.667,2,3,0.667,0,6,6
3349,Carmelo Anthony,32-278,F,3/3/17,NYK,@,PHI,L,1,36,5,18,0.278,3,13,0.231,2,5,0.4,6,6,1,1,5,6
3350,Trevor Ariza,31-150,F,11/27/16,HOU,@,POR,W,1,33,6,7,0.857,2,2,1,4,5,0.8,2,4,0.5,0,2,2
3351,Trevor Ariza,31-148,F,11/25/16,HOU,@,SAC,W,1,35,6,11,0.545,0,0,,6,11,0.545,0,0,,0,10,10
3352,Trevor Ariza,31-183,F,12/30/16,HOU,,LAC,W,1,37,6,11,0.545,1,1,1,5,10,0.5,1,2,0.5,0,4,4
3353,D.J. Augustin,29-009,G,11/19/16,ORL,,DAL,W,0,30,6,11,0.545,4,6,0.667,2,5,0.4,4,4,1,0,2,2
3354,Leandro Barbosa,34-013,G,12/11/16,PHO,,NOP,L,0,33,8,14,0.571,6,9,0.667,2,5,0.4,0,0,,0,3,3
3355,J.J. Barea,32-126,G,10/30/16,DAL,@,HOU,L,0,31,4,10,0.4,1,6,0.167,3,4,0.75,7,7,1,1,2,3
3356,J.J. Barea,32-135,G,11/8/16,DAL,@,LAL,W,1,34,7,15,0.467,5,9,0.556,2,6,0.333,2,2,1,1,6,7
3357,Harrison Barnes,24-287,F,3/13/17,DAL,@,TOR,L,1,36,7,16,0.438,6,14,0.429,1,2,0.5,3,3,1,1,1,2
3358,Harrison Barnes,24-196,F,12/12/16,DAL,,DEN,W,1,32,6,11,0.545,6,11,0.545,0,0,,6,7,0.857,1,2,3
3359,Harrison Barnes,24-277,F,3/3/17,DAL,,MEM,W,1,37,6,15,0.4,5,11,0.455,1,4,0.25,5,5,1,1,2,3
3360,Will Barton,26-013,G,1/19/17,DEN,@,SAS,L,1,36,5,12,0.417,4,7,0.571,1,5,0.2,7,7,1,0,3,3
3361,Will Barton,26-040,G,2/15/17,DEN,,MIN,L,0,38,7,15,0.467,7,11,0.636,0,4,0,4,5,0.8,2,7,9
3362,Will Barton,26-015,G,1/21/17,DEN,,LAC,W,1,29,8,13,0.615,6,9,0.667,2,4,0.5,0,0,,1,2,3
3363,Brandon Bass,31-245,F,12/31/16,LAC,@,OKC,L,0,24,7,9,0.778,7,8,0.875,0,1,0,4,4,1,2,4,6
3364,Nicolas Batum,28-071,F-G,2/23/17,CHO,@,DET,L,1,40,6,17,0.353,5,10,0.5,1,7,0.143,5,5,1,1,5,6
3365,Nicolas Batum,28-048,F-G,1/31/17,CHO,@,POR,L,1,34,6,12,0.5,2,6,0.333,4,6,0.667,2,4,0.5,0,8,8
3366,Nicolas Batum,27-326,F-G,11/4/16,CHO,@,BRK,W,1,36,7,13,0.538,5,8,0.625,2,5,0.4,2,3,0.667,0,9,9
3367,Nicolas Batum,27-333,F-G,11/11/16,CHO,,TOR,L,1,39,7,15,0.467,4,9,0.444,3,6,0.5,1,2,0.5,4,6,10
3368,Nicolas Batum,27-347,F-G,11/25/16,CHO,@,NYK,L,1,45,7,17,0.412,6,10,0.6,1,7,0.143,3,6,0.5,0,9,9
3369,Jerryd Bayless,28-095,G,11/23/16,PHI,,MEM,L,0,30,6,15,0.4,5,13,0.385,1,2,0.5,5,6,0.833,1,5,6
3370,Kent Bazemore,27-248,G-F,3/6/17,ATL,,GSW,L,1,29,6,15,0.4,4,10,0.4,2,5,0.4,4,6,0.667,0,1,1
3371,Bradley Beal,23-263,G,3/18/17,WAS,@,CHO,L,1,31,6,14,0.429,4,7,0.571,2,7,0.286,4,6,0.667,0,3,3
3372,Bradley Beal,23-142,G,11/17/16,WAS,,NYK,W,1,29,5,10,0.5,2,5,0.4,3,5,0.6,5,5,1,0,2,2
3373,Bradley Beal,23-160,G,12/5/16,WAS,@,BRK,W,1,36,7,18,0.389,4,10,0.4,3,8,0.375,1,4,0.25,1,3,4
3374,Bradley Beal,23-209,G,1/23/17,WAS,@,CHO,W,1,32,6,16,0.375,2,7,0.286,4,9,0.444,2,3,0.667,2,3,5
3375,Michael Beasley,27-365,F,1/8/17,MIL,,WAS,L,0,16,6,9,0.667,5,8,0.625,1,1,1,5,5,1,0,1,1
3376,Marco Belinelli,30-350,G-F,3/10/17,CHO,,ORL,W,0,22,6,10,0.6,6,8,0.75,0,2,0,6,6,1,0,0,0
3377,Marco Belinelli,30-304,G-F,1/23/17,CHO,,WAS,L,0,29,5,12,0.417,3,4,0.75,2,8,0.25,6,7,0.857,0,3,3
3378,Patrick Beverley,28-195,G,1/23/17,HOU,@,MIL,L,1,33,7,10,0.7,3,3,1,4,7,0.571,0,0,,0,0,0
3379,Patrick Beverley,28-162,G,12/21/16,HOU,@,PHO,W,1,33,7,11,0.636,5,8,0.625,2,3,0.667,2,2,1,2,7,9
3380,Eric Bledsoe,27-046,G,1/24/17,PHO,,MIN,L,1,29,5,18,0.278,4,13,0.308,1,5,0.2,7,7,1,0,1,1
3381,Eric Bledsoe,27-084,G,3/3/17,PHO,,OKC,W,1,29,4,15,0.267,4,12,0.333,0,3,0,10,13,0.769,0,3,3
3382,Bojan Bogdanovic,27-231,G-F,12/5/16,BRK,,WAS,L,1,29,5,14,0.357,3,7,0.429,2,7,0.286,6,8,0.75,0,3,3
3383,Bojan Bogdanovic,27-210,G-F,11/14/16,BRK,@,LAC,L,1,25,8,11,0.727,7,8,0.875,1,3,0.333,1,1,1,0,2,2
3384,Devin Booker,20-050,G,12/19/16,PHO,@,MIN,L,1,29,6,15,0.4,5,10,0.5,1,5,0.2,5,6,0.833,1,1,2
3385,Devin Booker,19-362,G,10/26/16,PHO,,SAC,L,1,25,8,12,0.667,8,9,0.889,0,3,0,2,5,0.4,0,2,2
3386,Devin Booker,20-104,G,2/11/17,PHO,@,HOU,L,1,26,6,18,0.333,5,15,0.333,1,3,0.333,5,6,0.833,0,1,1
3387,Trevor Booker,28-364,F,11/23/16,BRK,,BOS,L,1,33,8,13,0.615,7,11,0.636,1,2,0.5,1,2,0.5,5,7,12
3388,Trevor Booker,29-051,F,1/15/17,BRK,,HOU,L,1,26,8,15,0.533,7,11,0.636,1,4,0.25,1,2,0.5,1,4,5
3389,Trevor Booker,29-082,F,2/15/17,BRK,,MIL,L,0,28,7,8,0.875,7,7,1,0,1,0,4,4,1,0,5,5
3390,Avery Bradley,26-002,G,11/28/16,BOS,@,MIA,W,1,39,8,16,0.5,6,14,0.429,2,2,1,0,0,,0,6,6
3391,Avery Bradley,26-015,G,12/11/16,BOS,@,OKC,L,1,35,8,18,0.444,6,14,0.429,2,4,0.5,0,1,0,1,3,4
3392,Avery Bradley,26-109,G,3/15/17,BOS,,MIN,W,1,32,7,12,0.583,3,6,0.5,4,6,0.667,0,0,,0,3,3
3393,Avery Bradley,25-356,G,11/16/16,BOS,,DAL,W,1,34,8,19,0.421,6,13,0.462,2,6,0.333,0,1,0,2,11,13
3394,Malcolm Brogdon,24-097,G,3/18/17,MIL,@,GSW,L,1,41,6,13,0.462,4,7,0.571,2,6,0.333,4,4,1,1,3,4
3395,Malcolm Brogdon,24-061,G,2/10/17,MIL,,LAL,L,0,27,8,11,0.727,7,8,0.875,1,3,0.333,1,1,1,0,2,2
3396,Trey Burke,23-363,G,11/9/16,WAS,,BOS,W,0,17,7,9,0.778,4,5,0.8,3,4,0.75,1,2,0.5,1,0,1
3397,Jimmy Butler,27-164,G-F,2/25/17,CHI,@,CLE,W,1,39,7,19,0.368,3,13,0.231,4,6,0.667,0,0,,1,9,10
3398,Kentavious Caldwell-Pope,23-312,G,12/26/16,DET,,CLE,W,1,39,7,11,0.636,3,5,0.6,4,6,0.667,0,0,,0,3,3
3399,Kentavious Caldwell-Pope,24-008,G,2/26/17,DET,,BOS,L,1,36,6,14,0.429,3,6,0.5,3,8,0.375,3,5,0.6,0,3,3
3400,Kentavious Caldwell-Pope,23-285,G,11/29/16,DET,@,CHO,W,1,32,6,14,0.429,2,6,0.333,4,8,0.5,2,2,1,2,5,7
3401,Kentavious Caldwell-Pope,24-008,G,2/26/17,DET,,BOS,L,1,36,6,14,0.429,3,6,0.5,3,8,0.375,3,5,0.6,0,3,3
3402,DeMarre Carroll,30-170,F,1/13/17,TOR,,BRK,W,1,29,7,16,0.438,4,6,0.667,3,10,0.3,1,1,1,1,10,11
3403,Vince Carter,39-278,G-F,10/30/16,MEM,,WAS,W,0,32,5,6,0.833,0,0,,5,6,0.833,3,4,0.75,0,2,2
3404,Willie Cauley-Stein,23-213,F-C,3/19/17,SAC,@,SAS,L,1,32,5,11,0.455,5,11,0.455,0,0,,8,10,0.8,0,4,4
3405,Willie Cauley-Stein,23-207,F-C,3/13/17,SAC,,ORL,W,1,36,9,16,0.563,9,16,0.563,0,0,,0,0,,0,8,8
3406,Wilson Chandler,29-187,F,11/13/16,DEN,@,POR,L,0,27,7,12,0.583,7,10,0.7,0,2,0,4,5,0.8,0,7,7
3407,Wilson Chandler,29-256,F,1/21/17,DEN,,LAC,W,0,23,8,12,0.667,6,10,0.6,2,2,1,0,0,,2,5,7
3408,Wilson Chandler,29-289,F,2/23/17,DEN,@,SAC,L,0,29,7,13,0.538,4,6,0.667,3,7,0.429,1,2,0.5,2,8,10
3409,Marquese Chriss,19-185,F,1/3/17,PHO,,MIA,W,1,31,7,11,0.636,5,6,0.833,2,5,0.4,2,2,1,1,5,6
3410,Marquese Chriss,19-250,F,3/9/17,PHO,,LAL,L,1,27,6,9,0.667,3,5,0.6,3,4,0.75,3,4,0.75,3,3,6
3411,Ian Clark,26-014,G,3/21/17,GSW,@,DAL,W,0,29,8,16,0.5,8,12,0.667,0,4,0,2,2,1,0,4,4
3412,Ian Clark,25-343,G,2/13/17,GSW,@,DEN,L,0,27,8,15,0.533,6,12,0.5,2,3,0.667,0,0,,0,1,1
3413,Jordan Clarkson,24-281,G,3/15/17,LAL,@,HOU,L,1,39,7,19,0.368,6,13,0.462,1,6,0.167,3,4,0.75,0,2,2
3414,Jordan Clarkson,24-176,G,11/30/16,LAL,@,CHI,W,0,34,9,18,0.5,9,17,0.529,0,1,0,0,0,,0,4,4
3415,Jordan Clarkson,24-173,G,11/27/16,LAL,,ATL,W,0,32,7,17,0.412,6,13,0.462,1,4,0.25,3,4,0.75,1,3,4
3416,Jordan Clarkson,24-199,G,12/23/16,LAL,@,ORL,L,0,27,7,14,0.5,3,6,0.5,4,8,0.5,0,0,,1,4,5
3417,Jordan Clarkson,24-152,G,11/6/16,LAL,,PHO,W,0,30,8,16,0.5,7,14,0.5,1,2,0.5,1,2,0.5,2,4,6
3418,Jordan Clarkson,24-168,G,11/22/16,LAL,,OKC,W,0,26,7,14,0.5,7,10,0.7,0,4,0,4,4,1,0,3,3
3419,Jordan Clarkson,24-148,G,11/2/16,LAL,@,ATL,W,0,23,8,13,0.615,7,10,0.7,1,3,0.333,1,2,0.5,0,2,2
3420,Darren Collison,29-194,G,3/5/17,SAC,,UTA,L,1,41,8,14,0.571,7,12,0.583,1,2,0.5,1,2,0.5,0,3,3
3421,Darren Collison,29-165,G,2/4/17,SAC,,GSW,W,1,33,8,13,0.615,8,10,0.8,0,3,0,2,2,1,0,2,2
3422,Darren Collison,29-096,G,11/27/16,SAC,@,BRK,W,1,30,6,10,0.6,4,8,0.5,2,2,1,4,6,0.667,0,2,2
3423,Mike Conley,29-034,G,11/14/16,MEM,@,UTA,W,1,31,7,14,0.5,5,9,0.556,2,5,0.4,2,2,1,0,3,3
3424,Mike Conley,29-115,G,2/3/17,MEM,@,OKC,L,1,34,7,16,0.438,6,11,0.545,1,5,0.2,3,5,0.6,0,1,1
3425,Mike Conley,29-113,G,2/1/17,MEM,@,DEN,W,1,27,7,14,0.5,5,7,0.714,2,7,0.286,2,2,1,1,3,4
3426,DeMarcus Cousins,26-177,C-F,2/6/17,SAC,,CHI,L,1,38,5,16,0.313,2,7,0.286,3,9,0.333,5,6,0.833,2,12,14
3427,Robert Covington,26-056,F,2/8/17,PHI,,SAS,L,1,38,6,14,0.429,4,7,0.571,2,7,0.286,4,4,1,1,5,6
3428,Robert Covington,26-093,F,3/17/17,PHI,,DAL,W,1,26,4,8,0.5,1,2,0.5,3,6,0.5,7,8,0.875,0,9,9
3429,Robert Covington,26-063,F,2/15/17,PHI,@,BOS,L,1,29,7,12,0.583,3,6,0.5,4,6,0.667,0,0,,3,6,9
3430,Allen Crabbe,24-199,G-F,10/25/16,POR,,UTA,W,0,29,6,10,0.6,2,5,0.4,4,5,0.8,2,2,1,0,3,3
3431,Allen Crabbe,24-334,G-F,3/9/17,POR,,PHI,W,0,24,8,12,0.667,6,7,0.857,2,5,0.4,0,0,,0,4,4
3432,Allen Crabbe,24-270,G-F,1/4/17,POR,@,GSW,L,1,36,4,11,0.364,2,7,0.286,2,4,0.5,8,8,1,0,3,3
3433,Jamal Crawford,36-288,G,1/2/17,LAC,,PHO,W,0,31,7,18,0.389,7,17,0.412,0,1,0,4,4,1,2,5,7
3434,Jae Crowder,26-212,F,2/3/17,BOS,,LAL,W,1,34,6,12,0.5,4,5,0.8,2,7,0.286,4,4,1,0,6,6
3435,Jae Crowder,26-142,F,11/25/16,BOS,,SAS,L,1,28,7,12,0.583,3,3,1,4,9,0.444,0,0,,0,3,3
3436,Jae Crowder,26-158,F,12/11/16,BOS,@,OKC,L,1,27,7,9,0.778,4,5,0.8,3,4,0.75,1,1,1,0,2,2
3437,Jae Crowder,26-191,F,1/13/17,BOS,@,ATL,W,1,33,7,12,0.583,3,4,0.75,4,8,0.5,0,0,,1,8,9
3438,Jae Crowder,26-224,F,2/15/17,BOS,,PHI,W,1,35,5,13,0.385,4,8,0.5,1,5,0.2,7,9,0.778,2,3,5
3439,Seth Curry,26-147,G,1/17/17,DAL,@,CHI,W,1,30,7,10,0.7,4,5,0.8,3,5,0.6,1,2,0.5,0,2,2
3440,Seth Curry,26-199,G,3/10/17,DAL,,BRK,W,1,32,6,11,0.545,3,7,0.429,3,4,0.75,3,3,1,1,4,5
3441,Seth Curry,26-196,G,3/7/17,DAL,,LAL,W,1,31,7,12,0.583,3,5,0.6,4,7,0.571,0,1,0,0,2,2
3442,Stephen Curry,28-333,G,2/10/17,GSW,@,MEM,W,1,35,6,13,0.462,4,7,0.571,2,6,0.333,4,5,0.8,0,4,4
3443,Anthony Davis,23-326,F-C,1/31/17,NOP,@,TOR,L,1,41,4,18,0.222,4,17,0.235,0,1,0,10,12,0.833,3,14,17
3444,Anthony Davis,23-341,F-C,2/15/17,NOP,@,MEM,W,1,39,9,20,0.45,9,19,0.474,0,1,0,0,0,,0,7,7
3445,Anthony Davis,23-232,F-C,10/29/16,NOP,@,SAS,L,1,32,6,15,0.4,6,15,0.4,0,0,,6,8,0.75,0,5,5
3446,Matthew Dellavedova,26-086,G,12/3/16,MIL,,BRK,W,1,27,6,10,0.6,6,8,0.75,0,2,0,6,6,1,1,1,2
3447,Luol Deng,31-231,F,12/3/16,LAL,@,MEM,L,1,36,8,15,0.533,6,8,0.75,2,7,0.286,0,1,0,2,3,5
3448,DeMar DeRozan,27-191,G,2/14/17,TOR,@,CHI,L,1,38,5,19,0.263,5,18,0.278,0,1,0,8,9,0.889,1,4,5
3449,Spencer Dinwiddie,23-347,G,3/19/17,BRK,,DAL,L,0,30,5,9,0.556,3,3,1,2,6,0.333,6,7,0.857,1,1,2
3450,Goran Dragic,30-211,G,12/3/16,MIA,@,POR,L,1,35,8,19,0.421,8,18,0.444,0,1,0,2,2,1,1,8,9
3451,Andre Drummond,23-091,C,11/9/16,DET,@,PHO,L,1,35,7,13,0.538,7,13,0.538,0,0,,4,6,0.667,4,10,14
3452,Andre Drummond,23-105,C,11/23/16,DET,,MIA,W,1,26,9,12,0.75,9,12,0.75,0,0,,0,1,0,3,12,15
3453,Andre Drummond,23-221,C,3/19/17,DET,,PHO,W,1,28,7,10,0.7,7,10,0.7,0,0,,4,11,0.364,4,14,18
3454,Kevin Durant,28-042,F-G,11/10/16,GSW,@,DEN,W,1,30,8,16,0.5,8,13,0.615,0,3,0,2,2,1,2,7,9
3455,Kevin Durant,28-125,F-G,2/1/17,GSW,,CHO,W,1,33,7,17,0.412,6,10,0.6,1,7,0.143,3,3,1,2,6,8
3456,Wayne Ellington,29-064,G,1/1/17,MIA,,DET,L,1,37,7,15,0.467,3,7,0.429,4,8,0.5,0,0,,0,4,4
3457,Wayne Ellington,29-080,G,1/17/17,MIA,,HOU,W,0,28,6,11,0.545,1,2,0.5,5,9,0.556,1,1,1,0,4,4
3458,Wayne Ellington,29-128,G,3/6/17,MIA,@,CLE,W,0,32,6,12,0.5,1,2,0.5,5,10,0.5,1,1,1,1,3,4
3459,Wayne Ellington,29-123,G,3/1/17,MIA,,PHI,W,0,25,6,9,0.667,0,0,,6,9,0.667,0,0,,1,2,3
3460,Monta Ellis,31-108,G,2/11/17,IND,,MIL,L,0,32,7,10,0.7,6,7,0.857,1,3,0.333,3,4,0.75,0,4,4
3461,Joel Embiid,22-310,C-F,1/20/17,PHI,,POR,W,1,22,7,14,0.5,7,14,0.5,0,0,,4,9,0.444,3,7,10
3462,Joel Embiid,22-230,C-F,11/1/16,PHI,,ORL,L,1,25,6,12,0.5,6,11,0.545,0,1,0,6,9,0.667,3,7,10
3463,Tyreke Evans,27-121,G-F,1/18/17,NOP,,ORL,W,0,20,6,12,0.5,2,6,0.333,4,6,0.667,2,2,1,0,4,4
3464,Kenneth Faried,26-360,F,11/13/16,DEN,@,POR,L,1,28,5,10,0.5,5,10,0.5,0,0,,8,9,0.889,8,6,14
3465,Derrick Favors,25-119,F-C,11/11/16,UTA,@,ORL,W,1,36,7,14,0.5,6,13,0.462,1,1,1,3,4,0.75,0,9,9
3466,Derrick Favors,25-193,F-C,1/24/17,UTA,@,DEN,L,1,25,8,11,0.727,8,11,0.727,0,0,,2,2,1,3,2,5
3467,Raymond Felton,32-220,G,2/1/17,LAC,@,PHO,W,1,30,7,14,0.5,5,11,0.455,2,3,0.667,2,2,1,1,4,5
3468,Evan Fournier,24-127,G-F,3/5/17,ORL,@,WAS,L,1,34,7,16,0.438,4,7,0.571,3,9,0.333,1,1,1,1,1,2
3469,Evan Fournier,24-023,G-F,11/21/16,ORL,@,MIL,L,1,37,6,13,0.462,4,8,0.5,2,5,0.4,4,4,1,0,5,5
3470,Channing Frye,33-247,C-F,1/19/17,CLE,,PHO,W,0,30,6,11,0.545,2,3,0.667,4,8,0.5,2,2,1,2,8,10
3471,Channing Frye,33-260,C-F,2/1/17,CLE,,MIN,W,1,22,7,13,0.538,4,4,1,3,9,0.333,1,2,0.5,0,4,4
3472,Danilo Gallinari,28-157,F,1/12/17,DEN,,IND,W,1,30,7,11,0.636,3,5,0.6,4,6,0.667,0,0,,0,2,2
3473,Danilo Gallinari,28-210,F,3/6/17,DEN,,SAC,W,1,31,5,7,0.714,2,3,0.667,3,4,0.75,5,5,1,0,7,7
3474,Danilo Gallinari,28-100,F,11/16/16,DEN,,PHO,W,1,38,4,13,0.308,3,9,0.333,1,4,0.25,9,9,1,1,4,5
3475,Danilo Gallinari,28-096,F,11/12/16,DEN,,DET,L,1,36,5,10,0.5,3,6,0.5,2,4,0.5,6,8,0.75,0,4,4
3476,Danilo Gallinari,28-144,F,12/30/16,DEN,,PHI,L,1,29,4,11,0.364,3,6,0.5,1,5,0.2,9,9,1,1,4,5
3477,Danilo Gallinari,28-166,F,1/21/17,DEN,,LAC,W,1,32,5,8,0.625,3,5,0.6,2,3,0.667,6,6,1,0,4,4
3478,Danilo Gallinari,28-217,F,3/13/17,DEN,,LAL,W,1,29,5,10,0.5,2,4,0.5,3,6,0.5,5,5,1,1,2,3
3479,Danilo Gallinari,28-142,F,12/28/16,DEN,,MIN,W,1,35,6,9,0.667,4,5,0.8,2,4,0.5,4,4,1,0,5,5
3480,Langston Galloway,24-329,G,11/2/16,NOP,@,MEM,L,0,32,6,13,0.462,2,6,0.333,4,7,0.571,2,3,0.667,0,2,2
3481,Langston Galloway,25-040,G,1/18/17,NOP,,ORL,W,0,31,5,8,0.625,1,1,1,4,7,0.571,4,5,0.8,1,2,3
3482,Marc Gasol,31-365,C,1/28/17,MEM,@,UTA,W,1,37,7,12,0.583,3,7,0.429,4,5,0.8,0,0,,0,4,4
3483,Marc Gasol,32-036,C,3/6/17,MEM,,BRK,L,1,34,4,11,0.364,2,7,0.286,2,4,0.5,8,10,0.8,1,5,6
3484,Marc Gasol,32-046,C,3/16/17,MEM,@,ATL,W,1,36,7,16,0.438,5,11,0.455,2,5,0.4,2,2,1,1,9,10
3485,Marc Gasol,31-306,C,11/30/16,MEM,@,TOR,L,1,35,7,14,0.5,5,10,0.5,2,4,0.5,2,2,1,3,5,8
3486,Marc Gasol,31-271,C,10/26/16,MEM,,MIN,W,1,32,7,17,0.412,6,14,0.429,1,3,0.333,3,4,0.75,1,2,3
3487,Marc Gasol,31-288,C,11/12/16,MEM,@,MIL,L,1,34,6,13,0.462,5,9,0.556,1,4,0.25,5,6,0.833,1,4,5
3488,Marc Gasol,32-001,C,1/30/17,MEM,@,PHO,W,1,29,6,12,0.5,4,8,0.5,2,4,0.5,4,4,1,1,5,6
3489,Pau Gasol,36-238,F-C,3/1/17,SAS,,IND,W,0,21,4,7,0.571,2,3,0.667,2,4,0.5,8,8,1,0,4,4
3490,Pau Gasol,36-162,F-C,12/15/16,SAS,@,PHO,W,1,24,8,12,0.667,8,11,0.727,0,1,0,2,2,1,2,7,9
3491,Pau Gasol,36-179,F-C,1/1/17,SAS,@,ATL,L,1,38,6,10,0.6,5,9,0.556,1,1,1,5,6,0.833,1,8,9
3492,Pau Gasol,36-246,F-C,3/9/17,SAS,@,OKC,L,0,24,8,14,0.571,6,12,0.5,2,2,1,0,0,,3,4,7
3493,Rudy Gay,30-103,F,11/28/16,SAC,@,WAS,L,1,38,7,16,0.438,6,12,0.5,1,4,0.25,3,3,1,2,3,5
3494,Rudy Gay,30-142,F,1/6/17,SAC,,LAC,L,1,33,7,17,0.412,6,11,0.545,1,6,0.167,3,3,1,1,6,7
3495,Paul George,26-312,F,3/10/17,IND,@,MIL,L,1,42,5,14,0.357,5,9,0.556,0,5,0,8,8,1,1,10,11
3496,Paul George,26-321,F,3/19/17,IND,@,TOR,L,1,31,7,14,0.5,6,10,0.6,1,4,0.25,3,5,0.6,1,3,4
3497,Paul George,26-205,F,11/23/16,IND,,ATL,L,1,38,6,22,0.273,4,11,0.364,2,11,0.182,4,4,1,1,5,6
3498,Paul George,26-227,F,12/15/16,IND,@,NOP,L,1,36,6,13,0.462,4,10,0.4,2,3,0.667,4,4,1,1,3,4
3499,Taj Gibson,31-205,F,1/15/17,CHI,@,MEM,W,1,32,7,14,0.5,7,13,0.538,0,1,0,4,5,0.8,0,8,8
3500,Taj Gibson,31-125,F,10/27/16,CHI,,BOS,W,1,28,8,13,0.615,8,13,0.615,0,0,,2,2,1,2,8,10
3501,Taj Gibson,31-125,F,10/27/16,CHI,,BOS,W,1,28,8,13,0.615,8,13,0.615,0,0,,2,2,1,2,8,10
3502,Manu Ginobili,39-191,G,2/4/17,SAS,,DEN,W,0,10,5,6,0.833,1,1,1,4,5,0.8,4,4,1,0,1,1
3503,Rudy Gobert,24-204,C,1/16/17,UTA,@,PHO,W,1,36,8,12,0.667,8,12,0.667,0,0,,2,5,0.4,6,11,17
3504,Rudy Gobert,24-188,C,12/31/16,UTA,,PHO,W,1,37,7,8,0.875,7,8,0.875,0,0,,4,5,0.8,2,11,13
3505,Aaron Gordon,21-162,F,2/25/17,ORL,,ATL,W,1,24,7,11,0.636,7,9,0.778,0,2,0,4,4,1,0,3,3
3506,Aaron Gordon,21-112,F,1/6/17,ORL,,HOU,L,1,36,7,14,0.5,5,8,0.625,2,6,0.333,2,3,0.667,3,3,6
3507,Eric Gordon,27-343,G,12/2/16,HOU,@,DEN,W,0,24,6,13,0.462,2,5,0.4,4,8,0.5,2,4,0.5,1,1,2
3508,Eric Gordon,28-044,G,2/7/17,HOU,,ORL,W,0,30,5,10,0.5,1,2,0.5,4,8,0.5,4,5,0.8,0,3,3
3509,Eric Gordon,27-308,G,10/28/16,HOU,@,DAL,W,1,33,4,9,0.444,1,3,0.333,3,6,0.5,7,8,0.875,0,4,4
3510,Eric Gordon,28-069,G,3/4/17,HOU,,MEM,W,0,35,6,9,0.667,0,0,,6,9,0.667,0,0,,0,2,2
3511,Eric Gordon,28-085,G,3/20/17,HOU,,DEN,W,0,32,5,9,0.556,1,2,0.5,4,7,0.571,4,4,1,0,1,1
3512,Eric Gordon,27-351,G,12/10/16,HOU,,DAL,W,0,26,6,14,0.429,0,5,0,6,9,0.667,0,0,,1,0,1
3513,Marcin Gortat,32-269,C-F,11/12/16,WAS,@,CHI,L,1,35,9,12,0.75,9,12,0.75,0,0,,0,0,,3,11,14
3514,Jerian Grant,24-037,G,11/15/16,CHI,@,POR,W,1,30,6,13,0.462,4,8,0.5,2,5,0.4,4,4,1,0,3,3
3515,Danny Green,29-191,G-F,12/30/16,SAS,,POR,W,1,31,6,9,0.667,0,1,0,6,8,0.75,0,0,,0,2,2
3516,Draymond Green,26-235,F,10/25/16,GSW,,SAS,L,1,33,7,14,0.5,5,9,0.556,2,5,0.4,2,2,1,5,7,12
3517,Draymond Green,26-282,F,12/11/16,GSW,@,MIN,W,1,35,6,9,0.667,1,1,1,5,8,0.625,1,2,0.5,0,5,5
3518,JaMychal Green,26-193,F,12/31/16,MEM,@,SAC,W,1,38,7,9,0.778,3,4,0.75,4,5,0.8,0,0,,3,4,7
3519,Jeff Green,30-145,F,1/20/17,ORL,,MIL,W,0,27,6,13,0.462,5,8,0.625,1,5,0.2,5,5,1,3,4,7
3520,Jeff Green,30-069,F,11/5/16,ORL,,WAS,W,0,27,5,12,0.417,3,7,0.429,2,5,0.4,6,7,0.857,1,4,5
3521,Blake Griffin,27-364,F,3/15/17,LAC,,MIL,L,1,37,6,12,0.5,5,8,0.625,1,4,0.25,5,8,0.625,2,5,7
3522,Blake Griffin,27-228,F,10/30/16,LAC,,UTA,W,1,30,7,14,0.5,7,13,0.538,0,1,0,4,6,0.667,3,7,10
3523,Tim Hardaway,25-000,G,3/16/17,ATL,,MEM,L,0,30,6,14,0.429,4,5,0.8,2,9,0.222,4,5,0.8,0,4,4
3524,Tim Hardaway,24-268,G,12/9/16,ATL,@,MIL,W,1,31,6,17,0.353,3,8,0.375,3,9,0.333,3,5,0.6,2,2,4
3525,James Harden,27-106,G,12/10/16,HOU,,DAL,W,1,40,4,12,0.333,2,4,0.5,2,8,0.25,8,10,0.8,0,9,9
3526,James Harden,27-201,G,3/15/17,HOU,,LAL,W,1,31,6,12,0.5,5,6,0.833,1,6,0.167,5,7,0.714,3,9,12
3527,Maurice Harkless,23-200,F-G,11/27/16,POR,,HOU,L,1,38,7,12,0.583,5,8,0.625,2,4,0.5,2,2,1,1,2,3
3528,Maurice Harkless,23-297,F-G,3/4/17,POR,,BRK,W,1,30,6,7,0.857,4,5,0.8,2,2,1,4,5,0.8,1,1,2
3529,Maurice Harkless,23-179,F-G,11/6/16,POR,@,MEM,W,1,34,8,15,0.533,6,10,0.6,2,5,0.4,0,0,,2,5,7
3530,Maurice Harkless,23-291,F-G,2/26/17,POR,@,TOR,L,1,36,7,9,0.778,5,6,0.833,2,3,0.667,2,4,0.5,2,3,5
3531,Gary Harris,22-092,G,12/15/16,DEN,,POR,W,1,32,7,11,0.636,4,7,0.571,3,4,0.75,1,1,1,0,4,4
3532,Tobias Harris,24-181,F,1/12/17,DET,@,GSW,L,1,34,8,15,0.533,7,11,0.636,1,4,0.25,1,2,0.5,0,4,4
3533,Tobias Harris,24-179,F,1/10/17,DET,@,SAC,L,1,40,7,16,0.438,5,10,0.5,2,6,0.333,2,2,1,0,3,3
3534,Tobias Harris,24-190,F,1/21/17,DET,,WAS,W,1,40,8,16,0.5,6,8,0.75,2,8,0.25,0,1,0,1,8,9
3535,Tobias Harris,24-140,F,12/2/16,DET,@,ATL,W,1,32,8,13,0.615,6,10,0.6,2,3,0.667,0,0,,1,6,7
3536,Tobias Harris,24-105,F,10/28/16,DET,,ORL,W,1,27,8,16,0.5,6,11,0.545,2,5,0.4,0,0,,0,4,4
3537,Spencer Hawes,28-252,C-F,1/5/17,CHO,@,DET,L,0,28,6,13,0.462,3,8,0.375,3,5,0.6,3,3,1,0,4,4
3538,Gordon Hayward,26-283,F-G,12/31/16,UTA,,PHO,W,1,35,7,13,0.538,7,11,0.636,0,2,0,4,5,0.8,1,8,9
3539,Gerald Henderson,29-028,G,1/6/17,PHI,@,BOS,L,0,29,6,9,0.667,4,6,0.667,2,3,0.667,4,4,1,0,4,4
3540,Gerald Henderson,28-328,G,11/1/16,PHI,,ORL,L,1,31,7,13,0.538,7,13,0.538,0,0,,4,5,0.8,1,3,4
3541,Buddy Hield,22-321,G,11/2/16,NOP,@,MEM,L,0,31,6,15,0.4,2,6,0.333,4,9,0.444,2,2,1,0,4,4
3542,Buddy Hield,22-331,G,11/12/16,NOP,,LAL,L,0,26,8,13,0.615,7,9,0.778,1,4,0.25,1,1,1,0,3,3
3543,Buddy Hield,23-083,G,3/10/17,SAC,,WAS,L,1,37,7,16,0.438,3,8,0.375,4,8,0.5,0,0,,2,2,4
3544,Buddy Hield,23-092,G,3/19/17,SAC,@,SAS,L,1,32,8,14,0.571,6,11,0.545,2,3,0.667,0,0,,0,5,5
3545,Nene Hilario,34-114,F-C,1/5/17,HOU,,OKC,W,1,17,6,6,1,6,6,1,0,0,,6,10,0.6,0,3,3
3546,George Hill,30-179,G,10/30/16,UTA,@,LAC,L,1,32,8,13,0.615,6,9,0.667,2,4,0.5,0,0,,1,1,2
3547,George Hill,30-318,G,3/18/17,UTA,@,CHI,L,1,37,6,11,0.545,4,6,0.667,2,5,0.4,4,4,1,1,6,7
3548,Solomon Hill,25-228,F,11/1/16,NOP,,MIL,L,1,36,5,9,0.556,2,5,0.4,3,4,0.75,5,8,0.625,1,5,6
3549,Jrue Holiday,26-207,G,1/5/17,NOP,,ATL,L,1,35,5,13,0.385,1,7,0.143,4,6,0.667,4,4,1,0,2,2
3550,Jrue Holiday,26-258,G,2/25/17,NOP,@,DAL,L,1,39,5,17,0.294,3,11,0.273,2,6,0.333,6,6,1,3,4,7
3551,Jrue Holiday,26-246,G,2/13/17,NOP,@,PHO,W,1,36,6,11,0.545,4,5,0.8,2,6,0.333,4,6,0.667,1,1,2
3552,Richaun Holmes,23-101,F-C,1/24/17,PHI,,LAC,W,0,19,8,11,0.727,7,10,0.7,1,1,1,1,1,1,0,3,3
3553,Rodney Hood,24-018,G-F,11/7/16,UTA,@,PHI,W,1,29,7,13,0.538,3,8,0.375,4,5,0.8,0,0,,0,2,2
3554,Rodney Hood,24-017,G-F,11/6/16,UTA,@,NYK,W,1,38,7,13,0.538,5,9,0.556,2,4,0.5,2,3,0.667,0,6,6
3555,Rodney Hood,24-015,G-F,11/4/16,UTA,,SAS,L,1,24,7,12,0.583,5,8,0.625,2,4,0.5,2,4,0.5,1,4,5
3556,Rodney Hood,24-082,G-F,1/10/17,UTA,,CLE,W,1,35,7,15,0.467,3,5,0.6,4,10,0.4,0,0,,1,4,5
3557,Rodney Hood,24-131,G-F,2/28/17,UTA,@,OKC,L,1,31,6,13,0.462,3,7,0.429,3,6,0.5,3,3,1,0,6,6
3558,Al Horford,30-169,C-F,11/19/16,BOS,@,DET,W,1,34,7,12,0.583,5,9,0.556,2,3,0.667,2,2,1,2,9,11
3559,Al Horford,30-196,C-F,12/16/16,BOS,,CHO,W,1,35,6,11,0.545,6,11,0.545,0,0,,6,8,0.75,1,7,8
3560,Dwight Howard,30-348,C,11/20/16,ATL,@,NYK,L,1,29,6,11,0.545,6,11,0.545,0,0,,6,12,0.5,8,10,18
3561,Dwight Howard,30-328,C,10/31/16,ATL,,SAC,W,1,30,5,9,0.556,5,9,0.556,0,0,,8,20,0.4,7,4,11
3562,Dwight Howard,30-337,C,11/9/16,ATL,,CHI,W,1,34,6,9,0.667,6,9,0.667,0,0,,6,9,0.667,6,4,10
3563,Serge Ibaka,27-161,F-C,2/26/17,TOR,,POR,W,1,34,8,15,0.533,6,10,0.6,2,5,0.4,0,0,,2,8,10
3564,Serge Ibaka,27-072,F-C,11/29/16,ORL,@,SAS,W,1,34,7,11,0.636,5,7,0.714,2,4,0.5,2,2,1,1,6,7
3565,Serge Ibaka,27-173,F-C,3/10/17,TOR,@,ATL,L,1,30,6,12,0.5,4,7,0.571,2,5,0.4,4,4,1,2,1,3
3566,Serge Ibaka,27-089,F-C,12/16/16,ORL,,BRK,W,1,32,8,13,0.615,7,11,0.636,1,2,0.5,1,3,0.333,2,9,11
3567,Ersan Ilyasova,29-248,F,1/18/17,PHI,,TOR,W,1,24,7,14,0.5,4,8,0.5,3,6,0.5,1,2,0.5,1,3,4
3568,Ersan Ilyasova,29-244,F,1/14/17,PHI,@,WAS,L,1,26,7,13,0.538,4,8,0.5,3,5,0.6,1,2,0.5,3,4,7
3569,Ersan Ilyasova,29-202,F,12/3/16,PHI,,BOS,L,1,30,6,14,0.429,3,7,0.429,3,7,0.429,3,3,1,0,6,6
3570,Ersan Ilyasova,29-290,F,3/1/17,ATL,,DAL,W,0,26,6,7,0.857,2,3,0.667,4,4,1,2,2,1,0,1,1
3571,Joe Ingles,29-162,F-G,3/13/17,UTA,,LAC,W,0,26,6,9,0.667,3,5,0.6,3,4,0.75,3,3,1,1,3,4
3572,Joe Ingles,29-136,F-G,2/15/17,UTA,,POR,W,1,32,7,9,0.778,3,3,1,4,6,0.667,0,0,,0,4,4
3573,Brandon Ingram,19-194,F,3/15/17,LAL,@,HOU,L,1,39,8,14,0.571,6,11,0.545,2,3,0.667,0,0,,1,5,6
3574,Brandon Ingram,19-198,F,3/19/17,LAL,,CLE,L,1,40,8,15,0.533,8,13,0.615,0,2,0,2,2,1,0,6,6
3575,Kyrie Irving,24-278,G,12/26/16,CLE,@,DET,L,1,29,8,20,0.4,6,14,0.429,2,6,0.333,0,1,0,1,4,5
3576,Kyrie Irving,24-313,G,1/30/17,CLE,@,DAL,L,1,33,7,21,0.333,6,13,0.462,1,8,0.125,3,3,1,1,4,5
3577,Reggie Jackson,26-249,G,12/21/16,DET,,MEM,L,1,26,6,12,0.5,4,8,0.5,2,4,0.5,4,4,1,0,1,1
3578,Reggie Jackson,26-232,G,12/4/16,DET,,ORL,L,1,23,7,12,0.583,5,9,0.556,2,3,0.667,2,2,1,0,1,1
3579,Reggie Jackson,26-282,G,1/23/17,DET,,SAC,L,1,35,6,12,0.5,3,7,0.429,3,5,0.6,3,4,0.75,1,2,3
3580,LeBron James,32-055,F-G,2/23/17,CLE,,NYK,W,1,37,7,11,0.636,7,9,0.778,0,2,0,4,6,0.667,0,13,13
3581,LeBron James,32-041,F-G,2/9/17,CLE,@,OKC,L,1,41,8,19,0.421,7,15,0.467,1,4,0.25,1,3,0.333,1,4,5
3582,Al Jefferson,31-310,C-F,11/9/16,IND,,PHI,W,0,20,9,12,0.75,9,12,0.75,0,0,,0,0,,2,5,7
3583,Al Jefferson,31-351,C-F,12/20/16,IND,@,NYK,L,0,16,8,11,0.727,8,11,0.727,0,0,,2,2,1,2,1,3
3584,Brandon Jennings,27-128,G,1/29/17,NYK,@,ATL,L,1,53,5,15,0.333,1,7,0.143,4,8,0.5,4,6,0.667,0,3,3
3585,James Johnson,29-261,F,11/7/16,MIA,@,OKC,L,0,25,5,12,0.417,4,9,0.444,1,3,0.333,7,7,1,2,4,6
3586,James Johnson,29-343,F,1/28/17,MIA,,DET,W,0,32,7,13,0.538,7,12,0.583,0,1,0,4,4,1,0,8,8
3587,Joe Johnson,35-155,G-F,12/1/16,UTA,,MIA,L,1,33,6,9,0.667,2,3,0.667,4,6,0.667,2,2,1,0,3,3
3588,Joe Johnson,35-220,G-F,2/4/17,UTA,,CHO,W,0,30,7,12,0.583,3,5,0.6,4,7,0.571,0,0,,2,4,6
3589,Tyler Johnson,24-207,G,11/30/16,MIA,@,DEN,W,0,28,7,13,0.538,7,13,0.538,0,0,,4,6,0.667,1,1,2
3590,Tyler Johnson,24-236,G,12/29/16,MIA,@,CHO,L,0,28,8,16,0.5,6,10,0.6,2,6,0.333,0,0,,1,6,7
3591,Tyler Johnson,24-279,G,2/10/17,MIA,@,BRK,W,0,36,6,16,0.375,6,13,0.462,0,3,0,6,6,1,3,3,6
3592,Tyler Johnson,24-248,G,1/10/17,MIA,@,GSW,L,0,30,6,11,0.545,3,3,1,3,8,0.375,3,4,0.75,1,6,7
3593,Nikola Jokic,21-355,C-F,2/8/17,DEN,@,ATL,L,1,34,8,17,0.471,6,14,0.429,2,3,0.667,0,0,,9,6,15
3594,Nikola Jokic,22-022,C-F,3/13/17,DEN,,LAL,W,1,24,8,13,0.615,8,10,0.8,0,3,0,2,2,1,1,8,9
3595,Nikola Jokic,21-319,C-F,1/3/17,DEN,,SAC,L,1,28,7,11,0.636,6,9,0.667,1,2,0.5,3,3,1,1,5,6
3596,Nikola Jokic,21-338,C-F,1/22/17,DEN,@,MIN,L,1,27,8,15,0.533,8,12,0.667,0,3,0,2,2,1,5,4,9
3597,Terrence Jones,24-336,F,12/10/16,NOP,@,LAC,L,1,26,7,9,0.778,5,6,0.833,2,3,0.667,2,4,0.5,1,4,5
3598,DeAndre Jordan,28-114,C,11/12/16,LAC,@,MIN,W,1,34,4,6,0.667,4,6,0.667,0,0,,10,16,0.625,4,12,16
3599,DeAndre Jordan,28-167,C,1/4/17,LAC,,MEM,W,1,37,7,10,0.7,7,10,0.7,0,0,,4,11,0.364,4,16,20
3600,Enes Kanter,24-286,C,3/2/17,OKC,@,POR,L,0,28,6,13,0.462,6,13,0.462,0,0,,6,7,0.857,2,8,10
3601,Sean Kilpatrick,27-006,G,1/12/17,BRK,,NOP,L,0,27,6,12,0.5,3,6,0.5,3,6,0.5,3,3,1,0,7,7
3602,Sean Kilpatrick,27-021,G,1/27/17,BRK,@,CLE,L,0,34,7,17,0.412,4,12,0.333,3,5,0.6,1,2,0.5,0,2,2
3603,Sean Kilpatrick,27-030,G,2/5/17,BRK,,TOR,L,0,32,5,10,0.5,0,1,0,5,9,0.556,3,3,1,0,5,5
3604,Sean Kilpatrick,26-296,G,10/28/16,BRK,,IND,W,0,25,7,11,0.636,3,7,0.429,4,4,1,0,0,,1,4,5
3605,Sean Kilpatrick,27-028,G,2/3/17,BRK,,IND,L,0,26,6,11,0.545,4,7,0.571,2,4,0.5,4,4,1,0,5,5
3606,Sean Kilpatrick,26-357,G,12/28/16,BRK,@,CHI,L,1,34,6,14,0.429,2,5,0.4,4,9,0.444,2,2,1,0,3,3
3607,Brandon Knight,24-334,G,10/31/16,PHO,@,LAC,L,1,31,6,13,0.462,4,9,0.444,2,4,0.5,4,4,1,0,0,0
3608,Kyle Korver,35-302,G-F,1/13/17,CLE,@,SAC,W,0,25,7,10,0.7,3,4,0.75,4,6,0.667,0,0,,1,4,5
3609,Kosta Koufos,27-314,C,1/3/17,SAC,@,DEN,W,1,29,8,9,0.889,8,9,0.889,0,0,,2,3,0.667,1,4,5
3610,Jeremy Lamb,24-180,G-F,11/26/16,CHO,,NYK,W,1,36,8,15,0.533,7,12,0.583,1,3,0.333,1,2,0.5,2,15,17
3611,Zach LaVine,21-286,G,12/21/16,MIN,@,ATL,W,1,38,5,12,0.417,1,4,0.25,4,8,0.5,4,4,1,1,3,4
3612,Zach LaVine,21-313,G,1/17/17,MIN,@,SAS,L,1,35,8,14,0.571,6,9,0.667,2,5,0.4,0,0,,0,4,4
3613,Ty Lawson,29-092,G,2/3/17,SAC,,PHO,L,0,28,7,10,0.7,7,9,0.778,0,1,0,4,4,1,2,3,5
3614,Ty Lawson,29-015,G,11/18/16,SAC,,LAC,L,1,36,7,11,0.636,5,8,0.625,2,3,0.667,2,2,1,1,6,7
3615,David Lee,33-313,F,3/8/17,SAS,,SAC,W,1,31,8,9,0.889,8,9,0.889,0,0,,2,5,0.4,2,8,10
3616,David Lee,33-306,F,3/1/17,SAS,,IND,W,0,21,8,8,1,8,8,1,0,0,,2,2,1,2,3,5
3617,Alex Len,23-139,C,11/2/16,PHO,,POR,W,0,21,6,10,0.6,6,9,0.667,0,1,0,6,6,1,4,2,6
3618,Kawhi Leonard,25-169,F,12/15/16,SAS,@,PHO,W,1,27,6,12,0.5,5,9,0.556,1,3,0.333,5,5,1,2,8,10
3619,Jon Leuer,27-221,F,12/21/16,DET,,MEM,L,0,30,6,13,0.462,5,9,0.556,1,4,0.25,5,5,1,0,5,5
3620,Damian Lillard,26-128,G,11/20/16,POR,@,BRK,W,1,28,8,14,0.571,8,9,0.889,0,5,0,2,4,0.5,0,4,4
3621,Damian Lillard,26-125,G,11/17/16,POR,@,HOU,L,1,34,7,17,0.412,6,12,0.5,1,5,0.2,3,5,0.6,1,4,5
3622,Jeremy Lin,28-195,G,3/6/17,BRK,@,MEM,W,1,24,5,10,0.5,2,3,0.667,3,7,0.429,5,6,0.833,0,4,4
3623,Jeremy Lin,28-193,G,3/4/17,BRK,@,POR,L,1,22,6,14,0.429,2,7,0.286,4,7,0.571,2,2,1,0,3,3
3624,Jeremy Lin,28-064,G,10/26/16,BRK,@,BOS,L,1,28,6,14,0.429,4,9,0.444,2,5,0.4,4,5,0.8,1,2,3
3625,Jeremy Lin,28-199,G,3/10/17,BRK,@,DAL,L,1,27,4,9,0.444,3,6,0.5,1,3,0.333,9,10,0.9,1,4,5
3626,Brook Lopez,28-217,C,11/4/16,BRK,,CHO,L,1,29,7,17,0.412,5,11,0.455,2,6,0.333,2,3,0.667,1,2,3
3627,Brook Lopez,28-341,C,3/8/17,BRK,@,ATL,L,1,29,7,18,0.389,5,13,0.385,2,5,0.4,2,2,1,2,4,6
3628,Robin Lopez,28-339,C,3/6/17,CHI,@,DET,L,1,34,8,17,0.471,8,17,0.471,0,0,,2,2,1,0,4,4
3629,Kevin Love,28-051,F,10/28/16,CLE,@,TOR,W,1,36,6,15,0.4,4,10,0.4,2,5,0.4,4,4,1,2,8,10
3630,Kyle Lowry,30-222,G,11/2/16,TOR,@,WAS,W,1,36,7,13,0.538,4,7,0.571,3,6,0.5,1,2,0.5,0,1,1
3631,Kyle Lowry,30-238,G,11/18/16,TOR,@,DEN,W,1,38,6,15,0.4,3,8,0.375,3,7,0.429,3,4,0.75,0,5,5
3632,Kyle Lowry,30-315,G,2/3/17,TOR,@,ORL,L,1,42,5,20,0.25,3,9,0.333,2,11,0.182,6,6,1,1,4,5
3633,Kyle Lowry,30-262,G,12/12/16,TOR,,MIL,W,1,34,5,9,0.556,1,2,0.5,4,7,0.571,4,4,1,0,3,3
3634,Timothe Luwawu-Cabarrot,21-307,F,3/12/17,PHI,@,LAL,W,1,27,7,11,0.636,5,7,0.714,2,4,0.5,2,2,1,0,3,3
3635,Trey Lyles,21-009,F,11/14/16,UTA,,MEM,L,0,32,6,12,0.5,5,6,0.833,1,6,0.167,5,6,0.833,1,4,5
3636,Wesley Matthews,30-090,G,1/12/17,DAL,@,PHO,W,1,38,7,14,0.5,3,6,0.5,4,8,0.5,0,0,,0,0,0
3637,Wesley Matthews,30-040,G,11/23/16,DAL,,LAC,L,1,30,6,10,0.6,3,7,0.429,3,3,1,3,3,1,0,4,4
3638,Wesley Matthews,30-122,G,2/13/17,DAL,,BOS,L,1,35,5,12,0.417,4,7,0.571,1,5,0.2,7,10,0.7,0,7,7
3639,Wesley Matthews,30-097,G,1/19/17,DAL,@,MIA,L,1,37,7,14,0.5,3,5,0.6,4,9,0.444,0,0,,0,5,5
3640,C.J. McCollum,25-181,G,3/19/17,POR,@,MIA,W,1,37,7,16,0.438,5,11,0.455,2,5,0.4,2,2,1,0,5,5
3641,C.J. McCollum,25-121,G,1/18/17,POR,@,CHO,L,1,32,7,18,0.389,5,12,0.417,2,6,0.333,2,2,1,0,2,2
3642,C.J. McCollum,25-164,G,3/2/17,POR,,OKC,W,1,34,5,14,0.357,3,10,0.3,2,4,0.5,6,6,1,0,6,6
3643,C.J. McCollum,25-134,G,1/31/17,POR,,CHO,W,1,26,7,14,0.5,5,10,0.5,2,4,0.5,2,2,1,0,2,2
3644,C.J. McCollum,25-130,G,1/27/17,POR,,MEM,W,1,31,7,11,0.636,7,7,1,0,4,0,4,4,1,2,2,4
3645,C.J. McCollum,25-149,G,2/15/17,POR,@,UTA,L,1,25,8,19,0.421,6,14,0.429,2,5,0.4,0,0,,1,1,2
3646,Ben McLemore,24-014,G,2/25/17,SAC,,CHO,L,1,33,7,15,0.467,4,8,0.5,3,7,0.429,1,1,1,0,2,2
3647,Ben McLemore,23-358,G,2/3/17,SAC,,PHO,L,1,35,6,12,0.5,3,6,0.5,3,6,0.5,3,4,0.75,0,0,0
3648,Jodie Meeks,29-107,G,12/6/16,ORL,@,WAS,W,0,16,5,7,0.714,1,2,0.5,4,5,0.8,4,4,1,0,2,2
3649,Khris Middleton,25-208,F-G,3/8/17,MIL,,NYK,W,1,28,7,9,0.778,3,3,1,4,6,0.667,0,0,,0,3,3
3650,C.J. Miles,29-284,G-F,1/27/17,IND,,SAC,W,1,40,6,9,0.667,0,0,,6,9,0.667,0,0,,0,2,2
3651,C.J. Miles,29-235,G-F,12/9/16,IND,@,DAL,L,0,28,6,9,0.667,0,0,,6,9,0.667,0,0,,0,4,4
3652,Patty Mills,28-166,G,1/24/17,SAS,@,TOR,W,0,30,8,15,0.533,6,10,0.6,2,5,0.4,0,1,0,0,0,0
3653,Patty Mills,28-080,G,10/30/16,SAS,@,MIA,W,0,25,6,10,0.6,2,4,0.5,4,6,0.667,2,2,1,0,0,0
3654,Patty Mills,28-079,G,10/29/16,SAS,,NOP,W,1,24,6,9,0.667,2,2,1,4,7,0.571,2,2,1,1,0,1
3655,Paul Millsap,31-287,F,11/23/16,ATL,@,IND,W,1,36,8,18,0.444,8,14,0.571,0,4,0,2,2,1,4,7,11
3656,Paul Millsap,31-340,F,1/15/17,ATL,,MIL,W,1,36,7,12,0.583,4,7,0.571,3,5,0.6,1,1,1,2,6,8
3657,Paul Millsap,31-315,F,12/21/16,ATL,,MIN,L,1,39,7,18,0.389,7,13,0.538,0,5,0,4,6,0.667,3,7,10
3658,Paul Millsap,32-019,F,3/1/17,ATL,,DAL,W,1,38,6,12,0.5,6,11,0.545,0,1,0,6,8,0.75,1,7,8
3659,Nikola Mirotic,25-298,F,12/5/16,CHI,,POR,L,0,27,4,8,0.5,1,4,0.25,3,4,0.75,7,8,0.875,0,7,7
3660,Greg Monroe,26-279,C-F,3/10/17,MIL,,IND,W,0,27,6,7,0.857,6,7,0.857,0,0,,6,7,0.857,1,6,7
3661,Greg Monroe,26-214,C-F,1/4/17,MIL,@,NYK,W,0,31,7,10,0.7,7,10,0.7,0,0,,4,10,0.4,3,6,9
3662,E'Twaun Moore,27-332,G,1/25/17,NOP,,OKC,L,0,28,6,9,0.667,4,6,0.667,2,3,0.667,4,4,1,3,5,8
3663,E'Twaun Moore,28-015,G,3/15/17,NOP,@,MIA,L,0,35,8,12,0.667,7,9,0.778,1,3,0.333,1,2,0.5,0,1,1
3664,E'Twaun Moore,27-244,G,10/29/16,NOP,@,SAS,L,1,25,8,13,0.615,8,11,0.727,0,2,0,2,3,0.667,0,0,0
3665,Marcus Morris,27-088,F,11/29/16,DET,@,CHO,W,1,36,8,18,0.444,6,12,0.5,2,6,0.333,0,0,,0,4,4
3666,Markieff Morris,27-155,F,2/4/17,WAS,,NOP,W,1,38,6,16,0.375,4,10,0.4,2,6,0.333,4,4,1,0,4,4
3667,Markieff Morris,27-115,F,12/26/16,WAS,,MIL,W,1,38,7,11,0.636,6,9,0.667,1,2,0.5,3,4,0.75,1,3,4
3668,Markieff Morris,27-064,F,11/5/16,WAS,@,ORL,L,1,38,5,16,0.313,4,12,0.333,1,4,0.25,7,9,0.778,1,6,7
3669,Markieff Morris,27-063,F,11/4/16,WAS,,ATL,W,1,33,5,13,0.385,4,10,0.4,1,3,0.333,7,9,0.778,0,9,9
3670,Emmanuel Mudiay,20-317,G,1/16/17,DEN,,ORL,W,1,37,6,12,0.5,4,8,0.5,2,4,0.5,4,4,1,0,2,2
3671,Emmanuel Mudiay,20-289,G,12/19/16,DEN,,DAL,W,1,33,7,12,0.583,3,7,0.429,4,5,0.8,0,0,,0,5,5
3672,Shabazz Muhammad,24-076,F-G,1/28/17,MIN,,BRK,W,0,28,6,11,0.545,4,8,0.5,2,3,0.667,4,4,1,5,2,7
3673,Shabazz Muhammad,24-128,F-G,3/21/17,MIN,,SAS,L,0,24,8,15,0.533,6,12,0.5,2,3,0.667,0,0,,3,1,4
3674,Shabazz Muhammad,24-108,F-G,3/1/17,MIN,@,UTA,W,0,24,7,12,0.583,7,10,0.7,0,2,0,4,4,1,2,1,3
3675,Jamal Murray,19-340,G,1/28/17,DEN,@,PHO,W,0,23,7,10,0.7,6,8,0.75,1,2,0.5,3,3,1,0,1,1
3676,Jamal Murray,19-271,G,11/20/16,DEN,,UTA,W,0,23,6,8,0.75,3,4,0.75,3,4,0.75,3,4,0.75,1,1,2
3677,Jamal Murray,19-346,G,2/3/17,DEN,,MIL,W,0,21,5,9,0.556,4,7,0.571,1,2,0.5,7,7,1,1,2,3
3678,Larry Nance Jr.,23-324,F,11/20/16,LAL,,CHI,L,0,26,8,11,0.727,8,11,0.727,0,0,,2,2,1,2,4,6
3679,Larry Nance Jr.,24-033,F,2/3/17,LAL,@,BOS,L,0,32,7,13,0.538,7,13,0.538,0,0,,4,6,0.667,5,6,11
3680,Jameer Nelson,34-342,G,1/16/17,DEN,,ORL,W,0,32,7,10,0.7,5,5,1,2,5,0.4,2,2,1,1,3,4
3681,Dirk Nowitzki,38-251,F,2/25/17,DAL,,NOP,W,1,28,8,12,0.667,6,10,0.6,2,2,1,0,0,,0,9,9
3682,Dirk Nowitzki,38-207,F,1/12/17,DAL,@,PHO,W,1,30,7,15,0.467,4,10,0.4,3,5,0.6,1,1,1,0,6,6
3683,Dirk Nowitzki,38-239,F,2/13/17,DAL,,BOS,L,1,29,7,17,0.412,6,12,0.5,1,5,0.2,3,3,1,0,5,5
3684,Dirk Nowitzki,38-259,F,3/5/17,DAL,,OKC,W,1,30,8,17,0.471,7,13,0.538,1,4,0.25,1,1,1,0,13,13
3685,Jusuf Nurkic,22-072,C,11/3/16,DEN,@,MIN,W,1,27,7,13,0.538,7,13,0.538,0,0,,4,7,0.571,2,3,5
3686,Jusuf Nurkic,22-191,C,3/2/17,POR,,OKC,W,1,38,7,10,0.7,7,10,0.7,0,0,,4,5,0.8,3,9,12
3687,Kyle O'Quinn,26-319,F-C,2/8/17,NYK,,LAC,L,1,25,8,13,0.615,8,13,0.615,0,0,,2,2,1,2,4,6
3688,Jahlil Okafor,20-333,C-F,11/12/16,PHI,@,ATL,L,1,24,7,13,0.538,7,13,0.538,0,0,,4,8,0.5,3,3,6
3689,Victor Oladipo,24-264,G,1/23/17,OKC,@,UTA,W,1,30,8,11,0.727,7,10,0.7,1,1,1,1,2,0.5,1,3,4
3690,Victor Oladipo,24-245,G,1/4/17,OKC,@,CHO,L,1,36,7,20,0.35,4,12,0.333,3,8,0.375,1,2,0.5,2,1,3
3691,Victor Oladipo,24-206,G,11/26/16,OKC,,DET,W,1,33,6,10,0.6,3,5,0.6,3,5,0.6,3,6,0.5,1,5,6
3692,Victor Oladipo,24-243,G,1/2/17,OKC,@,MIL,L,1,35,7,12,0.583,3,5,0.6,4,7,0.571,0,0,,1,4,5
3693,Victor Oladipo,24-191,G,11/11/16,OKC,,LAC,L,1,38,6,19,0.316,2,11,0.182,4,8,0.5,2,3,0.667,1,1,2
3694,Victor Oladipo,24-203,G,11/23/16,OKC,@,SAC,L,1,36,7,15,0.467,4,7,0.571,3,8,0.375,1,2,0.5,0,6,6
3695,Victor Oladipo,24-189,G,11/9/16,OKC,,TOR,L,1,36,6,16,0.375,1,7,0.143,5,9,0.556,1,1,1,3,5,8
3696,Kelly Oubre,21-038,F,1/16/17,WAS,,POR,W,0,28,5,8,0.625,2,4,0.5,3,4,0.75,5,5,1,3,1,4
3697,Jabari Parker,21-326,F,2/4/17,MIL,@,PHO,W,1,31,7,10,0.7,7,9,0.778,0,1,0,4,6,0.667,2,7,9
3698,Jabari Parker,21-259,F,11/29/16,MIL,,CLE,W,1,31,7,17,0.412,6,14,0.429,1,3,0.333,3,3,1,1,3,4
3699,Tony Parker,34-227,G,12/30/16,SAS,,POR,W,1,22,7,15,0.467,6,14,0.429,1,1,1,3,5,0.6,0,2,2
3700,Tony Parker,34-267,G,2/8/17,SAS,@,PHI,W,1,30,7,12,0.583,6,11,0.545,1,1,1,3,3,1,0,1,1
3701,Tony Parker,34-263,G,2/4/17,SAS,,DEN,W,1,23,8,8,1,8,8,1,0,0,,2,2,1,0,0,0
3702,Chris Paul,31-201,G,11/23/16,LAC,@,DAL,W,1,26,6,10,0.6,4,6,0.667,2,4,0.5,4,4,1,1,2,3
3703,Chris Paul,31-314,G,3/16/17,LAC,@,DEN,L,1,30,8,12,0.667,6,9,0.667,2,3,0.667,0,0,,0,1,1
3704,Chris Paul,31-212,G,12/4/16,LAC,,IND,L,1,35,5,9,0.556,3,4,0.75,2,5,0.4,6,7,0.857,0,2,2
3705,Chris Paul,31-250,G,1/11/17,LAC,,ORL,W,1,33,6,13,0.462,5,8,0.625,1,5,0.2,5,6,0.833,0,7,7
3706,Elfrid Payton,22-253,G,11/1/16,ORL,@,PHI,W,1,38,8,17,0.471,7,14,0.5,1,3,0.333,1,3,0.333,0,3,3
3707,Elfrid Payton,22-261,G,11/9/16,ORL,,MIN,L,1,27,8,14,0.571,7,11,0.636,1,3,0.333,1,1,1,0,3,3
3708,Mason Plumlee,26-302,C-F,1/1/17,POR,@,MIN,W,1,29,6,9,0.667,6,9,0.667,0,0,,6,10,0.6,2,6,8
3709,Mason Plumlee,26-283,C-F,12/13/16,POR,,OKC,W,1,29,7,9,0.778,7,9,0.778,0,0,,4,6,0.667,1,6,7
3710,Mason Plumlee,26-282,C-F,12/12/16,POR,@,LAC,L,1,34,8,15,0.533,8,15,0.533,0,0,,2,4,0.5,4,3,7
3711,Otto Porter,23-273,F,3/3/17,WAS,,TOR,L,1,36,4,10,0.4,2,5,0.4,2,5,0.4,8,9,0.889,3,5,8
3712,Otto Porter,23-185,F,12/5/16,WAS,@,BRK,W,1,36,7,9,0.778,3,4,0.75,4,5,0.8,0,0,,0,4,4
3713,Otto Porter,23-281,F,3/11/17,WAS,@,POR,W,1,40,8,14,0.571,6,9,0.667,2,5,0.4,0,1,0,2,8,10
3714,Otto Porter,23-280,F,3/10/17,WAS,@,SAC,W,1,39,7,11,0.636,5,8,0.625,2,3,0.667,2,2,1,1,5,6
3715,Otto Porter,23-255,F,2/13/17,WAS,,OKC,W,1,34,6,11,0.545,4,7,0.571,2,4,0.5,4,4,1,1,11,12
3716,Otto Porter,23-203,F,12/23/16,WAS,@,MIL,L,1,25,7,9,0.778,3,4,0.75,4,5,0.8,0,0,,2,3,5
3717,Kristaps Porzingis,21-178,F-C,1/27/17,NYK,,CHO,W,1,35,8,11,0.727,6,7,0.857,2,4,0.5,0,0,,1,3,4
3718,Kristaps Porzingis,21-221,F-C,3/11/17,NYK,@,DET,L,1,36,7,16,0.438,4,9,0.444,3,7,0.429,1,3,0.333,2,4,6
3719,Kristaps Porzingis,21-213,F-C,3/3/17,NYK,@,PHI,L,1,31,6,12,0.5,6,10,0.6,0,2,0,6,6,1,0,8,8
3720,Kristaps Porzingis,21-091,F-C,11/1/16,NYK,@,DET,L,1,30,7,18,0.389,5,11,0.455,2,7,0.286,2,2,1,2,4,6
3721,Kristaps Porzingis,21-230,F-C,3/20/17,NYK,@,LAC,L,1,32,9,16,0.563,9,12,0.75,0,4,0,0,0,,3,8,11
3722,Norman Powell,23-254,G,2/3/17,TOR,@,ORL,L,1,38,7,12,0.583,5,10,0.5,2,2,1,2,2,1,2,0,2
3723,Norman Powell,23-251,G,1/31/17,TOR,,NOP,W,1,40,8,15,0.533,8,13,0.615,0,2,0,2,2,1,0,4,4
3724,Julius Randle,21-343,F,11/6/16,LAL,,PHO,W,1,28,6,9,0.667,6,9,0.667,0,0,,6,6,1,0,5,5
3725,Julius Randle,22-030,F,12/29/16,LAL,,DAL,L,1,28,5,10,0.5,5,9,0.556,0,1,0,8,10,0.8,1,3,4
3726,Julius Randle,21-332,F,10/26/16,LAL,,HOU,W,1,29,9,11,0.818,9,10,0.9,0,1,0,0,1,0,0,7,7
3727,Zach Randolph,35-245,F,3/18/17,MEM,,SAS,W,0,26,7,12,0.583,6,11,0.545,1,1,1,3,5,0.6,2,5,7
3728,Zach Randolph,35-126,F,11/19/16,MEM,,MIN,W,0,21,7,11,0.636,6,9,0.667,1,2,0.5,3,4,0.75,1,6,7
3729,Zach Randolph,35-198,F,1/30/17,MEM,@,PHO,W,0,23,8,13,0.615,6,10,0.6,2,3,0.667,0,0,,0,6,6
3730,Zach Randolph,35-123,F,11/16/16,MEM,@,LAC,W,0,26,7,13,0.538,7,13,0.538,0,0,,4,4,1,2,5,7
3731,Zach Randolph,35-150,F,12/13/16,MEM,@,CLE,L,1,31,9,15,0.6,9,14,0.643,0,1,0,0,0,,1,4,5
3732,Zach Randolph,35-121,F,11/14/16,MEM,@,UTA,W,0,23,7,13,0.538,7,13,0.538,0,0,,4,4,1,5,5,10
3733,Zach Randolph,35-236,F,3/9/17,MEM,,LAC,L,0,25,8,15,0.533,7,14,0.5,1,1,1,1,2,0.5,5,6,11
3734,J.J. Redick,32-143,G,11/14/16,LAC,,BRK,W,1,23,6,13,0.462,4,10,0.4,2,3,0.667,4,4,1,0,2,2
3735,J.J. Redick,32-158,G,11/29/16,LAC,@,BRK,L,1,38,7,18,0.389,4,8,0.5,3,10,0.3,1,1,1,0,2,2
3736,J.J. Redick,32-141,G,11/12/16,LAC,@,MIN,W,1,29,7,13,0.538,5,6,0.833,2,7,0.286,2,2,1,0,1,1
3737,Josh Richardson,23-063,G,11/17/16,MIA,,MIL,W,1,32,7,19,0.368,3,8,0.375,4,11,0.364,0,0,,1,2,3
3738,Austin Rivers,24-185,G,2/2/17,LAC,,GSW,L,1,36,7,15,0.467,7,12,0.583,0,3,0,4,6,0.667,1,3,4
3739,Austin Rivers,24-131,G,12/10/16,LAC,,NOP,W,1,28,6,9,0.667,2,3,0.667,4,6,0.667,2,2,1,1,1,2
3740,Austin Rivers,24-232,G,3/21/17,LAC,@,LAL,W,0,31,6,11,0.545,5,7,0.714,1,4,0.25,5,6,0.833,0,4,4
3741,Austin Rivers,24-194,G,2/11/17,LAC,@,CHO,W,1,38,7,12,0.583,3,6,0.5,4,6,0.667,0,2,0,0,3,3
3742,Sergio Rodriguez,30-197,G,12/26/16,PHI,@,SAC,L,1,25,7,9,0.778,3,4,0.75,4,5,0.8,0,0,,0,3,3
3743,Derrick Rose,28-053,G,11/26/16,NYK,@,CHO,L,1,34,6,20,0.3,5,17,0.294,1,3,0.333,5,6,0.833,5,3,8
3744,Derrick Rose,28-131,G,2/12/17,NYK,,SAS,W,1,30,6,11,0.545,6,11,0.545,0,0,,6,8,0.75,0,4,4
3745,Derrick Rose,28-049,G,11/22/16,NYK,,POR,W,1,28,8,15,0.533,8,15,0.533,0,0,,2,2,1,2,2,4
3746,Derrick Rose,28-090,G,1/2/17,NYK,,ORL,L,1,28,8,15,0.533,8,14,0.571,0,1,0,2,2,1,2,1,3
3747,Derrick Rose,28-033,G,11/6/16,NYK,,UTA,L,1,36,7,14,0.5,7,14,0.5,0,0,,4,4,1,2,2,4
3748,Derrick Rose,28-167,G,3/20/17,NYK,@,LAC,L,1,28,6,11,0.545,6,11,0.545,0,0,,6,6,1,1,3,4
3749,Derrick Rose,28-104,G,1/16/17,NYK,,ATL,L,1,32,8,16,0.5,8,16,0.5,0,0,,2,4,0.5,1,3,4
3750,Derrick Rose,28-144,G,2/25/17,NYK,,PHI,W,1,36,8,17,0.471,8,16,0.5,0,1,0,2,2,1,0,5,5
3751,Terrence Ross,25-284,F-G,11/15/16,TOR,@,CLE,L,0,25,7,12,0.583,3,5,0.6,4,7,0.571,0,0,,0,3,3
3752,Ricky Rubio,26-068,G,12/28/16,MIN,@,DEN,L,1,34,5,14,0.357,4,7,0.571,1,7,0.143,7,7,1,2,6,8
3753,D'Angelo Russell,21-003,G,2/26/17,LAL,,SAS,L,1,29,8,16,0.5,6,11,0.545,2,5,0.4,0,0,,2,3,5
3754,D'Angelo Russell,20-315,G,1/3/17,LAL,,MEM,W,1,33,6,12,0.5,0,3,0,6,9,0.667,0,0,,0,4,4
3755,D'Angelo Russell,21-026,G,3/21/17,LAL,,LAC,L,1,36,7,15,0.467,4,8,0.5,3,7,0.429,1,2,0.5,0,2,2
3756,Dario Saric,22-346,F,3/20/17,PHI,@,ORL,L,1,26,6,14,0.429,4,9,0.444,2,5,0.4,4,4,1,0,5,5
3757,Dario Saric,22-275,F,1/8/17,PHI,@,BRK,W,0,30,5,13,0.385,2,7,0.286,3,6,0.5,5,6,0.833,0,5,5
3758,Dario Saric,22-311,F,2/13/17,PHI,@,CHO,W,0,31,8,17,0.471,6,10,0.6,2,7,0.286,0,0,,2,9,11
3759,Dennis Schroder,23-171,G,3/5/17,ATL,,IND,L,1,36,7,16,0.438,5,11,0.455,2,5,0.4,2,2,1,0,1,1
3760,Dennis Schroder,23-111,G,1/4/17,ATL,@,ORL,W,1,30,7,13,0.538,7,12,0.583,0,1,0,4,6,0.667,0,6,6
3761,Dennis Schroder,23-061,G,11/15/16,ATL,@,MIA,W,1,33,7,15,0.467,5,13,0.385,2,2,1,2,2,1,1,0,1
3762,Thabo Sefolosha,32-268,G-F,1/25/17,ATL,@,CHI,W,1,33,6,8,0.75,3,4,0.75,3,4,0.75,3,4,0.75,1,2,3
3763,Iman Shumpert,26-261,G,3/14/17,CLE,,DET,W,1,36,8,13,0.615,6,10,0.6,2,3,0.667,0,0,,0,5,5
3764,Jonathon Simmons,27-143,G-F,2/4/17,SAS,,DEN,W,0,22,7,10,0.7,6,9,0.667,1,1,1,3,4,0.75,0,4,4
3765,Marcus Smart,22-340,G,2/9/17,BOS,@,POR,W,1,38,8,13,0.615,8,11,0.727,0,2,0,2,3,0.667,1,5,6
3766,Marreese Speights,29-170,C-F,1/21/17,LAC,@,DEN,L,1,28,7,10,0.7,5,6,0.833,2,4,0.5,2,2,1,0,3,3
3767,Marreese Speights,29-149,C-F,12/31/16,LAC,@,OKC,L,0,25,5,9,0.556,1,3,0.333,4,6,0.667,4,4,1,0,5,5
3768,Rodney Stuckey,30-218,G,11/25/16,IND,,BRK,W,0,25,7,10,0.7,5,7,0.714,2,3,0.667,2,4,0.5,0,4,4
3769,Isaiah Thomas,28-024,G,3/3/17,BOS,@,LAL,W,1,26,6,13,0.462,5,8,0.625,1,5,0.2,5,5,1,0,2,2
3770,Isaiah Thomas,27-285,G,11/18/16,BOS,,GSW,L,1,28,4,12,0.333,3,6,0.5,1,6,0.167,9,9,1,0,2,2
3771,Klay Thompson,26-291,G,11/25/16,GSW,@,LAL,W,1,33,7,17,0.412,6,11,0.545,1,6,0.167,3,4,0.75,0,7,7
3772,Klay Thompson,27-015,G,2/23/17,GSW,,LAC,W,1,31,7,12,0.583,5,7,0.714,2,5,0.4,2,2,1,0,0,0
3773,Klay Thompson,26-335,G,1/8/17,GSW,@,SAC,W,1,36,8,19,0.421,7,12,0.583,1,7,0.143,1,2,0.5,1,5,6
3774,Klay Thompson,26-269,G,11/3/16,GSW,,OKC,W,1,33,7,14,0.5,3,6,0.5,4,8,0.5,0,0,,1,0,1
3775,Tristan Thompson,25-325,F-C,2/1/17,CLE,,MIN,W,1,39,7,11,0.636,7,11,0.636,0,0,,4,5,0.8,8,6,14
3776,Karl-Anthony Towns,21-053,F-C,1/7/17,MIN,,UTA,L,1,41,5,13,0.385,4,11,0.364,1,2,0.5,7,8,0.875,6,9,15
3777,Karl-Anthony Towns,21-070,F-C,1/24/17,MIN,@,PHO,W,1,39,7,12,0.583,7,12,0.583,0,0,,4,5,0.8,0,10,10
3778,Karl-Anthony Towns,21-052,F-C,1/6/17,MIN,@,WAS,L,1,38,7,17,0.412,7,15,0.467,0,2,0,4,5,0.8,4,6,10
3779,Karl-Anthony Towns,21-045,F-C,12/30/16,MIN,,MIL,W,1,38,7,12,0.583,7,10,0.7,0,2,0,4,6,0.667,5,11,16
3780,Karl-Anthony Towns,21-061,F-C,1/15/17,MIN,@,DAL,L,1,38,8,17,0.471,7,13,0.538,1,4,0.25,1,2,0.5,2,7,9
3781,Karl-Anthony Towns,21-011,F-C,11/26/16,MIN,@,GSW,L,1,35,8,21,0.381,7,15,0.467,1,6,0.167,1,2,0.5,5,4,9
3782,Evan Turner,28-094,G,1/29/17,POR,,GSW,L,1,33,8,17,0.471,6,10,0.6,2,7,0.286,0,0,,0,4,4
3783,Myles Turner,20-338,F-C,2/25/17,IND,@,MIA,L,1,32,8,19,0.421,8,18,0.444,0,1,0,2,2,1,3,4,7
3784,Myles Turner,20-298,F-C,1/16/17,IND,,NOP,W,1,38,7,17,0.412,6,14,0.429,1,3,0.333,3,6,0.5,1,11,12
3785,Myles Turner,20-311,F-C,1/29/17,IND,,HOU,W,1,36,6,13,0.462,6,13,0.462,0,0,,6,9,0.667,3,7,10
3786,Myles Turner,20-260,F-C,12/9/16,IND,@,DAL,L,1,31,4,9,0.444,4,8,0.5,0,1,0,10,10,1,2,4,6
3787,Myles Turner,20-324,F-C,2/11/17,IND,,MIL,L,1,31,4,12,0.333,4,9,0.444,0,3,0,10,11,0.909,1,3,4
3788,Jonas Valanciunas,24-249,C,1/10/17,TOR,,BOS,W,1,28,6,18,0.333,6,18,0.333,0,0,,6,6,1,11,12,23
3789,Jonas Valanciunas,24-244,C,1/5/17,TOR,,UTA,W,1,31,7,11,0.636,7,11,0.636,0,0,,4,4,1,8,5,13
3790,Jonas Valanciunas,24-273,C,2/3/17,TOR,@,ORL,L,1,35,7,17,0.412,7,17,0.412,0,0,,4,6,0.667,2,9,11
3791,Nikola Vucevic,26-102,C,2/3/17,ORL,,TOR,W,1,30,9,16,0.563,9,16,0.563,0,0,,0,2,0,2,3,5
3792,Nikola Vucevic,26-069,C,1/1/17,ORL,@,IND,L,0,30,9,18,0.5,9,16,0.563,0,2,0,0,0,,1,10,11
3793,Nikola Vucevic,26-144,C,3/17/17,ORL,@,PHO,W,1,32,8,20,0.4,8,18,0.444,0,2,0,2,2,1,6,11,17
3794,Nikola Vucevic,26-038,C,12/1/16,ORL,@,MEM,L,0,30,6,15,0.4,5,12,0.417,1,3,0.333,5,5,1,2,9,11
3795,Dwyane Wade,35-024,G,2/10/17,CHI,@,PHO,L,1,28,7,16,0.438,6,13,0.462,1,3,0.333,3,3,1,1,5,6
3796,Dwyane Wade,35-015,G,2/1/17,CHI,@,OKC,W,1,24,7,12,0.583,7,11,0.636,0,1,0,4,4,1,0,7,7
3797,Dwyane Wade,34-305,G,11/17/16,CHI,@,UTA,W,1,33,7,17,0.412,7,15,0.467,0,2,0,4,4,1,1,1,2
3798,Kemba Walker,26-207,G,12/1/16,CHO,,DAL,W,1,33,7,19,0.368,4,9,0.444,3,10,0.3,1,2,0.5,0,3,3
3799,Kemba Walker,26-223,G,12/17/16,CHO,@,ATL,W,1,34,5,14,0.357,1,5,0.2,4,9,0.444,4,4,1,1,5,6
3800,Kemba Walker,26-272,G,2/4/17,CHO,@,UTA,L,1,35,6,17,0.353,3,9,0.333,3,8,0.375,3,3,1,1,1,2
3801,Kemba Walker,26-244,G,1/7/17,CHO,@,SAS,L,1,31,6,13,0.462,4,9,0.444,2,4,0.5,4,5,0.8,0,2,2
3802,John Wall,26-118,G,1/2/17,WAS,@,HOU,L,1,37,8,18,0.444,8,16,0.5,0,2,0,2,3,0.667,1,4,5
3803,John Wall,26-145,G,1/29/17,WAS,@,NOP,W,1,37,8,19,0.421,8,16,0.5,0,3,0,2,4,0.5,0,1,1
3804,John Wall,26-111,G,12/26/16,WAS,,MIL,W,1,42,8,19,0.421,7,15,0.467,1,4,0.25,1,2,0.5,2,1,3
3805,John Wall,26-076,G,11/21/16,WAS,,PHO,W,1,38,6,24,0.25,5,19,0.263,1,5,0.2,5,5,1,2,2,4
3806,John Wall,26-108,G,12/23/16,WAS,@,MIL,L,1,32,8,18,0.444,8,15,0.533,0,3,0,2,2,1,0,3,3
3807,John Wall,26-122,G,1/6/17,WAS,,MIN,W,1,40,8,16,0.5,8,15,0.533,0,1,0,2,2,1,0,1,1
3808,John Wall,26-103,G,12/18/16,WAS,,LAC,W,1,36,7,16,0.438,7,14,0.5,0,2,0,4,8,0.5,2,3,5
3809,T.J. Warren,23-068,F,11/12/16,PHO,,BRK,L,1,34,9,17,0.529,9,14,0.643,0,3,0,0,0,,3,0,3
3810,T.J. Warren,23-065,F,11/9/16,PHO,,DET,W,1,38,7,17,0.412,7,15,0.467,0,2,0,4,4,1,2,1,3
3811,T.J. Warren,23-060,F,11/4/16,PHO,@,NOP,W,1,40,4,17,0.235,3,15,0.2,1,2,0.5,9,11,0.818,3,3,6
3812,T.J. Warren,23-136,F,1/19/17,PHO,@,CLE,L,1,40,8,12,0.667,8,10,0.8,0,2,0,2,4,0.5,2,1,3
3813,C.J. Watson,32-292,G,2/3/17,ORL,,TOR,W,0,32,5,6,0.833,4,4,1,1,2,0.5,7,7,1,1,2,3
3814,C.J. Watson,32-288,G,1/30/17,ORL,@,MIN,L,1,34,6,10,0.6,5,7,0.714,1,3,0.333,5,5,1,1,3,4
3815,Hassan Whiteside,27-233,C,2/1/17,MIA,,ATL,W,1,30,8,13,0.615,8,13,0.615,0,0,,2,3,0.667,4,14,18
3816,Hassan Whiteside,27-159,C,11/19/16,MIA,@,WAS,W,1,40,9,14,0.643,9,14,0.643,0,0,,0,3,0,9,9,18
3817,Hassan Whiteside,27-135,C,10/26/16,MIA,@,ORL,W,1,31,9,16,0.563,9,16,0.563,0,0,,0,4,0,4,10,14
3818,Deron Williams,32-173,G,12/16/16,DAL,@,UTA,L,1,35,6,11,0.545,5,7,0.714,1,4,0.25,5,5,1,0,0,0
3819,Lou Williams,30-134,G,3/10/17,HOU,@,CHI,W,0,27,4,11,0.364,2,4,0.5,2,7,0.286,8,8,1,0,3,3
3820,Lou Williams,30-006,G,11/2/16,LAL,@,ATL,W,0,23,6,11,0.545,4,6,0.667,2,5,0.4,4,4,1,0,3,3
3821,Lou Williams,30-050,G,12/16/16,LAL,@,PHI,W,0,23,5,12,0.417,4,6,0.667,1,6,0.167,7,8,0.875,0,0,0
3822,Lou Williams,30-034,G,11/30/16,LAL,@,CHI,W,0,28,4,12,0.333,3,9,0.333,1,3,0.333,9,11,0.818,0,5,5
3823,Troy Williams,21-332,F,11/26/16,MEM,@,MIA,W,1,35,6,12,0.5,4,7,0.571,2,5,0.4,4,6,0.667,0,3,3
3824,Justise Winslow,20-218,F,10/30/16,MIA,,SAS,L,1,39,7,15,0.467,7,12,0.583,0,3,0,4,5,0.8,2,3,5
3825,Thaddeus Young,28-260,F,3/8/17,IND,,DET,W,1,34,9,14,0.643,9,14,0.643,0,0,,0,2,0,3,5,8
3826,Cody Zeller,24-070,F-C,12/14/16,CHO,@,WAS,L,1,30,6,7,0.857,6,7,0.857,0,0,,6,8,0.75,1,1,2
3827,Ivica Zubac,19-364,C,3/17/17,LAL,,MIL,L,1,29,9,15,0.6,9,15,0.6,0,0,,0,0,,2,6,8
3828,Arron Afflalo,31-141,G,3/5/17,SAC,,UTA,L,1,40,6,12,0.5,5,10,0.5,1,2,0.5,4,4,1,1,3,4
3829,LaMarcus Aldridge,31-233,F-C,3/9/17,SAS,@,OKC,L,1,32,8,14,0.571,8,13,0.615,0,1,0,1,2,0.5,4,2,6
3830,LaMarcus Aldridge,31-154,F-C,12/20/16,SAS,@,HOU,W,1,36,6,15,0.4,6,15,0.4,0,0,,5,6,0.833,5,5,10
3831,Tony Allen,34-351,G-F,12/27/16,MEM,@,BOS,L,1,35,6,9,0.667,6,9,0.667,0,0,,5,7,0.714,4,3,7
3832,Justin Anderson,23-068,G,1/26/17,DAL,@,OKC,L,0,24,5,11,0.455,2,5,0.4,3,6,0.5,4,4,1,1,4,5
3833,Ryan Anderson,28-293,F,2/23/17,HOU,@,NOP,W,1,24,5,9,0.556,2,3,0.667,3,6,0.5,4,4,1,2,2,4
3834,Ryan Anderson,28-285,F,2/15/17,HOU,,MIA,L,1,31,6,16,0.375,1,6,0.167,5,10,0.5,0,0,,4,2,6
3835,Giannis Antetokounmpo,21-329,F-G,10/30/16,MIL,@,DET,L,1,35,5,16,0.313,4,13,0.308,1,3,0.333,6,6,1,0,8,8
3836,Giannis Antetokounmpo,22-045,F-G,1/20/17,MIL,@,ORL,L,1,36,6,17,0.353,5,13,0.385,1,4,0.25,4,4,1,2,12,14
3837,Giannis Antetokounmpo,21-340,F-G,11/10/16,MIL,,NOP,L,1,35,7,16,0.438,7,16,0.438,0,0,,3,4,0.75,4,6,10
3838,Giannis Antetokounmpo,21-335,F-G,11/5/16,MIL,,SAC,W,1,25,5,9,0.556,5,8,0.625,0,1,0,7,8,0.875,3,5,8
3839,Giannis Antetokounmpo,22-050,F-G,1/25/17,MIL,,PHI,L,1,39,7,19,0.368,7,12,0.583,0,7,0,3,3,1,6,6,12
3840,Carmelo Anthony,32-177,F,11/22/16,NYK,,POR,W,1,36,7,22,0.318,4,13,0.308,3,9,0.333,0,0,,2,4,6
3841,Carmelo Anthony,32-276,F,3/1/17,NYK,@,ORL,W,1,39,4,16,0.25,2,9,0.222,2,7,0.286,7,8,0.875,0,8,8
3842,Carmelo Anthony,32-223,F,1/7/17,NYK,@,IND,L,1,27,6,14,0.429,5,10,0.5,1,4,0.25,4,5,0.8,0,2,2
3843,Carmelo Anthony,32-251,F,2/4/17,NYK,,CLE,L,1,35,6,20,0.3,5,14,0.357,1,6,0.167,4,5,0.8,2,4,6
3844,Carmelo Anthony,32-291,F,3/16/17,NYK,,BRK,L,1,37,6,18,0.333,6,12,0.5,0,6,0,5,5,1,0,6,6
3845,Trevor Ariza,31-167,F,12/14/16,HOU,,SAC,W,1,29,6,9,0.667,1,2,0.5,5,7,0.714,0,0,,0,3,3
3846,Trevor Ariza,31-137,F,11/14/16,HOU,,PHI,W,1,35,6,14,0.429,1,3,0.333,5,11,0.455,0,0,,1,7,8
3847,Trevor Ariza,31-163,F,12/10/16,HOU,,DAL,W,1,33,6,11,0.545,2,3,0.667,4,8,0.5,1,2,0.5,0,7,7
3848,Trevor Ariza,31-192,F,1/8/17,HOU,@,TOR,W,1,42,5,10,0.5,0,0,,5,10,0.5,2,2,1,0,7,7
3849,D.J. Augustin,29-036,G,12/16/16,ORL,,BRK,W,1,27,6,14,0.429,4,7,0.571,2,7,0.286,3,3,1,0,5,5
3850,J.J. Barea,32-141,G,11/14/16,DAL,@,NYK,L,1,33,8,16,0.5,7,11,0.636,1,5,0.2,0,0,,0,1,1
3851,Harrison Barnes,24-279,F,3/5/17,DAL,,OKC,W,1,34,5,14,0.357,5,11,0.455,0,3,0,7,8,0.875,3,2,5
3852,Harrison Barnes,24-158,F,11/4/16,DAL,,POR,L,1,35,8,17,0.471,7,13,0.538,1,4,0.25,0,0,,2,8,10
3853,Harrison Barnes,24-185,F,12/1/16,DAL,@,CHO,L,1,38,8,20,0.4,7,18,0.389,1,2,0.5,0,0,,1,8,9
3854,Harrison Barnes,24-184,F,11/30/16,DAL,,SAS,L,1,40,8,15,0.533,7,13,0.538,1,2,0.5,0,0,,1,1,2
3855,Harrison Barnes,24-213,F,12/29/16,DAL,@,LAL,W,1,36,6,17,0.353,5,13,0.385,1,4,0.25,4,4,1,2,7,9
3856,Will Barton,25-331,G,12/2/16,DEN,,HOU,L,1,33,7,16,0.438,6,12,0.5,1,4,0.25,2,5,0.4,2,5,7
3857,Will Barton,25-346,G,12/17/16,DEN,,NYK,W,0,32,6,10,0.6,4,7,0.571,2,3,0.667,3,5,0.6,0,8,8
3858,Will Barton,26-033,G,2/8/17,DEN,@,ATL,L,0,38,6,19,0.316,6,10,0.6,0,9,0,5,7,0.714,3,4,7
3859,Nicolas Batum,28-035,F-G,1/18/17,CHO,,POR,W,1,34,6,15,0.4,5,10,0.5,1,5,0.2,4,4,1,0,7,7
3860,Nicolas Batum,28-055,F-G,2/7/17,CHO,,BRK,W,1,38,7,18,0.389,5,12,0.417,2,6,0.333,1,2,0.5,1,7,8
3861,Kent Bazemore,27-134,G-F,11/12/16,ATL,,PHI,W,1,28,8,13,0.615,7,10,0.7,1,3,0.333,0,0,,1,4,5
3862,Kent Bazemore,27-169,G-F,12/17/16,ATL,,CHO,L,0,30,7,13,0.538,6,9,0.667,1,4,0.25,2,2,1,2,2,4
3863,Kent Bazemore,27-187,G-F,1/4/17,ATL,@,ORL,W,1,27,6,9,0.667,3,6,0.5,3,3,1,2,2,1,0,0,0
3864,Bradley Beal,23-207,G,1/21/17,WAS,@,DET,L,1,38,4,16,0.25,4,9,0.444,0,7,0,9,11,0.818,1,4,5
3865,Michael Beasley,27-325,F,11/29/16,MIL,,CLE,W,0,26,7,10,0.7,6,9,0.667,1,1,1,2,2,1,1,1,2
3866,Michael Beasley,28-019,F,1/28/17,MIL,,BOS,L,0,22,7,10,0.7,6,9,0.667,1,1,1,2,2,1,0,8,8
3867,Michael Beasley,28-048,F,2/26/17,MIL,,PHO,W,0,23,8,10,0.8,8,10,0.8,0,0,,1,1,1,1,2,3
3868,Marco Belinelli,30-323,G-F,2/11/17,CHO,,LAC,L,0,27,7,14,0.5,5,6,0.833,2,8,0.25,1,1,1,1,3,4
3869,Marco Belinelli,30-319,G-F,2/7/17,CHO,,BRK,W,0,26,4,9,0.444,3,6,0.5,1,3,0.333,8,9,0.889,0,3,3
3870,Davis Bertans,24-076,F,1/27/17,SAS,@,NOP,L,0,20,6,9,0.667,1,2,0.5,5,7,0.714,0,0,,0,1,1
3871,Patrick Beverley,28-212,G,2/9/17,HOU,@,CHO,W,1,32,7,15,0.467,4,7,0.571,3,8,0.375,0,0,,0,2,2
3872,Patrick Beverley,28-178,G,1/6/17,HOU,@,ORL,W,1,31,7,9,0.778,4,5,0.8,3,4,0.75,0,0,,4,5,9
3873,Nemanja Bjelica,28-207,F,12/2/16,MIN,@,NYK,L,0,21,7,13,0.538,4,6,0.667,3,7,0.429,0,0,,2,5,7
3874,Eric Bledsoe,26-324,G,10/28/16,PHO,@,OKC,L,1,38,6,16,0.375,6,9,0.667,0,7,0,5,9,0.556,0,5,5
3875,Eric Bledsoe,27-077,G,2/24/17,PHO,@,CHI,L,1,40,5,14,0.357,3,7,0.429,2,7,0.286,5,5,1,1,6,7
3876,Eric Bledsoe,27-036,G,1/14/17,PHO,,SAS,W,1,38,5,17,0.294,4,14,0.286,1,3,0.333,6,8,0.75,2,4,6
3877,Eric Bledsoe,26-331,G,11/4/16,PHO,@,NOP,W,1,36,7,13,0.538,5,7,0.714,2,6,0.333,1,3,0.333,2,5,7
3878,Eric Bledsoe,27-025,G,1/3/17,PHO,,MIA,W,1,35,4,14,0.286,2,10,0.2,2,4,0.5,7,8,0.875,0,4,4
3879,Bojan Bogdanovic,27-326,G-F,3/10/17,WAS,@,SAC,W,0,30,7,16,0.438,7,11,0.636,0,5,0,3,4,0.75,2,0,2
3880,Bojan Bogdanovic,27-284,G-F,1/27/17,BRK,@,CLE,L,1,30,7,13,0.538,6,7,0.857,1,6,0.167,2,2,1,0,2,2
3881,Bojan Bogdanovic,27-282,G-F,1/25/17,BRK,,MIA,L,1,26,5,11,0.455,4,8,0.5,1,3,0.333,6,6,1,0,5,5
3882,Devin Booker,20-124,G,3/3/17,PHO,,OKC,W,1,33,5,13,0.385,3,6,0.5,2,7,0.286,5,6,0.833,0,7,7
3883,Devin Booker,20-046,G,12/15/16,PHO,,SAS,L,1,36,6,19,0.316,4,13,0.308,2,6,0.333,3,4,0.75,1,3,4
3884,Trevor Booker,29-038,F,1/2/17,BRK,,UTA,L,1,34,6,14,0.429,5,10,0.5,1,4,0.25,4,4,1,4,11,15
3885,Avery Bradley,26-106,G,3/12/17,BOS,,CHI,W,1,26,7,16,0.438,4,13,0.308,3,3,1,0,0,,3,3,6
3886,Avery Bradley,25-335,G,10/26/16,BOS,,BRK,W,1,34,7,15,0.467,4,11,0.364,3,4,0.75,0,0,,4,5,9
3887,Avery Bradley,25-358,G,11/18/16,BOS,,GSW,L,1,35,7,15,0.467,5,11,0.455,2,4,0.5,1,2,0.5,1,9,10
3888,Malcolm Brogdon,24-062,G,2/11/17,MIL,@,IND,W,0,36,5,14,0.357,3,8,0.375,2,6,0.333,5,6,0.833,0,3,3
3889,Malcolm Brogdon,24-083,G,3/4/17,MIL,,TOR,W,1,42,6,13,0.462,6,9,0.667,0,4,0,5,6,0.833,1,4,5
3890,Malcolm Brogdon,24-030,G,1/10/17,MIL,@,SAS,W,1,25,5,11,0.455,2,6,0.333,3,5,0.6,4,5,0.8,2,4,6
3891,Malcolm Brogdon,24-012,G,12/23/16,MIL,,WAS,W,0,29,7,7,1,4,4,1,3,3,1,0,0,,0,3,3
3892,Malcolm Brogdon,24-080,G,3/1/17,MIL,,DEN,L,1,34,7,16,0.438,5,13,0.385,2,3,0.667,1,1,1,1,1,2
3893,Kentavious Caldwell-Pope,23-270,G,11/14/16,DET,,OKC,W,1,34,7,17,0.412,6,13,0.462,1,4,0.25,2,3,0.667,1,2,3
3894,Isaiah Canaan,25-183,G,11/20/16,CHI,@,LAL,W,0,31,6,10,0.6,3,4,0.75,3,6,0.5,2,2,1,0,2,2
3895,Clint Capela,22-296,F-C,3/10/17,HOU,@,CHI,W,1,24,7,9,0.778,7,9,0.778,0,0,,3,4,0.75,3,4,7
3896,Clint Capela,22-254,F-C,1/27/17,HOU,@,PHI,W,0,21,7,11,0.636,7,11,0.636,0,0,,3,3,1,2,4,6
3897,Clint Capela,22-191,F-C,11/25/16,HOU,@,SAC,W,1,30,7,14,0.5,7,14,0.5,0,0,,3,4,0.75,3,7,10
3898,Clint Capela,22-265,F-C,2/7/17,HOU,,ORL,W,1,28,7,9,0.778,7,9,0.778,0,0,,3,8,0.375,2,7,9
3899,DeMarre Carroll,30-116,F,11/20/16,TOR,@,SAC,L,1,33,6,12,0.5,3,6,0.5,3,6,0.5,2,2,1,1,3,4
3900,DeMarre Carroll,30-126,F,11/30/16,TOR,,MEM,W,1,29,6,11,0.545,3,4,0.75,3,7,0.429,2,4,0.5,0,0,0
3901,DeMarre Carroll,30-126,F,11/30/16,TOR,,MEM,W,1,29,6,11,0.545,3,4,0.75,3,7,0.429,2,4,0.5,0,0,0
3902,Vince Carter,39-291,G-F,11/12/16,MEM,@,MIL,L,0,34,7,11,0.636,6,6,1,1,5,0.2,2,2,1,0,1,1
3903,Willie Cauley-Stein,23-165,F-C,1/30/17,SAC,@,PHI,L,0,20,8,10,0.8,8,10,0.8,0,0,,1,2,0.5,1,2,3
3904,Wilson Chandler,29-204,F,11/30/16,DEN,,MIA,L,0,29,8,17,0.471,7,13,0.538,1,4,0.25,0,0,,2,5,7
3905,Wilson Chandler,29-219,F,12/15/16,DEN,,POR,W,1,35,6,16,0.375,4,9,0.444,2,7,0.286,3,5,0.6,1,7,8
3906,Wilson Chandler,29-257,F,1/22/17,DEN,@,MIN,L,0,34,6,11,0.545,5,9,0.556,1,2,0.5,4,5,0.8,2,4,6
3907,Wilson Chandler,29-232,F,12/28/16,DEN,,MIN,W,1,37,6,17,0.353,3,8,0.375,3,9,0.333,2,2,1,2,5,7
3908,Wilson Chandler,29-194,F,11/20/16,DEN,,UTA,W,0,24,7,11,0.636,5,7,0.714,2,4,0.5,1,2,0.5,0,4,4
3909,Wilson Chandler,29-223,F,12/19/16,DEN,,DAL,W,1,38,7,13,0.538,7,12,0.583,0,1,0,3,3,1,2,6,8
3910,Marquese Chriss,19-256,F,3/15/17,PHO,,SAC,L,1,32,6,14,0.429,4,6,0.667,2,8,0.25,3,7,0.429,2,5,7
3911,Marquese Chriss,19-237,F,2/24/17,PHO,@,CHI,L,1,33,7,10,0.7,5,7,0.714,2,3,0.667,1,3,0.333,1,6,7
3912,Marquese Chriss,19-243,F,3/2/17,PHO,,CHO,W,1,22,6,9,0.667,3,5,0.6,3,4,0.75,2,2,1,0,1,1
3913,Jordan Clarkson,24-181,G,12/5/16,LAL,,UTA,L,0,38,7,13,0.538,6,11,0.545,1,2,0.5,2,2,1,1,4,5
3914,Darren Collison,29-109,G,12/10/16,SAC,@,UTA,L,1,32,7,14,0.5,4,9,0.444,3,5,0.6,0,0,,1,0,1
3915,Darren Collison,29-158,G,1/28/17,SAC,@,CHO,W,1,35,7,11,0.636,5,5,1,2,6,0.333,1,1,1,0,0,0
3916,Darren Collison,29-195,G,3/6/17,SAC,@,DEN,L,1,26,6,11,0.545,5,10,0.5,1,1,1,4,4,1,0,1,1
3917,Mike Conley,29-085,G,1/4/17,MEM,@,LAC,L,1,36,5,16,0.313,4,11,0.364,1,5,0.2,6,7,0.857,3,4,7
3918,Mike Conley,29-076,G,12/26/16,MEM,@,ORL,L,1,27,6,8,0.75,6,7,0.857,0,1,0,5,5,1,0,2,2
3919,Mike Conley,29-127,G,2/15/17,MEM,,NOP,L,1,33,5,16,0.313,2,6,0.333,3,10,0.3,4,6,0.667,0,2,2
3920,Mike Conley,29-094,G,1/13/17,MEM,@,HOU,W,1,39,7,14,0.5,5,8,0.625,2,6,0.333,1,1,1,0,6,6
3921,Mike Conley,29-108,G,1/27/17,MEM,@,POR,L,1,36,5,16,0.313,2,8,0.25,3,8,0.375,4,5,0.8,1,2,3
3922,DeMarcus Cousins,26-148,C-F,1/8/17,SAC,,GSW,L,1,29,4,11,0.364,3,8,0.375,1,3,0.333,8,9,0.889,0,10,10
3923,Robert Covington,26-061,F,2/13/17,PHI,@,CHO,W,1,30,6,16,0.375,3,6,0.5,3,10,0.3,2,3,0.667,2,3,5
3924,Allen Crabbe,24-240,G-F,12/5/16,POR,@,CHI,W,0,33,7,15,0.467,6,11,0.545,1,4,0.25,2,2,1,2,3,5
3925,Jamal Crawford,36-239,G,11/14/16,LAC,,BRK,W,0,22,5,10,0.5,2,5,0.4,3,5,0.6,4,4,1,0,0,0
3926,Jae Crowder,26-145,F,11/28/16,BOS,@,MIA,W,1,32,6,11,0.545,4,7,0.571,2,4,0.5,3,3,1,0,4,4
3927,Jae Crowder,26-174,F,12/27/16,BOS,,MEM,W,1,32,6,9,0.667,3,4,0.75,3,5,0.6,2,2,1,0,7,7
3928,Jae Crowder,26-154,F,12/7/16,BOS,@,ORL,W,1,30,6,10,0.6,5,7,0.714,1,3,0.333,4,5,0.8,1,9,10
3929,Jae Crowder,26-202,F,1/24/17,BOS,@,WAS,L,1,34,6,8,0.75,3,3,1,3,5,0.6,2,2,1,1,5,6
3930,Jae Crowder,26-238,F,3/1/17,BOS,,CLE,W,1,33,5,10,0.5,2,5,0.4,3,5,0.6,4,4,1,0,10,10
3931,Stephen Curry,28-271,G,12/10/16,GSW,@,MEM,L,1,31,4,14,0.286,1,3,0.333,3,11,0.273,6,6,1,2,6,8
3932,Stephen Curry,29-007,G,3/21/17,GSW,@,DAL,W,1,30,7,14,0.5,4,5,0.8,3,9,0.333,0,0,,1,4,5
3933,Deyonta Davis,19-335,F-C,11/1/16,MEM,@,MIN,L,0,26,7,8,0.875,7,8,0.875,0,0,,3,5,0.6,1,5,6
3934,Dewayne Dedmon,27-182,C,2/10/17,SAS,@,DET,W,1,32,8,10,0.8,8,10,0.8,0,0,,1,1,1,5,12,17
3935,Sam Dekker,22-259,F,1/20/17,HOU,,GSW,L,0,28,6,14,0.429,5,7,0.714,1,7,0.143,4,5,0.8,4,3,7
3936,Sam Dekker,22-210,F,12/2/16,HOU,@,DEN,W,0,28,6,10,0.6,5,6,0.833,1,4,0.25,4,4,1,1,2,3
3937,Malcolm Delaney,27-308,G,1/13/17,ATL,,BOS,L,0,27,6,12,0.5,3,8,0.375,3,4,0.75,2,2,1,0,4,4
3938,Matthew Dellavedova,26-090,G,12/7/16,MIL,,POR,W,1,24,7,11,0.636,4,6,0.667,3,5,0.6,0,0,,1,3,4
3939,Luol Deng,31-292,F,2/2/17,LAL,@,WAS,L,1,32,6,11,0.545,3,4,0.75,3,7,0.429,2,2,1,3,3,6
3940,DeMar DeRozan,27-216,G,3/11/17,TOR,@,MIA,L,1,28,5,16,0.313,5,14,0.357,0,2,0,7,7,1,1,3,4
3941,Gorgui Dieng,26-288,C,11/1/16,MIN,,MEM,W,1,34,8,9,0.889,8,9,0.889,0,0,,1,2,0.5,1,5,6
3942,Gorgui Dieng,26-365,C,1/17/17,MIN,@,SAS,L,1,29,6,12,0.5,6,12,0.5,0,0,,5,6,0.833,1,5,6
3943,Spencer Dinwiddie,23-313,G,2/13/17,BRK,,MEM,L,1,29,5,8,0.625,1,3,0.333,4,5,0.8,3,3,1,0,3,3
3944,Goran Dragic,30-249,G,1/10/17,MIA,@,GSW,L,1,38,7,16,0.438,5,11,0.455,2,5,0.4,1,1,1,0,2,2
3945,Goran Dragic,30-264,G,1/25/17,MIA,@,BRK,W,1,39,6,16,0.375,5,13,0.385,1,3,0.333,4,5,0.8,3,6,9
3946,Goran Dragic,30-182,G,11/4/16,MIA,@,TOR,L,1,36,6,14,0.429,3,9,0.333,3,5,0.6,2,2,1,1,4,5
3947,Goran Dragic,30-317,G,3/19/17,MIA,,POR,L,1,38,6,22,0.273,5,15,0.333,1,7,0.143,4,6,0.667,2,2,4
3948,Goran Dragic,30-294,G,2/24/17,MIA,@,ATL,W,1,29,5,16,0.313,3,10,0.3,2,6,0.333,5,5,1,1,5,6
3949,Andre Drummond,23-200,C,2/26/17,DET,,BOS,L,1,36,8,13,0.615,8,13,0.615,0,0,,1,11,0.091,2,13,15
3950,Andre Drummond,23-175,C,2/1/17,DET,,NOP,W,1,26,8,13,0.615,8,13,0.615,0,0,,1,2,0.5,1,5,6
3951,Andre Drummond,23-171,C,1/28/17,DET,@,MIA,L,1,35,8,15,0.533,8,14,0.571,0,1,0,1,3,0.333,8,13,21
3952,Jared Dudley,31-125,F-G,11/12/16,PHO,,BRK,L,0,28,6,12,0.5,2,4,0.5,4,8,0.5,1,2,0.5,2,4,6
3953,Jared Dudley,31-143,F-G,11/30/16,PHO,,ATL,W,0,32,6,9,0.667,3,4,0.75,3,5,0.6,2,3,0.667,1,1,2
3954,Wayne Ellington,29-033,G,12/1/16,MIA,@,UTA,W,0,34,6,9,0.667,3,4,0.75,3,5,0.6,2,2,1,0,0,0
3955,Wayne Ellington,29-102,G,2/8/17,MIA,@,MIL,W,1,28,6,11,0.545,1,3,0.333,5,8,0.625,0,0,,0,2,2
3956,Monta Ellis,31-006,G,11/1/16,IND,,LAL,W,1,38,6,14,0.429,4,9,0.444,2,5,0.4,3,4,0.75,0,2,2
3957,Derrick Favors,25-183,F-C,1/14/17,UTA,,ORL,W,1,32,7,12,0.583,7,12,0.583,0,0,,3,3,1,1,5,6
3958,Yogi Ferrell,23-305,G,3/10/17,DAL,,BRK,W,1,34,5,12,0.417,2,7,0.286,3,5,0.6,4,4,1,1,1,2
3959,Yogi Ferrell,23-298,G,3/3/17,DAL,,MEM,W,1,29,6,12,0.5,6,10,0.6,0,2,0,5,5,1,0,2,2
3960,Dorian Finney-Smith,23-228,F,12/18/16,DAL,,SAC,W,1,29,5,9,0.556,2,3,0.667,3,6,0.5,4,4,1,0,2,2
3961,Evan Fournier,24-003,G-F,11/1/16,ORL,@,PHI,W,1,37,6,17,0.353,3,11,0.273,3,6,0.5,2,2,1,0,5,5
3962,Tim Frazier,26-018,G,11/19/16,NOP,,CHO,W,1,36,6,12,0.5,5,7,0.714,1,5,0.2,4,4,1,0,5,5
3963,Danilo Gallinari,28-176,F,1/31/17,DEN,@,LAL,L,1,36,5,12,0.417,5,9,0.556,0,3,0,7,7,1,0,2,2
3964,Danilo Gallinari,28-134,F,12/20/16,DEN,@,LAC,L,1,32,6,11,0.545,2,3,0.667,4,8,0.5,1,2,0.5,1,4,5
3965,Danilo Gallinari,28-082,F,10/29/16,DEN,,POR,L,1,42,4,16,0.25,4,11,0.364,0,5,0,9,10,0.9,1,4,5
3966,Danilo Gallinari,28-114,F,11/30/16,DEN,,MIA,L,1,36,6,16,0.375,5,11,0.455,1,5,0.2,4,6,0.667,0,4,4
3967,Langston Galloway,25-017,G,12/26/16,NOP,,DAL,W,0,26,6,8,0.75,1,3,0.333,5,5,1,0,0,,0,2,2
3968,Marc Gasol,31-345,C,1/8/17,MEM,,UTA,W,1,34,7,18,0.389,7,15,0.467,0,3,0,3,4,0.75,1,3,4
3969,Marc Gasol,32-012,C,2/10/17,MEM,,GSW,L,1,36,4,14,0.286,3,9,0.333,1,5,0.2,8,10,0.8,1,5,6
3970,Marc Gasol,32-034,C,3/4/17,MEM,@,HOU,L,1,36,7,16,0.438,7,13,0.538,0,3,0,3,5,0.6,0,4,4
3971,Marc Gasol,31-320,C,12/14/16,MEM,,CLE,W,1,29,6,9,0.667,3,6,0.5,3,3,1,2,2,1,1,10,11
3972,Pau Gasol,36-183,F-C,1/5/17,SAS,@,DEN,W,1,35,7,8,0.875,6,7,0.857,1,1,1,2,3,0.667,1,8,9
3973,Pau Gasol,36-233,F-C,2/24/17,SAS,@,LAC,W,0,27,5,7,0.714,2,4,0.5,3,3,1,4,4,1,5,7,12
3974,Pau Gasol,36-161,F-C,12/14/16,SAS,,BOS,W,1,35,7,12,0.583,6,10,0.6,1,2,0.5,2,2,1,1,12,13
3975,Pau Gasol,36-241,F-C,3/4/17,SAS,,MIN,W,0,30,7,10,0.7,5,6,0.833,2,4,0.5,1,3,0.333,3,5,8
3976,Rudy Gay,30-071,F,10/27/16,SAC,,SAS,L,1,32,3,10,0.3,2,7,0.286,1,3,0.333,10,12,0.833,0,7,7
3977,Rudy Gay,30-131,F,12/26/16,SAC,,PHI,W,1,36,7,16,0.438,6,12,0.5,1,4,0.25,2,2,1,2,7,9
3978,Rudy Gay,30-098,F,11/23/16,SAC,,OKC,W,1,34,6,15,0.4,3,9,0.333,3,6,0.5,2,2,1,2,7,9
3979,Paul George,26-290,F,2/16/17,IND,,WAS,L,1,37,6,19,0.316,5,12,0.417,1,7,0.143,4,4,1,0,7,7
3980,Taj Gibson,31-263,F,3/14/17,OKC,@,BRK,W,1,24,8,17,0.471,8,17,0.471,0,0,,1,3,0.333,3,4,7
3981,Taj Gibson,31-180,F,12/21/16,CHI,,WAS,L,1,33,8,12,0.667,8,12,0.667,0,0,,1,3,0.333,4,7,11
3982,Manu Ginobili,39-143,G,12/18/16,SAS,,NOP,W,0,18,6,9,0.667,3,4,0.75,3,5,0.6,2,2,1,0,1,1
3983,Rudy Gobert,24-167,C,12/10/16,UTA,,SAC,W,1,36,5,6,0.833,5,6,0.833,0,0,,7,8,0.875,4,10,14
3984,Rudy Gobert,24-178,C,12/21/16,UTA,,SAC,L,1,35,6,9,0.667,6,9,0.667,0,0,,5,7,0.714,2,12,14
3985,Aaron Gordon,21-171,F,3/6/17,ORL,,NYK,L,1,30,8,15,0.533,7,9,0.778,1,6,0.167,0,1,0,1,4,5
3986,Aaron Gordon,21-185,F,3/20/17,ORL,,PHI,W,1,32,4,7,0.571,4,7,0.571,0,0,,9,11,0.818,0,3,3
3987,Aaron Gordon,21-126,F,1/20/17,ORL,,MIL,W,1,32,7,16,0.438,7,12,0.583,0,4,0,3,6,0.5,2,6,8
3988,Aaron Gordon,21-182,F,3/17/17,ORL,@,PHO,W,1,34,7,12,0.583,6,9,0.667,1,3,0.333,2,2,1,0,4,4
3989,Aaron Gordon,21-042,F,10/28/16,ORL,@,DET,L,1,29,6,12,0.5,5,10,0.5,1,2,0.5,4,6,0.667,3,4,7
3990,Aaron Gordon,21-178,F,3/13/17,ORL,@,SAC,L,1,29,6,15,0.4,4,12,0.333,2,3,0.667,3,3,1,0,3,3
3991,Eric Gordon,28-037,G,1/31/17,HOU,,SAC,W,0,28,7,15,0.467,4,5,0.8,3,10,0.3,0,0,,2,3,5
3992,Eric Gordon,27-350,G,12/9/16,HOU,@,OKC,W,0,33,5,10,0.5,2,4,0.5,3,6,0.5,4,4,1,1,0,1
3993,Eric Gordon,27-364,G,12/23/16,HOU,@,MEM,L,0,32,6,19,0.316,2,3,0.667,4,16,0.25,1,1,1,0,2,2
3994,Eric Gordon,28-012,G,1/6/17,HOU,@,ORL,W,0,32,7,20,0.35,4,4,1,3,16,0.188,0,0,,0,3,3
3995,Marcin Gortat,32-347,C-F,1/29/17,WAS,@,NOP,W,1,31,7,11,0.636,7,11,0.636,0,0,,3,3,1,3,8,11
3996,JaMychal Green,26-191,F,12/29/16,MEM,,OKC,W,1,34,6,7,0.857,4,5,0.8,2,2,1,3,5,0.6,2,2,4
3997,Jeff Green,30-104,F,12/10/16,ORL,,DEN,L,0,25,6,10,0.6,4,6,0.667,2,4,0.5,3,4,0.75,0,4,4
3998,Jeff Green,30-126,F,1/1/17,ORL,@,IND,L,0,23,7,12,0.583,4,6,0.667,3,6,0.5,0,0,,1,1,2
3999,Blake Griffin,27-350,F,3/1/17,LAC,,HOU,L,1,35,7,17,0.412,6,13,0.462,1,4,0.25,2,5,0.4,3,1,4
4000,Blake Griffin,27-336,F,2/15/17,LAC,,ATL,W,1,29,6,15,0.4,5,12,0.417,1,3,0.333,4,4,1,1,4,5
4001,Tim Hardaway,24-362,G,3/13/17,ATL,@,SAS,L,0,29,6,14,0.429,3,7,0.429,3,7,0.429,2,2,1,0,2,2
4002,Tim Hardaway,24-315,G,1/25/17,ATL,@,CHI,W,0,33,6,11,0.545,2,5,0.4,4,6,0.667,1,1,1,0,2,2
4003,James Harden,27-147,G,1/20/17,HOU,,GSW,L,1,35,6,13,0.462,6,8,0.75,0,5,0,5,5,1,0,6,6
4004,Maurice Harkless,23-206,F-G,12/3/16,POR,,MIA,W,1,33,6,12,0.5,5,9,0.556,1,3,0.333,4,4,1,2,5,7
4005,Maurice Harkless,23-220,F-G,12/17/16,POR,@,GSW,L,1,30,7,15,0.467,4,8,0.5,3,7,0.429,0,0,,0,2,2
4006,Maurice Harkless,23-278,F-G,2/13/17,POR,,ATL,L,1,32,7,15,0.467,4,11,0.364,3,4,0.75,0,1,0,6,3,9
4007,Maurice Harkless,23-186,F-G,11/13/16,POR,,DEN,W,1,33,6,11,0.545,4,7,0.571,2,4,0.5,3,4,0.75,1,5,6
4008,Montrezl Harrell,22-330,F-C,12/21/16,HOU,@,PHO,W,1,28,8,11,0.727,8,11,0.727,0,0,,1,2,0.5,0,3,3
4009,Montrezl Harrell,22-281,F-C,11/2/16,HOU,@,NYK,W,0,27,8,11,0.727,8,11,0.727,0,0,,1,2,0.5,5,5,10
4010,Devin Harris,33-311,G,1/3/17,DAL,,WAS,W,0,17,6,11,0.545,2,4,0.5,4,7,0.571,1,1,1,0,4,4
4011,Gary Harris,22-139,G,1/31/17,DEN,@,LAL,L,1,32,6,11,0.545,3,7,0.429,3,4,0.75,2,2,1,1,3,4
4012,Gary Harris,22-107,G,12/30/16,DEN,,PHI,L,1,34,5,12,0.417,3,6,0.5,2,6,0.333,5,6,0.833,1,3,4
4013,Gary Harris,22-185,G,3/18/17,DEN,,HOU,L,1,39,6,14,0.429,5,10,0.5,1,4,0.25,4,5,0.8,3,3,6
4014,Gary Harris,22-105,G,12/28/16,DEN,,MIN,W,1,29,7,12,0.583,5,7,0.714,2,5,0.4,1,1,1,1,3,4
4015,Joe Harris,25-087,G,12/3/16,BRK,@,MIL,L,0,30,7,12,0.583,4,5,0.8,3,7,0.429,0,0,,0,5,5
4016,Tobias Harris,24-170,F,1/1/17,DET,@,MIA,W,0,35,5,13,0.385,4,9,0.444,1,4,0.25,6,7,0.857,1,6,7
4017,Tobias Harris,24-242,F,3/14/17,DET,@,CLE,L,1,26,6,11,0.545,5,7,0.714,1,4,0.25,4,5,0.8,1,1,2
4018,Tobias Harris,24-131,F,11/23/16,DET,,MIA,W,1,33,6,14,0.429,6,12,0.5,0,2,0,5,6,0.833,1,5,6
4019,Gordon Hayward,26-306,F-G,1/23/17,UTA,,OKC,L,1,36,6,17,0.353,4,11,0.364,2,6,0.333,3,3,1,0,6,6
4020,Gordon Hayward,26-322,F-G,2/8/17,UTA,@,NOP,W,1,26,7,16,0.438,6,12,0.5,1,4,0.25,2,2,1,1,4,5
4021,Gordon Hayward,26-299,F-G,1/16/17,UTA,@,PHO,W,1,32,4,13,0.308,3,10,0.3,1,3,0.333,8,9,0.889,0,4,4
4022,Gordon Hayward,26-266,F-G,12/14/16,UTA,,OKC,W,1,32,7,14,0.5,7,10,0.7,0,4,0,3,5,0.6,0,2,2
4023,Gerald Henderson,28-336,G,11/9/16,PHI,@,IND,L,1,30,8,14,0.571,7,11,0.636,1,3,0.333,0,0,,1,3,4
4024,Willy Hernangomez,22-204,C,12/17/16,NYK,@,DEN,L,0,28,5,8,0.625,5,8,0.625,0,0,,7,8,0.875,2,8,10
4025,Willy Hernangomez,22-236,C,1/18/17,NYK,@,BOS,W,0,20,8,13,0.615,8,13,0.615,0,0,,1,1,1,4,7,11
4026,Buddy Hield,23-055,G,2/10/17,NOP,@,MIN,W,1,22,7,10,0.7,5,6,0.833,2,4,0.5,1,1,1,0,4,4
4027,Buddy Hield,23-086,G,3/13/17,SAC,,ORL,W,1,31,6,13,0.462,4,7,0.571,2,6,0.333,3,4,0.75,0,6,6
4028,Buddy Hield,23-084,G,3/11/17,SAC,,DEN,L,1,30,6,8,0.75,3,3,1,3,5,0.6,2,2,1,2,4,6
4029,Buddy Hield,23-011,G,12/28/16,NOP,,LAC,W,1,23,7,11,0.636,4,6,0.667,3,5,0.6,0,0,,1,5,6
4030,Nene Hilario,34-132,F-C,1/23/17,HOU,@,MIL,L,0,22,6,9,0.667,6,9,0.667,0,0,,5,8,0.625,3,5,8
4031,George Hill,30-265,G,1/24/17,UTA,@,DEN,L,1,35,6,18,0.333,5,12,0.417,1,6,0.167,4,4,1,0,3,3
4032,George Hill,30-257,G,1/16/17,UTA,@,PHO,W,1,33,7,18,0.389,6,10,0.6,1,8,0.125,2,2,1,2,6,8
4033,George Hill,30-315,G,3/15/17,UTA,@,DET,W,1,31,6,12,0.5,5,8,0.625,1,4,0.25,4,5,0.8,0,4,4
4034,Jrue Holiday,26-168,G,11/27/16,NOP,@,DAL,L,0,31,7,13,0.538,4,9,0.444,3,4,0.75,0,0,,1,3,4
4035,Justin Holiday,27-285,G,1/15/17,NYK,@,TOR,L,0,26,5,8,0.625,2,3,0.667,3,5,0.6,4,5,0.8,0,2,2
4036,Richaun Holmes,23-153,F-C,3/17/17,PHI,,DAL,W,1,20,8,11,0.727,8,10,0.8,0,1,0,1,2,0.5,2,5,7
4037,Rodney Hood,24-023,G-F,11/12/16,UTA,@,MIA,W,1,34,6,13,0.462,5,9,0.556,1,4,0.25,4,4,1,0,4,4
4038,Al Horford,30-273,C-F,3/3/17,BOS,@,LAL,W,1,32,8,12,0.667,7,10,0.7,1,2,0.5,0,0,,0,4,4
4039,Al Horford,30-200,C-F,12/20/16,BOS,@,MEM,W,1,40,8,19,0.421,7,11,0.636,1,8,0.125,0,1,0,3,11,14
4040,Al Horford,30-232,C-F,1/21/17,BOS,,POR,L,1,38,6,13,0.462,4,11,0.364,2,2,1,3,5,0.6,2,7,9
4041,Al Horford,30-198,C-F,12/18/16,BOS,@,MIA,W,1,31,7,16,0.438,7,11,0.636,0,5,0,3,3,1,2,5,7
4042,Al Horford,30-173,C-F,11/23/16,BOS,@,BRK,W,1,30,7,12,0.583,4,8,0.5,3,4,0.75,0,0,,1,4,5
4043,Dwight Howard,31-081,C,2/27/17,ATL,@,BOS,W,1,27,6,11,0.545,6,11,0.545,0,0,,5,9,0.556,6,6,12
4044,Dwight Howard,30-358,C,11/30/16,ATL,@,PHO,L,1,33,8,10,0.8,8,10,0.8,0,0,,1,1,1,3,11,14
4045,Serge Ibaka,27-046,F-C,11/3/16,ORL,,SAC,W,1,33,6,13,0.462,5,7,0.714,1,6,0.167,4,4,1,1,2,3
4046,Serge Ibaka,27-180,F-C,3/17/17,TOR,@,DET,W,1,34,6,14,0.429,3,6,0.5,3,8,0.375,2,2,1,1,8,9
4047,Serge Ibaka,27-105,F-C,1/1/17,ORL,@,IND,L,1,32,8,17,0.471,8,12,0.667,0,5,0,1,2,0.5,2,4,6
4048,Serge Ibaka,27-134,F-C,1/30/17,ORL,@,MIN,L,1,38,7,16,0.438,4,9,0.444,3,7,0.429,0,0,,4,6,10
4049,Serge Ibaka,27-148,F-C,2/13/17,ORL,@,MIA,W,1,28,7,9,0.778,6,8,0.75,1,1,1,2,2,1,5,3,8
4050,Ersan Ilyasova,29-204,F,12/5/16,PHI,,DEN,L,1,36,7,15,0.467,5,10,0.5,2,5,0.4,1,2,0.5,3,5,8
4051,Ersan Ilyasova,29-255,F,1/25/17,PHI,@,MIL,W,1,27,6,14,0.429,3,9,0.333,3,5,0.6,2,4,0.5,1,8,9
4052,Ersan Ilyasova,29-225,F,12/26/16,PHI,@,SAC,L,0,33,7,12,0.583,5,7,0.714,2,5,0.4,1,2,0.5,0,4,4
4053,Brandon Ingram,19-126,F,1/6/17,LAL,,MIA,W,0,28,6,9,0.667,6,8,0.75,0,1,0,5,5,1,1,5,6
4054,Brandon Ingram,19-091,F,12/2/16,LAL,@,TOR,L,1,35,8,16,0.5,7,11,0.636,1,5,0.2,0,0,,1,5,6
4055,Brandon Ingram,19-128,F,1/8/17,LAL,,ORL,W,0,27,6,9,0.667,4,5,0.8,2,4,0.5,3,4,0.75,0,3,3
4056,Kyrie Irving,24-299,G,1/16/17,CLE,@,GSW,L,1,29,6,19,0.316,5,14,0.357,1,5,0.2,4,5,0.8,0,2,2
4057,Reggie Jackson,26-251,G,12/23/16,DET,,GSW,L,1,30,7,17,0.412,7,13,0.538,0,4,0,3,4,0.75,0,3,3
4058,Reggie Jackson,26-316,G,2/26/17,DET,,BOS,L,1,34,6,12,0.5,3,7,0.429,3,5,0.6,2,2,1,1,3,4
4059,Brandon Jennings,27-106,G,1/7/17,NYK,@,IND,L,0,23,6,11,0.545,3,6,0.5,3,5,0.6,2,5,0.4,1,2,3
4060,Brandon Jennings,27-055,G,11/17/16,NYK,@,WAS,L,0,24,7,10,0.7,4,5,0.8,3,5,0.6,0,0,,3,2,5
4061,Amir Johnson,29-236,F,12/23/16,BOS,,OKC,L,1,26,6,10,0.6,5,8,0.625,1,2,0.5,4,5,0.8,3,3,6
4062,James Johnson,29-273,F,11/19/16,MIA,@,WAS,W,0,27,7,8,0.875,5,5,1,2,3,0.667,1,3,0.333,2,1,3
4063,James Johnson,29-345,F,1/30/17,MIA,,BRK,W,0,33,6,11,0.545,4,8,0.5,2,3,0.667,3,4,0.75,1,3,4
4064,James Johnson,30-025,F,3/17/17,MIA,,MIN,W,0,27,8,12,0.667,7,10,0.7,1,2,0.5,0,0,,0,2,2
4065,Joe Johnson,35-188,G-F,1/3/17,UTA,@,BOS,L,0,21,7,11,0.636,4,7,0.571,3,4,0.75,0,0,,0,3,3
4066,Stanley Johnson,20-283,F,3/8/17,DET,@,IND,L,0,28,7,12,0.583,4,6,0.667,3,6,0.5,0,0,,2,3,5
4067,Tyler Johnson,24-318,G,3/21/17,MIA,,PHO,W,0,29,7,17,0.412,5,14,0.357,2,3,0.667,1,2,0.5,1,5,6
4068,Tyler Johnson,24-200,G,11/23/16,MIA,@,DET,L,0,32,5,13,0.385,5,10,0.5,0,3,0,7,9,0.778,0,2,2
4069,Tyler Johnson,24-280,G,2/11/17,MIA,@,PHI,L,0,32,6,13,0.462,5,9,0.556,1,4,0.25,4,4,1,0,3,3
4070,Tyler Johnson,24-301,G,3/4/17,MIA,,CLE,W,0,26,6,11,0.545,3,5,0.6,3,6,0.5,2,2,1,2,4,6
4071,Nikola Jokic,21-360,C-F,2/13/17,DEN,,GSW,W,1,36,7,13,0.538,7,13,0.538,0,0,,3,4,0.75,6,15,21
4072,Nikola Jokic,21-293,C-F,12/8/16,DEN,@,WAS,L,0,28,6,10,0.6,6,10,0.6,0,0,,5,7,0.714,7,4,11
4073,Nikola Jokic,22-025,C-F,3/16/17,DEN,,LAC,W,1,30,7,12,0.583,7,11,0.636,0,1,0,3,3,1,3,11,14
4074,Nikola Jokic,21-285,C-F,11/30/16,DEN,,MIA,L,0,24,7,11,0.636,7,11,0.636,0,0,,3,4,0.75,3,11,14
4075,Terrence Jones,24-319,F,11/23/16,NOP,,MIN,W,0,24,7,10,0.7,7,9,0.778,0,1,0,3,4,0.75,1,6,7
4076,Terrence Jones,24-318,F,11/22/16,NOP,@,ATL,W,0,28,7,13,0.538,7,11,0.636,0,2,0,3,4,0.75,0,6,6
4077,Terrence Jones,24-346,F,12/20/16,NOP,@,PHI,W,0,30,6,14,0.429,6,14,0.429,0,0,,5,8,0.625,4,6,10
4078,DeAndre Jordan,28-123,C,11/21/16,LAC,,TOR,W,1,34,4,6,0.667,4,6,0.667,0,0,,9,14,0.643,3,12,15
4079,DeAndre Jordan,28-217,C,2/23/17,LAC,@,GSW,L,1,31,6,12,0.5,6,12,0.5,0,0,,5,8,0.625,5,6,11
4080,Cory Joseph,25-095,G,11/23/16,TOR,@,HOU,W,0,25,6,11,0.545,3,8,0.375,3,3,1,2,2,1,1,1,2
4081,Cory Joseph,25-118,G,12/16/16,TOR,,ATL,L,0,27,7,12,0.583,6,11,0.545,1,1,1,2,2,1,2,2,4
4082,Frank Kaminsky,23-275,F-C,1/4/17,CHO,,OKC,W,0,24,6,11,0.545,4,6,0.667,2,5,0.4,3,4,0.75,2,4,6
4083,Frank Kaminsky,23-325,F-C,2/23/17,CHO,@,DET,L,1,39,6,18,0.333,3,10,0.3,3,8,0.375,2,3,0.667,0,1,1
4084,Enes Kanter,24-198,C,12/4/16,OKC,,NOP,W,0,30,7,13,0.538,7,13,0.538,0,0,,3,6,0.5,4,6,10
4085,Enes Kanter,24-159,C,10/26/16,OKC,@,PHI,W,0,24,7,14,0.5,7,14,0.5,0,0,,3,4,0.75,5,7,12
4086,Enes Kanter,24-298,C,3/14/17,OKC,@,BRK,W,0,19,6,10,0.6,6,9,0.667,0,1,0,5,6,0.833,2,3,5
4087,Enes Kanter,24-250,C,1/25/17,OKC,@,NOP,W,0,21,6,13,0.462,6,13,0.462,0,0,,5,5,1,3,8,11
4088,Michael Kidd-Gilchrist,23-117,F,1/21/17,CHO,,BRK,W,1,35,7,11,0.636,7,11,0.636,0,0,,3,4,0.75,6,8,14
4089,Sean Kilpatrick,27-017,G,1/23/17,BRK,,SAS,L,0,31,7,16,0.438,6,10,0.6,1,6,0.167,2,2,1,0,10,10
4090,Sean Kilpatrick,26-341,G,12/12/16,BRK,@,HOU,L,1,32,6,8,0.75,4,6,0.667,2,2,1,3,4,0.75,0,3,3
4091,Brandon Knight,25-019,G,12/21/16,PHO,,HOU,L,0,26,5,10,0.5,3,8,0.375,2,2,1,5,6,0.833,1,4,5
4092,Brandon Knight,24-352,G,11/18/16,PHO,@,IND,W,0,22,6,14,0.429,3,9,0.333,3,5,0.6,2,2,1,0,0,0
4093,Brandon Knight,25-034,G,1/5/17,PHO,@,DAL,W,0,26,6,11,0.545,5,10,0.5,1,1,1,4,4,1,2,0,2
4094,Brandon Knight,25-055,G,1/26/17,PHO,@,DEN,L,0,29,8,11,0.727,7,9,0.778,1,2,0.5,0,0,,0,1,1
4095,Kyle Korver,35-248,G-F,11/20/16,ATL,@,NYK,L,1,37,7,12,0.583,5,8,0.625,2,4,0.5,1,1,1,0,4,4
4096,Kyle Korver,35-228,G-F,10/31/16,ATL,,SAC,W,1,32,6,11,0.545,1,3,0.333,5,8,0.625,0,0,,0,0,0
4097,Mindaugas Kuzminskas,27-091,F,1/18/17,NYK,@,BOS,W,1,29,6,12,0.5,4,9,0.444,2,3,0.667,3,3,1,2,4,6
4098,Jeremy Lamb,24-210,G-F,12/26/16,CHO,@,BRK,L,0,22,7,14,0.5,5,8,0.625,2,6,0.333,1,3,0.333,1,3,4
4099,Joffrey Lauvergne,25-136,C-F,2/13/17,OKC,@,WAS,L,0,29,6,7,0.857,5,6,0.833,1,1,1,4,4,1,3,3,6
4100,Zach LaVine,21-268,G,12/3/16,MIN,@,CHO,W,1,44,7,20,0.35,4,11,0.364,3,9,0.333,0,0,,1,1,2
4101,Zach LaVine,21-268,G,12/3/16,MIN,@,CHO,W,1,44,7,20,0.35,4,11,0.364,3,9,0.333,0,0,,1,1,2
4102,Zach LaVine,21-265,G,11/30/16,MIN,,NYK,L,1,42,5,13,0.385,4,8,0.5,1,5,0.2,6,6,1,1,1,2
4103,Zach LaVine,21-293,G,12/28/16,MIN,@,DEN,L,1,40,7,17,0.412,5,9,0.556,2,8,0.25,1,2,0.5,0,1,1
4104,Ty Lawson,29-071,G,1/13/17,SAC,,CLE,L,0,26,7,10,0.7,7,9,0.778,0,1,0,3,4,0.75,0,4,4
4105,Ty Lawson,29-064,G,1/6/17,SAC,,LAC,L,1,37,6,12,0.5,6,9,0.667,0,3,0,5,6,0.833,0,4,4
4106,Jake Layman,22-239,F,11/1/16,POR,,GSW,L,0,8,6,8,0.75,1,1,1,5,7,0.714,0,0,,0,1,1
4107,Courtney Lee,31-032,G,11/4/16,NYK,@,CHI,W,1,41,8,10,0.8,7,9,0.778,1,1,1,0,0,,0,2,2
4108,Courtney Lee,31-118,G,1/29/17,NYK,@,ATL,L,1,52,6,16,0.375,3,8,0.375,3,8,0.375,2,2,1,2,7,9
4109,Courtney Lee,31-124,G,2/4/17,NYK,,CLE,L,1,30,7,11,0.636,4,6,0.667,3,5,0.6,0,2,0,2,2,4
4110,Alex Len,23-160,C,11/23/16,PHO,@,ORL,W,1,35,6,10,0.6,6,10,0.6,0,0,,5,6,0.833,4,8,12
4111,Kawhi Leonard,25-135,F,11/11/16,SAS,,DET,W,1,37,5,18,0.278,1,13,0.077,4,5,0.8,3,3,1,0,4,4
4112,Meyers Leonard,24-329,C-F,1/21/17,POR,@,BOS,W,0,25,6,7,0.857,2,3,0.667,4,4,1,1,1,1,1,3,4
4113,Jon Leuer,27-209,F,12/9/16,DET,@,MIN,W,0,28,5,10,0.5,5,6,0.833,0,4,0,7,8,0.875,1,4,5
4114,Jon Leuer,27-186,F,11/16/16,DET,@,NYK,L,0,27,7,11,0.636,5,7,0.714,2,4,0.5,1,1,1,2,7,9
4115,Jon Leuer,27-216,F,12/16/16,DET,@,WAS,L,0,31,8,12,0.667,7,9,0.778,1,3,0.333,0,0,,1,6,7
4116,Caris LeVert,22-148,G-F,1/20/17,BRK,@,NOP,W,0,25,6,6,1,3,3,1,3,3,1,2,2,1,1,4,5
4117,Damian Lillard,26-151,G,12/13/16,POR,,OKC,W,1,30,7,13,0.538,6,8,0.75,1,5,0.2,2,2,1,2,0,2
4118,Jeremy Lin,28-125,G,12/26/16,BRK,,CHO,W,1,22,6,11,0.545,4,7,0.571,2,4,0.5,3,4,0.75,0,0,0
4119,Jeremy Lin,28-115,G,12/16/16,BRK,@,ORL,L,0,20,7,13,0.538,6,11,0.545,1,2,0.5,2,2,1,0,3,3
4120,Jeremy Lin,28-190,G,3/1/17,BRK,@,SAC,W,1,20,5,10,0.5,3,7,0.429,2,3,0.667,5,6,0.833,0,2,2
4121,Brook Lopez,28-280,C,1/6/17,BRK,,CLE,L,1,33,5,10,0.5,4,8,0.5,1,2,0.5,6,7,0.857,0,1,1
4122,Brook Lopez,28-336,C,3/3/17,BRK,@,UTA,L,1,29,5,13,0.385,4,9,0.444,1,4,0.25,6,7,0.857,0,5,5
4123,Brook Lopez,28-240,C,11/27/16,BRK,,SAC,L,1,30,5,15,0.333,2,8,0.25,3,7,0.429,4,4,1,1,6,7
4124,Brook Lopez,28-329,C,2/24/17,BRK,@,DEN,L,1,27,7,11,0.636,6,7,0.857,1,4,0.25,2,4,0.5,1,0,1
4125,Brook Lopez,28-318,C,2/13/17,BRK,,MEM,L,1,32,7,18,0.389,6,13,0.462,1,5,0.2,2,2,1,1,2,3
4126,Robin Lopez,28-313,C,2/8/17,CHI,@,GSW,L,1,29,8,18,0.444,8,18,0.444,0,0,,1,2,0.5,7,3,10
4127,Robin Lopez,28-311,C,2/6/17,CHI,@,SAC,W,1,32,7,12,0.583,7,12,0.583,0,0,,3,4,0.75,4,2,6
4128,Kevin Love,28-126,F,1/11/17,CLE,@,POR,L,1,28,5,15,0.333,2,6,0.333,3,9,0.333,4,4,1,0,8,8
4129,Kevin Love,28-067,F,11/13/16,CLE,,CHO,W,1,26,6,10,0.6,4,7,0.571,2,3,0.667,3,4,0.75,4,7,11
4130,Kevin Love,28-121,F,1/6/17,CLE,@,BRK,W,1,36,5,16,0.313,1,7,0.143,4,9,0.444,3,3,1,3,10,13
4131,Kevin Love,28-110,F,12/26/16,CLE,@,DET,L,1,26,6,14,0.429,3,8,0.375,3,6,0.5,2,2,1,4,10,14
4132,Kyle Lowry,30-217,G,10/28/16,TOR,,CLE,L,1,39,5,16,0.313,4,11,0.364,1,5,0.2,6,7,0.857,0,2,2
4133,Kyle Lowry,30-243,G,11/23/16,TOR,@,HOU,W,1,36,6,15,0.4,4,8,0.5,2,7,0.286,3,4,0.75,1,0,1
4134,Kyle Lowry,30-253,G,12/3/16,TOR,,ATL,W,1,31,6,9,0.667,3,4,0.75,3,5,0.6,2,2,1,1,7,8
4135,Shelvin Mack,26-206,G,11/14/16,UTA,,MEM,L,0,28,7,9,0.778,5,6,0.833,2,3,0.667,1,2,0.5,2,1,3
4136,Shelvin Mack,26-245,G,12/23/16,UTA,,TOR,L,1,34,7,13,0.538,5,7,0.714,2,6,0.333,1,2,0.5,1,3,4
4137,Shelvin Mack,26-258,G,1/5/17,UTA,@,TOR,L,1,31,7,9,0.778,6,8,0.75,1,1,1,2,2,1,1,3,4
4138,Wesley Matthews,30-073,G,12/26/16,DAL,@,NOP,L,1,36,4,11,0.364,1,4,0.25,3,7,0.429,6,7,0.857,0,2,2
4139,Wesley Matthews,30-107,G,1/29/17,DAL,@,SAS,W,1,31,6,10,0.6,4,5,0.8,2,5,0.4,3,4,0.75,0,7,7
4140,C.J. McCollum,25-075,G,12/3/16,POR,,MIA,W,1,33,7,18,0.389,6,13,0.462,1,5,0.2,2,3,0.667,2,2,4
4141,C.J. McCollum,25-057,G,11/15/16,POR,,CHI,L,1,33,7,17,0.412,4,11,0.364,3,6,0.5,0,0,,1,3,4
4142,C.J. McCollum,25-160,G,2/26/17,POR,@,TOR,L,1,35,6,19,0.316,5,16,0.313,1,3,0.333,4,6,0.667,1,2,3
4143,T.J. McConnell,24-280,G,12/30/16,PHI,@,DEN,W,1,36,6,12,0.5,3,9,0.333,3,3,1,2,2,1,0,2,2
4144,Doug McDermott,25-004,F,1/7/17,CHI,,TOR,W,0,38,6,17,0.353,4,10,0.4,2,7,0.286,3,3,1,2,8,10
4145,Doug McDermott,25-001,F,1/4/17,CHI,@,CLE,W,0,32,6,9,0.667,3,5,0.6,3,4,0.75,2,2,1,1,5,6
4146,JaVale McGee,28-331,C,12/15/16,GSW,,NYK,W,1,16,8,10,0.8,8,10,0.8,0,0,,1,3,0.333,2,0,2
4147,Ben McLemore,23-363,G,2/8/17,SAC,,BOS,W,0,30,7,12,0.583,4,7,0.571,3,5,0.6,0,0,,0,2,2
4148,C.J. Miles,29-312,G-F,2/24/17,IND,,MEM,W,1,22,6,10,0.6,1,1,1,5,9,0.556,0,0,,0,4,4
4149,Patty Mills,28-209,G,3/8/17,SAS,,SAC,W,0,27,6,9,0.667,2,3,0.667,4,6,0.667,1,1,1,0,1,1
4150,Patty Mills,28-102,G,11/21/16,SAS,,DAL,W,0,30,6,11,0.545,4,6,0.667,2,5,0.4,3,4,0.75,1,2,3
4151,Paul Millsap,31-332,F,1/7/17,ATL,@,DAL,W,1,39,3,10,0.3,3,8,0.375,0,2,0,11,13,0.846,0,9,9
4152,Paul Millsap,31-262,F,10/29/16,ATL,@,PHI,W,1,27,6,14,0.429,6,12,0.5,0,2,0,5,6,0.833,0,4,4
4153,Paul Millsap,31-330,F,1/5/17,ATL,@,NOP,W,1,33,6,19,0.316,5,15,0.333,1,4,0.25,4,4,1,0,10,10
4154,Paul Millsap,32-017,F,2/27/17,ATL,@,BOS,W,1,32,7,18,0.389,7,15,0.467,0,3,0,3,3,1,0,10,10
4155,Paul Millsap,31-307,F,12/13/16,ATL,,ORL,L,1,34,6,12,0.5,4,7,0.571,2,5,0.4,3,3,1,1,8,9
4156,Paul Millsap,31-341,F,1/16/17,ATL,@,NYK,W,1,39,5,18,0.278,4,13,0.308,1,5,0.2,6,10,0.6,1,6,7
4157,Nikola Mirotic,25-265,F,11/2/16,CHI,@,BOS,L,0,35,3,6,0.5,0,0,,3,6,0.5,8,11,0.727,0,6,6
4158,Nikola Mirotic,25-275,F,11/12/16,CHI,,WAS,W,0,23,6,7,0.857,3,3,1,3,4,0.75,2,2,1,1,10,11
4159,Greg Monroe,26-277,C-F,3/8/17,MIL,,NYK,W,0,29,6,14,0.429,6,14,0.429,0,0,,5,7,0.714,2,6,8
4160,Greg Monroe,26-252,C-F,2/11/17,MIL,@,IND,W,0,26,6,8,0.75,6,8,0.75,0,0,,5,6,0.833,1,7,8
4161,Greg Monroe,26-233,C-F,1/23/17,MIL,,HOU,W,0,27,7,13,0.538,7,12,0.583,0,1,0,3,4,0.75,2,8,10
4162,E'Twaun Moore,27-338,G,1/31/17,NOP,@,TOR,L,0,30,6,14,0.429,1,7,0.143,5,7,0.714,0,0,,2,4,6
4163,E'Twaun Moore,27-247,G,11/1/16,NOP,,MIL,L,1,36,7,13,0.538,4,7,0.571,3,6,0.5,0,0,,0,0,0
4164,Marcus Morris,27-056,F,10/28/16,DET,,ORL,W,1,29,7,14,0.5,5,9,0.556,2,5,0.4,1,1,1,1,7,8
4165,Marcus Morris,27-071,F,11/12/16,DET,@,DEN,W,1,34,8,15,0.533,7,9,0.778,1,6,0.167,0,0,,0,1,1
4166,Marcus Morris,27-054,F,10/26/16,DET,@,TOR,L,1,32,7,17,0.412,5,9,0.556,2,8,0.25,1,1,1,4,5,9
4167,Marcus Morris,27-084,F,11/25/16,DET,,LAC,W,1,22,8,13,0.615,7,11,0.636,1,2,0.5,0,0,,0,3,3
4168,Markieff Morris,27-138,F,1/18/17,WAS,,MEM,W,1,34,6,16,0.375,6,11,0.545,0,5,0,5,5,1,3,9,12
4169,Markieff Morris,27-136,F,1/16/17,WAS,,POR,W,1,33,6,9,0.667,5,7,0.714,1,2,0.5,4,4,1,0,13,13
4170,Emmanuel Mudiay,20-265,G,11/25/16,DEN,,OKC,L,1,30,5,10,0.5,2,4,0.5,3,6,0.5,4,6,0.667,1,2,3
4171,Emmanuel Mudiay,20-282,G,12/12/16,DEN,@,DAL,L,1,31,6,12,0.5,3,7,0.429,3,5,0.6,2,4,0.5,0,2,2
4172,Emmanuel Mudiay,20-293,G,12/23/16,DEN,,ATL,L,1,28,3,8,0.375,2,5,0.4,1,3,0.333,10,10,1,0,3,3
4173,Shabazz Muhammad,24-115,F-G,3/8/17,MIN,,LAC,W,1,26,7,13,0.538,7,12,0.583,0,1,0,3,4,0.75,3,3,6
4174,Jamal Murray,20-013,G,3/8/17,DEN,,WAS,L,0,24,7,15,0.467,4,10,0.4,3,5,0.6,0,0,,0,3,3
4175,Jamal Murray,19-334,G,1/22/17,DEN,@,MIN,L,0,20,7,13,0.538,7,11,0.636,0,2,0,3,4,0.75,1,4,5
4176,Jameer Nelson,34-354,G,1/28/17,DEN,@,PHO,W,1,33,4,9,0.444,2,3,0.667,2,6,0.333,7,8,0.875,0,3,3
4177,Jameer Nelson,34-350,G,1/24/17,DEN,,UTA,W,1,31,6,8,0.75,3,4,0.75,3,4,0.75,2,2,1,0,1,1
4178,Jameer Nelson,34-281,G,11/16/16,DEN,,PHO,W,1,34,8,12,0.667,7,9,0.778,1,3,0.333,0,0,,0,1,1
4179,Jameer Nelson,34-295,G,11/30/16,DEN,,MIA,L,1,38,5,14,0.357,2,9,0.222,3,5,0.6,4,6,0.667,1,4,5
4180,Dirk Nowitzki,38-267,F,3/13/17,DAL,@,TOR,L,1,29,7,16,0.438,4,11,0.364,3,5,0.6,0,0,,0,7,7
4181,Dirk Nowitzki,38-210,F,1/15/17,DAL,,MIN,W,1,28,7,14,0.5,4,10,0.4,3,4,0.75,0,0,,0,6,6
4182,Dirk Nowitzki,38-187,F,12/23/16,DAL,@,LAC,W,1,15,7,12,0.583,5,9,0.556,2,3,0.667,1,1,1,2,2,4
4183,Jusuf Nurkic,22-109,C,12/10/16,DEN,@,ORL,W,1,21,8,11,0.727,8,11,0.727,0,0,,1,2,0.5,1,7,8
4184,Jusuf Nurkic,22-196,C,3/7/17,POR,@,OKC,W,1,25,5,12,0.417,5,11,0.455,0,1,0,7,8,0.875,2,7,9
4185,Jusuf Nurkic,22-193,C,3/4/17,POR,,BRK,W,1,30,6,11,0.545,6,11,0.545,0,0,,5,8,0.625,1,5,6
4186,Jahlil Okafor,20-365,C-F,12/14/16,PHI,,TOR,L,1,30,6,9,0.667,6,9,0.667,0,0,,5,6,0.833,3,1,4
4187,Victor Oladipo,24-187,G,11/7/16,OKC,,MIA,W,1,33,6,9,0.667,5,7,0.714,1,2,0.5,4,4,1,0,2,2
4188,Victor Oladipo,24-270,G,1/29/17,OKC,@,CLE,L,1,38,6,18,0.333,5,14,0.357,1,4,0.25,4,5,0.8,1,6,7
4189,Victor Oladipo,24-320,G,3/20/17,OKC,,GSW,L,1,33,6,14,0.429,4,11,0.364,2,3,0.667,3,4,0.75,1,5,6
4190,Victor Oladipo,24-267,G,1/26/17,OKC,,DAL,W,1,36,7,14,0.5,6,10,0.6,1,4,0.25,2,2,1,0,3,3
4191,Victor Oladipo,24-246,G,1/5/17,OKC,@,HOU,L,1,41,6,16,0.375,2,7,0.286,4,9,0.444,1,2,0.5,2,5,7
4192,Kelly Olynyk,25-323,C-F,3/8/17,BOS,@,GSW,W,0,26,7,9,0.778,6,7,0.857,1,2,0.5,2,2,1,0,5,5
4193,Kelly Olynyk,25-303,C-F,2/16/17,BOS,@,CHI,L,0,32,6,10,0.6,3,4,0.75,3,6,0.5,2,3,0.667,0,7,7
4194,Kelly Olynyk,25-284,C-F,1/28/17,BOS,@,MIL,W,0,36,7,12,0.583,6,7,0.857,1,5,0.2,2,3,0.667,1,6,7
4195,Kelly Oubre,21-030,F,1/8/17,WAS,@,MIL,W,0,25,7,14,0.5,4,7,0.571,3,7,0.429,0,0,,3,2,5
4196,Jabari Parker,21-323,F,2/1/17,MIL,@,UTA,L,1,32,6,12,0.5,6,10,0.6,0,2,0,5,6,0.833,1,6,7
4197,Tony Parker,34-283,G,2/24/17,SAS,@,LAC,W,1,31,5,12,0.417,4,10,0.4,1,2,0.5,6,6,1,0,2,2
4198,Patrick Patterson,27-264,F,12/3/16,TOR,,ATL,W,0,21,6,8,0.75,2,3,0.667,4,5,0.8,1,1,1,0,4,4
4199,Chris Paul,31-210,G,12/2/16,LAC,@,NOP,W,1,34,6,11,0.545,5,7,0.714,1,4,0.25,4,4,1,1,7,8
4200,Chris Paul,31-294,G,2/24/17,LAC,,SAS,L,1,33,6,14,0.429,4,11,0.364,2,3,0.667,3,4,0.75,0,6,6
4201,Chris Paul,31-302,G,3/4/17,LAC,@,CHI,W,1,33,7,14,0.5,5,10,0.5,2,4,0.5,1,2,0.5,0,2,2
4202,Chris Paul,31-210,G,12/2/16,LAC,@,NOP,W,1,34,6,11,0.545,5,7,0.714,1,4,0.25,4,4,1,1,7,8
4203,Chris Paul,31-294,G,2/24/17,LAC,,SAS,L,1,33,6,14,0.429,4,11,0.364,2,3,0.667,3,4,0.75,0,6,6
4204,Mason Plumlee,26-236,C-F,10/27/16,POR,,LAC,L,1,31,7,9,0.778,7,9,0.778,0,0,,3,6,0.5,2,6,8
4205,Otto Porter,23-217,F,1/6/17,WAS,,MIN,W,1,34,7,12,0.583,4,6,0.667,3,6,0.5,0,0,,1,5,6
4206,Otto Porter,23-199,F,12/19/16,WAS,@,IND,L,1,38,5,13,0.385,3,7,0.429,2,6,0.333,5,5,1,2,7,9
4207,Bobby Portis,22-020,F,3/2/17,CHI,,GSW,W,1,31,6,12,0.5,4,8,0.5,2,4,0.5,3,4,0.75,2,11,13
4208,Kristaps Porzingis,21-129,F-C,12/9/16,NYK,@,SAC,W,1,35,6,19,0.316,5,14,0.357,1,5,0.2,4,4,1,2,9,11
4209,Kristaps Porzingis,21-192,F-C,2/10/17,NYK,,DEN,L,1,33,7,14,0.5,5,10,0.5,2,4,0.5,1,2,0.5,2,2,4
4210,Dwight Powell,25-136,F-C,12/3/16,DAL,,CHI,W,0,28,7,11,0.636,7,11,0.636,0,0,,3,4,0.75,3,4,7
4211,Norman Powell,23-266,G,2/15/17,TOR,,CHO,W,1,28,5,12,0.417,2,5,0.4,3,7,0.429,4,6,0.667,0,3,3
4212,Norman Powell,23-280,G,3/1/17,TOR,,WAS,L,0,16,5,12,0.417,4,8,0.5,1,4,0.25,6,8,0.75,0,2,2
4213,Julius Randle,22-037,F,1/5/17,LAL,@,POR,L,1,37,4,13,0.308,4,12,0.333,0,1,0,9,11,0.818,2,7,9
4214,Julius Randle,22-012,F,12/11/16,LAL,,NYK,L,1,34,7,12,0.583,7,12,0.583,0,0,,3,4,0.75,2,8,10
4215,Julius Randle,22-071,F,2/8/17,LAL,@,DET,L,1,30,7,13,0.538,7,13,0.538,0,0,,3,4,0.75,1,5,6
4216,Julius Randle,21-352,F,11/15/16,LAL,,BRK,W,1,31,5,8,0.625,5,8,0.625,0,0,,7,10,0.7,1,13,14
4217,Zach Randolph,35-195,F,1/27/17,MEM,@,POR,L,0,31,8,11,0.727,8,10,0.8,0,1,0,1,2,0.5,4,9,13
4218,Zach Randolph,35-209,F,2/10/17,MEM,,GSW,L,0,25,5,9,0.556,5,8,0.625,0,1,0,7,9,0.778,6,7,13
4219,J.J. Redick,32-213,G,1/23/17,LAC,@,ATL,W,1,35,6,13,0.462,3,9,0.333,3,4,0.75,2,2,1,1,2,3
4220,J.J. Redick,32-177,G,12/18/16,LAC,@,WAS,L,1,25,7,14,0.5,5,8,0.625,2,6,0.333,1,2,0.5,0,1,1
4221,J.J. Redick,32-175,G,12/16/16,LAC,@,MIA,W,1,29,5,16,0.313,3,7,0.429,2,9,0.222,5,6,0.833,0,1,1
4222,J.J. Redick,32-223,G,2/2/17,LAC,,GSW,L,1,37,6,14,0.429,2,4,0.5,4,10,0.4,1,1,1,0,2,2
4223,Austin Rivers,24-227,G,3/16/17,LAC,@,DEN,L,1,33,7,12,0.583,4,6,0.667,3,6,0.5,0,1,0,0,1,1
4224,Austin Rivers,24-231,G,3/20/17,LAC,,NYK,W,0,23,6,10,0.6,5,6,0.833,1,4,0.25,4,5,0.8,0,1,1
4225,Glenn Robinson,22-324,G-F,11/27/16,IND,,LAC,W,1,39,7,9,0.778,6,8,0.75,1,1,1,2,2,1,0,6,6
4226,Sergio Rodriguez,30-176,G,12/5/16,PHI,,DEN,L,1,33,7,14,0.5,4,8,0.5,3,6,0.5,0,0,,1,3,4
4227,Rajon Rondo,31-021,G,3/15/17,CHI,,MEM,L,1,35,7,16,0.438,4,12,0.333,3,4,0.75,0,0,,3,3,6
4228,Derrick Rose,28-100,G,1/12/17,NYK,,CHI,W,1,34,7,15,0.467,7,15,0.467,0,0,,3,3,1,0,4,4
4229,Derrick Rose,28-159,G,3/12/17,NYK,@,BRK,L,1,37,5,15,0.333,5,15,0.333,0,0,,7,8,0.875,3,2,5
4230,Derrick Rose,28-021,G,10/25/16,NYK,@,CLE,L,1,30,7,17,0.412,6,15,0.4,1,2,0.5,2,2,1,2,1,3
4231,Terrence Ross,25-359,F-G,1/29/17,TOR,,ORL,L,0,28,6,10,0.6,2,3,0.667,4,7,0.571,1,1,1,0,1,1
4232,Terrence Ross,26-000,F-G,2/5/17,TOR,@,BRK,W,0,26,7,11,0.636,4,7,0.571,3,4,0.75,0,0,,1,2,3
4233,Terrence Ross,25-333,F-G,1/3/17,TOR,@,SAS,L,0,25,7,11,0.636,5,7,0.714,2,4,0.5,1,2,0.5,0,5,5
4234,Ricky Rubio,26-140,G,3/10/17,MIN,,GSW,W,1,36,3,10,0.3,3,9,0.333,0,1,0,11,11,1,1,3,4
4235,Ricky Rubio,26-114,G,2/12/17,MIN,,CHI,W,1,33,5,10,0.5,4,7,0.571,1,3,0.333,6,6,1,0,6,6
4236,D'Angelo Russell,20-293,G,12/12/16,LAL,@,SAC,L,1,20,6,10,0.6,3,6,0.5,3,4,0.75,2,2,1,1,1,2
4237,D'Angelo Russell,20-255,G,11/4/16,LAL,,GSW,W,1,22,5,11,0.455,2,4,0.5,3,7,0.429,4,4,1,0,2,2
4238,D'Angelo Russell,21-008,G,3/3/17,LAL,,BOS,L,1,30,7,12,0.583,5,7,0.714,2,5,0.4,1,2,0.5,1,2,3
4239,D'Angelo Russell,20-320,G,1/8/17,LAL,,ORL,W,1,31,7,10,0.7,5,5,1,2,5,0.4,1,2,0.5,0,8,8
4240,D'Angelo Russell,20-345,G,2/2/17,LAL,@,WAS,L,1,31,5,15,0.333,1,5,0.2,4,10,0.4,3,6,0.5,1,6,7
4241,D'Angelo Russell,20-303,G,12/22/16,LAL,@,MIA,L,1,32,7,16,0.438,4,8,0.5,3,8,0.375,0,0,,0,4,4
4242,D'Angelo Russell,20-261,G,11/10/16,LAL,@,SAC,W,1,23,7,12,0.583,6,8,0.75,1,4,0.25,2,3,0.667,0,0,0
4243,Dario Saric,22-283,F,1/16/17,PHI,@,MIL,W,0,24,6,11,0.545,4,6,0.667,2,5,0.4,3,3,1,2,7,9
4244,Dario Saric,22-297,F,1/30/17,PHI,,SAC,W,0,27,8,11,0.727,7,8,0.875,1,3,0.333,0,0,,2,3,5
4245,Dario Saric,22-242,F,12/6/16,PHI,@,MEM,L,0,25,6,12,0.5,3,6,0.5,3,6,0.5,2,3,0.667,2,5,7
4246,Dario Saric,22-241,F,12/5/16,PHI,,DEN,L,0,25,6,12,0.5,3,6,0.5,3,6,0.5,2,3,0.667,1,7,8
4247,Dario Saric,22-292,F,1/25/17,PHI,@,MIL,W,0,21,7,14,0.5,6,10,0.6,1,4,0.25,2,2,1,2,1,3
4248,Dennis Schroder,23-083,G,12/7/16,ATL,,MIA,W,1,31,8,15,0.533,7,13,0.538,1,2,0.5,0,0,,1,3,4
4249,Dennis Schroder,23-081,G,12/5/16,ATL,,OKC,L,1,34,6,15,0.4,5,13,0.385,1,2,0.5,4,4,1,1,5,6
4250,Dennis Schroder,23-051,G,11/5/16,ATL,,HOU,W,1,32,6,14,0.429,4,9,0.444,2,5,0.4,3,4,0.75,0,3,3
4251,Dennis Schroder,23-078,G,12/2/16,ATL,,DET,L,1,25,7,13,0.538,6,11,0.545,1,2,0.5,2,3,0.667,0,2,2
4252,Dennis Schroder,23-169,G,3/3/17,ATL,,CLE,L,1,32,7,15,0.467,6,10,0.6,1,5,0.2,2,2,1,1,1,2
4253,Dennis Schroder,23-142,G,2/4/17,ATL,,ORL,W,1,26,6,11,0.545,4,6,0.667,2,5,0.4,3,4,0.75,0,4,4
4254,Dennis Schroder,23-046,G,10/31/16,ATL,,SAC,W,1,32,5,14,0.357,3,9,0.333,2,5,0.4,5,6,0.833,1,2,3
4255,Dennis Schroder,23-167,G,3/1/17,ATL,,DAL,W,1,33,7,13,0.538,6,11,0.545,1,2,0.5,2,2,1,0,2,2
4256,Dennis Schroder,23-106,G,12/30/16,ATL,,DET,W,1,31,6,14,0.429,4,10,0.4,2,4,0.5,3,4,0.75,0,1,1
4257,Thabo Sefolosha,32-225,G-F,12/13/16,ATL,,ORL,L,1,30,6,11,0.545,5,8,0.625,1,3,0.333,4,4,1,1,4,5
4258,Ramon Sessions,30-285,G,1/21/17,CHO,,BRK,W,0,19,3,8,0.375,0,4,0,3,4,0.75,8,8,1,0,2,2
4259,Iman Shumpert,26-207,G,1/19/17,CLE,,PHO,W,1,30,6,8,0.75,1,2,0.5,5,6,0.833,0,0,,1,1,2
4260,Marcus Smart,22-321,G,1/21/17,BOS,,POR,L,1,41,5,15,0.333,4,8,0.5,1,7,0.143,6,6,1,2,4,6
4261,J.R. Smith,31-063,G-F,11/11/16,CLE,@,WAS,W,1,35,5,11,0.455,0,2,0,5,9,0.556,2,2,1,0,4,4
4262,Jason Smith,31-015,F-C,3/17/17,WAS,,CHI,W,1,38,6,15,0.4,3,9,0.333,3,6,0.5,2,3,0.667,3,4,7
4263,Jason Smith,31-005,F-C,3/7/17,WAS,@,PHO,W,0,23,6,7,0.857,4,5,0.8,2,2,1,3,4,0.75,1,5,6
4264,Marreese Speights,29-128,C-F,12/10/16,LAC,,NOP,W,0,25,7,12,0.583,4,6,0.667,3,6,0.5,0,0,,2,10,12
4265,Rodney Stuckey,30-312,G,2/27/17,IND,@,HOU,W,0,22,6,15,0.4,4,9,0.444,2,6,0.333,3,3,1,1,5,6
4266,Jeff Teague,28-207,G,1/3/17,IND,@,DET,W,1,33,5,8,0.625,4,7,0.571,1,1,1,6,7,0.857,0,3,3
4267,Jeff Teague,28-241,G,2/6/17,IND,,OKC,W,1,34,6,16,0.375,4,12,0.333,2,4,0.5,3,4,0.75,0,4,4
4268,Jeff Teague,28-273,G,3/10/17,IND,@,MIL,L,1,35,7,12,0.583,6,10,0.6,1,2,0.5,2,2,1,0,4,4
4269,Jeff Teague,28-233,G,1/29/17,IND,,HOU,W,1,36,5,10,0.5,5,8,0.625,0,2,0,7,7,1,0,3,3
4270,Jeff Teague,28-193,G,12/20/16,IND,@,NYK,L,1,37,5,13,0.385,5,10,0.5,0,3,0,7,9,0.778,1,6,7
4271,Jeff Teague,28-231,G,1/27/17,IND,,SAC,W,1,43,5,11,0.455,4,8,0.5,1,3,0.333,6,6,1,1,7,8
4272,Garrett Temple,30-222,G,12/16/16,SAC,@,MEM,W,1,37,4,10,0.4,1,5,0.2,3,5,0.6,6,6,1,2,4,6
4273,Garrett Temple,30-213,G,12/7/16,SAC,@,DAL,W,0,27,5,6,0.833,1,2,0.5,4,4,1,3,4,0.75,0,3,3
4274,Lance Thomas,28-316,F,3/6/17,NYK,@,ORL,W,1,27,5,13,0.385,2,8,0.25,3,5,0.6,4,4,1,1,3,4
4275,Klay Thompson,26-319,G,12/23/16,GSW,@,DET,W,1,37,6,14,0.429,3,6,0.5,3,8,0.375,2,2,1,0,3,3
4276,Klay Thompson,26-333,G,1/6/17,GSW,,MEM,L,1,42,7,17,0.412,5,11,0.455,2,6,0.333,1,3,0.333,3,3,6
4277,Klay Thompson,26-316,G,12/20/16,GSW,,UTA,W,1,31,8,13,0.615,7,10,0.7,1,3,0.333,0,0,,0,5,5
4278,Klay Thompson,26-309,G,12/13/16,GSW,@,NOP,W,1,37,6,16,0.375,4,8,0.5,2,8,0.25,3,4,0.75,1,2,3
4279,Anthony Tolliver,31-223,F-C,1/10/17,SAC,,DET,W,1,36,4,11,0.364,1,4,0.25,3,7,0.429,6,6,1,3,1,4
4280,Anthony Tolliver,31-205,F-C,12/23/16,SAC,@,MIN,W,0,31,6,9,0.667,1,2,0.5,5,7,0.714,0,0,,0,3,3
4281,Karl-Anthony Towns,21-023,F-C,12/8/16,MIN,@,TOR,L,1,35,8,16,0.5,7,12,0.583,1,4,0.25,0,0,,5,6,11
4282,Karl-Anthony Towns,21-036,F-C,12/21/16,MIN,@,ATL,W,1,37,7,16,0.438,7,13,0.538,0,3,0,3,4,0.75,4,14,18
4283,Karl-Anthony Towns,21-004,F-C,11/19/16,MIN,@,MEM,L,1,28,6,10,0.6,3,7,0.429,3,3,1,2,4,0.5,0,3,3
4284,Karl-Anthony Towns,21-120,F-C,3/15/17,MIN,@,BOS,L,1,40,7,14,0.5,6,9,0.667,1,5,0.2,2,2,1,4,10,14
4285,P.J. Tucker,31-209,F,11/30/16,PHO,,ATL,W,1,30,6,9,0.667,4,6,0.667,2,3,0.667,3,3,1,1,2,3
4286,Evan Turner,28-027,G,11/23/16,POR,@,CLE,L,0,33,7,13,0.538,5,9,0.556,2,4,0.5,1,1,1,0,1,1
4287,Myles Turner,20-285,F-C,1/3/17,IND,@,DET,W,1,36,7,12,0.583,5,10,0.5,2,2,1,1,2,0.5,2,5,7
4288,Myles Turner,20-233,F-C,11/12/16,IND,,BOS,L,1,30,6,8,0.75,6,7,0.857,0,1,0,5,5,1,2,6,8
4289,Myles Turner,20-355,F-C,3/14/17,IND,@,NYK,L,1,31,8,17,0.471,8,17,0.471,0,0,,1,2,0.5,6,5,11
4290,Myles Turner,20-248,F-C,11/27/16,IND,,LAC,W,1,25,8,16,0.5,7,13,0.538,1,3,0.333,0,0,,3,9,12
4291,Myles Turner,20-329,F-C,2/16/17,IND,,WAS,L,1,37,6,13,0.462,6,12,0.5,0,1,0,5,7,0.714,3,6,9
4292,Tyler Ulis,21-073,G,3/19/17,PHO,@,DET,L,1,43,7,24,0.292,7,19,0.368,0,5,0,3,4,0.75,0,3,3
4293,Jonas Valanciunas,24-222,C,12/14/16,TOR,@,PHI,W,1,34,6,11,0.545,6,11,0.545,0,0,,5,5,1,4,6,10
4294,Jonas Valanciunas,24-282,C,2/12/17,TOR,,DET,L,1,34,7,14,0.5,7,14,0.5,0,0,,3,4,0.75,2,7,9
4295,Nikola Vucevic,26-002,C,10/26/16,ORL,,MIA,L,1,36,7,14,0.5,7,14,0.5,0,0,,3,4,0.75,5,9,14
4296,Nikola Vucevic,26-034,C,11/27/16,ORL,,MIL,L,0,30,7,15,0.467,6,12,0.5,1,3,0.333,2,2,1,3,13,16
4297,Nikola Vucevic,26-032,C,11/25/16,ORL,,WAS,L,1,35,8,16,0.5,7,14,0.5,1,2,0.5,0,0,,5,12,17
4298,Nikola Vucevic,26-084,C,1/16/17,ORL,@,DEN,L,1,28,8,13,0.615,8,12,0.667,0,1,0,1,1,1,1,3,4
4299,Dwyane Wade,34-318,G,11/30/16,CHI,,LAL,L,1,30,7,15,0.467,7,14,0.5,0,1,0,3,4,0.75,1,3,4
4300,Dwyane Wade,35-000,G,1/17/17,CHI,,DAL,L,1,35,8,21,0.381,8,20,0.4,0,1,0,1,3,0.333,1,4,5
4301,Dion Waiters,25-038,G,1/17/17,MIA,,HOU,W,1,28,7,15,0.467,6,11,0.545,1,4,0.25,2,3,0.667,2,3,5
4302,Dion Waiters,25-049,G,1/28/17,MIA,,DET,W,1,34,7,19,0.368,6,10,0.6,1,9,0.111,2,4,0.5,1,2,3
4303,Kemba Walker,26-197,G,11/21/16,CHO,,MEM,L,1,31,6,15,0.4,5,8,0.625,1,7,0.143,4,6,0.667,0,2,2
4304,Kemba Walker,26-275,G,2/7/17,CHO,,BRK,W,1,35,4,20,0.2,3,16,0.188,1,4,0.25,8,9,0.889,1,2,3
4305,Kemba Walker,26-220,G,12/14/16,CHO,@,WAS,L,1,36,7,15,0.467,4,7,0.571,3,8,0.375,0,0,,1,5,6
4306,Kemba Walker,26-171,G,10/26/16,CHO,@,MIL,W,1,35,5,15,0.333,2,8,0.25,3,7,0.429,4,6,0.667,0,1,1
4307,Kemba Walker,26-201,G,11/25/16,CHO,@,NYK,L,1,32,7,16,0.438,7,11,0.636,0,5,0,3,5,0.6,1,4,5
4308,Kemba Walker,26-250,G,1/13/17,CHO,@,PHI,L,1,42,7,23,0.304,5,14,0.357,2,9,0.222,1,1,1,1,2,3
4309,John Wall,26-087,G,12/2/16,WAS,@,SAS,L,1,37,8,16,0.5,7,15,0.467,1,1,1,0,0,,0,2,2
4310,Taurean Waller-Prince,22-354,F,3/11/17,ATL,@,MEM,W,0,31,5,6,0.833,2,2,1,3,4,0.75,4,4,1,0,3,3
4311,T.J. Warren,23-185,F,3/9/17,PHO,,LAL,L,1,39,8,17,0.471,8,16,0.5,0,1,0,1,1,1,4,9,13
4312,T.J. Warren,23-176,F,2/28/17,PHO,@,MEM,L,1,34,8,13,0.615,8,10,0.8,0,3,0,1,2,0.5,2,4,6
4313,T.J. Warren,23-172,F,2/24/17,PHO,@,CHI,L,1,38,8,14,0.571,8,12,0.667,0,2,0,1,2,0.5,3,5,8
4314,Russell Westbrook,28-104,G,2/24/17,OKC,,LAL,W,1,35,4,18,0.222,3,13,0.231,1,5,0.2,8,9,0.889,2,16,18
4315,Russell Westbrook,28-014,G,11/26/16,OKC,,DET,W,1,37,8,22,0.364,8,17,0.471,0,5,0,1,2,0.5,3,10,13
4316,Russell Westbrook,28-049,G,12/31/16,OKC,,LAC,W,1,29,6,11,0.545,6,9,0.667,0,2,0,5,6,0.833,0,12,12
4317,Russell Westbrook,28-093,G,2/13/17,OKC,@,WAS,L,1,24,5,19,0.263,5,15,0.333,0,4,0,7,7,1,2,2,4
4318,Hassan Whiteside,27-279,C,3/19/17,MIA,,POR,L,1,31,8,15,0.533,8,15,0.533,0,0,,1,2,0.5,5,5,10
4319,Hassan Whiteside,27-182,C,12/12/16,MIA,,WAS,W,1,34,7,14,0.5,7,14,0.5,0,0,,3,6,0.5,3,13,16
4320,Andrew Wiggins,21-252,F-G,11/1/16,MIN,,MEM,W,1,29,6,11,0.545,4,9,0.444,2,2,1,3,5,0.6,1,2,3
4321,Andrew Wiggins,22-009,F-G,3/4/17,MIN,@,SAS,L,1,44,6,24,0.25,6,22,0.273,0,2,0,5,6,0.833,0,4,4
4322,Alan Williams,24-029,F-C,2/26/17,PHO,@,MIL,L,0,34,7,13,0.538,7,13,0.538,0,0,,3,3,1,7,8,15
4323,Deron Williams,32-169,G,12/12/16,DAL,,DEN,W,1,32,7,16,0.438,6,10,0.6,1,6,0.167,2,2,1,0,2,2
4324,Derrick Williams,25-198,F,12/9/16,MIA,@,CLE,L,0,31,6,11,0.545,6,9,0.667,0,2,0,5,7,0.714,1,1,2
4325,Lou Williams,30-017,G,11/13/16,LAL,@,MIN,L,0,18,5,10,0.5,3,6,0.5,2,4,0.5,5,5,1,0,5,5
4326,Lou Williams,30-001,G,10/28/16,LAL,@,UTA,L,0,27,6,12,0.5,3,8,0.375,3,4,0.75,2,2,1,0,0,0
4327,Lou Williams,30-104,G,2/8/17,LAL,@,DET,L,0,21,4,10,0.4,4,5,0.8,0,5,0,9,9,1,0,1,1
4328,Lou Williams,30-121,G,2/25/17,HOU,,MIN,W,0,26,4,11,0.364,2,4,0.5,2,7,0.286,7,9,0.778,0,0,0
4329,Marvin Williams,30-222,F,1/27/17,CHO,@,NYK,L,1,31,6,14,0.429,1,5,0.2,5,9,0.556,0,0,,0,3,3
4330,Reggie Williams,30-088,F,12/11/16,NOP,@,PHO,W,0,20,5,8,0.625,1,3,0.333,4,5,0.8,3,3,1,1,2,3
4331,Brandan Wright,29-131,F-C,2/13/17,MEM,@,BRK,W,0,21,7,9,0.778,7,9,0.778,0,0,,3,3,1,1,3,4
4332,Nick Young,31-211,G-F,12/29/16,LAL,,DAL,L,1,30,6,8,0.75,1,2,0.5,5,6,0.833,0,0,,0,2,2
4333,Nick Young,31-154,G-F,11/2/16,LAL,@,ATL,W,1,26,6,11,0.545,3,4,0.75,3,7,0.429,2,2,1,0,1,1
4334,Nick Young,31-179,G-F,11/27/16,LAL,,ATL,W,1,23,6,12,0.5,2,7,0.286,4,5,0.8,1,1,1,1,0,1
4335,Nick Young,31-174,G-F,11/22/16,LAL,,OKC,W,1,29,6,12,0.5,2,5,0.4,4,7,0.571,1,2,0.5,1,1,2
4336,Nick Young,31-250,G-F,2/6/17,LAL,@,NYK,W,1,22,5,15,0.333,2,5,0.4,3,10,0.3,4,4,1,1,4,5
4337,Nick Young,31-247,G-F,2/3/17,LAL,@,BOS,L,1,33,6,14,0.429,1,4,0.25,5,10,0.5,0,0,,1,2,3
4338,Thaddeus Young,28-209,F,1/16/17,IND,,NOP,W,1,37,8,9,0.889,8,9,0.889,0,0,,1,1,1,0,3,3
4339,Thaddeus Young,28-166,F,12/4/16,IND,@,LAC,W,1,30,7,13,0.538,7,13,0.538,0,0,,3,4,0.75,2,5,7
4340,Thaddeus Young,28-192,F,12/30/16,IND,,CHI,W,1,36,7,11,0.636,7,11,0.636,0,0,,3,4,0.75,2,4,6
4341,Cody Zeller,24-066,F-C,12/10/16,CHO,@,CLE,L,1,23,7,8,0.875,7,8,0.875,0,0,,3,4,0.75,3,6,9
4342,Ivica Zubac,20-003,C,3/21/17,LAL,,LAC,L,1,36,8,14,0.571,8,14,0.571,0,0,,1,2,0.5,1,6,7
4343,Ivica Zubac,19-319,C,1/31/17,LAL,,DEN,W,0,21,8,9,0.889,8,9,0.889,0,0,,1,1,1,3,3,6
4344,Steven Adams,23-144,C,12/11/16,OKC,,BOS,W,1,32,7,8,0.875,7,8,0.875,0,0,,2,5,0.4,4,4,8
4345,Steven Adams,23-195,C,1/31/17,OKC,@,SAS,L,1,34,7,13,0.538,7,13,0.538,0,0,,2,4,0.5,5,7,12
4346,Steven Adams,23-171,C,1/7/17,OKC,,DEN,W,1,31,7,10,0.7,7,10,0.7,0,0,,2,3,0.667,0,5,5
4347,Steven Adams,23-241,C,3/18/17,OKC,,SAC,W,1,35,6,7,0.857,6,7,0.857,0,0,,4,6,0.667,4,9,13
4348,Steven Adams,23-129,C,11/26/16,OKC,,DET,W,1,29,7,9,0.778,7,9,0.778,0,0,,2,5,0.4,3,6,9
4349,Steven Adams,23-198,C,2/3/17,OKC,,MEM,W,1,44,7,13,0.538,7,13,0.538,0,0,,2,6,0.333,10,2,12
4350,Steven Adams,23-098,C,10/26/16,OKC,@,PHI,W,1,36,7,16,0.438,7,16,0.438,0,0,,2,2,1,2,3,5
4351,Alexis Ajinca,28-226,C,12/18/16,NOP,@,SAS,L,1,27,8,12,0.667,8,11,0.727,0,1,0,0,0,,1,7,8
4352,LaMarcus Aldridge,31-116,F-C,11/12/16,SAS,@,HOU,W,1,35,5,13,0.385,5,12,0.417,0,1,0,6,6,1,0,10,10
4353,LaMarcus Aldridge,31-188,F-C,1/23/17,SAS,@,BRK,W,1,27,8,19,0.421,8,18,0.444,0,1,0,0,0,,4,5,9
4354,LaMarcus Aldridge,31-133,F-C,11/29/16,SAS,,ORL,L,1,31,7,12,0.583,6,11,0.545,1,1,1,1,2,0.5,1,5,6
4355,LaMarcus Aldridge,31-186,F-C,1/21/17,SAS,@,CLE,W,1,42,7,14,0.5,7,14,0.5,0,0,,2,4,0.5,4,8,12
4356,LaMarcus Aldridge,31-222,F-C,2/26/17,SAS,@,LAL,W,1,23,8,14,0.571,8,14,0.571,0,0,,0,0,,5,4,9
4357,LaMarcus Aldridge,31-194,F-C,1/29/17,SAS,,DAL,L,1,34,5,14,0.357,5,14,0.357,0,0,,6,9,0.667,2,5,7
4358,LaMarcus Aldridge,31-100,F-C,10/27/16,SAS,@,SAC,W,1,32,5,13,0.385,5,12,0.417,0,1,0,6,8,0.75,2,3,5
4359,Tony Allen,34-340,G-F,12/16/16,MEM,,SAC,L,1,34,6,13,0.462,6,13,0.462,0,0,,4,6,0.667,6,3,9
4360,Tony Allen,34-338,G-F,12/14/16,MEM,,CLE,W,1,33,7,17,0.412,7,16,0.438,0,1,0,2,5,0.4,5,3,8
4361,Al-Farouq Aminu,26-109,F,1/8/17,POR,,DET,L,1,37,7,10,0.7,6,7,0.857,1,3,0.333,1,1,1,1,7,8
4362,Justin Anderson,22-356,G,11/9/16,DAL,@,GSW,L,1,41,6,19,0.316,6,14,0.429,0,5,0,4,7,0.571,3,5,8
4363,Ryan Anderson,28-310,F,3/12/17,HOU,,CLE,W,1,30,5,11,0.455,1,4,0.25,4,7,0.571,2,2,1,2,4,6
4364,Ryan Anderson,28-281,F,2/11/17,HOU,,PHO,W,1,33,4,9,0.444,1,3,0.333,3,6,0.5,5,8,0.625,2,2,4
4365,Ryan Anderson,28-262,F,1/23/17,HOU,@,MIL,L,1,29,6,11,0.545,3,4,0.75,3,7,0.429,1,1,1,1,0,1
4366,Ryan Anderson,28-180,F,11/2/16,HOU,@,NYK,W,1,29,6,15,0.4,2,6,0.333,4,9,0.444,0,0,,5,4,9
4367,Giannis Antetokounmpo,22-099,F-G,3/15/17,MIL,@,LAC,W,1,28,5,10,0.5,5,10,0.5,0,0,,6,9,0.667,0,5,5
4368,Giannis Antetokounmpo,21-363,F-G,12/3/16,MIL,,BRK,W,1,35,5,9,0.556,4,6,0.667,1,3,0.333,5,8,0.625,1,9,10
4369,Carmelo Anthony,32-283,F,3/8/17,NYK,@,MIL,L,1,40,6,13,0.462,4,9,0.444,2,4,0.5,2,3,0.667,2,2,4
4370,Carmelo Anthony,32-295,F,3/20/17,NYK,@,LAC,L,1,25,6,14,0.429,5,9,0.556,1,5,0.2,3,3,1,2,2,4
4371,Trevor Ariza,31-140,F,11/17/16,HOU,,POR,W,1,29,5,8,0.625,1,2,0.5,4,6,0.667,2,2,1,2,5,7
4372,Trevor Ariza,31-155,F,12/2/16,HOU,@,DEN,W,1,31,6,12,0.5,2,4,0.5,4,8,0.5,0,0,,2,5,7
4373,Trevor Ariza,31-195,F,1/11/17,HOU,@,MIN,L,1,40,6,13,0.462,3,6,0.5,3,7,0.429,1,3,0.333,2,1,3
4374,Trevor Ariza,31-194,F,1/10/17,HOU,,CHO,W,1,40,5,10,0.5,2,4,0.5,3,6,0.5,3,5,0.6,0,5,5
4375,Trevor Ariza,31-173,F,12/20/16,HOU,,SAS,L,1,35,6,14,0.429,3,5,0.6,3,9,0.333,1,2,0.5,0,6,6
4376,Darrell Arthur,28-305,F,1/24/17,DEN,,UTA,W,0,22,5,7,0.714,2,4,0.5,3,3,1,3,3,1,2,6,8
4377,Luke Babbitt,27-207,F,1/13/17,MIA,@,MIL,L,1,32,6,9,0.667,2,2,1,4,7,0.571,0,0,,0,4,4
4378,Leandro Barbosa,34-094,G,3/2/17,PHO,,CHO,W,0,23,7,11,0.636,6,7,0.857,1,4,0.25,1,1,1,0,4,4
4379,Harrison Barnes,24-261,F,2/15/17,DAL,@,DET,L,1,37,7,16,0.438,7,12,0.583,0,4,0,2,2,1,1,4,5
4380,Matt Barnes,36-327,F,1/30/17,SAC,@,PHI,L,0,22,6,12,0.5,2,5,0.4,4,7,0.571,0,0,,2,1,3
4381,Will Barton,25-339,G,12/10/16,DEN,@,ORL,W,1,24,5,8,0.625,5,8,0.625,0,0,,6,8,0.75,1,3,4
4382,Will Barton,25-299,G,10/31/16,DEN,@,TOR,L,1,30,5,7,0.714,3,5,0.6,2,2,1,4,5,0.8,0,4,4
4383,Will Barton,26-048,G,2/23/17,DEN,@,SAC,L,0,32,7,15,0.467,5,10,0.5,2,5,0.4,0,0,,1,1,2
4384,Will Barton,25-297,G,10/29/16,DEN,,POR,L,1,41,4,13,0.308,4,11,0.364,0,2,0,8,8,1,1,5,6
4385,Will Barton,26-020,G,1/26/17,DEN,,PHO,W,0,25,6,7,0.857,5,6,0.833,1,1,1,3,3,1,1,1,2
4386,Nicolas Batum,28-096,F-G,3/20/17,CHO,,ATL,W,1,31,5,8,0.625,4,6,0.667,1,2,0.5,5,7,0.714,0,1,1
4387,Nicolas Batum,28-038,F-G,1/21/17,CHO,,BRK,W,1,35,6,16,0.375,3,10,0.3,3,6,0.5,1,1,1,0,9,9
4388,Nicolas Batum,28-015,F-G,12/29/16,CHO,,MIA,W,1,36,7,17,0.412,7,12,0.583,0,5,0,2,3,0.667,3,10,13
4389,Nicolas Batum,27-361,F-G,12/9/16,CHO,,ORL,W,1,29,6,11,0.545,2,7,0.286,4,4,1,0,0,,1,8,9
4390,Nicolas Batum,28-084,F-G,3/8/17,CHO,@,MIA,L,1,31,5,14,0.357,5,11,0.455,0,3,0,6,6,1,1,6,7
4391,Nicolas Batum,28-061,F-G,2/13/17,CHO,,PHI,L,1,38,5,12,0.417,2,6,0.333,3,6,0.5,3,3,1,0,1,1
4392,Nicolas Batum,28-042,F-G,1/25/17,CHO,,GSW,L,1,38,6,12,0.5,4,8,0.5,2,4,0.5,2,2,1,1,5,6
4393,Nicolas Batum,27-337,F-G,11/15/16,CHO,@,MIN,W,1,36,5,9,0.556,1,4,0.25,4,5,0.8,2,3,0.667,0,5,5
4394,Kent Bazemore,27-199,G-F,1/16/17,ATL,@,NYK,W,1,32,5,13,0.385,3,5,0.6,2,8,0.25,4,4,1,1,5,6
4395,Kent Bazemore,27-208,G-F,1/25/17,ATL,@,CHI,W,1,33,7,14,0.5,5,10,0.5,2,4,0.5,0,0,,1,5,6
4396,Kent Bazemore,27-204,G-F,1/21/17,ATL,,PHI,W,1,24,7,12,0.583,5,8,0.625,2,4,0.5,0,0,,0,2,2
4397,Kent Bazemore,27-258,G-F,3/16/17,ATL,,MEM,L,1,31,4,8,0.5,4,6,0.667,0,2,0,8,10,0.8,0,0,0
4398,Marco Belinelli,30-313,G-F,2/1/17,CHO,@,GSW,L,0,30,6,11,0.545,5,6,0.833,1,5,0.2,3,3,1,1,1,2
4399,Marco Belinelli,30-255,G-F,12/5/16,CHO,@,DAL,W,0,30,5,9,0.556,3,5,0.6,2,4,0.5,4,5,0.8,0,6,6
4400,Marco Belinelli,30-264,G-F,12/14/16,CHO,@,WAS,L,0,22,6,10,0.6,2,4,0.5,4,6,0.667,0,0,,0,1,1
4401,Patrick Beverley,28-187,G,1/15/17,HOU,@,BRK,W,1,27,6,11,0.545,2,4,0.5,4,7,0.571,0,0,,0,7,7
4402,Nemanja Bjelica,28-279,F,2/12/17,MIN,,CHI,W,0,19,6,12,0.5,3,6,0.5,3,6,0.5,1,1,1,1,5,6
4403,Nemanja Bjelica,28-308,F,3/13/17,MIN,,WAS,W,0,29,6,7,0.857,5,5,1,1,2,0.5,3,4,0.75,2,7,9
4404,Eric Bledsoe,26-322,G,10/26/16,PHO,,SAC,L,1,29,5,11,0.455,3,6,0.5,2,5,0.4,4,4,1,0,6,6
4405,Eric Bledsoe,26-350,G,11/23/16,PHO,@,ORL,W,1,32,5,15,0.333,4,11,0.364,1,4,0.25,5,8,0.625,0,9,9
4406,Eric Bledsoe,27-061,G,2/8/17,PHO,@,MEM,L,1,25,3,15,0.2,2,11,0.182,1,4,0.25,9,9,1,0,0,0
4407,Eric Bledsoe,27-012,G,12/21/16,PHO,,HOU,L,1,31,6,13,0.462,5,8,0.625,1,5,0.2,3,4,0.75,2,0,2
4408,Bojan Bogdanovic,27-316,G-F,2/28/17,WAS,,GSW,W,0,24,5,12,0.417,2,6,0.333,3,6,0.5,3,3,1,2,0,2
4409,Bojan Bogdanovic,27-287,G-F,1/30/17,BRK,@,MIA,L,1,31,6,13,0.462,5,9,0.556,1,4,0.25,3,3,1,0,6,6
4410,Bojan Bogdanovic,27-267,G-F,1/10/17,BRK,,ATL,L,1,26,5,10,0.5,2,5,0.4,3,5,0.6,3,3,1,0,6,6
4411,Bojan Bogdanovic,27-278,G-F,1/21/17,BRK,@,CHO,L,1,28,4,12,0.333,0,4,0,4,8,0.5,4,4,1,0,3,3
4412,Devin Booker,20-042,G,12/11/16,PHO,,NOP,L,1,38,6,15,0.4,4,7,0.571,2,8,0.25,2,3,0.667,0,5,5
4413,Devin Booker,20-126,G,3/5/17,PHO,,BOS,W,1,27,5,10,0.5,4,7,0.571,1,3,0.333,5,6,0.833,0,5,5
4414,Devin Booker,20-057,G,12/26/16,PHO,@,HOU,L,1,28,6,18,0.333,5,13,0.385,1,5,0.2,3,3,1,1,1,2
4415,Trevor Booker,29-041,F,1/5/17,BRK,@,IND,L,1,20,7,11,0.636,5,9,0.556,2,2,1,0,0,,2,4,6
4416,Trevor Booker,29-035,F,12/30/16,BRK,@,WAS,L,1,20,6,11,0.545,3,7,0.429,3,4,0.75,1,2,0.5,2,5,7
4417,Trevor Booker,28-361,F,11/20/16,BRK,,POR,L,1,26,7,9,0.778,5,7,0.714,2,2,1,0,0,,3,1,4
4418,Avery Bradley,26-024,G,12/20/16,BOS,@,MEM,W,1,38,5,8,0.625,4,5,0.8,1,3,0.333,5,6,0.833,0,3,3
4419,Avery Bradley,26-104,G,3/10/17,BOS,@,DEN,L,1,29,6,14,0.429,2,6,0.333,4,8,0.5,0,0,,0,2,2
4420,Avery Bradley,25-336,G,10/27/16,BOS,@,CHI,L,1,41,6,12,0.5,5,9,0.556,1,3,0.333,3,4,0.75,1,5,6
4421,Avery Bradley,26-027,G,12/23/16,BOS,,OKC,L,1,36,6,16,0.375,5,11,0.455,1,5,0.2,3,6,0.5,2,4,6
4422,Avery Bradley,26-009,G,12/5/16,BOS,@,HOU,L,1,35,8,16,0.5,8,14,0.571,0,2,0,0,0,,2,8,10
4423,Avery Bradley,26-111,G,3/17/17,BOS,@,BRK,W,1,34,6,13,0.462,6,11,0.545,0,2,0,4,5,0.8,1,4,5
4424,Malcolm Brogdon,24-040,G,1/20/17,MIL,@,ORL,L,1,35,6,11,0.545,2,5,0.4,4,6,0.667,0,0,,0,2,2
4425,Aaron Brooks,31-321,G,11/30/16,IND,@,POR,L,0,21,6,10,0.6,3,5,0.6,3,5,0.6,1,1,1,0,3,3
4426,Jaylen Brown,20-130,F,3/3/17,BOS,@,LAL,W,0,23,7,13,0.538,7,11,0.636,0,2,0,2,3,0.667,2,6,8
4427,Jimmy Butler,27-177,G-F,3/10/17,CHI,,HOU,L,1,31,6,12,0.5,6,10,0.6,0,2,0,4,4,1,3,2,5
4428,Jimmy Butler,27-045,G-F,10/29/16,CHI,,IND,W,1,26,6,9,0.667,6,7,0.857,0,2,0,4,4,1,2,3,5
4429,Jimmy Butler,27-123,G-F,1/15/17,CHI,@,MEM,W,1,38,6,14,0.429,5,9,0.556,1,5,0.2,3,7,0.429,0,8,8
4430,Jimmy Butler,27-171,G-F,3/4/17,CHI,,LAC,L,1,36,4,7,0.571,3,6,0.5,1,1,1,7,8,0.875,2,2,4
4431,Jimmy Butler,27-103,G-F,12/26/16,CHI,,IND,W,1,40,3,12,0.25,2,9,0.222,1,3,0.333,9,12,0.75,0,5,5
4432,Jimmy Butler,27-052,G-F,11/5/16,CHI,@,IND,L,1,32,5,7,0.714,4,6,0.667,1,1,1,5,6,0.833,0,4,4
4433,Kentavious Caldwell-Pope,23-281,G,11/25/16,DET,,LAC,W,1,35,5,11,0.455,1,5,0.2,4,6,0.667,2,2,1,0,1,1
4434,Kentavious Caldwell-Pope,24-010,G,2/28/17,DET,,POR,W,1,47,5,12,0.417,4,8,0.5,1,4,0.25,5,5,1,0,3,3
4435,Kentavious Caldwell-Pope,23-363,G,2/15/17,DET,,DAL,W,1,37,7,15,0.467,5,8,0.625,2,7,0.286,0,0,,1,4,5
4436,Kentavious Caldwell-Pope,23-320,G,1/3/17,DET,,IND,L,1,39,5,13,0.385,4,8,0.5,1,5,0.2,5,5,1,1,2,3
4437,Clint Capela,22-283,F-C,2/25/17,HOU,,MIN,W,1,22,7,9,0.778,7,9,0.778,0,0,,2,2,1,4,5,9
4438,Clint Capela,22-161,F-C,10/26/16,HOU,@,LAL,L,1,26,8,11,0.727,8,11,0.727,0,0,,0,1,0,3,6,9
4439,Clint Capela,22-250,F-C,1/23/17,HOU,@,MIL,L,1,22,7,12,0.583,7,12,0.583,0,0,,2,3,0.667,1,2,3
4440,Clint Capela,22-304,F-C,3/18/17,HOU,@,DEN,W,1,24,7,13,0.538,7,13,0.538,0,0,,2,2,1,5,3,8
4441,Tyson Chandler,34-112,C,1/22/17,PHO,@,TOR,W,1,35,7,10,0.7,7,10,0.7,0,0,,2,2,1,3,6,9
4442,Wilson Chandler,29-196,F,11/22/16,DEN,,CHI,W,0,33,7,23,0.304,6,19,0.316,1,4,0.25,1,1,1,4,5,9
4443,Marquese Chriss,19-133,F,11/12/16,PHO,,BRK,L,1,18,7,15,0.467,5,11,0.455,2,4,0.5,0,0,,2,3,5
4444,Marquese Chriss,19-260,F,3/19/17,PHO,@,DET,L,1,26,5,13,0.385,4,10,0.4,1,3,0.333,5,6,0.833,1,6,7
4445,Jordan Clarkson,24-233,G,1/26/17,LAL,@,UTA,L,0,36,8,18,0.444,8,16,0.5,0,2,0,0,0,,0,5,5
4446,Jordan Clarkson,24-169,G,11/23/16,LAL,@,GSW,L,0,29,7,16,0.438,7,14,0.5,0,2,0,2,3,0.667,1,2,3
4447,Jordan Clarkson,24-210,G,1/3/17,LAL,,MEM,W,0,18,6,9,0.667,3,3,1,3,6,0.5,1,3,0.333,3,4,7
4448,Jordan Clarkson,24-266,G,2/28/17,LAL,,CHO,L,0,34,7,14,0.5,6,10,0.6,1,4,0.25,1,1,1,0,3,3
4449,Jordan Clarkson,24-222,G,1/15/17,LAL,,DET,L,0,24,7,12,0.583,7,10,0.7,0,2,0,2,2,1,0,2,2
4450,Darren Collison,29-087,G,11/18/16,SAC,,LAC,L,0,33,7,11,0.636,6,9,0.667,1,2,0.5,1,2,0.5,1,1,2
4451,Darren Collison,29-130,G,12/31/16,SAC,,MEM,L,1,39,8,16,0.5,8,14,0.571,0,2,0,0,0,,1,3,4
4452,Mike Conley,29-161,G,3/21/17,MEM,@,NOP,L,1,31,6,14,0.429,4,8,0.5,2,6,0.333,2,2,1,0,6,6
4453,Mike Conley,29-101,G,1/20/17,MEM,,SAC,W,1,34,6,13,0.462,4,8,0.5,2,5,0.4,2,2,1,1,7,8
4454,Mike Conley,29-045,G,11/25/16,MEM,,MIA,L,0,23,5,15,0.333,4,11,0.364,1,4,0.25,5,5,1,2,2,4
4455,Mike Conley,29-026,G,11/6/16,MEM,,POR,L,1,31,5,11,0.455,4,6,0.667,1,5,0.2,5,5,1,0,4,4
4456,Mike Conley,29-151,G,3/11/17,MEM,,ATL,L,1,32,5,12,0.417,4,5,0.8,1,7,0.143,5,5,1,0,1,1
4457,DeMarcus Cousins,26-171,C-F,1/31/17,SAC,@,HOU,L,1,25,5,16,0.313,4,12,0.333,1,4,0.25,5,7,0.714,1,6,7
4458,DeMarcus Cousins,26-119,C-F,12/10/16,SAC,@,UTA,L,1,34,7,22,0.318,6,16,0.375,1,6,0.167,1,3,0.333,3,7,10
4459,Robert Covington,26-079,F,3/3/17,PHI,,NYK,W,1,36,3,9,0.333,1,4,0.25,2,5,0.4,8,9,0.889,1,3,4
4460,Robert Covington,26-095,F,3/19/17,PHI,,BOS,W,1,36,7,15,0.467,5,8,0.625,2,7,0.286,0,0,,1,7,8
4461,Robert Covington,25-363,F,12/11/16,PHI,@,DET,W,1,34,6,9,0.667,4,5,0.8,2,4,0.5,2,2,1,0,7,7
4462,Robert Covington,26-009,F,12/23/16,PHI,@,PHO,L,1,33,6,11,0.545,5,5,1,1,6,0.167,3,3,1,1,1,2
4463,Allen Crabbe,24-238,G-F,12/3/16,POR,,MIA,W,0,28,5,11,0.455,1,5,0.2,4,6,0.667,2,2,1,0,3,3
4464,Allen Crabbe,24-343,G-F,3/18/17,POR,@,ATL,W,0,29,5,10,0.5,1,2,0.5,4,8,0.5,2,2,1,0,3,3
4465,Allen Crabbe,24-216,G-F,11/11/16,POR,,SAC,W,0,37,6,10,0.6,4,5,0.8,2,5,0.4,2,3,0.667,1,6,7
4466,Jamal Crawford,36-230,G,11/5/16,LAC,@,SAS,W,0,26,6,10,0.6,3,5,0.6,3,5,0.6,1,1,1,0,3,3
4467,Jae Crowder,26-172,F,12/25/16,BOS,@,NYK,W,1,34,5,9,0.556,2,3,0.667,3,6,0.5,3,4,0.75,1,5,6
4468,Jae Crowder,26-242,F,3/5/17,BOS,@,PHO,L,1,33,6,10,0.6,4,5,0.8,2,5,0.4,2,3,0.667,0,10,10
4469,Jae Crowder,26-257,F,3/20/17,BOS,,WAS,W,1,38,5,12,0.417,2,4,0.5,3,8,0.375,3,4,0.75,4,5,9
4470,Jae Crowder,26-149,F,12/2/16,BOS,,SAC,W,1,37,6,12,0.5,3,7,0.429,3,5,0.6,1,1,1,0,3,3
4471,Jae Crowder,26-199,F,1/21/17,BOS,,POR,L,1,40,5,12,0.417,2,5,0.4,3,7,0.429,3,3,1,0,4,4
4472,Dante Cunningham,29-313,F,3/1/17,NOP,,DET,W,1,33,5,8,0.625,1,1,1,4,7,0.571,2,2,1,1,4,5
4473,Seth Curry,26-160,G,1/30/17,DAL,,CLE,W,1,38,7,17,0.412,5,11,0.455,2,6,0.333,0,0,,1,4,5
4474,Seth Curry,26-125,G,12/26/16,DAL,@,NOP,L,0,31,5,9,0.556,3,3,1,2,6,0.333,4,5,0.8,0,1,1
4475,Seth Curry,26-170,G,2/9/17,DAL,,UTA,W,1,43,6,12,0.5,5,8,0.625,1,4,0.25,3,3,1,1,4,5
4476,Seth Curry,26-135,G,1/5/17,DAL,,PHO,L,0,26,6,9,0.667,5,6,0.833,1,3,0.333,3,4,0.75,0,1,1
4477,Seth Curry,26-133,G,1/3/17,DAL,,WAS,W,0,22,5,8,0.625,1,3,0.333,4,5,0.8,2,2,1,0,1,1
4478,Stephen Curry,28-249,G,11/18/16,GSW,@,BOS,W,1,36,7,20,0.35,5,10,0.5,2,10,0.2,0,0,,0,3,3
4479,Troy Daniels,25-164,G,12/26/16,MEM,@,ORL,L,0,20,5,12,0.417,1,4,0.25,4,8,0.5,2,3,0.667,1,3,4
4480,Anthony Davis,23-311,F-C,1/16/17,NOP,@,IND,L,1,23,6,11,0.545,6,11,0.545,0,0,,4,5,0.8,0,3,3
4481,Anthony Davis,23-322,F-C,1/27/17,NOP,,SAS,W,1,33,6,11,0.545,6,10,0.6,0,1,0,4,5,0.8,5,17,22
4482,Matthew Dellavedova,26-137,G,1/23/17,MIL,,HOU,W,1,31,5,6,0.833,3,3,1,2,3,0.667,4,5,0.8,0,3,3
4483,Matthew Dellavedova,26-184,G,3/11/17,MIL,,MIN,W,1,28,5,12,0.417,1,5,0.2,4,7,0.571,2,2,1,0,1,1
4484,Luol Deng,31-240,F,12/12/16,LAL,@,SAC,L,1,26,7,11,0.636,5,8,0.625,2,3,0.667,0,1,0,1,3,4
4485,DeMar DeRozan,27-117,G,12/2/16,TOR,,LAL,W,1,29,6,18,0.333,6,17,0.353,0,1,0,4,4,1,1,3,4
4486,Boris Diaw,34-283,F-C,1/24/17,UTA,@,DEN,L,0,24,7,12,0.583,5,7,0.714,2,5,0.4,0,0,,0,1,1
4487,Gorgui Dieng,27-006,C,1/24/17,MIN,@,PHO,W,1,34,8,11,0.727,8,11,0.727,0,0,,0,0,,4,5,9
4488,Gorgui Dieng,26-323,C,12/6/16,MIN,,SAS,L,1,33,7,9,0.778,7,9,0.778,0,0,,2,5,0.4,3,5,8
4489,Gorgui Dieng,27-038,C,2/25/17,MIN,@,HOU,L,1,36,7,10,0.7,7,9,0.778,0,1,0,2,4,0.5,4,9,13
4490,Gorgui Dieng,26-330,C,12/13/16,MIN,@,CHI,W,1,37,7,12,0.583,6,10,0.6,1,2,0.5,1,2,0.5,2,5,7
4491,Goran Dragic,30-195,G,11/17/16,MIA,,MIL,W,1,35,5,14,0.357,4,11,0.364,1,3,0.333,5,6,0.833,2,4,6
4492,Goran Dragic,30-319,G,3/21/17,MIA,,PHO,W,1,28,6,15,0.4,4,10,0.4,2,5,0.4,2,3,0.667,1,3,4
4493,Goran Dragic,30-245,G,1/6/17,MIA,@,LAL,L,1,22,7,13,0.538,5,10,0.5,2,3,0.667,0,0,,0,3,3
4494,Goran Dragic,30-208,G,11/30/16,MIA,@,DEN,W,1,34,6,17,0.353,6,14,0.429,0,3,0,4,6,0.667,0,3,3
4495,Goran Dragic,30-278,G,2/8/17,MIA,@,MIL,W,1,34,7,13,0.538,7,11,0.636,0,2,0,2,3,0.667,2,2,4
4496,Goran Dragic,30-274,G,2/4/17,MIA,,PHI,W,1,28,6,11,0.545,4,9,0.444,2,2,1,2,3,0.667,0,4,4
4497,Goran Dragic,30-173,G,10/26/16,MIA,@,ORL,W,1,29,7,15,0.467,7,14,0.5,0,1,0,2,2,1,3,3,6
4498,Andre Drummond,23-077,C,10/26/16,DET,@,TOR,L,1,24,7,11,0.636,7,11,0.636,0,0,,2,6,0.333,1,5,6
4499,Andre Drummond,23-140,C,12/28/16,DET,,MIL,L,1,26,7,13,0.538,7,13,0.538,0,0,,2,6,0.333,4,5,9
4500,Andre Drummond,23-107,C,11/25/16,DET,,LAC,W,1,26,8,11,0.727,8,11,0.727,0,0,,0,2,0,4,6,10
4501,Andre Drummond,23-148,C,1/5/17,DET,,CHO,W,1,25,7,15,0.467,7,15,0.467,0,0,,2,3,0.667,2,6,8
4502,Andre Drummond,23-180,C,2/6/17,DET,,PHI,W,1,26,8,14,0.571,8,13,0.615,0,1,0,0,0,,3,14,17
4503,Jared Dudley,31-131,F-G,11/18/16,PHO,@,IND,W,0,32,6,10,0.6,4,6,0.667,2,4,0.5,2,2,1,2,3,5
4504,Kevin Durant,28-069,F-G,12/7/16,GSW,@,LAC,W,1,32,5,17,0.294,4,12,0.333,1,5,0.2,5,6,0.833,0,8,8
4505,Wayne Ellington,29-105,G,2/11/17,MIA,@,PHI,L,1,36,4,14,0.286,1,4,0.25,3,10,0.3,5,5,1,3,2,5
4506,Monta Ellis,31-069,G,1/3/17,IND,@,DET,W,0,20,6,6,1,6,6,1,0,0,,4,5,0.8,0,1,1
4507,Monta Ellis,31-140,G,3/15/17,IND,,CHO,W,0,27,7,13,0.538,5,8,0.625,2,5,0.4,0,0,,0,1,1
4508,Monta Ellis,31-121,G,2/24/17,IND,,MEM,W,0,24,7,10,0.7,5,7,0.714,2,3,0.667,0,0,,0,1,1
4509,Joel Embiid,22-264,C-F,12/5/16,PHI,,DEN,L,1,26,5,15,0.333,4,12,0.333,1,3,0.333,5,6,0.833,1,3,4
4510,James Ennis,26-124,F,11/2/16,MEM,,NOP,W,1,38,5,8,0.625,3,4,0.75,2,4,0.5,4,4,1,2,8,10
4511,James Ennis,26-120,F,10/29/16,MEM,@,NYK,L,1,27,5,7,0.714,3,4,0.75,2,3,0.667,4,5,0.8,1,3,4
4512,Tyreke Evans,27-173,G-F,3/11/17,SAC,,DEN,L,0,24,6,15,0.4,4,10,0.4,2,5,0.4,2,4,0.5,0,3,3
4513,Tyreke Evans,27-102,G-F,12/30/16,NOP,,NYK,W,0,18,5,11,0.455,3,6,0.5,2,5,0.4,4,4,1,0,5,5
4514,Derrick Favors,25-117,F-C,11/9/16,UTA,@,CHO,L,1,35,8,12,0.667,8,11,0.727,0,1,0,0,0,,2,8,10
4515,Derrick Favors,25-115,F-C,11/7/16,UTA,@,PHI,W,1,29,6,11,0.545,6,11,0.545,0,0,,4,8,0.5,3,11,14
4516,Raymond Felton,32-190,G,1/2/17,LAC,,PHO,W,1,37,5,13,0.385,5,11,0.455,0,2,0,6,8,0.75,0,4,4
4517,Raymond Felton,32-224,G,2/5/17,LAC,@,BOS,L,0,25,6,10,0.6,3,5,0.6,3,5,0.6,1,2,0.5,1,4,5
4518,Yogi Ferrell,23-302,G,3/7/17,DAL,,LAL,W,1,32,6,9,0.667,4,5,0.8,2,4,0.5,2,2,1,1,1,2
4519,Evan Fournier,24-018,G-F,11/16/16,ORL,,NOP,W,1,34,5,13,0.385,3,8,0.375,2,5,0.4,4,6,0.667,0,1,1
4520,Evan Fournier,24-034,G-F,12/2/16,ORL,@,PHI,W,1,30,4,11,0.364,3,9,0.333,1,2,0.5,7,8,0.875,0,4,4
4521,Randy Foye,33-125,G,1/27/17,BRK,@,CLE,L,1,30,6,12,0.5,2,4,0.5,4,8,0.5,0,0,,0,8,8
4522,Danilo Gallinari,28-084,F,10/31/16,DEN,@,TOR,L,1,37,3,11,0.273,1,6,0.167,2,5,0.4,8,8,1,1,1,2
4523,Danilo Gallinari,28-116,F,12/2/16,DEN,,HOU,L,1,35,6,11,0.545,4,8,0.5,2,3,0.667,2,2,1,2,3,5
4524,Danilo Gallinari,28-090,F,11/6/16,DEN,@,BOS,W,1,41,7,13,0.538,5,9,0.556,2,4,0.5,0,0,,1,2,3
4525,Danilo Gallinari,28-089,F,11/5/16,DEN,@,DET,L,1,29,5,14,0.357,3,7,0.429,2,7,0.286,4,5,0.8,1,2,3
4526,Marc Gasol,31-329,C,12/23/16,MEM,,HOU,W,1,34,5,14,0.357,5,13,0.385,0,1,0,6,6,1,1,4,5
4527,Marc Gasol,32-048,C,3/18/17,MEM,,SAS,W,1,39,6,14,0.429,5,11,0.455,1,3,0.333,3,3,1,0,5,5
4528,Pau Gasol,36-175,F-C,12/28/16,SAS,,PHO,W,1,29,6,12,0.5,6,10,0.6,0,2,0,4,5,0.8,2,8,10
4529,Pau Gasol,36-138,F-C,11/21/16,SAS,,DAL,W,1,28,7,13,0.538,6,12,0.5,1,1,1,1,2,0.5,0,8,8
4530,Pau Gasol,36-135,F-C,11/18/16,SAS,@,LAL,W,1,28,6,13,0.462,6,13,0.462,0,0,,4,4,1,0,5,5
4531,Rudy Gay,30-078,F,11/3/16,SAC,@,ORL,L,1,32,6,13,0.462,4,10,0.4,2,3,0.667,2,5,0.4,0,2,2
4532,Paul George,26-232,F,12/20/16,IND,@,NYK,L,1,36,6,16,0.375,6,13,0.462,0,3,0,4,4,1,1,4,5
4533,Paul George,26-216,F,12/4/16,IND,@,LAC,W,1,34,6,13,0.462,3,7,0.429,3,6,0.5,1,1,1,0,7,7
4534,Taj Gibson,31-136,F,11/7/16,CHI,,ORL,W,1,28,7,13,0.538,7,13,0.538,0,0,,2,2,1,2,9,11
4535,Taj Gibson,31-178,F,12/19/16,CHI,,DET,W,1,19,8,8,1,8,8,1,0,0,,0,0,,0,4,4
4536,Manu Ginobili,39-170,G,1/14/17,SAS,@,PHO,L,0,25,3,7,0.429,1,3,0.333,2,4,0.5,8,8,1,0,2,2
4537,Rudy Gobert,24-252,C,3/5/17,UTA,@,SAC,W,1,41,8,11,0.727,8,11,0.727,0,0,,0,2,0,5,18,23
4538,Rudy Gobert,24-267,C,3/20/17,UTA,@,IND,L,1,37,7,12,0.583,7,12,0.583,0,0,,2,6,0.333,5,9,14
4539,Rudy Gobert,24-144,C,11/17/16,UTA,,CHI,L,1,41,7,9,0.778,7,9,0.778,0,0,,2,2,1,5,8,13
4540,Rudy Gobert,24-156,C,11/29/16,UTA,,HOU,W,1,33,5,7,0.714,5,7,0.714,0,0,,6,8,0.75,4,10,14
4541,Rudy Gobert,24-173,C,12/16/16,UTA,,DAL,W,1,35,4,7,0.571,4,7,0.571,0,0,,8,10,0.8,3,7,10
4542,Rudy Gobert,24-155,C,11/28/16,UTA,@,MIN,W,1,34,5,10,0.5,5,10,0.5,0,0,,6,8,0.75,8,9,17
4543,Aaron Gordon,21-141,F,2/4/17,ORL,@,ATL,L,1,26,5,10,0.5,4,8,0.5,1,2,0.5,5,6,0.833,1,2,3
4544,Aaron Gordon,21-176,F,3/11/17,ORL,,CLE,L,1,31,6,12,0.5,6,11,0.545,0,1,0,4,4,1,2,3,5
4545,Eric Gordon,27-312,G,11/1/16,HOU,@,CLE,L,1,33,6,13,0.462,2,4,0.5,4,9,0.444,0,0,,0,2,2
4546,Eric Gordon,27-328,G,11/17/16,HOU,,POR,W,0,24,6,15,0.4,4,8,0.5,2,7,0.286,2,3,0.667,3,2,5
4547,Eric Gordon,27-325,G,11/14/16,HOU,,PHI,W,1,27,6,12,0.5,2,5,0.4,4,7,0.571,0,0,,0,1,1
4548,Marcin Gortat,32-301,C-F,12/14/16,WAS,,CHO,W,1,36,8,11,0.727,8,11,0.727,0,0,,0,0,,5,7,12
4549,Marcin Gortat,32-342,C-F,1/24/17,WAS,,BOS,W,1,33,7,8,0.875,7,8,0.875,0,0,,2,2,1,2,6,8
4550,Marcin Gortat,32-355,C-F,2/6/17,WAS,,CLE,L,1,38,6,13,0.462,6,13,0.462,0,0,,4,4,1,5,3,8
4551,Marcin Gortat,32-274,C-F,11/17/16,WAS,,NYK,W,1,31,7,12,0.583,7,12,0.583,0,0,,2,4,0.5,2,6,8
4552,Danny Green,29-154,G-F,11/23/16,SAS,@,CHO,W,1,30,6,12,0.5,2,5,0.4,4,7,0.571,0,0,,1,2,3
4553,Draymond Green,26-337,F,2/4/17,GSW,@,SAC,L,1,43,6,15,0.4,3,7,0.429,3,8,0.375,1,4,0.25,1,7,8
4554,Draymond Green,26-250,F,11/9/16,GSW,,DAL,W,1,35,6,11,0.545,2,5,0.4,4,6,0.667,0,1,0,1,9,10
4555,Draymond Green,26-296,F,12/25/16,GSW,@,CLE,L,1,32,7,9,0.778,7,7,1,0,2,0,2,2,1,0,4,4
4556,Draymond Green,26-245,F,11/4/16,GSW,@,LAL,L,1,34,6,10,0.6,6,7,0.857,0,3,0,4,6,0.667,2,7,9
4557,Gerald Green,31-016,G-F,2/11/17,BOS,@,UTA,W,0,23,7,8,0.875,5,5,1,2,3,0.667,0,0,,0,0,0
4558,JaMychal Green,26-165,F,12/3/16,MEM,,LAL,W,1,34,7,13,0.538,7,10,0.7,0,3,0,2,2,1,7,6,13
4559,JaMychal Green,26-162,F,11/30/16,MEM,@,TOR,L,1,34,5,11,0.455,5,9,0.556,0,2,0,6,7,0.857,3,2,5
4560,Jeff Green,30-154,F,1/29/17,ORL,@,TOR,W,0,27,6,8,0.75,4,5,0.8,2,3,0.667,2,4,0.5,1,2,3
4561,Jeff Green,30-096,F,12/2/16,ORL,@,PHI,W,0,23,6,13,0.462,4,9,0.444,2,4,0.5,2,2,1,1,5,6
4562,Jeff Green,30-107,F,12/13/16,ORL,@,ATL,W,0,31,6,14,0.429,5,10,0.5,1,4,0.25,3,3,1,1,3,4
4563,Blake Griffin,27-353,F,3/4/17,LAC,@,CHI,W,1,34,5,15,0.333,5,12,0.417,0,3,0,6,6,1,1,5,6
4564,Blake Griffin,27-256,F,11/27/16,LAC,@,IND,L,1,34,6,15,0.4,6,14,0.429,0,1,0,4,4,1,3,6,9
4565,Blake Griffin,27-357,F,3/8/17,LAC,@,MIN,L,1,36,5,11,0.455,3,7,0.429,2,4,0.5,4,4,1,0,4,4
4566,Justin Hamilton,26-282,C,1/8/17,BRK,,PHI,L,0,23,6,11,0.545,4,7,0.571,2,4,0.5,2,3,0.667,1,4,5
4567,Justin Hamilton,26-279,C,1/5/17,BRK,@,IND,L,0,22,6,9,0.667,2,4,0.5,4,5,0.8,0,0,,2,6,8
4568,Tim Hardaway,24-357,G,3/8/17,ATL,,BRK,W,0,29,5,11,0.455,4,9,0.444,1,2,0.5,5,5,1,1,5,6
4569,James Harden,27-119,G,12/23/16,HOU,@,MEM,L,1,36,6,13,0.462,4,7,0.571,2,6,0.333,2,3,0.667,1,6,7
4570,Montrezl Harrell,22-332,F-C,12/23/16,HOU,@,MEM,L,1,28,7,11,0.636,7,11,0.636,0,0,,2,2,1,2,6,8
4571,Montrezl Harrell,22-355,F-C,1/15/17,HOU,@,BRK,W,1,34,6,9,0.667,6,9,0.667,0,0,,4,6,0.667,2,6,8
4572,Gary Harris,22-120,G,1/12/17,DEN,,IND,W,1,34,6,11,0.545,5,10,0.5,1,1,1,3,3,1,0,5,5
4573,Gary Harris,22-094,G,12/17/16,DEN,,NYK,W,1,30,6,9,0.667,6,8,0.75,0,1,0,4,6,0.667,0,3,3
4574,Gary Harris,22-152,G,2/13/17,DEN,,GSW,W,1,32,6,12,0.5,2,5,0.4,4,7,0.571,0,2,0,1,1,2
4575,Gary Harris,22-150,G,2/11/17,DEN,@,CLE,L,1,29,6,11,0.545,3,6,0.5,3,5,0.6,1,2,0.5,0,3,3
4576,Gary Harris,22-149,G,2/10/17,DEN,@,NYK,W,1,34,6,10,0.6,3,4,0.75,3,6,0.5,1,1,1,2,5,7
4577,Joe Harris,25-049,G,10/26/16,BRK,@,BOS,L,0,25,6,15,0.4,2,6,0.333,4,9,0.444,0,0,,0,4,4
4578,Joe Harris,25-091,G,12/7/16,BRK,,DEN,W,0,24,6,8,0.75,4,5,0.8,2,3,0.667,2,2,1,1,1,2
4579,Tobias Harris,24-107,F,10/30/16,DET,,MIL,W,1,31,7,12,0.583,5,9,0.556,2,3,0.667,0,0,,1,4,5
4580,Tobias Harris,24-197,F,1/28/17,DET,@,MIA,L,0,28,7,11,0.636,7,11,0.636,0,0,,2,2,1,0,2,2
4581,Tobias Harris,24-210,F,2/10/17,DET,,SAS,L,0,33,7,12,0.583,7,11,0.636,0,1,0,2,2,1,0,5,5
4582,Spencer Hawes,28-310,C-F,3/4/17,MIL,,TOR,W,0,17,6,7,0.857,4,4,1,2,3,0.667,2,3,0.667,1,7,8
4583,Spencer Hawes,28-257,C-F,1/10/17,CHO,@,HOU,L,0,25,7,10,0.7,5,6,0.833,2,4,0.5,0,0,,0,5,5
4584,Gordon Hayward,26-290,F-G,1/7/17,UTA,@,MIN,W,1,32,4,13,0.308,3,9,0.333,1,4,0.25,7,7,1,0,2,2
4585,Gordon Hayward,26-288,F-G,1/5/17,UTA,@,TOR,L,1,34,6,12,0.5,4,8,0.5,2,4,0.5,2,2,1,2,2,4
4586,Gerald Henderson,29-005,G,12/14/16,PHI,,TOR,L,1,25,6,7,0.857,4,4,1,2,3,0.667,2,2,1,0,0,0
4587,Gerald Henderson,29-080,G,2/27/17,PHI,,GSW,L,1,25,4,11,0.364,1,7,0.143,3,4,0.75,5,5,1,1,2,3
4588,John Henson,26-037,C-F,2/3/17,MIL,@,DEN,L,1,31,7,12,0.583,7,12,0.583,0,0,,2,2,1,0,5,5
4589,Willy Hernangomez,22-253,C,2/4/17,NYK,,CLE,L,0,36,7,10,0.7,7,9,0.778,0,1,0,2,6,0.333,3,2,5
4590,Willy Hernangomez,22-250,C,2/1/17,NYK,@,BRK,W,0,25,7,12,0.583,7,12,0.583,0,0,,2,4,0.5,7,9,16
4591,Roy Hibbert,30-038,C,1/18/17,CHO,,POR,W,0,22,7,8,0.875,7,8,0.875,0,0,,2,2,1,2,4,6
4592,Buddy Hield,23-074,G,3/1/17,SAC,,BRK,L,0,26,6,11,0.545,2,5,0.4,4,6,0.667,0,0,,1,0,1
4593,Buddy Hield,22-353,G,12/4/16,NOP,@,OKC,L,0,15,6,12,0.5,2,5,0.4,4,7,0.571,0,0,,1,3,4
4594,Buddy Hield,23-068,G,2/23/17,SAC,,DEN,W,0,26,6,10,0.6,5,7,0.714,1,3,0.333,3,3,1,0,6,6
4595,Nene Hilario,34-169,F-C,3/1/17,HOU,@,LAC,W,0,22,6,7,0.857,6,7,0.857,0,0,,4,5,0.8,4,5,9
4596,Nene Hilario,34-067,F-C,11/19/16,HOU,,UTA,W,0,17,6,9,0.667,5,8,0.625,1,1,1,3,3,1,1,5,6
4597,George Hill,30-320,G,3/20/17,UTA,@,IND,L,1,38,7,17,0.412,7,10,0.7,0,7,0,2,2,1,2,4,6
4598,George Hill,30-269,G,1/28/17,UTA,,MEM,L,1,33,7,13,0.538,6,8,0.75,1,5,0.2,1,1,1,0,3,3
4599,Solomon Hill,25-315,F,1/27/17,NOP,,SAS,W,1,34,5,10,0.5,0,3,0,5,7,0.714,1,2,0.5,3,3,6
4600,Solomon Hill,25-358,F,3/11/17,NOP,@,CHO,W,1,43,7,11,0.636,5,6,0.833,2,5,0.4,0,0,,1,2,3
4601,Jrue Holiday,26-166,G,11/25/16,NOP,@,POR,L,0,29,6,13,0.462,4,9,0.444,2,4,0.5,2,4,0.5,0,4,4
4602,Jrue Holiday,26-186,G,12/15/16,NOP,,IND,W,1,36,7,12,0.583,7,11,0.636,0,1,0,2,3,0.667,2,5,7
4603,Jrue Holiday,26-245,G,2/12/17,NOP,@,SAC,L,1,40,6,14,0.429,5,10,0.5,1,4,0.25,3,3,1,2,4,6
4604,Justin Holiday,27-223,G,11/14/16,NYK,,DAL,W,0,25,6,7,0.857,4,4,1,2,3,0.667,2,2,1,0,4,4
4605,Rondae Hollis-Jefferson,22-053,F,2/25/17,BRK,@,GSW,L,1,21,6,13,0.462,6,11,0.545,0,2,0,4,4,1,4,6,10
4606,Rondae Hollis-Jefferson,21-362,F,12/30/16,BRK,@,WAS,L,0,29,6,13,0.462,6,13,0.462,0,0,,4,6,0.667,1,4,5
4607,Rondae Hollis-Jefferson,22-029,F,2/1/17,BRK,,NYK,L,1,30,6,11,0.545,6,10,0.6,0,1,0,4,4,1,3,5,8
4608,Rodney Hood,24-034,G-F,11/23/16,UTA,,DEN,W,1,29,7,15,0.467,5,8,0.625,2,7,0.286,0,0,,0,6,6
4609,Rodney Hood,24-046,G-F,12/5/16,UTA,@,LAL,W,1,31,5,17,0.294,3,9,0.333,2,8,0.25,4,4,1,1,4,5
4610,Al Horford,30-222,C-F,1/11/17,BOS,,WAS,W,1,33,7,12,0.583,5,6,0.833,2,6,0.333,0,0,,1,8,9
4611,Al Horford,30-253,C-F,2/11/17,BOS,@,UTA,W,1,34,6,9,0.667,4,5,0.8,2,4,0.5,2,3,0.667,0,9,9
4612,Al Horford,30-290,C-F,3/20/17,BOS,,WAS,W,1,36,6,11,0.545,6,10,0.6,0,1,0,4,7,0.571,2,7,9
4613,Dwight Howard,31-092,C,3/10/17,ATL,,TOR,W,1,34,6,9,0.667,6,9,0.667,0,0,,4,10,0.4,3,7,10
4614,Dwight Howard,31-020,C,12/28/16,ATL,,NYK,W,1,39,6,9,0.667,6,9,0.667,0,0,,4,6,0.667,7,15,22
4615,Dwight Howard,31-038,C,1/15/17,ATL,,MIL,W,1,32,6,8,0.75,6,8,0.75,0,0,,4,6,0.667,7,7,14
4616,Dwight Howard,31-048,C,1/25/17,ATL,@,CHI,W,1,34,6,10,0.6,6,10,0.6,0,0,,4,5,0.8,2,10,12
4617,Dwight Howard,31-046,C,1/23/17,ATL,,LAC,L,1,35,6,7,0.857,6,7,0.857,0,0,,4,5,0.8,1,11,12
4618,Serge Ibaka,27-099,F-C,12/26/16,ORL,,MEM,W,1,24,6,11,0.545,4,5,0.8,2,6,0.333,2,2,1,1,5,6
4619,Serge Ibaka,27-184,F-C,3/21/17,TOR,,CHI,W,1,26,7,13,0.538,5,10,0.5,2,3,0.667,0,0,,2,4,6
4620,Serge Ibaka,27-110,F-C,1/6/17,ORL,,HOU,L,1,33,8,17,0.471,8,16,0.5,0,1,0,0,2,0,5,7,12
4621,Serge Ibaka,27-128,F-C,1/24/17,ORL,,CHI,L,1,35,6,13,0.462,3,8,0.375,3,5,0.6,1,1,1,1,7,8
4622,Serge Ibaka,27-144,F-C,2/9/17,ORL,,PHI,L,1,35,6,14,0.429,4,10,0.4,2,4,0.5,2,2,1,2,1,3
4623,Serge Ibaka,27-182,F-C,3/19/17,TOR,,IND,W,1,24,7,11,0.636,5,8,0.625,2,3,0.667,0,0,,0,5,5
4624,Serge Ibaka,27-059,F-C,11/16/16,ORL,,NOP,W,1,30,7,13,0.538,5,9,0.556,2,4,0.5,0,0,,2,6,8
4625,Serge Ibaka,27-075,F-C,12/2/16,ORL,@,PHI,W,1,25,6,12,0.5,5,7,0.714,1,5,0.2,3,4,0.75,1,3,4
4626,Ersan Ilyasova,29-228,F,12/29/16,PHI,@,UTA,L,1,24,7,13,0.538,5,9,0.556,2,4,0.5,0,0,,4,8,12
4627,Ersan Ilyasova,29-241,F,1/11/17,PHI,,NYK,W,1,30,5,16,0.313,4,8,0.5,1,8,0.125,5,6,0.833,2,2,4
4628,Ersan Ilyasova,29-185,F,11/16/16,PHI,,WAS,W,1,26,5,10,0.5,1,2,0.5,4,8,0.5,2,2,1,1,3,4
4629,Joe Ingles,29-130,F-G,2/9/17,UTA,@,DAL,L,1,41,6,12,0.5,2,5,0.4,4,7,0.571,0,0,,1,4,5
4630,Brandon Ingram,19-082,F,11/23/16,LAL,@,GSW,L,1,34,6,12,0.5,4,8,0.5,2,4,0.5,2,2,1,0,3,3
4631,Brandon Ingram,19-184,F,3/5/17,LAL,,NOP,L,1,39,7,13,0.538,5,10,0.5,2,3,0.667,0,2,0,0,6,6
4632,Reggie Jackson,26-274,G,1/15/17,DET,@,LAL,W,1,28,6,16,0.375,5,14,0.357,1,2,0.5,3,3,1,2,1,3
4633,Reggie Jackson,26-237,G,12/9/16,DET,@,MIN,W,1,29,5,15,0.333,3,12,0.25,2,3,0.667,4,4,1,0,1,1
4634,LeBron James,31-337,F-G,12/1/16,CLE,,LAC,L,1,34,5,14,0.357,5,12,0.417,0,2,0,6,11,0.545,1,4,5
4635,LeBron James,32-074,F-G,3/14/17,CLE,,DET,W,1,28,6,12,0.5,6,10,0.6,0,2,0,4,5,0.8,0,11,11
4636,LeBron James,32-014,F-G,1/13/17,CLE,@,SAC,W,1,42,6,12,0.5,5,8,0.625,1,4,0.25,3,3,1,0,2,2
4637,Al Jefferson,31-326,C-F,11/25/16,IND,,BRK,W,0,19,8,14,0.571,8,14,0.571,0,0,,0,0,,1,2,3
4638,Al Jefferson,31-328,C-F,11/27/16,IND,,LAC,W,0,21,8,17,0.471,8,17,0.471,0,0,,0,0,,3,5,8
4639,Richard Jefferson,36-266,F,3/14/17,CLE,,DET,W,1,26,5,9,0.556,1,2,0.5,4,7,0.571,2,3,0.667,0,2,2
4640,Richard Jefferson,36-264,F,3/12/17,CLE,@,HOU,L,1,31,6,6,1,2,2,1,4,4,1,0,0,,0,3,3
4641,Brandon Jennings,27-075,G,12/7/16,NYK,,CLE,L,1,31,6,14,0.429,5,11,0.455,1,3,0.333,3,3,1,0,4,4
4642,Brandon Jennings,27-136,G,2/6/17,NYK,,LAL,L,0,28,5,9,0.556,4,6,0.667,1,3,0.333,5,7,0.714,0,3,3
4643,James Johnson,29-347,F,2/1/17,MIA,,ATL,W,0,23,7,13,0.538,5,7,0.714,2,6,0.333,0,1,0,0,2,2
4644,James Johnson,29-311,F,12/27/16,MIA,,OKC,L,0,25,6,13,0.462,5,8,0.625,1,5,0.2,3,6,0.5,2,3,5
4645,Joe Johnson,35-252,G-F,3/8/17,UTA,@,HOU,W,1,32,5,10,0.5,3,5,0.6,2,5,0.4,4,4,1,0,2,2
4646,Tyler Johnson,24-273,G,2/4/17,MIA,,PHI,W,0,34,5,9,0.556,5,9,0.556,0,0,,6,8,0.75,0,6,6
4647,Tyler Johnson,24-284,G,2/15/17,MIA,@,HOU,W,0,33,6,11,0.545,4,5,0.8,2,6,0.333,2,3,0.667,4,3,7
4648,Tyler Johnson,24-308,G,3/11/17,MIA,,TOR,W,0,27,6,12,0.5,6,11,0.545,0,1,0,4,4,1,0,3,3
4649,Tyler Johnson,24-255,G,1/17/17,MIA,,HOU,W,0,34,6,17,0.353,5,13,0.385,1,4,0.25,3,5,0.6,1,1,2
4650,Tyler Johnson,24-181,G,11/4/16,MIA,@,TOR,L,0,30,5,10,0.5,1,2,0.5,4,8,0.5,2,2,1,0,4,4
4651,Nikola Jokic,21-313,C-F,12/28/16,DEN,,MIN,W,1,34,6,12,0.5,6,10,0.6,0,2,0,4,5,0.8,2,6,8
4652,Nikola Jokic,22-027,C-F,3/18/17,DEN,,HOU,L,1,22,7,14,0.5,6,12,0.5,1,2,0.5,1,1,1,2,3,5
4653,Terrence Jones,24-342,F,12/16/16,NOP,@,HOU,L,0,29,7,14,0.5,7,12,0.583,0,2,0,2,6,0.333,3,5,8
4654,DeAndre Jordan,28-120,C,11/18/16,LAC,@,SAC,W,1,37,8,10,0.8,8,10,0.8,0,0,,0,0,,1,11,12
4655,DeAndre Jordan,28-111,C,11/9/16,LAC,,POR,W,1,24,6,9,0.667,6,9,0.667,0,0,,4,8,0.5,3,6,9
4656,DeAndre Jordan,28-125,C,11/23/16,LAC,@,DAL,W,1,26,5,8,0.625,5,8,0.625,0,0,,6,9,0.667,0,8,8
4657,Cory Joseph,25-146,G,1/13/17,TOR,,BRK,W,0,22,7,7,1,6,6,1,1,1,1,1,1,1,1,3,4
4658,Cory Joseph,25-102,G,11/30/16,TOR,,MEM,W,0,28,4,8,0.5,3,5,0.6,1,3,0.333,7,8,0.875,2,6,8
4659,Frank Kaminsky,23-328,F-C,2/26/17,CHO,@,LAC,L,1,28,5,13,0.385,4,8,0.5,1,5,0.2,5,5,1,0,5,5
4660,Frank Kaminsky,23-291,F-C,1/20/17,CHO,,TOR,W,0,27,5,10,0.5,3,5,0.6,2,5,0.4,4,4,1,2,6,8
4661,Frank Kaminsky,23-332,F-C,3/2/17,CHO,@,PHO,L,1,32,7,14,0.5,5,8,0.625,2,6,0.333,0,0,,0,1,1
4662,Enes Kanter,24-177,C,11/13/16,OKC,,ORL,L,0,24,7,13,0.538,7,11,0.636,0,2,0,2,2,1,4,4,8
4663,Enes Kanter,24-295,C,3/11/17,OKC,,UTA,W,0,18,8,12,0.667,8,12,0.667,0,0,,0,0,,2,4,6
4664,Enes Kanter,24-184,C,11/20/16,OKC,,IND,L,0,25,5,9,0.556,4,7,0.571,1,2,0.5,5,6,0.833,0,4,4
4665,Enes Kanter,24-289,C,3/5/17,OKC,@,DAL,L,0,19,7,14,0.5,7,13,0.538,0,1,0,2,5,0.4,6,4,10
4666,Enes Kanter,24-163,C,10/30/16,OKC,,LAL,W,0,22,8,11,0.727,8,10,0.8,0,1,0,0,0,,1,5,6
4667,Michael Kidd-Gilchrist,23-074,F,12/9/16,CHO,,ORL,W,1,21,6,9,0.667,6,9,0.667,0,0,,4,4,1,3,4,7
4668,Sean Kilpatrick,26-324,G,11/25/16,BRK,@,IND,L,1,27,5,10,0.5,3,5,0.6,2,5,0.4,4,6,0.667,0,2,2
4669,Brandon Knight,25-068,G,2/8/17,PHO,@,MEM,L,0,26,5,11,0.455,3,7,0.429,2,4,0.5,4,4,1,1,1,2
4670,Brandon Knight,24-336,G,11/2/16,PHO,,POR,W,0,32,6,17,0.353,5,13,0.385,1,4,0.25,3,3,1,1,3,4
4671,Kosta Koufos,27-296,C,12/16/16,SAC,@,MEM,W,1,30,7,11,0.636,7,11,0.636,0,0,,2,6,0.333,7,6,13
4672,Jeremy Lamb,24-151,G-F,10/28/16,CHO,@,MIA,W,0,22,7,12,0.583,7,10,0.7,0,2,0,2,2,1,2,6,8
4673,Jeremy Lamb,24-253,G-F,2/7/17,CHO,,BRK,W,0,19,6,11,0.545,5,9,0.556,1,2,0.5,3,3,1,1,5,6
4674,Joffrey Lauvergne,25-126,C-F,2/3/17,OKC,,MEM,W,0,29,6,7,0.857,3,3,1,3,4,0.75,1,2,0.5,1,7,8
4675,Zach LaVine,21-290,G,12/25/16,MIN,@,OKC,L,1,31,5,11,0.455,2,6,0.333,3,5,0.6,3,3,1,0,1,1
4676,Ty Lawson,29-085,G,1/27/17,SAC,@,IND,L,0,23,3,7,0.429,1,4,0.25,2,3,0.667,8,8,1,1,1,2
4677,Ty Lawson,29-047,G,12/20/16,SAC,,POR,W,0,29,6,8,0.75,6,7,0.857,0,1,0,4,4,1,0,3,3
4678,Courtney Lee,31-147,G,2/27/17,NYK,,TOR,L,1,41,6,10,0.6,3,6,0.5,3,4,0.75,1,2,0.5,0,3,3
4679,Courtney Lee,31-069,G,12/11/16,NYK,@,LAL,W,1,35,4,6,0.667,1,2,0.5,3,4,0.75,5,5,1,0,0,0
4680,Courtney Lee,31-135,G,2/15/17,NYK,@,OKC,L,1,39,7,13,0.538,5,8,0.625,2,5,0.4,0,0,,0,4,4
4681,Courtney Lee,31-030,G,11/2/16,NYK,,HOU,L,1,28,7,12,0.583,5,8,0.625,2,4,0.5,0,0,,0,0,0
4682,Courtney Lee,31-116,G,1/27/17,NYK,,CHO,W,1,35,7,12,0.583,5,7,0.714,2,5,0.4,0,0,,0,3,3
4683,Courtney Lee,31-026,G,10/29/16,NYK,,MEM,W,1,34,6,11,0.545,4,7,0.571,2,4,0.5,2,2,1,0,3,3
4684,Courtney Lee,31-151,G,3/3/17,NYK,@,PHI,L,1,37,6,13,0.462,4,7,0.571,2,6,0.333,2,2,1,1,5,6
4685,Alex Len,23-146,C,11/9/16,PHO,,DET,W,1,37,7,10,0.7,7,10,0.7,0,0,,2,6,0.333,1,13,14
4686,Meyers Leonard,24-305,C-F,12/28/16,POR,,SAC,W,0,25,5,13,0.385,2,7,0.286,3,6,0.5,3,3,1,0,5,5
4687,Meyers Leonard,24-300,C-F,12/23/16,POR,,SAS,L,0,28,6,11,0.545,2,4,0.5,4,7,0.571,0,0,,1,4,5
4688,Jon Leuer,27-202,F,12/2/16,DET,@,ATL,W,0,31,5,6,0.833,1,1,1,4,5,0.8,2,3,0.667,3,6,9
4689,Jon Leuer,27-219,F,12/19/16,DET,@,CHI,L,0,21,7,9,0.778,7,8,0.875,0,1,0,2,2,1,2,3,5
4690,Caris LeVert,22-201,G-F,3/14/17,BRK,,OKC,L,1,23,4,6,0.667,3,4,0.75,1,2,0.5,7,8,0.875,1,6,7
4691,Damian Lillard,26-161,G,12/23/16,POR,,SAS,L,1,37,7,19,0.368,6,14,0.429,1,5,0.2,1,2,0.5,0,5,5
4692,Jeremy Lin,28-197,G,3/8/17,BRK,@,ATL,L,1,25,6,13,0.462,3,7,0.429,3,6,0.5,1,2,0.5,0,3,3
4693,Jeremy Lin,28-117,G,12/18/16,BRK,@,PHI,L,0,22,5,10,0.5,3,3,1,2,7,0.286,4,5,0.8,0,2,2
4694,Brook Lopez,28-266,C,12/23/16,BRK,@,CLE,L,1,22,7,11,0.636,5,8,0.625,2,3,0.667,0,0,,1,2,3
4695,Robin Lopez,28-223,C,11/10/16,CHI,@,MIA,W,1,38,8,20,0.4,8,20,0.4,0,0,,0,0,,7,2,9
4696,Kevin Love,28-085,F,12/1/16,CLE,,LAC,L,1,25,7,11,0.636,5,6,0.833,2,5,0.4,0,0,,0,4,4
4697,Kevin Love,28-157,F,2/11/17,CLE,,DEN,W,1,34,5,11,0.455,2,6,0.333,3,5,0.6,3,4,0.75,3,6,9
4698,Kyle Lowry,30-268,G,12/18/16,TOR,@,ORL,W,1,35,3,9,0.333,1,2,0.5,2,7,0.286,8,8,1,0,3,3
4699,Kyle Lowry,30-232,G,11/12/16,TOR,,NYK,W,1,41,7,15,0.467,7,10,0.7,0,5,0,2,2,1,3,3,6
4700,Kyle Lowry,30-296,G,1/15/17,TOR,,NYK,W,1,28,6,10,0.6,4,5,0.8,2,5,0.4,2,3,0.667,0,4,4
4701,Ian Mahinmi,30-132,C,3/17/17,WAS,,CHI,W,0,20,8,11,0.727,8,11,0.727,0,0,,0,0,,2,1,3
4702,Wesley Matthews,30-070,G,12/23/16,DAL,@,LAC,W,1,40,6,16,0.375,5,8,0.625,1,8,0.125,3,6,0.5,0,6,6
4703,Wesley Matthews,30-068,G,12/21/16,DAL,@,POR,W,1,41,6,16,0.375,5,9,0.556,1,7,0.143,3,5,0.6,0,4,4
4704,Wesley Matthews,30-054,G,12/7/16,DAL,,SAC,L,1,33,6,10,0.6,2,4,0.5,4,6,0.667,0,0,,0,4,4
4705,Wesley Matthews,30-052,G,12/5/16,DAL,,CHO,L,1,35,5,13,0.385,1,4,0.25,4,9,0.444,2,2,1,0,5,5
4706,C.J. McCollum,25-095,G,12/23/16,POR,,SAS,L,1,30,5,16,0.313,2,8,0.25,3,8,0.375,3,4,0.75,3,3,6
4707,C.J. McCollum,25-064,G,11/22/16,POR,@,NYK,L,1,36,6,17,0.353,5,14,0.357,1,3,0.333,3,3,1,1,4,5
4708,C.J. McCollum,25-123,G,1/20/17,POR,@,PHI,L,1,35,5,18,0.278,3,10,0.3,2,8,0.25,4,4,1,0,4,4
4709,C.J. McCollum,25-043,G,11/1/16,POR,,GSW,L,1,26,6,12,0.5,4,7,0.571,2,5,0.4,2,2,1,1,3,4
4710,C.J. McCollum,25-038,G,10/27/16,POR,,LAC,L,1,38,5,12,0.417,4,11,0.364,1,1,1,5,6,0.833,0,4,4
4711,T.J. McConnell,24-360,G,3/20/17,PHI,@,ORL,L,1,34,6,15,0.4,6,13,0.462,0,2,0,4,4,1,0,1,1
4712,Doug McDermott,25-040,F,2/12/17,CHI,@,MIN,L,1,29,6,15,0.4,2,8,0.25,4,7,0.571,0,0,,0,1,1
4713,Doug McDermott,25-056,F,2/28/17,OKC,,UTA,W,0,25,6,11,0.545,2,5,0.4,4,6,0.667,0,0,,0,5,5
4714,JaVale McGee,29-023,C,2/11/17,GSW,@,OKC,W,1,20,7,8,0.875,7,8,0.875,0,0,,2,5,0.4,3,0,3
4715,Salah Mejri,30-231,C,2/1/17,DAL,,PHI,W,0,21,7,9,0.778,7,9,0.778,0,0,,2,4,0.5,8,9,17
4716,Khris Middleton,25-215,F-G,3/15/17,MIL,@,LAC,W,1,32,4,8,0.5,3,6,0.5,1,2,0.5,7,7,1,0,7,7
4717,C.J. Miles,29-210,G-F,11/14/16,IND,,ORL,W,0,23,5,12,0.417,1,4,0.25,4,8,0.5,2,2,1,0,4,4
4718,C.J. Miles,29-289,G-F,2/1/17,IND,@,ORL,W,1,21,6,7,0.857,2,2,1,4,5,0.8,0,0,,0,4,4
4719,C.J. Miles,29-322,G-F,3/6/17,IND,@,CHO,L,1,33,6,11,0.545,2,4,0.5,4,7,0.571,0,0,,1,3,4
4720,C.J. Miles,29-197,G-F,11/1/16,IND,,LAL,W,0,23,6,9,0.667,4,6,0.667,2,3,0.667,2,2,1,1,1,2
4721,Patty Mills,28-121,G,12/10/16,SAS,,BRK,W,0,16,6,11,0.545,2,4,0.5,4,7,0.571,0,0,,0,0,0
4722,Patty Mills,28-119,G,12/8/16,SAS,@,CHI,L,0,24,6,12,0.5,2,6,0.333,4,6,0.667,0,0,,0,2,2
4723,Patty Mills,28-085,G,11/4/16,SAS,@,UTA,W,1,30,6,11,0.545,2,4,0.5,4,7,0.571,0,0,,0,3,3
4724,Paul Millsap,31-273,F,11/9/16,ATL,,CHI,W,1,34,5,13,0.385,3,10,0.3,2,3,0.667,4,4,1,0,11,11
4725,Paul Millsap,32-031,F,3/13/17,ATL,@,SAS,L,1,40,6,13,0.462,6,11,0.545,0,2,0,4,6,0.667,1,2,3
4726,Paul Millsap,31-329,F,1/4/17,ATL,@,ORL,W,1,30,6,12,0.5,4,8,0.5,2,4,0.5,2,5,0.4,0,6,6
4727,Paul Millsap,32-029,F,3/11/17,ATL,@,MEM,W,1,33,5,12,0.417,4,9,0.444,1,3,0.333,5,7,0.714,2,9,11
4728,Paul Millsap,31-358,F,2/2/17,ATL,@,HOU,W,1,29,4,8,0.5,3,4,0.75,1,4,0.25,7,8,0.875,0,4,4
4729,Paul Millsap,31-268,F,11/4/16,ATL,@,WAS,L,1,33,5,14,0.357,4,11,0.364,1,3,0.333,5,10,0.5,1,6,7
4730,Nikola Mirotic,25-263,F,10/31/16,CHI,@,BRK,W,0,25,6,14,0.429,2,4,0.5,4,10,0.4,0,0,,1,9,10
4731,Nikola Mirotic,25-328,F,1/4/17,CHI,@,CLE,W,0,26,6,12,0.5,3,5,0.6,3,7,0.429,1,1,1,0,4,4
4732,Greg Monroe,26-223,C-F,1/13/17,MIL,,MIA,W,0,25,5,13,0.385,5,13,0.385,0,0,,6,6,1,5,6,11
4733,Greg Monroe,26-152,C-F,11/3/16,MIL,,IND,W,0,26,6,11,0.545,6,11,0.545,0,0,,4,5,0.8,6,10,16
4734,Greg Monroe,26-205,C-F,12/26/16,MIL,@,WAS,L,0,22,7,10,0.7,7,10,0.7,0,0,,2,4,0.5,1,4,5
4735,E'Twaun Moore,27-302,G,12/26/16,NOP,,DAL,W,0,23,7,10,0.7,5,7,0.714,2,3,0.667,0,0,,0,1,1
4736,E'Twaun Moore,27-321,G,1/14/17,NOP,@,CHI,L,0,27,6,9,0.667,2,4,0.5,4,5,0.8,0,0,,0,1,1
4737,E'Twaun Moore,27-250,G,11/4/16,NOP,,PHO,L,1,36,5,15,0.333,4,12,0.333,1,3,0.333,5,6,0.833,0,1,1
4738,Marcus Morris,27-177,F,2/26/17,DET,,BOS,L,1,38,5,15,0.333,3,8,0.375,2,7,0.286,4,5,0.8,5,5,10
4739,Marcus Morris,27-174,F,2/23/17,DET,,CHO,W,1,38,6,17,0.353,3,13,0.231,3,4,0.75,1,1,1,1,7,8
4740,Marcus Morris,27-068,F,11/9/16,DET,@,PHO,L,1,40,5,13,0.385,4,9,0.444,1,4,0.25,5,5,1,0,3,3
4741,Marcus Morris,27-198,F,3/19/17,DET,,PHO,W,1,36,6,9,0.667,4,6,0.667,2,3,0.667,2,3,0.667,1,4,5
4742,Markieff Morris,27-094,F,12/5/16,WAS,@,BRK,W,1,33,5,9,0.556,5,8,0.625,0,1,0,6,6,1,1,4,5
4743,Timofey Mozgov,30-129,C,11/22/16,LAL,,OKC,W,1,31,6,10,0.6,6,10,0.6,0,0,,4,4,1,2,1,3
4744,Emmanuel Mudiay,20-240,G,10/31/16,DEN,@,TOR,L,1,33,6,17,0.353,5,13,0.385,1,4,0.25,3,4,0.75,1,5,6
4745,Shabazz Muhammad,24-080,F-G,2/1/17,MIN,@,CLE,L,0,31,7,16,0.438,5,13,0.385,2,3,0.667,0,0,,3,3,6
4746,Shabazz Muhammad,24-072,F-G,1/24/17,MIN,@,PHO,W,0,27,6,9,0.667,4,6,0.667,2,3,0.667,2,3,0.667,0,3,3
4747,Jamal Murray,19-354,G,2/11/17,DEN,@,CLE,L,0,17,5,11,0.455,2,4,0.5,3,7,0.429,3,3,1,0,0,0
4748,Mike Muscala,25-138,F-C,11/16/16,ATL,,MIL,W,1,33,6,11,0.545,5,8,0.625,1,3,0.333,3,4,0.75,1,4,5
4749,Mike Muscala,25-173,F-C,12/21/16,ATL,,MIN,L,0,30,6,9,0.667,3,6,0.5,3,3,1,1,1,1,2,2,4
4750,Jameer Nelson,35-006,G,2/15/17,DEN,,MIN,L,1,35,7,15,0.467,6,10,0.6,1,5,0.2,1,1,1,2,6,8
4751,Jameer Nelson,35-001,G,2/10/17,DEN,@,NYK,W,1,36,6,10,0.6,2,4,0.5,4,6,0.667,0,0,,0,4,4
4752,Jameer Nelson,35-035,G,3/16/17,DEN,,LAC,W,1,34,4,8,0.5,1,4,0.25,3,4,0.75,5,5,1,0,1,1
4753,Joakim Noah,31-253,C,11/4/16,NYK,@,CHI,W,1,35,7,11,0.636,7,10,0.7,0,1,0,2,2,1,3,6,9
4754,Nerlens Noel,22-290,C-F,1/25/17,PHI,@,MIL,W,1,28,5,9,0.556,5,9,0.556,0,0,,6,6,1,3,10,13
4755,Nerlens Noel,22-311,C-F,2/15/17,PHI,@,BOS,L,1,31,7,10,0.7,7,10,0.7,0,0,,2,2,1,3,4,7
4756,Dirk Nowitzki,38-275,F,3/21/17,DAL,,GSW,L,1,28,6,13,0.462,5,9,0.556,1,4,0.25,3,3,1,1,8,9
4757,Jusuf Nurkic,22-204,C,3/15/17,POR,@,SAS,W,1,35,7,18,0.389,7,18,0.389,0,0,,2,5,0.4,3,6,9
4758,Jusuf Nurkic,22-133,C,1/3/17,DEN,,SAC,L,0,18,6,8,0.75,6,8,0.75,0,0,,4,4,1,1,5,6
4759,Jusuf Nurkic,22-089,C,11/20/16,DEN,,UTA,W,1,26,8,12,0.667,8,12,0.667,0,0,,0,6,0,5,6,11
4760,Kyle O'Quinn,26-321,F-C,2/10/17,NYK,,DEN,L,0,22,8,9,0.889,8,8,1,0,1,0,0,0,,2,4,6
4761,Jahlil Okafor,21-084,C-F,3/9/17,PHI,@,POR,L,1,29,7,14,0.5,7,14,0.5,0,0,,2,2,1,3,5,8
4762,Jahlil Okafor,21-053,C-F,2/6/17,PHI,@,DET,L,1,26,7,11,0.636,7,11,0.636,0,0,,2,7,0.286,2,2,4
4763,Jahlil Okafor,20-353,C-F,12/2/16,PHI,,ORL,L,0,28,8,10,0.8,8,10,0.8,0,0,,0,1,0,6,7,13
4764,Jahlil Okafor,21-048,C-F,2/1/17,PHI,@,DAL,L,1,24,7,16,0.438,7,16,0.438,0,0,,2,5,0.4,0,1,1
4765,Victor Oladipo,24-252,G,1/11/17,OKC,,MEM,W,1,32,5,10,0.5,1,3,0.333,4,7,0.571,2,3,0.667,0,3,3
4766,Victor Oladipo,24-307,G,3/7/17,OKC,,POR,L,1,25,5,9,0.556,1,4,0.25,4,5,0.8,2,2,1,0,5,5
4767,Kelly Olynyk,25-283,C-F,1/27/17,BOS,,ORL,W,0,17,7,7,1,5,5,1,2,2,1,0,0,,0,5,5
4768,Kelly Olynyk,25-207,C-F,11/12/16,BOS,@,IND,W,1,28,6,13,0.462,4,7,0.571,2,6,0.333,2,4,0.5,2,4,6
4769,Kelly Olynyk,25-302,C-F,2/15/17,BOS,,PHI,W,0,26,6,8,0.75,4,6,0.667,2,2,1,2,3,0.667,1,6,7
4770,Kelly Olynyk,25-250,C-F,12/25/16,BOS,@,NYK,W,0,23,7,9,0.778,5,6,0.833,2,3,0.667,0,0,,0,2,2
4771,Zaza Pachulia,33-017,C,2/27/17,GSW,@,PHI,W,1,15,5,5,1,5,5,1,0,0,,6,7,0.857,1,4,5
4772,Jabari Parker,21-242,F,11/12/16,MIL,,MEM,W,1,34,5,16,0.313,5,12,0.417,0,4,0,6,8,0.75,1,3,4
4773,Jabari Parker,21-236,F,11/6/16,MIL,@,DAL,L,1,39,8,16,0.5,8,15,0.533,0,1,0,0,0,,1,6,7
4774,Jabari Parker,21-312,F,1/21/17,MIL,@,MIA,L,0,32,7,18,0.389,7,14,0.5,0,4,0,2,3,0.667,2,5,7
4775,Tony Parker,34-179,G,11/12/16,SAS,@,HOU,W,1,27,6,9,0.667,6,9,0.667,0,0,,4,5,0.8,0,1,1
4776,Tony Parker,34-306,G,3/19/17,SAS,,SAC,W,1,20,8,10,0.8,8,10,0.8,0,0,,0,1,0,0,3,3
4777,Tony Parker,34-257,G,1/29/17,SAS,,DAL,L,1,23,8,12,0.667,8,12,0.667,0,0,,0,1,0,0,0,0
4778,Tony Parker,34-185,G,11/18/16,SAS,@,LAL,W,1,27,6,10,0.6,5,9,0.556,1,1,1,3,3,1,1,1,2
4779,Tony Parker,34-211,G,12/14/16,SAS,,BOS,W,1,26,8,15,0.533,8,14,0.571,0,1,0,0,0,,0,2,2
4780,Chris Paul,31-228,G,12/20/16,LAC,,DEN,W,1,26,7,14,0.5,5,9,0.556,2,5,0.4,0,0,,0,8,8
4781,Chris Paul,31-209,G,12/1/16,LAC,@,CLE,W,1,25,5,11,0.455,2,4,0.5,3,7,0.429,3,3,1,2,4,6
4782,Chris Paul,31-222,G,12/14/16,LAC,@,ORL,W,1,32,5,9,0.556,4,7,0.571,1,2,0.5,5,6,0.833,1,2,3
4783,Chris Paul,31-299,G,3/1/17,LAC,,HOU,L,1,36,5,13,0.385,2,6,0.333,3,7,0.429,3,3,1,1,1,2
4784,Elfrid Payton,22-279,G,11/27/16,ORL,,MIL,L,0,29,6,9,0.667,5,6,0.833,1,3,0.333,3,4,0.75,0,3,3
4785,Elfrid Payton,22-308,G,12/26/16,ORL,,MEM,W,0,25,6,10,0.6,5,8,0.625,1,2,0.5,3,5,0.6,0,4,4
4786,Elfrid Payton,22-247,G,10/26/16,ORL,,MIA,L,1,38,4,12,0.333,4,10,0.4,0,2,0,8,8,1,2,2,4
4787,Elfrid Payton,23-012,G,3/6/17,ORL,,NYK,L,1,35,7,13,0.538,7,12,0.583,0,1,0,2,2,1,3,8,11
4788,Mason Plumlee,26-305,C-F,1/4/17,POR,@,GSW,L,1,33,6,12,0.5,6,11,0.545,0,1,0,4,5,0.8,3,7,10
4789,Mason Plumlee,26-270,C-F,11/30/16,POR,,IND,W,1,27,8,14,0.571,8,13,0.615,0,1,0,0,0,,3,6,9
4790,Otto Porter,23-288,F,3/18/17,WAS,@,CHO,L,1,33,4,11,0.364,0,2,0,4,9,0.444,4,4,1,2,1,3
4791,Bobby Portis,21-269,F,11/5/16,CHI,@,IND,L,0,18,7,9,0.778,6,8,0.75,1,1,1,1,3,0.333,2,3,5
4792,Bobby Portis,22-002,F,2/12/17,CHI,@,MIN,L,0,31,6,11,0.545,5,7,0.714,1,4,0.25,3,3,1,2,4,6
4793,Kristaps Porzingis,21-188,F-C,2/6/17,NYK,,LAL,L,1,33,5,14,0.357,4,9,0.444,1,5,0.2,5,7,0.714,1,8,9
4794,Kristaps Porzingis,21-107,F-C,11/17/16,NYK,@,WAS,L,1,37,7,16,0.438,5,11,0.455,2,5,0.4,0,0,,2,5,7
4795,Kristaps Porzingis,21-158,F-C,1/7/17,NYK,@,IND,L,1,34,5,11,0.455,1,5,0.2,4,6,0.667,2,2,1,1,3,4
4796,Kristaps Porzingis,21-084,F-C,10/25/16,NYK,@,CLE,L,1,33,5,13,0.385,2,8,0.25,3,5,0.6,3,6,0.5,4,3,7
4797,Kristaps Porzingis,21-194,F-C,2/12/17,NYK,,SAS,W,1,37,4,10,0.4,1,5,0.2,3,5,0.6,5,5,1,0,7,7
4798,Kristaps Porzingis,21-115,F-C,11/25/16,NYK,,CHO,W,1,34,6,16,0.375,2,8,0.25,4,8,0.5,0,0,,2,6,8
4799,Norman Powell,23-191,G,12/2/16,TOR,,LAL,W,1,32,7,14,0.5,5,8,0.625,2,6,0.333,0,2,0,1,6,7
4800,Norman Powell,23-244,G,1/24/17,TOR,,SAS,L,1,39,8,16,0.5,8,12,0.667,0,4,0,0,0,,0,4,4
4801,Julius Randle,22-018,F,12/17/16,LAL,@,CLE,L,1,28,8,15,0.533,8,15,0.533,0,0,,0,1,0,1,3,4
4802,Julius Randle,22-052,F,1/20/17,LAL,,IND,W,1,35,7,13,0.538,7,13,0.538,0,0,,2,3,0.667,1,4,5
4803,Zach Randolph,35-202,F,2/3/17,MEM,@,OKC,L,0,29,6,14,0.429,6,13,0.462,0,1,0,4,4,1,3,7,10
4804,Zach Randolph,35-164,F,12/27/16,MEM,@,BOS,L,0,29,6,13,0.462,6,12,0.5,0,1,0,4,4,1,5,5,10
4805,Zach Randolph,35-181,F,1/13/17,MEM,@,HOU,W,0,23,7,16,0.438,6,14,0.429,1,2,0.5,1,2,0.5,3,9,12
4806,Zach Randolph,35-214,F,2/15/17,MEM,,NOP,L,0,25,5,11,0.455,5,10,0.5,0,1,0,6,6,1,5,4,9
4807,Zach Randolph,35-160,F,12/23/16,MEM,,HOU,W,0,20,8,11,0.727,8,11,0.727,0,0,,0,0,,1,4,5
4808,Zach Randolph,35-193,F,1/25/17,MEM,,TOR,W,1,38,7,10,0.7,6,8,0.75,1,2,0.5,1,4,0.25,1,7,8
4809,Zach Randolph,35-115,F,11/8/16,MEM,,DEN,W,0,23,8,13,0.615,8,13,0.615,0,0,,0,1,0,4,4,8
4810,J.J. Redick,32-262,G,3/13/17,LAC,@,UTA,L,1,33,5,11,0.455,4,7,0.571,1,4,0.25,5,6,0.833,0,1,1
4811,J.J. Redick,32-169,G,12/10/16,LAC,,NOP,W,1,34,6,14,0.429,4,7,0.571,2,7,0.286,2,2,1,0,1,1
4812,J.J. Redick,32-222,G,2/1/17,LAC,@,PHO,W,1,31,5,13,0.385,3,6,0.5,2,7,0.286,4,4,1,0,2,2
4813,J.J. Redick,32-267,G,3/18/17,LAC,,CLE,W,1,19,6,11,0.545,4,7,0.571,2,4,0.5,2,2,1,0,1,1
4814,J.J. Redick,32-140,G,11/11/16,LAC,@,OKC,W,1,28,6,12,0.5,2,5,0.4,4,7,0.571,0,0,,0,3,3
4815,J.J. Redick,32-264,G,3/15/17,LAC,,MIL,L,1,31,4,9,0.444,2,4,0.5,2,5,0.4,6,9,0.667,0,1,1
4816,Josh Richardson,23-056,G,11/10/16,MIA,,CHI,L,0,28,6,13,0.462,2,6,0.333,4,7,0.571,0,0,,0,1,1
4817,Austin Rivers,24-144,G,12/23/16,LAC,,DAL,L,0,29,6,13,0.462,2,7,0.286,4,6,0.667,0,0,,0,0,0
4818,Austin Rivers,24-173,G,1/21/17,LAC,@,DEN,L,1,26,7,12,0.583,5,8,0.625,2,4,0.5,0,0,,1,1,2
4819,Austin Rivers,24-212,G,3/1/17,LAC,,HOU,L,0,26,6,12,0.5,2,5,0.4,4,7,0.571,0,0,,0,5,5
4820,Austin Rivers,24-168,G,1/16/17,LAC,,OKC,W,1,35,5,13,0.385,3,6,0.5,2,7,0.286,4,4,1,0,2,2
4821,Glenn Robinson,22-317,G-F,11/20/16,IND,@,OKC,W,1,45,6,14,0.429,4,9,0.444,2,5,0.4,2,2,1,2,9,11
4822,Thomas Robinson,26-004,F,3/21/17,LAL,,LAC,L,0,10,7,8,0.875,7,8,0.875,0,0,,2,2,1,2,4,6
4823,Sergio Rodriguez,30-185,G,12/14/16,PHI,,TOR,L,1,29,7,15,0.467,5,9,0.556,2,6,0.333,0,0,,0,1,1
4824,Sergio Rodriguez,30-179,G,12/8/16,PHI,@,NOP,W,1,30,6,13,0.462,2,5,0.4,4,8,0.5,0,0,,0,2,2
4825,Rajon Rondo,30-262,G,11/10/16,CHI,@,MIA,W,1,37,6,14,0.429,5,13,0.385,1,1,1,3,4,0.75,1,11,12
4826,Derrick Rose,28-052,G,11/25/16,NYK,,CHO,W,1,38,6,13,0.462,6,12,0.5,0,1,0,4,5,0.8,2,1,3
4827,Derrick Rose,28-029,G,11/2/16,NYK,,HOU,L,1,30,8,18,0.444,8,18,0.444,0,0,,0,0,,1,3,4
4828,Derrick Rose,28-103,G,1/15/17,NYK,@,TOR,L,1,29,6,12,0.5,6,12,0.5,0,0,,4,5,0.8,0,2,2
4829,Derrick Rose,28-161,G,3/14/17,NYK,,IND,W,1,32,7,12,0.583,7,11,0.636,0,1,0,2,2,1,0,2,2
4830,Derrick Rose,28-146,G,2/27/17,NYK,,TOR,L,1,40,5,12,0.417,5,11,0.455,0,1,0,6,6,1,0,6,6
4831,Terrence Ross,25-287,F-G,11/18/16,TOR,@,DEN,W,0,30,6,11,0.545,2,6,0.333,4,5,0.8,0,1,0,0,2,2
4832,Terry Rozier,22-265,G,12/7/16,BOS,@,ORL,W,0,26,6,13,0.462,5,9,0.556,1,4,0.25,3,4,0.75,1,4,5
4833,Ricky Rubio,26-105,G,2/3/17,MIN,@,DET,L,1,34,4,10,0.4,2,6,0.333,2,4,0.5,6,7,0.857,0,2,2
4834,D'Angelo Russell,21-010,G,3/5/17,LAL,,NOP,L,1,33,7,20,0.35,5,9,0.556,2,11,0.182,0,1,0,0,4,4
4835,Dario Saric,22-223,F,11/17/16,PHI,@,MIN,L,0,27,6,11,0.545,4,7,0.571,2,4,0.5,2,3,0.667,3,1,4
4836,Dario Saric,22-291,F,1/24/17,PHI,,LAC,W,0,26,4,10,0.4,4,8,0.5,0,2,0,8,9,0.889,1,7,8
4837,Dario Saric,22-337,F,3/11/17,PHI,@,LAC,L,1,35,6,17,0.353,4,12,0.333,2,5,0.4,2,2,1,2,3,5
4838,Dennis Schroder,23-108,G,1/1/17,ATL,,SAS,W,1,33,7,17,0.412,7,15,0.467,0,2,0,2,3,0.667,1,0,1
4839,Dennis Schroder,23-058,G,11/12/16,ATL,,PHI,W,1,28,7,10,0.7,5,8,0.625,2,2,1,0,3,0,0,5,5
4840,Dennis Schroder,23-177,G,3/11/17,ATL,@,MEM,W,1,29,7,15,0.467,6,11,0.545,1,4,0.25,1,2,0.5,1,6,7
4841,Dennis Schroder,23-071,G,11/25/16,ATL,@,UTA,L,1,28,6,19,0.316,4,12,0.333,2,7,0.286,2,2,1,0,2,2
4842,Kevin Seraphin,27-065,F,2/10/17,IND,@,WAS,L,0,25,8,10,0.8,8,10,0.8,0,0,,0,0,,3,4,7
4843,Iman Shumpert,26-201,G,1/13/17,CLE,@,SAC,W,1,26,6,9,0.667,2,3,0.667,4,6,0.667,0,0,,0,0,0
4844,Iman Shumpert,26-217,G,1/29/17,CLE,,OKC,W,1,34,5,11,0.455,0,3,0,5,8,0.625,1,2,0.5,2,1,3
4845,Iman Shumpert,26-167,G,12/10/16,CLE,,CHO,W,0,32,5,8,0.625,1,2,0.5,4,6,0.667,2,2,1,0,5,5
4846,Iman Shumpert,26-213,G,1/25/17,CLE,,SAC,L,1,28,6,9,0.667,2,2,1,4,7,0.571,0,0,,0,3,3
4847,Marcus Smart,22-310,G,1/10/17,BOS,@,TOR,L,1,38,6,11,0.545,5,9,0.556,1,2,0.5,3,3,1,1,3,4
4848,Marcus Smart,22-358,G,2/27/17,BOS,,ATL,L,0,28,5,13,0.385,3,6,0.5,2,7,0.286,4,4,1,1,3,4
4849,Ish Smith,28-259,G,3/21/17,DET,@,BRK,L,0,28,8,15,0.533,8,13,0.615,0,2,0,0,0,,1,6,7
4850,Ish Smith,28-253,G,3/15/17,DET,,UTA,L,0,28,6,9,0.667,6,9,0.667,0,0,,4,6,0.667,0,3,3
4851,Ish Smith,28-115,G,10/28/16,DET,,ORL,W,1,26,8,13,0.615,8,13,0.615,0,0,,0,0,,0,2,2
4852,Ish Smith,28-143,G,11/25/16,DET,,LAC,W,1,34,6,13,0.462,4,11,0.364,2,2,1,2,2,1,0,2,2
4853,J.R. Smith,31-050,G-F,10/29/16,CLE,,ORL,W,1,28,5,11,0.455,1,1,1,4,10,0.4,2,2,1,3,2,5
4854,Jason Smith,30-325,F-C,1/21/17,WAS,@,DET,L,0,19,6,9,0.667,4,6,0.667,2,3,0.667,2,2,1,1,3,4
4855,Tony Snell,25-095,G-F,2/13/17,MIL,,DET,W,1,30,5,11,0.455,1,3,0.333,4,8,0.5,2,2,1,0,2,2
4856,Tony Snell,25-015,G-F,11/25/16,MIL,,TOR,L,1,33,6,12,0.5,2,2,1,4,10,0.4,0,0,,0,3,3
4857,Marreese Speights,29-111,C-F,11/23/16,LAC,@,DAL,W,0,22,5,8,0.625,4,6,0.667,1,2,0.5,5,6,0.833,3,9,12
4858,Marreese Speights,29-107,C-F,11/19/16,LAC,,CHI,W,0,19,5,7,0.714,2,3,0.667,3,4,0.75,3,4,0.75,4,0,4
4859,Nik Stauskas,23-124,G,2/8/17,PHI,,SAS,L,0,32,5,10,0.5,1,3,0.333,4,7,0.571,2,2,1,0,7,7
4860,Nik Stauskas,23-115,G,1/30/17,PHI,,SAC,W,1,28,6,10,0.6,2,4,0.5,4,6,0.667,0,0,,0,0,0
4861,Rodney Stuckey,30-227,G,12/4/16,IND,@,LAC,W,0,21,7,10,0.7,7,9,0.778,0,1,0,2,2,1,0,3,3
4862,Jeff Teague,28-220,G,1/16/17,IND,,NOP,W,1,37,7,10,0.7,6,7,0.857,1,3,0.333,1,1,1,1,7,8
4863,Jeff Teague,28-268,G,3/5/17,IND,@,ATL,W,1,32,5,10,0.5,4,6,0.667,1,4,0.25,5,5,1,0,4,4
4864,Jeff Teague,28-146,G,11/3/16,IND,@,MIL,L,1,30,4,11,0.364,3,8,0.375,1,3,0.333,7,8,0.875,1,3,4
4865,Jeff Teague,28-282,G,3/19/17,IND,@,TOR,L,1,27,4,11,0.364,3,9,0.333,1,2,0.5,7,7,1,0,2,2
4866,Jeff Teague,28-178,G,12/5/16,IND,@,GSW,L,1,26,4,10,0.4,4,10,0.4,0,0,,8,10,0.8,1,2,3
4867,Jeff Teague,28-260,G,2/25/17,IND,@,MIA,L,1,32,5,16,0.313,5,13,0.385,0,3,0,6,7,0.857,0,3,3
4868,Jeff Teague,28-185,G,12/12/16,IND,,CHO,W,1,35,5,8,0.625,2,5,0.4,3,3,1,3,5,0.6,1,4,5
4869,Garrett Temple,30-218,G,12/12/16,SAC,,LAL,W,0,31,7,8,0.875,5,6,0.833,2,2,1,0,0,,0,1,1
4870,Klay Thompson,26-347,G,1/20/17,GSW,@,HOU,W,1,34,7,19,0.368,5,9,0.556,2,10,0.2,0,0,,0,1,1
4871,Klay Thompson,27-020,G,2/28/17,GSW,@,WAS,L,1,38,5,20,0.25,2,7,0.286,3,13,0.231,3,4,0.75,0,3,3
4872,Klay Thompson,26-355,G,1/28/17,GSW,,LAC,W,1,27,7,11,0.636,5,8,0.625,2,3,0.667,0,1,0,0,1,1
4873,Klay Thompson,26-313,G,12/17/16,GSW,,POR,W,1,25,7,15,0.467,6,11,0.545,1,4,0.25,1,1,1,0,0,0
4874,Tristan Thompson,25-285,F-C,12/23/16,CLE,,BRK,W,1,26,7,8,0.875,7,8,0.875,0,0,,2,2,1,6,5,11
4875,Marcus Thornton,29-157,G,11/9/16,WAS,,BOS,W,0,34,5,13,0.385,3,8,0.375,2,5,0.4,4,4,1,2,2,4
4876,Anthony Tolliver,31-213,F-C,12/31/16,SAC,,MEM,L,0,28,4,5,0.8,0,0,,4,5,0.8,4,4,1,2,4,6
4877,Anthony Tolliver,31-221,F-C,1/8/17,SAC,,GSW,L,1,32,5,9,0.556,2,5,0.4,3,4,0.75,3,4,0.75,0,5,5
4878,Karl-Anthony Towns,21-028,F-C,12/13/16,MIN,@,CHI,W,1,39,6,21,0.286,5,13,0.385,1,8,0.125,3,4,0.75,2,10,12
4879,Myles Turner,20-300,F-C,1/18/17,IND,@,SAC,W,1,34,7,9,0.778,6,7,0.857,1,2,0.5,1,2,0.5,1,4,5
4880,Myles Turner,20-246,F-C,11/25/16,IND,,BRK,W,1,23,6,11,0.545,6,10,0.6,0,1,0,4,4,1,2,6,8
4881,Myles Turner,20-277,F-C,12/26/16,IND,@,CHI,L,1,28,7,15,0.467,6,12,0.5,1,3,0.333,1,2,0.5,0,8,8
4882,Myles Turner,20-226,F-C,11/5/16,IND,,CHI,W,1,28,5,13,0.385,5,12,0.417,0,1,0,6,8,0.75,1,4,5
4883,Myles Turner,20-361,F-C,3/20/17,IND,,UTA,W,1,35,6,11,0.545,6,11,0.545,0,0,,4,4,1,2,4,6
4884,Myles Turner,20-342,F-C,3/1/17,IND,@,SAS,L,1,32,7,11,0.636,7,10,0.7,0,1,0,2,2,1,2,4,6
4885,Myles Turner,20-321,F-C,2/8/17,IND,,CLE,L,1,40,4,10,0.4,4,8,0.5,0,2,0,8,8,1,1,6,7
4886,Jonas Valanciunas,24-261,C,1/22/17,TOR,,PHO,L,1,31,6,10,0.6,6,10,0.6,0,0,,4,5,0.8,4,8,12
4887,Jonas Valanciunas,24-226,C,12/18/16,TOR,@,ORL,W,1,26,8,15,0.533,8,15,0.533,0,0,,0,0,,6,7,13
4888,Jonas Valanciunas,24-278,C,2/8/17,TOR,@,MIN,L,1,26,7,7,1,7,7,1,0,0,,2,2,1,1,4,5
4889,Nikola Vucevic,26-124,C,2/25/17,ORL,,ATL,W,1,29,6,14,0.429,6,13,0.462,0,1,0,4,4,1,3,11,14
4890,Nikola Vucevic,26-114,C,2/15/17,ORL,,SAS,L,1,28,7,16,0.438,7,16,0.438,0,0,,2,2,1,1,9,10
4891,Nikola Vucevic,26-079,C,1/11/17,ORL,@,LAC,L,1,32,8,16,0.5,8,14,0.571,0,2,0,0,0,,1,11,12
4892,Nikola Vucevic,26-041,C,12/4/16,ORL,@,DET,W,0,28,8,14,0.571,8,13,0.615,0,1,0,0,0,,0,8,8
4893,Dwyane Wade,34-295,G,11/7/16,CHI,,ORL,W,1,25,7,12,0.583,7,10,0.7,0,2,0,2,2,1,1,2,3
4894,Dwyane Wade,34-346,G,12/28/16,CHI,,BRK,W,1,22,5,13,0.385,5,12,0.417,0,1,0,6,7,0.857,2,2,4
4895,Dion Waiters,24-336,G,11/10/16,MIA,,CHI,L,1,36,6,15,0.4,4,9,0.444,2,6,0.333,2,4,0.5,2,2,4
4896,Dion Waiters,24-345,G,11/19/16,MIA,@,WAS,W,1,29,7,16,0.438,6,12,0.5,1,4,0.25,1,2,0.5,1,3,4
4897,Kemba Walker,26-316,G,3/20/17,CHO,,ATL,W,1,29,6,16,0.375,2,8,0.25,4,8,0.5,0,0,,0,4,4
4898,Kemba Walker,26-314,G,3/18/17,CHO,,WAS,W,1,34,5,18,0.278,1,9,0.111,4,9,0.444,2,3,0.667,0,2,2
4899,Kemba Walker,26-258,G,1/21/17,CHO,,BRK,W,1,33,6,17,0.353,4,11,0.364,2,6,0.333,2,3,0.667,0,4,4
4900,John Wall,26-195,G,3/20/17,WAS,@,BOS,L,1,34,4,10,0.4,4,7,0.571,0,3,0,8,9,0.889,0,4,4
4901,John Wall,26-195,G,3/20/17,WAS,@,BOS,L,1,34,4,10,0.4,4,7,0.571,0,3,0,8,9,0.889,0,4,4
4902,Taurean Waller-Prince,22-359,F,3/16/17,ATL,,MEM,L,0,29,6,10,0.6,4,6,0.667,2,4,0.5,2,2,1,1,5,6
4903,T.J. Warren,23-187,F,3/11/17,PHO,@,DAL,W,1,33,6,12,0.5,6,11,0.545,0,1,0,4,5,0.8,3,6,9
4904,T.J. Warren,23-158,F,2/10/17,PHO,,CHI,W,1,37,8,17,0.471,8,16,0.5,0,1,0,0,0,,1,4,5
4905,T.J. Warren,23-178,F,3/2/17,PHO,,CHO,W,1,27,8,11,0.727,8,10,0.8,0,1,0,0,0,,3,5,8
4906,Isaiah Whitehead,21-325,G,1/27/17,BRK,@,CLE,L,0,24,4,9,0.444,2,7,0.286,2,2,1,6,6,1,0,3,3
4907,Hassan Whiteside,27-222,C,1/21/17,MIA,,MIL,W,1,30,7,8,0.875,7,8,0.875,0,0,,2,4,0.5,2,13,15
4908,Andrew Wiggins,21-277,F-G,11/26/16,MIN,@,GSW,L,1,39,6,15,0.4,5,9,0.556,1,6,0.167,3,4,0.75,0,3,3
4909,Andrew Wiggins,21-290,F-G,12/9/16,MIN,,DET,L,1,27,6,16,0.375,5,13,0.385,1,3,0.333,3,4,0.75,0,2,2
4910,Andrew Wiggins,21-319,F-G,1/7/17,MIN,,UTA,L,1,38,6,19,0.316,5,16,0.313,1,3,0.333,3,7,0.429,4,1,5
4911,Alan Williams,24-033,F-C,3/2/17,PHO,,CHO,W,0,24,7,9,0.778,7,9,0.778,0,0,,2,4,0.5,1,11,12
4912,Alan Williams,24-027,F-C,2/24/17,PHO,@,CHI,L,0,15,8,9,0.889,8,9,0.889,0,0,,0,2,0,1,2,3
4913,Alan Williams,24-040,F-C,3/9/17,PHO,,LAL,L,0,22,5,9,0.556,5,9,0.556,0,0,,6,6,1,5,5,10
4914,Deron Williams,32-171,G,12/14/16,DAL,,DET,L,1,36,3,13,0.231,2,9,0.222,1,4,0.25,9,9,1,1,2,3
4915,Deron Williams,32-166,G,12/9/16,DAL,,IND,W,1,33,5,13,0.385,2,7,0.286,3,6,0.5,3,3,1,0,1,1
4916,Deron Williams,32-208,G,1/20/17,DAL,,UTA,L,1,35,6,14,0.429,5,11,0.455,1,3,0.333,3,5,0.6,1,3,4
4917,Lou Williams,30-048,G,12/14/16,LAL,@,BRK,L,0,24,5,12,0.417,5,8,0.625,0,4,0,6,6,1,1,1,2
4918,Lou Williams,30-033,G,11/29/16,LAL,@,NOP,L,0,22,5,14,0.357,3,7,0.429,2,7,0.286,4,5,0.8,1,2,3
4919,Lou Williams,30-027,G,11/23/16,LAL,@,GSW,L,0,22,6,11,0.545,5,9,0.556,1,2,0.5,3,5,0.6,0,0,0
4920,Lou Williams,30-054,G,12/20/16,LAL,@,CHO,L,0,28,5,12,0.417,4,8,0.5,1,4,0.25,5,6,0.833,1,1,2
4921,Marvin Williams,30-272,F,3/18/17,CHO,,WAS,W,1,33,5,7,0.714,3,4,0.75,2,3,0.667,4,4,1,1,7,8
4922,Marvin Williams,30-254,F,2/28/17,CHO,@,LAL,W,1,34,6,11,0.545,2,4,0.5,4,7,0.571,0,0,,3,4,7
4923,Marvin Williams,30-230,F,2/4/17,CHO,@,UTA,L,1,38,5,10,0.5,2,4,0.5,3,6,0.5,3,4,0.75,0,12,12
4924,Marvin Williams,30-251,F,2/25/17,CHO,@,SAC,W,1,36,6,12,0.5,3,4,0.75,3,8,0.375,1,1,1,1,5,6
4925,Marvin Williams,30-147,F,11/13/16,CHO,@,CLE,L,1,26,6,14,0.429,3,5,0.6,3,9,0.333,1,1,1,1,5,6
4926,Marvin Williams,30-205,F,1/10/17,CHO,@,HOU,L,1,25,6,10,0.6,3,5,0.6,3,5,0.6,1,2,0.5,1,7,8
4927,Nick Young,31-289,G-F,3/17/17,LAL,,MIL,L,1,29,6,11,0.545,2,3,0.667,4,8,0.5,0,0,,0,3,3
4928,Nick Young,31-151,G-F,10/30/16,LAL,@,OKC,L,1,30,4,11,0.364,1,1,1,3,10,0.3,5,5,1,0,3,3
4929,Nick Young,31-162,G-F,11/10/16,LAL,@,SAC,W,1,30,6,11,0.545,2,2,1,4,9,0.444,0,0,,0,3,3
4930,Thaddeus Young,28-148,F,11/16/16,IND,,CLE,W,1,37,7,14,0.5,6,13,0.462,1,1,1,1,2,0.5,1,5,6
4931,Thaddeus Young,28-200,F,1/7/17,IND,,NYK,W,1,29,6,8,0.75,4,6,0.667,2,2,1,2,4,0.5,1,8,9
4932,Thaddeus Young,28-271,F,3/19/17,IND,@,TOR,L,1,26,7,9,0.778,6,8,0.75,1,1,1,1,3,0.333,2,2,4
4933,Cody Zeller,24-073,F-C,12/17/16,CHO,@,ATL,W,1,36,8,14,0.571,8,14,0.571,0,0,,0,0,,2,9,11
4934,Cody Zeller,24-100,F-C,1/13/17,CHO,@,PHI,L,1,36,6,14,0.429,6,14,0.429,0,0,,4,4,1,6,4,10
4935,Ivica Zubac,19-314,C,1/26/17,LAL,@,UTA,L,0,26,6,11,0.545,6,11,0.545,0,0,,4,4,1,2,8,10
4936,Steven Adams,23-201,C,2/6/17,OKC,@,IND,L,1,37,6,13,0.462,6,13,0.462,0,0,,3,4,0.75,7,2,9
4937,Steven Adams,23-219,C,2/24/17,OKC,,LAL,W,1,31,7,13,0.538,7,13,0.538,0,0,,1,2,0.5,3,7,10
4938,Steven Adams,23-160,C,12/27/16,OKC,@,MIA,W,1,23,7,10,0.7,7,10,0.7,0,0,,1,1,1,6,2,8
4939,Steven Adams,23-121,C,11/18/16,OKC,,BRK,W,1,32,4,6,0.667,4,6,0.667,0,0,,7,8,0.875,3,4,7
4940,Steven Adams,23-190,C,1/26/17,OKC,,DAL,W,1,37,5,7,0.714,5,7,0.714,0,0,,5,6,0.833,3,4,7
4941,Arron Afflalo,31-104,G,1/27/17,SAC,@,IND,L,1,34,6,9,0.667,3,4,0.75,3,5,0.6,0,0,,0,1,1
4942,Arron Afflalo,31-081,G,1/4/17,SAC,,MIA,L,0,31,5,8,0.625,2,5,0.4,3,3,1,2,2,1,0,1,1
4943,Arron Afflalo,31-027,G,11/11/16,SAC,@,POR,L,1,32,5,9,0.556,5,8,0.625,0,1,0,5,6,0.833,1,1,2
4944,Arron Afflalo,31-024,G,11/8/16,SAC,,NOP,W,1,29,5,6,0.833,3,3,1,2,3,0.667,3,3,1,0,2,2
4945,LaMarcus Aldridge,31-220,F-C,2/24/17,SAS,@,LAC,W,1,34,5,15,0.333,4,14,0.286,1,1,1,4,4,1,2,9,11
4946,LaMarcus Aldridge,31-172,F-C,1/7/17,SAS,,CHO,W,1,34,5,9,0.556,5,8,0.625,0,1,0,5,6,0.833,5,6,11
4947,LaMarcus Aldridge,31-230,F-C,3/6/17,SAS,,HOU,W,1,37,4,10,0.4,4,10,0.4,0,0,,7,8,0.875,1,3,4
4948,LaMarcus Aldridge,31-208,F-C,2/12/17,SAS,@,NYK,L,1,37,5,16,0.313,5,15,0.333,0,1,0,5,6,0.833,6,4,10
4949,LaMarcus Aldridge,31-204,F-C,2/8/17,SAS,@,PHI,W,1,36,5,10,0.5,5,9,0.556,0,1,0,5,6,0.833,2,8,10
4950,Tony Allen,35-061,G-F,3/13/17,MEM,,MIL,W,1,30,6,10,0.6,4,8,0.5,2,2,1,1,3,0.333,1,3,4
4951,Tony Allen,34-332,G-F,12/8/16,MEM,,POR,W,1,29,6,10,0.6,6,10,0.6,0,0,,3,5,0.6,5,5,10
4952,Tony Allen,35-030,G-F,2/10/17,MEM,,GSW,L,1,28,5,12,0.417,5,12,0.417,0,0,,5,7,0.714,4,5,9
4953,Tony Allen,35-014,G-F,1/25/17,MEM,,TOR,W,1,35,7,14,0.5,6,12,0.5,1,2,0.5,0,1,0,3,8,11
4954,Justin Anderson,23-012,G,12/1/16,DAL,@,CHO,L,0,18,4,7,0.571,1,4,0.25,3,3,1,4,4,1,1,2,3
4955,Ryan Anderson,28-234,F,12/26/16,HOU,,PHO,W,1,25,6,9,0.667,3,4,0.75,3,5,0.6,0,0,,2,3,5
4956,Ryan Anderson,28-229,F,12/21/16,HOU,@,PHO,W,1,28,5,10,0.5,2,3,0.667,3,7,0.429,2,2,1,1,4,5
4957,Giannis Antetokounmpo,22-001,F-G,12/7/16,MIL,,POR,W,1,40,4,11,0.364,4,8,0.5,0,3,0,7,10,0.7,2,10,12
4958,Giannis Antetokounmpo,22-085,F-G,3/1/17,MIL,,DEN,L,1,34,5,13,0.385,5,12,0.417,0,1,0,5,6,0.833,2,7,9
4959,Carmelo Anthony,32-248,F,2/1/17,NYK,@,BRK,W,1,27,6,22,0.273,5,16,0.313,1,6,0.167,2,3,0.667,2,1,3
4960,Carmelo Anthony,32-280,F,3/5/17,NYK,,GSW,L,1,35,6,12,0.5,5,8,0.625,1,4,0.25,2,2,1,2,4,6
4961,Carmelo Anthony,32-207,F,12/22/16,NYK,,ORL,W,1,29,5,17,0.294,5,14,0.357,0,3,0,5,5,1,1,7,8
4962,Trevor Ariza,31-130,F,11/7/16,HOU,@,WAS,W,1,34,5,11,0.455,1,2,0.5,4,9,0.444,1,1,1,0,5,5
4963,Trevor Ariza,31-158,F,12/5/16,HOU,,BOS,W,1,33,6,15,0.4,3,5,0.6,3,10,0.3,0,0,,1,7,8
4964,Trevor Ariza,31-240,F,2/25/17,HOU,,MIN,W,1,32,3,8,0.375,0,0,,3,8,0.375,6,6,1,2,1,3
4965,Trevor Ariza,31-135,F,11/12/16,HOU,,SAS,L,1,37,5,13,0.385,1,2,0.5,4,11,0.364,1,2,0.5,1,3,4
4966,D.J. Augustin,29-027,G,12/7/16,ORL,,BOS,L,1,24,4,7,0.571,0,1,0,4,6,0.667,3,4,0.75,0,1,1
4967,D.J. Augustin,29-111,G,3/1/17,ORL,,NYK,L,0,27,4,8,0.5,2,3,0.667,2,5,0.4,5,5,1,1,3,4
4968,D.J. Augustin,29-064,G,1/13/17,ORL,@,POR,W,0,17,4,7,0.571,3,5,0.6,1,2,0.5,6,6,1,0,1,1
4969,J.J. Barea,32-203,G,1/15/17,DAL,,MIN,W,0,17,5,5,1,4,4,1,1,1,1,4,5,0.8,1,2,3
4970,Harrison Barnes,24-234,F,1/19/17,DAL,@,MIA,L,1,34,7,14,0.5,7,11,0.636,0,3,0,1,1,1,2,5,7
4971,Harrison Barnes,24-247,F,2/1/17,DAL,,PHI,W,1,32,6,13,0.462,5,10,0.5,1,3,0.333,2,2,1,2,5,7
4972,Harrison Barnes,24-210,F,12/26/16,DAL,@,NOP,L,1,37,6,14,0.429,5,12,0.417,1,2,0.5,2,2,1,0,7,7
4973,Harrison Barnes,24-172,F,11/18/16,DAL,,MEM,L,1,34,5,17,0.294,5,16,0.313,0,1,0,5,5,1,1,6,7
4974,Harrison Barnes,24-202,F,12/18/16,DAL,,SAC,W,1,30,5,15,0.333,4,13,0.308,1,2,0.5,4,6,0.667,3,6,9
4975,Matt Barnes,36-252,F,11/16/16,SAC,,SAS,L,0,28,6,9,0.667,4,5,0.8,2,4,0.5,1,2,0.5,1,1,2
4976,Matt Barnes,36-343,F,2/15/17,SAC,@,GSW,L,0,32,5,12,0.417,4,7,0.571,1,5,0.2,4,4,1,3,11,14
4977,Matt Barnes,36-254,F,11/18/16,SAC,,LAC,L,0,30,5,10,0.5,1,4,0.25,4,6,0.667,1,2,0.5,2,5,7
4978,Will Barton,25-336,G,12/7/16,DEN,@,BRK,L,1,39,6,15,0.4,5,6,0.833,1,9,0.111,2,2,1,3,6,9
4979,Will Barton,26-035,G,2/10/17,DEN,@,NYK,W,0,34,6,15,0.4,5,11,0.455,1,4,0.25,2,4,0.5,6,4,10
4980,Will Barton,26-053,G,2/28/17,DEN,@,CHI,W,0,29,7,15,0.467,6,10,0.6,1,5,0.2,0,0,,0,8,8
4981,Will Barton,25-344,G,12/15/16,DEN,,POR,W,0,23,3,8,0.375,0,2,0,3,6,0.5,6,6,1,0,1,1
4982,Brandon Bass,31-320,F,3/16/17,LAC,@,DEN,L,0,24,6,8,0.75,6,8,0.75,0,0,,3,5,0.6,1,3,4
4983,Nicolas Batum,28-044,F-G,1/27/17,CHO,@,NYK,L,1,36,5,12,0.417,2,6,0.333,3,6,0.5,2,2,1,2,9,11
4984,Nicolas Batum,27-355,F-G,12/3/16,CHO,,MIN,L,1,41,6,15,0.4,3,6,0.5,3,9,0.333,0,3,0,2,6,8
4985,Nicolas Batum,28-057,F-G,2/9/17,CHO,,HOU,L,1,35,5,10,0.5,3,6,0.5,2,4,0.5,3,3,1,1,7,8
4986,Nicolas Batum,27-335,F-G,11/13/16,CHO,@,CLE,L,1,33,5,12,0.417,4,7,0.571,1,5,0.2,4,5,0.8,1,8,9
4987,Nicolas Batum,28-073,F-G,2/25/17,CHO,@,SAC,W,1,34,4,17,0.235,3,11,0.273,1,6,0.167,6,6,1,0,6,6
4988,Nicolas Batum,28-086,F-G,3/10/17,CHO,,ORL,W,1,28,7,14,0.5,7,11,0.636,0,3,0,1,2,0.5,1,2,3
4989,Kent Bazemore,27-243,G-F,3/1/17,ATL,,DAL,W,1,30,6,11,0.545,3,6,0.5,3,5,0.6,0,0,,0,1,1
4990,Kent Bazemore,27-241,G-F,2/27/17,ATL,@,BOS,W,1,26,7,13,0.538,6,10,0.6,1,3,0.333,0,0,,1,3,4
4991,Kent Bazemore,27-255,G-F,3/13/17,ATL,@,SAS,L,1,31,5,6,0.833,4,4,1,1,2,0.5,4,5,0.8,0,2,2
4992,Kent Bazemore,27-253,G-F,3/11/17,ATL,@,MEM,W,1,26,6,10,0.6,3,3,1,3,7,0.429,0,0,,1,1,2
4993,Kent Bazemore,27-210,G-F,1/27/17,ATL,,WAS,L,1,21,6,14,0.429,4,10,0.4,2,4,0.5,1,1,1,0,0,0
4994,Bradley Beal,23-130,G,11/5/16,WAS,@,ORL,L,1,33,6,17,0.353,5,12,0.417,1,5,0.2,2,2,1,2,2,4
4995,Bradley Beal,23-127,G,11/2/16,WAS,,TOR,L,1,39,5,13,0.385,3,9,0.333,2,4,0.5,3,6,0.5,0,1,1
4996,Bradley Beal,23-213,G,1/27/17,WAS,@,ATL,W,1,26,6,13,0.462,4,6,0.667,2,7,0.286,1,1,1,0,1,1
4997,Michael Beasley,28-032,F,2/10/17,MIL,,LAL,L,0,23,6,9,0.667,5,6,0.833,1,3,0.333,2,3,0.667,1,4,5
4998,Marco Belinelli,30-291,G-F,1/10/17,CHO,@,HOU,L,0,28,6,13,0.462,3,4,0.75,3,9,0.333,0,0,,0,3,3
4999,Marco Belinelli,30-308,G-F,1/27/17,CHO,@,NYK,L,0,21,6,10,0.6,4,5,0.8,2,5,0.4,1,1,1,0,2,2
5000,Marco Belinelli,30-260,G-F,12/10/16,CHO,@,CLE,L,0,29,6,11,0.545,3,7,0.429,3,4,0.75,0,0,,1,0,1
5001,Marco Belinelli,30-260,G-F,12/10/16,CHO,@,CLE,L,0,29,6,11,0.545,3,7,0.429,3,4,0.75,0,0,,1,0,1
5002,Davis Bertans,24-013,F,11/25/16,SAS,@,BOS,W,0,23,6,8,0.75,3,3,1,3,5,0.6,0,0,,0,2,2
5003,Patrick Beverley,28-171,G,12/30/16,HOU,,LAC,W,1,33,5,9,0.556,3,5,0.6,2,4,0.5,3,3,1,2,5,7
5004,Patrick Beverley,28-228,G,2/25/17,HOU,,MIN,W,1,29,4,10,0.4,1,3,0.333,3,7,0.429,4,5,0.8,1,3,4
5005,Patrick Beverley,28-151,G,12/10/16,HOU,,DAL,W,1,29,5,7,0.714,1,1,1,4,6,0.667,1,2,0.5,1,6,7
5006,Bismack Biyombo,24-141,C-F,1/16/17,ORL,@,DEN,L,0,20,7,9,0.778,7,9,0.778,0,0,,1,4,0.25,3,6,9
5007,Bismack Biyombo,24-167,C-F,2/11/17,ORL,@,DAL,L,0,21,5,7,0.714,5,7,0.714,0,0,,5,5,1,5,2,7
5008,Eric Bledsoe,26-364,G,12/7/16,PHO,,IND,L,1,29,5,13,0.385,5,8,0.625,0,5,0,5,5,1,0,3,3
5009,Bojan Bogdanovic,27-216,G-F,11/20/16,BRK,,POR,L,1,24,6,11,0.545,5,8,0.625,1,3,0.333,2,2,1,0,2,2
5010,Bojan Bogdanovic,27-196,G-F,10/31/16,BRK,,CHI,L,1,21,5,11,0.455,3,7,0.429,2,4,0.5,3,4,0.75,2,1,3
5011,Bojan Bogdanovic,27-242,G-F,12/16/16,BRK,@,ORL,L,1,30,5,14,0.357,2,7,0.286,3,7,0.429,2,2,1,0,3,3
5012,Bojan Bogdanovic,27-289,G-F,2/1/17,BRK,,NYK,L,1,29,6,10,0.6,5,5,1,1,5,0.2,2,4,0.5,1,6,7
5013,Bojan Bogdanovic,27-314,G-F,2/26/17,WAS,,UTA,L,0,33,5,10,0.5,2,4,0.5,3,6,0.5,2,2,1,0,1,1
5014,Devin Booker,20-003,G,11/2/16,PHO,,POR,W,1,39,6,15,0.4,5,13,0.385,1,2,0.5,2,4,0.5,0,3,3
5015,Devin Booker,20-123,G,3/2/17,PHO,,CHO,W,1,30,5,12,0.417,4,8,0.5,1,4,0.25,4,5,0.8,0,6,6
5016,Devin Booker,20-119,G,2/26/17,PHO,@,MIL,L,1,35,5,11,0.455,3,8,0.375,2,3,0.667,3,4,0.75,0,4,4
5017,Devin Booker,20-040,G,12/9/16,PHO,@,LAL,W,1,28,6,17,0.353,5,11,0.455,1,6,0.167,2,2,1,1,2,3
5018,Trevor Booker,28-349,F,11/8/16,BRK,,MIN,W,1,27,7,13,0.538,7,12,0.583,0,1,0,1,3,0.333,0,9,9
5019,Trevor Booker,29-072,F,2/5/17,BRK,,TOR,L,0,26,7,13,0.538,6,12,0.5,1,1,1,0,2,0,2,8,10
5020,Trevor Booker,29-091,F,2/24/17,BRK,@,DEN,L,0,22,6,11,0.545,6,10,0.6,0,1,0,3,5,0.6,0,9,9
5021,Trevor Booker,29-012,F,12/7/16,BRK,,DEN,W,1,37,6,12,0.5,6,11,0.545,0,1,0,3,6,0.5,1,11,12
5022,Trevor Booker,29-105,F,3/10/17,BRK,@,DAL,L,0,27,6,14,0.429,5,12,0.417,1,2,0.5,2,5,0.4,2,5,7
5023,Trevor Booker,29-004,F,11/29/16,BRK,,LAC,W,1,42,7,13,0.538,7,11,0.636,0,2,0,1,1,1,2,9,11
5024,Avery Bradley,25-351,G,11/11/16,BOS,,NYK,W,1,32,5,17,0.294,4,13,0.308,1,4,0.25,4,4,1,3,7,10
5025,Avery Bradley,26-097,G,3/3/17,BOS,@,LAL,W,1,24,6,11,0.545,4,5,0.8,2,6,0.333,1,4,0.25,1,3,4
5026,Avery Bradley,26-026,G,12/22/16,BOS,@,IND,W,1,31,6,13,0.462,6,10,0.6,0,3,0,3,3,1,1,4,5
5027,Avery Bradley,26-006,G,12/2/16,BOS,,SAC,W,1,35,6,13,0.462,4,9,0.444,2,4,0.5,1,1,1,2,7,9
5028,Corey Brewer,30-311,F-G,1/10/17,HOU,,CHO,W,0,26,7,10,0.7,6,8,0.75,1,2,0.5,0,0,,0,5,5
5029,Malcolm Brogdon,24-077,G,2/26/17,MIL,,PHO,W,0,24,6,9,0.667,5,6,0.833,1,3,0.333,2,2,1,0,0,0
5030,Malcolm Brogdon,24-020,G,12/31/16,MIL,@,CHI,W,1,39,7,13,0.538,6,11,0.545,1,2,0.5,0,0,,1,9,10
5031,Malcolm Brogdon,24-092,G,3/13/17,MIL,@,MEM,L,0,32,5,10,0.5,2,5,0.4,3,5,0.6,2,2,1,2,0,2
5032,Jaylen Brown,20-126,F,2/27/17,BOS,,ATL,L,0,26,6,10,0.6,4,6,0.667,2,4,0.5,1,3,0.333,1,4,5
5033,Reggie Bullock,25-308,G-F,1/18/17,DET,,ATL,W,1,36,6,11,0.545,4,6,0.667,2,5,0.4,1,2,0.5,3,3,6
5034,Alec Burks,25-192,G,1/28/17,UTA,,MEM,L,0,16,4,5,0.8,2,3,0.667,2,2,1,5,6,0.833,0,2,2
5035,Kentavious Caldwell-Pope,23-258,G,11/2/16,DET,@,BRK,L,1,37,4,14,0.286,2,6,0.333,2,8,0.25,5,5,1,2,5,7
5036,Kentavious Caldwell-Pope,24-019,G,3/9/17,DET,,CLE,W,1,34,5,10,0.5,1,3,0.333,4,7,0.571,1,1,1,0,0,0
5037,Isaiah Canaan,25-163,G,10/31/16,CHI,@,BRK,W,0,22,5,7,0.714,2,3,0.667,3,4,0.75,2,2,1,1,2,3
5038,Clint Capela,22-281,F-C,2/23/17,HOU,@,NOP,W,0,19,7,8,0.875,7,8,0.875,0,0,,1,2,0.5,2,6,8
5039,Clint Capela,22-183,F-C,11/17/16,HOU,,POR,W,1,27,7,9,0.778,7,9,0.778,0,0,,1,2,0.5,2,5,7
5040,Clint Capela,22-187,F-C,11/21/16,HOU,@,DET,W,1,35,7,10,0.7,7,10,0.7,0,0,,1,2,0.5,4,8,12
5041,Clint Capela,22-301,F-C,3/15/17,HOU,,LAL,W,1,21,5,7,0.714,5,7,0.714,0,0,,5,8,0.625,3,7,10
5042,DeMarre Carroll,30-200,F,2/12/17,TOR,,DET,L,1,36,6,9,0.667,4,5,0.8,2,4,0.5,1,4,0.25,0,2,2
5043,DeMarre Carroll,30-193,F,2/5/17,TOR,@,BRK,W,1,32,6,11,0.545,4,6,0.667,2,5,0.4,1,2,0.5,1,4,5
5044,Michael Carter-Williams,25-091,G,1/9/17,CHI,,OKC,L,1,24,6,11,0.545,6,10,0.6,0,1,0,3,3,1,0,1,1
5045,Willie Cauley-Stein,23-199,F-C,3/5/17,SAC,,UTA,L,1,39,6,12,0.5,6,12,0.5,0,0,,3,6,0.5,0,9,9
5046,Tyson Chandler,34-118,C,1/28/17,PHO,,DEN,L,1,40,6,8,0.75,6,8,0.75,0,0,,3,4,0.75,3,10,13
5047,Tyson Chandler,34-082,C,12/23/16,PHO,,PHI,W,1,33,5,9,0.556,5,9,0.556,0,0,,5,8,0.625,3,9,12
5048,Marquese Chriss,19-228,F,2/15/17,PHO,,LAL,W,1,25,4,11,0.364,4,9,0.444,0,2,0,7,9,0.778,2,6,8
5049,Marquese Chriss,19-203,F,1/21/17,PHO,@,NYK,W,1,22,6,10,0.6,4,5,0.8,2,5,0.4,1,3,0.333,3,2,5
5050,Jordan Clarkson,24-205,G,12/29/16,LAL,,DAL,L,0,30,7,11,0.636,6,8,0.75,1,3,0.333,0,2,0,0,1,1
5051,Jordan Clarkson,24-147,G,11/1/16,LAL,@,IND,L,0,31,7,16,0.438,7,12,0.583,0,4,0,1,1,1,1,0,1
5052,Jordan Clarkson,24-188,G,12/12/16,LAL,@,SAC,L,0,22,4,11,0.364,3,9,0.333,1,2,0.5,6,6,1,1,1,2
5053,Jordan Clarkson,24-253,G,2/15/17,LAL,@,PHO,L,0,30,6,12,0.5,4,7,0.571,2,5,0.4,1,3,0.333,0,3,3
5054,Darren Collison,29-184,G,2/23/17,SAC,,DEN,W,1,32,5,13,0.385,3,10,0.3,2,3,0.667,3,3,1,0,4,4
5055,Darren Collison,29-089,G,11/20/16,SAC,,TOR,W,1,32,4,8,0.5,3,4,0.75,1,4,0.25,6,8,0.75,0,0,0
5056,Mike Conley,29-032,G,11/12/16,MEM,@,MIL,L,1,30,3,10,0.3,2,4,0.5,1,6,0.167,8,8,1,0,4,4
5057,Mike Conley,29-102,G,1/21/17,MEM,,HOU,L,1,35,6,17,0.353,3,9,0.333,3,8,0.375,0,0,,1,3,4
5058,DeMarcus Cousins,26-084,C-F,11/5/16,SAC,@,MIL,L,1,28,5,12,0.417,5,10,0.5,0,2,0,5,6,0.833,0,4,4
5059,DeMarcus Cousins,26-205,C-F,3/6/17,NOP,@,UTA,L,1,38,5,15,0.333,4,11,0.364,1,4,0.25,4,4,1,0,8,8
5060,DeMarcus Cousins,26-218,C-F,3/19/17,NOP,,MIN,W,1,31,7,14,0.5,6,9,0.667,1,5,0.2,0,0,,1,10,11
5061,Robert Covington,26-075,F,2/27/17,PHI,,GSW,L,1,35,6,12,0.5,4,5,0.8,2,7,0.286,1,2,0.5,1,7,8
5062,Robert Covington,26-082,F,3/6/17,PHI,,MIL,L,1,33,5,12,0.417,2,5,0.4,3,7,0.429,2,2,1,0,3,3
5063,Robert Covington,26-025,F,1/8/17,PHI,@,BRK,W,1,37,5,12,0.417,4,7,0.571,1,5,0.2,4,4,1,1,10,11
5064,Robert Covington,26-004,F,12/18/16,PHI,,BRK,W,1,35,5,11,0.455,4,7,0.571,1,4,0.25,4,4,1,2,3,5
5065,Robert Covington,26-038,F,1/21/17,PHI,@,ATL,L,1,31,5,12,0.417,2,6,0.333,3,6,0.5,2,2,1,2,8,10
5066,Allen Crabbe,24-235,G-F,11/30/16,POR,,IND,W,0,23,4,8,0.5,2,4,0.5,2,4,0.5,5,5,1,0,1,1
5067,Allen Crabbe,24-220,G-F,11/15/16,POR,,CHI,L,0,33,6,12,0.5,3,5,0.6,3,7,0.429,0,0,,1,3,4
5068,Jamal Crawford,36-248,G,11/23/16,LAC,@,DAL,W,0,28,5,12,0.417,2,5,0.4,3,7,0.429,2,2,1,0,2,2
5069,Jamal Crawford,37-001,G,3/21/17,LAC,@,LAL,W,0,30,6,10,0.6,3,4,0.75,3,6,0.5,0,0,,0,2,2
5070,Jamal Crawford,36-241,G,11/16/16,LAC,,MEM,L,0,27,6,12,0.5,5,8,0.625,1,4,0.25,2,2,1,1,0,1
5071,Jamal Crawford,36-221,G,10/27/16,LAC,@,POR,W,0,26,3,12,0.25,2,6,0.333,1,6,0.167,8,8,1,0,3,3
5072,Jae Crowder,26-140,F,11/23/16,BOS,@,BRK,W,1,22,6,11,0.545,3,4,0.75,3,7,0.429,0,1,0,1,4,5
5073,Jae Crowder,26-169,F,12/22/16,BOS,@,IND,W,1,35,5,9,0.556,2,4,0.5,3,5,0.6,2,2,1,1,5,6
5074,Jae Crowder,26-256,F,3/19/17,BOS,@,PHI,L,1,36,3,13,0.231,1,8,0.125,2,5,0.4,7,8,0.875,0,7,7
5075,Jae Crowder,26-165,F,12/18/16,BOS,@,MIA,W,1,34,4,10,0.4,1,4,0.25,3,6,0.5,4,6,0.667,2,4,6
5076,Jae Crowder,26-194,F,1/16/17,BOS,,CHO,W,1,30,5,11,0.455,2,3,0.667,3,8,0.375,2,2,1,0,7,7
5077,Jae Crowder,26-161,F,12/14/16,BOS,@,SAS,L,1,36,5,12,0.417,2,4,0.5,3,8,0.375,2,3,0.667,1,5,6
5078,Dante Cunningham,29-189,F,10/28/16,NOP,,GSW,L,0,32,6,11,0.545,3,5,0.6,3,6,0.5,0,0,,0,8,8
5079,Seth Curry,26-150,G,1/20/17,DAL,,UTA,L,1,30,5,8,0.625,3,5,0.6,2,3,0.667,3,4,0.75,0,3,3
5080,Seth Curry,26-167,G,2/6/17,DAL,@,DEN,L,1,34,6,15,0.4,3,8,0.375,3,7,0.429,0,0,,0,2,2
5081,Seth Curry,26-149,G,1/19/17,DAL,@,MIA,L,1,32,6,11,0.545,3,6,0.5,3,5,0.6,0,1,0,2,2,4
5082,Stephen Curry,28-286,G,12/25/16,GSW,@,CLE,L,1,37,4,11,0.364,2,4,0.5,2,7,0.286,5,6,0.833,0,3,3
5083,Stephen Curry,28-283,G,12/22/16,GSW,@,BRK,W,1,33,6,19,0.316,3,6,0.5,3,13,0.231,0,0,,0,2,2
5084,Anthony Davis,24-003,F-C,3/14/17,NOP,,POR,W,1,29,5,15,0.333,5,15,0.333,0,0,,5,6,0.833,3,11,14
5085,Dewayne Dedmon,27-148,C,1/7/17,SAS,,CHO,W,0,23,6,6,1,6,6,1,0,0,,3,4,0.75,1,9,10
5086,Sam Dekker,22-264,F,1/25/17,HOU,@,BOS,L,0,29,7,14,0.5,6,9,0.667,1,5,0.2,0,0,,0,4,4
5087,Matthew Dellavedova,26-176,G,3/3/17,MIL,,LAC,W,0,36,6,9,0.667,5,6,0.833,1,3,0.333,2,2,1,1,0,1
5088,Matthew Dellavedova,26-135,G,1/21/17,MIL,@,MIA,L,1,36,5,8,0.625,3,5,0.6,2,3,0.667,3,3,1,0,2,2
5089,Matthew Dellavedova,26-174,G,3/1/17,MIL,,DEN,L,0,23,7,9,0.778,6,7,0.857,1,2,0.5,0,0,,0,0,0
5090,Luol Deng,31-245,F,12/17/16,LAL,@,CLE,L,1,34,6,11,0.545,3,4,0.75,3,7,0.429,0,0,,2,6,8
5091,DeMar DeRozan,27-135,G,12/20/16,TOR,,BRK,W,1,29,6,20,0.3,6,18,0.333,0,2,0,3,4,0.75,0,1,1
5092,Boris Diaw,34-262,F-C,1/3/17,UTA,@,BOS,L,0,15,6,7,0.857,3,4,0.75,3,3,1,0,0,,0,0,0
5093,Gorgui Dieng,26-313,C,11/26/16,MIN,@,GSW,L,1,38,7,12,0.583,6,10,0.6,1,2,0.5,0,0,,1,5,6
5094,Gorgui Dieng,26-354,C,1/6/17,MIN,@,WAS,L,1,40,6,12,0.5,5,11,0.455,1,1,1,2,2,1,3,8,11
5095,Goran Dragic,30-301,G,3/3/17,MIA,@,ORL,L,1,34,3,14,0.214,3,11,0.273,0,3,0,9,11,0.818,2,2,4
5096,Goran Dragic,30-299,G,3/1/17,MIA,,PHI,W,1,23,6,13,0.462,5,10,0.5,1,3,0.333,2,3,0.667,0,2,2
5097,Goran Dragic,30-309,G,3/11/17,MIA,,TOR,W,1,17,5,9,0.556,4,7,0.571,1,2,0.5,4,5,0.8,0,2,2
5098,Goran Dragic,30-217,G,12/9/16,MIA,@,CLE,L,1,34,4,10,0.4,2,6,0.333,2,4,0.5,5,6,0.833,1,2,3
5099,Andre Drummond,23-135,C,12/23/16,DET,,GSW,L,1,30,6,7,0.857,6,7,0.857,0,0,,3,9,0.333,0,9,9
5100,Andre Drummond,23-089,C,11/7/16,DET,@,LAC,L,1,25,6,10,0.6,6,10,0.6,0,0,,3,5,0.6,4,8,12
5101,Andre Drummond,23-135,C,12/23/16,DET,,GSW,L,1,30,6,7,0.857,6,7,0.857,0,0,,3,9,0.333,0,9,9
5102,Andre Drummond,23-089,C,11/7/16,DET,@,LAC,L,1,25,6,10,0.6,6,10,0.6,0,0,,3,5,0.6,4,8,12
5103,Andre Drummond,23-118,C,12/6/16,DET,,CHI,W,1,25,7,13,0.538,7,13,0.538,0,0,,1,4,0.25,3,7,10
5104,Andre Drummond,23-098,C,11/16/16,DET,@,NYK,L,1,29,7,13,0.538,7,13,0.538,0,0,,1,2,0.5,1,8,9
5105,Kris Dunn,22-263,G,12/6/16,MIN,,SAS,L,0,17,6,7,0.857,5,6,0.833,1,1,1,2,2,1,1,0,1
5106,Kevin Durant,28-115,F-G,1/22/17,GSW,@,ORL,W,1,29,5,12,0.417,4,9,0.444,1,3,0.333,4,5,0.8,1,9,10
5107,Kevin Durant,28-077,F-G,12/15/16,GSW,,NYK,W,1,33,7,18,0.389,6,12,0.5,1,6,0.167,0,0,,1,13,14
5108,Wayne Ellington,29-084,G,1/21/17,MIA,,MIL,W,0,35,6,12,0.5,3,3,1,3,9,0.333,0,0,,0,5,5
5109,Monta Ellis,31-087,G,1/21/17,IND,@,UTA,L,0,33,6,10,0.6,4,8,0.5,2,2,1,1,2,0.5,1,3,4
5110,Monta Ellis,31-017,G,11/12/16,IND,,BOS,L,1,34,5,10,0.5,4,7,0.571,1,3,0.333,4,7,0.571,0,4,4
5111,Joel Embiid,22-275,C-F,12/16/16,PHI,,LAL,L,1,29,5,14,0.357,3,10,0.3,2,4,0.5,3,8,0.375,2,2,4
5112,James Ennis,26-117,F,10/26/16,MEM,,MIN,W,1,28,5,8,0.625,3,4,0.75,2,4,0.5,3,4,0.75,1,5,6
5113,Tyreke Evans,27-138,G-F,2/4/17,NOP,@,WAS,L,0,27,6,16,0.375,4,13,0.308,2,3,0.667,1,2,0.5,1,5,6
5114,Tyreke Evans,27-163,G-F,3/1/17,SAC,,BRK,L,0,20,5,10,0.5,2,5,0.4,3,5,0.6,2,2,1,1,4,5
5115,Tyreke Evans,27-157,G-F,2/23/17,SAC,,DEN,W,0,26,4,8,0.5,3,6,0.5,1,2,0.5,6,8,0.75,0,4,4
5116,Tyreke Evans,27-147,G-F,2/13/17,NOP,@,PHO,W,0,25,6,11,0.545,6,8,0.75,0,3,0,3,5,0.6,0,4,4
5117,Dante Exum,21-231,G,3/1/17,UTA,,MIN,L,0,29,6,12,0.5,4,7,0.571,2,5,0.4,1,3,0.333,0,1,1
5118,Kenneth Faried,27-031,F,12/20/16,DEN,@,LAC,L,0,27,5,9,0.556,5,8,0.625,0,1,0,5,6,0.833,4,7,11
5119,Kenneth Faried,27-054,F,1/12/17,DEN,,IND,W,0,16,6,8,0.75,6,8,0.75,0,0,,3,3,1,4,5,9
5120,Kenneth Faried,27-068,F,1/26/17,DEN,,PHO,W,1,21,5,8,0.625,5,8,0.625,0,0,,5,5,1,4,2,6
5121,Derrick Favors,25-105,F-C,10/28/16,UTA,,LAL,W,0,20,4,7,0.571,4,7,0.571,0,0,,7,11,0.636,4,4,8
5122,Derrick Favors,25-176,F-C,1/7/17,UTA,@,MIN,W,1,34,7,12,0.583,6,10,0.6,1,2,0.5,0,0,,0,6,6
5123,Raymond Felton,32-204,G,1/16/17,LAC,,OKC,W,0,27,7,7,1,7,7,1,0,0,,1,2,0.5,0,3,3
5124,Raymond Felton,32-202,G,1/14/17,LAC,,LAL,W,0,25,7,11,0.636,6,9,0.667,1,2,0.5,0,0,,0,2,2
5125,Yogi Ferrell,23-273,G,2/6/17,DAL,@,DEN,L,1,35,4,11,0.364,2,6,0.333,2,5,0.4,5,5,1,0,2,2
5126,Evan Fournier,24-133,G-F,3/11/17,ORL,,CLE,L,1,32,4,10,0.4,2,5,0.4,2,5,0.4,5,6,0.833,0,1,1
5127,Evan Fournier,24-050,G-F,12/18/16,ORL,,TOR,L,1,26,6,10,0.6,6,8,0.75,0,2,0,3,3,1,2,1,3
5128,Randy Foye,33-139,G,2/10/17,BRK,,MIA,L,1,26,5,9,0.556,4,7,0.571,1,2,0.5,4,4,1,1,0,1
5129,Tim Frazier,25-360,G,10/26/16,NOP,,DEN,L,1,37,6,10,0.6,5,7,0.714,1,3,0.333,2,4,0.5,0,5,5
5130,Tim Frazier,26-009,G,11/10/16,NOP,@,MIL,W,1,34,3,8,0.375,1,4,0.25,2,4,0.5,7,7,1,0,5,5
5131,Channing Frye,33-296,C-F,3/9/17,CLE,@,DET,L,0,22,5,7,0.714,0,0,,5,7,0.714,0,0,,0,9,9
5132,Channing Frye,33-232,C-F,1/4/17,CLE,,CHI,L,1,30,6,11,0.545,3,5,0.6,3,6,0.5,0,0,,2,3,5
5133,Channing Frye,33-217,C-F,12/20/16,CLE,@,MIL,W,0,25,5,11,0.455,2,4,0.5,3,7,0.429,2,2,1,1,2,3
5134,Danilo Gallinari,28-152,F,1/7/17,DEN,@,OKC,L,1,35,5,18,0.278,5,14,0.357,0,4,0,5,5,1,0,7,7
5135,Danilo Gallinari,28-150,F,1/5/17,DEN,,SAS,L,1,28,5,13,0.385,4,10,0.4,1,3,0.333,4,4,1,0,3,3
5136,Danilo Gallinari,28-079,F,10/26/16,DEN,@,NOP,W,1,38,5,11,0.455,2,5,0.4,3,6,0.5,2,4,0.5,0,3,3
5137,Danilo Gallinari,28-106,F,11/22/16,DEN,,CHI,W,1,37,6,9,0.667,5,7,0.714,1,2,0.5,2,4,0.5,0,5,5
5138,Danilo Gallinari,28-199,F,2/23/17,DEN,@,SAC,L,1,30,5,9,0.556,5,6,0.833,0,3,0,5,5,1,1,5,6
5139,Danilo Gallinari,28-215,F,3/11/17,DEN,@,SAC,W,1,34,5,11,0.455,4,8,0.5,1,3,0.333,4,5,0.8,0,5,5
5140,Danilo Gallinari,28-161,F,1/16/17,DEN,,ORL,W,1,40,5,11,0.455,3,5,0.6,2,6,0.333,3,4,0.75,0,6,6
5141,Langston Galloway,24-343,G,11/16/16,NOP,@,ORL,L,0,21,6,12,0.5,3,4,0.75,3,8,0.375,0,1,0,1,1,2
5142,Marc Gasol,32-008,C,2/6/17,MEM,,SAS,W,1,34,4,12,0.333,4,10,0.4,0,2,0,7,8,0.875,2,6,8
5143,Marc Gasol,32-017,C,2/15/17,MEM,,NOP,L,1,36,6,17,0.353,6,14,0.429,0,3,0,3,3,1,2,10,12
5144,Pau Gasol,36-129,F-C,11/12/16,SAS,@,HOU,W,1,32,5,10,0.5,5,9,0.556,0,1,0,5,8,0.625,1,6,7
5145,Pau Gasol,36-235,F-C,2/26/17,SAS,@,LAL,W,0,20,6,12,0.5,4,10,0.4,2,2,1,1,1,1,0,7,7
5146,Pau Gasol,36-157,F-C,12/10/16,SAS,,BRK,W,1,25,6,13,0.462,5,12,0.417,1,1,1,2,3,0.667,0,5,5
5147,Pau Gasol,36-152,F-C,12/5/16,SAS,@,MIL,W,1,27,6,9,0.667,4,7,0.571,2,2,1,1,1,1,2,7,9
5148,Rudy Gay,30-085,F,11/10/16,SAC,,LAL,L,1,33,6,13,0.462,6,10,0.6,0,3,0,3,4,0.75,0,8,8
5149,Paul George,26-301,F,2/27/17,IND,@,HOU,W,1,30,5,16,0.313,2,7,0.286,3,9,0.333,2,2,1,1,6,7
5150,Taj Gibson,31-204,F,1/14/17,CHI,,NOP,W,1,32,7,14,0.5,7,12,0.583,0,2,0,1,4,0.25,4,11,15
5151,Taj Gibson,31-260,F,3/11/17,OKC,,UTA,W,1,22,7,9,0.778,7,9,0.778,0,0,,1,1,1,1,5,6
5152,Taj Gibson,31-149,F,11/20/16,CHI,@,LAL,W,1,32,7,12,0.583,7,12,0.583,0,0,,1,3,0.333,3,4,7
5153,Taj Gibson,31-229,F,2/8/17,CHI,@,GSW,L,1,23,6,10,0.6,6,10,0.6,0,0,,3,4,0.75,3,6,9
5154,Taj Gibson,31-251,F,3/2/17,OKC,@,POR,L,0,33,6,9,0.667,5,8,0.625,1,1,1,2,2,1,3,3,6
5155,Rudy Gobert,24-216,C,1/28/17,UTA,,MEM,L,1,38,3,5,0.6,3,5,0.6,0,0,,9,9,1,3,6,9
5156,Rudy Gobert,24-253,C,3/6/17,UTA,,NOP,W,1,36,6,10,0.6,6,10,0.6,0,0,,3,3,1,8,8,16
5157,Rudy Gobert,24-228,C,2/9/17,UTA,@,DAL,L,1,36,5,9,0.556,5,9,0.556,0,0,,5,6,0.833,3,12,15
5158,Rudy Gobert,24-193,C,1/5/17,UTA,@,TOR,L,1,36,3,10,0.3,3,10,0.3,0,0,,9,10,0.9,7,9,16
5159,Rudy Gobert,24-245,C,2/26/17,UTA,@,WAS,W,1,36,2,4,0.5,2,4,0.5,0,0,,11,14,0.786,3,16,19
5160,Rudy Gobert,24-190,C,1/2/17,UTA,@,BRK,W,1,38,5,10,0.5,5,10,0.5,0,0,,5,9,0.556,7,9,16
5161,Rudy Gobert,24-243,C,2/24/17,UTA,@,MIL,W,1,33,5,7,0.714,5,7,0.714,0,0,,5,7,0.714,4,12,16
5162,Aaron Gordon,21-110,F,1/4/17,ORL,,ATL,L,1,25,6,11,0.545,4,7,0.571,2,4,0.5,1,1,1,4,6,10
5163,Aaron Gordon,21-170,F,3/5/17,ORL,@,WAS,L,1,35,5,13,0.385,4,8,0.5,1,5,0.2,4,5,0.8,5,6,11
5164,Aaron Gordon,21-052,F,11/7/16,ORL,@,CHI,L,1,30,6,15,0.4,5,11,0.455,1,4,0.25,2,2,1,1,3,4
5165,Eric Gordon,27-320,G,11/9/16,HOU,@,SAS,W,0,34,5,14,0.357,3,7,0.429,2,7,0.286,3,3,1,0,1,1
5166,Eric Gordon,28-001,G,12/26/16,HOU,,PHO,W,0,28,5,13,0.385,2,5,0.4,3,8,0.375,2,2,1,0,3,3
5167,Eric Gordon,28-006,G,12/31/16,HOU,,NYK,W,0,32,5,19,0.263,0,4,0,5,15,0.333,0,0,,0,2,2
5168,Marcin Gortat,32-349,C-F,1/31/17,WAS,,NYK,W,1,31,7,7,1,7,7,1,0,0,,1,1,1,0,10,10
5169,Marcin Gortat,32-345,C-F,1/27/17,WAS,@,ATL,W,1,29,7,8,0.875,7,8,0.875,0,0,,1,2,0.5,6,6,12
5170,Marcin Gortat,32-259,C-F,11/2/16,WAS,,TOR,L,1,43,6,10,0.6,6,10,0.6,0,0,,3,4,0.75,1,9,10
5171,Marcin Gortat,33-022,C-F,3/11/17,WAS,@,POR,W,1,34,6,8,0.75,6,8,0.75,0,0,,3,6,0.5,4,11,15
5172,Jerami Grant,22-326,F,2/1/17,OKC,,CHI,L,0,20,5,8,0.625,4,4,1,1,4,0.25,4,4,1,0,1,1
5173,Jerami Grant,22-282,F,12/19/16,OKC,,ATL,L,0,28,5,7,0.714,2,4,0.5,3,3,1,2,2,1,0,1,1
5174,Draymond Green,26-291,F,12/20/16,GSW,,UTA,W,1,31,6,11,0.545,4,6,0.667,2,5,0.4,1,2,0.5,0,11,11
5175,Draymond Green,26-304,F,1/2/17,GSW,,DEN,W,1,36,5,8,0.625,4,6,0.667,1,2,0.5,4,6,0.667,3,7,10
5176,Draymond Green,26-322,F,1/20/17,GSW,@,HOU,W,1,33,6,12,0.5,3,7,0.429,3,5,0.6,0,0,,3,6,9
5177,Gerald Green,30-347,G-F,1/7/17,BOS,,NOP,W,0,16,3,7,0.429,1,4,0.25,2,3,0.667,7,7,1,0,3,3
5178,JaMychal Green,26-211,F,1/18/17,MEM,@,WAS,L,1,34,6,7,0.857,4,5,0.8,2,2,1,1,2,0.5,2,11,13
5179,Jeff Green,30-190,F,3/6/17,ORL,,NYK,L,0,20,5,10,0.5,4,6,0.667,1,4,0.25,4,4,1,0,1,1
5180,Jeff Green,30-067,F,11/3/16,ORL,,SAC,W,0,19,5,9,0.556,2,5,0.4,3,4,0.75,2,2,1,1,2,3
5181,Blake Griffin,27-360,F,3/11/17,LAC,,PHI,W,1,35,5,12,0.417,5,10,0.5,0,2,0,5,5,1,3,7,10
5182,Tim Hardaway,24-346,G,2/25/17,ATL,@,ORL,L,1,33,6,11,0.545,4,5,0.8,2,6,0.333,1,2,0.5,1,2,3
5183,Tim Hardaway,24-262,G,12/3/16,ATL,@,TOR,L,0,23,6,10,0.6,3,4,0.75,3,6,0.5,0,2,0,0,1,1
5184,Tim Hardaway,24-244,G,11/15/16,ATL,@,MIA,W,0,24,6,10,0.6,5,6,0.833,1,4,0.25,2,3,0.667,1,1,2
5185,James Harden,27-156,G,1/29/17,HOU,@,IND,L,1,32,3,17,0.176,1,7,0.143,2,10,0.2,7,7,1,1,4,5
5186,James Harden,27-110,G,12/14/16,HOU,,SAC,W,1,30,4,7,0.571,1,1,1,3,6,0.5,4,4,1,0,11,11
5187,Maurice Harkless,23-304,F-G,3/11/17,POR,,WAS,L,1,33,7,12,0.583,6,9,0.667,1,3,0.333,0,1,0,3,2,5
5188,Maurice Harkless,23-216,F-G,12/13/16,POR,,OKC,W,1,25,5,10,0.5,4,7,0.571,1,3,0.333,4,4,1,0,4,4
5189,Maurice Harkless,23-195,F-G,11/22/16,POR,@,NYK,L,1,34,6,13,0.462,5,10,0.5,1,3,0.333,2,4,0.5,1,7,8
5190,Montrezl Harrell,23-014,F-C,2/9/17,HOU,@,CHO,W,0,22,7,10,0.7,7,10,0.7,0,0,,1,1,1,2,2,4
5191,Gary Harris,22-111,G,1/3/17,DEN,,SAC,L,1,32,6,11,0.545,3,7,0.429,3,4,0.75,0,0,,1,0,1
5192,Gary Harris,22-173,G,3/6/17,DEN,,SAC,W,1,35,5,7,0.714,3,4,0.75,2,3,0.667,3,4,0.75,0,3,3
5193,Gary Harris,22-136,G,1/28/17,DEN,@,PHO,W,1,35,6,15,0.4,5,9,0.556,1,6,0.167,2,3,0.667,2,6,8
5194,Gary Harris,22-167,G,2/28/17,DEN,@,CHI,W,1,36,7,12,0.583,6,7,0.857,1,5,0.2,0,0,,2,2,4
5195,Gary Harris,22-055,G,11/8/16,DEN,@,MEM,L,1,30,5,13,0.385,3,7,0.429,2,6,0.333,3,4,0.75,1,2,3
5196,Joe Harris,25-127,G,1/12/17,BRK,,NOP,L,1,27,6,10,0.6,4,4,1,2,6,0.333,1,2,0.5,0,2,2
5197,Joe Harris,25-149,G,2/3/17,BRK,,IND,L,0,24,5,10,0.5,2,6,0.333,3,4,0.75,2,2,1,0,2,2
5198,Joe Harris,25-083,G,11/29/16,BRK,,LAC,W,0,39,5,9,0.556,3,5,0.6,2,4,0.5,3,5,0.6,1,0,1
5199,Tobias Harris,24-237,F,3/9/17,DET,,CLE,W,1,41,5,18,0.278,5,15,0.333,0,3,0,5,6,0.833,3,6,9
5200,Tobias Harris,24-133,F,11/25/16,DET,,LAC,W,1,29,7,11,0.636,6,8,0.75,1,3,0.333,0,0,,0,3,3
5201,Tobias Harris,24-147,F,12/9/16,DET,@,MIN,W,1,25,5,8,0.625,2,5,0.4,3,3,1,2,3,0.667,0,0,0
5202,Tobias Harris,24-199,F,1/30/17,DET,@,BOS,L,0,30,7,14,0.5,7,10,0.7,0,4,0,1,2,0.5,0,4,4
5203,Tobias Harris,24-192,F,1/23/17,DET,,SAC,L,0,26,7,11,0.636,6,8,0.75,1,3,0.333,0,0,,2,2,4
5204,Tobias Harris,24-229,F,3/1/17,DET,@,NOP,L,0,27,6,10,0.6,5,8,0.625,1,2,0.5,2,5,0.4,0,6,6
5205,Gerald Henderson,29-052,G,1/30/17,PHI,,SAC,W,0,25,4,7,0.571,4,6,0.667,0,1,0,7,8,0.875,0,2,2
5206,John Henson,26-038,C-F,2/4/17,MIL,@,PHO,W,1,25,6,8,0.75,6,8,0.75,0,0,,3,5,0.6,2,5,7
5207,Juan Hernangomez,21-173,F,3/20/17,DEN,@,HOU,L,1,33,6,11,0.545,5,6,0.833,1,5,0.2,2,2,1,1,4,5
5208,Juan Hernangomez,21-171,F,3/18/17,DEN,,HOU,L,1,28,5,9,0.556,2,5,0.4,3,4,0.75,2,3,0.667,2,3,5
5209,Willy Hernangomez,22-209,C,12/22/16,NYK,,ORL,W,0,21,7,11,0.636,6,8,0.75,1,3,0.333,0,0,,3,2,5
5210,Willy Hernangomez,22-249,C,1/31/17,NYK,@,WAS,L,1,32,5,12,0.417,5,12,0.417,0,0,,5,5,1,6,8,14
5211,Roy Hibbert,29-320,C,10/26/16,CHO,@,MIL,W,1,32,6,9,0.667,6,9,0.667,0,0,,3,3,1,4,6,10
5212,Buddy Hield,22-359,G,12/10/16,NOP,@,LAC,L,1,36,6,13,0.462,4,8,0.5,2,5,0.4,1,1,1,0,3,3
5213,Buddy Hield,23-019,G,1/5/17,NOP,,ATL,L,1,31,5,16,0.313,1,7,0.143,4,9,0.444,1,1,1,2,5,7
5214,Buddy Hield,23-070,G,2/25/17,SAC,,CHO,L,0,26,5,10,0.5,3,5,0.6,2,5,0.4,3,3,1,0,1,1
5215,Buddy Hield,23-045,G,1/31/17,NOP,@,TOR,L,1,33,6,9,0.667,3,4,0.75,3,5,0.6,0,0,,0,6,6
5216,Nene Hilario,34-167,F-C,2/27/17,HOU,,IND,L,0,19,4,7,0.571,4,7,0.571,0,0,,7,9,0.778,5,2,7
5217,George Hill,30-249,G,1/8/17,UTA,@,MEM,L,1,33,6,15,0.4,4,11,0.364,2,4,0.5,1,2,0.5,0,4,4
5218,George Hill,30-305,G,3/5/17,UTA,@,SAC,W,1,40,4,14,0.286,2,8,0.25,2,6,0.333,5,8,0.625,1,4,5
5219,George Hill,30-300,G,2/28/17,UTA,@,OKC,L,1,38,6,15,0.4,6,11,0.545,0,4,0,3,3,1,0,2,2
5220,Jrue Holiday,26-241,G,2/8/17,NOP,,UTA,L,1,31,7,12,0.583,6,8,0.75,1,4,0.25,0,3,0,1,5,6
5221,Jrue Holiday,26-272,G,3/11/17,NOP,@,CHO,W,1,42,6,14,0.429,5,9,0.556,1,5,0.2,2,2,1,0,4,4
5222,Jrue Holiday,26-163,G,11/22/16,NOP,@,ATL,W,0,27,7,15,0.467,7,12,0.583,0,3,0,1,1,1,0,4,4
5223,Justin Holiday,27-299,G,1/29/17,NYK,@,ATL,L,0,36,5,15,0.333,0,2,0,5,13,0.385,0,0,,1,8,9
5224,Justin Holiday,27-270,G,12/31/16,NYK,@,HOU,L,0,30,6,12,0.5,3,4,0.75,3,8,0.375,0,0,,1,5,6
5225,Justin Holiday,27-254,G,12/15/16,NYK,@,GSW,L,0,23,5,8,0.625,3,4,0.75,2,4,0.5,3,4,0.75,0,2,2
5226,Rondae Hollis-Jefferson,22-052,F,2/24/17,BRK,@,DEN,L,1,26,7,11,0.636,6,9,0.667,1,2,0.5,0,2,0,3,5,8
5227,Richaun Holmes,23-137,F-C,3/1/17,PHI,@,MIA,L,0,26,7,10,0.7,7,9,0.778,0,1,0,1,1,1,1,5,6
5228,Richaun Holmes,23-135,F-C,2/27/17,PHI,,GSW,L,0,28,6,11,0.545,5,8,0.625,1,3,0.333,2,2,1,3,2,5
5229,Rodney Hood,24-044,G-F,12/3/16,UTA,,DEN,W,1,28,4,14,0.286,3,8,0.375,1,6,0.167,6,7,0.857,1,5,6
5230,Rodney Hood,24-008,G-F,10/28/16,UTA,,LAL,W,1,32,5,14,0.357,3,6,0.5,2,8,0.25,3,5,0.6,0,6,6
5231,Rodney Hood,24-057,G-F,12/16/16,UTA,,DAL,W,1,31,6,11,0.545,4,6,0.667,2,5,0.4,1,2,0.5,0,3,3
5232,Rodney Hood,24-074,G-F,1/2/17,UTA,@,BRK,W,1,28,6,19,0.316,5,15,0.333,1,4,0.25,2,2,1,1,2,3
5233,Al Horford,30-205,C-F,12/25/16,BOS,@,NYK,W,1,35,7,13,0.538,6,10,0.6,1,3,0.333,0,0,,3,4,7
5234,Al Horford,30-280,C-F,3/10/17,BOS,@,DEN,L,1,33,7,11,0.636,6,9,0.667,1,2,0.5,0,0,,1,5,6
5235,Dwight Howard,31-085,C,3/3/17,ATL,,CLE,L,1,27,6,12,0.5,6,12,0.5,0,0,,3,6,0.5,4,6,10
5236,Dwight Howard,31-030,C,1/7/17,ATL,@,DAL,W,1,31,4,10,0.4,4,10,0.4,0,0,,7,9,0.778,3,17,20
5237,Serge Ibaka,27-062,F-C,11/19/16,ORL,,DAL,W,1,31,6,12,0.5,4,9,0.444,2,3,0.667,1,2,0.5,3,6,9
5238,Serge Ibaka,27-162,F-C,2/27/17,TOR,@,NYK,W,1,36,5,14,0.357,3,8,0.375,2,6,0.333,3,4,0.75,1,3,4
5239,Serge Ibaka,27-120,F-C,1/16/17,ORL,@,DEN,L,1,30,6,12,0.5,3,5,0.6,3,7,0.429,0,0,,0,4,4
5240,Serge Ibaka,27-159,F-C,2/24/17,TOR,,BOS,W,1,36,7,12,0.583,6,9,0.667,1,3,0.333,0,0,,1,6,7
5241,Andre Iguodala,33-016,G-F,2/13/17,GSW,@,DEN,L,0,18,6,9,0.667,5,5,1,1,4,0.25,2,2,1,0,1,1
5242,Andre Iguodala,33-049,G-F,3/18/17,GSW,,MIL,W,0,30,6,10,0.6,5,7,0.714,1,3,0.333,2,2,1,0,4,4
5243,Ersan Ilyasova,29-210,F,12/11/16,PHI,@,DET,W,1,34,6,12,0.5,4,7,0.571,2,5,0.4,1,1,1,1,7,8
5244,Ersan Ilyasova,29-295,F,3/6/17,ATL,,GSW,L,0,27,4,6,0.667,2,3,0.667,2,3,0.667,5,6,0.833,0,2,2
5245,Joe Ingles,29-060,F-G,12/1/16,UTA,,MIA,L,0,22,6,8,0.75,3,4,0.75,3,4,0.75,0,0,,0,4,4
5246,Brandon Ingram,19-140,F,1/20/17,LAL,,IND,W,1,33,6,14,0.429,3,8,0.375,3,6,0.5,0,0,,2,5,7
5247,Brandon Ingram,19-159,F,2/8/17,LAL,@,DET,L,1,27,6,10,0.6,3,6,0.5,3,4,0.75,0,0,,0,4,4
5248,Brandon Ingram,19-137,F,1/17/17,LAL,,DEN,L,1,37,6,14,0.429,4,8,0.5,2,6,0.333,1,2,0.5,1,4,5
5249,Al Jefferson,31-338,C-F,12/7/16,IND,@,PHO,W,0,19,5,7,0.714,5,7,0.714,0,0,,5,8,0.625,3,3,6
5250,Brandon Jennings,27-126,G,1/27/17,NYK,,CHO,W,0,31,6,11,0.545,4,6,0.667,2,5,0.4,1,3,0.333,0,3,3
5251,James Johnson,29-359,F,2/13/17,MIA,,ORL,L,0,28,5,9,0.556,4,7,0.571,1,2,0.5,4,5,0.8,1,2,3
5252,James Johnson,29-266,F,11/12/16,MIA,,UTA,L,0,30,6,7,0.857,5,6,0.833,1,1,1,2,3,0.667,0,4,4
5253,James Johnson,30-005,F,2/25/17,MIA,,IND,W,0,29,6,14,0.429,4,9,0.444,2,5,0.4,1,3,0.333,1,6,7
5254,James Johnson,29-277,F,11/23/16,MIA,@,DET,L,0,35,3,6,0.5,1,2,0.5,2,4,0.5,7,8,0.875,0,4,4
5255,James Johnson,29-332,F,1/17/17,MIA,,HOU,W,0,31,6,14,0.429,5,10,0.5,1,4,0.25,2,2,1,1,7,8
5256,Joe Johnson,35-205,G-F,1/20/17,UTA,@,DAL,W,0,31,7,11,0.636,6,8,0.75,1,3,0.333,0,0,,2,3,5
5257,Joe Johnson,35-201,G-F,1/16/17,UTA,@,PHO,W,0,24,5,9,0.556,2,5,0.4,3,4,0.75,2,2,1,1,3,4
5258,Tyler Johnson,24-234,G,12/27/16,MIA,,OKC,L,0,30,5,13,0.385,3,10,0.3,2,3,0.667,3,4,0.75,0,2,2
5259,Tyler Johnson,24-221,G,12/14/16,MIA,,IND,W,0,33,6,13,0.462,5,8,0.625,1,5,0.2,2,4,0.5,1,4,5
5260,Tyler Johnson,24-172,G,10/26/16,MIA,@,ORL,W,0,28,7,11,0.636,7,10,0.7,0,1,0,1,1,1,1,5,6
5261,Tyler Johnson,24-217,G,12/10/16,MIA,@,CHI,L,0,34,5,13,0.385,3,8,0.375,2,5,0.4,3,3,1,0,3,3
5262,Nikola Jokic,21-362,C-F,2/15/17,DEN,,MIN,L,1,34,6,19,0.316,4,14,0.286,2,5,0.4,1,2,0.5,4,10,14
5263,James Jones,36-071,F-G,12/14/16,CLE,@,MEM,L,0,25,5,8,0.625,2,3,0.667,3,5,0.6,2,3,0.667,0,2,2
5264,Terrence Jones,24-314,F,11/18/16,NOP,,POR,W,0,31,6,10,0.6,4,7,0.571,2,3,0.667,1,2,0.5,0,7,7
5265,Terrence Jones,24-310,F,11/14/16,NOP,,BOS,W,0,30,7,12,0.583,7,11,0.636,0,1,0,1,3,0.333,3,7,10
5266,Terrence Jones,25-026,F,2/4/17,NOP,@,WAS,L,1,30,5,10,0.5,4,7,0.571,1,3,0.333,4,9,0.444,1,3,4
5267,Terrence Jones,25-007,F,1/16/17,NOP,@,IND,L,0,26,6,13,0.462,5,12,0.417,1,1,1,2,5,0.4,4,4,8
5268,DeAndre Jordan,28-228,C,3/6/17,LAC,,BOS,W,1,28,6,7,0.857,6,7,0.857,0,0,,3,16,0.188,3,9,12
5269,Cory Joseph,25-202,G,3/10/17,TOR,@,ATL,L,1,35,6,11,0.545,5,8,0.625,1,3,0.333,2,2,1,2,0,2
5270,Cory Joseph,25-131,G,12/29/16,TOR,@,PHO,L,0,25,6,10,0.6,4,8,0.5,2,2,1,1,2,0.5,1,5,6
5271,Cory Joseph,25-158,G,1/25/17,TOR,@,MEM,L,0,29,5,11,0.455,5,10,0.5,0,1,0,5,6,0.833,0,2,2
5272,Cory Joseph,25-195,G,3/3/17,TOR,@,WAS,W,1,32,7,13,0.538,7,13,0.538,0,0,,1,2,0.5,2,3,5
5273,Frank Kaminsky,23-229,F-C,11/19/16,CHO,@,NOP,L,0,36,6,12,0.5,3,4,0.75,3,8,0.375,0,0,,1,4,5
5274,Frank Kaminsky,23-306,F-C,2/4/17,CHO,@,UTA,L,1,32,6,15,0.4,3,9,0.333,3,6,0.5,0,0,,0,2,2
5275,Frank Kaminsky,23-271,F-C,12/31/16,CHO,,CLE,L,0,30,5,9,0.556,4,5,0.8,1,4,0.25,4,4,1,1,4,5
5276,Enes Kanter,24-230,C,1/5/17,OKC,@,HOU,L,0,22,5,8,0.625,5,8,0.625,0,0,,5,6,0.833,6,7,13
5277,Enes Kanter,24-304,C,3/20/17,OKC,,GSW,L,0,25,6,16,0.375,6,15,0.4,0,1,0,3,4,0.75,6,4,10
5278,Enes Kanter,24-284,C,2/28/17,OKC,,UTA,W,0,27,7,12,0.583,7,12,0.583,0,0,,1,1,1,3,6,9
5279,Michael Kidd-Gilchrist,23-068,F,12/3/16,CHO,,MIN,L,1,30,4,7,0.571,4,7,0.571,0,0,,7,7,1,3,3,6
5280,Michael Kidd-Gilchrist,23-121,F,1/25/17,CHO,,GSW,L,1,35,7,12,0.583,7,12,0.583,0,0,,1,1,1,5,4,9
5281,Sean Kilpatrick,27-038,G,2/13/17,BRK,,MEM,L,0,25,6,15,0.4,3,6,0.5,3,9,0.333,0,0,,1,5,6
5282,Sean Kilpatrick,26-297,G,10/29/16,BRK,@,MIL,L,0,24,5,9,0.556,4,7,0.571,1,2,0.5,4,5,0.8,0,0,0
5283,Sean Kilpatrick,27-050,G,2/25/17,BRK,@,GSW,L,0,29,6,16,0.375,5,11,0.455,1,5,0.2,2,2,1,1,9,10
5284,Brandon Knight,25-004,G,12/6/16,PHO,@,UTA,L,0,27,6,18,0.333,6,16,0.375,0,2,0,3,5,0.6,4,3,7
5285,Brandon Knight,24-359,G,11/25/16,PHO,,MIN,L,1,28,5,12,0.417,4,7,0.571,1,5,0.2,4,4,1,1,3,4
5286,Kyle Korver,35-263,G-F,12/5/16,ATL,,OKC,L,0,32,5,10,0.5,2,4,0.5,3,6,0.5,2,2,1,0,2,2
5287,Kyle Korver,35-226,G-F,10/29/16,ATL,@,PHI,W,1,24,6,8,0.75,3,4,0.75,3,4,0.75,0,0,,0,2,2
5288,Kyle Korver,35-352,G-F,3/4/17,CLE,@,MIA,L,1,27,5,12,0.417,0,3,0,5,9,0.556,0,0,,0,1,1
5289,Mindaugas Kuzminskas,27-077,F,1/4/17,NYK,,MIL,L,0,19,6,10,0.6,4,5,0.8,2,5,0.4,1,2,0.5,2,2,4
5290,Skal Labissiere,20-355,F,3/8/17,SAC,@,SAS,L,0,15,7,10,0.7,7,10,0.7,0,0,,1,1,1,2,4,6
5291,Jeremy Lamb,24-217,G-F,1/2/17,CHO,@,CHI,L,0,27,4,7,0.571,3,4,0.75,1,3,0.333,6,7,0.857,0,6,6
5292,Joffrey Lauvergne,25-056,C-F,11/25/16,OKC,@,DEN,W,0,18,6,8,0.75,3,4,0.75,3,4,0.75,0,0,,1,3,4
5293,Zach LaVine,21-247,G,11/12/16,MIN,,LAC,L,1,40,7,15,0.467,6,10,0.6,1,5,0.2,0,0,,0,3,3
5294,Ty Lawson,29-066,G,1/8/17,SAC,,GSW,L,0,22,4,8,0.5,4,7,0.571,0,1,0,7,8,0.875,0,2,2
5295,Ty Lawson,29-062,G,1/4/17,SAC,,MIA,L,0,29,7,11,0.636,6,10,0.6,1,1,1,0,0,,0,0,0
5296,Ty Lawson,29-118,G,3/1/17,SAC,,BRK,L,0,32,7,11,0.636,6,9,0.667,1,2,0.5,0,0,,1,2,3
5297,Ty Lawson,29-050,G,12/23/16,SAC,@,MIN,W,0,28,5,11,0.455,3,8,0.375,2,3,0.667,3,4,0.75,0,3,3
5298,Courtney Lee,31-130,G,2/10/17,NYK,,DEN,L,1,31,6,10,0.6,3,3,1,3,7,0.429,0,0,,0,3,3
5299,Courtney Lee,31-160,G,3/12/17,NYK,@,BRK,L,1,39,5,10,0.5,3,6,0.5,2,4,0.5,3,4,0.75,1,1,2
5300,Courtney Lee,31-065,G,12/7/16,NYK,,CLE,L,1,31,5,10,0.5,2,3,0.667,3,7,0.429,2,2,1,1,1,2
5301,David Lee,33-269,F,1/23/17,SAS,@,BRK,W,0,25,7,13,0.538,7,13,0.538,0,0,,1,2,0.5,4,3,7
5302,David Lee,33-210,F,11/25/16,SAS,@,BOS,W,0,18,6,9,0.667,6,9,0.667,0,0,,3,3,1,7,5,12
5303,Alex Len,23-244,C,2/15/17,PHO,,LAL,W,0,23,5,10,0.5,5,10,0.5,0,0,,5,6,0.833,3,6,9
5304,Meyers Leonard,24-272,C-F,11/25/16,POR,,NOP,W,0,22,6,11,0.545,3,5,0.6,3,6,0.5,0,0,,1,8,9
5305,Jon Leuer,27-275,F,2/13/17,DET,@,MIL,L,1,36,6,9,0.667,5,7,0.714,1,2,0.5,2,2,1,2,9,11
5306,Jon Leuer,27-298,F,3/8/17,DET,@,IND,L,1,27,7,13,0.538,6,10,0.6,1,3,0.333,0,0,,1,3,4
5307,Jon Leuer,27-254,F,1/23/17,DET,,SAC,L,1,28,6,11,0.545,3,7,0.429,3,4,0.75,0,0,,0,4,4
5308,Jon Leuer,27-175,F,11/5/16,DET,,DEN,W,0,28,6,10,0.6,5,8,0.625,1,2,0.5,2,2,1,2,1,3
5309,Jon Leuer,27-188,F,11/18/16,DET,@,CLE,L,0,22,5,12,0.417,4,10,0.4,1,2,0.5,4,4,1,3,4,7
5310,Caris LeVert,22-208,G-F,3/21/17,BRK,,DET,W,1,25,5,8,0.625,2,4,0.5,3,4,0.75,2,2,1,1,1,2
5311,Jeremy Lin,28-205,G,3/16/17,BRK,@,NYK,W,1,30,5,16,0.313,3,7,0.429,2,9,0.222,3,3,1,0,4,4
5312,Brook Lopez,28-244,C,12/1/16,BRK,,MIL,L,1,28,4,12,0.333,1,4,0.25,3,8,0.375,4,6,0.667,2,2,4
5313,Robin Lopez,28-321,C,2/16/17,CHI,,BOS,W,1,27,7,13,0.538,7,13,0.538,0,0,,1,1,1,5,3,8
5314,Robin Lopez,28-246,C,12/3/16,CHI,@,DAL,L,1,26,7,12,0.583,7,12,0.583,0,0,,1,2,0.5,5,2,7
5315,Kevin Love,28-128,F,1/13/17,CLE,@,SAC,W,1,31,6,16,0.375,5,10,0.5,1,6,0.167,2,2,1,5,12,17
5316,Kevin Love,28-086,F,12/2/16,CLE,@,CHI,L,1,42,5,14,0.357,2,7,0.286,3,7,0.429,2,3,0.667,0,9,9
5317,Kevin Love,28-155,F,2/9/17,CLE,@,OKC,L,1,31,5,12,0.417,5,11,0.455,0,1,0,5,5,1,1,11,12
5318,Kyle Lowry,30-303,G,1/22/17,TOR,,PHO,L,1,37,5,17,0.294,4,8,0.5,1,9,0.111,4,5,0.8,0,4,4
5319,Kyle Lowry,30-317,G,2/5/17,TOR,@,BRK,W,1,39,5,13,0.385,5,8,0.625,0,5,0,5,6,0.833,0,10,10
5320,Kyle Lowry,30-226,G,11/6/16,TOR,,SAC,L,1,39,5,16,0.313,2,6,0.333,3,10,0.3,2,3,0.667,1,3,4
5321,Kyle Lowry,30-324,G,2/12/17,TOR,,DET,L,1,36,5,10,0.5,1,4,0.25,4,6,0.667,1,2,0.5,0,6,6
5322,Trey Lyles,20-362,F,11/1/16,UTA,@,SAS,W,0,29,6,15,0.4,4,8,0.5,2,7,0.286,1,1,1,0,7,7
5323,Shelvin Mack,26-255,G,1/2/17,UTA,@,BRK,W,1,32,7,14,0.5,6,9,0.667,1,5,0.2,0,0,,1,1,2
5324,Shelvin Mack,26-236,G,12/14/16,UTA,,OKC,W,0,29,5,6,0.833,2,3,0.667,3,3,1,2,2,1,1,4,5
5325,Ian Mahinmi,30-122,C,3/7/17,WAS,@,PHO,W,0,26,5,8,0.625,5,8,0.625,0,0,,5,8,0.625,2,7,9
5326,Boban Marjanovic,28-143,C,1/5/17,DET,,CHO,W,0,22,3,4,0.75,3,4,0.75,0,0,,9,11,0.818,9,10,19
5327,Wesley Matthews,30-065,G,12/18/16,DAL,,SAC,W,1,35,6,13,0.462,3,5,0.6,3,8,0.375,0,0,,0,2,2
5328,Wesley Matthews,30-118,G,2/9/17,DAL,,UTA,W,1,42,6,10,0.6,5,7,0.714,1,3,0.333,2,2,1,0,6,6
5329,Wesley Matthews,30-144,G,3/7/17,DAL,,LAL,W,1,25,5,9,0.556,0,2,0,5,7,0.714,0,0,,0,2,2
5330,Wesley Matthews,30-156,G,3/19/17,DAL,@,BRK,W,1,36,5,9,0.556,3,6,0.5,2,3,0.667,3,5,0.6,0,5,5
5331,Luc Mbah a Moute,30-064,F,11/12/16,LAC,@,MIN,W,1,34,6,8,0.75,4,5,0.8,2,3,0.667,1,1,1,1,0,1
5332,Luc Mbah a Moute,30-084,F,12/2/16,LAC,@,NOP,W,1,33,5,9,0.556,2,5,0.4,3,4,0.75,2,2,1,3,3,6
5333,Sheldon McClellan,23-327,G,11/12/16,WAS,@,CHI,L,1,35,5,9,0.556,4,8,0.5,1,1,1,4,5,0.8,1,1,2
5334,C.J. McCollum,25-085,G,12/13/16,POR,,OKC,W,1,30,6,13,0.462,5,10,0.5,1,3,0.333,2,3,0.667,1,3,4
5335,Doug McDermott,24-355,F,12/23/16,CHI,@,CHO,L,0,33,5,12,0.417,2,5,0.4,3,7,0.429,2,2,1,0,4,4
5336,JaVale McGee,28-339,C,12/23/16,GSW,@,DET,W,0,9,6,7,0.857,6,7,0.857,0,0,,3,3,1,0,3,3
5337,Rodney McGruder,25-192,G,2/6/17,MIA,@,MIN,W,1,39,6,8,0.75,3,4,0.75,3,4,0.75,0,0,,4,1,5
5338,C.J. Miles,29-240,G-F,12/14/16,IND,@,MIA,L,0,22,5,10,0.5,2,4,0.5,3,6,0.5,2,2,1,0,2,2
5339,C.J. Miles,29-254,G-F,12/28/16,IND,@,WAS,L,0,25,4,12,0.333,0,4,0,4,8,0.5,3,3,1,0,3,3
5340,C.J. Miles,29-193,G-F,10/28/16,IND,@,BRK,L,0,21,6,10,0.6,4,5,0.8,2,5,0.4,1,1,1,2,5,7
5341,C.J. Miles,29-324,G-F,3/8/17,IND,,DET,W,1,23,5,10,0.5,1,1,1,4,9,0.444,1,1,1,0,1,1
5342,C.J. Miles,29-264,G-F,1/7/17,IND,,NYK,W,0,20,6,11,0.545,3,4,0.75,3,7,0.429,0,0,,1,3,4
5343,C.J. Miles,29-336,G-F,3/20/17,IND,,UTA,W,1,23,4,6,0.667,1,3,0.333,3,3,1,4,4,1,1,1,2
5344,Patty Mills,28-204,G,3/3/17,SAS,@,NOP,W,0,29,5,10,0.5,1,1,1,4,9,0.444,1,2,0.5,1,1,2
5345,Patty Mills,28-214,G,3/13/17,SAS,,ATL,W,1,37,5,13,0.385,2,6,0.333,3,7,0.429,2,3,0.667,0,2,2
5346,Patty Mills,28-117,G,12/6/16,SAS,@,MIN,W,0,27,6,13,0.462,4,6,0.667,2,7,0.286,1,1,1,1,3,4
5347,Paul Millsap,31-279,F,11/15/16,ATL,@,MIA,W,1,35,7,17,0.412,7,15,0.467,0,2,0,1,2,0.5,1,5,6
5348,Nikola Mirotic,25-283,F,11/20/16,CHI,@,LAL,W,1,37,4,9,0.444,1,1,1,3,8,0.375,4,8,0.5,2,13,15
5349,Nikola Mirotic,25-259,F,10/27/16,CHI,,BOS,W,0,29,6,11,0.545,5,5,1,1,6,0.167,2,2,1,2,7,9
5350,Nikola Mirotic,26-034,F,3/17/17,CHI,@,WAS,L,0,32,6,16,0.375,4,8,0.5,2,8,0.25,1,2,0.5,1,6,7
5351,Greg Monroe,26-186,C-F,12/7/16,MIL,,POR,W,0,23,5,7,0.714,5,7,0.714,0,0,,5,8,0.625,0,4,4
5352,Greg Monroe,26-212,C-F,1/2/17,MIL,,OKC,W,0,27,7,10,0.7,7,10,0.7,0,0,,1,4,0.25,1,7,8
5353,Greg Monroe,26-210,C-F,12/31/16,MIL,@,CHI,W,0,34,6,13,0.462,6,13,0.462,0,0,,3,4,0.75,4,8,12
5354,E'Twaun Moore,27-268,G,11/22/16,NOP,@,ATL,W,1,23,6,11,0.545,3,6,0.5,3,5,0.6,0,0,,0,3,3
5355,E'Twaun Moore,27-323,G,1/16/17,NOP,@,IND,L,0,28,5,9,0.556,4,6,0.667,1,3,0.333,4,4,1,1,3,4
5356,E'Twaun Moore,27-278,G,12/2/16,NOP,,LAC,L,0,19,7,12,0.583,6,9,0.667,1,3,0.333,0,0,,1,3,4
5357,E'Twaun Moore,27-351,G,2/13/17,NOP,@,PHO,W,0,24,6,11,0.545,6,9,0.667,0,2,0,3,3,1,0,0,0
5358,E'Twaun Moore,27-296,G,12/20/16,NOP,@,PHI,W,0,18,6,7,0.857,4,4,1,2,3,0.667,1,1,1,0,0,0
5359,E'Twaun Moore,27-271,G,11/25/16,NOP,@,POR,L,1,23,6,11,0.545,3,8,0.375,3,3,1,0,2,0,0,1,1
5360,E'Twaun Moore,27-253,G,11/7/16,NOP,@,GSW,L,1,31,6,11,0.545,5,8,0.625,1,3,0.333,2,2,1,1,2,3
5361,Marcus Morris,27-098,F,12/9/16,DET,@,MIN,W,1,35,6,12,0.5,3,6,0.5,3,6,0.5,0,0,,0,7,7
5362,Marcus Morris,27-115,F,12/26/16,DET,,CLE,W,1,36,6,15,0.4,3,9,0.333,3,6,0.5,0,0,,0,4,4
5363,Marcus Morris,27-064,F,11/5/16,DET,,DEN,W,1,28,5,10,0.5,4,8,0.5,1,2,0.5,4,4,1,3,3,6
5364,Markieff Morris,27-099,F,12/10/16,WAS,,MIL,W,1,34,5,12,0.417,5,11,0.455,0,1,0,5,8,0.625,2,7,9
5365,Markieff Morris,27-147,F,1/27/17,WAS,@,ATL,W,1,25,4,11,0.364,2,7,0.286,2,4,0.5,5,6,0.833,5,4,9
5366,Markieff Morris,27-097,F,12/8/16,WAS,,DEN,W,1,33,5,12,0.417,5,12,0.417,0,0,,5,5,1,2,1,3
5367,Markieff Morris,27-126,F,1/6/17,WAS,,MIN,W,1,36,6,13,0.462,5,10,0.5,1,3,0.333,2,2,1,0,6,6
5368,Markieff Morris,27-157,F,2/6/17,WAS,,CLE,L,1,30,6,12,0.5,6,10,0.6,0,2,0,3,4,0.75,1,5,6
5369,Anthony Morrow,31-129,G,2/3/17,OKC,,MEM,W,0,19,5,7,0.714,2,3,0.667,3,4,0.75,2,2,1,1,0,1
5370,Anthony Morrow,31-069,G,12/5/16,OKC,@,ATL,W,0,26,5,8,0.625,1,2,0.5,4,6,0.667,1,1,1,0,2,2
5371,Timofey Mozgov,30-176,C,1/8/17,LAL,,ORL,W,1,30,7,7,1,7,7,1,0,0,,1,1,1,2,7,9
5372,Emmanuel Mudiay,20-256,G,11/16/16,DEN,,PHO,W,1,38,7,17,0.412,7,15,0.467,0,2,0,1,1,1,2,3,5
5373,Shabazz Muhammad,24-124,F-G,3/17/17,MIN,@,MIA,L,0,28,7,10,0.7,7,7,1,0,3,0,1,1,1,0,1,1
5374,Shabazz Muhammad,24-065,F-G,1/17/17,MIN,@,SAS,L,0,23,4,6,0.667,2,3,0.667,2,3,0.667,5,5,1,1,3,4
5375,Shabazz Muhammad,24-082,F-G,2/3/17,MIN,@,DET,L,0,23,6,11,0.545,3,7,0.429,3,4,0.75,0,0,,0,0,0
5376,Shabazz Muhammad,24-094,F-G,2/15/17,MIN,@,DEN,W,0,17,5,7,0.714,5,6,0.833,0,1,0,5,5,1,0,3,3
5377,Shabazz Muhammad,23-358,F-G,11/5/16,MIN,@,OKC,L,0,21,6,9,0.667,6,9,0.667,0,0,,3,3,1,3,1,4
5378,Shabazz Muhammad,24-042,F-G,12/25/16,MIN,@,OKC,L,0,25,5,8,0.625,5,7,0.714,0,1,0,5,5,1,0,1,1
5379,Jamal Murray,19-293,G,12/12/16,DEN,@,DAL,L,0,28,7,14,0.5,6,9,0.667,1,5,0.2,0,1,0,2,4,6
5380,Jameer Nelson,35-037,G,3/18/17,DEN,,HOU,L,1,39,6,14,0.429,4,7,0.571,2,7,0.286,1,2,0.5,2,5,7
5381,Jameer Nelson,34-310,G,12/15/16,DEN,,POR,W,0,26,6,11,0.545,5,9,0.556,1,2,0.5,2,2,1,0,0,0
5382,Joakim Noah,31-310,C,12/31/16,NYK,@,HOU,L,1,29,7,10,0.7,7,10,0.7,0,0,,1,3,0.333,4,12,16
5383,Nerlens Noel,22-327,C-F,3/3/17,DAL,,MEM,W,1,35,6,10,0.6,6,10,0.6,0,0,,3,6,0.5,4,13,17
5384,Dirk Nowitzki,38-224,F,1/29/17,DAL,@,SAS,W,1,28,5,11,0.455,3,8,0.375,2,3,0.667,3,3,1,2,8,10
5385,Dirk Nowitzki,38-159,F,11/25/16,DAL,@,CLE,L,1,27,7,18,0.389,6,13,0.462,1,5,0.2,0,0,,1,5,6
5386,Jusuf Nurkic,22-132,C,1/2/17,DEN,@,GSW,L,0,21,6,8,0.75,6,8,0.75,0,0,,3,4,0.75,0,6,6
5387,Johnny O'Bryant,23-276,F-C,3/4/17,CHO,@,DEN,W,0,15,7,9,0.778,6,7,0.857,1,2,0.5,0,0,,3,3,6
5388,Jahlil Okafor,20-349,C-F,11/28/16,PHI,@,TOR,L,1,25,7,14,0.5,7,14,0.5,0,0,,1,2,0.5,3,2,5
5389,Jahlil Okafor,21-046,C-F,1/30/17,PHI,,SAC,W,1,22,5,11,0.455,5,11,0.455,0,0,,5,6,0.833,3,1,4
5390,Jahlil Okafor,20-330,C-F,11/9/16,PHI,@,IND,L,1,24,7,11,0.636,7,11,0.636,0,0,,1,5,0.2,1,2,3
5391,Jahlil Okafor,20-328,C-F,11/7/16,PHI,,UTA,L,0,22,7,14,0.5,7,14,0.5,0,0,,1,2,0.5,2,2,4
5392,Jahlil Okafor,20-342,C-F,11/21/16,PHI,,MIA,W,0,25,7,13,0.538,7,13,0.538,0,0,,1,3,0.333,1,2,3
5393,Jahlil Okafor,20-354,C-F,12/3/16,PHI,,BOS,L,1,33,6,9,0.667,6,9,0.667,0,0,,3,4,0.75,0,4,4
5394,Victor Oladipo,24-272,G,1/31/17,OKC,@,SAS,L,1,32,5,12,0.417,4,9,0.444,1,3,0.333,4,4,1,1,3,4
5395,Victor Oladipo,24-248,G,1/7/17,OKC,,DEN,W,1,33,7,19,0.368,7,11,0.636,0,8,0,1,2,0.5,1,2,3
5396,Victor Oladipo,24-266,G,1/25/17,OKC,@,NOP,W,1,35,5,11,0.455,2,4,0.5,3,7,0.429,2,3,0.667,0,4,4
5397,Victor Oladipo,24-214,G,12/4/16,OKC,,NOP,W,1,35,6,15,0.4,5,7,0.714,1,8,0.125,2,7,0.286,0,5,5
5398,Victor Oladipo,24-241,G,12/31/16,OKC,,LAC,W,1,29,4,9,0.444,2,4,0.5,2,5,0.4,5,5,1,0,4,4
5399,Kelly Olynyk,25-300,C-F,2/13/17,BOS,@,DAL,W,0,29,6,10,0.6,5,7,0.714,1,3,0.333,2,2,1,2,5,7
5400,Kelly Olynyk,25-272,C-F,1/16/17,BOS,,CHO,W,0,26,6,9,0.667,4,7,0.571,2,2,1,1,2,0.5,3,6,9
5401,Kelly Oubre,21-005,F,12/14/16,WAS,,CHO,W,1,40,7,12,0.583,6,8,0.75,1,4,0.25,0,1,0,0,6,6
5402,Zaza Pachulia,32-316,C,12/22/16,GSW,@,BRK,W,1,26,6,9,0.667,6,9,0.667,0,0,,3,4,0.75,7,7,14
5403,Jabari Parker,21-263,F,12/3/16,MIL,,BRK,W,1,33,6,13,0.462,6,11,0.545,0,2,0,3,7,0.429,2,6,8
5404,Jabari Parker,21-295,F,1/4/17,MIL,@,NYK,W,1,37,4,10,0.4,3,7,0.429,1,3,0.333,6,8,0.75,0,4,4
5405,Jabari Parker,21-309,F,1/18/17,MIL,@,HOU,L,1,31,5,15,0.333,5,13,0.385,0,2,0,5,7,0.714,2,4,6
5406,Tony Parker,34-231,G,1/3/17,SAS,,TOR,W,1,22,6,9,0.667,5,8,0.625,1,1,1,2,2,1,0,2,2
5407,Patrick Patterson,27-287,F,12/26/16,TOR,@,POR,W,0,31,5,12,0.417,0,1,0,5,11,0.455,0,0,,3,5,8
5408,Chris Paul,31-215,G,12/7/16,LAC,,GSW,L,1,32,7,14,0.5,6,8,0.75,1,6,0.167,0,0,,1,5,6
5409,Chris Paul,31-296,G,2/26/17,LAC,,CHO,W,1,41,4,18,0.222,2,12,0.167,2,6,0.333,5,6,0.833,0,9,9
5410,Chris Paul,31-180,G,11/2/16,LAC,,OKC,L,1,33,4,11,0.364,2,7,0.286,2,4,0.5,5,6,0.833,1,10,11
5411,Cameron Payne,22-185,G,2/9/17,OKC,,CLE,W,0,13,6,12,0.5,3,7,0.429,3,5,0.6,0,0,,0,1,1
5412,Elfrid Payton,22-317,G,1/4/17,ORL,,ATL,L,1,35,6,13,0.462,5,10,0.5,1,3,0.333,2,2,1,1,3,4
5413,Elfrid Payton,23-003,G,2/25/17,ORL,,ATL,W,1,28,3,8,0.375,3,8,0.375,0,0,,9,10,0.9,3,6,9
5414,Elfrid Payton,22-249,G,10/28/16,ORL,@,DET,L,1,28,6,13,0.462,5,9,0.556,1,4,0.25,2,2,1,1,4,5
5415,Elfrid Payton,22-277,G,11/25/16,ORL,,WAS,L,1,26,6,12,0.5,6,11,0.545,0,1,0,3,4,0.75,2,3,5
5416,Elfrid Payton,22-353,G,2/9/17,ORL,,PHI,L,0,26,7,11,0.636,7,9,0.778,0,2,0,1,2,0.5,0,1,1
5417,Elfrid Payton,23-011,G,3/5/17,ORL,@,WAS,L,1,30,7,8,0.875,7,7,1,0,1,0,1,2,0.5,2,3,5
5418,Mason Plumlee,27-008,C-F,3/13/17,DEN,,LAL,W,1,36,6,9,0.667,6,9,0.667,0,0,,3,4,0.75,1,9,10
5419,Mason Plumlee,26-330,C-F,1/29/17,POR,,GSW,L,1,30,7,14,0.5,7,14,0.5,0,0,,1,3,0.333,3,8,11
5420,Mason Plumlee,26-306,C-F,1/5/17,POR,,LAL,W,1,31,6,7,0.857,6,7,0.857,0,0,,3,8,0.375,1,6,7
5421,Otto Porter,23-166,F,11/16/16,WAS,@,PHI,L,1,41,5,17,0.294,3,12,0.25,2,5,0.4,3,4,0.75,5,8,13
5422,Otto Porter,23-182,F,12/2/16,WAS,@,SAS,L,1,37,6,10,0.6,5,7,0.714,1,3,0.333,2,2,1,0,12,12
5423,Otto Porter,23-196,F,12/16/16,WAS,,DET,W,1,34,6,10,0.6,3,6,0.5,3,4,0.75,0,0,,0,8,8
5424,Otto Porter,23-178,F,11/28/16,WAS,,SAC,W,1,30,6,9,0.667,4,5,0.8,2,4,0.5,1,2,0.5,1,8,9
5425,Kristaps Porzingis,21-170,F-C,1/19/17,NYK,,WAS,L,0,29,6,11,0.545,6,8,0.75,0,3,0,3,3,1,3,2,5
5426,Kristaps Porzingis,21-124,F-C,12/4/16,NYK,,SAC,W,1,35,6,18,0.333,5,12,0.417,1,6,0.167,2,2,1,3,11,14
5427,Kristaps Porzingis,21-180,F-C,1/29/17,NYK,@,ATL,L,1,30,6,14,0.429,6,11,0.545,0,3,0,3,3,1,3,2,5
5428,Dwight Powell,25-138,F-C,12/5/16,DAL,,CHO,L,0,32,7,11,0.636,7,11,0.636,0,0,,1,3,0.333,4,3,7
5429,Julius Randle,22-038,F,1/6/17,LAL,,MIA,W,1,25,6,9,0.667,6,9,0.667,0,0,,3,3,1,0,6,6
5430,Julius Randle,21-347,F,11/10/16,LAL,@,SAC,W,1,26,4,10,0.4,4,9,0.444,0,1,0,7,7,1,1,7,8
5431,Julius Randle,21-345,F,11/8/16,LAL,,DAL,L,1,31,6,12,0.5,6,12,0.5,0,0,,3,4,0.75,5,5,10
5432,Julius Randle,22-033,F,1/1/17,LAL,,TOR,L,1,36,3,10,0.3,3,10,0.3,0,0,,9,10,0.9,3,6,9
5433,Julius Randle,22-073,F,2/10/17,LAL,@,MIL,W,1,26,6,12,0.5,6,11,0.545,0,1,0,3,6,0.5,1,6,7
5434,Zach Randolph,35-205,F,2/6/17,MEM,,SAS,W,0,23,6,13,0.462,6,13,0.462,0,0,,3,3,1,3,3,6
5435,Zach Randolph,35-113,F,11/6/16,MEM,,POR,L,0,20,6,11,0.545,5,10,0.5,1,1,1,2,2,1,1,6,7
5436,Zach Randolph,35-111,F,11/4/16,MEM,,LAC,L,0,28,6,11,0.545,6,10,0.6,0,1,0,3,5,0.6,1,8,9
5437,Zach Randolph,35-183,F,1/15/17,MEM,,CHI,L,0,33,7,19,0.368,6,18,0.333,1,1,1,0,0,,8,8,16
5438,J.J. Redick,32-258,G,3/9/17,LAC,@,MEM,W,1,18,3,5,0.6,2,3,0.667,1,2,0.5,8,8,1,0,2,2
5439,J.J. Redick,32-236,G,2/15/17,LAC,,ATL,W,1,25,5,11,0.455,0,3,0,5,8,0.625,0,0,,0,1,1
5440,J.J. Redick,32-163,G,12/4/16,LAC,,IND,L,1,31,5,15,0.333,0,4,0,5,11,0.455,0,0,,0,3,3
5441,Josh Richardson,23-065,G,11/19/16,MIA,@,WAS,W,1,34,4,8,0.5,0,2,0,4,6,0.667,3,5,0.6,1,6,7
5442,Josh Richardson,23-072,G,11/26/16,MIA,,MEM,L,1,29,5,12,0.417,2,5,0.4,3,7,0.429,2,2,1,1,2,3
5443,Austin Rivers,24-166,G,1/14/17,LAC,,LAL,W,1,31,7,14,0.5,6,9,0.667,1,5,0.2,0,0,,0,1,1
5444,Austin Rivers,24-196,G,2/13/17,LAC,@,UTA,W,1,32,6,12,0.5,3,8,0.375,3,4,0.75,0,0,,0,3,3
5445,Austin Rivers,24-120,G,11/29/16,LAC,@,BRK,L,0,26,5,9,0.556,3,5,0.6,2,4,0.5,3,5,0.6,1,1,2
5446,Austin Rivers,24-224,G,3/13/17,LAC,@,UTA,L,0,26,6,11,0.545,4,6,0.667,2,5,0.4,1,4,0.25,0,0,0
5447,Brian Roberts,31-097,G,3/10/17,CHO,,ORL,W,0,24,5,8,0.625,2,5,0.4,3,3,1,2,2,1,0,1,1
5448,Glenn Robinson,22-327,G-F,11/30/16,IND,@,POR,L,1,34,6,10,0.6,4,6,0.667,2,4,0.5,1,1,1,0,4,4
5449,Sergio Rodriguez,30-174,G,12/3/16,PHI,,BOS,L,1,32,5,11,0.455,1,4,0.25,4,7,0.571,1,1,1,2,3,5
5450,Rajon Rondo,31-003,G,2/25/17,CHI,@,CLE,W,0,25,6,12,0.5,6,10,0.6,0,2,0,3,4,0.75,1,1,2
5451,Rajon Rondo,30-284,G,12/2/16,CHI,,CLE,W,1,36,7,12,0.583,6,11,0.545,1,1,1,0,0,,2,8,10
5452,Derrick Rose,28-092,G,1/4/17,NYK,,MIL,L,1,33,7,18,0.389,6,16,0.375,1,2,0.5,0,0,,0,3,3
5453,Derrick Rose,28-031,G,11/4/16,NYK,@,CHI,W,1,38,6,16,0.375,6,16,0.375,0,0,,3,3,1,0,7,7
5454,Derrick Rose,28-043,G,11/16/16,NYK,,DET,W,1,34,7,15,0.467,7,13,0.538,0,2,0,1,2,0.5,0,5,5
5455,Terrence Ross,25-271,F-G,11/2/16,TOR,@,WAS,W,0,18,6,8,0.75,4,5,0.8,2,3,0.667,1,1,1,1,1,2
5456,Terrence Ross,26-043,F-G,3/20/17,ORL,,PHI,W,1,35,4,15,0.267,2,6,0.333,2,9,0.222,5,5,1,0,5,5
5457,Terrence Ross,25-302,F-G,12/3/16,TOR,,ATL,W,0,18,6,8,0.75,3,4,0.75,3,4,0.75,0,0,,0,1,1
5458,Terrence Ross,25-347,F-G,1/17/17,TOR,@,BRK,W,0,30,6,11,0.545,3,4,0.75,3,7,0.429,0,0,,0,4,4
5459,Terry Rozier,22-310,G,1/21/17,BOS,,POR,L,0,22,6,13,0.462,3,7,0.429,3,6,0.5,0,0,,0,3,3
5460,Ricky Rubio,26-138,G,3/8/17,MIN,,LAC,W,1,33,5,12,0.417,4,7,0.571,1,5,0.2,4,4,1,0,6,6
5461,Ricky Rubio,26-112,G,2/10/17,MIN,,NOP,L,1,39,5,10,0.5,4,7,0.571,1,3,0.333,4,6,0.667,0,1,1
5462,D'Angelo Russell,20-304,G,12/23/16,LAL,@,ORL,L,1,30,6,15,0.4,5,11,0.455,1,4,0.25,2,2,1,1,1,2
5463,D'Angelo Russell,20-301,G,12/20/16,LAL,@,CHO,L,1,26,6,13,0.462,5,9,0.556,1,4,0.25,2,2,1,1,4,5
5464,D'Angelo Russell,20-297,G,12/16/16,LAL,@,PHI,W,1,27,4,12,0.333,1,4,0.25,3,8,0.375,4,4,1,0,7,7
5465,D'Angelo Russell,20-310,G,12/29/16,LAL,,DAL,L,1,31,5,15,0.333,4,10,0.4,1,5,0.2,4,4,1,0,4,4
5466,Domantas Sabonis,20-188,F,11/7/16,OKC,,MIA,W,1,30,5,13,0.385,1,6,0.167,4,7,0.571,1,2,0.5,0,10,10
5467,Dario Saric,22-280,F,1/13/17,PHI,,CHO,W,0,21,5,10,0.5,1,4,0.25,4,6,0.667,1,2,0.5,4,2,6
5468,Dennis Schroder,23-079,G,12/3/16,ATL,@,TOR,L,1,24,7,14,0.5,7,13,0.538,0,1,0,1,1,1,0,1,1
5469,Dennis Schroder,23-128,G,1/21/17,ATL,,PHI,W,1,31,6,18,0.333,5,16,0.313,1,2,0.5,2,2,1,0,1,1
5470,Dennis Schroder,23-153,G,2/15/17,ATL,@,LAC,L,1,29,5,15,0.333,3,9,0.333,2,6,0.333,3,4,0.75,1,3,4
5471,Luis Scola,36-224,F,12/10/16,BRK,@,SAS,L,0,16,5,9,0.556,4,8,0.5,1,1,1,4,5,0.8,4,7,11
5472,Thabo Sefolosha,32-231,G-F,12/19/16,ATL,@,OKC,W,1,34,6,10,0.6,5,7,0.714,1,3,0.333,2,2,1,0,6,6
5473,Iman Shumpert,26-204,G,1/16/17,CLE,@,GSW,L,1,30,5,10,0.5,3,5,0.6,2,5,0.4,3,4,0.75,0,9,9
5474,Iman Shumpert,26-130,G,11/3/16,CLE,,BOS,W,0,26,3,7,0.429,1,2,0.5,2,5,0.4,7,8,0.875,0,2,2
5475,Iman Shumpert,26-258,G,3/11/17,CLE,@,ORL,W,1,31,5,7,0.714,2,3,0.667,3,4,0.75,2,2,1,1,3,4
5476,Iman Shumpert,26-140,G,11/13/16,CLE,,CHO,W,0,32,6,9,0.667,3,4,0.75,3,5,0.6,0,0,,1,2,3
5477,Jonathon Simmons,27-073,G-F,11/26/16,SAS,@,WAS,W,0,23,5,6,0.833,4,4,1,1,2,0.5,4,4,1,1,0,1
5478,Marcus Smart,22-294,G,12/25/16,BOS,@,NYK,W,0,28,5,9,0.556,3,5,0.6,2,4,0.5,3,4,0.75,1,1,2
5479,Marcus Smart,22-253,G,11/14/16,BOS,@,NOP,L,1,37,6,12,0.5,3,6,0.5,3,6,0.5,0,0,,2,4,6
5480,Ish Smith,28-211,G,2/1/17,DET,,NOP,W,0,27,6,7,0.857,5,5,1,1,2,0.5,2,4,0.5,0,3,3
5481,Ish Smith,28-222,G,2/12/17,DET,@,TOR,W,0,31,6,10,0.6,5,8,0.625,1,2,0.5,2,4,0.5,0,5,5
5482,Ish Smith,28-220,G,2/10/17,DET,,SAS,L,0,19,6,9,0.667,5,8,0.625,1,1,1,2,2,1,0,3,3
5483,J.R. Smith,31-053,G-F,11/1/16,CLE,,HOU,W,1,34,5,12,0.417,0,1,0,5,11,0.455,0,0,,0,3,3
5484,Jason Smith,30-343,F-C,2/8/17,WAS,@,BRK,W,0,23,5,9,0.556,4,7,0.571,1,2,0.5,4,7,0.571,3,5,8
5485,Marreese Speights,29-148,C-F,12/30/16,LAC,@,HOU,L,0,20,6,11,0.545,4,8,0.5,2,3,0.667,1,1,1,2,5,7
5486,Marreese Speights,29-084,C-F,10/27/16,LAC,@,POR,W,0,16,4,8,0.5,2,5,0.4,2,3,0.667,5,7,0.714,2,0,2
5487,Marreese Speights,29-143,C-F,12/25/16,LAC,@,LAL,L,0,21,3,7,0.429,0,2,0,3,5,0.6,6,6,1,1,3,4
5488,Marreese Speights,29-125,C-F,12/7/16,LAC,,GSW,L,0,16,6,11,0.545,5,8,0.625,1,3,0.333,2,2,1,2,7,9
5489,Marreese Speights,29-093,C-F,11/5/16,LAC,@,SAS,W,0,18,4,8,0.5,3,5,0.6,1,3,0.333,6,6,1,2,6,8
5490,Marreese Speights,29-186,C-F,2/6/17,LAC,@,TOR,L,0,20,5,10,0.5,2,3,0.667,3,7,0.429,2,2,1,1,1,2
5491,Nik Stauskas,23-040,G,11/16/16,PHI,,WAS,W,0,25,6,8,0.75,4,5,0.8,2,3,0.667,1,2,0.5,0,1,1
5492,Nik Stauskas,23-093,G,1/8/17,PHI,@,BRK,W,1,31,4,7,0.571,1,3,0.333,3,4,0.75,4,4,1,0,5,5
5493,Nik Stauskas,23-114,G,1/29/17,PHI,@,CHI,L,1,33,6,14,0.429,3,8,0.375,3,6,0.5,0,0,,0,1,1
5494,Lance Stephenson,26-053,G-F,10/28/16,NOP,,GSW,L,0,31,6,11,0.545,6,10,0.6,0,1,0,3,4,0.75,2,6,8
5495,Jeff Teague,28-250,G,2/15/17,IND,@,CLE,L,1,35,5,14,0.357,3,10,0.3,2,4,0.5,3,3,1,1,3,4
5496,Jeff Teague,28-248,G,2/13/17,IND,,SAS,L,1,30,6,8,0.75,5,7,0.714,1,1,1,2,3,0.667,1,4,5
5497,Jeff Teague,28-177,G,12/4/16,IND,@,LAC,W,1,35,5,12,0.417,4,11,0.364,1,1,1,4,4,1,0,1,1
5498,Garrett Temple,30-315,G,3/19/17,SAC,@,SAS,L,1,26,6,9,0.667,3,6,0.5,3,3,1,0,1,0,0,1,1
5499,Garrett Temple,30-241,G,1/4/17,SAC,,MIA,L,0,31,7,11,0.636,7,7,1,0,4,0,1,1,1,0,0,0
5500,Lance Thomas,28-326,F,3/16/17,NYK,,BRK,L,1,34,5,5,1,4,4,1,1,1,1,4,4,1,1,9,10
5501,Klay Thompson,26-282,G,11/16/16,GSW,@,TOR,W,1,32,4,15,0.267,1,4,0.25,3,11,0.273,4,4,1,1,3,4
5502,Klay Thompson,26-297,G,12/1/16,GSW,,HOU,L,1,47,4,20,0.2,1,7,0.143,3,13,0.231,4,6,0.667,0,6,6
5503,Tristan Thompson,25-235,F-C,11/3/16,CLE,,BOS,W,1,31,6,7,0.857,6,7,0.857,0,0,,3,4,0.75,4,10,14
5504,Tristan Thompson,25-247,F-C,11/15/16,CLE,,TOR,W,1,30,7,8,0.875,7,8,0.875,0,0,,1,1,1,3,8,11
5505,Anthony Tolliver,31-254,F-C,2/10/17,SAC,,ATL,W,0,26,5,7,0.714,0,0,,5,7,0.714,0,0,,1,2,3
5506,Karl-Anthony Towns,20-349,F-C,10/29/16,MIN,@,SAC,L,1,37,7,12,0.583,6,10,0.6,1,2,0.5,0,2,0,2,4,6
5507,Karl-Anthony Towns,21-043,F-C,12/28/16,MIN,@,DEN,L,1,35,7,17,0.412,6,15,0.4,1,2,0.5,0,0,,5,6,11
5508,P.J. Tucker,31-261,F,1/21/17,PHO,@,NYK,W,0,36,6,10,0.6,4,5,0.8,2,5,0.4,1,2,0.5,1,2,3
5509,P.J. Tucker,31-232,F,12/23/16,PHO,,PHI,W,1,35,5,7,0.714,2,3,0.667,3,4,0.75,2,2,1,1,5,6
5510,Evan Turner,28-031,G,11/27/16,POR,,HOU,L,0,23,6,12,0.5,4,8,0.5,2,4,0.5,1,2,0.5,0,6,6
5511,Evan Turner,28-046,G,12/12/16,POR,@,LAC,L,0,30,7,12,0.583,6,8,0.75,1,4,0.25,0,0,,1,3,4
5512,Evan Turner,28-042,G,12/8/16,POR,@,MEM,L,1,30,4,9,0.444,4,8,0.5,0,1,0,7,8,0.875,2,8,10
5513,Evan Turner,28-078,G,1/13/17,POR,,ORL,L,0,24,5,10,0.5,4,6,0.667,1,4,0.25,4,4,1,3,1,4
5514,Myles Turner,20-230,F-C,11/9/16,IND,,PHI,W,1,32,6,10,0.6,5,9,0.556,1,1,1,2,2,1,1,8,9
5515,Myles Turner,20-279,F-C,12/28/16,IND,@,WAS,L,1,34,6,9,0.667,6,8,0.75,0,1,0,3,3,1,0,8,8
5516,Myles Turner,20-328,F-C,2/15/17,IND,@,CLE,L,1,32,7,12,0.583,7,11,0.636,0,1,0,1,3,0.333,3,4,7
5517,Myles Turner,20-241,F-C,11/20/16,IND,@,OKC,W,1,38,2,8,0.25,2,7,0.286,0,1,0,11,12,0.917,2,7,9
5518,Myles Turner,20-224,F-C,11/3/16,IND,@,MIL,L,1,24,6,9,0.667,5,7,0.714,1,2,0.5,2,2,1,1,1,2
5519,Myles Turner,20-353,F-C,3/12/17,IND,,MIA,W,1,30,4,14,0.286,4,11,0.364,0,3,0,7,7,1,5,3,8
5520,Myles Turner,20-281,F-C,12/30/16,IND,,CHI,W,1,29,5,10,0.5,5,10,0.5,0,0,,5,6,0.833,1,2,3
5521,Myles Turner,20-302,F-C,1/20/17,IND,@,LAL,L,1,33,6,12,0.5,6,10,0.6,0,2,0,3,3,1,0,5,5
5522,Jonas Valanciunas,24-296,C,2/26/17,TOR,,POR,W,1,22,7,8,0.875,7,8,0.875,0,0,,1,2,0.5,2,5,7
5523,Jonas Valanciunas,24-201,C,11/23/16,TOR,@,HOU,W,1,31,6,10,0.6,6,10,0.6,0,0,,3,4,0.75,5,11,16
5524,Jonas Valanciunas,24-199,C,11/21/16,TOR,@,LAC,L,1,29,5,8,0.625,5,8,0.625,0,0,,5,5,1,2,6,8
5525,Jonas Valanciunas,24-196,C,11/18/16,TOR,@,DEN,W,1,37,6,9,0.667,6,9,0.667,0,0,,3,7,0.429,2,7,9
5526,Denzel Valentine,23-100,G,2/24/17,CHI,,PHO,W,0,34,5,9,0.556,0,1,0,5,8,0.625,0,0,,0,5,5
5527,Fred VanVleet,22-344,G,2/3/17,TOR,@,ORL,L,0,23,5,12,0.417,3,8,0.375,2,4,0.5,3,3,1,1,2,3
5528,Nikola Vucevic,26-082,C,1/14/17,ORL,@,UTA,L,1,33,7,15,0.467,6,12,0.5,1,3,0.333,0,0,,2,6,8
5529,Nikola Vucevic,26-100,C,2/1/17,ORL,,IND,L,1,38,6,15,0.4,6,13,0.462,0,2,0,3,6,0.5,4,11,15
5530,Dwyane Wade,34-290,G,11/2/16,CHI,@,BOS,L,1,35,5,13,0.385,5,10,0.5,0,3,0,5,6,0.833,0,1,1
5531,Dwyane Wade,35-010,G,1/27/17,CHI,,MIA,L,0,28,6,17,0.353,6,17,0.353,0,0,,3,4,0.75,1,5,6
5532,Dion Waiters,25-081,G,3/1/17,MIA,,PHI,W,1,24,7,12,0.583,7,11,0.636,0,1,0,1,2,0.5,0,4,4
5533,Dion Waiters,24-351,G,11/25/16,MIA,@,MEM,W,1,35,6,15,0.4,5,11,0.455,1,4,0.25,2,2,1,1,3,4
5534,Kemba Walker,26-215,G,12/9/16,CHO,,ORL,W,1,25,7,13,0.538,6,10,0.6,1,3,0.333,0,0,,0,0,0
5535,Kemba Walker,26-232,G,12/26/16,CHO,@,BRK,L,1,35,6,17,0.353,5,12,0.417,1,5,0.2,2,2,1,0,3,3
5536,John Wall,26-093,G,12/8/16,WAS,,DEN,W,1,38,5,14,0.357,5,10,0.5,0,4,0,5,6,0.833,1,6,7
5537,John Wall,26-085,G,11/30/16,WAS,@,OKC,L,1,44,6,20,0.3,4,13,0.308,2,7,0.286,1,2,0.5,3,3,6
5538,John Wall,26-147,G,1/31/17,WAS,,NYK,W,1,34,6,18,0.333,5,16,0.313,1,2,0.5,2,3,0.667,2,2,4
5539,John Wall,26-160,G,2/13/17,WAS,,OKC,W,1,30,4,10,0.4,3,8,0.375,1,2,0.5,6,7,0.857,0,5,5
5540,T.J. Warren,23-056,F,10/31/16,PHO,@,LAC,L,1,29,6,14,0.429,6,13,0.462,0,1,0,3,5,0.6,2,2,4
5541,T.J. Warren,23-133,F,1/16/17,PHO,,UTA,L,1,31,5,7,0.714,4,6,0.667,1,1,1,4,4,1,0,1,1
5542,T.J. Warren,23-183,F,3/7/17,PHO,,WAS,L,1,30,7,13,0.538,6,11,0.545,1,2,0.5,0,0,,1,9,10
5543,T.J. Warren,23-179,F,3/3/17,PHO,,OKC,W,1,27,6,9,0.667,6,9,0.667,0,0,,3,5,0.6,1,6,7
5544,T.J. Warren,23-195,F,3/19/17,PHO,@,DET,L,1,45,6,16,0.375,5,14,0.357,1,2,0.5,2,3,0.667,2,4,6
5545,T.J. Warren,23-125,F,1/8/17,PHO,,CLE,L,1,27,7,9,0.778,6,7,0.857,1,2,0.5,0,0,,1,2,3
5546,C.J. Watson,32-287,G,1/29/17,ORL,@,TOR,W,1,34,5,8,0.625,5,7,0.714,0,1,0,5,5,1,0,1,1
5547,Russell Westbrook,28-128,G,3/20/17,OKC,,GSW,L,1,27,4,16,0.25,3,10,0.3,1,6,0.167,6,7,0.857,0,8,8
5548,Isaiah Whitehead,21-363,G,3/6/17,BRK,@,MEM,W,0,23,5,8,0.625,3,4,0.75,2,4,0.5,3,3,1,1,1,2
5549,Hassan Whiteside,27-263,C,3/3/17,MIA,@,ORL,L,1,35,5,10,0.5,5,10,0.5,0,0,,5,6,0.833,1,17,18
5550,Hassan Whiteside,27-261,C,3/1/17,MIA,,PHI,W,1,22,6,9,0.667,6,9,0.667,0,0,,3,4,0.75,3,8,11
5551,Hassan Whiteside,27-152,C,11/12/16,MIA,,UTA,L,1,33,6,13,0.462,6,13,0.462,0,0,,3,6,0.5,2,12,14
5552,Hassan Whiteside,27-166,C,11/26/16,MIA,,MEM,L,1,34,7,11,0.636,7,11,0.636,0,0,,1,4,0.25,4,8,12
5553,Hassan Whiteside,27-209,C,1/8/17,MIA,@,LAC,L,1,31,7,12,0.583,7,12,0.583,0,0,,1,2,0.5,5,8,13
5554,Andrew Wiggins,21-304,F-G,12/23/16,MIN,,SAC,L,1,40,6,19,0.316,6,13,0.462,0,6,0,3,4,0.75,0,0,0
5555,Andrew Wiggins,22-018,F-G,3/13/17,MIN,,WAS,W,1,39,5,15,0.333,4,13,0.308,1,2,0.5,4,6,0.667,0,5,5
5556,Alan Williams,24-038,F-C,3/7/17,PHO,,WAS,L,0,24,5,9,0.556,5,9,0.556,0,0,,5,9,0.556,3,7,10
5557,Alan Williams,23-295,F-C,11/18/16,PHO,@,IND,W,0,26,6,7,0.857,6,7,0.857,0,0,,3,4,0.75,8,7,15
5558,Deron Williams,32-162,G,12/5/16,DAL,,CHO,L,1,37,6,18,0.333,4,10,0.4,2,8,0.25,1,1,1,0,1,1
5559,Deron Williams,32-175,G,12/18/16,DAL,,SAC,W,1,33,5,10,0.5,4,6,0.667,1,4,0.25,4,4,1,0,2,2
5560,Lou Williams,30-098,G,2/2/17,LAL,@,WAS,L,0,23,4,12,0.333,2,4,0.5,2,8,0.25,5,5,1,0,2,2
5561,Lou Williams,30-087,G,1/22/17,LAL,@,DAL,L,0,20,4,11,0.364,3,5,0.6,1,6,0.167,6,6,1,0,0,0
5562,Lou Williams,30-012,G,11/8/16,LAL,,DAL,L,0,23,5,15,0.333,3,7,0.429,2,8,0.25,3,4,0.75,1,3,4
5563,Marvin Williams,30-184,F,12/20/16,CHO,,LAL,W,1,30,6,10,0.6,5,7,0.714,1,3,0.333,2,2,1,2,3,5
5564,Justise Winslow,20-265,F,12/16/16,MIA,,LAC,L,0,29,6,12,0.5,5,11,0.455,1,1,1,2,4,0.5,2,2,4
5565,Justise Winslow,20-214,F,10/26/16,MIA,@,ORL,W,1,34,7,15,0.467,7,13,0.538,0,2,0,1,1,1,3,5,8
5566,Justise Winslow,20-229,F,11/10/16,MIA,,CHI,L,1,38,6,11,0.545,3,6,0.5,3,5,0.6,0,0,,1,4,5
5567,Nick Young,31-233,G-F,1/20/17,LAL,,IND,W,1,26,5,13,0.385,0,2,0,5,11,0.455,0,0,,1,2,3
5568,Nick Young,31-198,G-F,12/16/16,LAL,@,PHI,W,1,21,5,9,0.556,3,4,0.75,2,5,0.4,3,4,0.75,0,1,1
5569,Nick Young,31-272,G-F,2/28/17,LAL,,CHO,L,1,30,5,11,0.455,0,1,0,5,10,0.5,0,0,,0,0,0
5570,Nick Young,31-172,G-F,11/20/16,LAL,,CHI,L,1,30,5,13,0.385,2,5,0.4,3,8,0.375,2,2,1,1,5,6
5571,Nick Young,31-193,G-F,12/11/16,LAL,,NYK,L,1,20,6,11,0.545,5,5,1,1,6,0.167,2,3,0.667,2,2,4
5572,Nick Young,31-238,G-F,1/25/17,LAL,@,POR,L,1,30,5,10,0.5,2,4,0.5,3,6,0.5,2,2,1,0,4,4
5573,Nick Young,31-164,G-F,11/12/16,LAL,@,NOP,W,1,20,5,9,0.556,0,1,0,5,8,0.625,0,0,,1,0,1
5574,Thaddeus Young,28-184,F,12/22/16,IND,,BOS,L,1,37,6,11,0.545,3,5,0.6,3,6,0.5,0,2,0,0,12,12
5575,Cody Zeller,24-051,F-C,11/25/16,CHO,@,NYK,L,1,23,7,10,0.7,7,10,0.7,0,0,,1,4,0.25,2,4,6
5576,Cody Zeller,24-082,F-C,12/26/16,CHO,@,BRK,L,1,29,7,11,0.636,7,11,0.636,0,0,,1,2,0.5,3,6,9
5577,Cody Zeller,24-021,F-C,10/26/16,CHO,@,MIL,W,0,14,5,6,0.833,5,6,0.833,0,0,,5,6,0.833,1,2,3
5578,Ivica Zubac,19-329,C,2/10/17,LAL,@,MIL,W,0,21,7,11,0.636,7,11,0.636,0,0,,1,1,1,1,5,6
5579,Alex Abrines,23-148,G-F,12/27/16,OKC,@,MIA,W,0,22,5,9,0.556,1,2,0.5,4,7,0.571,0,0,,1,1,2
5580,Quincy Acy,26-107,F,1/21/17,BRK,@,CHO,L,0,17,5,7,0.714,2,3,0.667,3,4,0.75,1,1,1,0,4,4
5581,Steven Adams,23-102,C,10/30/16,OKC,,LAL,W,1,30,6,12,0.5,6,12,0.5,0,0,,2,2,1,3,9,12
5582,Steven Adams,23-131,C,11/28/16,OKC,@,NYK,W,1,32,7,11,0.636,7,11,0.636,0,0,,0,0,,4,6,10
5583,Steven Adams,23-146,C,12/13/16,OKC,@,POR,L,1,26,6,10,0.6,6,9,0.667,0,1,0,2,3,0.667,2,2,4
5584,Steven Adams,23-112,C,11/9/16,OKC,,TOR,L,1,35,3,5,0.6,3,5,0.6,0,0,,8,8,1,6,6,12
5585,Steven Adams,23-108,C,11/5/16,OKC,,MIN,W,1,28,6,7,0.857,6,7,0.857,0,0,,2,2,1,3,5,8
5586,Arron Afflalo,31-102,G,1/25/17,SAC,@,CLE,W,1,40,5,8,0.625,1,2,0.5,4,6,0.667,0,0,,0,2,2
5587,Arron Afflalo,31-036,G,11/20/16,SAC,,TOR,W,0,20,5,7,0.714,4,5,0.8,1,2,0.5,3,3,1,1,4,5
5588,Arron Afflalo,31-137,G,3/1/17,SAC,,BRK,L,1,26,4,7,0.571,2,5,0.4,2,2,1,4,4,1,0,3,3
5589,Arron Afflalo,31-151,G,3/15/17,SAC,@,PHO,W,1,30,5,11,0.455,5,9,0.556,0,2,0,4,4,1,0,4,4
5590,LaMarcus Aldridge,31-192,F-C,1/27/17,SAS,@,NOP,L,1,32,6,20,0.3,6,18,0.333,0,2,0,2,4,0.5,4,10,14
5591,LaMarcus Aldridge,31-115,F-C,11/11/16,SAS,,DET,W,1,37,6,14,0.429,6,14,0.429,0,0,,2,2,1,1,11,12
5592,LaMarcus Aldridge,31-113,F-C,11/9/16,SAS,,HOU,L,1,31,5,15,0.333,5,14,0.357,0,1,0,4,5,0.8,3,2,5
5593,LaMarcus Aldridge,31-149,F-C,12/15/16,SAS,@,PHO,W,1,27,6,11,0.545,6,11,0.545,0,0,,2,2,1,3,4,7
5594,Al-Farouq Aminu,26-145,F,2/13/17,POR,,ATL,L,0,39,5,14,0.357,1,5,0.2,4,9,0.444,0,0,,3,12,15
5595,Al-Farouq Aminu,26-135,F,2/3/17,POR,,DAL,L,0,37,5,10,0.5,1,2,0.5,4,8,0.5,0,0,,0,8,8
5596,Al-Farouq Aminu,26-162,F,3/2/17,POR,,OKC,W,0,32,6,9,0.667,5,6,0.833,1,3,0.333,1,3,0.333,1,5,6
5597,Justin Anderson,23-008,G,11/27/16,DAL,,NOP,W,0,23,4,7,0.571,2,4,0.5,2,3,0.667,4,5,0.8,1,7,8
5598,Kyle Anderson,23-125,F-G,1/23/17,SAS,@,BRK,W,1,35,6,10,0.6,5,9,0.556,1,1,1,1,2,0.5,0,3,3
5599,Ryan Anderson,28-173,F,10/26/16,HOU,@,LAL,L,1,34,6,15,0.4,4,8,0.5,2,7,0.286,0,0,,1,6,7
5600,Ryan Anderson,28-205,F,11/27/16,HOU,@,POR,W,1,27,5,7,0.714,3,3,1,2,4,0.5,2,2,1,1,5,6
5601,Ryan Anderson,28-173,F,10/26/16,HOU,@,LAL,L,1,34,6,15,0.4,4,8,0.5,2,7,0.286,0,0,,1,6,7
5602,Ryan Anderson,28-205,F,11/27/16,HOU,@,POR,W,1,27,5,7,0.714,3,3,1,2,4,0.5,2,2,1,1,5,6
5603,Ryan Anderson,28-217,F,12/9/16,HOU,@,OKC,W,1,32,5,15,0.333,1,4,0.25,4,11,0.364,0,0,,3,5,8
5604,Ryan Anderson,28-279,F,2/9/17,HOU,@,CHO,W,1,35,5,11,0.455,3,5,0.6,2,6,0.333,2,2,1,1,3,4
5605,Giannis Antetokounmpo,22-003,F-G,12/9/16,MIL,,ATL,L,1,24,5,12,0.417,4,8,0.5,1,4,0.25,3,4,0.75,0,6,6
5606,Giannis Antetokounmpo,21-347,F-G,11/17/16,MIL,@,MIA,L,1,35,5,15,0.333,5,13,0.385,0,2,0,4,5,0.8,1,6,7
5607,Carmelo Anthony,32-185,F,11/30/16,NYK,@,MIN,W,1,35,5,16,0.313,4,10,0.4,1,6,0.167,3,4,0.75,1,3,4
5608,Trevor Ariza,31-263,F,3/20/17,HOU,,DEN,W,1,41,5,11,0.455,2,4,0.5,3,7,0.429,1,2,0.5,0,4,4
5609,Trevor Ariza,31-144,F,11/21/16,HOU,@,DET,W,1,35,5,15,0.333,1,5,0.2,4,10,0.4,0,0,,2,4,6
5610,Trevor Ariza,31-184,F,12/31/16,HOU,,NYK,W,1,39,5,15,0.333,3,5,0.6,2,10,0.2,2,2,1,0,7,7
5611,Darrell Arthur,28-313,F,2/1/17,DEN,,MEM,L,0,16,4,9,0.444,0,2,0,4,7,0.571,2,2,1,0,5,5
5612,D.J. Augustin,29-067,G,1/16/17,ORL,@,DEN,L,0,19,5,8,0.625,3,4,0.75,2,4,0.5,2,2,1,0,1,1
5613,Leandro Barbosa,34-095,G,3/3/17,PHO,,OKC,W,0,20,5,9,0.556,4,5,0.8,1,4,0.25,3,3,1,0,1,1
5614,Leandro Barbosa,34-070,G,2/6/17,PHO,@,NOP,L,0,20,5,7,0.714,3,5,0.6,2,2,1,2,2,1,0,2,2
5615,Harrison Barnes,24-156,F,11/2/16,DAL,@,UTA,L,1,36,6,13,0.462,6,10,0.6,0,3,0,2,2,1,0,2,2
5616,Harrison Barnes,24-281,F,3/7/17,DAL,,LAL,W,1,35,6,14,0.429,6,12,0.5,0,2,0,2,4,0.5,1,5,6
5617,Matt Barnes,36-236,F,10/31/16,SAC,@,ATL,L,0,28,4,9,0.444,0,1,0,4,8,0.5,2,2,1,0,5,5
5618,Matt Barnes,37-002,F,3/11/17,GSW,@,SAS,L,1,36,4,11,0.364,2,4,0.5,2,7,0.286,4,4,1,1,8,9
5619,Matt Barnes,36-336,F,2/8/17,SAC,,BOS,W,0,31,3,6,0.5,0,0,,3,6,0.5,5,5,1,0,11,11
5620,Matt Barnes,36-231,F,10/26/16,SAC,@,PHO,W,0,28,6,9,0.667,4,4,1,2,5,0.4,0,0,,1,6,7
5621,Will Barton,25-362,G,1/2/17,DEN,@,GSW,L,0,27,6,11,0.545,4,6,0.667,2,5,0.4,0,0,,2,5,7
5622,Nicolas Batum,27-359,F-G,12/7/16,CHO,,DET,W,1,36,4,10,0.4,3,9,0.333,1,1,1,5,6,0.833,0,15,15
5623,Nicolas Batum,27-357,F-G,12/5/16,CHO,@,DAL,W,1,37,5,14,0.357,5,8,0.625,0,6,0,4,4,1,0,14,14
5624,Kent Bazemore,27-222,G-F,2/8/17,ATL,,DEN,W,1,21,4,8,0.5,1,4,0.25,3,4,0.75,3,4,0.75,1,1,2
5625,Kent Bazemore,27-245,G-F,3/3/17,ATL,,CLE,L,1,35,5,12,0.417,3,7,0.429,2,5,0.4,2,2,1,0,4,4
5626,Kent Bazemore,27-215,G-F,2/1/17,ATL,@,MIA,L,1,23,6,11,0.545,5,8,0.625,1,3,0.333,1,1,1,0,0,0
5627,Bradley Beal,23-150,G,11/25/16,WAS,@,ORL,W,1,38,6,15,0.4,4,9,0.444,2,6,0.333,0,0,,0,2,2
5628,Bradley Beal,23-124,G,10/30/16,WAS,@,MEM,L,1,40,5,17,0.294,3,9,0.333,2,8,0.25,2,2,1,0,3,3
5629,Michael Beasley,27-317,F,11/21/16,MIL,,ORL,W,0,20,7,14,0.5,7,13,0.538,0,1,0,0,0,,1,2,3
5630,Michael Beasley,27-335,F,12/9/16,MIL,,ATL,L,0,23,6,7,0.857,5,6,0.833,1,1,1,1,1,1,2,4,6
5631,Michael Beasley,28-009,F,1/18/17,MIL,@,HOU,L,0,24,6,14,0.429,4,11,0.364,2,3,0.667,0,0,,3,5,8
5632,Michael Beasley,28-037,F,2/15/17,MIL,@,BRK,W,1,22,7,9,0.778,7,9,0.778,0,0,,0,1,0,1,2,3
5633,Marco Belinelli,30-306,G-F,1/25/17,CHO,,GSW,L,0,25,3,5,0.6,2,2,1,1,3,0.333,7,7,1,0,1,1
5634,Marco Belinelli,30-262,G-F,12/12/16,CHO,@,IND,L,0,28,4,9,0.444,3,6,0.5,1,3,0.333,5,5,1,0,3,3
5635,Marco Belinelli,30-302,G-F,1/21/17,CHO,,BRK,W,0,22,5,10,0.5,3,5,0.6,2,5,0.4,2,2,1,0,1,1
5636,Marco Belinelli,30-241,G-F,11/21/16,CHO,,MEM,L,0,31,3,8,0.375,1,4,0.25,2,4,0.5,6,7,0.857,0,5,5
5637,Patrick Beverley,28-210,G,2/7/17,HOU,,ORL,W,1,29,6,11,0.545,5,6,0.833,1,5,0.2,1,1,1,1,5,6
5638,Patrick Beverley,28-251,G,3/20/17,HOU,,DEN,W,1,32,5,9,0.556,1,4,0.25,4,5,0.8,0,0,,1,5,6
5639,Patrick Beverley,28-232,G,3/1/17,HOU,@,LAC,W,1,32,4,9,0.444,0,1,0,4,8,0.5,2,2,1,4,8,12
5640,Bismack Biyombo,24-189,C-F,3/5/17,ORL,@,WAS,L,1,34,5,8,0.625,5,8,0.625,0,0,,4,7,0.571,5,10,15
5641,Bismack Biyombo,24-100,C-F,12/6/16,ORL,@,WAS,W,1,31,4,7,0.571,4,7,0.571,0,0,,6,13,0.462,4,9,13
5642,Nemanja Bjelica,28-178,F,11/3/16,MIN,,DEN,L,0,22,5,13,0.385,3,8,0.375,2,5,0.4,2,2,1,2,6,8
5643,Tarik Black,25-056,C-F,1/17/17,LAL,,DEN,L,0,20,7,13,0.538,7,13,0.538,0,0,,0,0,,6,2,8
5644,Eric Bledsoe,27-052,G,1/30/17,PHO,,MEM,L,1,32,3,11,0.273,2,6,0.333,1,5,0.2,7,11,0.636,0,5,5
5645,Eric Bledsoe,26-363,G,12/6/16,PHO,@,UTA,L,1,25,5,10,0.5,5,10,0.5,0,0,,4,4,1,1,5,6
5646,Eric Bledsoe,27-059,G,2/6/17,PHO,@,NOP,L,1,24,3,9,0.333,2,5,0.4,1,4,0.25,7,8,0.875,0,7,7
5647,Eric Bledsoe,27-083,G,3/2/17,PHO,,CHO,W,1,25,3,4,0.75,2,3,0.667,1,1,1,7,8,0.875,0,4,4
5648,Eric Bledsoe,27-006,G,12/15/16,PHO,,SAS,L,1,30,5,14,0.357,4,9,0.444,1,5,0.2,3,4,0.75,1,3,4
5649,Bojan Bogdanovic,27-303,G-F,2/15/17,BRK,,MIL,L,1,31,6,12,0.5,5,8,0.625,1,4,0.25,1,1,1,1,5,6
5650,Bojan Bogdanovic,27-200,G-F,11/4/16,BRK,,CHO,L,1,33,4,17,0.235,2,8,0.25,2,9,0.222,4,4,1,1,3,4
5651,Bojan Bogdanovic,27-219,G-F,11/23/16,BRK,,BOS,L,1,28,6,12,0.5,4,5,0.8,2,7,0.286,0,0,,0,8,8
5652,Bojan Bogdanovic,27-336,G-F,3/20/17,WAS,@,BOS,L,0,28,5,12,0.417,5,7,0.714,0,5,0,4,5,0.8,3,3,6
5653,Bojan Bogdanovic,27-244,G-F,12/18/16,BRK,@,PHI,L,1,25,5,13,0.385,3,6,0.5,2,7,0.286,2,2,1,1,5,6
5654,Bojan Bogdanovic,27-225,G-F,11/29/16,BRK,,LAC,W,1,26,2,7,0.286,2,4,0.5,0,3,0,10,12,0.833,0,6,6
5655,Devin Booker,20-099,G,2/6/17,PHO,@,NOP,L,1,37,5,20,0.25,4,12,0.333,1,8,0.125,3,4,0.75,0,2,2
5656,Trevor Booker,29-107,F,3/12/17,BRK,,NYK,W,0,25,6,12,0.5,4,9,0.444,2,3,0.667,0,0,,5,4,9
5657,Trevor Booker,29-010,F,12/5/16,BRK,,WAS,L,1,31,6,9,0.667,6,8,0.75,0,1,0,2,4,0.5,6,7,13
5658,Trevor Booker,28-339,F,10/29/16,BRK,@,MIL,L,1,31,4,8,0.5,4,6,0.667,0,2,0,6,6,1,1,13,14
5659,Trevor Booker,29-075,F,2/8/17,BRK,,WAS,L,0,28,6,12,0.5,6,12,0.5,0,0,,2,5,0.4,6,4,10
5660,Avery Bradley,26-100,G,3/6/17,BOS,@,LAC,L,1,26,5,12,0.417,4,9,0.444,1,3,0.333,3,4,0.75,0,3,3
5661,Avery Bradley,25-346,G,11/6/16,BOS,,DEN,L,1,34,6,17,0.353,5,12,0.417,1,5,0.2,1,2,0.5,2,9,11
5662,Avery Bradley,26-004,G,11/30/16,BOS,,DET,L,1,36,4,12,0.333,0,4,0,4,8,0.5,2,2,1,0,6,6
5663,Avery Bradley,26-038,G,1/3/17,BOS,,UTA,W,1,36,4,7,0.571,2,3,0.667,2,4,0.5,4,4,1,0,3,3
5664,Malcolm Brogdon,23-326,G,11/1/16,MIL,@,NOP,W,0,24,6,10,0.6,5,8,0.625,1,2,0.5,1,1,1,1,1,2
5665,Aaron Brooks,31-364,G,1/12/17,IND,@,DEN,L,0,23,6,10,0.6,4,5,0.8,2,5,0.4,0,0,,0,0,0
5666,Aaron Brooks,31-353,G,1/1/17,IND,,ORL,W,0,18,6,9,0.667,4,6,0.667,2,3,0.667,0,0,,0,2,2
5667,Jaylen Brown,20-137,F,3/10/17,BOS,@,DEN,L,0,22,5,8,0.625,3,3,1,2,5,0.4,2,3,0.667,1,1,2
5668,Jaylen Brown,20-108,F,2/9/17,BOS,@,POR,W,1,33,3,7,0.429,1,4,0.25,2,3,0.667,6,8,0.75,1,6,7
5669,Jaylen Brown,20-132,F,3/5/17,BOS,@,PHO,L,1,30,4,8,0.5,3,7,0.429,1,1,1,5,10,0.5,2,4,6
5670,Jimmy Butler,27-182,G-F,3/15/17,CHI,,MEM,L,1,40,4,16,0.25,4,13,0.308,0,3,0,6,8,0.75,3,4,7
5671,Jose Calderon,35-164,G,3/11/17,ATL,@,MEM,W,0,19,4,6,0.667,2,3,0.667,2,3,0.667,4,5,0.8,0,3,3
5672,Kentavious Caldwell-Pope,23-268,G,11/12/16,DET,@,DEN,W,1,35,4,11,0.364,3,6,0.5,1,5,0.2,5,6,0.833,0,1,1
5673,Kentavious Caldwell-Pope,23-340,G,1/23/17,DET,,SAC,L,1,37,4,14,0.286,3,6,0.5,1,8,0.125,5,6,0.833,0,5,5
5674,Clint Capela,22-210,F-C,12/14/16,HOU,,SAC,W,1,18,7,10,0.7,7,10,0.7,0,0,,0,1,0,1,1,2
5675,Clint Capela,22-261,F-C,2/3/17,HOU,,CHI,W,1,32,7,8,0.875,7,8,0.875,0,0,,0,0,,2,7,9
5676,Clint Capela,22-287,F-C,3/1/17,HOU,@,LAC,W,1,26,4,9,0.444,4,9,0.444,0,0,,6,7,0.857,6,6,12
5677,Clint Capela,22-173,F-C,11/7/16,HOU,@,WAS,W,1,27,7,10,0.7,7,10,0.7,0,0,,0,2,0,2,4,6
5678,DeMarre Carroll,30-179,F,1/22/17,TOR,,PHO,L,1,32,4,12,0.333,2,7,0.286,2,5,0.4,4,4,1,1,3,4
5679,DeMarre Carroll,30-121,F,11/25/16,TOR,@,MIL,W,1,26,4,9,0.444,0,1,0,4,8,0.5,2,2,1,0,1,1
5680,Vince Carter,40-018,G-F,2/13/17,MEM,@,BRK,W,0,20,5,8,0.625,1,3,0.333,4,5,0.8,0,0,,0,3,3
5681,Vince Carter,39-332,G-F,12/23/16,MEM,,HOU,W,0,22,5,8,0.625,1,2,0.5,4,6,0.667,0,0,,0,4,4
5682,Vince Carter,39-340,G-F,12/31/16,MEM,@,SAC,W,0,21,5,8,0.625,1,2,0.5,4,6,0.667,0,0,,0,3,3
5683,Vince Carter,40-006,G-F,2/1/17,MEM,@,DEN,W,0,26,4,6,0.667,1,3,0.333,3,3,1,3,4,0.75,1,4,5
5684,Michael Carter-Williams,25-092,G,1/10/17,CHI,@,WAS,L,1,29,4,12,0.333,4,10,0.4,0,2,0,6,7,0.857,0,7,7
5685,Michael Carter-Williams,25-097,G,1/15/17,CHI,@,MEM,W,1,27,5,8,0.625,5,7,0.714,0,1,0,4,5,0.8,1,6,7
5686,Willie Cauley-Stein,23-174,F-C,2/8/17,SAC,,BOS,W,0,24,5,8,0.625,5,8,0.625,0,0,,4,4,1,1,4,5
5687,Willie Cauley-Stein,23-209,F-C,3/15/17,SAC,@,PHO,W,1,33,6,11,0.545,6,11,0.545,0,0,,2,6,0.333,4,7,11
5688,Willie Cauley-Stein,23-193,F-C,2/27/17,SAC,,MIN,L,1,34,5,11,0.455,5,11,0.455,0,0,,4,8,0.5,0,6,6
5689,Willie Cauley-Stein,23-170,F-C,2/4/17,SAC,,GSW,W,0,18,7,12,0.583,7,12,0.583,0,0,,0,0,,0,4,4
5690,Tyson Chandler,34-070,C,12/11/16,PHO,,NOP,L,1,36,5,6,0.833,5,6,0.833,0,0,,4,5,0.8,7,14,21
5691,Tyson Chandler,34-102,C,1/12/17,PHO,,DAL,L,1,38,5,8,0.625,5,8,0.625,0,0,,4,6,0.667,7,12,19
5692,Wilson Chandler,29-252,F,1/17/17,DEN,@,LAL,W,0,26,5,11,0.455,5,9,0.556,0,2,0,4,5,0.8,2,4,6
5693,Wilson Chandler,29-292,F,2/26/17,DEN,,MEM,L,1,36,5,15,0.333,3,8,0.375,2,7,0.286,2,2,1,6,3,9
5694,Wilson Chandler,29-272,F,2/6/17,DEN,,DAL,W,1,40,6,11,0.545,6,9,0.667,0,2,0,2,2,1,0,10,10
5695,Marquese Chriss,19-164,F,12/13/16,PHO,,NYK,W,1,31,5,12,0.417,4,9,0.444,1,3,0.333,3,3,1,4,8,12
5696,Ian Clark,25-311,G,1/12/17,GSW,,DET,W,0,16,4,8,0.5,1,4,0.25,3,4,0.75,3,4,0.75,0,2,2
5697,Jordan Clarkson,24-271,G,3/5/17,LAL,,NOP,L,0,24,4,9,0.444,4,7,0.571,0,2,0,6,6,1,0,2,2
5698,Jordan Clarkson,24-178,G,12/2/16,LAL,@,TOR,L,0,31,4,15,0.267,1,6,0.167,3,9,0.333,3,3,1,1,0,1
5699,Jordan Clarkson,24-262,G,2/24/17,LAL,@,OKC,L,0,29,6,17,0.353,4,9,0.444,2,8,0.25,0,2,0,0,5,5
5700,Jordan Clarkson,24-159,G,11/13/16,LAL,@,MIN,L,0,22,6,10,0.6,6,10,0.6,0,0,,2,2,1,0,3,3
5701,Jordan Clarkson,24-185,G,12/9/16,LAL,,PHO,L,1,34,6,17,0.353,6,12,0.5,0,5,0,2,3,0.667,1,1,2
5702,Jordan Clarkson,24-271,G,3/5/17,LAL,,NOP,L,0,24,4,9,0.444,4,7,0.571,0,2,0,6,6,1,0,2,2
5703,Jordan Clarkson,24-178,G,12/2/16,LAL,@,TOR,L,0,31,4,15,0.267,1,6,0.167,3,9,0.333,3,3,1,1,0,1
5704,Darren Collison,29-108,G,12/9/16,SAC,,NYK,L,1,30,5,11,0.455,4,9,0.444,1,2,0.5,3,3,1,0,3,3
5705,Darren Collison,29-138,G,1/8/17,SAC,,GSW,L,1,30,6,9,0.667,4,6,0.667,2,3,0.667,0,0,,0,1,1
5706,Darren Collison,29-167,G,2/6/17,SAC,,CHI,L,1,36,6,13,0.462,4,10,0.4,2,3,0.667,0,0,,0,1,1
5707,Darren Collison,29-176,G,2/15/17,SAC,@,GSW,L,1,28,5,9,0.556,4,7,0.571,1,2,0.5,3,4,0.75,0,1,1
5708,Darren Collison,29-199,G,3/10/17,SAC,,WAS,L,1,33,5,12,0.417,5,9,0.556,0,3,0,4,5,0.8,1,1,2
5709,Mike Conley,29-068,G,12/18/16,MEM,,UTA,L,1,29,3,16,0.188,2,7,0.286,1,9,0.111,7,9,0.778,0,0,0
5710,Mike Conley,29-048,G,11/28/16,MEM,,CHO,L,1,20,6,11,0.545,4,5,0.8,2,6,0.333,0,0,,0,1,1
5711,DeMarcus Cousins,26-079,C-F,10/31/16,SAC,@,ATL,L,1,32,6,16,0.375,5,11,0.455,1,5,0.2,1,3,0.333,2,10,12
5712,Robert Covington,26-002,F,12/16/16,PHI,,LAL,L,1,36,6,16,0.375,6,10,0.6,0,6,0,2,2,1,3,3,6
5713,Robert Covington,26-041,F,1/24/17,PHI,,LAC,W,1,37,6,15,0.4,4,7,0.571,2,8,0.25,0,0,,4,4,8
5714,Allen Crabbe,24-336,G-F,3/11/17,POR,,WAS,L,0,35,5,10,0.5,2,5,0.4,3,5,0.6,1,2,0.5,0,6,6
5715,Allen Crabbe,24-256,G-F,12/21/16,POR,,DAL,L,0,37,5,9,0.556,1,3,0.333,4,6,0.667,0,0,,0,6,6
5716,Allen Crabbe,24-225,G-F,11/20/16,POR,@,BRK,W,0,30,5,10,0.5,1,3,0.333,4,7,0.571,0,0,,1,1,2
5717,Allen Crabbe,24-242,G-F,12/7/16,POR,@,MIL,L,0,25,4,7,0.571,0,1,0,4,6,0.667,2,2,1,0,4,4
5718,Allen Crabbe,24-271,G-F,1/5/17,POR,,LAL,W,0,26,4,10,0.4,2,5,0.4,2,5,0.4,4,4,1,2,2,4
5719,Allen Crabbe,24-207,G-F,11/2/16,POR,@,PHO,L,0,37,5,9,0.556,3,4,0.75,2,5,0.4,2,2,1,0,1,1
5720,Jamal Crawford,36-354,G,3/9/17,LAC,@,MEM,W,0,26,5,9,0.556,2,4,0.5,3,5,0.6,1,1,1,0,4,4
5721,Jamal Crawford,36-250,G,11/25/16,LAC,@,DET,L,0,27,4,12,0.333,3,7,0.429,1,5,0.2,5,6,0.833,0,5,5
5722,Jamal Crawford,36-267,G,12/12/16,LAC,,POR,W,0,23,4,9,0.444,3,7,0.429,1,2,0.5,5,5,1,0,0,0
5723,Jamal Crawford,36-318,G,2/1/17,LAC,@,PHO,W,0,32,5,11,0.455,5,9,0.556,0,2,0,4,6,0.667,1,2,3
5724,Jamal Crawford,37-000,G,3/20/17,LAC,,NYK,W,0,29,5,10,0.5,4,6,0.667,1,4,0.25,3,4,0.75,0,1,1
5725,Jamal Crawford,36-259,G,12/4/16,LAC,,IND,L,0,27,4,10,0.4,4,7,0.571,0,3,0,6,7,0.857,0,2,2
5726,Jamal Crawford,36-360,G,3/15/17,LAC,,MIL,L,0,31,5,8,0.625,4,5,0.8,1,3,0.333,3,3,1,0,2,2
5727,Jamal Crawford,36-323,G,2/6/17,LAC,@,TOR,L,0,27,5,12,0.417,3,6,0.5,2,6,0.333,2,3,0.667,0,1,1
5728,Jamal Crawford,36-225,G,10/31/16,LAC,,PHO,W,0,27,5,10,0.5,5,10,0.5,0,0,,4,4,1,0,2,2
5729,Jae Crowder,26-113,F,10/27/16,BOS,@,CHI,L,1,35,4,6,0.667,3,4,0.75,1,2,0.5,5,5,1,1,5,6
5730,Jae Crowder,26-147,F,11/30/16,BOS,,DET,L,1,36,5,15,0.333,3,5,0.6,2,10,0.2,2,2,1,1,4,5
5731,Jae Crowder,26-210,F,2/1/17,BOS,,TOR,W,1,34,5,13,0.385,4,9,0.444,1,4,0.25,3,4,0.75,3,5,8
5732,Jae Crowder,26-235,F,2/26/17,BOS,@,DET,W,1,33,3,8,0.375,2,4,0.5,1,4,0.25,7,9,0.778,0,11,11
5733,Jae Crowder,26-240,F,3/3/17,BOS,@,LAL,W,1,27,4,6,0.667,2,4,0.5,2,2,1,4,6,0.667,1,5,6
5734,Dante Cunningham,29-323,F,3/11/17,NOP,@,CHO,W,0,34,6,7,0.857,5,5,1,1,2,0.5,1,1,1,2,4,6
5735,Dante Cunningham,29-296,F,2/12/17,NOP,@,SAC,L,1,38,5,12,0.417,1,5,0.2,4,7,0.571,0,0,,1,5,6
5736,Dante Cunningham,29-273,F,1/20/17,NOP,,BRK,L,1,30,5,7,0.714,1,1,1,4,6,0.667,0,0,,3,4,7
5737,Dante Cunningham,29-271,F,1/18/17,NOP,,ORL,W,1,27,7,11,0.636,7,8,0.875,0,3,0,0,0,,2,3,5
5738,Seth Curry,26-172,G,2/11/17,DAL,,ORL,W,1,27,6,12,0.5,4,7,0.571,2,5,0.4,0,0,,1,2,3
5739,Seth Curry,26-099,G,11/30/16,DAL,,SAS,L,0,28,5,11,0.455,3,6,0.5,2,5,0.4,2,2,1,1,1,2
5740,Seth Curry,26-118,G,12/19/16,DAL,@,DEN,L,0,26,5,7,0.714,3,4,0.75,2,3,0.667,2,2,1,1,3,4
5741,Seth Curry,26-152,G,1/22/17,DAL,,LAL,W,1,27,6,8,0.75,4,4,1,2,4,0.5,0,0,,1,1,2
5742,Stephen Curry,28-291,G,12/30/16,GSW,,DAL,W,1,30,5,12,0.417,2,6,0.333,3,6,0.5,1,1,1,0,4,4
5743,Troy Daniels,25-208,G,2/8/17,MEM,,PHO,W,0,22,5,11,0.455,1,2,0.5,4,9,0.444,0,0,,0,3,3
5744,Anthony Davis,23-275,F-C,12/11/16,NOP,@,PHO,W,1,44,4,17,0.235,4,14,0.286,0,3,0,6,6,1,3,9,12
5745,Ed Davis,27-170,F,11/22/16,POR,@,NYK,L,1,33,7,9,0.778,7,9,0.778,0,0,,0,0,,4,6,10
5746,Sam Dekker,22-281,F,2/11/17,HOU,,PHO,W,0,28,6,8,0.75,6,7,0.857,0,1,0,2,3,0.667,3,1,4
5747,Matthew Dellavedova,26-142,G,1/28/17,MIL,,BOS,L,1,28,4,7,0.571,3,5,0.6,1,2,0.5,5,6,0.833,0,3,3
5748,Matthew Dellavedova,26-051,G,10/29/16,MIL,,BRK,W,1,36,5,10,0.5,5,9,0.556,0,1,0,4,4,1,1,2,3
5749,Luol Deng,31-269,F,1/10/17,LAL,,POR,L,1,30,5,10,0.5,4,8,0.5,1,2,0.5,3,4,0.75,4,2,6
5750,DeMar DeRozan,27-222,G,3/17/17,TOR,@,DET,W,1,36,3,9,0.333,3,8,0.375,0,1,0,8,8,1,0,8,8
5751,DeMar DeRozan,27-213,G,3/8/17,TOR,@,NOP,W,1,38,5,15,0.333,5,14,0.357,0,1,0,4,6,0.667,1,1,2
5752,DeMar DeRozan,27-113,G,11/28/16,TOR,,PHI,W,1,31,4,13,0.308,4,13,0.308,0,0,,6,6,1,0,5,5
5753,Gorgui Dieng,26-285,C,10/29/16,MIN,@,SAC,L,1,35,5,9,0.556,5,8,0.625,0,1,0,4,4,1,4,9,13
5754,Gorgui Dieng,26-343,C,12/26/16,MIN,,ATL,W,1,35,6,12,0.5,6,12,0.5,0,0,,2,2,1,2,5,7
5755,Spencer Dinwiddie,23-332,G,3/4/17,BRK,@,POR,L,0,27,4,7,0.571,4,5,0.8,0,2,0,6,6,1,1,2,3
5756,Spencer Dinwiddie,23-258,G,12/20/16,BRK,@,TOR,L,0,22,4,9,0.444,4,6,0.667,0,3,0,6,7,0.857,1,3,4
5757,Toney Douglas,30-273,G,12/14/16,MEM,,CLE,W,0,28,6,10,0.6,4,7,0.571,2,3,0.667,0,1,0,0,6,6
5758,Goran Dragic,30-175,G,10/28/16,MIA,,CHO,L,1,34,4,12,0.333,1,7,0.143,3,5,0.6,3,3,1,1,3,4
5759,Andre Drummond,23-094,C,11/12/16,DET,@,DEN,W,1,27,7,11,0.636,7,11,0.636,0,0,,0,2,0,5,7,12
5760,Andre Drummond,23-123,C,12/11/16,DET,,PHI,L,1,36,6,14,0.429,6,14,0.429,0,0,,2,4,0.5,5,9,14
5761,Andre Drummond,23-210,C,3/8/17,DET,@,IND,L,1,26,6,11,0.545,6,11,0.545,0,0,,2,5,0.4,6,9,15
5762,Andre Drummond,23-208,C,3/6/17,DET,,CHI,W,1,30,5,8,0.625,5,8,0.625,0,0,,4,8,0.5,1,7,8
5763,Andre Drummond,23-166,C,1/23/17,DET,,SAC,L,1,36,6,11,0.545,6,10,0.6,0,1,0,2,5,0.4,2,10,12
5764,Andre Drummond,23-206,C,3/4/17,DET,@,PHI,W,1,32,7,13,0.538,7,13,0.538,0,0,,0,0,,5,9,14
5765,Andre Drummond,23-114,C,12/2/16,DET,@,ATL,W,1,28,6,9,0.667,6,9,0.667,0,0,,2,4,0.5,3,11,14
5766,Jared Dudley,31-126,F-G,11/13/16,PHO,@,GSW,L,0,31,5,9,0.556,2,4,0.5,3,5,0.6,1,2,0.5,0,3,3
5767,Mike Dunleavy,36-099,F-G,12/23/16,CLE,,BRK,W,0,22,6,9,0.667,4,5,0.8,2,4,0.5,0,0,,2,2,4
5768,Kevin Durant,28-053,F-G,11/21/16,GSW,@,IND,W,1,27,3,9,0.333,2,5,0.4,1,4,0.25,7,7,1,0,11,11
5769,Wayne Ellington,29-062,G,12/30/16,MIA,@,BOS,L,0,30,6,11,0.545,4,4,1,2,7,0.286,0,0,,0,1,1
5770,Wayne Ellington,29-038,G,12/6/16,MIA,,NYK,L,1,33,5,14,0.357,1,3,0.333,4,11,0.364,0,0,,0,2,2
5771,Wayne Ellington,29-090,G,1/27/17,MIA,@,CHI,W,0,27,6,16,0.375,4,8,0.5,2,8,0.25,0,0,,0,5,5
5772,Wayne Ellington,29-125,G,3/3/17,MIA,@,ORL,L,0,20,6,10,0.6,4,4,1,2,6,0.333,0,0,,0,2,2
5773,Monta Ellis,31-039,G,12/4/16,IND,@,LAC,W,1,35,5,11,0.455,5,10,0.5,0,1,0,4,5,0.8,0,4,4
5774,Monta Ellis,31-030,G,11/25/16,IND,,BRK,W,1,26,6,6,1,4,4,1,2,2,1,0,0,,0,3,3
5775,Monta Ellis,31-112,G,2/15/17,IND,@,CLE,L,0,31,6,8,0.75,4,6,0.667,2,2,1,0,0,,0,2,2
5776,Joel Embiid,22-236,C-F,11/7/16,PHI,,UTA,L,1,19,4,8,0.5,4,8,0.5,0,0,,6,9,0.667,4,5,9
5777,Joel Embiid,22-227,C-F,10/29/16,PHI,,ATL,L,1,15,5,9,0.556,4,8,0.5,1,1,1,3,4,0.75,0,2,2
5778,Joel Embiid,22-267,C-F,12/8/16,PHI,@,NOP,W,1,27,5,15,0.333,5,10,0.5,0,5,0,4,5,0.8,3,4,7
5779,Tyreke Evans,27-117,G-F,1/14/17,NOP,@,CHI,L,0,22,6,15,0.4,6,12,0.5,0,3,0,2,3,0.667,0,1,1
5780,Tyreke Evans,27-128,G-F,1/25/17,NOP,,OKC,L,0,22,5,11,0.455,4,8,0.5,1,3,0.333,3,6,0.5,0,5,5
5781,Dante Exum,21-127,G,11/17/16,UTA,,CHI,L,1,34,5,12,0.417,3,7,0.429,2,5,0.4,2,2,1,1,3,4
5782,Kenneth Faried,27-013,F,12/2/16,DEN,,HOU,L,1,23,6,15,0.4,6,15,0.4,0,0,,2,2,1,9,2,11
5783,Kenneth Faried,27-073,F,1/31/17,DEN,@,LAL,L,1,28,5,12,0.417,5,12,0.417,0,0,,4,6,0.667,6,11,17
5784,Kenneth Faried,27-008,F,11/27/16,DEN,@,PHO,W,1,28,4,8,0.5,4,8,0.5,0,0,,6,7,0.857,2,7,9
5785,Kay Felder,21-260,G,12/14/16,CLE,@,MEM,L,0,23,4,8,0.5,2,6,0.333,2,2,1,4,6,0.667,1,2,3
5786,Raymond Felton,32-209,G,1/21/17,LAC,@,DEN,L,0,30,6,17,0.353,4,11,0.364,2,6,0.333,0,0,,0,3,3
5787,Raymond Felton,32-211,G,1/23/17,LAC,@,ATL,W,1,30,6,13,0.462,4,9,0.444,2,4,0.5,0,0,,2,3,5
5788,Evan Fournier,24-105,G-F,2/11/17,ORL,@,DAL,L,1,29,6,14,0.429,6,10,0.6,0,4,0,2,4,0.5,1,1,2
5789,Evan Fournier,24-016,G-F,11/14/16,ORL,@,IND,L,1,33,4,15,0.267,3,11,0.273,1,4,0.25,5,5,1,0,2,2
5790,Evan Fournier,24-041,G-F,12/9/16,ORL,@,CHO,L,1,24,6,11,0.545,4,5,0.8,2,6,0.333,0,0,,0,2,2
5791,Evan Fournier,24-067,G-F,1/4/17,ORL,,ATL,L,0,30,6,14,0.429,4,8,0.5,2,6,0.333,0,0,,0,1,1
5792,Evan Fournier,24-039,G-F,12/7/16,ORL,,BOS,L,1,29,4,14,0.286,3,11,0.273,1,3,0.333,5,6,0.833,0,3,3
5793,Evan Fournier,24-132,G-F,3/10/17,ORL,@,CHO,L,1,25,6,13,0.462,4,7,0.571,2,6,0.333,0,0,,0,1,1
5794,Randy Foye,33-163,G,3/6/17,BRK,@,MEM,W,1,16,5,7,0.714,1,3,0.333,4,4,1,0,0,,0,3,3
5795,Randy Foye,33-174,G,3/17/17,BRK,,BOS,L,1,27,4,7,0.571,1,2,0.5,3,5,0.6,3,4,0.75,0,1,1
5796,Tim Frazier,26-136,G,3/17/17,NOP,,HOU,W,0,23,6,11,0.545,5,6,0.833,1,5,0.2,1,2,0.5,1,4,5
5797,Tim Frazier,26-040,G,12/11/16,NOP,@,PHO,W,0,38,4,10,0.4,4,8,0.5,0,2,0,6,7,0.857,3,8,11
5798,Channing Frye,33-282,C-F,2/23/17,CLE,,NYK,W,1,27,5,14,0.357,3,7,0.429,2,7,0.286,2,2,1,0,4,4
5799,Channing Frye,33-190,C-F,11/23/16,CLE,,POR,W,0,14,4,6,0.667,0,0,,4,6,0.667,2,2,1,0,3,3
5800,Channing Frye,33-230,C-F,1/2/17,CLE,,NOP,W,0,25,5,9,0.556,1,2,0.5,4,7,0.571,0,2,0,0,6,6
5801,Channing Frye,33-263,C-F,2/4/17,CLE,@,NYK,W,0,16,5,9,0.556,1,1,1,4,8,0.5,0,2,0,1,2,3
5802,Danilo Gallinari,28-133,F,12/19/16,DEN,,DAL,W,1,34,3,9,0.333,2,6,0.333,1,3,0.333,7,7,1,0,2,2
5803,Danilo Gallinari,28-167,F,1/22/17,DEN,@,MIN,L,1,35,4,10,0.4,2,6,0.333,2,4,0.5,4,4,1,1,5,6
5804,Danilo Gallinari,28-162,F,1/17/17,DEN,@,LAL,W,1,39,6,13,0.462,4,7,0.571,2,6,0.333,0,1,0,0,5,5
5805,Danilo Gallinari,28-122,F,12/8/16,DEN,@,WAS,L,1,32,3,11,0.273,2,3,0.667,1,8,0.125,7,9,0.778,0,4,4
5806,Danilo Gallinari,28-177,F,2/1/17,DEN,,MEM,L,1,30,4,12,0.333,4,9,0.444,0,3,0,6,8,0.75,1,2,3
5807,Langston Galloway,24-331,G,11/4/16,NOP,,PHO,L,0,28,5,10,0.5,1,4,0.25,4,6,0.667,0,0,,0,4,4
5808,Marc Gasol,31-350,C,1/13/17,MEM,@,HOU,W,1,34,6,9,0.667,5,7,0.714,1,2,0.5,1,2,0.5,0,6,6
5809,Paul George,26-238,F,12/26/16,IND,@,CHI,L,1,39,6,14,0.429,5,9,0.556,1,5,0.2,1,1,1,0,3,3
5810,Taj Gibson,31-217,F,1/27/17,CHI,,MIA,L,1,26,4,6,0.667,4,6,0.667,0,0,,6,6,1,2,3,5
5811,Taj Gibson,31-235,F,2/14/17,CHI,,TOR,W,1,27,6,9,0.667,6,8,0.75,0,1,0,2,2,1,0,4,4
5812,Taj Gibson,31-129,F,10/31/16,CHI,@,BRK,W,1,25,7,9,0.778,7,9,0.778,0,0,,0,0,,2,9,11
5813,Manu Ginobili,39-175,G,1/19/17,SAS,,DEN,W,0,20,6,11,0.545,5,8,0.625,1,3,0.333,1,1,1,0,5,5
5814,Manu Ginobili,39-155,G,12/30/16,SAS,,POR,W,0,17,4,8,0.5,2,3,0.667,2,5,0.4,4,4,1,1,6,7
5815,Rudy Gobert,24-230,C,2/11/17,UTA,,BOS,L,1,34,5,10,0.5,5,10,0.5,0,0,,4,5,0.8,4,9,13
5816,Rudy Gobert,24-162,C,12/5/16,UTA,@,LAL,W,1,39,4,7,0.571,4,7,0.571,0,0,,6,11,0.545,8,9,17
5817,Rudy Gobert,24-225,C,2/6/17,UTA,@,ATL,W,1,34,5,5,1,5,5,1,0,0,,4,7,0.571,1,5,6
5818,Aaron Gordon,21-124,F,1/18/17,ORL,@,NOP,L,1,31,6,13,0.462,5,9,0.556,1,4,0.25,1,3,0.333,1,7,8
5819,Eric Gordon,28-066,G,3/1/17,HOU,@,LAC,W,0,27,4,10,0.4,1,1,1,3,9,0.333,3,4,0.75,0,3,3
5820,Eric Gordon,27-336,G,11/25/16,HOU,@,SAC,W,0,29,5,13,0.385,1,1,1,4,12,0.333,0,0,,0,2,2
5821,Eric Gordon,28-035,G,1/29/17,HOU,@,IND,L,0,26,4,11,0.364,3,4,0.75,1,7,0.143,5,7,0.714,0,1,1
5822,Eric Gordon,28-062,G,2/25/17,HOU,,MIN,W,0,30,5,13,0.385,1,3,0.333,4,10,0.4,0,0,,0,1,1
5823,Eric Gordon,27-310,G,10/30/16,HOU,,DAL,W,1,33,5,16,0.313,3,8,0.375,2,8,0.25,2,2,1,0,3,3
5824,Eric Gordon,28-073,G,3/8/17,HOU,,UTA,L,1,40,4,11,0.364,2,4,0.5,2,7,0.286,4,5,0.8,0,2,2
5825,Marcin Gortat,32-264,C-F,11/7/16,WAS,,HOU,L,1,37,5,9,0.556,5,9,0.556,0,0,,4,6,0.667,3,9,12
5826,Marcin Gortat,32-359,C-F,2/10/17,WAS,,IND,W,1,35,7,12,0.583,7,12,0.583,0,0,,0,0,,8,8,16
5827,Marcin Gortat,32-357,C-F,2/8/17,WAS,@,BRK,W,1,41,5,10,0.5,5,10,0.5,0,0,,4,4,1,3,11,14
5828,Marcin Gortat,32-308,C-F,12/21/16,WAS,@,CHI,W,1,35,7,9,0.778,7,9,0.778,0,0,,0,0,,1,10,11
5829,Marcin Gortat,32-256,C-F,10/30/16,WAS,@,MEM,L,1,38,2,3,0.667,2,3,0.667,0,0,,10,10,1,1,11,12
5830,Jerian Grant,24-095,G,1/12/17,CHI,@,NYK,L,0,25,5,10,0.5,3,6,0.5,2,4,0.5,2,3,0.667,0,3,3
5831,Danny Green,29-202,G-F,1/10/17,SAS,,MIL,L,1,26,5,12,0.417,1,3,0.333,4,9,0.444,0,0,,0,3,3
5832,Danny Green,29-264,G-F,3/13/17,SAS,,ATL,W,1,29,5,9,0.556,1,4,0.25,4,5,0.8,0,0,,0,5,5
5833,Danny Green,29-259,G-F,3/8/17,SAS,,SAC,W,1,27,5,13,0.385,1,5,0.2,4,8,0.5,0,0,,0,2,2
5834,Draymond Green,26-360,F,2/27/17,GSW,@,PHI,W,1,37,5,10,0.5,4,7,0.571,1,3,0.333,3,6,0.5,1,5,6
5835,Draymond Green,26-299,F,12/28/16,GSW,,TOR,W,1,38,6,8,0.75,4,5,0.8,2,3,0.667,0,0,,0,6,6
5836,Draymond Green,26-254,F,11/13/16,GSW,,PHO,W,1,37,4,10,0.4,3,5,0.6,1,5,0.2,5,5,1,2,5,7
5837,Draymond Green,26-361,F,2/28/17,GSW,@,WAS,L,1,40,6,11,0.545,4,8,0.5,2,3,0.667,0,0,,1,7,8
5838,Gerald Green,30-350,G-F,1/10/17,BOS,@,TOR,L,0,24,6,12,0.5,6,9,0.667,0,3,0,2,2,1,0,5,5
5839,JaMychal Green,26-268,F,3/16/17,MEM,@,ATL,W,1,26,6,11,0.545,4,7,0.571,2,4,0.5,0,0,,3,9,12
5840,JaMychal Green,26-208,F,1/15/17,MEM,,CHI,L,1,20,6,8,0.75,4,5,0.8,2,3,0.667,0,0,,2,3,5
5841,JaMychal Green,26-172,F,12/10/16,MEM,,GSW,W,1,29,4,7,0.571,2,5,0.4,2,2,1,4,5,0.8,2,8,10
5842,JaMychal Green,26-157,F,11/25/16,MEM,,MIA,L,1,32,5,9,0.556,5,9,0.556,0,0,,4,4,1,3,3,6
5843,Jeff Green,30-114,F,12/20/16,ORL,@,MIA,W,0,32,4,9,0.444,4,8,0.5,0,1,0,6,6,1,0,3,3
5844,Jeff Green,30-098,F,12/4/16,ORL,@,DET,W,0,30,6,11,0.545,4,8,0.5,2,3,0.667,0,0,,0,5,5
5845,Jeff Green,30-095,F,12/1/16,ORL,@,MEM,L,0,27,5,8,0.625,5,5,1,0,3,0,4,5,0.8,0,2,2
5846,Blake Griffin,27-358,F,3/9/17,LAC,@,MEM,W,1,30,4,13,0.308,4,11,0.364,0,2,0,6,8,0.75,3,9,12
5847,Blake Griffin,27-233,F,11/4/16,LAC,@,MEM,W,1,36,5,13,0.385,5,13,0.385,0,0,,4,6,0.667,2,8,10
5848,Blake Griffin,27-231,F,11/2/16,LAC,,OKC,L,1,34,7,21,0.333,7,19,0.368,0,2,0,0,3,0,3,6,9
5849,Tim Hardaway,24-329,G,2/8/17,ATL,,DEN,W,1,38,6,15,0.4,4,8,0.5,2,7,0.286,0,0,,1,1,2
5850,Tim Hardaway,24-275,G,12/16/16,ATL,@,TOR,W,1,36,5,16,0.313,4,11,0.364,1,5,0.2,3,3,1,0,1,1
5851,Tim Hardaway,24-295,G,1/5/17,ATL,@,NOP,W,0,26,5,12,0.417,1,5,0.2,4,7,0.571,0,0,,0,6,6
5852,Tim Hardaway,24-327,G,2/6/17,ATL,,UTA,L,1,29,4,9,0.444,3,7,0.429,1,2,0.5,5,6,0.833,0,3,3
5853,James Harden,27-133,G,1/6/17,HOU,@,ORL,W,1,34,5,15,0.333,5,7,0.714,0,8,0,4,6,0.667,1,5,6
5854,Maurice Harkless,23-244,F-G,1/10/17,POR,@,LAL,W,1,32,5,6,0.833,4,4,1,1,2,0.5,3,4,0.75,0,5,5
5855,Montrezl Harrell,22-350,F-C,1/10/17,HOU,,CHO,W,1,29,5,5,1,5,5,1,0,0,,4,6,0.667,1,2,3
5856,Montrezl Harrell,22-335,F-C,12/26/16,HOU,,PHO,W,1,23,5,6,0.833,5,6,0.833,0,0,,4,6,0.667,1,2,3
5857,Montrezl Harrell,22-342,F-C,1/2/17,HOU,,WAS,W,1,33,6,11,0.545,6,11,0.545,0,0,,2,3,0.667,3,6,9
5858,Devin Harris,33-295,G,12/18/16,DAL,,SAC,W,0,20,5,10,0.5,3,5,0.6,2,5,0.4,2,2,1,0,7,7
5859,Devin Harris,33-306,G,12/29/16,DAL,@,LAL,W,0,21,5,10,0.5,2,5,0.4,3,5,0.6,1,1,1,0,1,1
5860,Devin Harris,33-340,G,2/1/17,DAL,,PHI,W,0,19,3,5,0.6,0,2,0,3,3,1,5,5,1,0,1,1
5861,Devin Harris,34-012,G,3/11/17,DAL,,PHO,L,0,23,3,8,0.375,0,1,0,3,7,0.429,5,6,0.833,0,3,3
5862,Gary Harris,22-142,G,2/3/17,DEN,,MIL,W,1,27,6,13,0.462,4,7,0.571,2,6,0.333,0,0,,0,2,2
5863,Gary Harris,22-168,G,3/1/17,DEN,@,MIL,W,1,34,6,12,0.5,4,6,0.667,2,6,0.333,0,0,,1,2,3
5864,Joe Harris,25-161,G,2/15/17,BRK,,MIL,L,0,21,5,9,0.556,1,3,0.333,4,6,0.667,0,0,,0,1,1
5865,Tobias Harris,24-154,F,12/16/16,DET,@,WAS,L,1,33,5,16,0.313,4,11,0.364,1,5,0.2,3,3,1,2,4,6
5866,Tobias Harris,24-168,F,12/30/16,DET,@,ATL,L,1,38,5,14,0.357,3,8,0.375,2,6,0.333,2,2,1,1,4,5
5867,Tobias Harris,24-203,F,2/3/17,DET,,MIN,W,0,23,5,12,0.417,3,8,0.375,2,4,0.5,2,2,1,0,3,3
5868,Tobias Harris,24-145,F,12/7/16,DET,@,CHO,L,1,39,7,19,0.368,7,12,0.583,0,7,0,0,0,,1,6,7
5869,Tobias Harris,24-177,F,1/8/17,DET,@,POR,W,0,38,7,16,0.438,7,11,0.636,0,5,0,0,0,,0,9,9
5870,Tobias Harris,24-245,F,3/17/17,DET,,TOR,L,1,33,5,10,0.5,5,8,0.625,0,2,0,4,4,1,4,3,7
5871,Spencer Hawes,28-207,C-F,11/21/16,CHO,,MEM,L,0,37,6,14,0.429,4,10,0.4,2,4,0.5,0,0,,1,9,10
5872,Gordon Hayward,26-311,F-G,1/28/17,UTA,,MEM,L,1,36,4,13,0.308,4,10,0.4,0,3,0,6,7,0.857,1,7,8
5873,Gordon Hayward,26-360,F-G,3/18/17,UTA,@,CHI,L,1,36,5,16,0.313,2,8,0.25,3,8,0.375,1,2,0.5,2,4,6
5874,Gerald Henderson,29-064,G,2/11/17,PHI,,MIA,W,1,30,2,11,0.182,2,9,0.222,0,2,0,10,10,1,0,6,6
5875,Gerald Henderson,29-090,G,3/9/17,PHI,@,POR,L,0,29,5,10,0.5,5,9,0.556,0,1,0,4,5,0.8,1,2,3
5876,Gerald Henderson,28-362,G,12/5/16,PHI,,DEN,L,1,26,4,9,0.444,3,5,0.6,1,4,0.25,5,6,0.833,0,5,5
5877,Gerald Henderson,28-343,G,11/16/16,PHI,,WAS,W,1,29,6,11,0.545,6,10,0.6,0,1,0,2,2,1,0,1,1
5878,John Henson,25-348,C-F,12/10/16,MIL,@,WAS,L,1,25,7,10,0.7,7,10,0.7,0,0,,0,0,,2,2,4
5879,John Henson,25-358,C-F,12/20/16,MIL,,CLE,L,1,27,5,7,0.714,5,7,0.714,0,0,,4,6,0.667,2,6,8
5880,Juan Hernangomez,21-073,F,12/10/16,DEN,@,ORL,W,0,18,5,9,0.556,1,4,0.25,4,5,0.8,0,0,,3,1,4
5881,Willy Hernangomez,22-288,C,3/11/17,NYK,@,DET,L,1,27,7,12,0.583,7,12,0.583,0,0,,0,0,,2,7,9
5882,Willy Hernangomez,22-241,C,1/23/17,NYK,@,IND,W,0,24,5,8,0.625,5,8,0.625,0,0,,4,4,1,2,8,10
5883,Willy Hernangomez,22-283,C,3/6/17,NYK,@,ORL,W,0,18,7,10,0.7,7,10,0.7,0,0,,0,0,,4,4,8
5884,Willy Hernangomez,22-166,C,11/9/16,NYK,,BRK,W,0,15,6,7,0.857,6,7,0.857,0,0,,2,2,1,2,4,6
5885,Buddy Hield,22-327,G,11/8/16,NOP,@,SAC,L,0,22,6,16,0.375,5,9,0.556,1,7,0.143,1,2,0.5,0,2,2
5886,Buddy Hield,23-079,G,3/6/17,SAC,@,DEN,L,0,23,4,7,0.571,2,5,0.4,2,2,1,4,5,0.8,0,3,3
5887,Buddy Hield,23-001,G,12/18/16,NOP,@,SAS,L,1,25,6,11,0.545,4,7,0.571,2,4,0.5,0,0,,1,2,3
5888,Buddy Hield,23-009,G,12/26/16,NOP,,DAL,W,1,23,6,8,0.75,4,4,1,2,4,0.5,0,0,,0,2,2
5889,Nene Hilario,34-186,F-C,3/18/17,HOU,@,DEN,W,0,24,6,12,0.5,6,12,0.5,0,0,,2,4,0.5,3,4,7
5890,George Hill,30-255,G,1/14/17,UTA,,ORL,W,1,34,4,13,0.308,4,8,0.5,0,5,0,6,8,0.75,0,0,0
5891,Solomon Hill,25-300,F,1/12/17,NOP,@,BRK,W,1,33,5,10,0.5,3,6,0.5,2,4,0.5,2,2,1,1,8,9
5892,Solomon Hill,25-313,F,1/25/17,NOP,,OKC,L,1,28,6,10,0.6,4,6,0.667,2,4,0.5,0,0,,3,5,8
5893,Jrue Holiday,26-227,G,1/25/17,NOP,,OKC,L,1,32,6,11,0.545,4,7,0.571,2,4,0.5,0,0,,1,1,2
5894,Jrue Holiday,26-220,G,1/18/17,NOP,,ORL,W,1,26,6,13,0.462,4,9,0.444,2,4,0.5,0,0,,1,3,4
5895,Justin Holiday,27-267,G,12/28/16,NYK,@,ATL,L,0,34,5,12,0.417,3,5,0.6,2,7,0.286,2,2,1,1,2,3
5896,Justin Holiday,27-307,G,2/6/17,NYK,,LAL,L,0,22,5,8,0.625,2,3,0.667,3,5,0.6,1,2,0.5,0,1,1
5897,Justin Holiday,27-330,G,3/1/17,NYK,@,ORL,W,0,16,6,11,0.545,4,6,0.667,2,5,0.4,0,0,,0,1,1
5898,Justin Holiday,27-326,G,2/25/17,NYK,,PHI,W,0,24,6,14,0.429,4,8,0.5,2,6,0.333,0,0,,3,4,7
5899,Rondae Hollis-Jefferson,22-014,F,1/17/17,BRK,,TOR,L,0,26,5,8,0.625,5,8,0.625,0,0,,4,4,1,0,8,8
5900,Rondae Hollis-Jefferson,22-068,F,3/12/17,BRK,,NYK,W,1,24,6,8,0.75,6,8,0.75,0,0,,2,4,0.5,5,6,11
5901,Rondae Hollis-Jefferson,22-012,F,1/15/17,BRK,,HOU,L,0,17,5,8,0.625,5,8,0.625,0,0,,4,4,1,2,5,7
5902,Richaun Holmes,23-150,F-C,3/14/17,PHI,@,GSW,L,0,21,6,10,0.6,5,8,0.625,1,2,0.5,1,1,1,3,5,8
5903,Rodney Hood,24-086,G-F,1/14/17,UTA,,ORL,W,1,33,6,14,0.429,4,7,0.571,2,7,0.286,0,1,0,0,4,4
5904,Al Horford,30-287,C-F,3/17/17,BOS,@,BRK,W,1,29,6,16,0.375,5,14,0.357,1,2,0.5,1,2,0.5,4,4,8
5905,Al Horford,30-221,C-F,1/10/17,BOS,@,TOR,L,1,35,5,11,0.455,3,7,0.429,2,4,0.5,2,2,1,2,7,9
5906,Al Horford,30-148,C-F,10/29/16,BOS,@,CHO,W,1,31,6,10,0.6,5,9,0.556,1,1,1,1,2,0.5,0,4,4
5907,Dwight Howard,31-083,C,3/1/17,ATL,,DAL,W,1,32,5,5,1,5,5,1,0,0,,4,6,0.667,2,10,12
5908,Dwight Howard,31-100,C,3/18/17,ATL,,POR,L,1,34,6,10,0.6,6,10,0.6,0,0,,2,3,0.667,5,5,10
5909,Dwight Howard,31-033,C,1/10/17,ATL,@,BRK,W,1,28,6,9,0.667,6,9,0.667,0,0,,2,8,0.25,7,9,16
5910,Dwight Howard,30-356,C,11/28/16,ATL,@,GSW,L,1,37,5,8,0.625,5,8,0.625,0,0,,4,8,0.5,4,12,16
5911,Kris Humphries,31-345,F-C,1/16/17,ATL,@,NYK,W,0,24,3,5,0.6,0,2,0,3,3,1,5,8,0.625,3,4,7
5912,Serge Ibaka,27-166,F-C,3/3/17,TOR,@,WAS,W,1,33,6,15,0.4,4,8,0.5,2,7,0.286,0,0,,1,7,8
5913,Serge Ibaka,27-038,F-C,10/26/16,ORL,,MIA,L,1,36,6,17,0.353,4,13,0.308,2,4,0.5,0,0,,2,6,8
5914,Andre Iguodala,32-354,G-F,1/16/17,GSW,,CLE,W,0,25,5,5,1,3,3,1,2,2,1,2,2,1,1,2,3
5915,Andre Iguodala,33-047,G-F,3/16/17,GSW,,ORL,W,0,23,6,8,0.75,6,7,0.857,0,1,0,2,6,0.333,1,5,6
5916,Ersan Ilyasova,29-222,F,12/23/16,PHI,@,PHO,L,0,25,5,11,0.455,2,6,0.333,3,5,0.6,1,1,1,2,1,3
5917,Ersan Ilyasova,29-270,F,2/9/17,PHI,@,ORL,W,1,27,4,16,0.25,3,8,0.375,1,8,0.125,5,6,0.833,2,2,4
5918,Ersan Ilyasova,29-219,F,12/20/16,PHI,,NOP,L,0,26,5,9,0.556,3,5,0.6,2,4,0.5,2,2,1,2,2,4
5919,Ersan Ilyasova,29-171,F,11/2/16,PHI,@,CHO,L,0,23,5,12,0.417,3,6,0.5,2,6,0.333,2,2,1,2,1,3
5920,Ersan Ilyasova,29-238,F,1/8/17,PHI,@,BRK,W,1,26,5,16,0.313,4,9,0.444,1,7,0.143,3,5,0.6,2,5,7
5921,Ersan Ilyasova,29-180,F,11/11/16,PHI,,IND,W,0,24,4,6,0.667,1,1,1,3,5,0.6,3,3,1,2,9,11
5922,Ersan Ilyasova,29-194,F,11/25/16,PHI,,CHI,L,1,26,5,8,0.625,4,6,0.667,1,2,0.5,3,4,0.75,1,6,7
5923,Ersan Ilyasova,29-272,F,2/11/17,PHI,,MIA,W,1,22,5,12,0.417,4,8,0.5,1,4,0.25,3,6,0.5,1,3,4
5924,Brandon Ingram,19-157,F,2/6/17,LAL,@,NYK,W,1,33,5,10,0.5,3,5,0.6,2,5,0.4,2,5,0.4,2,5,7
5925,Brandon Ingram,19-154,F,2/3/17,LAL,@,BOS,L,0,33,5,10,0.5,3,6,0.5,2,4,0.5,2,2,1,1,5,6
5926,Brandon Ingram,19-134,F,1/14/17,LAL,@,LAC,L,0,31,4,8,0.5,2,6,0.333,2,2,1,4,6,0.667,0,5,5
5927,Brandon Ingram,19-192,F,3/13/17,LAL,@,DEN,L,1,27,7,12,0.583,7,10,0.7,0,2,0,0,0,,0,1,1
5928,Brandon Ingram,19-188,F,3/9/17,LAL,@,PHO,W,1,40,5,11,0.455,5,8,0.625,0,3,0,4,8,0.5,1,5,6
5929,Kyrie Irving,24-315,G,2/1/17,CLE,,MIN,W,1,31,5,18,0.278,4,12,0.333,1,6,0.167,3,4,0.75,2,0,2
5930,Reggie Jackson,26-256,G,12/28/16,DET,,MIL,L,1,34,6,15,0.4,5,9,0.556,1,6,0.167,1,1,1,0,3,3
5931,Reggie Jackson,26-271,G,1/12/17,DET,@,GSW,L,1,25,5,11,0.455,4,5,0.8,1,6,0.167,3,3,1,0,2,2
5932,Reggie Jackson,26-337,G,3/19/17,DET,,PHO,W,1,25,5,15,0.333,3,11,0.273,2,4,0.5,2,2,1,0,2,2
5933,Reggie Jackson,26-244,G,12/16/16,DET,@,WAS,L,1,24,4,10,0.4,2,5,0.4,2,5,0.4,4,6,0.667,0,1,1
5934,Reggie Jackson,26-296,G,2/6/17,DET,,PHI,W,1,28,4,12,0.333,2,5,0.4,2,7,0.286,4,4,1,1,1,2
5935,Al Jefferson,31-346,C-F,12/15/16,IND,@,NOP,L,0,18,6,13,0.462,6,13,0.462,0,0,,2,2,1,2,3,5
5936,Al Jefferson,32-003,C-F,1/7/17,IND,,NYK,W,0,15,4,9,0.444,4,9,0.444,0,0,,6,6,1,4,3,7
5937,Richard Jefferson,36-247,F,2/23/17,CLE,,NYK,W,0,23,5,6,0.833,3,3,1,2,3,0.667,2,2,1,0,2,2
5938,Brandon Jennings,27-085,G,12/17/16,NYK,@,DEN,L,1,36,2,8,0.25,0,3,0,2,5,0.4,8,8,1,0,0,0
5939,Amir Johnson,29-283,F,2/8/17,BOS,@,SAC,L,1,27,6,7,0.857,4,5,0.8,2,2,1,0,0,,1,5,6
5940,Amir Johnson,29-195,F,11/12/16,BOS,@,IND,W,1,31,4,8,0.5,4,7,0.571,0,1,0,6,6,1,5,4,9
5941,James Johnson,29-325,F,1/10/17,MIA,@,GSW,L,0,30,6,14,0.429,5,7,0.714,1,7,0.143,1,2,0.5,0,2,2
5942,James Johnson,30-009,F,3/1/17,MIA,,PHI,W,0,26,6,11,0.545,6,8,0.75,0,3,0,2,4,0.5,1,3,4
5943,James Johnson,29-319,F,1/4/17,MIA,@,SAC,W,0,25,4,8,0.5,2,5,0.4,2,3,0.667,4,4,1,2,4,6
5944,James Johnson,29-298,F,12/14/16,MIA,,IND,W,0,25,6,9,0.667,5,8,0.625,1,1,1,1,2,0.5,1,2,3
5945,James Johnson,30-020,F,3/12/17,MIA,@,IND,L,0,32,6,16,0.375,5,11,0.455,1,5,0.2,1,1,1,0,4,4
5946,James Johnson,29-296,F,12/12/16,MIA,,WAS,W,0,30,6,9,0.667,6,7,0.857,0,2,0,2,4,0.5,2,3,5
5947,Joe Johnson,35-217,G-F,2/1/17,UTA,,MIL,W,0,27,5,9,0.556,3,6,0.5,2,3,0.667,2,3,0.667,1,5,6
5948,Joe Johnson,35-257,G-F,3/13/17,UTA,,LAC,W,0,28,6,12,0.5,4,7,0.571,2,5,0.4,0,0,,0,3,3
5949,Joe Johnson,35-128,G-F,11/4/16,UTA,,SAS,L,1,24,5,8,0.625,3,6,0.5,2,2,1,2,2,1,0,1,1
5950,Joe Johnson,35-174,G-F,12/20/16,UTA,@,GSW,L,0,22,5,9,0.556,3,6,0.5,2,3,0.667,2,2,1,0,2,2
5951,Tyler Johnson,24-251,G,1/13/17,MIA,@,MIL,L,0,30,6,12,0.5,5,7,0.714,1,5,0.2,1,2,0.5,0,2,2
5952,Tyler Johnson,24-316,G,3/19/17,MIA,,POR,L,0,31,6,12,0.5,6,9,0.667,0,3,0,2,3,0.667,0,3,3
5953,Tyler Johnson,24-229,G,12/22/16,MIA,,LAL,W,0,34,5,14,0.357,1,8,0.125,4,6,0.667,0,0,,0,1,1
5954,Tyler Johnson,24-192,G,11/15/16,MIA,,ATL,L,0,33,5,10,0.5,3,6,0.5,2,4,0.5,2,4,0.5,0,2,2
5955,Tyler Johnson,24-187,G,11/10/16,MIA,,CHI,L,0,32,4,11,0.364,2,7,0.286,2,4,0.5,4,7,0.571,1,7,8
5956,Nikola Jokic,21-295,C-F,12/10/16,DEN,@,ORL,W,0,26,6,11,0.545,6,8,0.75,0,3,0,2,2,1,1,5,6
5957,Nikola Jokic,21-292,C-F,12/7/16,DEN,@,BRK,L,0,21,5,7,0.714,5,7,0.714,0,0,,4,4,1,7,4,11
5958,James Jones,36-144,F-G,2/25/17,CLE,,CHI,L,0,23,5,6,0.833,1,1,1,4,5,0.8,0,0,,0,2,2
5959,James Jones,36-107,F-G,1/19/17,CLE,,PHO,W,1,20,5,8,0.625,1,2,0.5,4,6,0.667,0,0,,0,0,0
5960,Terrence Jones,24-328,F,12/2/16,NOP,,LAC,L,0,29,5,10,0.5,5,9,0.556,0,1,0,4,7,0.571,2,6,8
5961,DeAndre Jordan,28-242,C,3/20/17,LAC,,NYK,W,1,28,7,9,0.778,7,9,0.778,0,0,,0,0,,3,7,10
5962,DeAndre Jordan,28-184,C,1/21/17,LAC,@,DEN,L,1,27,6,10,0.6,6,10,0.6,0,0,,2,2,1,8,5,13
5963,DeAndre Jordan,28-225,C,3/3/17,LAC,@,MIL,L,1,32,5,7,0.714,5,7,0.714,0,0,,4,13,0.308,3,7,10
5964,DeAndre Jordan,28-218,C,2/24/17,LAC,,SAS,L,1,33,7,9,0.778,7,9,0.778,0,0,,0,1,0,2,6,8
5965,Cory Joseph,25-190,G,2/26/17,TOR,,POR,W,1,33,6,12,0.5,5,11,0.455,1,1,1,1,1,1,0,1,1
5966,Cory Joseph,25-196,G,3/4/17,TOR,@,MIL,L,1,37,5,11,0.455,3,7,0.429,2,4,0.5,2,2,1,1,4,5
5967,Cory Joseph,25-088,G,11/16/16,TOR,,GSW,L,0,22,4,7,0.571,4,5,0.8,0,2,0,6,7,0.857,1,1,2
5968,Cory Joseph,25-104,G,12/2/16,TOR,,LAL,W,0,25,7,10,0.7,7,9,0.778,0,1,0,0,0,,0,2,2
5969,Cory Joseph,25-140,G,1/7/17,TOR,@,CHI,L,0,23,5,6,0.833,2,3,0.667,3,3,1,1,1,1,0,3,3
5970,Frank Kaminsky,23-212,F-C,11/2/16,CHO,,PHI,W,0,25,6,12,0.5,4,6,0.667,2,6,0.333,0,0,,2,3,5
5971,Frank Kaminsky,23-350,F-C,3/20/17,CHO,,ATL,W,0,36,5,11,0.455,2,5,0.4,3,6,0.5,1,1,1,0,3,3
5972,Frank Kaminsky,23-348,F-C,3/18/17,CHO,,WAS,W,0,30,4,14,0.286,2,7,0.286,2,7,0.286,4,8,0.5,1,3,4
5973,Frank Kaminsky,23-236,F-C,11/26/16,CHO,,NYK,W,1,35,5,13,0.385,3,9,0.333,2,4,0.5,2,2,1,0,5,5
5974,Enes Kanter,24-215,C,12/21/16,OKC,@,NOP,W,0,34,6,11,0.545,6,11,0.545,0,0,,2,2,1,5,8,13
5975,Enes Kanter,24-248,C,1/23/17,OKC,@,UTA,W,0,29,5,9,0.556,5,9,0.556,0,0,,4,4,1,2,3,5
5976,Enes Kanter,24-194,C,11/30/16,OKC,,WAS,W,0,15,6,10,0.6,6,10,0.6,0,0,,2,3,0.667,0,3,3
5977,Enes Kanter,24-302,C,3/18/17,OKC,,SAC,W,0,18,5,10,0.5,5,10,0.5,0,0,,4,6,0.667,1,3,4
5978,Enes Kanter,24-300,C,3/16/17,OKC,@,TOR,W,0,19,5,9,0.556,5,9,0.556,0,0,,4,5,0.8,2,5,7
5979,Enes Kanter,24-205,C,12/11/16,OKC,,BOS,W,0,25,6,10,0.6,6,8,0.75,0,2,0,2,2,1,3,4,7
5980,Enes Kanter,24-293,C,3/9/17,OKC,,SAS,W,0,24,6,10,0.6,6,10,0.6,0,0,,2,2,1,6,4,10
5981,Enes Kanter,24-232,C,1/7/17,OKC,,DEN,W,0,21,7,12,0.583,7,12,0.583,0,0,,0,0,,2,4,6
5982,Michael Kidd-Gilchrist,23-100,F,1/4/17,CHO,,OKC,W,1,32,7,9,0.778,7,9,0.778,0,0,,0,2,0,2,9,11
5983,Michael Kidd-Gilchrist,23-134,F,2/7/17,CHO,,BRK,W,1,28,7,12,0.583,7,12,0.583,0,0,,0,0,,3,4,7
5984,Michael Kidd-Gilchrist,23-066,F,12/1/16,CHO,,DAL,W,1,33,4,9,0.444,4,9,0.444,0,0,,6,8,0.75,1,2,3
5985,Michael Kidd-Gilchrist,23-063,F,11/28/16,CHO,@,MEM,W,1,20,6,10,0.6,6,10,0.6,0,0,,2,4,0.5,2,5,7
5986,Sean Kilpatrick,27-022,G,1/28/17,BRK,@,MIN,L,0,25,6,10,0.6,6,9,0.667,0,1,0,2,2,1,0,1,1
5987,Sean Kilpatrick,27-004,G,1/10/17,BRK,,ATL,L,0,25,6,14,0.429,5,11,0.455,1,3,0.333,1,2,0.5,2,3,5
5988,Sean Kilpatrick,26-351,G,12/22/16,BRK,,GSW,L,1,32,4,11,0.364,3,6,0.5,1,5,0.2,5,7,0.714,0,4,4
5989,Sean Kilpatrick,26-313,G,11/14/16,BRK,@,LAC,L,1,18,5,17,0.294,3,10,0.3,2,7,0.286,2,2,1,2,3,5
5990,Sean Kilpatrick,26-330,G,12/1/16,BRK,,MIL,L,1,30,5,10,0.5,3,4,0.75,2,6,0.333,2,2,1,1,5,6
5991,Sean Kilpatrick,26-307,G,11/8/16,BRK,,MIN,W,0,28,4,7,0.571,4,5,0.8,0,2,0,6,6,1,0,5,5
5992,Brandon Knight,25-001,G,12/3/16,PHO,@,GSW,L,0,22,6,12,0.5,6,9,0.667,0,3,0,2,2,1,0,1,1
5993,Brandon Knight,24-343,G,11/9/16,PHO,,DET,W,0,17,5,9,0.556,4,7,0.571,1,2,0.5,3,3,1,0,1,1
5994,Brandon Knight,25-011,G,12/13/16,PHO,,NYK,W,0,20,4,11,0.364,2,6,0.333,2,5,0.4,4,6,0.667,0,2,2
5995,Brandon Knight,25-026,G,12/28/16,PHO,@,SAS,L,0,23,6,12,0.5,4,10,0.4,2,2,1,0,1,0,0,1,1
5996,Brandon Knight,25-007,G,12/9/16,PHO,@,LAL,W,0,23,5,11,0.455,4,8,0.5,1,3,0.333,3,3,1,1,1,2
5997,Kyle Korver,35-290,G-F,1/1/17,ATL,,SAS,W,0,39,5,12,0.417,1,3,0.333,4,9,0.444,0,0,,0,8,8
5998,Kyle Korver,35-345,G-F,2/25/17,CLE,,CHI,L,0,27,5,8,0.625,1,1,1,4,7,0.571,0,0,,0,2,2
5999,Kyle Korver,35-250,G-F,11/22/16,ATL,,NOP,L,1,29,5,6,0.833,1,1,1,4,5,0.8,0,0,,0,2,2
6000,Kyle Korver,35-316,G-F,1/27/17,CLE,,BRK,W,0,22,5,11,0.455,2,5,0.4,3,6,0.5,1,1,1,1,1,2
6001,Kyle Korver,35-345,G-F,2/25/17,CLE,,CHI,L,0,27,5,8,0.625,1,1,1,4,7,0.571,0,0,,0,2,2
6002,Kyle Korver,35-250,G-F,11/22/16,ATL,,NOP,L,1,29,5,6,0.833,1,1,1,4,5,0.8,0,0,,0,2,2
6003,Kosta Koufos,28-010,C,3/6/17,SAC,@,DEN,L,1,24,7,12,0.583,7,12,0.583,0,0,,0,0,,3,6,9
6004,Kosta Koufos,28-003,C,2/27/17,SAC,,MIN,L,1,25,6,8,0.75,6,8,0.75,0,0,,2,2,1,3,8,11
6005,Mindaugas Kuzminskas,27-073,F,12/31/16,NYK,@,HOU,L,0,16,5,9,0.556,3,4,0.75,2,5,0.4,2,2,1,0,2,2
6006,Mindaugas Kuzminskas,27-089,F,1/16/17,NYK,,ATL,L,1,38,6,10,0.6,5,5,1,1,5,0.2,1,1,1,1,4,5
6007,Mindaugas Kuzminskas,27-042,F,11/30/16,NYK,@,MIN,W,0,20,5,9,0.556,1,4,0.25,4,5,0.8,0,0,,2,0,2
6008,Skal Labissiere,21-001,F,3/19/17,SAC,@,SAS,L,0,23,7,9,0.778,7,9,0.778,0,0,,0,0,,2,5,7
6009,Jeremy Lamb,24-285,G-F,3/11/17,CHO,,NOP,L,0,21,4,9,0.444,3,5,0.6,1,4,0.25,5,5,1,0,4,4
6010,Jeremy Lamb,24-212,G-F,12/28/16,CHO,@,ORL,W,0,28,5,10,0.5,4,8,0.5,1,2,0.5,3,3,1,0,4,4
6011,Jeremy Lamb,24-280,G-F,3/6/17,CHO,,IND,W,0,25,6,9,0.667,4,6,0.667,2,3,0.667,0,0,,1,4,5
6012,Jeremy Lamb,24-189,G-F,12/5/16,CHO,@,DAL,W,0,21,5,10,0.5,4,7,0.571,1,3,0.333,3,3,1,1,4,5
6013,Zach LaVine,21-274,G,12/9/16,MIN,,DET,L,1,35,6,12,0.5,6,9,0.667,0,3,0,2,4,0.5,0,3,3
6014,Zach LaVine,21-238,G,11/3/16,MIN,,DEN,L,1,36,4,13,0.308,2,7,0.286,2,6,0.333,4,6,0.667,1,4,5
6015,Courtney Lee,31-048,G,11/20/16,NYK,,ATL,W,1,38,6,13,0.462,4,10,0.4,2,3,0.667,0,0,,1,4,5
6016,Courtney Lee,31-091,G,1/2/17,NYK,,ORL,L,1,34,6,11,0.545,5,7,0.714,1,4,0.25,1,1,1,1,2,3
6017,Courtney Lee,31-112,G,1/23/17,NYK,@,IND,W,1,25,3,7,0.429,2,4,0.5,1,3,0.333,7,7,1,1,3,4
6018,Courtney Lee,31-054,G,11/26/16,NYK,@,CHO,L,1,30,5,9,0.556,1,2,0.5,4,7,0.571,0,0,,0,2,2
6019,Courtney Lee,31-071,G,12/13/16,NYK,@,PHO,L,1,29,6,8,0.75,4,5,0.8,2,3,0.667,0,0,,1,1,2
6020,David Lee,33-267,F,1/21/17,SAS,@,CLE,W,1,36,7,11,0.636,7,11,0.636,0,0,,0,0,,3,8,11
6021,David Lee,33-283,F,2/6/17,SAS,@,MEM,L,0,17,6,6,1,6,6,1,0,0,,2,5,0.4,1,2,3
6022,David Lee,33-318,F,3/13/17,SAS,,ATL,W,1,30,7,8,0.875,7,8,0.875,0,0,,0,0,,2,4,6
6023,David Lee,33-275,F,1/29/17,SAS,,DAL,L,0,25,7,9,0.778,7,9,0.778,0,0,,0,0,,1,2,3
6024,Alex Len,23-176,C,12/9/16,PHO,@,LAL,W,0,34,6,10,0.6,6,10,0.6,0,0,,2,4,0.5,5,9,14
6025,Alex Len,23-173,C,12/6/16,PHO,@,UTA,L,0,21,4,9,0.444,4,9,0.444,0,0,,6,6,1,1,3,4
6026,Alex Len,23-203,C,1/5/17,PHO,@,DAL,W,0,17,6,12,0.5,6,12,0.5,0,0,,2,2,1,5,2,7
6027,Kawhi Leonard,25-129,F,11/5/16,SAS,,LAC,L,1,28,3,13,0.231,3,10,0.3,0,3,0,8,8,1,1,5,6
6028,Meyers Leonard,24-267,C-F,11/20/16,POR,@,BRK,W,0,27,4,8,0.5,0,2,0,4,6,0.667,2,2,1,0,11,11
6029,Jon Leuer,27-182,F,11/12/16,DET,@,DEN,W,0,26,7,12,0.583,7,11,0.636,0,1,0,0,0,,3,7,10
6030,Jon Leuer,27-296,F,3/6/17,DET,,CHI,W,1,32,6,12,0.5,6,10,0.6,0,2,0,2,2,1,1,5,6
6031,Jon Leuer,27-177,F,11/7/16,DET,@,LAC,L,0,29,6,10,0.6,5,7,0.714,1,3,0.333,1,2,0.5,2,4,6
6032,Jon Leuer,27-266,F,2/4/17,DET,@,IND,L,1,27,7,11,0.636,7,9,0.778,0,2,0,0,0,,1,5,6
6033,Jon Leuer,27-234,F,1/3/17,DET,,IND,L,1,34,7,11,0.636,7,8,0.875,0,3,0,0,0,,1,6,7
6034,Caris LeVert,22-145,G-F,1/17/17,BRK,,TOR,L,0,23,6,8,0.75,4,5,0.8,2,3,0.667,0,0,,0,3,3
6035,Caris LeVert,22-193,G-F,3/6/17,BRK,@,MEM,W,1,25,5,6,0.833,3,3,1,2,3,0.667,2,5,0.4,1,2,3
6036,Damian Lillard,26-180,G,1/11/17,POR,,CLE,W,1,32,5,15,0.333,4,11,0.364,1,4,0.25,3,3,1,0,3,3
6037,Jeremy Lin,28-069,G,10/31/16,BRK,,CHI,L,1,24,6,10,0.6,5,8,0.625,1,2,0.5,1,2,0.5,0,2,2
6038,Shaun Livingston,31-170,G,2/28/17,GSW,@,WAS,L,0,24,5,8,0.625,5,7,0.714,0,1,0,4,4,1,1,2,3
6039,Brook Lopez,28-276,C,1/2/17,BRK,,UTA,L,1,31,6,16,0.375,5,10,0.5,1,6,0.167,1,2,0.5,1,5,6
6040,Brook Lopez,28-253,C,12/10/16,BRK,@,SAS,L,1,25,3,7,0.429,3,6,0.5,0,1,0,8,8,1,3,2,5
6041,Brook Lopez,28-304,C,1/30/17,BRK,@,MIA,L,1,31,5,17,0.294,5,11,0.455,0,6,0,4,6,0.667,2,1,3
6042,Robin Lopez,28-306,C,2/1/17,CHI,@,OKC,W,1,21,7,8,0.875,7,8,0.875,0,0,,0,0,,1,1,2
6043,Robin Lopez,28-256,C,12/13/16,CHI,,MIN,L,1,33,7,9,0.778,7,9,0.778,0,0,,0,0,,4,1,5
6044,Robin Lopez,28-284,C,1/10/17,CHI,@,WAS,L,1,34,5,10,0.5,5,10,0.5,0,0,,4,5,0.8,5,1,6
6045,Robin Lopez,28-351,C,3/18/17,CHI,,UTA,W,1,30,6,12,0.5,6,12,0.5,0,0,,2,2,1,3,2,5
6046,Robin Lopez,28-262,C,12/19/16,CHI,,DET,W,1,26,7,10,0.7,7,10,0.7,0,0,,0,0,,3,3,6
6047,Kevin Love,28-107,F,12/23/16,CLE,,BRK,W,1,25,4,14,0.286,2,7,0.286,2,7,0.286,4,4,1,1,14,15
6048,Kevin Love,28-065,F,11/11/16,CLE,@,WAS,W,1,34,4,12,0.333,4,11,0.364,0,1,0,6,9,0.667,7,9,16
6049,Kevin Love,28-154,F,2/8/17,CLE,@,IND,W,1,35,3,11,0.273,2,4,0.5,1,7,0.143,7,7,1,0,10,10
6050,Trey Lyles,21-026,F,12/1/16,UTA,,MIA,L,0,25,5,8,0.625,1,4,0.25,4,4,1,0,0,,0,1,1
6051,Trey Lyles,21-035,F,12/10/16,UTA,,SAC,W,0,19,4,14,0.286,1,6,0.167,3,8,0.375,3,3,1,3,2,5
6052,Shelvin Mack,26-193,G,11/1/16,UTA,@,SAS,W,0,19,6,9,0.667,4,7,0.571,2,2,1,0,0,,0,1,1
6053,Wesley Matthews,30-048,G,12/1/16,DAL,@,CHO,L,1,39,4,15,0.267,3,4,0.75,1,11,0.091,5,5,1,0,3,3
6054,Wesley Matthews,30-077,G,12/30/16,DAL,@,GSW,L,1,30,5,14,0.357,3,10,0.3,2,4,0.5,2,2,1,1,1,2
6055,Luc Mbah a Moute,30-102,F,12/20/16,LAC,,DEN,W,1,31,5,8,0.625,4,6,0.667,1,2,0.5,3,3,1,1,2,3
6056,T.J. McConnell,24-341,G,3/1/17,PHI,@,MIA,L,1,32,5,7,0.714,5,7,0.714,0,0,,4,4,1,1,4,5
6057,T.J. McConnell,24-325,G,2/13/17,PHI,@,CHO,W,1,36,7,12,0.583,7,11,0.636,0,1,0,0,0,,0,4,4
6058,T.J. McConnell,24-310,G,1/29/17,PHI,@,CHI,L,1,37,7,14,0.5,7,13,0.538,0,1,0,0,0,,0,4,4
6059,Doug McDermott,25-026,F,1/29/17,CHI,,PHI,W,0,20,5,9,0.556,3,6,0.5,2,3,0.667,2,2,1,0,3,3
6060,Rodney McGruder,25-106,G,11/12/16,MIA,,UTA,L,0,22,5,6,0.833,2,2,1,3,4,0.75,1,2,0.5,0,2,2
6061,Ben McLemore,24-030,G,3/13/17,SAC,,ORL,W,0,23,4,10,0.4,1,4,0.25,3,6,0.5,3,5,0.6,0,5,5
6062,Ben McLemore,24-016,G,2/27/17,SAC,,MIN,L,1,25,5,10,0.5,3,7,0.429,2,3,0.667,2,2,1,1,3,4
6063,Ben McLemore,23-279,G,11/16/16,SAC,,SAS,L,0,26,6,10,0.6,4,6,0.667,2,4,0.5,0,0,,0,3,3
6064,Jodie Meeks,29-143,G,1/11/17,ORL,@,LAC,L,0,28,6,11,0.545,4,6,0.667,2,5,0.4,0,0,,0,5,5
6065,Patty Mills,28-197,G,2/24/17,SAS,@,LAC,W,0,21,5,10,0.5,3,3,1,2,7,0.286,2,3,0.667,0,1,1
6066,Paul Millsap,31-335,F,1/10/17,ATL,@,BRK,W,1,29,6,14,0.429,6,13,0.462,0,1,0,2,4,0.5,3,5,8
6067,Paul Millsap,31-292,F,11/28/16,ATL,@,GSW,L,1,35,3,11,0.273,1,6,0.167,2,5,0.4,6,7,0.857,5,9,14
6068,Paul Millsap,31-362,F,2/6/17,ATL,,UTA,L,1,36,4,14,0.286,3,11,0.273,1,3,0.333,5,8,0.625,3,5,8
6069,Paul Millsap,31-345,F,1/20/17,ATL,,CHI,W,1,24,4,5,0.8,2,3,0.667,2,2,1,4,4,1,2,7,9
6070,Paul Millsap,31-310,F,12/16/16,ATL,@,TOR,W,1,28,5,9,0.556,4,7,0.571,1,2,0.5,3,4,0.75,1,4,5
6071,Nikola Mirotic,25-267,F,11/4/16,CHI,,NYK,L,0,21,4,10,0.4,2,4,0.5,2,6,0.333,4,4,1,0,6,6
6072,Nikola Mirotic,26-014,F,2/25/17,CHI,@,CLE,W,0,29,5,8,0.625,3,3,1,2,5,0.4,2,4,0.5,2,8,10
6073,Nikola Mirotic,26-032,F,3/15/17,CHI,,MEM,L,0,28,3,10,0.3,0,2,0,3,8,0.375,5,5,1,2,3,5
6074,Greg Monroe,26-144,C-F,10/26/16,MIL,,CHO,L,0,29,5,13,0.385,5,13,0.385,0,0,,4,5,0.8,5,5,10
6075,Greg Monroe,26-267,C-F,2/26/17,MIL,,PHO,W,0,34,5,13,0.385,5,13,0.385,0,0,,4,5,0.8,2,6,8
6076,Greg Monroe,26-195,C-F,12/16/16,MIL,@,CHI,W,0,23,6,14,0.429,6,14,0.429,0,0,,2,3,0.667,4,8,12
6077,Greg Monroe,26-155,C-F,11/6/16,MIL,@,DAL,L,0,29,5,10,0.5,5,10,0.5,0,0,,4,4,1,1,11,12
6078,Greg Monroe,26-178,C-F,11/29/16,MIL,,CLE,W,0,26,6,8,0.75,6,8,0.75,0,0,,2,2,1,3,3,6
6079,Greg Monroe,26-226,C-F,1/16/17,MIL,,PHI,L,0,21,6,13,0.462,6,13,0.462,0,0,,2,4,0.5,4,2,6
6080,Greg Monroe,26-238,C-F,1/28/17,MIL,,BOS,L,0,35,4,10,0.4,4,10,0.4,0,0,,6,9,0.667,3,10,13
6081,Greg Monroe,26-207,C-F,12/28/16,MIL,@,DET,W,0,27,7,10,0.7,7,10,0.7,0,0,,0,1,0,0,5,5
6082,Greg Monroe,26-188,C-F,12/9/16,MIL,,ATL,L,0,23,6,13,0.462,6,13,0.462,0,0,,2,2,1,2,4,6
6083,Greg Monroe,26-220,C-F,1/10/17,MIL,@,SAS,W,0,28,7,13,0.538,7,13,0.538,0,0,,0,0,,4,5,9
6084,E'Twaun Moore,27-262,G,11/16/16,NOP,@,ORL,L,1,32,6,16,0.375,6,13,0.462,0,3,0,2,2,1,2,1,3
6085,E'Twaun Moore,28-019,G,3/19/17,NOP,,MIN,W,0,28,6,11,0.545,5,8,0.625,1,3,0.333,1,1,1,2,1,3
6086,Marcus Morris,27-123,F,1/3/17,DET,,IND,L,1,29,6,14,0.429,4,7,0.571,2,7,0.286,0,0,,1,0,1
6087,Marcus Morris,27-159,F,2/8/17,DET,,LAL,W,1,28,6,14,0.429,5,11,0.455,1,3,0.333,1,2,0.5,2,4,6
6088,Marcus Morris,27-138,F,1/18/17,DET,,ATL,W,1,36,5,13,0.385,4,7,0.571,1,6,0.167,3,4,0.75,1,9,10
6089,Marcus Morris,27-148,F,1/28/17,DET,@,MIA,L,1,36,7,11,0.636,7,9,0.778,0,2,0,0,1,0,0,2,2
6090,Markieff Morris,27-134,F,1/14/17,WAS,,PHI,W,1,30,6,10,0.6,4,8,0.5,2,2,1,0,0,,0,9,9
6091,Markieff Morris,27-175,F,2/24/17,WAS,@,PHI,L,1,27,6,10,0.6,6,10,0.6,0,0,,2,2,1,2,5,7
6092,Markieff Morris,27-131,F,1/11/17,WAS,@,BOS,L,1,38,6,21,0.286,5,15,0.333,1,6,0.167,1,2,0.5,2,7,9
6093,Markieff Morris,27-112,F,12/23/16,WAS,@,MIL,L,1,26,5,10,0.5,4,8,0.5,1,2,0.5,3,4,0.75,0,2,2
6094,Markieff Morris,27-199,F,3/20/17,WAS,@,BOS,L,1,31,6,15,0.4,5,9,0.556,1,6,0.167,1,1,1,1,3,4
6095,Markieff Morris,27-139,F,1/19/17,WAS,@,NYK,W,1,35,6,11,0.545,4,8,0.5,2,3,0.667,0,0,,2,4,6
6096,Anthony Morrow,31-062,G,11/28/16,OKC,@,NYK,W,0,20,5,7,0.714,2,2,1,3,5,0.6,1,2,0.5,0,0,0
6097,Donatas Motiejunas,26-125,F-C,1/23/17,NOP,,CLE,W,0,24,5,8,0.625,3,5,0.6,2,3,0.667,2,4,0.5,1,3,4
6098,Timofey Mozgov,30-159,C,12/22/16,LAL,@,MIA,L,1,30,6,11,0.545,6,11,0.545,0,0,,2,2,1,0,5,5
6099,Timofey Mozgov,30-113,C,11/6/16,LAL,,PHO,W,1,22,6,9,0.667,6,9,0.667,0,0,,2,3,0.667,4,4,8
6100,Timofey Mozgov,30-171,C,1/3/17,LAL,,MEM,W,1,38,7,12,0.583,7,12,0.583,0,0,,0,0,,1,4,5
6101,Emmanuel Mudiay,20-318,G,1/17/17,DEN,@,LAL,W,1,28,5,7,0.714,3,4,0.75,2,3,0.667,2,3,0.667,0,2,2
6102,Emmanuel Mudiay,20-333,G,2/1/17,DEN,,MEM,L,0,26,4,10,0.4,4,9,0.444,0,1,0,6,10,0.6,2,4,6
6103,Shabazz Muhammad,24-019,F-G,12/2/16,MIN,@,NYK,L,0,21,6,10,0.6,4,5,0.8,2,5,0.4,0,0,,0,2,2
6104,Dejounte Murray,20-124,G,1/21/17,SAS,@,CLE,W,1,22,7,10,0.7,7,10,0.7,0,0,,0,0,,0,2,2
6105,Jamal Murray,19-358,G,2/15/17,DEN,,MIN,L,0,23,5,13,0.385,1,5,0.2,4,8,0.5,0,0,,1,1,2
6106,Jamal Murray,19-261,G,11/10/16,DEN,,GSW,L,0,29,5,15,0.333,3,8,0.375,2,7,0.286,2,2,1,2,1,3
6107,Jamal Murray,19-343,G,1/31/17,DEN,@,LAL,L,0,27,5,12,0.417,1,4,0.25,4,8,0.5,0,0,,1,1,2
6108,Jamal Murray,19-356,G,2/13/17,DEN,,GSW,W,0,23,5,9,0.556,3,4,0.75,2,5,0.4,2,2,1,0,1,1
6109,Jamal Murray,20-009,G,3/4/17,DEN,,CHO,L,0,26,6,10,0.6,4,7,0.571,2,3,0.667,0,0,,0,3,3
6110,Jamal Murray,20-005,G,2/28/17,DEN,@,CHI,W,0,18,4,9,0.444,2,4,0.5,2,5,0.4,4,4,1,0,2,2
6111,Jamal Murray,20-016,G,3/11/17,DEN,@,SAC,W,0,20,5,10,0.5,3,5,0.6,2,5,0.4,2,2,1,2,1,3
6112,Mike Muscala,25-120,F-C,10/29/16,ATL,@,PHI,W,0,21,7,8,0.875,7,7,1,0,1,0,0,0,,1,4,5
6113,Mike Muscala,25-137,F-C,11/15/16,ATL,@,MIA,W,0,22,6,7,0.857,4,5,0.8,2,2,1,0,0,,0,5,5
6114,Jameer Nelson,34-302,G,12/7/16,DEN,@,BRK,L,0,29,7,19,0.368,7,15,0.467,0,4,0,0,0,,3,2,5
6115,Jameer Nelson,34-268,G,11/3/16,DEN,@,MIN,W,0,34,5,10,0.5,3,6,0.5,2,4,0.5,2,2,1,1,6,7
6116,Joakim Noah,31-307,C,12/28/16,NYK,@,ATL,L,1,38,5,8,0.625,5,8,0.625,0,0,,4,4,1,6,10,16
6117,Nerlens Noel,22-345,C-F,3/21/17,DAL,,GSW,L,0,17,5,7,0.714,5,7,0.714,0,0,,4,4,1,2,5,7
6118,Nerlens Noel,22-263,C-F,12/29/16,PHI,@,UTA,L,0,22,6,10,0.6,6,10,0.6,0,0,,2,2,1,2,3,5
6119,Dirk Nowitzki,38-237,F,2/11/17,DAL,,ORL,W,1,18,6,12,0.5,4,9,0.444,2,3,0.667,0,0,,0,7,7
6120,Jusuf Nurkic,22-091,C,11/22/16,DEN,,CHI,W,1,29,7,13,0.538,7,13,0.538,0,0,,0,0,,5,9,14
6121,Jusuf Nurkic,22-087,C,11/18/16,DEN,,TOR,L,1,25,5,9,0.556,5,9,0.556,0,0,,4,6,0.667,0,1,1
6122,Kyle O'Quinn,26-271,F-C,12/22/16,NYK,,ORL,W,0,24,6,12,0.5,6,11,0.545,0,1,0,2,2,1,5,11,16
6123,Kyle O'Quinn,26-299,F-C,1/19/17,NYK,,WAS,L,1,21,7,10,0.7,7,10,0.7,0,0,,0,0,,4,4,8
6124,Jahlil Okafor,20-348,C-F,11/27/16,PHI,,CLE,L,0,23,7,11,0.636,7,11,0.636,0,0,,0,0,,2,7,9
6125,Jahlil Okafor,21-001,C-F,12/16/16,PHI,,LAL,L,1,24,4,7,0.571,4,7,0.571,0,0,,6,6,1,2,6,8
6126,Jahlil Okafor,21-086,C-F,3/11/17,PHI,@,LAC,L,1,21,6,10,0.6,6,10,0.6,0,0,,2,2,1,0,4,4
6127,Jahlil Okafor,20-362,C-F,12/11/16,PHI,@,DET,W,1,27,6,9,0.667,6,9,0.667,0,0,,2,4,0.5,1,8,9
6128,Jahlil Okafor,20-326,C-F,11/5/16,PHI,,CLE,L,0,23,7,11,0.636,7,11,0.636,0,0,,0,2,0,0,5,5
6129,Victor Oladipo,24-202,G,11/22/16,OKC,@,LAL,L,1,39,6,13,0.462,4,9,0.444,2,4,0.5,0,0,,0,4,4
6130,Victor Oladipo,24-215,G,12/5/16,OKC,@,ATL,W,1,36,6,15,0.4,4,7,0.571,2,8,0.25,0,0,,0,6,6
6131,Victor Oladipo,24-200,G,11/20/16,OKC,,IND,L,1,38,6,14,0.429,4,8,0.5,2,6,0.333,0,0,,0,5,5
6132,Victor Oladipo,24-278,G,2/6/17,OKC,@,IND,L,1,36,4,16,0.25,4,10,0.4,0,6,0,6,6,1,0,5,5
6133,Kelly Olynyk,25-223,C-F,11/28/16,BOS,@,MIA,W,0,20,5,7,0.714,3,4,0.75,2,3,0.667,2,2,1,0,6,6
6134,Kelly Oubre,21-053,F,1/31/17,WAS,,NYK,W,0,28,5,7,0.714,3,3,1,2,4,0.5,2,2,1,0,2,2
6135,Zaza Pachulia,32-347,C,1/22/17,GSW,@,ORL,W,1,20,7,8,0.875,7,8,0.875,0,0,,0,2,0,2,3,5
6136,Zaza Pachulia,32-354,C,1/29/17,GSW,@,POR,W,1,24,3,5,0.6,3,5,0.6,0,0,,8,10,0.8,2,3,5
6137,Georgios Papagiannis,19-258,C,3/18/17,SAC,@,OKC,L,0,22,6,10,0.6,6,10,0.6,0,0,,2,2,1,2,9,11
6138,Jabari Parker,21-228,F,10/29/16,MIL,,BRK,W,1,35,5,11,0.455,5,10,0.5,0,1,0,4,6,0.667,2,6,8
6139,Jabari Parker,21-255,F,11/25/16,MIL,,TOR,L,1,33,6,14,0.429,5,9,0.556,1,5,0.2,1,2,0.5,1,3,4
6140,Jabari Parker,21-286,F,12/26/16,MIL,@,WAS,L,1,40,7,18,0.389,7,15,0.467,0,3,0,0,0,,1,5,6
6141,Jabari Parker,21-330,F,2/8/17,MIL,,MIA,L,1,20,6,11,0.545,6,10,0.6,0,1,0,2,3,0.667,0,1,1
6142,Tony Parker,34-242,G,1/14/17,SAS,@,PHO,L,1,31,5,10,0.5,3,7,0.429,2,3,0.667,2,4,0.5,1,0,1
6143,Tony Parker,34-238,G,1/10/17,SAS,,MIL,L,1,33,7,15,0.467,7,14,0.5,0,1,0,0,0,,0,3,3
6144,Tony Parker,34-183,G,11/16/16,SAS,@,SAC,W,1,26,7,10,0.7,7,10,0.7,0,0,,0,0,,0,3,3
6145,Tony Parker,34-245,G,1/17/17,SAS,,MIN,W,1,29,6,13,0.462,6,13,0.462,0,0,,2,3,0.667,0,0,0
6146,Chandler Parsons,28-078,F,1/11/17,MEM,@,OKC,L,1,18,7,12,0.583,7,9,0.778,0,3,0,0,0,,0,0,0
6147,Patrick Patterson,27-261,F,11/30/16,TOR,,MEM,W,0,30,5,10,0.5,1,4,0.25,4,6,0.667,0,0,,3,10,13
6148,Patrick Patterson,27-252,F,11/21/16,TOR,@,LAC,L,0,36,4,8,0.5,1,2,0.5,3,6,0.5,3,3,1,0,6,6
6149,Chris Paul,31-245,G,1/6/17,LAC,@,SAC,W,1,31,3,5,0.6,2,3,0.667,1,2,0.5,7,8,0.875,0,6,6
6150,Cameron Payne,22-210,G,3/6/17,CHI,@,DET,L,0,23,5,14,0.357,1,5,0.2,4,9,0.444,0,0,,0,3,3
6151,Elfrid Payton,22-331,G,1/18/17,ORL,@,NOP,L,1,24,5,10,0.5,3,7,0.429,2,3,0.667,2,2,1,0,2,2
6152,Mason Plumlee,26-321,C-F,1/20/17,POR,@,PHI,L,1,33,4,14,0.286,4,14,0.286,0,0,,6,10,0.6,3,8,11
6153,Otto Porter,23-176,F,11/26/16,WAS,,SAS,L,1,38,6,8,0.75,5,7,0.714,1,1,1,1,1,1,2,6,8
6154,Otto Porter,23-234,F,1/23/17,WAS,@,CHO,W,1,35,6,11,0.545,4,5,0.8,2,6,0.333,0,0,,1,11,12
6155,Otto Porter,23-287,F,3/17/17,WAS,,CHI,W,1,38,6,14,0.429,6,11,0.545,0,3,0,2,2,1,3,5,8
6156,Otto Porter,23-285,F,3/15/17,WAS,,DAL,L,1,37,6,9,0.667,4,5,0.8,2,4,0.5,0,0,,1,9,10
6157,Otto Porter,23-270,F,2/28/17,WAS,,GSW,W,1,38,5,8,0.625,3,5,0.6,2,3,0.667,2,2,1,2,6,8
6158,Kristaps Porzingis,21-172,F-C,1/21/17,NYK,,PHO,L,1,33,7,13,0.538,7,10,0.7,0,3,0,0,0,,1,0,1
6159,Kristaps Porzingis,21-216,F-C,3/6/17,NYK,@,ORL,W,1,30,6,12,0.5,6,12,0.5,0,0,,2,2,1,2,5,7
6160,Kristaps Porzingis,21-126,F-C,12/6/16,NYK,@,MIA,W,1,30,6,16,0.375,6,12,0.5,0,4,0,2,4,0.5,2,10,12
6161,Kristaps Porzingis,21-101,F-C,11/11/16,NYK,@,BOS,L,1,23,5,15,0.333,5,13,0.385,0,2,0,4,4,1,2,4,6
6162,Dwight Powell,25-184,F-C,1/20/17,DAL,,UTA,L,0,27,5,6,0.833,5,6,0.833,0,0,,4,6,0.667,2,1,3
6163,Dwight Powell,25-201,F-C,2/6/17,DAL,@,DEN,L,0,26,6,8,0.75,6,7,0.857,0,1,0,2,4,0.5,2,2,4
6164,Dwight Powell,25-162,F-C,12/29/16,DAL,@,LAL,W,0,14,7,9,0.778,7,8,0.875,0,1,0,0,0,,1,5,6
6165,Dwight Powell,25-240,F-C,3/17/17,DAL,@,PHI,L,0,18,6,12,0.5,4,7,0.571,2,5,0.4,0,0,,0,0,0
6166,Dwight Powell,25-194,F-C,1/30/17,DAL,,CLE,W,0,29,6,11,0.545,6,9,0.667,0,2,0,2,2,1,4,4,8
6167,Dwight Powell,25-112,F-C,11/9/16,DAL,@,GSW,L,1,26,6,8,0.75,6,7,0.857,0,1,0,2,3,0.667,3,6,9
6168,Dwight Powell,25-142,F-C,12/9/16,DAL,,IND,W,0,21,3,6,0.5,3,5,0.6,0,1,0,8,8,1,1,4,5
6169,Norman Powell,23-290,G,3/11/17,TOR,@,MIA,L,1,35,5,14,0.357,5,10,0.5,0,4,0,4,6,0.667,1,0,1
6170,Julius Randle,21-350,F,11/13/16,LAL,@,MIN,L,1,28,5,8,0.625,4,7,0.571,1,1,1,3,5,0.6,1,5,6
6171,Julius Randle,21-357,F,11/20/16,LAL,,CHI,L,1,25,6,11,0.545,6,10,0.6,0,1,0,2,4,0.5,0,3,3
6172,Julius Randle,22-010,F,12/9/16,LAL,,PHO,L,1,33,4,11,0.364,4,9,0.444,0,2,0,6,7,0.857,1,8,9
6173,Julius Randle,22-069,F,2/6/17,LAL,@,NYK,W,1,17,7,14,0.5,7,14,0.5,0,0,,0,0,,2,0,2
6174,Zach Randolph,35-168,F,12/31/16,MEM,@,SAC,W,0,24,7,16,0.438,7,14,0.5,0,2,0,0,0,,2,4,6
6175,Zach Randolph,35-200,F,2/1/17,MEM,@,DEN,W,0,21,7,12,0.583,7,11,0.636,0,1,0,0,0,,1,4,5
6176,Zach Randolph,35-240,F,3/13/17,MEM,,MIL,W,0,21,6,13,0.462,6,13,0.462,0,0,,2,3,0.667,3,4,7
6177,Zach Randolph,35-147,F,12/10/16,MEM,,GSW,W,0,21,6,11,0.545,5,9,0.556,1,2,0.5,1,1,1,2,5,7
6178,Zach Randolph,35-179,F,1/11/17,MEM,@,OKC,L,0,27,6,13,0.462,6,13,0.462,0,0,,2,3,0.667,4,5,9
6179,Zach Randolph,35-128,F,11/21/16,MEM,@,CHO,W,0,21,7,14,0.5,7,14,0.5,0,0,,0,0,,1,7,8
6180,J.J. Redick,32-134,G,11/5/16,LAC,@,SAS,W,1,24,5,9,0.556,3,6,0.5,2,3,0.667,2,2,1,1,1,2
6181,J.J. Redick,32-257,G,3/8/17,LAC,@,MIN,L,1,26,6,14,0.429,4,9,0.444,2,5,0.4,0,0,,0,1,1
6182,J.J. Redick,32-269,G,3/20/17,LAC,,NYK,W,1,23,4,11,0.364,1,5,0.2,3,6,0.5,3,3,1,0,3,3
6183,J.J. Redick,32-211,G,1/21/17,LAC,@,DEN,L,1,26,6,15,0.4,4,8,0.5,2,7,0.286,0,0,,0,1,1
6184,J.J. Redick,32-229,G,2/8/17,LAC,@,NYK,W,1,28,4,12,0.333,2,6,0.333,2,6,0.333,4,4,1,0,5,5
6185,Willie Reed,26-254,F-C,1/25/17,MIA,@,BRK,W,0,24,4,5,0.8,4,5,0.8,0,0,,6,8,0.75,1,3,4
6186,Josh Richardson,23-187,G,3/21/17,MIA,,PHO,W,1,36,6,13,0.462,4,8,0.5,2,5,0.4,0,0,,1,1,2
6187,Josh Richardson,23-108,G,1/1/17,MIA,,DET,L,1,38,5,13,0.385,3,8,0.375,2,5,0.4,2,4,0.5,0,1,1
6188,Austin Rivers,24-152,G,12/31/16,LAC,@,OKC,L,1,34,3,11,0.273,2,6,0.333,1,5,0.2,7,7,1,0,1,1
6189,Austin Rivers,24-128,G,12/7/16,LAC,,GSW,L,0,29,4,10,0.4,2,6,0.333,2,4,0.5,4,4,1,0,2,2
6190,Austin Rivers,24-184,G,2/1/17,LAC,@,PHO,W,1,28,4,12,0.333,4,8,0.5,0,4,0,6,8,0.75,0,2,2
6191,Andre Roberson,25-032,G-F,1/5/17,OKC,@,HOU,L,1,36,6,11,0.545,6,8,0.75,0,3,0,2,2,1,5,4,9
6192,Andre Roberson,25-063,G-F,2/5/17,OKC,,POR,W,1,36,6,8,0.75,6,7,0.857,0,1,0,2,2,1,2,9,11
6193,Andre Roberson,25-015,G-F,12/19/16,OKC,,ATL,L,1,40,5,14,0.357,2,5,0.4,3,9,0.333,1,2,0.5,2,3,5
6194,Andre Roberson,24-345,G-F,11/13/16,OKC,,ORL,L,1,32,6,11,0.545,4,5,0.8,2,6,0.333,0,3,0,2,1,3
6195,Glenn Robinson,23-024,G-F,2/1/17,IND,@,ORL,W,0,21,5,5,1,3,3,1,2,2,1,2,2,1,1,6,7
6196,Glenn Robinson,23-021,G-F,1/29/17,IND,,HOU,W,0,21,6,8,0.75,4,6,0.667,2,2,1,0,0,,1,5,6
6197,Glenn Robinson,23-029,G-F,2/6/17,IND,,OKC,W,0,24,5,5,1,2,2,1,3,3,1,1,2,0.5,1,1,2
6198,Sergio Rodriguez,30-139,G,10/29/16,PHI,,ATL,L,1,29,7,13,0.538,7,11,0.636,0,2,0,0,0,,1,3,4
6199,Rajon Rondo,30-282,G,11/30/16,CHI,,LAL,L,1,36,6,12,0.5,4,9,0.444,2,3,0.667,0,0,,1,7,8
6200,Derrick Rose,28-047,G,11/20/16,NYK,,ATL,W,1,30,5,14,0.357,5,12,0.417,0,2,0,4,4,1,1,2,3
6201,Derrick Rose,28-047,G,11/20/16,NYK,,ATL,W,1,30,5,14,0.357,5,12,0.417,0,2,0,4,4,1,1,2,3
6202,Derrick Rose,28-095,G,1/7/17,NYK,@,IND,L,1,26,6,12,0.5,6,10,0.6,0,2,0,2,2,1,0,2,2
6203,Terrence Ross,26-040,F-G,3/17/17,ORL,@,PHO,W,1,31,6,10,0.6,4,7,0.571,2,3,0.667,0,0,,0,1,1
6204,Terrence Ross,25-292,F-G,11/23/16,TOR,@,HOU,W,0,20,6,12,0.5,4,9,0.444,2,3,0.667,0,0,,1,2,3
6205,Terrence Ross,26-031,F-G,3/8/17,ORL,,CHI,W,1,31,5,12,0.417,3,8,0.375,2,4,0.5,2,3,0.667,1,2,3
6206,Terrence Ross,25-304,F-G,12/5/16,TOR,,CLE,L,0,22,4,9,0.444,0,2,0,4,7,0.571,2,2,1,1,0,1
6207,Terry Rozier,22-353,G,3/5/17,BOS,@,PHO,L,0,20,5,9,0.556,1,4,0.25,4,5,0.8,0,0,,1,3,4
6208,Terry Rozier,23-002,G,3/19/17,BOS,@,PHI,L,0,26,4,12,0.333,2,5,0.4,2,7,0.286,4,4,1,4,6,10
6209,Ricky Rubio,26-106,G,2/4/17,MIN,,MEM,L,1,38,5,15,0.333,3,9,0.333,2,6,0.333,2,2,1,0,1,1
6210,Ricky Rubio,26-127,G,2/25/17,MIN,@,HOU,L,1,32,3,8,0.375,1,3,0.333,2,5,0.4,6,7,0.857,1,2,3
6211,Ricky Rubio,26-103,G,2/1/17,MIN,@,CLE,L,1,38,5,11,0.455,4,8,0.5,1,3,0.333,3,3,1,0,2,2
6212,Ricky Rubio,26-084,G,1/13/17,MIN,,OKC,W,1,36,6,12,0.5,6,10,0.6,0,2,0,2,2,1,1,3,4
6213,Ricky Rubio,26-099,G,1/28/17,MIN,,BRK,W,1,22,5,9,0.556,5,7,0.714,0,2,0,4,4,1,0,3,3
6214,Ricky Rubio,26-095,G,1/24/17,MIN,@,PHO,W,1,34,4,8,0.5,3,7,0.429,1,1,1,5,6,0.833,2,2,4
6215,Ricky Rubio,26-108,G,2/6/17,MIN,,MIA,L,1,36,4,8,0.5,4,7,0.571,0,1,0,6,6,1,0,3,3
6216,Damjan Rudez,30-224,F,1/27/17,ORL,@,BOS,L,0,24,5,5,1,1,1,1,4,4,1,0,0,,0,0,0
6217,D'Angelo Russell,20-353,G,2/10/17,LAL,@,MIL,W,1,27,4,9,0.444,0,1,0,4,8,0.5,2,2,1,0,3,3
6218,D'Angelo Russell,20-306,G,12/25/16,LAL,,LAC,W,1,32,5,13,0.385,3,7,0.429,2,6,0.333,2,2,1,0,5,5
6219,D'Angelo Russell,21-022,G,3/17/17,LAL,,MIL,L,0,21,5,9,0.556,3,6,0.5,2,3,0.667,2,5,0.4,0,2,2
6220,Dario Saric,22-208,F,11/2/16,PHI,@,CHO,L,1,29,5,13,0.385,3,9,0.333,2,4,0.5,2,3,0.667,1,6,7
6221,Dario Saric,22-300,F,2/2/17,PHI,@,SAS,L,1,36,5,17,0.294,3,10,0.3,2,7,0.286,2,2,1,3,5,8
6222,Dario Saric,22-215,F,11/9/16,PHI,@,IND,L,1,34,5,9,0.556,3,7,0.429,2,2,1,2,2,1,2,10,12
6223,Dario Saric,22-332,F,3/6/17,PHI,,MIL,L,1,33,5,15,0.333,4,10,0.4,1,5,0.2,3,4,0.75,2,6,8
6224,Dario Saric,22-265,F,12/29/16,PHI,@,UTA,L,0,25,6,11,0.545,5,8,0.625,1,3,0.333,1,1,1,2,2,4
6225,Dennis Schroder,23-042,G,10/27/16,ATL,,WAS,W,1,25,6,12,0.5,4,8,0.5,2,4,0.5,0,0,,0,2,2
6226,Dennis Schroder,23-068,G,11/22/16,ATL,,NOP,L,1,27,6,13,0.462,5,9,0.556,1,4,0.25,1,2,0.5,0,4,4
6227,Luis Scola,36-182,F,10/29/16,BRK,@,MIL,L,0,18,5,5,1,3,3,1,2,2,1,2,2,1,5,3,8
6228,Luis Scola,36-265,F,1/20/17,BRK,@,NOP,W,0,8,6,8,0.75,5,6,0.833,1,2,0.5,1,1,1,2,1,3
6229,Iman Shumpert,26-164,G,12/7/16,CLE,@,NYK,W,0,23,4,8,0.5,0,2,0,4,6,0.667,2,2,1,0,6,6
6230,Pascal Siakam,22-303,F,12/3/16,TOR,,ATL,W,1,27,7,12,0.583,7,11,0.636,0,1,0,0,0,,1,2,3
6231,Jonathon Simmons,27-185,G-F,3/18/17,SAS,@,MEM,L,0,18,4,6,0.667,2,3,0.667,2,3,0.667,4,4,1,1,0,1
6232,Jonathon Simmons,27-087,G-F,12/10/16,SAS,,BRK,W,0,18,6,8,0.75,4,6,0.667,2,2,1,0,0,,0,0,0
6233,Jonathon Simmons,27-118,G-F,1/10/17,SAS,,MIL,L,0,23,5,8,0.625,3,4,0.75,2,4,0.5,2,2,1,0,0,0
6234,Jonathon Simmons,27-175,G-F,3/8/17,SAS,,SAC,W,1,25,5,13,0.385,4,11,0.364,1,2,0.5,3,3,1,1,3,4
6235,Marcus Smart,22-242,G,11/3/16,BOS,@,CLE,L,0,28,5,9,0.556,2,3,0.667,3,6,0.5,1,2,0.5,0,2,2
6236,Marcus Smart,22-306,G,1/6/17,BOS,,PHI,W,0,30,4,12,0.333,2,7,0.286,2,5,0.4,4,4,1,0,2,2
6237,Marcus Smart,22-357,G,2/26/17,BOS,@,DET,W,0,31,5,10,0.5,5,7,0.714,0,3,0,4,5,0.8,4,1,5
6238,Ish Smith,28-134,G,11/16/16,DET,@,NYK,L,1,35,6,7,0.857,5,6,0.833,1,1,1,1,2,0.5,1,1,2
6239,Ish Smith,28-144,G,11/26/16,DET,@,OKC,L,1,31,6,11,0.545,6,11,0.545,0,0,,2,2,1,0,1,1
6240,J.R. Smith,31-099,G-F,12/17/16,CLE,,LAL,W,1,31,5,8,0.625,1,3,0.333,4,5,0.8,0,0,,0,1,1
6241,Tony Snell,25-064,G-F,1/13/17,MIL,,MIA,W,1,29,5,8,0.625,3,5,0.6,2,3,0.667,2,2,1,0,1,1
6242,Tony Snell,24-359,G-F,11/3/16,MIL,,IND,W,1,29,6,9,0.667,4,4,1,2,5,0.4,0,0,,0,1,1
6243,Tony Snell,25-007,G-F,11/17/16,MIL,@,MIA,L,1,32,5,10,0.5,1,1,1,4,9,0.444,0,0,,2,4,6
6244,Marreese Speights,29-140,C-F,12/22/16,LAC,,SAS,W,0,29,5,10,0.5,4,5,0.8,1,5,0.2,3,3,1,2,4,6
6245,Marreese Speights,29-136,C-F,12/18/16,LAC,@,WAS,L,0,12,4,7,0.571,2,2,1,2,5,0.4,4,4,1,3,1,4
6246,Marreese Speights,29-090,C-F,11/2/16,LAC,,OKC,L,0,16,6,9,0.667,5,7,0.714,1,2,0.5,1,2,0.5,1,3,4
6247,Nik Stauskas,23-141,G,2/25/17,PHI,@,NYK,L,0,24,5,9,0.556,3,5,0.6,2,4,0.5,2,2,1,0,3,3
6248,Nik Stauskas,23-035,G,11/11/16,PHI,,IND,W,0,24,5,7,0.714,3,3,1,2,4,0.5,2,4,0.5,0,0,0
6249,Nik Stauskas,23-062,G,12/8/16,PHI,@,NOP,W,0,22,5,7,0.714,2,2,1,3,5,0.6,1,1,1,1,1,2
6250,Rodney Stuckey,30-235,G,12/12/16,IND,,CHO,W,0,21,5,11,0.455,4,9,0.444,1,2,0.5,3,4,0.75,0,4,4
6251,Jeff Teague,28-216,G,1/12/17,IND,@,DEN,L,1,25,5,7,0.714,5,6,0.833,0,1,0,4,5,0.8,0,3,3
6252,Mirza Teletovic,31-059,F,11/16/16,MIL,@,ATL,L,0,26,5,10,0.5,1,1,1,4,9,0.444,0,0,,0,4,4
6253,Garrett Temple,30-309,G,3/13/17,SAC,,ORL,W,1,35,6,9,0.667,4,4,1,2,5,0.4,0,0,,0,3,3
6254,Garrett Temple,30-245,G,1/8/17,SAC,,GSW,L,1,42,5,9,0.556,3,4,0.75,2,5,0.4,2,4,0.5,0,1,1
6255,Garrett Temple,30-257,G,1/20/17,SAC,@,MEM,L,1,33,5,9,0.556,3,4,0.75,2,5,0.4,2,3,0.667,0,3,3
6256,Garrett Temple,30-234,G,12/28/16,SAC,@,POR,L,0,31,6,13,0.462,4,7,0.571,2,6,0.333,0,0,,0,3,3
6257,Hollis Thompson,25-230,G-F,11/19/16,PHI,,PHO,W,0,26,5,9,0.556,2,4,0.5,3,5,0.6,1,2,0.5,2,2,4
6258,Klay Thompson,26-345,G,1/18/17,GSW,,OKC,W,1,30,5,12,0.417,2,7,0.286,3,5,0.6,1,2,0.5,1,3,4
6259,Klay Thompson,26-267,G,11/1/16,GSW,@,POR,W,1,30,6,17,0.353,6,10,0.6,0,7,0,2,2,1,2,3,5
6260,Klay Thompson,26-331,G,1/4/17,GSW,,POR,W,1,37,5,15,0.333,4,8,0.5,1,7,0.143,3,3,1,0,3,3
6261,Klay Thompson,26-265,G,10/30/16,GSW,@,PHO,W,1,40,5,15,0.333,5,9,0.556,0,6,0,4,5,0.8,0,6,6
6262,Tristan Thompson,25-338,F-C,2/14/17,CLE,@,MIN,W,1,35,6,7,0.857,6,7,0.857,0,0,,2,3,0.667,6,5,11
6263,Tristan Thompson,25-314,F-C,1/21/17,CLE,,SAS,L,1,39,7,13,0.538,7,13,0.538,0,0,,0,4,0,5,7,12
6264,Tristan Thompson,25-363,F-C,3/11/17,CLE,@,ORL,W,1,28,6,9,0.667,6,9,0.667,0,0,,2,7,0.286,3,10,13
6265,Anthony Tolliver,31-241,F-C,1/28/17,SAC,@,CHO,W,0,30,5,9,0.556,1,1,1,4,8,0.5,0,0,,0,7,7
6266,Anthony Tolliver,31-217,F-C,1/4/17,SAC,,MIA,L,0,29,5,6,0.833,4,4,1,1,2,0.5,3,3,1,0,3,3
6267,Karl-Anthony Towns,21-024,F-C,12/9/16,MIN,,DET,L,1,32,6,12,0.5,6,10,0.6,0,2,0,2,4,0.5,3,9,12
6268,P.J. Tucker,31-238,F,12/29/16,PHO,,TOR,W,1,30,4,7,0.571,2,4,0.5,2,3,0.667,4,4,1,1,3,4
6269,Evan Turner,28-005,G,11/1/16,POR,,GSW,L,0,21,5,6,0.833,4,5,0.8,1,1,1,3,4,0.75,0,1,1
6270,Evan Turner,28-017,G,11/13/16,POR,,DEN,W,0,29,5,17,0.294,5,14,0.357,0,3,0,4,4,1,2,3,5
6271,Evan Turner,28-047,G,12/13/16,POR,,OKC,W,0,27,6,8,0.75,5,6,0.833,1,2,0.5,1,2,0.5,0,3,3
6272,Evan Turner,28-081,G,1/16/17,POR,@,WAS,L,0,21,5,8,0.625,3,6,0.5,2,2,1,2,2,1,1,2,3
6273,Myles Turner,20-261,F-C,12/10/16,IND,,POR,W,1,33,5,8,0.625,4,7,0.571,1,1,1,3,4,0.75,3,5,8
6274,Myles Turner,20-309,F-C,1/27/17,IND,,SAC,W,1,35,6,9,0.667,5,7,0.714,1,2,0.5,1,2,0.5,1,1,2
6275,Tyler Ulis,21-057,G,3/3/17,PHO,,OKC,W,0,21,6,9,0.667,6,9,0.667,0,0,,2,2,1,0,4,4
6276,Jonas Valanciunas,24-246,C,1/7/17,TOR,@,CHI,L,1,33,7,11,0.636,7,11,0.636,0,0,,0,0,,1,6,7
6277,Jonas Valanciunas,24-311,C,3/13/17,TOR,,DAL,W,1,23,5,11,0.455,5,11,0.455,0,0,,4,5,0.8,3,9,12
6278,Jonas Valanciunas,24-193,C,11/15/16,TOR,@,CLE,L,1,34,5,9,0.556,5,9,0.556,0,0,,4,4,1,3,6,9
6279,Jonas Valanciunas,24-240,C,1/1/17,TOR,@,LAL,W,1,31,6,7,0.857,6,7,0.857,0,0,,2,2,1,2,8,10
6280,Jonas Valanciunas,24-252,C,1/13/17,TOR,,BRK,W,1,25,4,9,0.444,4,9,0.444,0,0,,6,6,1,3,7,10
6281,Jonas Valanciunas,24-231,C,12/23/16,TOR,@,UTA,W,1,16,5,5,1,5,5,1,0,0,,4,6,0.667,0,7,7
6282,Rashad Vaughn,20-081,G,11/5/16,MIL,,SAC,W,0,25,5,9,0.556,1,1,1,4,8,0.5,0,0,,0,3,3
6283,Nikola Vucevic,26-095,C,1/27/17,ORL,@,BOS,L,1,23,7,10,0.7,7,9,0.778,0,1,0,0,0,,0,7,7
6284,Nikola Vucevic,26-106,C,2/7/17,ORL,@,HOU,L,1,30,7,12,0.583,7,12,0.583,0,0,,0,0,,5,14,19
6285,Nikola Vucevic,26-128,C,3/1/17,ORL,,NYK,L,1,27,6,16,0.375,6,16,0.375,0,0,,2,2,1,3,7,10
6286,Nikola Vucevic,26-070,C,1/2/17,ORL,@,NYK,W,0,31,7,11,0.636,7,11,0.636,0,0,,0,1,0,5,8,13
6287,Dwyane Wade,35-012,G,1/29/17,CHI,,PHI,W,1,26,6,12,0.5,6,12,0.5,0,0,,2,2,1,2,4,6
6288,Dwyane Wade,34-300,G,11/12/16,CHI,,WAS,W,1,30,5,17,0.294,5,15,0.333,0,2,0,4,4,1,2,0,2
6289,Dwyane Wade,34-286,G,10/29/16,CHI,,IND,W,1,21,4,7,0.571,4,7,0.571,0,0,,6,6,1,2,3,5
6290,Dion Waiters,25-095,G,3/15/17,MIA,,NOP,W,1,29,5,15,0.333,4,9,0.444,1,6,0.167,3,4,0.75,0,1,1
6291,Dion Waiters,25-076,G,2/24/17,MIA,@,ATL,W,1,31,6,19,0.316,4,14,0.286,2,5,0.4,0,0,,1,2,3
6292,Kemba Walker,26-277,G,2/9/17,CHO,,HOU,L,1,36,6,14,0.429,4,8,0.5,2,6,0.333,0,0,,0,5,5
6293,John Wall,26-192,G,3/17/17,WAS,,CHI,W,1,34,4,13,0.308,3,10,0.3,1,3,0.333,5,6,0.833,0,0,0
6294,T.J. Warren,23-159,F,2/11/17,PHO,@,HOU,L,1,28,6,10,0.6,5,8,0.625,1,2,0.5,1,2,0.5,2,3,5
6295,T.J. Warren,23-181,F,3/5/17,PHO,,BOS,W,1,32,6,10,0.6,6,8,0.75,0,2,0,2,3,0.667,2,5,7
6296,T.J. Warren,23-051,F,10/26/16,PHO,,SAC,L,1,30,5,14,0.357,5,12,0.417,0,2,0,4,4,1,2,3,5
6297,Russell Westbrook,27-361,G,11/7/16,OKC,,MIA,W,1,27,5,16,0.313,4,10,0.4,1,6,0.167,3,3,1,2,3,5
6298,Isaiah Whitehead,21-358,G,3/1/17,BRK,@,SAC,W,0,18,3,4,0.75,2,2,1,1,2,0.5,7,7,1,0,2,2
6299,Isaiah Whitehead,21-274,G,12/7/16,BRK,,DEN,W,1,29,5,11,0.455,3,6,0.5,2,5,0.4,2,3,0.667,0,2,2
6300,Hassan Whiteside,27-218,C,1/17/17,MIA,,HOU,W,1,33,5,8,0.625,5,8,0.625,0,0,,4,6,0.667,4,11,15
6301,Hassan Whiteside,27-141,C,11/1/16,MIA,,SAC,W,1,28,6,13,0.462,6,13,0.462,0,0,,2,4,0.5,2,9,11
6302,Andrew Wiggins,21-272,F-G,11/21/16,MIN,,BOS,L,1,39,5,18,0.278,5,13,0.385,0,5,0,4,6,0.667,0,4,4
6303,Alan Williams,24-046,F-C,3/15/17,PHO,,SAC,L,0,31,6,16,0.375,6,16,0.375,0,0,,2,3,0.667,4,7,11
6304,Alan Williams,24-013,F-C,2/10/17,PHO,,CHI,W,0,24,7,12,0.583,7,12,0.583,0,0,,0,0,,5,6,11
6305,Alan Williams,24-034,F-C,3/3/17,PHO,,OKC,W,0,30,7,15,0.467,7,15,0.467,0,0,,0,0,,6,7,13
6306,Deron Williams,32-124,G,10/28/16,DAL,,HOU,L,1,34,5,11,0.455,4,7,0.571,1,4,0.25,3,4,0.75,0,0,0
6307,Deron Williams,32-158,G,12/1/16,DAL,@,CHO,L,1,30,6,14,0.429,5,7,0.714,1,7,0.143,1,1,1,0,3,3
6308,Derrick Williams,25-278,F,2/27/17,CLE,,MIL,W,0,27,5,7,0.714,3,3,1,2,4,0.5,2,2,1,1,6,7
6309,Lou Williams,30-046,G,12/12/16,LAL,@,SAC,L,0,26,3,12,0.25,1,7,0.143,2,5,0.4,6,8,0.75,0,1,1
6310,Lou Williams,30-059,G,12/25/16,LAL,,LAC,W,0,24,5,11,0.455,4,8,0.5,1,3,0.333,3,4,0.75,0,3,3
6311,Lou Williams,30-010,G,11/6/16,LAL,,PHO,W,0,26,5,12,0.417,4,10,0.4,1,2,0.5,3,5,0.6,1,3,4
6312,Lou Williams,30-068,G,1/3/17,LAL,,MEM,W,0,17,4,9,0.444,3,5,0.6,1,4,0.25,5,5,1,0,1,1
6313,Lou Williams,30-141,G,3/17/17,HOU,@,NOP,L,0,31,4,12,0.333,4,9,0.444,0,3,0,6,8,0.75,0,1,1
6314,Marvin Williams,30-227,F,2/1/17,CHO,@,GSW,L,1,31,6,13,0.462,4,7,0.571,2,6,0.333,0,0,,0,6,6
6315,Marvin Williams,30-223,F,1/28/17,CHO,,SAC,L,1,31,5,12,0.417,3,4,0.75,2,8,0.25,2,2,1,1,1,2
6316,Marvin Williams,30-262,F,3/8/17,CHO,@,MIA,L,1,37,5,8,0.625,4,5,0.8,1,3,0.333,3,4,0.75,2,10,12
6317,Marvin Williams,30-220,F,1/25/17,CHO,,GSW,L,1,30,6,12,0.5,5,9,0.556,1,3,0.333,1,2,0.5,0,5,5
6318,Marvin Williams,30-258,F,3/4/17,CHO,@,DEN,W,1,38,5,7,0.714,3,5,0.6,2,2,1,2,2,1,6,6,12
6319,Marvin Williams,30-233,F,2/7/17,CHO,,BRK,W,1,33,6,11,0.545,6,8,0.75,0,3,0,2,2,1,1,8,9
6320,Troy Williams,21-307,F,11/1/16,MEM,@,MIN,L,1,30,4,7,0.571,4,6,0.667,0,1,0,6,7,0.857,1,1,2
6321,Christian Wood,21-164,F,3/10/17,CHO,,ORL,W,0,16,5,6,0.833,5,6,0.833,0,0,,4,5,0.8,3,2,5
6322,Nick Young,31-196,G-F,12/14/16,LAL,@,BRK,L,1,30,5,15,0.333,2,5,0.4,3,10,0.3,1,1,1,3,1,4
6323,Thaddeus Young,28-153,F,11/21/16,IND,,GSW,L,1,29,6,14,0.429,4,10,0.4,2,4,0.5,0,0,,3,3,6
6324,Thaddeus Young,28-133,F,11/1/16,IND,,LAL,W,1,28,6,8,0.75,4,4,1,2,4,0.5,0,0,,1,5,6
6325,Cody Zeller,24-041,F-C,11/15/16,CHO,@,MIN,W,1,31,6,9,0.667,6,9,0.667,0,0,,2,2,1,2,7,9
6326,Paul Zipser,22-344,G-F,1/27/17,CHI,,MIA,L,1,27,5,11,0.455,4,7,0.571,1,4,0.25,3,3,1,0,5,5
6327,Ivica Zubac,19-356,C,3/9/17,LAL,@,PHO,W,0,17,7,13,0.538,7,13,0.538,0,0,,0,1,0,2,1,3
6328,Alex Abrines,23-209,G-F,2/26/17,OKC,,NOP,W,1,35,4,12,0.333,1,5,0.2,3,7,0.429,2,2,1,1,2,3
6329,Alex Abrines,23-225,G-F,3/14/17,OKC,@,BRK,W,0,26,5,7,0.714,2,2,1,3,5,0.6,0,0,,0,3,3
6330,Alex Abrines,23-167,G-F,1/15/17,OKC,@,SAC,W,0,17,3,5,0.6,0,1,0,3,4,0.75,4,5,0.8,1,2,3
6331,Alex Abrines,23-214,G-F,3/3/17,OKC,@,PHO,L,1,33,5,11,0.455,2,3,0.667,3,8,0.375,0,0,,0,1,1
6332,Steven Adams,23-206,C,2/11/17,OKC,,GSW,L,1,35,6,9,0.667,6,9,0.667,0,0,,1,6,0.167,2,1,3
6333,Steven Adams,23-116,C,11/13/16,OKC,,ORL,L,1,35,6,13,0.462,6,13,0.462,0,0,,1,1,1,4,6,10
6334,Steven Adams,23-221,C,2/26/17,OKC,,NOP,W,1,29,6,10,0.6,6,10,0.6,0,0,,1,5,0.2,9,1,10
6335,Arron Afflalo,31-105,G,1/28/17,SAC,@,CHO,W,1,31,4,8,0.5,2,4,0.5,2,4,0.5,3,4,0.75,0,2,2
6336,LaMarcus Aldridge,31-202,F-C,2/6/17,SAS,@,MEM,L,1,34,4,19,0.211,4,18,0.222,0,1,0,5,7,0.714,5,5,10
6337,LaMarcus Aldridge,31-179,F-C,1/14/17,SAS,@,PHO,L,1,34,6,14,0.429,5,13,0.385,1,1,1,0,0,,2,2,4
6338,LaMarcus Aldridge,31-177,F-C,1/12/17,SAS,,LAL,W,1,24,5,11,0.455,4,10,0.4,1,1,1,2,2,1,2,2,4
6339,Tony Allen,34-359,G-F,1/4/17,MEM,@,LAC,L,1,30,5,9,0.556,5,8,0.625,0,1,0,3,3,1,2,4,6
6340,Tony Allen,35-009,G-F,1/20/17,MEM,,SAC,W,1,31,6,11,0.545,6,10,0.6,0,1,0,1,2,0.5,5,5,10
6341,Al-Farouq Aminu,26-158,F,2/26/17,POR,@,TOR,L,0,29,3,6,0.5,2,3,0.667,1,3,0.333,6,6,1,3,5,8
6342,Justin Anderson,23-038,G,12/27/16,DAL,,HOU,L,0,21,4,8,0.5,2,2,1,2,6,0.333,3,4,0.75,2,6,8
6343,Justin Anderson,23-018,G,12/7/16,DAL,,SAC,L,0,16,3,8,0.375,3,6,0.5,0,2,0,7,8,0.875,2,1,3
6344,Kyle Anderson,23-172,F-G,3/11/17,SAS,,GSW,W,1,32,5,7,0.714,4,5,0.8,1,2,0.5,2,2,1,1,7,8
6345,Ryan Anderson,28-201,F,11/23/16,HOU,,TOR,L,1,29,5,13,0.385,2,5,0.4,3,8,0.375,0,0,,2,1,3
6346,Ryan Anderson,28-195,F,11/17/16,HOU,,POR,W,1,33,4,8,0.5,1,3,0.333,3,5,0.6,2,3,0.667,2,3,5
6347,Ryan Anderson,28-203,F,11/25/16,HOU,@,SAC,W,1,29,4,10,0.4,1,3,0.333,3,7,0.429,2,2,1,0,0,0
6348,Ryan Anderson,28-249,F,1/10/17,HOU,,CHO,W,1,36,5,12,0.417,2,5,0.4,3,7,0.429,0,0,,2,0,2
6349,Carmelo Anthony,32-234,F,1/18/17,NYK,@,BOS,W,1,33,5,14,0.357,2,5,0.4,3,9,0.333,0,0,,1,3,4
6350,Carmelo Anthony,32-198,F,12/13/16,NYK,@,PHO,L,1,39,3,15,0.2,3,13,0.231,0,2,0,7,8,0.875,0,6,6
6351,Carmelo Anthony,32-286,F,3/11/17,NYK,@,DET,L,1,36,4,9,0.444,1,3,0.333,3,6,0.5,2,2,1,0,1,1
6352,Carmelo Anthony,32-196,F,12/11/16,NYK,@,LAL,W,1,38,4,16,0.25,4,12,0.333,0,4,0,5,6,0.833,0,7,7
6353,Trevor Ariza,31-253,F,3/10/17,HOU,@,CHI,W,1,30,3,6,0.5,1,2,0.5,2,4,0.5,5,6,0.833,1,10,11
6354,Trevor Ariza,31-249,F,3/6/17,HOU,@,SAS,L,1,35,5,11,0.455,3,3,1,2,8,0.25,1,1,1,0,8,8
6355,Trevor Ariza,31-190,F,1/6/17,HOU,@,ORL,W,1,29,5,10,0.5,2,2,1,3,8,0.375,0,0,,2,4,6
6356,Darrell Arthur,28-286,F,1/5/17,DEN,,SAS,L,1,19,5,8,0.625,3,4,0.75,2,4,0.5,1,1,1,1,3,4
6357,Darrell Arthur,28-322,F,2/10/17,DEN,@,NYK,W,1,21,5,9,0.556,2,3,0.667,3,6,0.5,0,0,,0,3,3
6358,D.J. Augustin,28-354,G,10/29/16,ORL,@,CLE,L,0,21,5,12,0.417,3,6,0.5,2,6,0.333,1,1,1,0,2,2
6359,Ron Baker,23-260,G,12/15/16,NYK,@,GSW,L,0,23,6,7,0.857,5,5,1,1,2,0.5,0,0,,0,2,2
6360,Leandro Barbosa,34-113,G,3/21/17,PHO,@,MIA,L,0,18,4,7,0.571,3,5,0.6,1,2,0.5,4,4,1,0,1,1
6361,Leandro Barbosa,33-356,G,11/18/16,PHO,@,IND,W,0,24,5,9,0.556,2,5,0.4,3,4,0.75,0,0,,0,1,1
6362,Leandro Barbosa,34-008,G,12/6/16,PHO,@,UTA,L,0,21,5,10,0.5,3,7,0.429,2,3,0.667,1,1,1,0,3,3
6363,J.J. Barea,32-207,G,1/19/17,DAL,@,MIA,L,0,16,5,10,0.5,2,4,0.5,3,6,0.5,0,0,,0,1,1
6364,Harrison Barnes,24-249,F,2/3/17,DAL,@,POR,W,1,38,6,14,0.429,5,11,0.455,1,3,0.333,0,0,,0,7,7
6365,Harrison Barnes,24-230,F,1/15/17,DAL,,MIN,W,1,32,6,16,0.375,6,12,0.5,0,4,0,1,2,0.5,0,3,3
6366,Matt Barnes,36-294,F,12/28/16,SAC,@,POR,L,1,29,5,11,0.455,4,7,0.571,1,4,0.25,2,2,1,1,4,5
6367,Will Barton,26-054,G,3/1/17,DEN,@,MIL,W,0,20,5,11,0.455,5,8,0.625,0,3,0,3,3,1,4,0,4
6368,Nicolas Batum,28-017,F-G,12/31/16,CHO,,CLE,L,1,35,5,11,0.455,4,9,0.444,1,2,0.5,2,2,1,0,6,6
6369,Nicolas Batum,27-364,F-G,12/12/16,CHO,@,IND,L,1,35,4,13,0.308,0,6,0,4,7,0.571,1,2,0.5,1,9,10
6370,Nicolas Batum,28-037,F-G,1/20/17,CHO,,TOR,W,1,31,4,11,0.364,3,9,0.333,1,2,0.5,4,5,0.8,0,4,4
6371,Nicolas Batum,28-049,F-G,2/1/17,CHO,@,GSW,L,1,24,4,7,0.571,1,3,0.333,3,4,0.75,2,2,1,2,3,5
6372,Nicolas Batum,27-345,F-G,11/23/16,CHO,,SAS,L,1,40,5,9,0.556,3,6,0.5,2,3,0.667,1,1,1,1,6,7
6373,Nicolas Batum,27-341,F-G,11/19/16,CHO,@,NOP,L,1,35,3,10,0.3,1,4,0.25,2,6,0.333,5,5,1,1,6,7
6374,Aron Baynes,30-100,C,3/19/17,DET,,PHO,W,0,18,5,9,0.556,5,9,0.556,0,0,,3,3,1,5,12,17
6375,Aron Baynes,29-324,C,10/28/16,DET,,ORL,W,0,18,6,8,0.75,6,8,0.75,0,0,,1,2,0.5,1,2,3
6376,Bradley Beal,23-121,G,10/27/16,WAS,@,ATL,L,1,24,6,12,0.5,6,10,0.6,0,2,0,1,1,1,0,0,0
6377,Michael Beasley,27-323,F,11/27/16,MIL,@,ORL,W,0,17,6,9,0.667,6,9,0.667,0,0,,1,1,1,1,5,6
6378,Michael Beasley,27-313,F,11/17/16,MIL,@,MIA,L,0,16,5,11,0.455,5,11,0.455,0,0,,3,5,0.6,4,6,10
6379,Marco Belinelli,30-229,G-F,11/9/16,CHO,,UTA,W,0,27,5,7,0.714,4,5,0.8,1,2,0.5,2,2,1,0,1,1
6380,Marco Belinelli,30-316,G-F,2/4/17,CHO,@,UTA,L,0,24,4,9,0.444,1,3,0.333,3,6,0.5,2,2,1,0,2,2
6381,Marco Belinelli,30-257,G-F,12/7/16,CHO,,DET,W,0,28,5,10,0.5,4,6,0.667,1,4,0.25,2,2,1,0,5,5
6382,Marco Belinelli,30-270,G-F,12/20/16,CHO,,LAL,W,0,33,4,10,0.4,1,4,0.25,3,6,0.5,2,3,0.667,0,2,2
6383,Marco Belinelli,30-299,G-F,1/18/17,CHO,,POR,W,0,24,5,8,0.625,4,6,0.667,1,2,0.5,2,2,1,0,5,5
6384,Marco Belinelli,30-337,G-F,2/25/17,CHO,@,SAC,W,0,29,4,7,0.571,2,3,0.667,2,4,0.5,3,3,1,0,2,2
6385,Davis Bertans,24-119,F,3/11/17,SAS,,GSW,W,0,21,4,7,0.571,1,2,0.5,3,5,0.6,2,2,1,1,2,3
6386,Patrick Beverley,28-243,G,3/12/17,HOU,,CLE,W,1,34,4,10,0.4,1,4,0.25,3,6,0.5,2,4,0.5,2,1,3
6387,Patrick Beverley,28-164,G,12/23/16,HOU,@,MEM,L,1,33,4,11,0.364,1,2,0.5,3,9,0.333,2,2,1,2,4,6
6388,Patrick Beverley,28-192,G,1/20/17,HOU,,GSW,L,1,24,5,10,0.5,2,6,0.333,3,4,0.75,0,2,0,1,2,3
6389,Patrick Beverley,28-157,G,12/16/16,HOU,,NOP,W,1,34,5,10,0.5,2,2,1,3,8,0.375,0,0,,6,5,11
6390,Bismack Biyombo,24-145,C-F,1/20/17,ORL,,MIL,W,0,25,5,6,0.833,5,6,0.833,0,0,,3,5,0.6,1,12,13
6391,Bismack Biyombo,24-083,C-F,11/19/16,ORL,,DAL,W,0,23,4,6,0.667,4,6,0.667,0,0,,5,7,0.714,3,7,10
6392,Bismack Biyombo,24-085,C-F,11/21/16,ORL,@,MIL,L,0,22,6,8,0.75,6,8,0.75,0,0,,1,2,0.5,3,7,10
6393,Nemanja Bjelica,28-296,F,3/1/17,MIN,@,UTA,W,0,32,4,10,0.4,3,7,0.429,1,3,0.333,4,5,0.8,1,10,11
6394,Tarik Black,25-072,C-F,2/2/17,LAL,@,WAS,L,1,26,5,6,0.833,5,6,0.833,0,0,,3,5,0.6,2,9,11
6395,Eric Bledsoe,27-057,G,2/4/17,PHO,,MIL,L,1,35,3,11,0.273,2,8,0.25,1,3,0.333,6,6,1,1,3,4
6396,Eric Bledsoe,27-090,G,3/9/17,PHO,,LAL,L,1,32,4,12,0.333,3,8,0.375,1,4,0.25,4,6,0.667,0,7,7
6397,Eric Bledsoe,27-019,G,12/28/16,PHO,@,SAS,L,1,27,6,9,0.667,6,7,0.857,0,2,0,1,1,1,1,1,2
6398,Bojan Bogdanovic,27-293,G-F,2/5/17,BRK,,TOR,L,1,27,4,11,0.364,1,3,0.333,3,8,0.375,2,2,1,0,3,3
6399,Bojan Bogdanovic,27-227,G-F,12/1/16,BRK,,MIL,L,1,27,5,14,0.357,3,8,0.375,2,6,0.333,1,1,1,0,3,3
6400,Bojan Bogdanovic,27-223,G-F,11/27/16,BRK,,SAC,L,1,28,4,9,0.444,2,4,0.5,2,5,0.4,3,4,0.75,0,1,1
6401,Bojan Bogdanovic,27-204,G-F,11/8/16,BRK,,MIN,W,1,27,3,9,0.333,0,1,0,3,8,0.375,4,4,1,0,1,1
6402,Bojan Bogdanovic,27-214,G-F,11/18/16,BRK,@,OKC,L,1,24,4,6,0.667,3,5,0.6,1,1,1,4,6,0.667,1,2,3
6403,Devin Booker,20-038,G,12/7/16,PHO,,IND,L,1,31,4,13,0.308,2,7,0.286,2,6,0.333,3,4,0.75,1,2,3
6404,Devin Booker,20-019,G,11/18/16,PHO,@,IND,W,1,23,4,11,0.364,3,6,0.5,1,5,0.2,4,4,1,0,1,1
6405,Devin Booker,20-031,G,11/30/16,PHO,,ATL,W,1,33,5,13,0.385,4,11,0.364,1,2,0.5,2,6,0.333,0,1,1
6406,Devin Booker,20-064,G,1/2/17,PHO,@,LAC,L,1,33,4,15,0.267,3,10,0.3,1,5,0.2,4,6,0.667,0,1,1
6407,Trevor Booker,29-080,F,2/13/17,BRK,,MEM,L,0,23,6,10,0.6,6,8,0.75,0,2,0,1,1,1,2,2,4
6408,Trevor Booker,29-042,F,1/6/17,BRK,,CLE,L,1,32,6,9,0.667,6,9,0.667,0,0,,1,1,1,1,11,12
6409,Trevor Booker,29-066,F,1/30/17,BRK,@,MIA,L,1,26,5,9,0.556,5,8,0.625,0,1,0,3,5,0.6,2,6,8
6410,Avery Bradley,25-342,G,11/2/16,BOS,,CHI,W,1,39,6,15,0.4,5,8,0.625,1,7,0.143,0,0,,2,3,5
6411,Avery Bradley,25-352,G,11/12/16,BOS,@,IND,W,1,36,5,11,0.455,4,7,0.571,1,4,0.25,2,2,1,1,7,8
6412,Avery Bradley,25-361,G,11/21/16,BOS,@,MIN,W,1,33,5,12,0.417,4,9,0.444,1,3,0.333,2,2,1,0,3,3
6413,Avery Bradley,26-113,G,3/19/17,BOS,@,PHI,L,1,34,6,14,0.429,6,9,0.667,0,5,0,1,1,1,1,2,3
6414,Avery Bradley,25-359,G,11/19/16,BOS,@,DET,W,1,36,6,10,0.6,5,7,0.714,1,3,0.333,0,0,,1,3,4
6415,Malcolm Brogdon,24-085,G,3/6/17,MIL,@,PHI,W,1,21,6,7,0.857,5,6,0.833,1,1,1,0,0,,1,4,5
6416,Malcolm Brogdon,24-033,G,1/13/17,MIL,,MIA,W,1,30,3,6,0.5,2,4,0.5,1,2,0.5,6,6,1,3,3,6
6417,Malcolm Brogdon,23-362,G,12/7/16,MIL,,POR,W,0,24,4,6,0.667,1,3,0.333,3,3,1,2,2,1,0,1,1
6418,Malcolm Brogdon,24-055,G,2/4/17,MIL,@,PHO,W,0,26,5,8,0.625,4,7,0.571,1,1,1,2,3,0.667,2,3,5
6419,Malcolm Brogdon,23-356,G,12/1/16,MIL,@,BRK,W,0,26,4,7,0.571,1,3,0.333,3,4,0.75,2,2,1,1,3,4
6420,Jaylen Brown,20-125,F,2/26/17,BOS,@,DET,W,1,26,5,9,0.556,3,7,0.429,2,2,1,1,3,0.333,2,3,5
6421,Jaylen Brown,20-044,F,12/7/16,BOS,@,ORL,W,0,22,5,8,0.625,4,5,0.8,1,3,0.333,2,3,0.667,1,1,2
6422,Jaylen Brown,20-123,F,2/24/17,BOS,@,TOR,L,1,28,5,8,0.625,3,4,0.75,2,4,0.5,1,1,1,0,0,0
6423,Alec Burks,25-188,G,1/24/17,UTA,@,DEN,L,0,22,5,9,0.556,5,8,0.625,0,1,0,3,4,0.75,0,2,2
6424,Alec Burks,25-187,G,1/23/17,UTA,,OKC,L,0,25,4,7,0.571,4,5,0.8,0,2,0,5,6,0.833,0,2,2
6425,Alec Burks,25-185,G,1/21/17,UTA,,IND,W,0,19,5,8,0.625,4,4,1,1,4,0.25,2,2,1,1,3,4
6426,Alec Burks,25-203,G,2/8/17,UTA,@,NOP,W,0,23,4,8,0.5,3,5,0.6,1,3,0.333,4,4,1,0,5,5
6427,Alec Burks,25-223,G,2/28/17,UTA,@,OKC,L,0,15,5,9,0.556,4,7,0.571,1,2,0.5,2,2,1,1,1,2
6428,Jimmy Butler,27-085,G-F,12/8/16,CHI,,SAS,W,1,38,4,14,0.286,3,11,0.273,1,3,0.333,4,5,0.8,2,7,9
6429,Kentavious Caldwell-Pope,23-261,G,11/5/16,DET,,DEN,W,1,28,5,11,0.455,2,5,0.4,3,6,0.5,0,0,,0,1,1
6430,Clint Capela,22-198,F-C,12/2/16,HOU,@,DEN,W,1,26,6,8,0.75,6,8,0.75,0,0,,1,1,1,2,7,9
6431,Clint Capela,22-182,F-C,11/16/16,HOU,@,OKC,L,1,28,5,8,0.625,5,8,0.625,0,0,,3,4,0.75,4,10,14
6432,Clint Capela,22-206,F-C,12/10/16,HOU,,DAL,W,1,27,4,8,0.5,4,8,0.5,0,0,,5,7,0.714,5,5,10
6433,Clint Capela,22-205,F-C,12/9/16,HOU,@,OKC,W,1,17,5,10,0.5,5,10,0.5,0,0,,3,5,0.6,3,3,6
6434,DeMarre Carroll,30-203,F,2/15/17,TOR,,CHO,W,1,39,4,13,0.308,1,5,0.2,3,8,0.375,2,2,1,3,8,11
6435,DeMarre Carroll,30-138,F,12/12/16,TOR,,MIL,W,1,29,5,12,0.417,2,5,0.4,3,7,0.429,0,0,,2,4,6
6436,DeMarre Carroll,30-154,F,12/28/16,TOR,@,GSW,L,1,28,5,12,0.417,2,7,0.286,3,5,0.6,0,0,,3,4,7
6437,Vince Carter,40-001,G-F,1/27/17,MEM,@,POR,L,0,25,4,8,0.5,3,7,0.429,1,1,1,4,4,1,2,0,2
6438,Michael Carter-Williams,25-086,G,1/4/17,CHI,@,CLE,W,1,28,6,13,0.462,6,10,0.6,0,3,0,1,2,0.5,0,3,3
6439,Omri Casspi,28-173,F,12/12/16,SAC,,LAL,W,0,30,6,10,0.6,5,9,0.556,1,1,1,0,3,0,1,5,6
6440,Willie Cauley-Stein,23-205,F-C,3/11/17,SAC,,DEN,L,1,35,3,11,0.273,3,11,0.273,0,0,,7,8,0.875,0,5,5
6441,Willie Cauley-Stein,23-181,F-C,2/15/17,SAC,@,GSW,L,0,24,6,16,0.375,6,16,0.375,0,0,,1,1,1,3,4,7
6442,Willie Cauley-Stein,23-163,F-C,1/28/17,SAC,@,CHO,W,0,14,6,7,0.857,6,7,0.857,0,0,,1,4,0.25,1,2,3
6443,Tyson Chandler,34-072,C,12/13/16,PHO,,NYK,W,1,41,5,8,0.625,5,8,0.625,0,0,,3,3,1,9,14,23
6444,Wilson Chandler,29-295,F,3/1/17,DEN,@,MIL,W,1,36,4,8,0.5,2,3,0.667,2,5,0.4,3,4,0.75,0,5,5
6445,Wilson Chandler,29-197,F,11/23/16,DEN,@,UTA,L,0,25,4,11,0.364,3,8,0.375,1,3,0.333,4,4,1,1,8,9
6446,Wilson Chandler,29-224,F,12/20/16,DEN,@,LAC,L,1,28,5,13,0.385,4,9,0.444,1,4,0.25,2,4,0.5,1,3,4
6447,Wilson Chandler,29-277,F,2/11/17,DEN,@,CLE,L,1,34,6,15,0.4,6,9,0.667,0,6,0,1,1,1,3,3,6
6448,Marquese Chriss,19-179,F,12/28/16,PHO,@,SAS,L,1,21,5,9,0.556,4,6,0.667,1,3,0.333,2,6,0.333,2,0,2
6449,Marquese Chriss,19-194,F,1/12/17,PHO,,DAL,L,1,23,4,6,0.667,1,2,0.5,3,4,0.75,2,2,1,0,3,3
6450,Marquese Chriss,19-258,F,3/17/17,PHO,,ORL,L,1,26,6,9,0.667,5,7,0.714,1,2,0.5,0,0,,0,8,8
6451,Jordan Clarkson,24-161,G,11/15/16,LAL,,BRK,W,0,28,4,12,0.333,3,7,0.429,1,5,0.2,4,6,0.667,2,1,3
6452,Darren Collison,29-103,G,12/4/16,SAC,@,NYK,L,1,39,4,10,0.4,3,7,0.429,1,3,0.333,4,4,1,1,2,3
6453,Darren Collison,29-101,G,12/2/16,SAC,@,BOS,L,1,28,4,8,0.5,3,5,0.6,1,3,0.333,4,4,1,0,0,0
6454,Darren Collison,29-175,G,2/14/17,SAC,@,LAL,W,1,40,5,12,0.417,4,8,0.5,1,4,0.25,2,2,1,1,4,5
6455,Darren Collison,29-143,G,1/13/17,SAC,,CLE,L,1,22,5,10,0.5,3,6,0.5,2,4,0.5,1,1,1,0,1,1
6456,Mike Conley,29-149,G,3/9/17,MEM,,LAC,L,1,36,3,14,0.214,3,10,0.3,0,4,0,7,7,1,0,3,3
6457,Mike Conley,29-039,G,11/19/16,MEM,,MIN,W,1,34,3,9,0.333,2,6,0.333,1,3,0.333,6,6,1,2,2,4
6458,DeMarcus Cousins,26-144,C-F,1/4/17,SAC,,MIA,L,1,32,4,15,0.267,4,11,0.364,0,4,0,5,8,0.625,0,6,6
6459,DeMarcus Cousins,26-186,C-F,2/15/17,SAC,@,GSW,L,1,23,6,14,0.429,5,11,0.455,1,3,0.333,0,1,0,0,4,4
6460,Robert Covington,26-020,F,1/3/17,PHI,,MIN,W,1,39,4,14,0.286,3,5,0.6,1,9,0.111,4,4,1,1,9,10
6461,Robert Covington,26-087,F,3/11/17,PHI,@,LAC,L,1,31,5,9,0.556,3,4,0.75,2,5,0.4,1,1,1,2,4,6
6462,Robert Covington,26-028,F,1/11/17,PHI,,NYK,W,1,32,5,10,0.5,2,4,0.5,3,6,0.5,0,0,,1,4,5
6463,Allen Crabbe,24-325,G-F,2/28/17,POR,@,DET,L,0,35,5,7,0.714,3,5,0.6,2,2,1,1,2,0.5,0,1,1
6464,Allen Crabbe,24-247,G-F,12/12/16,POR,@,LAC,L,0,21,5,9,0.556,4,7,0.571,1,2,0.5,2,2,1,0,2,2
6465,Allen Crabbe,24-263,G-F,12/28/16,POR,,SAC,W,1,33,4,8,0.5,1,4,0.25,3,4,0.75,2,2,1,0,2,2
6466,Jamal Crawford,36-363,G,3/18/17,LAC,,CLE,W,0,28,4,11,0.364,1,6,0.167,3,5,0.6,2,2,1,0,2,2
6467,Jordan Crawford,28-142,G,3/14/17,NOP,,POR,W,0,23,5,11,0.455,3,6,0.5,2,5,0.4,1,2,0.5,0,0,0
6468,Jae Crowder,26-176,F,12/29/16,BOS,@,CLE,L,1,34,5,9,0.556,3,4,0.75,2,5,0.4,1,2,0.5,0,4,4
6469,Jae Crowder,26-167,F,12/20/16,BOS,@,MEM,W,1,40,3,8,0.375,2,4,0.5,1,4,0.25,6,6,1,0,7,7
6470,Seth Curry,26-186,G,2/25/17,DAL,,NOP,W,1,37,4,12,0.333,1,7,0.143,3,5,0.6,2,2,1,0,7,7
6471,Seth Curry,26-115,G,12/16/16,DAL,@,UTA,L,0,28,5,11,0.455,2,6,0.333,3,5,0.6,0,1,0,0,5,5
6472,Seth Curry,26-176,G,2/15/17,DAL,@,DET,L,1,31,5,9,0.556,2,2,1,3,7,0.429,0,0,,0,2,2
6473,Seth Curry,26-088,G,11/19/16,DAL,@,ORL,L,1,35,4,12,0.333,2,7,0.286,2,5,0.4,3,4,0.75,0,1,1
6474,Seth Curry,26-094,G,11/25/16,DAL,@,CLE,L,0,26,5,13,0.385,5,7,0.714,0,6,0,3,3,1,0,4,4
6475,Seth Curry,26-117,G,12/18/16,DAL,,SAC,W,0,29,5,10,0.5,2,4,0.5,3,6,0.5,0,0,,0,5,5
6476,Stephen Curry,28-331,G,2/8/17,GSW,,CHI,W,1,28,5,11,0.455,4,7,0.571,1,4,0.25,2,2,1,0,1,1
6477,Stephen Curry,28-338,G,2/15/17,GSW,,SAC,W,1,30,4,14,0.286,2,6,0.333,2,8,0.25,3,4,0.75,0,6,6
6478,Stephen Curry,28-235,G,11/4/16,GSW,@,LAL,L,1,31,5,17,0.294,5,7,0.714,0,10,0,3,3,1,0,8,8
6479,Stephen Curry,28-266,G,12/5/16,GSW,,IND,W,1,29,4,10,0.4,2,3,0.667,2,7,0.286,3,4,0.75,0,4,4
6480,Troy Daniels,25-182,G,1/13/17,MEM,@,HOU,W,0,22,3,6,0.5,0,0,,3,6,0.5,4,4,1,0,3,3
6481,Troy Daniels,25-224,G,2/24/17,MEM,@,IND,L,0,15,4,10,0.4,0,3,0,4,7,0.571,1,2,0.5,0,0,0
6482,Troy Daniels,25-237,G,3/9/17,MEM,,LAC,L,0,16,4,5,0.8,0,0,,4,5,0.8,1,2,0.5,0,1,1
6483,Troy Daniels,25-154,G,12/16/16,MEM,,SAC,L,0,28,4,11,0.364,0,2,0,4,9,0.444,1,1,1,1,2,3
6484,Anthony Davis,23-256,F-C,11/22/16,NOP,@,ATL,W,1,19,6,12,0.5,6,11,0.545,0,1,0,1,1,1,2,1,3
6485,Dewayne Dedmon,27-174,C,2/2/17,SAS,,PHI,W,1,22,5,7,0.714,5,7,0.714,0,0,,3,3,1,2,8,10
6486,Malcolm Delaney,27-257,G,11/23/16,ATL,@,IND,W,0,22,3,6,0.5,2,4,0.5,1,2,0.5,6,6,1,0,1,1
6487,Malcolm Delaney,27-332,G,2/6/17,ATL,,UTA,L,0,18,5,7,0.714,3,4,0.75,2,3,0.667,1,2,0.5,0,2,2
6488,Malcolm Delaney,27-316,G,1/21/17,ATL,,PHI,W,0,19,6,9,0.667,5,6,0.833,1,3,0.333,0,1,0,0,0,0
6489,Matthew Dellavedova,26-186,G,3/13/17,MIL,@,MEM,L,1,23,5,7,0.714,2,3,0.667,3,4,0.75,0,0,,0,3,3
6490,Luol Deng,31-200,F,11/2/16,LAL,@,ATL,W,1,26,4,11,0.364,3,10,0.3,1,1,1,4,4,1,3,7,10
6491,Luol Deng,31-211,F,11/13/16,LAL,@,MIN,L,1,24,2,5,0.4,0,2,0,2,3,0.667,7,7,1,1,2,3
6492,Luol Deng,31-253,F,12/25/16,LAL,,LAC,W,1,34,4,9,0.444,4,6,0.667,0,3,0,5,7,0.714,5,7,12
6493,Luol Deng,31-250,F,12/22/16,LAL,@,MIA,L,1,34,5,10,0.5,2,4,0.5,3,6,0.5,0,0,,0,7,7
6494,Boris Diaw,34-234,F-C,12/6/16,UTA,,PHO,W,1,33,5,11,0.455,4,6,0.667,1,5,0.2,2,2,1,1,3,4
6495,Gorgui Dieng,27-019,C,2/6/17,MIN,,MIA,L,1,25,6,8,0.75,6,8,0.75,0,0,,1,1,1,0,7,7
6496,Gorgui Dieng,27-001,C,1/19/17,MIN,@,LAC,W,1,26,5,8,0.625,5,8,0.625,0,0,,3,3,1,4,3,7
6497,Gorgui Dieng,26-326,C,12/9/16,MIN,,DET,L,1,27,6,9,0.667,6,9,0.667,0,0,,1,1,1,1,6,7
6498,Gorgui Dieng,27-045,C,3/4/17,MIN,@,SAS,L,1,37,5,11,0.455,5,11,0.455,0,0,,3,4,0.75,5,6,11
6499,Gorgui Dieng,26-310,C,11/23/16,MIN,@,NOP,L,1,24,5,7,0.714,5,7,0.714,0,0,,3,4,0.75,1,7,8
6500,Spencer Dinwiddie,23-261,G,12/23/16,BRK,@,CLE,L,0,21,6,7,0.857,5,6,0.833,1,1,1,0,1,0,1,2,3
6501,Spencer Dinwiddie,23-261,G,12/23/16,BRK,@,CLE,L,0,21,6,7,0.857,5,6,0.833,1,1,1,0,1,0,1,2,3
6502,Spencer Dinwiddie,23-292,G,1/23/17,BRK,,SAS,L,1,32,6,9,0.667,5,7,0.714,1,2,0.5,0,0,,0,2,2
6503,Spencer Dinwiddie,23-274,G,1/5/17,BRK,@,IND,L,0,32,4,7,0.571,3,6,0.5,1,1,1,4,4,1,1,2,3
6504,Spencer Dinwiddie,23-303,G,2/3/17,BRK,,IND,L,0,27,4,9,0.444,1,5,0.2,3,4,0.75,2,2,1,1,3,4
6505,Spencer Dinwiddie,23-325,G,2/25/17,BRK,@,GSW,L,0,29,4,6,0.667,2,3,0.667,2,3,0.667,3,5,0.6,0,5,5
6506,Andre Drummond,23-203,C,3/1/17,DET,@,NOP,L,1,29,6,13,0.462,6,13,0.462,0,0,,1,10,0.1,10,7,17
6507,Andre Drummond,23-128,C,12/16/16,DET,@,WAS,L,1,30,5,7,0.714,5,7,0.714,0,0,,3,6,0.5,4,8,12
6508,Andre Drummond,23-161,C,1/18/17,DET,,ATL,W,1,23,6,15,0.4,6,15,0.4,0,0,,1,6,0.167,8,9,17
6509,Andre Drummond,23-178,C,2/4/17,DET,@,IND,L,1,31,5,8,0.625,5,8,0.625,0,0,,3,5,0.6,2,7,9
6510,Andre Drummond,23-133,C,12/21/16,DET,,MEM,L,1,38,3,8,0.375,3,8,0.375,0,0,,7,10,0.7,7,12,19
6511,Andre Drummond,23-103,C,11/21/16,DET,,HOU,L,1,34,6,18,0.333,6,18,0.333,0,0,,1,6,0.167,6,10,16
6512,Andre Drummond,23-223,C,3/21/17,DET,@,BRK,L,1,31,6,12,0.5,6,12,0.5,0,0,,1,3,0.333,4,13,17
6513,Jarell Eddie,25-140,G-F,3/19/17,PHO,@,DET,L,0,29,3,8,0.375,1,1,1,2,7,0.286,5,5,1,0,2,2
6514,Wayne Ellington,29-067,G,1/4/17,MIA,@,SAC,W,0,24,4,8,0.5,0,3,0,4,5,0.8,1,1,1,0,0,0
6515,Wayne Ellington,29-048,G,12/16/16,MIA,,LAC,L,1,23,6,9,0.667,5,5,1,1,4,0.25,0,0,,1,1,2
6516,Monta Ellis,31-105,G,2/8/17,IND,,CLE,L,0,24,5,7,0.714,4,5,0.8,1,2,0.5,2,2,1,0,2,2
6517,Monta Ellis,31-019,G,11/14/16,IND,,ORL,W,1,36,6,11,0.545,6,7,0.857,0,4,0,1,1,1,0,2,2
6518,Joel Embiid,22-243,C-F,11/14/16,PHI,@,HOU,L,1,23,6,10,0.6,6,8,0.75,0,2,0,1,1,1,2,8,10
6519,James Ennis,26-218,F,2/4/17,MEM,@,MIN,W,1,35,4,5,0.8,1,2,0.5,3,3,1,2,2,1,3,3,6
6520,James Ennis,26-215,F,2/1/17,MEM,@,DEN,W,0,20,4,6,0.667,2,2,1,2,4,0.5,3,3,1,1,5,6
6521,James Ennis,26-175,F,12/23/16,MEM,,HOU,W,0,21,5,7,0.714,2,2,1,3,5,0.6,0,0,,0,1,1
6522,Tyreke Evans,27-161,G-F,2/27/17,SAC,,MIN,L,0,25,5,12,0.417,2,9,0.222,3,3,1,0,0,,0,5,5
6523,Kenneth Faried,27-063,F,1/21/17,DEN,,LAC,W,1,24,5,7,0.714,5,7,0.714,0,0,,3,4,0.75,3,4,7
6524,Derrick Favors,25-213,F-C,2/13/17,UTA,,LAC,L,1,24,5,11,0.455,5,11,0.455,0,0,,3,6,0.5,1,2,3
6525,Derrick Favors,25-114,F-C,11/6/16,UTA,@,NYK,W,1,27,6,10,0.6,6,10,0.6,0,0,,1,3,0.333,3,3,6
6526,Kay Felder,21-277,G,12/31/16,CLE,@,CHO,W,0,19,5,6,0.833,3,4,0.75,2,2,1,1,2,0.5,0,0,0
6527,Cristiano Felicio,24-189,F-C,1/12/17,CHI,@,NYK,L,0,24,6,9,0.667,6,9,0.667,0,0,,1,2,0.5,4,1,5
6528,Raymond Felton,32-179,G,12/22/16,LAC,,SAS,W,0,23,6,9,0.667,6,8,0.75,0,1,0,1,2,0.5,0,4,4
6529,Raymond Felton,32-242,G,2/23/17,LAC,@,GSW,L,0,24,4,7,0.571,3,5,0.6,1,2,0.5,4,4,1,1,2,3
6530,Yogi Ferrell,23-306,G,3/11/17,DAL,,PHO,L,1,27,3,7,0.429,2,4,0.5,1,3,0.333,6,6,1,0,0,0
6531,Yogi Ferrell,23-189,G,11/14/16,BRK,@,LAC,L,0,26,5,11,0.455,3,6,0.5,2,5,0.4,1,4,0.25,0,1,1
6532,Dorian Finney-Smith,23-222,F,12/12/16,DAL,,DEN,W,1,32,5,9,0.556,2,4,0.5,3,5,0.6,0,0,,1,8,9
6533,Evan Fournier,24-031,G-F,11/29/16,ORL,@,SAS,W,1,33,4,9,0.444,3,7,0.429,1,2,0.5,4,4,1,0,3,3
6534,Evan Fournier,24-011,G-F,11/9/16,ORL,,MIN,L,1,28,4,11,0.364,2,5,0.4,2,6,0.333,3,3,1,0,3,3
6535,Evan Fournier,24-009,G-F,11/7/16,ORL,@,CHI,L,1,30,6,12,0.5,5,7,0.714,1,5,0.2,0,0,,1,1,2
6536,Evan Fournier,24-007,G-F,11/5/16,ORL,,WAS,W,1,30,2,8,0.25,0,2,0,2,6,0.333,7,8,0.875,0,2,2
6537,Randy Foye,33-113,G,1/15/17,BRK,,HOU,L,0,17,4,6,0.667,1,2,0.5,3,4,0.75,2,2,1,0,0,0
6538,Randy Foye,33-171,G,3/14/17,BRK,,OKC,L,1,28,4,6,0.667,1,3,0.333,3,3,1,2,2,1,0,1,1
6539,Tim Frazier,26-042,G,12/13/16,NOP,,GSW,L,0,30,5,9,0.556,2,5,0.4,3,4,0.75,0,0,,0,2,2
6540,Tim Frazier,26-006,G,11/7/16,NOP,@,GSW,L,1,32,5,11,0.455,4,8,0.5,1,3,0.333,2,2,1,2,2,4
6541,Tim Frazier,26-003,G,11/4/16,NOP,,PHO,L,1,25,6,8,0.75,5,7,0.714,1,1,1,0,0,,0,0,0
6542,Channing Frye,33-258,C-F,1/30/17,CLE,@,DAL,L,0,19,4,8,0.5,1,2,0.5,3,6,0.5,2,2,1,2,5,7
6543,Channing Frye,33-175,C-F,11/8/16,CLE,,ATL,L,0,27,5,15,0.333,2,7,0.286,3,8,0.375,0,0,,2,5,7
6544,Danilo Gallinari,28-104,F,11/20/16,DEN,,UTA,W,1,36,4,14,0.286,3,8,0.375,1,6,0.167,4,6,0.667,0,5,5
6545,Danilo Gallinari,28-131,F,12/17/16,DEN,,NYK,W,1,28,4,9,0.444,2,2,1,2,7,0.286,3,4,0.75,0,2,2
6546,Marc Gasol,32-043,C,3/13/17,MEM,,MIL,W,1,37,6,13,0.462,6,11,0.545,0,2,0,1,2,0.5,1,6,7
6547,Marc Gasol,31-297,C,11/21/16,MEM,@,CHO,W,1,34,5,14,0.357,3,11,0.273,2,3,0.667,1,1,1,1,7,8
6548,Marc Gasol,32-033,C,3/3/17,MEM,@,DAL,L,1,36,6,18,0.333,6,15,0.4,0,3,0,1,4,0.25,1,5,6
6549,Pau Gasol,36-240,F-C,3/3/17,SAS,@,NOP,W,0,36,4,10,0.4,3,5,0.6,1,5,0.2,4,8,0.5,3,6,9
6550,Pau Gasol,36-250,F-C,3/13/17,SAS,,ATL,W,0,27,4,10,0.4,2,6,0.333,2,4,0.5,3,4,0.75,3,7,10
6551,Pau Gasol,36-155,F-C,12/8/16,SAS,@,CHI,L,1,31,6,11,0.545,5,8,0.625,1,3,0.333,0,0,,2,8,10
6552,Rudy Gay,30-114,F,12/9/16,SAC,,NYK,L,1,35,4,15,0.267,4,10,0.4,0,5,0,5,6,0.833,0,5,5
6553,Rudy Gay,30-107,F,12/2/16,SAC,@,BOS,L,1,35,6,14,0.429,5,7,0.714,1,7,0.143,0,0,,0,8,8
6554,Paul George,26-196,F,11/14/16,IND,,ORL,W,1,34,5,16,0.313,4,11,0.364,1,5,0.2,2,2,1,1,5,6
6555,Paul George,26-289,F,2/15/17,IND,@,CLE,L,1,36,4,19,0.211,1,13,0.077,3,6,0.5,2,2,1,2,5,7
6556,Paul George,26-285,F,2/11/17,IND,,MIL,L,1,38,4,11,0.364,2,8,0.25,2,3,0.667,3,3,1,1,7,8
6557,Paul George,26-187,F,11/5/16,IND,,CHI,W,1,29,5,10,0.5,2,5,0.4,3,5,0.6,0,0,,2,4,6
6558,Jonathan Gibson,29-027,G,12/5/16,DAL,,CHO,L,0,18,5,9,0.556,2,5,0.4,3,4,0.75,0,1,0,0,2,2
6559,Taj Gibson,31-227,F,2/6/17,CHI,@,SAC,W,1,28,6,12,0.5,6,11,0.545,0,1,0,1,2,0.5,0,4,4
6560,Taj Gibson,31-141,F,11/12/16,CHI,,WAS,W,1,29,6,10,0.6,6,10,0.6,0,0,,1,3,0.333,2,3,5
6561,Taj Gibson,31-138,F,11/9/16,CHI,@,ATL,L,1,37,6,15,0.4,6,15,0.4,0,0,,1,1,1,3,4,7
6562,Taj Gibson,31-169,F,12/10/16,CHI,,MIA,W,1,26,6,11,0.545,6,11,0.545,0,0,,1,2,0.5,2,5,7
6563,Manu Ginobili,39-127,G,12/2/16,SAS,,WAS,W,0,24,4,6,0.667,3,3,1,1,3,0.333,4,4,1,0,1,1
6564,Manu Ginobili,39-124,G,11/29/16,SAS,,ORL,L,0,23,4,9,0.444,2,4,0.5,2,5,0.4,3,4,0.75,4,2,6
6565,Rudy Gobert,24-124,C,10/28/16,UTA,,LAL,W,1,32,4,9,0.444,4,9,0.444,0,0,,5,8,0.625,6,7,13
6566,Rudy Gobert,24-138,C,11/11/16,UTA,@,ORL,W,1,34,6,9,0.667,6,9,0.667,0,0,,1,2,0.5,6,7,13
6567,Rudy Gobert,24-234,C,2/15/17,UTA,,POR,W,1,32,4,5,0.8,4,5,0.8,0,0,,5,8,0.625,3,9,12
6568,Rudy Gobert,24-133,C,11/6/16,UTA,@,NYK,W,1,33,5,6,0.833,5,6,0.833,0,0,,3,4,0.75,2,6,8
6569,Rudy Gobert,24-180,C,12/23/16,UTA,,TOR,L,1,35,5,7,0.714,5,7,0.714,0,0,,3,3,1,3,11,14
6570,Rudy Gobert,24-265,C,3/18/17,UTA,@,CHI,L,1,35,5,11,0.455,5,11,0.455,0,0,,3,6,0.5,6,7,13
6571,Rudy Gobert,24-247,C,2/28/17,UTA,@,OKC,L,1,32,6,9,0.667,6,9,0.667,0,0,,1,1,1,1,9,10
6572,Aaron Gordon,21-133,F,1/27/17,ORL,@,BOS,L,1,23,4,13,0.308,3,10,0.3,1,3,0.333,4,4,1,3,2,5
6573,Aaron Gordon,21-130,F,1/24/17,ORL,,CHI,L,1,36,5,12,0.417,4,9,0.444,1,3,0.333,2,3,0.667,4,2,6
6574,Aaron Gordon,21-173,F,3/8/17,ORL,,CHI,W,1,29,4,7,0.571,4,6,0.667,0,1,0,5,6,0.833,1,3,4
6575,Aaron Gordon,21-048,F,11/3/16,ORL,,SAC,W,1,31,5,10,0.5,4,7,0.571,1,3,0.333,2,3,0.667,3,7,10
6576,Aaron Gordon,21-091,F,12/16/16,ORL,,BRK,W,1,29,4,12,0.333,3,7,0.429,1,5,0.2,4,5,0.8,3,2,5
6577,Aaron Gordon,21-107,F,1/1/17,ORL,@,IND,L,1,28,4,10,0.4,3,5,0.6,1,5,0.2,4,4,1,2,4,6
6578,Eric Gordon,27-327,G,11/16/16,HOU,@,OKC,L,1,39,5,20,0.25,2,8,0.25,3,12,0.25,0,0,,1,4,5
6579,Eric Gordon,28-002,G,12/27/16,HOU,@,DAL,W,0,27,4,9,0.444,2,4,0.5,2,5,0.4,3,3,1,1,4,5
6580,Eric Gordon,28-039,G,2/2/17,HOU,,ATL,L,0,30,4,14,0.286,2,4,0.5,2,10,0.2,3,4,0.75,0,2,2
6581,Eric Gordon,28-019,G,1/13/17,HOU,,MEM,L,0,31,4,11,0.364,1,2,0.5,3,9,0.333,2,2,1,0,1,1
6582,Eric Gordon,28-077,G,3/12/17,HOU,,CLE,W,0,29,4,11,0.364,2,3,0.667,2,8,0.25,3,3,1,2,1,3
6583,Eric Gordon,27-361,G,12/20/16,HOU,,SAS,L,0,33,4,15,0.267,3,7,0.429,1,8,0.125,4,4,1,0,1,1
6584,Marcin Gortat,32-320,C-F,1/2/17,WAS,@,HOU,L,1,40,6,10,0.6,6,10,0.6,0,0,,1,2,0.5,4,10,14
6585,Marcin Gortat,32-266,C-F,11/9/16,WAS,,BOS,W,1,32,6,9,0.667,6,9,0.667,0,0,,1,2,0.5,5,4,9
6586,Marcin Gortat,32-315,C-F,12/28/16,WAS,,IND,W,1,41,4,8,0.5,4,8,0.5,0,0,,5,7,0.714,4,12,16
6587,Jerami Grant,22-340,F,2/15/17,OKC,,NYK,W,0,24,3,3,1,1,1,1,2,2,1,5,8,0.625,1,4,5
6588,Jerian Grant,24-150,G,3/8/17,CHI,@,ORL,L,1,24,5,9,0.556,2,5,0.4,3,4,0.75,0,0,,1,4,5
6589,Jerian Grant,24-120,G,2/6/17,CHI,@,SAC,W,1,35,4,5,0.8,2,2,1,2,3,0.667,3,5,0.6,2,3,5
6590,Draymond Green,26-251,F,11/10/16,GSW,@,DEN,W,1,29,4,7,0.571,1,3,0.333,3,4,0.75,2,2,1,0,9,9
6591,Draymond Green,26-301,F,12/30/16,GSW,,DAL,W,1,27,6,10,0.6,5,7,0.714,1,3,0.333,0,0,,2,6,8
6592,Draymond Green,26-279,F,12/8/16,GSW,@,UTA,W,1,35,4,9,0.444,0,3,0,4,6,0.667,1,4,0.25,2,8,10
6593,Draymond Green,26-312,F,1/10/17,GSW,,MIA,W,1,36,4,11,0.364,4,8,0.5,0,3,0,5,6,0.833,0,9,9
6594,Draymond Green,27-004,F,3/8/17,GSW,,BOS,L,1,34,6,15,0.4,5,9,0.556,1,6,0.167,0,0,,0,8,8
6595,Draymond Green,26-327,F,1/25/17,GSW,@,CHO,W,1,36,4,7,0.571,2,4,0.5,2,3,0.667,3,6,0.5,0,4,4
6596,Draymond Green,27-001,F,3/5/17,GSW,@,NYK,W,1,40,4,9,0.444,3,5,0.6,1,4,0.25,4,4,1,1,6,7
6597,JaMychal Green,26-168,F,12/6/16,MEM,,PHI,W,1,35,2,7,0.286,2,7,0.286,0,0,,9,10,0.9,3,7,10
6598,JaMychal Green,26-270,F,3/18/17,MEM,,SAS,W,1,24,4,7,0.571,2,4,0.5,2,3,0.667,3,3,1,2,2,4
6599,Jeff Green,30-141,F,1/16/17,ORL,@,DEN,L,0,17,3,9,0.333,2,5,0.4,1,4,0.25,6,6,1,0,1,1
6600,Jeff Green,30-169,F,2/13/17,ORL,@,MIA,W,0,20,5,11,0.455,5,9,0.556,0,2,0,3,3,1,0,2,2
6601,Jeff Green,30-143,F,1/18/17,ORL,@,NOP,L,0,23,5,10,0.5,4,6,0.667,1,4,0.25,2,2,1,0,2,2
6602,Jeff Green,30-200,F,3/16/17,ORL,@,GSW,L,0,18,6,9,0.667,5,7,0.714,1,2,0.5,0,0,,2,2,4
6603,Jeff Green,30-141,F,1/16/17,ORL,@,DEN,L,0,17,3,9,0.333,2,5,0.4,1,4,0.25,6,6,1,0,1,1
6604,Blake Griffin,27-260,F,12/1/16,LAC,@,CLE,W,1,31,4,14,0.286,4,13,0.308,0,1,0,5,8,0.625,2,3,5
6605,Blake Griffin,27-236,F,11/7/16,LAC,,DET,W,1,28,5,11,0.455,5,10,0.5,0,1,0,3,4,0.75,1,9,10
6606,Tim Hardaway,24-245,G,11/16/16,ATL,,MIL,W,0,21,4,7,0.571,3,3,1,1,4,0.25,4,6,0.667,0,1,1
6607,James Harden,27-181,G,2/23/17,HOU,@,NOP,W,1,30,3,9,0.333,2,3,0.667,1,6,0.167,6,6,1,0,4,4
6608,James Harden,27-082,G,11/16/16,HOU,@,OKC,L,1,37,4,16,0.25,3,11,0.273,1,5,0.2,4,7,0.571,3,4,7
6609,Maurice Harkless,23-175,F-G,11/2/16,POR,@,PHO,L,1,35,5,10,0.5,3,6,0.5,2,4,0.5,1,1,1,2,3,5
6610,Maurice Harkless,23-245,F-G,1/11/17,POR,,CLE,W,1,31,5,10,0.5,4,8,0.5,1,2,0.5,2,2,1,3,2,5
6611,Montrezl Harrell,23-050,F-C,3/17/17,HOU,@,NOP,L,0,19,5,5,1,5,5,1,0,0,,3,5,0.6,1,5,6
6612,Montrezl Harrell,22-357,F-C,1/17/17,HOU,@,MIA,L,0,16,5,6,0.833,5,6,0.833,0,0,,3,5,0.6,1,0,1
6613,Montrezl Harrell,22-310,F-C,12/1/16,HOU,@,GSW,W,0,25,6,10,0.6,6,10,0.6,0,0,,1,1,1,5,5,10
6614,Montrezl Harrell,22-340,F-C,12/31/16,HOU,,NYK,W,1,33,6,7,0.857,6,7,0.857,0,0,,1,1,1,0,4,4
6615,Devin Harris,33-348,G,2/9/17,DAL,,UTA,W,0,29,5,11,0.455,5,9,0.556,0,2,0,3,4,0.75,1,3,4
6616,Gary Harris,22-059,G,11/12/16,DEN,,DET,L,1,28,5,11,0.455,5,9,0.556,0,2,0,3,3,1,0,4,4
6617,Gary Harris,22-147,G,2/8/17,DEN,@,ATL,L,1,34,5,14,0.357,4,6,0.667,1,8,0.125,2,3,0.667,0,1,1
6618,Joe Harris,25-056,G,11/2/16,BRK,,DET,W,0,26,6,9,0.667,5,5,1,1,4,0.25,0,0,,0,2,2
6619,Tobias Harris,24-182,F,1/13/17,DET,@,UTA,L,1,34,4,12,0.333,3,9,0.333,1,3,0.333,4,5,0.8,0,2,2
6620,Tobias Harris,24-215,F,2/15/17,DET,,DAL,W,0,24,4,8,0.5,3,7,0.429,1,1,1,4,4,1,1,3,4
6621,Tobias Harris,24-234,F,3/6/17,DET,,CHI,W,0,28,5,10,0.5,4,8,0.5,1,2,0.5,2,2,1,1,7,8
6622,Tobias Harris,24-155,F,12/17/16,DET,,IND,L,1,31,5,12,0.417,4,6,0.667,1,6,0.167,2,2,1,0,7,7
6623,Andrew Harrison,22-022,G,11/19/16,MEM,,MIN,W,0,24,3,6,0.5,3,3,1,0,3,0,7,7,1,1,3,4
6624,Andrew Harrison,22-046,G,12/13/16,MEM,@,CLE,L,1,31,4,11,0.364,3,6,0.5,1,5,0.2,4,5,0.8,0,3,3
6625,Spencer Hawes,28-190,C-F,11/4/16,CHO,@,BRK,W,0,27,5,8,0.625,4,7,0.571,1,1,1,2,2,1,1,4,5
6626,Spencer Hawes,28-193,C-F,11/7/16,CHO,,IND,W,0,22,6,11,0.545,5,8,0.625,1,3,0.333,0,0,,2,11,13
6627,Gordon Hayward,26-358,F-G,3/16/17,UTA,@,CLE,L,1,35,4,14,0.286,3,10,0.3,1,4,0.25,4,4,1,1,4,5
6628,Gordon Hayward,26-343,F-G,3/1/17,UTA,,MIN,L,1,25,6,15,0.4,5,11,0.455,1,4,0.25,0,0,,0,4,4
6629,Gordon Hayward,26-236,F-G,11/14/16,UTA,,MEM,L,1,36,4,14,0.286,3,7,0.429,1,7,0.143,4,4,1,0,4,4
6630,Gordon Hayward,26-268,F-G,12/16/16,UTA,,DAL,W,1,35,4,11,0.364,1,5,0.2,3,6,0.5,2,3,0.667,0,9,9
6631,Gerald Henderson,29-049,G,1/27/17,PHI,,HOU,L,0,23,5,5,1,3,3,1,2,2,1,1,2,0.5,1,1,2
6632,Gerald Henderson,28-354,G,11/27/16,PHI,,CLE,L,1,32,5,13,0.385,4,7,0.571,1,6,0.167,2,2,1,1,4,5
6633,Gerald Henderson,28-360,G,12/3/16,PHI,,BOS,L,1,32,4,7,0.571,2,4,0.5,2,3,0.667,3,4,0.75,1,2,3
6634,Gerald Henderson,29-011,G,12/20/16,PHI,,NOP,L,1,27,3,9,0.333,0,4,0,3,5,0.6,4,4,1,0,3,3
6635,Juan Hernangomez,21-166,F,3/13/17,DEN,,LAL,W,0,19,3,5,0.6,0,0,,3,5,0.6,4,4,1,0,6,6
6636,Willy Hernangomez,22-285,C,3/8/17,NYK,@,MIL,L,1,28,6,10,0.6,6,10,0.6,0,0,,1,3,0.333,3,9,12
6637,Willy Hernangomez,22-291,C,3/14/17,NYK,,IND,W,0,31,6,12,0.5,6,12,0.5,0,0,,1,4,0.25,6,10,16
6638,Mario Hezonja,21-246,F-G,10/28/16,ORL,@,DET,L,0,24,5,15,0.333,3,8,0.375,2,7,0.286,1,1,1,0,2,2
6639,Nene Hilario,34-062,F-C,11/14/16,HOU,,PHI,W,0,16,6,8,0.75,6,7,0.857,0,1,0,1,4,0.25,3,1,4
6640,Nene Hilario,34-147,F-C,2/7/17,HOU,,ORL,W,0,18,6,8,0.75,6,8,0.75,0,0,,1,1,1,0,3,3
6641,Nene Hilario,34-049,F-C,11/1/16,HOU,@,CLE,L,0,25,4,4,1,3,3,1,1,1,1,4,6,0.667,3,2,5
6642,George Hill,30-184,G,11/4/16,UTA,,SAS,L,1,28,5,13,0.385,2,7,0.286,3,6,0.5,0,0,,1,2,3
6643,George Hill,30-261,G,1/20/17,UTA,@,DAL,W,1,31,5,13,0.385,4,9,0.444,1,4,0.25,2,2,1,0,1,1
6644,George Hill,30-251,G,1/10/17,UTA,,CLE,W,1,37,5,11,0.455,3,8,0.375,2,3,0.667,1,4,0.25,1,2,3
6645,Solomon Hill,26-001,F,3/19/17,NOP,,MIN,W,1,35,4,8,0.5,2,4,0.5,2,4,0.5,3,4,0.75,0,5,5
6646,Solomon Hill,25-267,F,12/10/16,NOP,@,LAC,L,1,30,5,8,0.625,3,6,0.5,2,2,1,1,1,1,0,3,3
6647,Jrue Holiday,26-209,G,1/7/17,NOP,@,BOS,L,1,29,5,10,0.5,4,6,0.667,1,4,0.25,2,2,1,0,1,1
6648,Jrue Holiday,26-237,G,2/4/17,NOP,@,WAS,L,1,36,5,17,0.294,5,14,0.357,0,3,0,3,4,0.75,2,8,10
6649,Justin Holiday,27-293,G,1/23/17,NYK,@,IND,W,0,32,4,9,0.444,1,2,0.5,3,7,0.429,2,2,1,1,2,3
6650,Justin Holiday,27-241,G,12/2/16,NYK,,MIN,W,1,31,3,9,0.333,1,3,0.333,2,6,0.333,5,5,1,0,6,6
6651,Justin Holiday,27-288,G,1/18/17,NYK,@,BOS,W,0,19,4,8,0.5,2,3,0.667,2,5,0.4,3,3,1,0,5,5
6652,Rondae Hollis-Jefferson,22-041,F,2/13/17,BRK,,MEM,L,1,25,4,6,0.667,3,4,0.75,1,2,0.5,4,6,0.667,0,3,3
6653,Rondae Hollis-Jefferson,22-036,F,2/8/17,BRK,,WAS,L,1,31,5,7,0.714,5,6,0.833,0,1,0,3,4,0.75,3,8,11
6654,Rondae Hollis-Jefferson,21-354,F,12/22/16,BRK,,GSW,L,0,24,6,15,0.4,5,12,0.417,1,3,0.333,0,1,0,3,3,6
6655,Rondae Hollis-Jefferson,21-310,F,11/8/16,BRK,,MIN,W,1,27,3,4,0.75,2,3,0.667,1,1,1,6,6,1,0,4,4
6656,Rondae Hollis-Jefferson,21-320,F,11/18/16,BRK,@,OKC,L,1,28,3,14,0.214,2,12,0.167,1,2,0.5,6,7,0.857,0,5,5
6657,Richaun Holmes,23-140,F-C,3/4/17,PHI,,DET,L,1,24,6,9,0.667,5,7,0.714,1,2,0.5,0,1,0,0,2,2
6658,Richaun Holmes,23-041,F-C,11/25/16,PHI,,CHI,L,0,21,4,8,0.5,3,6,0.5,1,2,0.5,4,4,1,3,2,5
6659,Rodney Hood,24-022,G-F,11/11/16,UTA,@,ORL,W,1,33,5,15,0.333,4,8,0.5,1,7,0.143,2,2,1,1,3,4
6660,Rodney Hood,24-072,G-F,12/31/16,UTA,,PHO,W,1,25,5,11,0.455,2,4,0.5,3,7,0.429,0,0,,1,3,4
6661,Al Horford,30-194,C-F,12/14/16,BOS,@,SAS,L,1,35,4,12,0.333,3,8,0.375,1,4,0.25,4,4,1,1,4,5
6662,Al Horford,30-247,C-F,2/5/17,BOS,,LAC,W,1,35,4,13,0.308,1,4,0.25,3,9,0.333,2,2,1,2,13,15
6663,Al Horford,30-241,C-F,1/30/17,BOS,,DET,W,1,35,6,10,0.6,5,7,0.714,1,3,0.333,0,0,,1,5,6
6664,Dwight Howard,31-102,C,3/20/17,ATL,@,CHO,L,1,33,6,9,0.667,6,9,0.667,0,0,,1,2,0.5,3,7,10
6665,Dwight Howard,31-044,C,1/21/17,ATL,,PHI,W,1,32,5,7,0.714,5,7,0.714,0,0,,3,7,0.429,5,10,15
6666,Dwight Howard,31-027,C,1/4/17,ATL,@,ORL,W,1,30,5,9,0.556,5,9,0.556,0,0,,3,3,1,3,9,12
6667,Kris Humphries,31-280,F-C,11/12/16,ATL,,PHI,W,0,18,5,7,0.714,4,5,0.8,1,2,0.5,2,2,1,4,5,9
6668,Kris Humphries,31-339,F-C,1/10/17,ATL,@,BRK,W,0,16,5,8,0.625,5,7,0.714,0,1,0,3,4,0.75,2,6,8
6669,Kris Humphries,31-347,F-C,1/18/17,ATL,@,DET,L,0,20,4,5,0.8,3,3,1,1,2,0.5,4,4,1,1,1,2
6670,Serge Ibaka,27-124,F-C,1/20/17,ORL,,MIL,W,1,22,4,7,0.571,2,4,0.5,2,3,0.667,3,3,1,1,3,4
6671,Serge Ibaka,27-118,F-C,1/14/17,ORL,@,UTA,L,1,33,5,10,0.5,3,3,1,2,7,0.286,1,1,1,0,5,5
6672,Serge Ibaka,27-117,F-C,1/13/17,ORL,@,POR,W,1,29,4,10,0.4,1,4,0.25,3,6,0.5,2,2,1,1,9,10
6673,Andre Iguodala,33-005,G-F,2/2/17,GSW,@,LAC,W,0,30,5,9,0.556,2,5,0.4,3,4,0.75,0,0,,1,3,4
6674,Ersan Ilyasova,29-183,F,11/14/16,PHI,@,HOU,L,0,22,5,11,0.455,4,9,0.444,1,2,0.5,2,2,1,0,6,6
6675,Ersan Ilyasova,29-215,F,12/16/16,PHI,,LAL,L,0,27,6,14,0.429,5,6,0.833,1,8,0.125,0,0,,2,8,10
6676,Ersan Ilyasova,29-196,F,11/27/16,PHI,,CLE,L,1,28,5,10,0.5,3,5,0.6,2,5,0.4,1,1,1,2,4,6
6677,Ersan Ilyasova,29-262,F,2/1/17,PHI,@,DAL,L,1,31,4,9,0.444,3,5,0.6,1,4,0.25,4,4,1,1,9,10
6678,Ersan Ilyasova,29-309,F,3/20/17,ATL,@,CHO,L,1,28,5,11,0.455,2,2,1,3,9,0.333,0,0,,1,5,6
6679,Joe Ingles,29-086,F-G,12/27/16,UTA,@,LAL,W,0,24,5,8,0.625,2,2,1,3,6,0.5,0,0,,0,2,2
6680,Brandon Ingram,19-186,F,3/7/17,LAL,@,DAL,L,1,35,5,9,0.556,4,6,0.667,1,3,0.333,2,4,0.5,2,2,4
6681,Kyrie Irving,24-275,G,12/23/16,CLE,,BRK,W,1,26,5,11,0.455,4,8,0.5,1,3,0.333,2,2,1,1,4,5
6682,Reggie Jackson,26-254,G,12/26/16,DET,,CLE,W,1,30,5,9,0.556,3,6,0.5,2,3,0.667,1,1,1,0,1,1
6683,Al Jefferson,32-019,C-F,1/23/17,IND,,NYK,L,0,19,5,8,0.625,5,8,0.625,0,0,,3,4,0.75,1,2,3
6684,Al Jefferson,31-331,C-F,11/30/16,IND,@,POR,L,0,21,5,8,0.625,5,8,0.625,0,0,,3,4,0.75,0,1,1
6685,Al Jefferson,32-031,C-F,2/4/17,IND,,DET,W,0,14,6,9,0.667,6,9,0.667,0,0,,1,2,0.5,1,2,3
6686,Richard Jefferson,36-126,F,10/25/16,CLE,,NYK,W,0,26,5,7,0.714,3,4,0.75,2,3,0.667,1,2,0.5,0,4,4
6687,Brandon Jennings,27-077,G,12/9/16,NYK,@,SAC,W,1,39,5,10,0.5,5,6,0.833,0,4,0,3,4,0.75,0,5,5
6688,Amir Johnson,29-250,F,1/6/17,BOS,,PHI,W,1,26,4,6,0.667,2,3,0.667,2,3,0.667,3,4,0.75,0,5,5
6689,Amir Johnson,29-280,F,2/5/17,BOS,,LAC,W,1,28,6,9,0.667,5,6,0.833,1,3,0.333,0,0,,2,4,6
6690,Amir Johnson,29-308,F,3/5/17,BOS,@,PHO,L,1,27,5,11,0.455,4,8,0.5,1,3,0.333,2,2,1,4,4,8
6691,Amir Johnson,29-306,F,3/3/17,BOS,@,LAL,W,1,25,5,7,0.714,3,3,1,2,4,0.5,1,1,1,0,6,6
6692,James Johnson,29-269,F,11/15/16,MIA,,ATL,L,0,26,5,8,0.625,2,3,0.667,3,5,0.6,0,0,,2,2,4
6693,James Johnson,29-279,F,11/25/16,MIA,@,MEM,W,0,31,4,10,0.4,1,6,0.167,3,4,0.75,2,2,1,1,5,6
6694,Joe Johnson,35-244,G-F,2/28/17,UTA,@,OKC,L,0,23,6,10,0.6,5,9,0.556,1,1,1,0,0,,3,1,4
6695,Joe Johnson,35-162,G-F,12/8/16,UTA,,GSW,L,1,28,4,12,0.333,2,6,0.333,2,6,0.333,3,5,0.6,1,2,3
6696,Joe Johnson,35-231,G-F,2/15/17,UTA,,POR,W,0,23,4,7,0.571,2,3,0.667,2,4,0.5,3,4,0.75,0,2,2
6697,Joe Johnson,35-160,G-F,12/6/16,UTA,,PHO,W,0,29,4,10,0.4,1,4,0.25,3,6,0.5,2,2,1,0,2,2
6698,Joe Johnson,35-126,G-F,11/2/16,UTA,,DAL,W,1,33,5,11,0.455,3,8,0.375,2,3,0.667,1,1,1,0,5,5
6699,Tyler Johnson,24-213,G,12/6/16,MIA,,NYK,L,0,36,5,11,0.455,4,9,0.444,1,2,0.5,2,2,1,1,4,5
6700,Tyler Johnson,24-282,G,2/13/17,MIA,,ORL,L,0,31,4,9,0.444,4,7,0.571,0,2,0,5,6,0.833,0,3,3
6701,Nikola Jokic,21-353,C-F,2/6/17,DEN,,DAL,W,1,24,5,9,0.556,5,8,0.625,0,1,0,3,3,1,1,3,4
6702,Nikola Jokic,21-282,C-F,11/27/16,DEN,@,PHO,W,0,31,3,8,0.375,2,6,0.333,1,2,0.5,6,6,1,3,8,11
6703,Nikola Jokic,21-300,C-F,12/15/16,DEN,,POR,W,1,19,5,6,0.833,4,5,0.8,1,1,1,2,3,0.667,0,4,4
6704,Nikola Jokic,22-010,C-F,3/1/17,DEN,@,MIL,W,1,30,6,10,0.6,6,10,0.6,0,0,,1,2,0.5,4,10,14
6705,Terrence Jones,25-011,F,1/20/17,NOP,,BRK,L,0,22,4,12,0.333,4,10,0.4,0,2,0,5,6,0.833,3,5,8
6706,DeAndre Jordan,28-152,C,12/20/16,LAC,,DEN,W,1,29,6,7,0.857,6,7,0.857,0,0,,1,1,1,2,11,13
6707,DeAndre Jordan,28-240,C,3/18/17,LAC,,CLE,W,1,27,4,5,0.8,4,5,0.8,0,0,,5,11,0.455,5,12,17
6708,DeAndre Jordan,28-150,C,12/18/16,LAC,@,WAS,L,1,36,5,6,0.833,5,6,0.833,0,0,,3,6,0.5,4,13,17
6709,DeAndre Jordan,28-160,C,12/28/16,LAC,@,NOP,L,1,39,5,6,0.833,5,6,0.833,0,0,,3,8,0.375,5,20,25
6710,Cory Joseph,25-116,G,12/14/16,TOR,@,PHI,W,0,29,5,9,0.556,5,8,0.625,0,1,0,3,4,0.75,1,4,5
6711,Frank Kaminsky,23-219,F-C,11/9/16,CHO,,UTA,W,0,20,6,10,0.6,5,7,0.714,1,3,0.333,0,1,0,1,4,5
6712,Frank Kaminsky,23-235,F-C,11/25/16,CHO,@,NYK,L,0,40,3,14,0.214,2,7,0.286,1,7,0.143,6,6,1,2,7,9
6713,Frank Kaminsky,23-266,F-C,12/26/16,CHO,@,BRK,L,0,20,5,9,0.556,4,6,0.667,1,3,0.333,2,2,1,2,3,5
6714,Frank Kaminsky,23-233,F-C,11/23/16,CHO,,SAS,L,0,30,5,12,0.417,4,9,0.444,1,3,0.333,2,4,0.5,3,5,8
6715,Frank Kaminsky,23-263,F-C,12/23/16,CHO,,CHI,W,0,24,5,14,0.357,4,10,0.4,1,4,0.25,2,2,1,1,4,5
6716,Enes Kanter,24-175,C,11/11/16,OKC,,LAC,L,0,21,6,11,0.545,6,10,0.6,0,1,0,1,1,1,3,8,11
6717,Enes Kanter,24-182,C,11/18/16,OKC,,BRK,W,0,13,3,4,0.75,2,3,0.667,1,1,1,6,6,1,0,3,3
6718,Michael Kidd-Gilchrist,23-042,F,11/7/16,CHO,,IND,W,1,19,4,4,1,4,4,1,0,0,,5,5,1,0,1,1
6719,Sean Kilpatrick,27-015,G,1/21/17,BRK,@,CHO,L,1,27,5,14,0.357,2,7,0.286,3,7,0.429,0,0,,0,4,4
6720,Sean Kilpatrick,26-365,G,1/5/17,BRK,@,IND,L,0,25,4,12,0.333,3,8,0.375,1,4,0.25,4,6,0.667,0,8,8
6721,Sean Kilpatrick,26-294,G,10/26/16,BRK,@,BOS,L,0,22,5,13,0.385,4,7,0.571,1,6,0.167,2,2,1,1,3,4
6722,Sean Kilpatrick,26-345,G,12/16/16,BRK,@,ORL,L,1,27,4,9,0.444,2,4,0.5,2,5,0.4,3,4,0.75,1,5,6
6723,Sean Kilpatrick,26-299,G,10/31/16,BRK,,CHI,L,0,25,3,13,0.231,3,7,0.429,0,6,0,7,7,1,0,2,2
6724,Kyle Korver,35-326,G-F,2/6/17,CLE,@,WAS,W,0,30,4,9,0.444,0,1,0,4,8,0.5,1,1,1,1,2,3
6725,Kyle Korver,35-347,G-F,2/27/17,CLE,,MIL,W,0,29,5,11,0.455,2,2,1,3,9,0.333,0,0,,0,3,3
6726,Kyle Korver,35-286,G-F,12/28/16,ATL,,NYK,W,0,25,4,10,0.4,1,5,0.2,3,5,0.6,2,2,1,0,5,5
6727,Kosta Koufos,27-256,C,11/6/16,SAC,@,TOR,W,1,25,6,8,0.75,6,8,0.75,0,0,,1,2,0.5,2,4,6
6728,Kosta Koufos,28-019,C,3/15/17,SAC,@,PHO,W,1,20,6,10,0.6,6,10,0.6,0,0,,1,1,1,1,5,6
6729,Mindaugas Kuzminskas,27-102,F,1/29/17,NYK,@,ATL,L,0,36,5,13,0.385,4,6,0.667,1,7,0.143,2,3,0.667,0,4,4
6730,Mindaugas Kuzminskas,27-080,F,1/7/17,NYK,@,IND,L,0,15,5,8,0.625,4,4,1,1,4,0.25,2,2,1,1,2,3
6731,Skal Labissiere,21-000,F,3/18/17,SAC,@,OKC,L,0,18,5,10,0.5,5,9,0.556,0,1,0,3,3,1,2,2,4
6732,Jeremy Lamb,24-222,G-F,1/7/17,CHO,@,SAS,L,1,29,4,12,0.333,4,9,0.444,0,3,0,5,6,0.833,0,8,8
6733,Jeremy Lamb,24-257,G-F,2/11/17,CHO,,LAC,L,0,16,4,9,0.444,2,5,0.4,2,4,0.5,3,5,0.6,1,0,1
6734,Joffrey Lauvergne,25-049,C-F,11/18/16,OKC,,BRK,W,0,14,6,9,0.667,5,5,1,1,4,0.25,0,0,,0,4,4
6735,Joffrey Lauvergne,25-121,C-F,1/29/17,OKC,@,CLE,L,0,21,6,10,0.6,6,10,0.6,0,0,,1,2,0.5,0,6,6
6736,Joffrey Lauvergne,25-108,C-F,1/16/17,OKC,@,LAC,L,0,30,5,14,0.357,4,10,0.4,1,4,0.25,2,3,0.667,3,6,9
6737,Zach LaVine,21-260,G,11/25/16,MIN,@,PHO,W,1,36,6,13,0.462,6,10,0.6,0,3,0,1,1,1,1,2,3
6738,Zach LaVine,21-297,G,1/1/17,MIN,,POR,L,1,36,5,12,0.417,3,7,0.429,2,5,0.4,1,3,0.333,1,2,3
6739,Ty Lawson,29-024,G,11/27/16,SAC,@,BRK,W,0,22,5,10,0.5,4,8,0.5,1,2,0.5,2,2,1,1,3,4
6740,Ty Lawson,29-123,G,3/6/17,SAC,@,DEN,L,1,34,2,8,0.25,1,5,0.2,1,3,0.333,8,10,0.8,1,1,2
6741,Ty Lawson,29-078,G,1/20/17,SAC,@,MEM,L,0,23,4,10,0.4,4,8,0.5,0,2,0,5,7,0.714,0,4,4
6742,Courtney Lee,31-037,G,11/9/16,NYK,,BRK,W,1,31,5,10,0.5,5,7,0.714,0,3,0,3,4,0.75,0,3,3
6743,Courtney Lee,31-159,G,3/11/17,NYK,@,DET,L,1,35,5,9,0.556,3,5,0.6,2,4,0.5,1,2,0.5,1,6,7
6744,Courtney Lee,31-056,G,11/28/16,NYK,,OKC,L,1,36,5,10,0.5,2,5,0.4,3,5,0.6,0,0,,0,3,3
6745,Courtney Lee,31-110,G,1/21/17,NYK,,PHO,L,1,37,5,9,0.556,2,6,0.333,3,3,1,0,0,,2,2,4
6746,Courtney Lee,31-164,G,3/16/17,NYK,,BRK,L,1,35,5,9,0.556,5,8,0.625,0,1,0,3,3,1,0,0,0
6747,David Lee,33-273,F,1/27/17,SAS,@,NOP,L,1,29,5,7,0.714,5,7,0.714,0,0,,3,4,0.75,5,5,10
6748,Alex Len,23-137,C,10/31/16,PHO,@,LAC,L,0,25,4,13,0.308,4,13,0.308,0,0,,5,8,0.625,2,4,6
6749,Alex Len,23-240,C,2/11/17,PHO,@,HOU,L,1,20,5,9,0.556,5,9,0.556,0,0,,3,5,0.6,4,5,9
6750,Kawhi Leonard,25-186,F,1/1/17,SAS,@,ATL,L,1,28,3,12,0.25,2,6,0.333,1,6,0.167,6,7,0.857,2,2,4
6751,Kawhi Leonard,25-172,F,12/18/16,SAS,,NOP,W,1,24,5,10,0.5,4,7,0.571,1,3,0.333,2,2,1,0,2,2
6752,Jon Leuer,27-226,F,12/26/16,DET,,CLE,W,1,28,5,11,0.455,3,8,0.375,2,3,0.667,1,1,1,1,4,5
6753,Caris LeVert,22-188,G-F,3/1/17,BRK,@,SAC,W,1,25,6,9,0.667,5,8,0.625,1,1,1,0,0,,3,4,7
6754,Caris LeVert,22-203,G-F,3/16/17,BRK,@,NYK,W,1,25,5,9,0.556,4,6,0.667,1,3,0.333,2,2,1,1,6,7
6755,Caris LeVert,22-199,G-F,3/12/17,BRK,,NYK,W,1,26,4,4,1,2,2,1,2,2,1,3,4,0.75,0,4,4
6756,Damian Lillard,26-203,G,2/3/17,POR,,DAL,L,1,38,4,20,0.2,3,12,0.25,1,8,0.125,4,5,0.8,2,7,9
6757,Damian Lillard,26-215,G,2/15/17,POR,@,UTA,L,1,35,3,19,0.158,2,15,0.133,1,4,0.25,6,8,0.75,2,4,6
6758,Jeremy Lin,28-201,G,3/12/17,BRK,,NYK,W,1,27,3,14,0.214,2,8,0.25,1,6,0.167,6,9,0.667,0,4,4
6759,Shaun Livingston,31-127,G,1/16/17,GSW,,CLE,W,0,15,6,7,0.857,6,7,0.857,0,0,,1,1,1,0,2,2
6760,Shawn Long,24-036,F,3/6/17,PHI,,MIL,L,0,15,5,8,0.625,4,7,0.571,1,1,1,2,7,0.286,2,5,7
6761,Brook Lopez,28-213,C,10/31/16,BRK,,CHI,L,1,22,5,11,0.455,5,10,0.5,0,1,0,3,3,1,2,0,2
6762,Brook Lopez,28-246,C,12/3/16,BRK,@,MIL,L,1,29,3,17,0.176,0,8,0,3,9,0.333,4,6,0.667,1,3,4
6763,Brook Lopez,28-236,C,11/23/16,BRK,,BOS,L,1,28,4,14,0.286,3,8,0.375,1,6,0.167,4,5,0.8,1,2,3
6764,Robin Lopez,28-228,C,11/15/16,CHI,@,POR,W,1,29,6,15,0.4,6,14,0.429,0,1,0,1,1,1,3,8,11
6765,Robin Lopez,28-345,C,3/12/17,CHI,@,BOS,L,1,25,5,6,0.833,5,6,0.833,0,0,,3,3,1,2,1,3
6766,Kevin Love,28-142,F,1/27/17,CLE,,BRK,W,1,28,5,13,0.385,2,7,0.286,3,6,0.5,0,0,,2,12,14
6767,Kevin Love,28-083,F,11/29/16,CLE,@,MIL,L,1,31,3,10,0.3,1,3,0.333,2,7,0.286,5,7,0.714,1,12,13
6768,Kevin Love,28-136,F,1/21/17,CLE,,SAS,L,1,36,4,15,0.267,1,4,0.25,3,11,0.273,2,3,0.667,1,10,11
6769,Kyle Lowry,30-224,G,11/4/16,TOR,,MIA,W,1,41,4,15,0.267,2,7,0.286,2,8,0.25,3,3,1,4,4,8
6770,Timothe Luwawu-Cabarrot,21-314,F,3/19/17,PHI,,BOS,W,1,29,4,12,0.333,1,4,0.25,3,8,0.375,2,2,1,1,1,2
6771,Trey Lyles,21-063,F,1/7/17,UTA,@,MIN,W,0,20,4,6,0.667,2,2,1,2,4,0.5,3,6,0.5,0,3,3
6772,Trey Lyles,21-041,F,12/16/16,UTA,,DAL,W,0,18,6,8,0.75,5,6,0.833,1,2,0.5,0,0,,1,3,4
6773,Trey Lyles,21-024,F,11/29/16,UTA,,HOU,W,0,24,5,8,0.625,3,5,0.6,2,3,0.667,1,2,0.5,0,4,4
6774,Trey Lyles,21-023,F,11/28/16,UTA,@,MIN,W,0,21,6,8,0.75,5,5,1,1,3,0.333,0,0,,1,0,1
6775,Trey Lyles,21-020,F,11/25/16,UTA,,ATL,W,0,27,6,14,0.429,5,8,0.625,1,6,0.167,0,0,,4,6,10
6776,Shelvin Mack,26-243,G,12/21/16,UTA,,SAC,L,1,34,4,10,0.4,2,5,0.4,2,5,0.4,3,4,0.75,0,3,3
6777,Boban Marjanovic,28-150,C,1/12/17,DET,@,GSW,L,0,16,5,7,0.714,5,7,0.714,0,0,,3,3,1,6,5,11
6778,Jarell Martin,22-158,F,10/29/16,MEM,@,NYK,L,0,13,5,9,0.556,3,7,0.429,2,2,1,1,2,0.5,2,1,3
6779,Jarell Martin,22-200,F,12/10/16,MEM,,GSW,W,0,17,5,10,0.5,4,8,0.5,1,2,0.5,2,2,1,3,4,7
6780,Wesley Matthews,30-036,G,11/19/16,DAL,@,ORL,L,1,36,4,11,0.364,1,5,0.2,3,6,0.5,2,2,1,0,4,4
6781,Wesley Matthews,30-100,G,1/22/17,DAL,,LAL,W,1,14,5,9,0.556,2,4,0.5,3,5,0.6,0,0,,1,1,2
6782,Wesley Matthews,30-014,G,10/28/16,DAL,,HOU,L,1,37,4,14,0.286,3,6,0.5,1,8,0.125,4,4,1,0,4,4
6783,Wesley Matthews,30-012,G,10/26/16,DAL,@,IND,L,1,40,3,16,0.188,1,6,0.167,2,10,0.2,5,6,0.833,0,5,5
6784,Wesley Matthews,30-063,G,12/16/16,DAL,@,UTA,L,1,33,4,11,0.364,1,4,0.25,3,7,0.429,2,2,1,0,3,3
6785,Luc Mbah a Moute,30-115,F,1/2/17,LAC,,PHO,W,1,23,5,6,0.833,4,5,0.8,1,1,1,2,3,0.667,1,2,3
6786,Luc Mbah a Moute,30-173,F,3/1/17,LAC,,HOU,L,1,18,6,11,0.545,5,9,0.556,1,2,0.5,0,0,,1,1,2
6787,Luc Mbah a Moute,30-057,F,11/5/16,LAC,@,SAS,W,1,24,5,9,0.556,3,5,0.6,2,4,0.5,1,1,1,0,1,1
6788,C.J. McCollum,25-065,G,11/23/16,POR,@,CLE,L,1,33,5,12,0.417,4,8,0.5,1,4,0.25,2,2,1,0,1,1
6789,C.J. McCollum,25-093,G,12/21/16,POR,,DAL,L,1,41,5,16,0.313,5,12,0.417,0,4,0,3,3,1,0,2,2
6790,T.J. McConnell,24-308,G,1/27/17,PHI,,HOU,L,1,28,4,5,0.8,4,5,0.8,0,0,,5,7,0.714,0,1,1
6791,Chris McCullough,21-283,F,11/14/16,BRK,@,LAC,L,0,12,6,9,0.667,5,7,0.714,1,2,0.5,0,0,,3,0,3
6792,K.J. McDaniels,23-270,G-F,11/5/16,HOU,@,ATL,L,0,19,5,6,0.833,4,4,1,1,2,0.5,2,2,1,0,2,2
6793,Doug McDermott,24-312,F,11/10/16,CHI,@,MIA,W,0,32,5,11,0.455,3,6,0.5,2,5,0.4,1,1,1,0,4,4
6794,Doug McDermott,24-351,F,12/19/16,CHI,,DET,W,0,25,6,12,0.5,5,9,0.556,1,3,0.333,0,0,,0,3,3
6795,Doug McDermott,24-363,F,12/31/16,CHI,,MIL,L,0,29,5,10,0.5,2,4,0.5,3,6,0.5,0,0,,1,0,1
6796,JaVale McGee,29-003,C,1/22/17,GSW,@,ORL,W,0,13,6,7,0.857,6,7,0.857,0,0,,1,2,0.5,3,1,4
6797,JaVale McGee,29-020,C,2/8/17,GSW,,CHI,W,1,16,6,10,0.6,6,10,0.6,0,0,,1,1,1,3,4,7
6798,Rodney McGruder,25-185,G,1/30/17,MIA,,BRK,W,1,32,5,9,0.556,2,3,0.667,3,6,0.5,0,0,,0,1,1
6799,Rodney McGruder,25-210,G,2/24/17,MIA,@,ATL,W,1,23,5,5,1,3,3,1,2,2,1,1,1,1,0,3,3
6800,Ben McLemore,24-003,G,2/14/17,SAC,@,LAL,W,1,34,4,9,0.444,1,4,0.25,3,5,0.6,2,2,1,0,3,3
6801,Ben McLemore,23-261,G,10/29/16,SAC,,MIN,W,0,18,5,10,0.5,3,6,0.5,2,4,0.5,1,1,1,0,0,0
6802,Josh McRoberts,29-279,F,12/3/16,MIA,@,POR,L,1,28,5,9,0.556,3,6,0.5,2,3,0.667,1,1,1,0,2,2
6803,Jodie Meeks,29-127,G,12/26/16,ORL,,MEM,W,1,29,5,8,0.625,2,3,0.667,3,5,0.6,0,0,,0,3,3
6804,Khris Middleton,25-206,F-G,3/6/17,MIL,@,PHI,W,1,32,5,10,0.5,3,5,0.6,2,5,0.4,1,2,0.5,1,4,5
6805,C.J. Miles,29-292,G-F,2/4/17,IND,,DET,W,1,27,5,9,0.556,3,4,0.75,2,5,0.4,1,1,1,0,3,3
6806,C.J. Miles,29-207,G-F,11/11/16,IND,@,PHI,L,1,30,4,9,0.444,3,6,0.5,1,3,0.333,4,4,1,0,4,4
6807,C.J. Miles,29-321,G-F,3/5/17,IND,@,ATL,W,1,33,5,12,0.417,2,2,1,3,10,0.3,0,0,,1,4,5
6808,Patty Mills,28-131,G,12/20/16,SAS,@,HOU,W,0,24,5,9,0.556,2,3,0.667,3,6,0.5,0,0,,0,0,0
6809,Patty Mills,28-216,G,3/15/17,SAS,,POR,L,1,37,5,10,0.5,2,2,1,3,8,0.375,0,0,,1,2,3
6810,Patty Mills,28-163,G,1/21/17,SAS,@,CLE,W,0,31,4,11,0.364,1,6,0.167,3,5,0.6,2,2,1,2,1,3
6811,Patty Mills,28-107,G,11/26/16,SAS,@,WAS,W,0,19,4,7,0.571,1,2,0.5,3,5,0.6,2,2,1,0,3,3
6812,Patty Mills,28-188,G,2/15/17,SAS,@,ORL,W,0,18,5,11,0.455,2,4,0.5,3,7,0.429,0,0,,1,1,2
6813,Patty Mills,28-149,G,1/7/17,SAS,,CHO,W,0,19,6,14,0.429,5,9,0.556,1,5,0.2,0,0,,0,2,2
6814,Paul Millsap,31-264,F,10/31/16,ATL,,SAC,W,1,32,5,14,0.357,5,13,0.385,0,1,0,3,4,0.75,5,8,13
6815,Nikola Mirotic,25-353,F,1/29/17,CHI,,PHI,W,0,26,6,10,0.6,5,7,0.714,1,3,0.333,0,0,,1,2,3
6816,Nikola Mirotic,25-312,F,12/19/16,CHI,,DET,W,0,21,5,10,0.5,2,4,0.5,3,6,0.5,0,0,,0,4,4
6817,Greg Monroe,26-245,C-F,2/4/17,MIL,@,PHO,W,0,20,5,5,1,5,5,1,0,0,,3,3,1,0,4,4
6818,Greg Monroe,26-268,C-F,2/27/17,MIL,@,CLE,L,0,19,5,7,0.714,5,7,0.714,0,0,,3,4,0.75,2,1,3
6819,Greg Monroe,26-282,C-F,3/13/17,MIL,@,MEM,L,0,26,5,10,0.5,5,10,0.5,0,0,,3,3,1,1,4,5
6820,Greg Monroe,26-182,C-F,12/3/16,MIL,,BRK,W,0,21,5,10,0.5,5,10,0.5,0,0,,3,3,1,2,5,7
6821,Greg Monroe,26-242,C-F,2/1/17,MIL,@,UTA,L,0,24,6,12,0.5,6,12,0.5,0,0,,1,2,0.5,1,2,3
6822,Greg Monroe,26-225,C-F,1/15/17,MIL,@,ATL,L,0,20,6,12,0.5,6,12,0.5,0,0,,1,2,0.5,1,0,1
6823,E'Twaun Moore,27-334,G,1/27/17,NOP,,SAS,W,0,18,6,11,0.545,5,9,0.556,1,2,0.5,0,0,,2,0,2
6824,E'Twaun Moore,28-008,G,3/8/17,NOP,,TOR,L,0,29,6,11,0.545,5,8,0.625,1,3,0.333,0,0,,0,1,1
6825,E'Twaun Moore,27-346,G,2/8/17,NOP,,UTA,L,0,19,6,11,0.545,5,7,0.714,1,4,0.25,0,0,,0,0,0
6826,E'Twaun Moore,28-005,G,3/5/17,NOP,@,LAL,W,0,31,5,9,0.556,3,6,0.5,2,3,0.667,1,2,0.5,0,1,1
6827,E'Twaun Moore,27-254,G,11/8/16,NOP,@,SAC,L,1,33,6,10,0.6,5,8,0.625,1,2,0.5,0,0,,0,0,0
6828,Marcus Morris,27-143,F,1/23/17,DET,,SAC,L,1,38,5,11,0.455,4,8,0.5,1,3,0.333,2,2,1,0,3,3
6829,Marcus Morris,27-193,F,3/14/17,DET,@,CLE,L,1,24,5,9,0.556,4,7,0.571,1,2,0.5,2,2,1,2,5,7
6830,Marcus Morris,27-150,F,1/30/17,DET,@,BOS,L,1,35,6,16,0.375,5,9,0.556,1,7,0.143,0,0,,1,4,5
6831,Marcus Morris,27-080,F,11/21/16,DET,,HOU,L,1,35,5,15,0.333,4,11,0.364,1,4,0.25,2,2,1,0,2,2
6832,Marcus Morris,27-095,F,12/6/16,DET,,CHI,W,1,26,5,9,0.556,2,4,0.5,3,5,0.6,0,0,,0,1,1
6833,Marcus Morris,27-185,F,3/6/17,DET,,CHI,W,1,31,5,13,0.385,4,8,0.5,1,5,0.2,2,4,0.5,1,5,6
6834,Marcus Morris,27-200,F,3/21/17,DET,@,BRK,L,1,38,5,14,0.357,4,9,0.444,1,5,0.2,2,4,0.5,0,4,4
6835,Markieff Morris,27-190,F,3/11/17,WAS,@,POR,W,1,43,6,12,0.5,6,12,0.5,0,0,,1,1,1,3,8,11
6836,Markieff Morris,27-123,F,1/3/17,WAS,@,DAL,L,1,26,5,10,0.5,4,8,0.5,1,2,0.5,2,3,0.667,1,4,5
6837,Markieff Morris,27-180,F,3/1/17,WAS,@,TOR,W,1,33,6,14,0.429,5,11,0.455,1,3,0.333,0,0,,2,6,8
6838,Timofey Mozgov,30-140,C,12/3/16,LAL,@,MEM,L,1,27,4,6,0.667,4,6,0.667,0,0,,5,7,0.714,3,2,5
6839,Shabazz Muhammad,23-362,F-G,11/9/16,MIN,@,ORL,W,0,19,4,6,0.667,3,5,0.6,1,1,1,4,7,0.571,0,1,1
6840,Jamal Murray,19-331,G,1/19/17,DEN,@,SAS,L,0,26,4,15,0.267,2,7,0.286,2,8,0.25,3,3,1,1,5,6
6841,Jamal Murray,20-015,G,3/10/17,DEN,,BOS,W,0,17,6,11,0.545,5,7,0.714,1,4,0.25,0,0,,0,3,3
6842,Jamal Murray,20-025,G,3/20/17,DEN,@,HOU,L,0,23,5,8,0.625,4,5,0.8,1,3,0.333,2,2,1,0,4,4
6843,Mike Muscala,25-145,F-C,11/23/16,ATL,@,IND,W,0,26,4,7,0.571,2,5,0.4,2,2,1,3,3,1,2,2,4
6844,Mike Muscala,25-175,F-C,12/23/16,ATL,@,DEN,W,0,21,5,7,0.714,4,4,1,1,3,0.333,2,3,0.667,0,3,3
6845,Larry Nance Jr.,24-075,F,3/17/17,LAL,,MIL,L,0,28,3,6,0.5,3,4,0.75,0,2,0,7,7,1,0,4,4
6846,Larry Nance Jr.,24-067,F,3/9/17,LAL,@,PHO,W,0,27,6,10,0.6,5,8,0.625,1,2,0.5,0,0,,2,6,8
6847,Jameer Nelson,34-333,G,1/7/17,DEN,@,OKC,L,0,22,5,10,0.5,3,7,0.429,2,3,0.667,1,3,0.333,1,0,1
6848,Jameer Nelson,34-352,G,1/26/17,DEN,,PHO,W,1,42,6,11,0.545,5,7,0.714,1,4,0.25,0,0,,0,4,4
6849,Jameer Nelson,34-298,G,12/3/16,DEN,@,UTA,L,0,26,5,8,0.625,2,3,0.667,3,5,0.6,0,1,0,1,3,4
6850,Jameer Nelson,34-265,G,10/31/16,DEN,@,TOR,L,0,22,5,9,0.556,2,5,0.4,3,4,0.75,0,0,,1,1,2
6851,Nerlens Noel,22-276,C-F,1/11/17,PHI,,NYK,W,0,21,5,8,0.625,5,8,0.625,0,0,,3,4,0.75,4,4,8
6852,Nerlens Noel,22-329,C-F,3/5/17,DAL,,OKC,W,0,16,6,7,0.857,6,7,0.857,0,0,,1,1,1,2,2,4
6853,Nerlens Noel,22-271,C-F,1/6/17,PHI,@,BOS,L,0,25,6,8,0.75,6,8,0.75,0,0,,1,2,0.5,2,6,8
6854,Lucas Nogueira,24-129,C,12/2/16,TOR,,LAL,W,0,18,5,5,1,5,5,1,0,0,,3,3,1,1,2,3
6855,Lucas Nogueira,24-180,C,1/22/17,TOR,,PHO,L,1,35,5,5,1,4,4,1,1,1,1,2,2,1,0,5,5
6856,Dirk Nowitzki,38-264,F,3/10/17,DAL,,BRK,W,1,23,5,12,0.417,2,4,0.5,3,8,0.375,0,0,,0,3,3
6857,Dirk Nowitzki,38-200,F,1/5/17,DAL,,PHO,L,1,28,5,14,0.357,2,7,0.286,3,7,0.429,0,0,,1,6,7
6858,Dirk Nowitzki,38-217,F,1/22/17,DAL,,LAL,W,1,20,5,11,0.455,4,8,0.5,1,3,0.333,2,2,1,1,4,5
6859,Jusuf Nurkic,22-069,C,10/31/16,DEN,@,TOR,L,1,38,5,14,0.357,5,14,0.357,0,0,,3,7,0.429,5,13,18
6860,Jusuf Nurkic,22-107,C,12/8/16,DEN,@,WAS,L,1,21,6,6,1,6,6,1,0,0,,1,2,0.5,1,6,7
6861,Jusuf Nurkic,22-176,C,2/15/17,POR,@,UTA,L,0,21,5,5,1,5,5,1,0,0,,3,4,0.75,1,7,8
6862,Kyle O'Quinn,26-311,F-C,1/31/17,NYK,@,WAS,L,0,17,6,10,0.6,6,10,0.6,0,0,,1,1,1,6,4,10
6863,Jahlil Okafor,21-014,C-F,12/29/16,PHI,@,UTA,L,1,24,6,15,0.4,6,15,0.4,0,0,,1,1,1,2,2,4
6864,Victor Oladipo,24-250,G,1/9/17,OKC,@,CHI,W,1,25,6,9,0.667,5,7,0.714,1,2,0.5,0,0,,0,2,2
6865,Kelly Olynyk,25-266,C-F,1/10/17,BOS,@,TOR,L,0,25,6,10,0.6,5,8,0.625,1,2,0.5,0,2,0,1,3,4
6866,Kelly Olynyk,25-296,C-F,2/9/17,BOS,@,POR,W,0,23,5,9,0.556,3,5,0.6,2,4,0.5,1,1,1,2,5,7
6867,Kelly Olynyk,25-292,C-F,2/5/17,BOS,,LAC,W,0,22,5,10,0.5,4,6,0.667,1,4,0.25,2,2,1,2,2,4
6868,Zaza Pachulia,32-329,C,1/4/17,GSW,,POR,W,1,19,5,7,0.714,5,7,0.714,0,0,,3,3,1,1,2,3
6869,Jabari Parker,21-229,F,10/30/16,MIL,@,DET,L,1,29,6,16,0.375,6,15,0.4,0,1,0,1,2,0.5,3,3,6
6870,Jabari Parker,21-225,F,10/26/16,MIL,,CHO,L,1,30,4,9,0.444,3,8,0.375,1,1,1,4,4,1,2,4,6
6871,Tony Parker,34-222,G,12/25/16,SAS,,CHI,W,1,28,6,15,0.4,5,13,0.385,1,2,0.5,0,0,,0,3,3
6872,Tony Parker,34-240,G,1/12/17,SAS,,LAL,W,1,21,6,10,0.6,6,10,0.6,0,0,,1,1,1,0,2,2
6873,Patrick Patterson,27-240,F,11/9/16,TOR,@,OKC,W,0,33,5,11,0.455,2,3,0.667,3,8,0.375,0,0,,0,3,3
6874,Chris Paul,31-226,G,12/18/16,LAC,@,WAS,L,1,37,6,15,0.4,5,10,0.5,1,5,0.2,0,1,0,1,3,4
6875,Chris Paul,31-205,G,11/27/16,LAC,@,IND,L,1,32,3,11,0.273,3,5,0.6,0,6,0,7,7,1,0,4,4
6876,Chris Paul,31-318,G,3/20/17,LAC,,NYK,W,1,28,5,11,0.455,3,6,0.5,2,5,0.4,1,1,1,0,5,5
6877,Elfrid Payton,23-019,G,3/13/17,ORL,@,SAC,L,1,34,6,10,0.6,6,9,0.667,0,1,0,1,1,1,1,9,10
6878,Elfrid Payton,22-315,G,1/2/17,ORL,@,NYK,W,0,31,6,12,0.5,5,11,0.455,1,1,1,0,0,,1,2,3
6879,Elfrid Payton,23-022,G,3/16/17,ORL,@,GSW,L,1,22,6,11,0.545,6,11,0.545,0,0,,1,1,1,4,4,8
6880,Elfrid Payton,22-300,G,12/18/16,ORL,,TOR,L,0,25,6,10,0.6,6,8,0.75,0,2,0,1,1,1,0,2,2
6881,Mason Plumlee,26-337,C-F,2/5/17,POR,@,OKC,L,1,29,4,10,0.4,4,10,0.4,0,0,,5,7,0.714,3,1,4
6882,Mason Plumlee,26-238,C-F,10/29/16,POR,@,DEN,W,1,32,5,8,0.625,5,8,0.625,0,0,,3,6,0.5,0,2,2
6883,Mason Plumlee,26-296,C-F,12/26/16,POR,,TOR,L,1,30,5,10,0.5,5,10,0.5,0,0,,3,4,0.75,4,11,15
6884,Mason Plumlee,26-328,C-F,1/27/17,POR,,MEM,W,1,34,5,11,0.455,5,11,0.455,0,0,,3,3,1,4,6,10
6885,Mason Plumlee,26-258,C-F,11/18/16,POR,@,NOP,L,1,34,6,10,0.6,6,10,0.6,0,0,,1,2,0.5,3,9,12
6886,Otto Porter,23-214,F,1/3/17,WAS,@,DAL,L,1,37,5,11,0.455,2,6,0.333,3,5,0.6,0,0,,0,4,4
6887,Otto Porter,23-149,F,10/30/16,WAS,@,MEM,L,1,36,6,15,0.4,6,10,0.6,0,5,0,1,1,1,3,1,4
6888,Otto Porter,23-240,F,1/29/17,WAS,@,NOP,W,1,34,5,10,0.5,2,5,0.4,3,5,0.6,0,0,,1,5,6
6889,Otto Porter,23-219,F,1/8/17,WAS,@,MIL,W,1,39,3,8,0.375,0,1,0,3,7,0.429,4,4,1,1,6,7
6890,Bobby Portis,21-335,F,1/10/17,CHI,@,WAS,L,0,18,5,8,0.625,2,4,0.5,3,4,0.75,0,0,,2,5,7
6891,Kristaps Porzingis,21-176,F-C,1/25/17,NYK,@,DAL,L,1,23,4,11,0.364,4,9,0.444,0,2,0,5,5,1,2,6,8
6892,Kristaps Porzingis,21-218,F-C,3/8/17,NYK,@,MIL,L,1,37,5,15,0.333,3,10,0.3,2,5,0.4,1,2,0.5,1,7,8
6893,Dwight Powell,25-160,F-C,12/27/16,DAL,,HOU,L,0,23,4,6,0.667,3,5,0.6,1,1,1,4,6,0.667,1,1,2
6894,Norman Powell,23-295,G,3/16/17,TOR,,OKC,L,0,22,4,12,0.333,3,9,0.333,1,3,0.333,4,5,0.8,1,3,4
6895,Norman Powell,23-265,G,2/14/17,TOR,@,CHI,L,0,18,4,8,0.5,4,5,0.8,0,3,0,5,6,0.833,1,1,2
6896,Julius Randle,22-094,F,3/3/17,LAL,,BOS,L,1,29,5,13,0.385,5,13,0.385,0,0,,3,3,1,1,6,7
6897,Julius Randle,21-355,F,11/18/16,LAL,,SAS,L,1,30,6,13,0.462,6,12,0.5,0,1,0,1,2,0.5,1,8,9
6898,Julius Randle,22-026,F,12/25/16,LAL,,LAC,W,1,31,5,11,0.455,5,10,0.5,0,1,0,3,4,0.75,2,5,7
6899,Julius Randle,22-087,F,2/24/17,LAL,@,OKC,L,1,29,6,12,0.5,6,11,0.545,0,1,0,1,2,0.5,3,8,11
6900,Julius Randle,22-078,F,2/15/17,LAL,@,PHO,L,1,29,4,9,0.444,4,9,0.444,0,0,,5,5,1,3,7,10
6901,Julius Randle,22-026,F,12/25/16,LAL,,LAC,W,1,31,5,11,0.455,5,10,0.5,0,1,0,3,4,0.75,2,5,7
6902,Julius Randle,22-087,F,2/24/17,LAL,@,OKC,L,1,29,6,12,0.5,6,11,0.545,0,1,0,1,2,0.5,3,8,11
6903,Julius Randle,22-078,F,2/15/17,LAL,@,PHO,L,1,29,4,9,0.444,4,9,0.444,0,0,,5,5,1,3,7,10
6904,Zach Randolph,35-105,F,10/29/16,MEM,@,NYK,L,0,21,5,14,0.357,4,13,0.308,1,1,1,2,2,1,2,7,9
6905,Zach Randolph,35-163,F,12/26/16,MEM,@,ORL,L,0,23,6,15,0.4,5,12,0.417,1,3,0.333,0,0,,1,4,5
6906,Zach Randolph,35-176,F,1/8/17,MEM,,UTA,W,0,27,6,16,0.375,6,14,0.429,0,2,0,1,1,1,2,9,11
6907,Zach Randolph,35-172,F,1/4/17,MEM,@,LAC,L,0,19,6,12,0.5,6,12,0.5,0,0,,1,2,0.5,0,3,3
6908,J.J. Redick,32-129,G,10/31/16,LAC,,PHO,W,1,26,6,13,0.462,5,10,0.5,1,3,0.333,0,0,,0,3,3
6909,J.J. Redick,32-253,G,3/4/17,LAC,@,CHI,W,1,24,6,12,0.5,5,7,0.714,1,5,0.2,0,0,,0,1,1
6910,J.J. Redick,32-218,G,1/28/17,LAC,@,GSW,L,1,26,4,8,0.5,1,3,0.333,3,5,0.6,2,2,1,0,1,1
6911,Austin Rivers,24-198,G,2/15/17,LAC,,ATL,W,1,27,5,11,0.455,4,8,0.5,1,3,0.333,2,2,1,0,2,2
6912,Austin Rivers,24-139,G,12/18/16,LAC,@,WAS,L,0,25,6,9,0.667,5,6,0.833,1,3,0.333,0,0,,0,0,0
6913,Andre Roberson,25-102,G-F,3/16/17,OKC,@,TOR,W,1,31,6,8,0.75,5,6,0.833,1,2,0.5,0,0,,1,3,4
6914,Andre Roberson,24-343,G-F,11/11/16,OKC,,LAC,L,1,34,5,10,0.5,2,4,0.5,3,6,0.5,0,0,,3,6,9
6915,Andre Roberson,25-034,G-F,1/7/17,OKC,,DEN,W,1,39,3,7,0.429,1,2,0.5,2,5,0.4,5,8,0.625,0,9,9
6916,Andre Roberson,25-000,G-F,12/4/16,OKC,,NOP,W,1,37,6,8,0.75,5,6,0.833,1,2,0.5,0,1,0,1,4,5
6917,Glenn Robinson,23-048,G-F,2/25/17,IND,@,MIA,L,0,24,5,8,0.625,3,6,0.5,2,2,1,1,2,0.5,0,5,5
6918,Sergio Rodriguez,30-153,G,11/12/16,PHI,@,ATL,L,1,25,5,9,0.556,2,5,0.4,3,4,0.75,0,0,,0,3,3
6919,Sergio Rodriguez,30-278,G,3/17/17,PHI,,DAL,W,0,26,5,5,1,3,3,1,2,2,1,1,2,0.5,1,3,4
6920,Rajon Rondo,30-340,G,1/27/17,CHI,,MIA,L,0,32,6,8,0.75,5,7,0.714,1,1,1,0,0,,1,6,7
6921,Rajon Rondo,30-274,G,11/22/16,CHI,@,DEN,L,1,33,6,11,0.545,5,9,0.556,1,2,0.5,0,0,,0,11,11
6922,Derrick Rose,28-115,G,1/27/17,NYK,,CHO,W,1,22,5,10,0.5,5,10,0.5,0,0,,3,3,1,1,1,2
6923,Derrick Rose,28-113,G,1/25/17,NYK,@,DAL,L,1,35,6,15,0.4,5,14,0.357,1,1,1,0,0,,2,1,3
6924,Derrick Rose,28-025,G,10/29/16,NYK,,MEM,W,1,32,6,13,0.462,6,12,0.5,0,1,0,1,2,0.5,1,3,4
6925,Derrick Rose,28-142,G,2/23/17,NYK,@,CLE,L,1,32,6,14,0.429,6,14,0.429,0,0,,1,1,1,0,2,2
6926,Derrick Rose,28-129,G,2/10/17,NYK,,DEN,L,1,28,6,9,0.667,6,9,0.667,0,0,,1,1,1,1,2,3
6927,Terrence Ross,25-313,F-G,12/14/16,TOR,@,PHI,W,0,19,3,8,0.375,2,3,0.667,1,5,0.2,6,6,1,0,2,2
6928,Terrence Ross,26-018,F-G,2/23/17,ORL,,POR,L,1,33,4,17,0.235,2,9,0.222,2,8,0.25,3,3,1,2,3,5
6929,Terry Rozier,22-346,G,2/26/17,BOS,@,DET,W,0,18,4,5,0.8,1,1,1,3,4,0.75,2,2,1,1,2,3
6930,Ricky Rubio,26-080,G,1/9/17,MIN,,DAL,W,1,30,3,9,0.333,3,7,0.429,0,2,0,7,7,1,0,5,5
6931,Ricky Rubio,26-063,G,12/23/16,MIN,,SAC,L,1,34,4,10,0.4,1,4,0.25,3,6,0.5,2,2,1,2,4,6
6932,Ricky Rubio,26-126,G,2/24/17,MIN,,DAL,W,1,35,6,13,0.462,6,12,0.5,0,1,0,1,2,0.5,1,4,5
6933,Domantas Sabonis,20-184,F,11/3/16,OKC,@,GSW,L,1,27,6,12,0.5,5,11,0.455,1,1,1,0,0,,1,5,6
6934,Domantas Sabonis,20-273,F,1/31/17,OKC,@,SAS,L,1,35,5,11,0.455,3,7,0.429,2,4,0.5,1,2,0.5,1,9,10
6935,Domantas Sabonis,20-206,F,11/25/16,OKC,@,DEN,W,1,28,5,7,0.714,2,4,0.5,3,3,1,0,0,,1,5,6
6936,Dario Saric,22-266,F,12/30/16,PHI,@,DEN,W,0,28,4,11,0.364,4,7,0.571,0,4,0,5,7,0.714,4,7,11
6937,Dario Saric,22-244,F,12/8/16,PHI,@,NOP,W,0,25,5,11,0.455,3,5,0.6,2,6,0.333,1,1,1,2,3,5
6938,Dario Saric,22-304,F,2/6/17,PHI,@,DET,L,0,28,6,14,0.429,5,9,0.556,1,5,0.2,0,0,,3,3,6
6939,Dario Saric,22-222,F,11/16/16,PHI,,WAS,W,0,26,5,13,0.385,4,7,0.571,1,6,0.167,2,3,0.667,1,11,12
6940,Dennis Schroder,23-125,G,1/18/17,ATL,@,DET,L,1,27,5,11,0.455,5,9,0.556,0,2,0,3,3,1,0,0,0
6941,Dennis Schroder,23-055,G,11/9/16,ATL,,CHI,W,1,31,5,19,0.263,4,15,0.267,1,4,0.25,2,3,0.667,2,5,7
6942,Thabo Sefolosha,32-238,G-F,12/26/16,ATL,@,MIN,L,1,21,5,10,0.5,2,6,0.333,3,4,0.75,0,0,,1,4,5
6943,Thabo Sefolosha,32-178,G-F,10/27/16,ATL,,WAS,W,0,22,6,8,0.75,5,7,0.714,1,1,1,0,2,0,3,4,7
6944,Ramon Sessions,30-249,G,12/16/16,CHO,@,BOS,L,1,32,5,16,0.313,4,13,0.308,1,3,0.333,2,2,1,2,4,6
6945,Ramon Sessions,30-261,G,12/28/16,CHO,@,ORL,W,0,22,5,9,0.556,4,8,0.5,1,1,1,2,2,1,1,3,4
6946,Marcus Smart,23-004,G,3/10/17,BOS,@,DEN,L,0,25,4,15,0.267,3,13,0.231,1,2,0.5,4,4,1,4,3,7
6947,Marcus Smart,22-296,G,12/27/16,BOS,,MEM,W,0,29,3,9,0.333,1,5,0.2,2,4,0.5,5,6,0.833,1,3,4
6948,Marcus Smart,22-330,G,1/30/17,BOS,,DET,W,0,30,3,13,0.231,1,10,0.1,2,3,0.667,5,6,0.833,1,4,5
6949,Marcus Smart,22-245,G,11/6/16,BOS,,DEN,L,0,27,6,13,0.462,5,9,0.556,1,4,0.25,0,0,,2,3,5
6950,Marcus Smart,22-276,G,12/7/16,BOS,@,ORL,W,1,23,5,7,0.714,4,5,0.8,1,2,0.5,2,2,1,0,3,3
6951,Marcus Smart,22-274,G,12/5/16,BOS,@,HOU,L,0,27,4,9,0.444,3,5,0.6,1,4,0.25,4,5,0.8,2,3,5
6952,Marcus Smart,22-324,G,1/24/17,BOS,@,WAS,L,1,33,4,13,0.308,2,7,0.286,2,6,0.333,3,4,0.75,1,4,5
6953,Marcus Smart,22-336,G,2/5/17,BOS,,LAC,W,0,30,5,9,0.556,2,4,0.5,3,5,0.6,0,0,,2,1,3
6954,Ish Smith,28-147,G,11/29/16,DET,@,CHO,W,1,25,6,10,0.6,6,7,0.857,0,3,0,1,1,1,0,2,2
6955,Jason Smith,30-315,F-C,1/11/17,WAS,@,BOS,L,0,19,5,9,0.556,5,8,0.625,0,1,0,3,4,0.75,2,3,5
6956,Jason Smith,31-018,F-C,3/20/17,WAS,@,BOS,L,0,17,5,8,0.625,2,3,0.667,3,5,0.6,0,0,,0,5,5
6957,Tony Snell,25-057,G-F,1/6/17,MIL,,NYK,L,1,38,5,6,0.833,2,2,1,3,4,0.75,0,0,,0,3,3
6958,Tony Snell,25-108,G-F,2/26/17,MIL,,PHO,W,1,32,5,9,0.556,2,3,0.667,3,6,0.5,0,0,,1,2,3
6959,Tony Snell,25-021,G-F,12/1/16,MIL,@,BRK,W,1,28,3,7,0.429,0,1,0,3,6,0.5,4,4,1,2,3,5
6960,Tony Snell,25-093,G-F,2/11/17,MIL,@,IND,W,1,21,4,5,0.8,0,0,,4,5,0.8,1,2,0.5,1,4,5
6961,Tony Snell,24-357,G-F,11/1/16,MIL,@,NOP,W,1,33,5,12,0.417,2,3,0.667,3,9,0.333,0,0,,1,9,10
6962,Marreese Speights,29-160,C-F,1/11/17,LAC,,ORL,W,0,16,5,7,0.714,2,3,0.667,3,4,0.75,0,1,0,0,3,3
6963,Nik Stauskas,23-041,G,11/17/16,PHI,@,MIN,L,0,24,4,8,0.5,1,2,0.5,3,6,0.5,2,2,1,1,4,5
6964,Nik Stauskas,23-125,G,2/9/17,PHI,@,ORL,W,0,28,4,8,0.5,2,5,0.4,2,3,0.667,3,3,1,1,4,5
6965,Nik Stauskas,23-019,G,10/26/16,PHI,,OKC,L,0,23,5,6,0.833,5,5,1,0,1,0,3,3,1,0,4,4
6966,Nik Stauskas,23-049,G,11/25/16,PHI,,CHI,L,0,24,5,9,0.556,3,5,0.6,2,4,0.5,1,2,0.5,0,5,5
6967,Rodney Stuckey,30-298,G,2/13/17,IND,,SAS,L,0,21,5,8,0.625,4,6,0.667,1,2,0.5,2,3,0.667,1,3,4
6968,Jared Sullinger,24-334,F,2/1/17,TOR,@,BOS,L,0,16,5,8,0.625,4,5,0.8,1,3,0.333,2,5,0.4,2,4,6
6969,Jeff Teague,28-239,G,2/4/17,IND,,DET,W,1,31,5,13,0.385,5,10,0.5,0,3,0,3,4,0.75,0,2,2
6970,Jeff Teague,28-154,G,11/11/16,IND,@,PHI,L,1,35,5,10,0.5,4,6,0.667,1,4,0.25,2,2,1,0,1,1
6971,Jeff Teague,28-236,G,2/1/17,IND,@,ORL,W,1,34,2,5,0.4,1,3,0.333,1,2,0.5,8,9,0.889,0,1,1
6972,Jeff Teague,28-245,G,2/10/17,IND,@,WAS,L,1,31,4,12,0.333,3,9,0.333,1,3,0.333,4,4,1,0,4,4
6973,Mirza Teletovic,31-088,F,12/15/16,MIL,,CHI,W,0,19,5,10,0.5,2,5,0.4,3,5,0.6,0,0,,0,0,0
6974,Mirza Teletovic,31-108,F,1/4/17,MIL,@,NYK,W,0,21,4,10,0.4,1,2,0.5,3,8,0.375,2,2,1,1,0,1
6975,Mirza Teletovic,31-089,F,12/16/16,MIL,@,CHI,W,0,27,5,10,0.5,2,2,1,3,8,0.375,0,0,,0,8,8
6976,Lance Thomas,28-322,F,3/12/17,NYK,@,BRK,L,0,32,4,7,0.571,1,3,0.333,3,4,0.75,2,3,0.667,2,3,5
6977,Klay Thompson,27-026,G,3/6/17,GSW,@,ATL,W,1,30,5,12,0.417,3,4,0.75,2,8,0.25,1,2,0.5,0,0,0
6978,Klay Thompson,27-022,G,3/2/17,GSW,@,CHI,L,1,37,5,22,0.227,4,11,0.364,1,11,0.091,2,2,1,0,1,1
6979,Tristan Thompson,25-272,F-C,12/10/16,CLE,,CHO,W,1,28,5,5,1,5,5,1,0,0,,3,6,0.5,4,8,12
6980,Tristan Thompson,25-335,F-C,2/11/17,CLE,,DEN,W,1,36,5,9,0.556,5,9,0.556,0,0,,3,6,0.5,4,9,13
6981,Marcus Thornton,29-165,G,11/17/16,WAS,,NYK,W,0,18,5,7,0.714,2,4,0.5,3,3,1,0,0,,1,1,2
6982,P.J. Tucker,31-222,F,12/13/16,PHO,,NYK,W,1,40,6,13,0.462,5,8,0.625,1,5,0.2,0,2,0,1,6,7
6983,P.J. Tucker,31-275,F,2/4/17,PHO,,MIL,L,0,37,5,7,0.714,3,4,0.75,2,3,0.667,1,1,1,1,3,4
6984,Evan Turner,28-034,G,11/30/16,POR,,IND,W,0,27,5,7,0.714,4,6,0.667,1,1,1,2,2,1,0,4,4
6985,Myles Turner,20-289,F-C,1/7/17,IND,,NYK,W,1,32,6,13,0.462,6,12,0.5,0,1,0,1,1,1,3,7,10
6986,Myles Turner,20-303,F-C,1/21/17,IND,@,UTA,L,1,33,5,9,0.556,4,7,0.571,1,2,0.5,2,2,1,1,6,7
6987,Myles Turner,20-218,F-C,10/28/16,IND,@,BRK,L,1,33,5,11,0.455,5,9,0.556,0,2,0,3,3,1,5,6,11
6988,Myles Turner,20-317,F-C,2/4/17,IND,,DET,W,1,32,5,12,0.417,4,9,0.444,1,3,0.333,2,3,0.667,1,5,6
6989,Beno Udrih,34-115,G,10/28/16,DET,,ORL,W,0,20,6,10,0.6,5,9,0.556,1,1,1,0,0,,0,2,2
6990,Tyler Ulis,21-069,G,3/15/17,PHO,,SAC,L,1,39,6,18,0.333,5,13,0.385,1,5,0.2,0,0,,0,1,1
6991,Tyler Ulis,21-037,G,2/11/17,PHO,@,HOU,L,0,28,5,13,0.385,4,9,0.444,1,4,0.25,2,2,1,1,0,1
6992,Jonas Valanciunas,24-302,C,3/4/17,TOR,@,MIL,L,1,21,5,5,1,5,5,1,0,0,,3,4,0.75,0,7,7
6993,Jonas Valanciunas,24-190,C,11/12/16,TOR,,NYK,W,1,22,4,8,0.5,4,8,0.5,0,0,,5,6,0.833,2,6,8
6994,Denzel Valentine,23-116,G,3/12/17,CHI,@,BOS,L,0,23,5,8,0.625,2,2,1,3,6,0.5,0,0,,0,3,3
6995,Nikola Vucevic,26-088,C,1/20/17,ORL,,MIL,W,1,23,6,12,0.5,6,12,0.5,0,0,,1,2,0.5,4,2,6
6996,Nikola Vucevic,26-098,C,1/30/17,ORL,@,MIN,L,1,38,5,15,0.333,5,12,0.417,0,3,0,3,6,0.5,2,9,11
6997,Nikola Vucevic,26-112,C,2/13/17,ORL,@,MIA,W,1,31,4,14,0.286,4,14,0.286,0,0,,5,8,0.625,4,13,17
6998,Nikola Vucevic,26-063,C,12/26/16,ORL,,MEM,W,0,27,6,11,0.545,5,10,0.5,1,1,1,0,0,,0,9,9
6999,Dwyane Wade,34-298,G,11/10/16,CHI,@,MIA,W,1,32,5,17,0.294,5,13,0.385,0,4,0,3,3,1,1,6,7
7000,Dwyane Wade,34-337,G,12/19/16,CHI,,DET,W,1,22,6,10,0.6,6,10,0.6,0,0,,1,1,1,1,3,4
7001,Dion Waiters,25-034,G,1/13/17,MIA,@,MIL,L,1,31,5,17,0.294,3,11,0.273,2,6,0.333,1,1,1,0,2,2
7002,Dion Waiters,24-323,G,10/28/16,MIA,,CHO,L,1,34,5,16,0.313,2,9,0.222,3,7,0.429,0,2,0,1,6,7
7003,Isaiah Whitehead,21-328,G,1/30/17,BRK,@,MIA,L,0,24,6,12,0.5,5,9,0.556,1,3,0.333,0,0,,2,2,4
7004,Isaiah Whitehead,21-279,G,12/12/16,BRK,@,HOU,L,1,24,6,8,0.75,6,7,0.857,0,1,0,1,2,0.5,0,2,2
7005,Hassan Whiteside,27-220,C,1/19/17,MIA,,DAL,W,1,29,6,12,0.5,6,12,0.5,0,0,,1,1,1,1,7,8
7006,Hassan Whiteside,27-266,C,3/6/17,MIA,@,CLE,W,1,36,4,10,0.4,4,10,0.4,0,0,,5,6,0.833,2,9,11
7007,Andrew Wiggins,21-279,F-G,11/28/16,MIN,,UTA,L,1,34,6,16,0.375,5,14,0.357,1,2,0.5,0,0,,0,2,2
7008,Andrew Wiggins,21-321,F-G,1/9/17,MIN,,DAL,W,1,36,5,11,0.455,5,10,0.5,0,1,0,3,6,0.5,3,1,4
7009,Andrew Wiggins,21-274,F-G,11/23/16,MIN,@,NOP,L,1,31,2,19,0.105,2,16,0.125,0,3,0,9,10,0.9,0,0,0
7010,Andrew Wiggins,21-298,F-G,12/17/16,MIN,,HOU,L,1,44,5,17,0.294,5,15,0.333,0,2,0,3,4,0.75,2,4,6
7011,Deron Williams,32-203,G,1/15/17,DAL,,MIN,W,1,31,5,9,0.556,2,4,0.5,3,5,0.6,0,2,0,0,4,4
7012,Deron Williams,32-261,G,3/14/17,CLE,,DET,W,0,14,6,6,1,5,5,1,1,1,1,0,0,,0,2,2
7013,Deron Williams,32-210,G,1/22/17,DAL,,LAL,W,1,26,6,9,0.667,5,6,0.833,1,3,0.333,0,0,,0,5,5
7014,Derrick Williams,25-293,F,3/14/17,CLE,,DET,W,0,21,4,8,0.5,1,3,0.333,3,5,0.6,2,4,0.5,0,0,0
7015,Derrick Williams,25-265,F,2/14/17,CLE,@,MIN,W,0,23,5,7,0.714,5,6,0.833,0,1,0,3,5,0.6,0,6,6
7016,Derrick Williams,25-185,F,11/26/16,MIA,,MEM,L,1,16,5,9,0.556,4,4,1,1,5,0.2,2,2,1,1,1,2
7017,Derrick Williams,25-280,F,3/1/17,CLE,@,BOS,L,0,31,5,10,0.5,3,5,0.6,2,5,0.4,1,2,0.5,0,3,3
7018,Lou Williams,30-026,G,11/22/16,LAL,,OKC,W,0,23,4,12,0.333,2,6,0.333,2,6,0.333,3,3,1,0,1,1
7019,Lou Williams,30-036,G,12/2/16,LAL,@,TOR,L,0,25,4,14,0.286,3,8,0.375,1,6,0.167,4,5,0.8,0,1,1
7020,Lou Williams,30-079,G,1/14/17,LAL,@,LAC,L,1,22,4,12,0.333,2,7,0.286,2,5,0.4,3,4,0.75,0,2,2
7021,Lou Williams,30-057,G,12/23/16,LAL,@,ORL,L,0,21,3,11,0.273,2,8,0.25,1,3,0.333,6,7,0.857,0,2,2
7022,Lou Williams,30-029,G,11/25/16,LAL,,GSW,L,0,26,5,13,0.385,5,9,0.556,0,4,0,3,4,0.75,1,2,3
7023,Marvin Williams,30-274,F,3/20/17,CHO,,ATL,W,1,36,5,10,0.5,5,6,0.833,0,4,0,3,3,1,1,7,8
7024,Marvin Williams,30-218,F,1/23/17,CHO,,WAS,L,1,29,5,12,0.417,4,6,0.667,1,6,0.167,2,2,1,4,4,8
7025,Marvin Williams,30-267,F,3/13/17,CHO,,CHI,L,1,38,5,12,0.417,4,7,0.571,1,5,0.2,2,2,1,5,13,18
7026,Marvin Williams,30-153,F,11/19/16,CHO,@,NOP,L,1,30,3,14,0.214,2,8,0.25,1,6,0.167,6,6,1,1,1,2
7027,Marvin Williams,30-176,F,12/12/16,CHO,@,IND,L,1,28,4,7,0.571,2,3,0.667,2,4,0.5,3,4,0.75,0,2,2
7028,Marvin Williams,30-193,F,12/29/16,CHO,,MIA,W,1,25,6,12,0.5,5,8,0.625,1,4,0.25,0,0,,0,1,1
7029,Marvin Williams,30-249,F,2/23/17,CHO,@,DET,L,1,40,4,8,0.5,4,6,0.667,0,2,0,5,5,1,0,7,7
7030,Marvin Williams,30-129,F,10/26/16,CHO,@,MIL,W,1,29,5,12,0.417,2,8,0.25,3,4,0.75,0,0,,2,8,10
7031,Troy Williams,21-349,F,12/13/16,MEM,@,CLE,L,1,36,6,16,0.375,5,12,0.417,1,4,0.25,0,0,,2,4,6
7032,Justise Winslow,20-269,F,12/20/16,MIA,,ORL,L,1,46,6,17,0.353,6,16,0.375,0,1,0,1,1,1,1,4,5
7033,Justise Winslow,20-223,F,11/4/16,MIA,@,TOR,L,1,39,5,18,0.278,5,16,0.313,0,2,0,3,4,0.75,1,2,3
7034,Delon Wright,24-319,G,3/11/17,TOR,@,MIA,L,0,25,5,8,0.625,5,8,0.625,0,0,,3,3,1,2,1,3
7035,Nick Young,31-279,G-F,3/7/17,LAL,@,DAL,L,1,21,4,10,0.4,1,2,0.5,3,8,0.375,2,2,1,0,2,2
7036,Nick Young,31-218,G-F,1/5/17,LAL,@,POR,L,1,35,5,15,0.333,2,6,0.333,3,9,0.333,0,0,,1,1,2
7037,Nick Young,31-239,G-F,1/26/17,LAL,@,UTA,L,1,29,5,12,0.417,2,5,0.4,3,7,0.429,0,0,,0,3,3
7038,Nick Young,31-149,G-F,10/28/16,LAL,@,UTA,L,1,24,3,7,0.429,2,5,0.4,1,2,0.5,6,6,1,0,0,0
7039,Thaddeus Young,28-264,F,3/12/17,IND,,MIA,W,1,38,5,9,0.556,5,9,0.556,0,0,,3,6,0.5,1,4,5
7040,Cody Zeller,24-033,F-C,11/7/16,CHO,,IND,W,1,23,5,7,0.714,5,7,0.714,0,0,,3,3,1,0,5,5
7041,Cody Zeller,24-110,F-C,1/23/17,CHO,,WAS,L,1,35,4,7,0.571,4,7,0.571,0,0,,5,5,1,4,5,9
7042,Cody Zeller,24-028,F-C,11/2/16,CHO,,PHI,W,1,26,5,7,0.714,5,7,0.714,0,0,,3,6,0.5,0,1,1
7043,Cody Zeller,24-079,F-C,12/23/16,CHO,,CHI,W,1,32,5,9,0.556,5,9,0.556,0,0,,3,4,0.75,5,2,7
7044,Cody Zeller,24-152,F-C,3/6/17,CHO,,IND,W,1,34,5,10,0.5,5,9,0.556,0,1,0,3,4,0.75,5,6,11
7045,Cody Zeller,24-103,F-C,1/16/17,CHO,@,BOS,L,1,31,5,7,0.714,5,7,0.714,0,0,,3,4,0.75,5,3,8
7046,Tyler Zeller,26-283,F-C,10/26/16,BOS,,BRK,W,0,16,6,7,0.857,6,7,0.857,0,0,,1,2,0.5,2,2,4
7047,Paul Zipser,22-338,G-F,1/21/17,CHI,,SAC,W,0,23,4,8,0.5,1,2,0.5,3,6,0.5,2,2,1,2,2,4
7048,Paul Zipser,22-346,G-F,1/29/17,CHI,,PHI,W,0,29,5,8,0.625,2,3,0.667,3,5,0.6,0,0,,0,3,3
7049,Alex Abrines,23-152,G-F,12/31/16,OKC,,LAC,W,0,12,4,5,0.8,0,0,,4,5,0.8,0,0,,0,1,1
7050,Quincy Acy,26-157,F,3/12/17,BRK,,NYK,W,0,19,4,6,0.667,0,2,0,4,4,1,0,0,,0,6,6
7051,Quincy Acy,26-155,F,3/10/17,BRK,@,DAL,L,1,23,5,7,0.714,3,5,0.6,2,2,1,0,0,,0,4,4
7052,Quincy Acy,26-106,F,1/20/17,BRK,@,NOP,W,0,22,3,5,0.6,1,1,1,2,4,0.5,4,4,1,1,7,8
7053,Steven Adams,23-133,C,11/30/16,OKC,,WAS,W,1,28,3,6,0.5,3,6,0.5,0,0,,6,10,0.6,2,4,6
7054,Steven Adams,23-175,C,1/11/17,OKC,,MEM,W,1,39,6,13,0.462,6,13,0.462,0,0,,0,1,0,4,4,8
7055,Steven Adams,23-138,C,12/5/16,OKC,@,ATL,W,1,28,5,10,0.5,5,10,0.5,0,0,,2,5,0.4,6,4,10
7056,Steven Adams,23-154,C,12/21/16,OKC,@,NOP,W,1,23,6,11,0.545,6,11,0.545,0,0,,0,0,,4,0,4
7057,Arron Afflalo,31-022,G,11/6/16,SAC,@,TOR,W,1,36,5,8,0.625,4,7,0.571,1,1,1,1,2,0.5,0,5,5
7058,Alexis Ajinca,28-285,C,2/15/17,NOP,@,MEM,W,1,35,3,6,0.5,3,6,0.5,0,0,,6,8,0.75,2,8,10
7059,LaMarcus Aldridge,31-200,F-C,2/4/17,SAS,,DEN,W,1,28,4,10,0.4,4,10,0.4,0,0,,4,4,1,0,5,5
7060,LaMarcus Aldridge,31-102,F-C,10/29/16,SAS,,NOP,W,1,25,4,13,0.308,3,11,0.273,1,2,0.5,3,4,0.75,1,5,6
7061,LaMarcus Aldridge,31-144,F-C,12/10/16,SAS,,BRK,W,1,22,6,10,0.6,6,10,0.6,0,0,,0,0,,4,5,9
7062,Tony Allen,34-324,G-F,11/30/16,MEM,@,TOR,L,1,29,4,8,0.5,4,7,0.571,0,1,0,4,5,0.8,4,0,4
7063,Tony Allen,34-315,G-F,11/21/16,MEM,@,CHO,W,1,31,5,9,0.556,4,7,0.571,1,2,0.5,1,2,0.5,1,3,4
7064,Al-Farouq Aminu,26-128,F,1/27/17,POR,,MEM,W,0,32,4,9,0.444,2,4,0.5,2,5,0.4,2,2,1,0,4,4
7065,Al-Farouq Aminu,26-044,F,11/4/16,POR,@,DAL,W,1,33,4,13,0.308,1,5,0.2,3,8,0.375,1,2,0.5,3,7,10
7066,Al-Farouq Aminu,26-105,F,1/4/17,POR,@,GSW,L,1,33,4,7,0.571,2,4,0.5,2,3,0.667,2,2,1,1,6,7
7067,Al-Farouq Aminu,26-139,F,2/7/17,POR,@,DAL,W,0,28,4,10,0.4,2,5,0.4,2,5,0.4,2,2,1,2,9,11
7068,Al-Farouq Aminu,26-167,F,3/7/17,POR,@,OKC,W,0,30,5,6,0.833,4,5,0.8,1,1,1,1,2,0.5,1,6,7
7069,Al-Farouq Aminu,26-117,F,1/16/17,POR,@,WAS,L,1,25,5,9,0.556,5,8,0.625,0,1,0,2,2,1,2,3,5
7070,Justin Anderson,23-004,G,11/23/16,DAL,,LAC,L,0,16,4,7,0.571,3,6,0.5,1,1,1,3,3,1,0,5,5
7071,Ryan Anderson,28-254,F,1/15/17,HOU,@,BRK,W,1,23,2,8,0.25,0,5,0,2,3,0.667,6,6,1,3,4,7
7072,Ryan Anderson,28-297,F,2/27/17,HOU,,IND,L,1,23,4,11,0.364,2,4,0.5,2,7,0.286,2,2,1,1,2,3
7073,Ryan Anderson,28-215,F,12/7/16,HOU,,LAL,W,1,25,3,9,0.333,3,6,0.5,0,3,0,6,6,1,2,2,4
7074,Ryan Anderson,28-183,F,11/5/16,HOU,@,ATL,L,1,31,4,13,0.308,0,3,0,4,10,0.4,0,0,,1,2,3
7075,Ryan Anderson,28-244,F,1/5/17,HOU,,OKC,W,1,32,5,11,0.455,3,4,0.75,2,7,0.286,0,0,,2,2,4
7076,Ryan Anderson,28-179,F,11/1/16,HOU,@,CLE,L,1,31,4,12,0.333,0,5,0,4,7,0.571,0,0,,3,1,4
7077,Carmelo Anthony,32-166,F,11/11/16,NYK,@,BOS,L,1,12,5,8,0.625,4,7,0.571,1,1,1,1,1,1,0,2,2
7078,Trevor Ariza,31-204,F,1/20/17,HOU,,GSW,L,1,34,5,12,0.417,3,4,0.75,2,8,0.25,0,0,,0,3,3
7079,Trevor Ariza,31-255,F,3/12/17,HOU,,CLE,W,1,39,3,10,0.3,1,3,0.333,2,7,0.286,4,5,0.8,1,6,7
7080,Trevor Ariza,31-154,F,12/1/16,HOU,@,GSW,W,1,43,5,13,0.385,5,6,0.833,0,7,0,2,2,1,1,3,4
7081,Trevor Ariza,31-197,F,1/13/17,HOU,,MEM,L,1,37,4,11,0.364,3,5,0.6,1,6,0.167,3,4,0.75,4,5,9
7082,Trevor Ariza,31-209,F,1/25/17,HOU,@,BOS,L,1,37,4,11,0.364,0,3,0,4,8,0.5,0,0,,0,2,2
7083,Darrell Arthur,28-284,F,1/3/17,DEN,,SAC,L,0,18,4,6,0.667,0,1,0,4,5,0.8,0,0,,0,3,3
7084,D.J. Augustin,29-013,G,11/23/16,ORL,,PHO,L,0,20,4,9,0.444,2,5,0.4,2,4,0.5,2,3,0.667,0,2,2
7085,D.J. Augustin,29-127,G,3/17/17,ORL,@,PHO,W,0,16,4,8,0.5,3,6,0.5,1,2,0.5,3,4,0.75,0,1,1
7086,D.J. Augustin,29-024,G,12/4/16,ORL,@,DET,W,1,25,5,8,0.625,3,3,1,2,5,0.4,0,0,,0,3,3
7087,D.J. Augustin,29-003,G,11/13/16,ORL,@,OKC,W,0,15,3,5,0.6,2,2,1,1,3,0.333,5,6,0.833,0,1,1
7088,Luke Babbitt,27-249,F,2/24/17,MIA,@,ATL,W,1,14,4,8,0.5,0,2,0,4,6,0.667,0,0,,1,5,6
7089,Luke Babbitt,27-261,F,3/8/17,MIA,,CHO,W,1,18,4,8,0.5,0,0,,4,8,0.5,0,0,,0,4,4
7090,Ron Baker,23-292,G,1/16/17,NYK,,ATL,L,1,22,4,9,0.444,0,2,0,4,7,0.571,0,0,,1,2,3
7091,Leandro Barbosa,34-099,G,3/7/17,PHO,,WAS,L,0,23,3,9,0.333,1,3,0.333,2,6,0.333,4,4,1,0,2,2
7092,Leandro Barbosa,34-075,G,2/11/17,PHO,@,HOU,L,0,20,4,11,0.364,3,8,0.375,1,3,0.333,3,4,0.75,0,3,3
7093,Leandro Barbosa,33-354,G,11/16/16,PHO,@,DEN,L,0,18,6,8,0.75,6,8,0.75,0,0,,0,0,,0,1,1
7094,Leandro Barbosa,34-033,G,12/31/16,PHO,@,UTA,L,0,13,5,8,0.625,5,8,0.625,0,0,,2,2,1,1,4,5
7095,J.J. Barea,32-205,G,1/17/17,DAL,@,CHI,W,0,18,5,8,0.625,3,4,0.75,2,4,0.5,0,0,,0,1,1
7096,Harrison Barnes,24-252,F,2/6/17,DAL,@,DEN,L,1,34,6,11,0.545,6,9,0.667,0,2,0,0,0,,0,4,4
7097,Harrison Barnes,24-179,F,11/25/16,DAL,@,CLE,L,1,30,6,13,0.462,6,10,0.6,0,3,0,0,0,,3,2,5
7098,Matt Barnes,36-340,F,2/12/17,SAC,,NOP,W,0,34,5,9,0.556,3,3,1,2,6,0.333,0,0,,1,4,5
7099,Matt Barnes,36-268,F,12/2/16,SAC,@,BOS,L,0,31,3,11,0.273,2,7,0.286,1,4,0.25,5,6,0.833,3,13,16
7100,Matt Barnes,36-234,F,10/29/16,SAC,,MIN,W,0,27,4,10,0.4,1,4,0.25,3,6,0.5,1,2,0.5,0,5,5
7101,Matt Barnes,36-301,F,1/4/17,SAC,,MIA,L,1,33,5,9,0.556,3,5,0.6,2,4,0.5,0,0,,1,6,7
7102,Matt Barnes,36-261,F,11/25/16,SAC,,HOU,L,1,33,5,10,0.5,3,3,1,2,7,0.286,0,0,,0,3,3
7103,Will Barton,25-352,G,12/23/16,DEN,,ATL,L,0,34,4,9,0.444,3,6,0.5,1,3,0.333,3,5,0.6,0,4,4
7104,Will Barton,26-036,G,2/11/17,DEN,@,CLE,L,0,23,3,11,0.273,1,7,0.143,2,4,0.5,4,4,1,1,2,3
7105,Brandon Bass,31-253,F,1/8/17,LAC,,MIA,W,0,20,5,9,0.556,5,9,0.556,0,0,,2,2,1,2,2,4
7106,Nicolas Batum,27-320,F-G,10/29/16,CHO,,BOS,L,1,33,3,10,0.3,2,5,0.4,1,5,0.2,5,6,0.833,0,4,4
7107,Nicolas Batum,27-319,F-G,10/28/16,CHO,@,MIA,W,1,31,4,14,0.286,2,7,0.286,2,7,0.286,2,2,1,2,4,6
7108,Nicolas Batum,28-078,F-G,3/2/17,CHO,@,PHO,L,1,35,3,15,0.2,1,6,0.167,2,9,0.222,4,4,1,0,3,3
7109,Nicolas Batum,27-353,F-G,12/1/16,CHO,,DAL,W,1,36,4,12,0.333,3,7,0.429,1,5,0.2,3,4,0.75,0,9,9
7110,Aron Baynes,30-087,C,3/6/17,DET,,CHI,W,0,18,6,9,0.667,6,9,0.667,0,0,,0,0,,3,4,7
7111,Aron Baynes,30-040,C,1/18/17,DET,,ATL,W,0,22,3,5,0.6,3,5,0.6,0,0,,6,8,0.75,2,2,4
7112,Aron Baynes,30-096,C,3/15/17,DET,,UTA,L,0,23,6,11,0.545,6,11,0.545,0,0,,0,0,,6,6,12
7113,Aron Baynes,30-059,C,2/6/17,DET,,PHI,W,0,22,5,8,0.625,5,8,0.625,0,0,,2,2,1,4,3,7
7114,Kent Bazemore,27-224,G-F,2/10/17,ATL,@,SAC,L,1,33,5,11,0.455,4,7,0.571,1,4,0.25,1,2,0.5,0,6,6
7115,Kent Bazemore,27-138,G-F,11/16/16,ATL,,MIL,W,1,30,4,10,0.4,1,5,0.2,3,5,0.6,1,2,0.5,1,4,5
7116,Kent Bazemore,27-260,G-F,3/18/17,ATL,,POR,L,1,32,5,12,0.417,5,8,0.625,0,4,0,2,2,1,0,0,0
7117,Kent Bazemore,27-137,G-F,11/15/16,ATL,@,MIA,W,1,31,4,12,0.333,3,10,0.3,1,2,0.5,3,4,0.75,0,3,3
7118,Kent Bazemore,27-171,G-F,12/19/16,ATL,@,OKC,W,1,40,4,9,0.444,4,7,0.571,0,2,0,4,9,0.444,0,5,5
7119,Kent Bazemore,27-142,G-F,11/20/16,ATL,@,NYK,L,1,30,4,11,0.364,4,8,0.5,0,3,0,4,4,1,0,3,3
7120,Kent Bazemore,27-196,G-F,1/13/17,ATL,,BOS,L,1,29,4,11,0.364,2,5,0.4,2,6,0.333,2,2,1,0,3,3
7121,Bradley Beal,23-221,G,2/4/17,WAS,,NOP,W,1,37,5,12,0.417,3,6,0.5,2,6,0.333,0,0,,0,5,5
7122,Bradley Beal,23-204,G,1/18/17,WAS,,MEM,W,1,37,4,14,0.286,3,7,0.429,1,7,0.143,3,4,0.75,0,1,1
7123,Bradley Beal,23-183,G,12/28/16,WAS,,IND,W,1,18,5,9,0.556,4,6,0.667,1,3,0.333,1,4,0.25,0,1,1
7124,Malik Beasley,19-350,G,11/10/16,DEN,,GSW,L,0,15,5,10,0.5,3,5,0.6,2,5,0.4,0,0,,0,2,2
7125,Michael Beasley,27-297,F,11/1/16,MIL,@,NOP,W,0,13,5,9,0.556,5,8,0.625,0,1,0,2,2,1,0,1,1
7126,Michael Beasley,27-333,F,12/7/16,MIL,,POR,W,0,22,5,7,0.714,4,6,0.667,1,1,1,1,2,0.5,0,8,8
7127,Michael Beasley,27-356,F,12/30/16,MIL,@,MIN,L,0,20,5,10,0.5,5,9,0.556,0,1,0,2,2,1,0,5,5
7128,Marco Belinelli,30-235,G-F,11/15/16,CHO,@,MIN,W,0,27,5,8,0.625,3,6,0.5,2,2,1,0,0,,0,1,1
7129,Marco Belinelli,30-217,G-F,10/28/16,CHO,@,MIA,W,0,28,4,9,0.444,2,6,0.333,2,3,0.667,2,2,1,0,1,1
7130,Marco Belinelli,30-227,G-F,11/7/16,CHO,,IND,W,0,27,3,8,0.375,1,4,0.25,2,4,0.5,4,4,1,1,2,3
7131,Marco Belinelli,30-243,G-F,11/23/16,CHO,,SAS,L,0,21,5,11,0.455,4,6,0.667,1,5,0.2,1,2,0.5,1,3,4
7132,Marco Belinelli,30-351,G-F,3/11/17,CHO,,NOP,L,0,23,4,9,0.444,3,5,0.6,1,4,0.25,3,3,1,0,1,1
7133,Anthony Bennett,23-249,F,11/18/16,BRK,@,OKC,L,0,21,4,8,0.5,2,4,0.5,2,4,0.5,2,2,1,0,3,3
7134,Davis Bertans,24-082,F,2/2/17,SAS,,PHI,W,1,30,5,14,0.357,3,6,0.5,2,8,0.25,0,0,,2,4,6
7135,Davis Bertans,24-073,F,1/24/17,SAS,@,TOR,W,0,15,4,6,0.667,2,2,1,2,4,0.5,2,2,1,0,1,1
7136,Patrick Beverley,28-190,G,1/18/17,HOU,,MIL,W,1,34,5,10,0.5,3,6,0.5,2,4,0.5,0,0,,2,7,9
7137,Patrick Beverley,28-189,G,1/17/17,HOU,@,MIA,L,1,33,5,9,0.556,5,6,0.833,0,3,0,2,2,1,0,7,7
7138,Patrick Beverley,28-235,G,3/4/17,HOU,,MEM,W,1,32,3,5,0.6,1,2,0.5,2,3,0.667,4,4,1,2,3,5
7139,Bismack Biyombo,24-147,C-F,1/22/17,ORL,,GSW,L,0,24,5,8,0.625,5,8,0.625,0,0,,2,7,0.286,4,9,13
7140,Bismack Biyombo,24-104,C-F,12/10/16,ORL,,DEN,L,1,34,5,9,0.556,5,9,0.556,0,0,,2,6,0.333,3,3,6
7141,Nemanja Bjelica,28-299,F,3/4/17,MIN,@,SAS,L,0,21,5,12,0.417,3,6,0.5,2,6,0.333,0,0,,1,2,3
7142,Nemanja Bjelica,28-208,F,12/3/16,MIN,@,CHO,W,0,19,5,7,0.714,3,4,0.75,2,3,0.667,0,0,,0,2,2
7143,Tarik Black,24-359,C-F,11/15/16,LAL,,BRK,W,0,13,4,6,0.667,4,6,0.667,0,0,,4,5,0.8,5,4,9
7144,Eric Bledsoe,26-327,G,10/31/16,PHO,@,LAC,L,1,32,5,14,0.357,5,13,0.385,0,1,0,2,4,0.5,1,7,8
7145,Eric Bledsoe,26-357,G,11/30/16,PHO,,ATL,W,1,28,5,17,0.294,5,14,0.357,0,3,0,2,2,1,2,4,6
7146,Eric Bledsoe,27-008,G,12/17/16,PHO,@,OKC,L,1,31,4,13,0.308,3,7,0.429,1,6,0.167,3,3,1,0,3,3
7147,Eric Bledsoe,27-092,G,3/11/17,PHO,@,DAL,W,1,31,4,16,0.25,3,11,0.273,1,5,0.2,3,3,1,0,2,2
7148,Bojan Bogdanovic,27-334,G-F,3/18/17,WAS,@,CHO,L,0,23,4,9,0.444,2,4,0.5,2,5,0.4,2,2,1,0,3,3
7149,Bojan Bogdanovic,27-333,G-F,3/17/17,WAS,,CHI,W,0,25,5,12,0.417,3,6,0.5,2,6,0.333,0,0,,2,1,3
7150,Bojan Bogdanovic,27-248,G-F,12/22/16,BRK,,GSW,L,1,26,5,10,0.5,3,5,0.6,2,5,0.4,0,0,,1,2,3
7151,Bojan Bogdanovic,27-265,G-F,1/8/17,BRK,,PHI,L,1,35,5,14,0.357,3,8,0.375,2,6,0.333,0,0,,1,7,8
7152,Bojan Bogdanovic,27-329,G-F,3/13/17,WAS,@,MIN,L,0,25,3,11,0.273,2,5,0.4,1,6,0.167,5,5,1,0,3,3
7153,Bojan Bogdanovic,27-256,G-F,12/30/16,BRK,@,WAS,L,1,21,4,10,0.4,2,6,0.333,2,4,0.5,2,2,1,1,2,3
7154,Devin Booker,20-044,G,12/13/16,PHO,,NYK,W,1,36,3,16,0.188,2,11,0.182,1,5,0.2,5,5,1,0,1,1
7155,Trevor Booker,29-092,F,2/25/17,BRK,@,GSW,L,0,27,6,9,0.667,6,9,0.667,0,0,,0,0,,3,7,10
7156,Trevor Booker,29-068,F,2/1/17,BRK,,NYK,L,0,16,6,11,0.545,6,9,0.667,0,2,0,0,0,,2,6,8
7157,Trevor Booker,29-103,F,3/8/17,BRK,@,ATL,L,0,27,5,8,0.625,5,7,0.714,0,1,0,2,2,1,1,7,8
7158,Trevor Booker,28-345,F,11/4/16,BRK,,CHO,L,1,28,5,9,0.556,5,8,0.625,0,1,0,2,2,1,4,9,13
7159,Avery Bradley,26-020,G,12/16/16,BOS,,CHO,W,1,31,5,14,0.357,3,8,0.375,2,6,0.333,0,0,,1,6,7
7160,Avery Bradley,26-102,G,3/8/17,BOS,@,GSW,W,1,30,6,15,0.4,6,12,0.5,0,3,0,0,0,,3,3,6
7161,Malcolm Brogdon,23-337,G,11/12/16,MIL,,MEM,W,0,22,5,9,0.556,3,6,0.5,2,3,0.667,0,0,,1,0,1
7162,Malcolm Brogdon,24-022,G,1/2/17,MIL,,OKC,W,1,32,3,12,0.25,2,8,0.25,1,4,0.25,5,5,1,0,2,2
7163,Malcolm Brogdon,23-352,G,11/27/16,MIL,@,ORL,W,0,20,5,10,0.5,3,7,0.429,2,3,0.667,0,0,,2,1,3
7164,Malcolm Brogdon,24-035,G,1/15/17,MIL,@,ATL,L,1,26,5,10,0.5,3,7,0.429,2,3,0.667,0,0,,0,0,0
7165,Malcolm Brogdon,23-364,G,12/9/16,MIL,,ATL,L,0,28,5,10,0.5,3,7,0.429,2,3,0.667,0,0,,0,2,2
7166,Malcolm Brogdon,23-328,G,11/3/16,MIL,,IND,W,0,24,3,5,0.6,1,2,0.5,2,3,0.667,4,4,1,0,2,2
7167,Malcolm Brogdon,24-082,G,3/3/17,MIL,,LAC,W,1,24,4,8,0.5,0,3,0,4,5,0.8,0,0,,0,3,3
7168,Malcolm Brogdon,24-024,G,1/4/17,MIL,@,NYK,W,1,38,5,14,0.357,5,11,0.455,0,3,0,2,2,1,1,5,6
7169,Jaylen Brown,20-086,F,1/18/17,BOS,,NYK,L,0,19,3,6,0.5,3,6,0.5,0,0,,6,7,0.857,1,3,4
7170,Jaylen Brown,20-102,F,2/3/17,BOS,,LAL,W,1,32,3,7,0.429,2,5,0.4,1,2,0.5,5,6,0.833,1,6,7
7171,Alec Burks,25-204,G,2/9/17,UTA,@,DAL,L,0,22,5,11,0.455,4,8,0.5,1,3,0.333,1,1,1,0,3,3
7172,Jose Calderon,35-055,G,11/22/16,LAL,,OKC,W,1,23,4,5,0.8,0,0,,4,5,0.8,0,0,,0,6,6
7173,Kentavious Caldwell-Pope,23-316,G,12/30/16,DET,@,ATL,L,1,39,3,11,0.273,1,3,0.333,2,8,0.25,4,4,1,0,4,4
7174,Kentavious Caldwell-Pope,23-292,G,12/6/16,DET,,CHI,W,1,31,5,10,0.5,4,5,0.8,1,5,0.2,1,2,0.5,1,2,3
7175,Kentavious Caldwell-Pope,23-354,G,2/6/17,DET,,PHI,W,1,29,4,11,0.364,2,5,0.4,2,6,0.333,2,2,1,1,3,4
7176,Clint Capela,22-178,F-C,11/12/16,HOU,,SAS,L,1,25,5,9,0.556,5,9,0.556,0,0,,2,2,1,4,6,10
7177,Clint Capela,22-292,F-C,3/6/17,HOU,@,SAS,L,1,25,6,11,0.545,6,11,0.545,0,0,,0,0,,2,6,8
7178,Clint Capela,22-306,F-C,3/20/17,HOU,,DEN,W,1,27,6,8,0.75,6,8,0.75,0,0,,0,0,,2,7,9
7179,Clint Capela,22-175,F-C,11/9/16,HOU,@,SAS,W,1,18,5,8,0.625,5,8,0.625,0,0,,2,4,0.5,2,3,5
7180,Clint Capela,22-189,F-C,11/23/16,HOU,,TOR,L,1,31,6,7,0.857,6,7,0.857,0,0,,0,0,,3,3,6
7181,Clint Capela,22-171,F-C,11/5/16,HOU,@,ATL,L,1,21,6,7,0.857,6,7,0.857,0,0,,0,0,,1,9,10
7182,Clint Capela,22-203,F-C,12/7/16,HOU,,LAL,W,1,20,6,10,0.6,6,10,0.6,0,0,,0,0,,1,8,9
7183,Clint Capela,22-258,F-C,1/31/17,HOU,,SAC,W,1,20,5,8,0.625,5,8,0.625,0,0,,2,5,0.4,4,7,11
7184,Clint Capela,22-273,F-C,2/15/17,HOU,,MIA,L,1,16,5,7,0.714,5,7,0.714,0,0,,2,3,0.667,0,2,2
7185,Clint Capela,22-252,F-C,1/25/17,HOU,@,BOS,L,1,20,5,10,0.5,5,10,0.5,0,0,,2,7,0.286,2,5,7
7186,DeMarre Carroll,30-235,F,3/19/17,TOR,,IND,W,1,18,4,7,0.571,0,2,0,4,5,0.8,0,0,,1,5,6
7187,DeMarre Carroll,30-233,F,3/17/17,TOR,@,DET,W,1,24,4,9,0.444,3,5,0.6,1,4,0.25,3,4,0.75,1,0,1
7188,Vince Carter,39-343,G-F,1/3/17,MEM,@,LAL,L,0,21,3,7,0.429,1,3,0.333,2,4,0.5,4,4,1,1,1,2
7189,Vince Carter,39-358,G-F,1/18/17,MEM,@,WAS,L,0,30,4,9,0.444,1,3,0.333,3,6,0.5,1,2,0.5,0,2,2
7190,Vince Carter,39-295,G-F,11/16/16,MEM,@,LAC,W,0,27,5,10,0.5,3,6,0.5,2,4,0.5,0,0,,0,3,3
7191,Michael Carter-Williams,25-125,G,2/12/17,CHI,@,MIN,L,1,30,4,12,0.333,3,11,0.273,1,1,1,3,5,0.6,0,7,7
7192,Michael Carter-Williams,25-081,G,12/30/16,CHI,@,IND,L,0,27,4,10,0.4,3,7,0.429,1,3,0.333,3,3,1,4,4,8
7193,Omri Casspi,28-246,F,2/23/17,NOP,,HOU,L,0,24,5,9,0.556,3,5,0.6,2,4,0.5,0,0,,1,1,2
7194,Omri Casspi,28-171,F,12/10/16,SAC,@,UTA,L,0,27,5,9,0.556,3,6,0.5,2,3,0.667,0,0,,2,3,5
7195,Omri Casspi,28-170,F,12/9/16,SAC,,NYK,L,0,20,4,5,0.8,3,4,0.75,1,1,1,3,3,1,0,3,3
7196,Omri Casspi,28-134,F,11/3/16,SAC,@,ORL,L,0,23,5,13,0.385,3,9,0.333,2,4,0.5,0,0,,3,2,5
7197,Willie Cauley-Stein,23-158,F-C,1/23/17,SAC,@,DET,W,0,21,5,8,0.625,5,8,0.625,0,0,,2,2,1,3,2,5
7198,Tyson Chandler,34-033,C,11/4/16,PHO,@,NOP,W,1,36,5,8,0.625,5,8,0.625,0,0,,2,2,1,3,15,18
7199,Tyson Chandler,34-092,C,1/2/17,PHO,@,LAC,L,1,23,3,3,1,3,3,1,0,0,,6,6,1,2,4,6
7200,Wilson Chandler,29-169,F,10/26/16,DEN,@,NOP,W,0,30,5,15,0.333,4,9,0.444,1,6,0.167,1,1,1,0,7,7
7201,Wilson Chandler,29-221,F,12/17/16,DEN,,NYK,W,1,27,5,14,0.357,3,7,0.429,2,7,0.286,0,0,,1,0,1
7202,Marquese Chriss,19-177,F,12/26/16,PHO,@,HOU,L,1,19,5,9,0.556,4,5,0.8,1,4,0.25,1,2,0.5,3,2,5
7203,Marquese Chriss,19-190,F,1/8/17,PHO,,CLE,L,1,33,4,11,0.364,3,9,0.333,1,2,0.5,3,4,0.75,1,2,3
7204,Ian Clark,25-301,G,1/2/17,GSW,,DEN,W,0,16,4,5,0.8,2,3,0.667,2,2,1,2,2,1,0,1,1
7205,Ian Clark,26-009,G,3/16/17,GSW,,ORL,W,0,20,5,8,0.625,3,5,0.6,2,3,0.667,0,0,,0,2,2
7206,Jordan Clarkson,24-227,G,1/20/17,LAL,,IND,W,0,33,5,12,0.417,4,8,0.5,1,4,0.25,1,1,1,1,4,5
7207,Jordan Clarkson,24-246,G,2/8/17,LAL,@,DET,L,0,22,3,10,0.3,3,7,0.429,0,3,0,6,7,0.857,0,1,1
7208,Jordan Clarkson,24-244,G,2/6/17,LAL,@,NYK,W,0,29,5,13,0.385,5,11,0.455,0,2,0,2,2,1,1,6,7
7209,Jordan Clarkson,24-190,G,12/14/16,LAL,@,BRK,L,0,19,6,12,0.5,6,10,0.6,0,2,0,0,0,,1,3,4
7210,Jordan Clarkson,24-203,G,12/27/16,LAL,,UTA,L,0,26,6,10,0.6,6,9,0.667,0,1,0,0,0,,3,2,5
7211,Jordan Clarkson,24-145,G,10/30/16,LAL,@,OKC,L,0,29,6,14,0.429,6,11,0.545,0,3,0,0,0,,2,3,5
7212,Darren Collison,29-153,G,1/23/17,SAC,@,DET,W,1,26,4,5,0.8,2,3,0.667,2,2,1,2,2,1,0,4,4
7213,Mike Conley,29-118,G,2/6/17,MEM,,SAS,W,1,35,3,10,0.3,2,8,0.25,1,2,0.5,5,5,1,0,2,2
7214,DeMarcus Cousins,26-196,C-F,2/25/17,NOP,@,DAL,L,1,32,3,8,0.375,1,4,0.25,2,4,0.5,4,8,0.5,3,12,15
7215,Robert Covington,25-329,F,11/7/16,PHI,,UTA,L,1,29,4,5,0.8,1,1,1,3,4,0.75,1,2,0.5,0,8,8
7216,Allen Crabbe,24-203,G-F,10/29/16,POR,@,DEN,W,0,29,4,10,0.4,3,6,0.5,1,4,0.25,3,3,1,0,3,3
7217,Allen Crabbe,24-291,G-F,1/25/17,POR,,LAL,W,0,28,6,9,0.667,6,8,0.75,0,1,0,0,0,,0,3,3
7218,Allen Crabbe,24-306,G-F,2/9/17,POR,,BOS,L,0,30,5,8,0.625,3,5,0.6,2,3,0.667,0,0,,0,3,3
7219,Jamal Crawford,36-246,G,11/21/16,LAC,,TOR,W,0,27,5,11,0.455,4,6,0.667,1,5,0.2,1,1,1,0,0,0
7220,Jamal Crawford,36-256,G,12/1/16,LAC,@,CLE,W,0,21,4,9,0.444,2,4,0.5,2,5,0.4,2,4,0.5,0,0,0
7221,Jamal Crawford,36-224,G,10/30/16,LAC,,UTA,W,0,21,4,9,0.444,4,6,0.667,0,3,0,4,4,1,0,1,1
7222,Jamal Crawford,36-252,G,11/27/16,LAC,@,IND,L,0,34,5,12,0.417,3,8,0.375,2,4,0.5,0,0,,0,0,0
7223,Jae Crowder,26-152,F,12/5/16,BOS,@,HOU,L,1,36,4,9,0.444,2,4,0.5,2,5,0.4,2,2,1,0,3,3
7224,Jae Crowder,26-163,F,12/16/16,BOS,,CHO,W,1,35,3,7,0.429,1,2,0.5,2,5,0.4,4,4,1,0,5,5
7225,Dante Cunningham,29-294,F,2/10/17,NOP,@,MIN,W,1,38,4,8,0.5,1,3,0.333,3,5,0.6,1,2,0.5,0,4,4
7226,Seth Curry,26-142,G,1/12/17,DAL,@,PHO,W,1,24,4,5,0.8,1,1,1,3,4,0.75,1,1,1,0,4,4
7227,Seth Curry,26-120,G,12/21/16,DAL,@,POR,W,0,24,4,10,0.4,0,2,0,4,8,0.5,0,0,,0,0,0
7228,Troy Daniels,25-175,G,1/6/17,MEM,@,GSW,W,0,21,4,8,0.5,0,1,0,4,7,0.571,0,0,,0,1,1
7229,Troy Daniels,25-249,G,3/21/17,MEM,@,NOP,L,0,24,4,8,0.5,0,0,,4,8,0.5,0,0,,0,2,2
7230,Anthony Davis,23-282,F-C,12/18/16,NOP,@,SAS,L,1,30,5,12,0.417,5,12,0.417,0,0,,2,4,0.5,2,2,4
7231,Anthony Davis,23-334,F-C,2/8/17,NOP,,UTA,L,1,30,4,12,0.333,4,12,0.333,0,0,,4,5,0.8,3,6,9
7232,Dewayne Dedmon,27-076,C,10/27/16,SAS,@,SAC,W,0,24,5,6,0.833,5,6,0.833,0,0,,2,2,1,4,3,7
7233,Sam Dekker,22-234,F,12/26/16,HOU,,PHO,W,0,25,5,10,0.5,3,6,0.5,2,4,0.5,0,0,,2,2,4
7234,Sam Dekker,22-199,F,11/21/16,HOU,@,DET,W,0,25,5,8,0.625,3,6,0.5,2,2,1,0,0,,0,4,4
7235,Sam Dekker,22-215,F,12/7/16,HOU,,LAL,W,0,23,6,10,0.6,6,7,0.857,0,3,0,0,0,,5,3,8
7236,Malcolm Delaney,27-305,G,1/10/17,ATL,@,BRK,W,0,16,5,6,0.833,4,4,1,1,2,0.5,1,3,0.333,0,1,1
7237,Malcolm Delaney,27-330,G,2/4/17,ATL,,ORL,W,0,21,5,8,0.625,3,4,0.75,2,4,0.5,0,0,,0,1,1
7238,Matthew Dellavedova,26-188,G,3/15/17,MIL,@,LAC,W,0,32,4,8,0.5,1,5,0.2,3,3,1,1,1,1,0,2,2
7239,Luol Deng,31-195,F,10/28/16,LAL,@,UTA,L,1,34,5,12,0.417,3,7,0.429,2,5,0.4,0,0,,2,10,12
7240,DeMar DeRozan,27-105,G,11/20/16,TOR,@,SAC,L,1,39,3,15,0.2,3,14,0.214,0,1,0,6,6,1,3,6,9
7241,Boris Diaw,34-233,F-C,12/5/16,UTA,@,LAL,W,1,26,5,5,1,3,3,1,2,2,1,0,0,,0,2,2
7242,Boris Diaw,34-275,F-C,1/16/17,UTA,@,PHO,W,0,22,6,10,0.6,6,8,0.75,0,2,0,0,0,,2,1,3
7243,Gorgui Dieng,26-349,C,1/1/17,MIN,,POR,L,1,38,5,13,0.385,5,13,0.385,0,0,,2,2,1,2,7,9
7244,Gorgui Dieng,26-282,C,10/26/16,MIN,@,MEM,L,1,34,5,10,0.5,5,9,0.556,0,1,0,2,2,1,5,9,14
7245,Gorgui Dieng,27-051,C,3/10/17,MIN,,GSW,W,1,24,5,10,0.5,5,10,0.5,0,0,,2,2,1,0,4,4
7246,Gorgui Dieng,27-027,C,2/14/17,MIN,,CLE,L,1,38,4,9,0.444,3,7,0.429,1,2,0.5,3,3,1,2,8,10
7247,Gorgui Dieng,27-010,C,1/28/17,MIN,,BRK,W,1,34,4,9,0.444,4,9,0.444,0,0,,4,4,1,1,9,10
7248,Gorgui Dieng,26-296,C,11/9/16,MIN,@,ORL,W,1,35,6,9,0.667,6,9,0.667,0,0,,0,0,,3,8,11
7249,Gorgui Dieng,26-357,C,1/9/17,MIN,,DAL,W,1,25,5,8,0.625,5,8,0.625,0,0,,2,4,0.5,2,3,5
7250,Gorgui Dieng,26-338,C,12/21/16,MIN,@,ATL,W,1,40,5,10,0.5,5,9,0.556,0,1,0,2,2,1,2,7,9
7251,Gorgui Dieng,26-304,C,11/17/16,MIN,,PHI,W,1,29,4,11,0.364,4,11,0.364,0,0,,4,4,1,3,7,10
7252,Toney Douglas,30-353,G,3/4/17,MEM,@,HOU,L,0,29,4,13,0.308,3,9,0.333,1,4,0.25,3,5,0.6,5,0,5
7253,Andre Drummond,23-184,C,2/10/17,DET,,SAS,L,1,37,5,17,0.294,5,17,0.294,0,0,,2,5,0.4,6,9,15
7254,Andre Drummond,23-079,C,10/28/16,DET,,ORL,W,1,28,5,14,0.357,5,14,0.357,0,0,,2,2,1,4,16,20
7255,Andre Drummond,23-177,C,2/3/17,DET,,MIN,W,1,29,6,14,0.429,6,14,0.429,0,0,,0,0,,6,12,18
7256,Andre Drummond,23-197,C,2/23/17,DET,,CHO,W,1,26,6,10,0.6,6,10,0.6,0,0,,0,0,,4,9,13
7257,Andre Drummond,23-155,C,1/12/17,DET,@,GSW,L,1,27,5,6,0.833,5,6,0.833,0,0,,2,4,0.5,2,8,10
7258,Jared Dudley,31-154,F-G,12/11/16,PHO,,NOP,L,0,19,4,6,0.667,0,1,0,4,5,0.8,0,0,,2,1,3
7259,Jared Dudley,31-216,F-G,2/11/17,PHO,@,HOU,L,0,26,4,5,0.8,2,3,0.667,2,2,1,2,2,1,0,6,6
7260,Jared Dudley,31-162,F-G,12/19/16,PHO,@,MIN,L,0,22,4,6,0.667,2,2,1,2,4,0.5,2,3,0.667,0,1,1
7261,Mike Dunleavy,36-136,F-G,1/29/17,ATL,,NYK,W,0,22,5,6,0.833,3,3,1,2,3,0.667,0,0,,0,3,3
7262,Wayne Ellington,29-035,G,12/3/16,MIA,@,POR,L,1,39,5,13,0.385,4,5,0.8,1,8,0.125,1,2,0.5,0,2,2
7263,Wayne Ellington,29-126,G,3/4/17,MIA,,CLE,W,0,24,4,9,0.444,0,2,0,4,7,0.571,0,0,,1,3,4
7264,Wayne Ellington,29-066,G,1/3/17,MIA,@,PHO,L,0,37,4,12,0.333,3,6,0.5,1,6,0.167,3,3,1,0,1,1
7265,Wayne Ellington,29-061,G,12/29/16,MIA,@,CHO,L,0,17,4,10,0.4,0,1,0,4,9,0.444,0,0,,0,2,2
7266,Monta Ellis,31-135,G,3/10/17,IND,@,MIL,L,0,28,4,7,0.571,4,5,0.8,0,2,0,4,6,0.667,1,1,2
7267,Monta Ellis,31-133,G,3/8/17,IND,,DET,W,0,22,5,9,0.556,3,7,0.429,2,2,1,0,0,,0,0,0
7268,Monta Ellis,31-078,G,1/12/17,IND,@,DEN,L,0,27,4,9,0.444,4,6,0.667,0,3,0,4,4,1,1,1,2
7269,Monta Ellis,31-131,G,3/6/17,IND,@,CHO,L,0,26,5,10,0.5,4,8,0.5,1,2,0.5,1,1,1,0,2,2
7270,Monta Ellis,31-145,G,3/20/17,IND,,UTA,W,0,25,5,11,0.455,4,8,0.5,1,3,0.333,1,2,0.5,0,2,2
7271,Monta Ellis,31-025,G,11/20/16,IND,@,OKC,W,1,42,5,10,0.5,4,8,0.5,1,2,0.5,1,1,1,0,4,4
7272,Monta Ellis,31-124,G,2/27/17,IND,@,HOU,W,0,32,6,8,0.75,6,7,0.857,0,1,0,0,0,,2,6,8
7273,Joel Embiid,22-252,C-F,11/23/16,PHI,,MEM,L,1,27,4,10,0.4,3,6,0.5,1,4,0.25,3,4,0.75,1,10,11
7274,James Ennis,26-196,F,1/13/17,MEM,@,HOU,W,0,28,4,7,0.571,3,5,0.6,1,2,0.5,3,4,0.75,3,3,6
7275,Tyreke Evans,27-112,G-F,1/9/17,NOP,@,NYK,W,0,21,5,9,0.556,3,4,0.75,2,5,0.4,0,0,,0,2,2
7276,Tyreke Evans,27-168,G-F,3/6/17,SAC,@,DEN,L,0,21,5,11,0.455,3,7,0.429,2,4,0.5,0,0,,1,5,6
7277,Tyreke Evans,27-100,G-F,12/28/16,NOP,,LAC,W,0,16,5,9,0.556,3,5,0.6,2,4,0.5,0,0,,1,4,5
7278,Tyreke Evans,27-119,G-F,1/16/17,NOP,@,IND,L,0,23,5,13,0.385,5,12,0.417,0,1,0,2,2,1,0,5,5
7279,Dante Exum,21-226,G,2/24/17,UTA,@,MIL,W,0,16,3,5,0.6,2,2,1,1,3,0.333,5,5,1,1,2,3
7280,Dante Exum,21-217,G,2/15/17,UTA,,POR,W,0,20,6,9,0.667,6,9,0.667,0,0,,0,0,,0,2,2
7281,Kenneth Faried,27-006,F,11/25/16,DEN,,OKC,L,1,24,6,8,0.75,6,8,0.75,0,0,,0,0,,3,5,8
7282,Kenneth Faried,26-353,F,11/6/16,DEN,@,BOS,W,0,24,2,4,0.5,2,4,0.5,0,0,,8,12,0.667,5,6,11
7283,Kenneth Faried,27-117,F,3/16/17,DEN,,LAC,W,0,18,5,9,0.556,5,9,0.556,0,0,,2,3,0.667,2,4,6
7284,Derrick Favors,25-179,F-C,1/10/17,UTA,,CLE,W,1,25,5,10,0.5,5,10,0.5,0,0,,2,4,0.5,1,4,5
7285,Derrick Favors,25-172,F-C,1/3/17,UTA,@,BOS,L,1,29,5,10,0.5,5,10,0.5,0,0,,2,2,1,2,4,6
7286,Derrick Favors,25-208,F-C,2/8/17,UTA,@,NOP,W,1,25,5,7,0.714,5,6,0.833,0,1,0,2,2,1,2,5,7
7287,Kay Felder,21-279,G,1/2/17,CLE,,NOP,W,0,22,6,11,0.545,6,11,0.545,0,0,,0,0,,0,1,1
7288,Cristiano Felicio,24-201,F-C,1/24/17,CHI,@,ORL,W,0,21,4,6,0.667,4,6,0.667,0,0,,4,6,0.667,1,9,10
7289,Cristiano Felicio,24-176,F-C,12/30/16,CHI,@,IND,L,0,22,4,5,0.8,4,5,0.8,0,0,,4,5,0.8,6,6,12
7290,Raymond Felton,32-159,G,12/2/16,LAC,@,NOP,W,1,26,5,10,0.5,3,7,0.429,2,3,0.667,0,0,,0,2,2
7291,Raymond Felton,32-248,G,3/1/17,LAC,,HOU,L,0,19,5,8,0.625,5,7,0.714,0,1,0,2,3,0.667,1,4,5
7292,Yogi Ferrell,23-316,G,3/21/17,DAL,,GSW,L,1,27,4,10,0.4,0,4,0,4,6,0.667,0,0,,1,0,1
7293,Yogi Ferrell,23-274,G,2/7/17,DAL,,POR,L,1,35,4,9,0.444,3,5,0.6,1,4,0.25,3,3,1,0,2,2
7294,Dorian Finney-Smith,23-239,F,12/29/16,DAL,@,LAL,W,1,32,4,8,0.5,1,1,1,3,7,0.429,1,2,0.5,1,2,3
7295,Dorian Finney-Smith,23-219,F,12/9/16,DAL,,IND,W,1,33,5,8,0.625,3,4,0.75,2,4,0.5,0,0,,1,7,8
7296,Dorian Finney-Smith,23-297,F,2/25/17,DAL,,NOP,W,0,24,5,6,0.833,3,3,1,2,3,0.667,0,0,,0,2,2
7297,Evan Fournier,24-138,G-F,3/16/17,ORL,@,GSW,L,1,24,3,9,0.333,0,2,0,3,7,0.429,3,4,0.75,0,1,1
7298,Evan Fournier,24-095,G-F,2/1/17,ORL,,IND,L,1,30,3,8,0.375,1,3,0.333,2,5,0.4,4,4,1,0,1,1
7299,Tim Frazier,26-017,G,11/18/16,NOP,,POR,W,1,32,5,11,0.455,4,8,0.5,1,3,0.333,1,1,1,0,3,3
7300,Channing Frye,33-220,C-F,12/23/16,CLE,,BRK,W,0,22,5,9,0.556,4,4,1,1,5,0.2,1,1,1,0,6,6
7301,Channing Frye,33-220,C-F,12/23/16,CLE,,BRK,W,0,22,5,9,0.556,4,4,1,1,5,0.2,1,1,1,0,6,6
7302,Channing Frye,33-172,C-F,11/5/16,CLE,@,PHI,W,0,18,4,9,0.444,0,1,0,4,8,0.5,0,0,,0,2,2
7303,Danilo Gallinari,28-117,F,12/3/16,DEN,@,UTA,L,1,35,3,11,0.273,2,9,0.222,1,2,0.5,5,5,1,1,4,5
7304,Danilo Gallinari,28-126,F,12/12/16,DEN,@,DAL,L,1,28,3,10,0.3,1,5,0.2,2,5,0.4,4,4,1,1,7,8
7305,Langston Galloway,25-009,G,12/18/16,NOP,@,SAS,L,0,20,4,10,0.4,2,4,0.5,2,6,0.333,2,2,1,2,1,3
7306,Langston Galloway,25-045,G,1/23/17,NOP,,CLE,W,0,29,3,9,0.333,0,1,0,3,8,0.375,3,3,1,1,4,5
7307,Langston Galloway,24-339,G,11/12/16,NOP,,LAL,L,0,22,5,12,0.417,3,6,0.5,2,6,0.333,0,0,,2,4,6
7308,Langston Galloway,25-002,G,12/11/16,NOP,@,PHO,W,0,19,4,7,0.571,0,0,,4,7,0.571,0,0,,0,0,0
7309,Langston Galloway,25-019,G,12/28/16,NOP,,LAC,W,0,31,4,10,0.4,3,5,0.6,1,5,0.2,3,4,0.75,0,4,4
7310,Langston Galloway,25-001,G,12/10/16,NOP,@,LAC,L,0,30,4,13,0.308,3,8,0.375,1,5,0.2,3,5,0.6,0,0,0
7311,Marc Gasol,32-026,C,2/24/17,MEM,@,IND,L,1,32,5,15,0.333,5,12,0.417,0,3,0,2,2,1,2,2,4
7312,Pau Gasol,36-252,F-C,3/15/17,SAS,,POR,L,0,19,5,10,0.5,3,8,0.375,2,2,1,0,0,,2,3,5
7313,Pau Gasol,36-172,F-C,12/25/16,SAS,,CHI,W,1,24,5,8,0.625,4,7,0.571,1,1,1,1,3,0.333,2,5,7
7314,Pau Gasol,36-131,F-C,11/14/16,SAS,,MIA,W,1,31,6,15,0.4,6,14,0.429,0,1,0,0,2,0,2,6,8
7315,Taj Gibson,31-154,F,11/25/16,CHI,@,PHI,W,1,22,4,5,0.8,4,5,0.8,0,0,,4,5,0.8,0,6,6
7316,Taj Gibson,31-202,F,1/12/17,CHI,@,NYK,L,1,25,4,8,0.5,4,8,0.5,0,0,,4,5,0.8,5,4,9
7317,Taj Gibson,31-245,F,2/24/17,OKC,,LAL,W,0,21,6,13,0.462,6,13,0.462,0,0,,0,0,,1,3,4
7318,Taj Gibson,31-151,F,11/22/16,CHI,@,DEN,L,1,35,6,11,0.545,6,11,0.545,0,0,,0,0,,5,6,11
7319,Taj Gibson,31-237,F,2/16/17,CHI,,BOS,W,1,28,5,8,0.625,5,8,0.625,0,0,,2,2,1,3,6,9
7320,Taj Gibson,31-167,F,12/8/16,CHI,,SAS,W,1,28,5,11,0.455,5,11,0.455,0,0,,2,2,1,0,5,5
7321,Taj Gibson,31-184,F,12/25/16,CHI,@,SAS,L,1,25,5,13,0.385,5,13,0.385,0,0,,2,2,1,4,3,7
7322,Taj Gibson,31-144,F,11/15/16,CHI,@,POR,W,1,30,4,9,0.444,4,9,0.444,0,0,,4,5,0.8,5,6,11
7323,Taj Gibson,31-127,F,10/29/16,CHI,,IND,W,1,25,6,11,0.545,6,11,0.545,0,0,,0,0,,0,8,8
7324,Manu Ginobili,39-139,G,12/14/16,SAS,,BOS,W,0,22,5,9,0.556,3,5,0.6,2,4,0.5,0,0,,0,2,2
7325,Manu Ginobili,39-193,G,2/6/17,SAS,@,MEM,L,0,17,5,9,0.556,3,4,0.75,2,5,0.4,0,0,,0,0,0
7326,Manu Ginobili,39-153,G,12/28/16,SAS,,PHO,W,0,20,3,9,0.333,1,5,0.2,2,4,0.5,4,4,1,3,2,5
7327,Manu Ginobili,39-107,G,11/12/16,SAS,@,HOU,W,0,16,5,7,0.714,3,5,0.6,2,2,1,0,0,,0,2,2
7328,Manu Ginobili,39-145,G,12/20/16,SAS,@,HOU,W,0,20,4,9,0.444,0,4,0,4,5,0.8,0,2,0,0,4,4
7329,Rudy Gobert,24-121,C,10/25/16,UTA,@,POR,L,1,41,4,7,0.571,4,7,0.571,0,0,,4,4,1,4,10,14
7330,Rudy Gobert,24-184,C,12/27/16,UTA,@,LAL,W,1,37,4,6,0.667,4,5,0.8,0,1,0,4,8,0.5,6,5,11
7331,Rudy Gobert,24-195,C,1/7/17,UTA,@,MIN,W,1,31,5,10,0.5,5,10,0.5,0,0,,2,3,0.667,7,6,13
7332,Rudy Gobert,24-211,C,1/23/17,UTA,,OKC,L,1,36,5,9,0.556,5,9,0.556,0,0,,2,7,0.286,3,7,10
7333,Rudy Gobert,24-146,C,11/19/16,UTA,@,HOU,L,1,35,5,7,0.714,5,7,0.714,0,0,,2,3,0.667,2,12,14
7334,Rudy Gobert,24-129,C,11/2/16,UTA,,DAL,W,1,23,3,5,0.6,3,5,0.6,0,0,,6,14,0.429,4,8,12
7335,Rudy Gobert,24-139,C,11/12/16,UTA,@,MIA,W,1,33,3,6,0.5,3,6,0.5,0,0,,6,8,0.75,2,10,12
7336,Rudy Gobert,24-262,C,3/15/17,UTA,@,DET,W,1,36,5,6,0.833,5,6,0.833,0,0,,2,5,0.4,3,6,9
7337,Rudy Gobert,24-171,C,12/14/16,UTA,,OKC,W,1,30,5,5,1,5,5,1,0,0,,2,2,1,1,11,12
7338,Aaron Gordon,21-095,F,12/20/16,ORL,@,MIA,W,1,28,4,8,0.5,3,5,0.6,1,3,0.333,3,4,0.75,0,5,5
7339,Aaron Gordon,21-136,F,1/30/17,ORL,@,MIN,L,1,28,4,11,0.364,3,6,0.5,1,5,0.2,3,3,1,2,4,6
7340,Aaron Gordon,21-058,F,11/13/16,ORL,@,OKC,W,0,22,5,9,0.556,4,6,0.667,1,3,0.333,1,1,1,0,1,1
7341,Aaron Gordon,21-040,F,10/26/16,ORL,,MIA,L,1,35,5,12,0.417,3,9,0.333,2,3,0.667,0,0,,2,6,8
7342,Eric Gordon,28-082,G,3/17/17,HOU,@,NOP,L,0,32,4,13,0.308,1,6,0.167,3,7,0.429,1,1,1,1,1,2
7343,Eric Gordon,28-052,G,2/15/17,HOU,,MIA,L,0,32,4,15,0.267,1,5,0.2,3,10,0.3,1,1,1,0,2,2
7344,Eric Gordon,28-071,G,3/6/17,HOU,@,SAS,L,0,34,4,10,0.4,2,3,0.667,2,7,0.286,2,2,1,1,3,4
7345,Marcin Gortat,32-332,C-F,1/14/17,WAS,,PHI,W,1,23,6,9,0.667,6,9,0.667,0,0,,0,1,0,2,8,10
7346,Marcin Gortat,32-365,C-F,2/16/17,WAS,@,IND,W,1,34,6,10,0.6,6,10,0.6,0,0,,0,0,,1,6,7
7347,Marcin Gortat,32-362,C-F,2/13/17,WAS,,OKC,W,1,25,6,8,0.75,6,8,0.75,0,0,,0,0,,1,4,5
7348,Marcin Gortat,32-282,C-F,11/25/16,WAS,@,ORL,W,1,34,6,9,0.667,6,8,0.75,0,1,0,0,0,,1,8,9
7349,Marcin Gortat,32-261,C-F,11/4/16,WAS,,ATL,W,1,31,5,8,0.625,5,8,0.625,0,0,,2,2,1,5,10,15
7350,Marcin Gortat,32-339,C-F,1/21/17,WAS,@,DET,L,1,25,4,6,0.667,4,6,0.667,0,0,,4,5,0.8,1,6,7
7351,Marcin Gortat,33-012,C-F,3/1/17,WAS,@,TOR,W,1,18,6,8,0.75,6,8,0.75,0,0,,0,0,,1,7,8
7352,Marcin Gortat,32-337,C-F,1/19/17,WAS,@,NYK,W,1,30,6,12,0.5,6,12,0.5,0,0,,0,0,,5,8,13
7353,Marcin Gortat,32-353,C-F,2/4/17,WAS,,NOP,W,1,36,5,11,0.455,5,11,0.455,0,0,,2,2,1,4,13,17
7354,Marcin Gortat,33-011,C-F,2/28/17,WAS,,GSW,W,1,23,5,8,0.625,5,8,0.625,0,0,,2,2,1,3,9,12
7355,Marcin Gortat,32-321,C-F,1/3/17,WAS,@,DAL,L,1,40,5,11,0.455,5,11,0.455,0,0,,2,2,1,4,12,16
7356,Marcin Gortat,32-287,C-F,11/30/16,WAS,@,OKC,L,1,36,6,12,0.5,6,12,0.5,0,0,,0,2,0,4,7,11
7357,Marcin Gortat,32-303,C-F,12/16/16,WAS,,DET,W,1,38,6,10,0.6,6,10,0.6,0,0,,0,0,,3,11,14
7358,Jerian Grant,24-103,G,1/20/17,CHI,@,ATL,L,0,11,3,5,0.6,2,3,0.667,1,2,0.5,5,5,1,0,0,0
7359,Jerian Grant,24-122,G,2/8/17,CHI,@,GSW,L,1,25,3,6,0.5,2,3,0.667,1,3,0.333,5,5,1,0,3,3
7360,Jerian Grant,24-115,G,2/1/17,CHI,@,OKC,W,1,26,5,7,0.714,3,5,0.6,2,2,1,0,0,,0,3,3
7361,Danny Green,29-233,G-F,2/10/17,SAS,@,DET,W,1,30,4,5,0.8,0,0,,4,5,0.8,0,0,,0,4,4
7362,Danny Green,29-181,G-F,12/20/16,SAS,@,HOU,W,1,34,4,8,0.5,0,0,,4,8,0.5,0,0,,1,2,3
7363,Danny Green,29-229,G-F,2/6/17,SAS,@,MEM,L,1,33,5,12,0.417,3,6,0.5,2,6,0.333,0,0,,2,6,8
7364,Danny Green,29-225,G-F,2/2/17,SAS,,PHI,W,1,29,5,10,0.5,3,5,0.6,2,5,0.4,0,0,,1,3,4
7365,Danny Green,29-236,G-F,2/13/17,SAS,@,IND,W,1,35,4,9,0.444,2,4,0.5,2,5,0.4,2,2,1,0,6,6
7366,Draymond Green,26-320,F,1/18/17,GSW,,OKC,W,1,36,5,9,0.556,5,8,0.625,0,1,0,2,4,0.5,2,9,11
7367,Draymond Green,26-266,F,11/25/16,GSW,@,LAL,W,1,26,5,7,0.714,4,5,0.8,1,2,0.5,1,3,0.333,0,8,8
7368,Draymond Green,27-002,F,3/6/17,GSW,@,ATL,W,1,30,4,10,0.4,2,5,0.4,2,5,0.4,2,2,1,3,5,8
7369,Draymond Green,26-363,F,3/2/17,GSW,@,CHI,L,1,35,4,9,0.444,2,4,0.5,2,5,0.4,2,2,1,1,7,8
7370,Draymond Green,26-284,F,12/13/16,GSW,@,NOP,W,1,36,4,11,0.364,2,6,0.333,2,5,0.4,2,2,1,1,13,14
7371,JaMychal Green,26-273,F,3/21/17,MEM,@,NOP,L,1,18,4,6,0.667,3,4,0.75,1,2,0.5,3,3,1,0,2,2
7372,JaMychal Green,26-127,F,10/26/16,MEM,,MIN,W,1,29,4,10,0.4,2,8,0.25,2,2,1,2,2,1,4,3,7
7373,JaMychal Green,26-158,F,11/26/16,MEM,@,MIA,W,1,33,4,6,0.667,1,2,0.5,3,4,0.75,1,2,0.5,1,6,7
7374,JaMychal Green,26-153,F,11/21/16,MEM,@,CHO,W,1,31,4,4,1,4,4,1,0,0,,4,5,0.8,1,7,8
7375,Jeff Green,30-189,F,3/5/17,ORL,@,WAS,L,0,22,5,11,0.455,4,9,0.444,1,2,0.5,1,2,0.5,0,2,2
7376,Jeff Green,30-147,F,1/22/17,ORL,,GSW,L,0,27,4,12,0.333,2,9,0.222,2,3,0.667,2,3,0.667,2,1,3
7377,Jeff Green,30-160,F,2/4/17,ORL,@,ATL,L,0,18,3,7,0.429,2,4,0.5,1,3,0.333,5,5,1,0,5,5
7378,Blake Griffin,28-005,F,3/21/17,LAC,@,LAL,W,1,26,2,9,0.222,1,5,0.2,1,4,0.25,7,8,0.875,1,2,3
7379,Blake Griffin,27-314,F,1/24/17,LAC,@,PHI,L,1,29,3,11,0.273,3,11,0.273,0,0,,6,10,0.6,2,9,11
7380,Blake Griffin,27-252,F,11/23/16,LAC,@,DAL,W,1,26,4,10,0.4,3,9,0.333,1,1,1,3,6,0.5,0,6,6
7381,Blake Griffin,27-266,F,12/7/16,LAC,,GSW,L,1,31,5,20,0.25,5,19,0.263,0,1,0,2,4,0.5,4,5,9
7382,Blake Griffin,27-344,F,2/23/17,LAC,@,GSW,L,1,35,3,13,0.231,2,11,0.182,1,2,0.5,5,9,0.556,0,5,5
7383,Justin Hamilton,26-301,C,1/27/17,BRK,@,CLE,L,1,23,6,11,0.545,6,10,0.6,0,1,0,0,0,,1,4,5
7384,Tim Hardaway,24-272,G,12/13/16,ATL,,ORL,L,1,30,4,12,0.333,3,6,0.5,1,6,0.167,3,3,1,1,2,3
7385,Tim Hardaway,24-294,G,1/4/17,ATL,@,ORL,W,0,21,5,9,0.556,3,5,0.6,2,4,0.5,0,0,,0,2,2
7386,Tim Hardaway,24-264,G,12/5/16,ATL,,OKC,L,0,26,4,9,0.444,3,4,0.75,1,5,0.2,3,3,1,0,3,3
7387,Tim Hardaway,24-317,G,1/27/17,ATL,,WAS,L,0,22,4,11,0.364,2,7,0.286,2,4,0.5,2,2,1,1,3,4
7388,Tim Hardaway,24-249,G,11/20/16,ATL,@,NYK,L,0,22,5,8,0.625,3,5,0.6,2,3,0.667,0,0,,0,1,1
7389,Tim Hardaway,24-311,G,1/21/17,ATL,,PHI,W,0,27,5,14,0.357,3,7,0.429,2,7,0.286,0,0,,2,1,3
7390,Maurice Harkless,23-288,F-G,2/23/17,POR,@,ORL,W,1,38,4,8,0.5,3,7,0.429,1,1,1,3,4,0.75,0,6,6
7391,Maurice Harkless,23-233,F-G,12/30/16,POR,@,SAS,L,1,28,5,8,0.625,3,5,0.6,2,3,0.667,0,0,,1,0,1
7392,Maurice Harkless,23-231,F-G,12/28/16,POR,,SAC,W,1,33,5,7,0.714,3,4,0.75,2,3,0.667,0,0,,0,4,4
7393,Maurice Harkless,23-311,F-G,3/18/17,POR,@,ATL,W,1,30,5,7,0.714,4,6,0.667,1,1,1,1,2,0.5,1,3,4
7394,Montrezl Harrell,22-319,F-C,12/10/16,HOU,,DAL,W,0,19,5,6,0.833,4,5,0.8,1,1,1,1,1,1,2,0,2
7395,Montrezl Harrell,22-358,F-C,1/18/17,HOU,,MIL,W,1,27,5,8,0.625,5,8,0.625,0,0,,2,3,0.667,4,4,8
7396,Montrezl Harrell,23-041,F-C,3/8/17,HOU,,UTA,L,0,16,5,6,0.833,5,6,0.833,0,0,,2,2,1,1,1,2
7397,Devin Harris,33-313,G,1/5/17,DAL,,PHO,L,0,20,3,5,0.6,1,2,0.5,2,3,0.667,4,4,1,0,3,3
7398,Devin Harris,33-346,G,2/7/17,DAL,,POR,L,0,27,3,8,0.375,1,4,0.25,2,4,0.5,4,6,0.667,0,7,7
7399,Gary Harris,22-100,G,12/23/16,DEN,,ATL,L,1,30,5,12,0.417,5,9,0.556,0,3,0,2,3,0.667,2,0,2
7400,Gary Harris,22-053,G,11/6/16,DEN,@,BOS,W,1,22,5,10,0.5,4,8,0.5,1,2,0.5,1,1,1,0,4,4
7401,Gary Harris,22-140,G,2/1/17,DEN,,MEM,L,1,25,4,4,1,2,2,1,2,2,1,2,2,1,0,2,2
7402,Gary Harris,22-180,G,3/13/17,DEN,,LAL,W,1,35,4,15,0.267,3,9,0.333,1,6,0.167,3,4,0.75,2,2,4
7403,Joe Harris,25-153,G,2/7/17,BRK,@,CHO,L,0,27,4,9,0.444,1,2,0.5,3,7,0.429,1,2,0.5,0,4,4
7404,Joe Harris,25-130,G,1/15/17,BRK,,HOU,L,1,20,5,11,0.455,3,3,1,2,8,0.25,0,0,,1,2,3
7405,Joe Harris,25-077,G,11/23/16,BRK,,BOS,L,0,25,4,7,0.571,0,1,0,4,6,0.667,0,0,,0,3,3
7406,Tobias Harris,24-243,F,3/15/17,DET,,UTA,L,0,30,5,8,0.625,5,8,0.625,0,0,,2,2,1,0,4,4
7407,Tobias Harris,24-119,F,11/11/16,DET,@,SAS,L,1,31,4,13,0.308,4,9,0.444,0,4,0,4,4,1,0,5,5
7408,Tobias Harris,24-115,F,11/7/16,DET,@,LAC,L,1,30,5,13,0.385,5,10,0.5,0,3,0,2,2,1,0,3,3
7409,Andrew Harrison,22-038,G,12/5/16,MEM,@,NOP,W,1,40,3,13,0.231,1,6,0.167,2,7,0.286,4,6,0.667,2,1,3
7410,Andrew Harrison,22-004,G,11/1/16,MEM,@,MIN,L,0,32,2,7,0.286,1,5,0.2,1,2,0.5,7,8,0.875,1,1,2
7411,Andrew Harrison,22-060,G,12/27/16,MEM,@,BOS,L,1,44,4,12,0.333,4,8,0.5,0,4,0,4,8,0.5,2,3,5
7412,Spencer Hawes,28-275,C-F,1/28/17,CHO,,SAC,L,0,28,4,6,0.667,4,5,0.8,0,1,0,4,4,1,2,5,7
7413,Gordon Hayward,26-345,F-G,3/3/17,UTA,,BRK,W,1,35,5,11,0.455,4,6,0.667,1,5,0.2,1,2,0.5,0,3,3
7414,Gerald Henderson,29-066,G,2/13/17,PHI,@,CHO,W,1,28,4,8,0.5,3,4,0.75,1,4,0.25,3,3,1,0,4,4
7415,Gerald Henderson,29-033,G,1/11/17,PHI,,NYK,W,0,26,5,10,0.5,5,10,0.5,0,0,,2,2,1,0,2,2
7416,Gerald Henderson,28-338,G,11/11/16,PHI,,IND,W,1,29,5,12,0.417,5,10,0.5,0,2,0,2,2,1,2,2,4
7417,Gerald Henderson,29-057,G,2/4/17,PHI,@,MIA,L,1,25,6,12,0.5,6,12,0.5,0,0,,0,0,,0,0,0
7418,John Henson,25-325,C-F,11/17/16,MIL,@,MIA,L,1,28,5,8,0.625,5,8,0.625,0,0,,2,2,1,1,4,5
7419,John Henson,26-005,C-F,1/2/17,MIL,,OKC,W,1,27,6,7,0.857,6,7,0.857,0,0,,0,0,,2,3,5
7420,John Henson,25-339,C-F,12/1/16,MIL,@,BRK,W,1,25,4,9,0.444,4,9,0.444,0,0,,4,4,1,3,5,8
7421,Willy Hernangomez,22-261,C,2/12/17,NYK,,SAS,W,1,29,6,8,0.75,6,8,0.75,0,0,,0,0,,3,6,9
7422,Willy Hernangomez,22-259,C,2/10/17,NYK,,DEN,L,0,9,6,7,0.857,6,7,0.857,0,0,,0,0,,2,2,4
7423,Mario Hezonja,22-008,F-G,3/5/17,ORL,@,WAS,L,0,17,4,9,0.444,1,4,0.25,3,5,0.6,1,2,0.5,0,2,2
7424,Buddy Hield,23-013,G,12/30/16,NOP,,NYK,W,1,24,3,9,0.333,1,4,0.25,2,5,0.4,4,4,1,0,2,2
7425,Nene Hilario,34-099,F-C,12/21/16,HOU,@,PHO,W,0,18,5,6,0.833,5,6,0.833,0,0,,2,2,1,1,1,2
7426,Nene Hilario,34-130,F-C,1/21/17,HOU,@,MEM,W,0,16,4,5,0.8,4,5,0.8,0,0,,4,6,0.667,0,3,3
7427,Nene Hilario,34-180,F-C,3/12/17,HOU,,CLE,W,0,22,6,10,0.6,6,10,0.6,0,0,,0,0,,4,2,6
7428,Nene Hilario,34-122,F-C,1/13/17,HOU,,MEM,L,0,23,4,6,0.667,4,6,0.667,0,0,,4,4,1,2,1,3
7429,Nene Hilario,34-090,F-C,12/12/16,HOU,,BRK,W,0,25,4,8,0.5,4,8,0.5,0,0,,4,6,0.667,3,3,6
7430,Nene Hilario,34-105,F-C,12/27/16,HOU,@,DAL,W,1,19,5,8,0.625,5,8,0.625,0,0,,2,5,0.4,1,6,7
7431,George Hill,30-267,G,1/26/17,UTA,,LAL,W,1,34,4,14,0.286,3,9,0.333,1,5,0.2,3,4,0.75,3,4,7
7432,Solomon Hill,25-332,F,2/13/17,NOP,@,PHO,W,1,31,2,5,0.4,1,1,1,1,4,0.25,7,8,0.875,0,4,4
7433,Solomon Hill,25-270,F,12/13/16,NOP,,GSW,L,1,30,5,10,0.5,3,6,0.5,2,4,0.5,0,0,,1,5,6
7434,Solomon Hill,25-361,F,3/14/17,NOP,,POR,W,1,31,4,5,0.8,2,2,1,2,3,0.667,2,2,1,0,3,3
7435,Jrue Holiday,26-191,G,12/20/16,NOP,@,PHI,W,1,30,4,14,0.286,3,10,0.3,1,4,0.25,3,4,0.75,1,3,4
7436,Jrue Holiday,26-222,G,1/20/17,NOP,,BRK,L,1,28,4,12,0.333,3,10,0.3,1,2,0.5,3,4,0.75,1,2,3
7437,Jrue Holiday,26-201,G,12/30/16,NOP,,NYK,W,1,35,5,10,0.5,5,9,0.556,0,1,0,2,2,1,0,4,4
7438,Rondae Hollis-Jefferson,22-062,F,3/6/17,BRK,@,MEM,W,1,23,5,10,0.5,5,8,0.625,0,2,0,2,4,0.5,0,4,4
7439,Rondae Hollis-Jefferson,22-060,F,3/4/17,BRK,@,POR,L,1,27,6,9,0.667,6,9,0.667,0,0,,0,1,0,5,3,8
7440,Rondae Hollis-Jefferson,22-017,F,1/20/17,BRK,@,NOP,W,0,18,4,6,0.667,4,6,0.667,0,0,,4,5,0.8,0,7,7
7441,Richaun Holmes,23-132,F-C,2/24/17,PHI,,WAS,W,0,26,6,9,0.667,6,8,0.75,0,1,0,0,0,,3,7,10
7442,Richaun Holmes,23-112,F-C,2/4/17,PHI,@,MIA,L,0,24,4,6,0.667,4,6,0.667,0,0,,4,4,1,2,7,9
7443,Rodney Hood,24-028,G-F,11/17/16,UTA,,CHI,L,1,34,5,16,0.313,4,9,0.444,1,7,0.143,1,2,0.5,0,6,6
7444,Al Horford,30-251,C-F,2/9/17,BOS,@,POR,W,1,33,5,12,0.417,4,10,0.4,1,2,0.5,1,1,1,2,4,6
7445,Al Horford,30-175,C-F,11/25/16,BOS,,SAS,L,1,35,6,13,0.462,6,10,0.6,0,3,0,0,0,,2,8,10
7446,Al Horford,30-282,C-F,3/12/17,BOS,,CHI,W,1,32,5,7,0.714,3,5,0.6,2,2,1,0,0,,3,4,7
7447,Al Horford,30-257,C-F,2/15/17,BOS,,PHI,W,1,29,4,8,0.5,2,5,0.4,2,3,0.667,2,3,0.667,0,5,5
7448,Dwight Howard,31-028,C,1/5/17,ATL,@,NOP,W,1,30,5,8,0.625,5,8,0.625,0,0,,2,4,0.5,4,8,12
7449,Dwight Howard,31-050,C,1/27/17,ATL,,WAS,L,1,29,4,5,0.8,4,5,0.8,0,0,,4,8,0.5,4,9,13
7450,Marcelo Huertas,33-198,G,12/9/16,LAL,,PHO,L,0,19,5,7,0.714,3,4,0.75,2,3,0.667,0,0,,0,1,1
7451,Kris Humphries,31-324,F-C,12/26/16,ATL,@,MIN,L,0,11,3,5,0.6,3,4,0.75,0,1,0,6,7,0.857,5,0,5
7452,Serge Ibaka,27-133,F-C,1/29/17,ORL,@,TOR,W,1,33,5,10,0.5,5,7,0.714,0,3,0,2,2,1,1,6,7
7453,Serge Ibaka,27-082,F-C,12/9/16,ORL,@,CHO,L,1,29,3,9,0.333,1,5,0.2,2,4,0.5,4,4,1,2,4,6
7454,Serge Ibaka,27-171,F-C,3/8/17,TOR,@,NOP,W,1,30,5,13,0.385,3,9,0.333,2,4,0.5,0,0,,0,5,5
7455,Andre Iguodala,33-001,G-F,1/29/17,GSW,@,POR,W,0,36,4,6,0.667,1,2,0.5,3,4,0.75,1,1,1,0,3,3
7456,Andre Iguodala,32-305,G-F,11/28/16,GSW,,ATL,W,0,28,5,9,0.556,3,3,1,2,6,0.333,0,2,0,0,5,5
7457,Ersan Ilyasova,29-243,F,1/13/17,PHI,,CHO,W,1,30,5,14,0.357,3,7,0.429,2,7,0.286,0,0,,1,2,3
7458,Ersan Ilyasova,29-213,F,12/14/16,PHI,,TOR,L,0,23,5,13,0.385,4,8,0.5,1,5,0.2,1,2,0.5,0,7,7
7459,Ersan Ilyasova,29-246,F,1/16/17,PHI,@,MIL,W,1,28,4,14,0.286,2,7,0.286,2,7,0.286,2,2,1,1,3,4
7460,Joe Ingles,29-152,F-G,3/3/17,UTA,,BRK,W,1,36,4,8,0.5,0,1,0,4,7,0.571,0,0,,0,4,4
7461,Joe Ingles,29-165,F-G,3/16/17,UTA,@,CLE,L,1,36,5,12,0.417,3,7,0.429,2,5,0.4,0,0,,0,4,4
7462,Joe Ingles,29-110,F-G,1/20/17,UTA,@,DAL,W,1,38,4,9,0.444,2,5,0.4,2,4,0.5,2,2,1,0,3,3
7463,Joe Ingles,29-164,F-G,3/15/17,UTA,@,DET,W,0,27,4,6,0.667,0,1,0,4,5,0.8,0,0,,0,3,3
7464,Joe Ingles,29-155,F-G,3/6/17,UTA,,NOP,W,1,32,4,6,0.667,0,1,0,4,5,0.8,0,0,,1,4,5
7465,Brandon Ingram,19-096,F,12/7/16,LAL,@,HOU,L,0,33,5,13,0.385,3,9,0.333,2,4,0.5,0,2,0,3,4,7
7466,Brandon Ingram,19-063,F,11/4/16,LAL,,GSW,W,0,27,2,8,0.25,2,4,0.5,0,4,0,8,9,0.889,2,4,6
7467,Brandon Ingram,19-191,F,3/12/17,LAL,,PHI,L,1,38,5,9,0.556,5,6,0.833,0,3,0,2,2,1,0,3,3
7468,Reggie Jackson,26-289,G,1/30/17,DET,@,BOS,L,1,28,4,12,0.333,4,9,0.444,0,3,0,4,6,0.667,0,2,2
7469,Reggie Jackson,26-300,G,2/10/17,DET,,SAS,L,1,29,5,13,0.385,3,9,0.333,2,4,0.5,0,0,,0,1,1
7470,Al Jefferson,31-363,C-F,1/1/17,IND,,ORL,W,0,14,5,9,0.556,5,9,0.556,0,0,,2,2,1,0,3,3
7471,Al Jefferson,32-043,C-F,2/16/17,IND,,WAS,L,0,11,6,8,0.75,6,8,0.75,0,0,,0,0,,0,3,3
7472,Al Jefferson,31-308,C-F,11/7/16,IND,@,CHO,L,0,19,6,12,0.5,6,12,0.5,0,0,,0,1,0,4,6,10
7473,Richard Jefferson,36-270,F,3/18/17,CLE,@,LAC,L,0,28,4,9,0.444,2,4,0.5,2,5,0.4,2,3,0.667,0,6,6
7474,Richard Jefferson,36-163,F,12/1/16,CLE,,LAC,L,0,22,4,6,0.667,0,0,,4,6,0.667,0,0,,0,4,4
7475,Richard Jefferson,36-195,F,1/2/17,CLE,,NOP,W,0,29,4,9,0.444,3,5,0.6,1,4,0.25,3,3,1,1,11,12
7476,Brandon Jennings,27-040,G,11/2/16,NYK,,HOU,L,0,23,3,7,0.429,3,5,0.6,0,2,0,6,8,0.75,0,3,3
7477,Brandon Jennings,27-039,G,11/1/16,NYK,@,DET,L,0,19,5,11,0.455,3,7,0.429,2,4,0.5,0,1,0,0,2,2
7478,Brandon Jennings,27-068,G,11/30/16,NYK,@,MIN,W,0,34,5,14,0.357,3,9,0.333,2,5,0.4,0,0,,1,1,2
7479,Brandon Jennings,27-101,G,1/2/17,NYK,,ORL,L,0,24,4,9,0.444,2,4,0.5,2,5,0.4,2,3,0.667,1,2,3
7480,Brandon Jennings,27-064,G,11/26/16,NYK,@,CHO,L,0,25,5,10,0.5,3,5,0.6,2,5,0.4,0,1,0,0,1,1
7481,Jonas Jerebko,29-302,F,12/29/16,BOS,@,CLE,L,0,17,4,7,0.571,2,3,0.667,2,4,0.5,2,2,1,1,6,7
7482,James Johnson,30-019,F,3/11/17,MIA,,TOR,W,0,28,4,10,0.4,4,7,0.571,0,3,0,4,6,0.667,0,5,5
7483,James Johnson,29-323,F,1/8/17,MIA,@,LAC,L,0,27,4,10,0.4,2,5,0.4,2,5,0.4,2,2,1,1,5,6
7484,James Johnson,29-304,F,12/20/16,MIA,,ORL,L,0,28,5,10,0.5,3,4,0.75,2,6,0.333,0,0,,1,7,8
7485,James Johnson,29-300,F,12/16/16,MIA,,LAC,L,0,22,5,11,0.455,5,6,0.833,0,5,0,2,3,0.667,1,6,7
7486,Joe Johnson,35-260,G-F,3/16/17,UTA,@,CLE,L,1,29,5,12,0.417,5,8,0.625,0,4,0,2,2,1,0,4,4
7487,Joe Johnson,35-259,G-F,3/15/17,UTA,@,DET,W,1,29,4,10,0.4,2,5,0.4,2,5,0.4,2,2,1,0,5,5
7488,Stanley Johnson,20-160,F,11/5/16,DET,,DEN,W,0,19,5,7,0.714,4,4,1,1,3,0.333,1,2,0.5,0,1,1
7489,Tyler Johnson,24-216,G,12/9/16,MIA,@,CLE,L,0,38,5,17,0.294,3,11,0.273,2,6,0.333,0,0,,0,5,5
7490,Tyler Johnson,24-246,G,1/8/17,MIA,@,LAC,L,0,33,4,12,0.333,3,9,0.333,1,3,0.333,3,4,0.75,0,7,7
7491,Tyler Johnson,24-176,G,10/30/16,MIA,,SAS,L,0,30,5,11,0.455,5,10,0.5,0,1,0,2,3,0.667,0,0,0
7492,Tyler Johnson,24-174,G,10/28/16,MIA,,CHO,L,0,29,4,10,0.4,2,6,0.333,2,4,0.5,2,2,1,1,5,6
7493,Tyler Johnson,24-203,G,11/26/16,MIA,,MEM,L,0,29,3,7,0.429,1,2,0.5,2,5,0.4,4,5,0.8,0,4,4
7494,Nikola Jokic,21-263,C-F,11/8/16,DEN,@,MEM,L,1,28,4,10,0.4,3,7,0.429,1,3,0.333,3,4,0.75,1,4,5
7495,Nikola Jokic,21-275,C-F,11/20/16,DEN,,UTA,W,0,21,5,8,0.625,4,7,0.571,1,1,1,1,2,0.5,2,3,5
7496,Nikola Jokic,21-255,C-F,10/31/16,DEN,@,TOR,L,1,22,6,9,0.667,6,8,0.75,0,1,0,0,0,,2,2,4
7497,Terrence Jones,25-016,F,1/25/17,NOP,,OKC,L,1,27,6,17,0.353,6,16,0.375,0,1,0,0,1,0,2,2,4
7498,Terrence Jones,24-362,F,1/5/17,NOP,,ATL,L,0,30,6,12,0.5,6,12,0.5,0,0,,0,1,0,4,7,11
7499,Terrence Jones,25-022,F,1/31/17,NOP,@,TOR,L,0,34,6,14,0.429,6,13,0.462,0,1,0,0,1,0,2,2,4
7500,Tyus Jones,20-182,G,11/8/16,MIN,@,BRK,L,0,32,4,7,0.571,2,3,0.667,2,4,0.5,2,3,0.667,1,4,5
7501,DeAndre Jordan,28-235,C,3/13/17,LAC,@,UTA,L,1,37,5,9,0.556,5,8,0.625,0,1,0,2,2,1,1,6,7
7502,DeAndre Jordan,28-148,C,12/16/16,LAC,@,MIA,W,1,35,5,7,0.714,5,7,0.714,0,0,,2,3,0.667,3,16,19
7503,DeAndre Jordan,28-113,C,11/11/16,LAC,@,OKC,W,1,33,3,5,0.6,3,5,0.6,0,0,,6,12,0.5,4,9,13
7504,DeAndre Jordan,28-127,C,11/25/16,LAC,@,DET,L,1,33,5,5,1,5,5,1,0,0,,2,3,0.667,2,7,9
7505,DeAndre Jordan,28-158,C,12/26/16,LAC,,DEN,L,1,34,4,7,0.571,4,7,0.571,0,0,,4,5,0.8,2,9,11
7506,DeAndre Jordan,28-243,C,3/21/17,LAC,@,LAL,W,1,23,6,9,0.667,6,9,0.667,0,0,,0,0,,6,5,11
7507,Cory Joseph,25-170,G,2/6/17,TOR,,LAC,W,0,20,4,9,0.444,4,6,0.667,0,3,0,4,4,1,1,3,4
7508,Cory Joseph,25-083,G,11/11/16,TOR,@,CHO,W,0,25,4,8,0.5,2,5,0.4,2,3,0.667,2,2,1,0,4,4
7509,Cory Joseph,25-110,G,12/8/16,TOR,,MIN,W,0,19,6,8,0.75,6,8,0.75,0,0,,0,0,,1,0,1
7510,Cory Joseph,25-093,G,11/21/16,TOR,@,LAC,L,0,18,3,7,0.429,3,7,0.429,0,0,,6,8,0.75,1,3,4
7511,Frank Kaminsky,23-238,F-C,11/28/16,CHO,@,MEM,W,1,31,5,12,0.417,5,8,0.625,0,4,0,2,2,1,0,6,6
7512,Frank Kaminsky,23-315,F-C,2/13/17,CHO,,PHI,L,1,38,5,16,0.313,4,10,0.4,1,6,0.167,1,4,0.25,1,10,11
7513,Frank Kaminsky,23-309,F-C,2/7/17,CHO,,BRK,W,1,33,4,17,0.235,2,10,0.2,2,7,0.286,2,4,0.5,3,8,11
7514,Enes Kanter,24-241,C,1/16/17,OKC,@,LAC,L,0,23,5,10,0.5,5,9,0.556,0,1,0,2,2,1,3,2,5
7515,Enes Kanter,24-211,C,12/17/16,OKC,,PHO,W,0,14,3,7,0.429,3,7,0.429,0,0,,6,7,0.857,3,2,5
7516,Enes Kanter,24-190,C,11/26/16,OKC,,DET,W,0,18,5,8,0.625,5,8,0.625,0,0,,2,3,0.667,0,3,3
7517,Michael Kidd-Gilchrist,23-091,F,12/26/16,CHO,@,BRK,L,1,35,5,10,0.5,5,10,0.5,0,0,,2,2,1,2,8,10
7518,Michael Kidd-Gilchrist,23-123,F,1/27/17,CHO,@,NYK,L,1,37,5,9,0.556,5,8,0.625,0,1,0,2,2,1,1,5,6
7519,Michael Kidd-Gilchrist,23-088,F,12/23/16,CHO,,CHI,W,1,33,5,9,0.556,5,9,0.556,0,0,,2,3,0.667,2,7,9
7520,Michael Kidd-Gilchrist,23-103,F,1/7/17,CHO,@,SAS,L,1,30,6,9,0.667,6,9,0.667,0,0,,0,0,,1,8,9
7521,Michael Kidd-Gilchrist,23-096,F,12/31/16,CHO,,CLE,L,1,35,5,8,0.625,5,8,0.625,0,0,,2,3,0.667,5,3,8
7522,Michael Kidd-Gilchrist,23-150,F,2/23/17,CHO,@,DET,L,1,39,5,9,0.556,5,9,0.556,0,0,,2,2,1,2,12,14
7523,Michael Kidd-Gilchrist,23-093,F,12/28/16,CHO,@,ORL,W,1,30,5,9,0.556,5,9,0.556,0,0,,2,2,1,3,3,6
7524,Michael Kidd-Gilchrist,23-109,F,1/13/17,CHO,@,PHI,L,1,35,2,6,0.333,2,6,0.333,0,0,,8,8,1,4,8,12
7525,Michael Kidd-Gilchrist,23-163,F,3/8/17,CHO,@,MIA,L,1,26,5,7,0.714,5,7,0.714,0,0,,2,2,1,1,4,5
7526,Sean Kilpatrick,26-352,G,12/23/16,BRK,@,CLE,L,1,21,4,10,0.4,2,5,0.4,2,5,0.4,2,2,1,0,5,5
7527,Brandon Knight,24-357,G,11/23/16,PHO,@,ORL,W,1,25,5,10,0.5,3,5,0.6,2,5,0.4,0,0,,0,0,0
7528,Brandon Knight,25-063,G,2/3/17,PHO,@,SAC,W,0,19,5,9,0.556,3,5,0.6,2,4,0.5,0,0,,0,2,2
7529,Brandon Knight,24-353,G,11/19/16,PHO,@,PHI,L,0,21,3,9,0.333,2,7,0.286,1,2,0.5,5,6,0.833,1,1,2
7530,Brandon Knight,25-021,G,12/23/16,PHO,,PHI,W,0,15,4,7,0.571,4,7,0.571,0,0,,4,5,0.8,1,2,3
7531,Brandon Knight,25-066,G,2/6/17,PHO,@,NOP,L,0,24,5,11,0.455,5,8,0.625,0,3,0,2,2,1,0,2,2
7532,Brandon Knight,25-051,G,1/22/17,PHO,@,TOR,W,0,24,3,6,0.5,3,6,0.5,0,0,,6,6,1,0,1,1
7533,Kyle Korver,35-314,G-F,1/25/17,CLE,,SAC,L,0,34,4,9,0.444,0,2,0,4,7,0.571,0,0,,1,0,1
7534,Kyle Korver,35-271,G-F,12/13/16,ATL,,ORL,L,0,27,4,6,0.667,0,1,0,4,5,0.8,0,0,,0,1,1
7535,Kosta Koufos,28-012,C,3/8/17,SAC,@,SAS,L,1,25,6,10,0.6,6,10,0.6,0,0,,0,0,,0,10,10
7536,Kosta Koufos,27-321,C,1/10/17,SAC,,DET,W,0,22,5,7,0.714,5,7,0.714,0,0,,2,2,1,1,7,8
7537,Kosta Koufos,28-009,C,3/5/17,SAC,,UTA,L,1,37,5,12,0.417,5,12,0.417,0,0,,2,2,1,4,6,10
7538,Kosta Koufos,27-303,C,12/23/16,SAC,@,MIN,W,1,21,6,8,0.75,6,8,0.75,0,0,,0,0,,2,2,4
7539,Kosta Koufos,27-342,C,1/31/17,SAC,@,HOU,L,1,17,6,7,0.857,6,7,0.857,0,0,,0,1,0,2,2,4
7540,Skal Labissiere,20-342,F,2/23/17,SAC,,DEN,W,0,14,5,7,0.714,5,7,0.714,0,0,,2,2,1,2,1,3
7541,Jeremy Lamb,24-193,G-F,12/9/16,CHO,,ORL,W,0,19,6,8,0.75,6,7,0.857,0,1,0,0,0,,1,7,8
7542,Jeremy Lamb,24-259,G-F,2/13/17,CHO,,PHI,L,0,15,4,8,0.5,2,5,0.4,2,3,0.667,2,3,0.667,0,0,0
7543,Jeremy Lamb,24-294,G-F,3/20/17,CHO,,ATL,W,0,17,5,9,0.556,3,5,0.6,2,4,0.5,0,0,,0,3,3
7544,Jeremy Lamb,24-278,G-F,3/4/17,CHO,@,DEN,W,0,22,5,10,0.5,3,7,0.429,2,3,0.667,0,0,,1,3,4
7545,Jeremy Lamb,24-185,G-F,12/1/16,CHO,,DAL,W,0,19,3,7,0.429,2,5,0.4,1,2,0.5,5,5,1,1,5,6
7546,Jeremy Lamb,24-250,G-F,2/4/17,CHO,@,UTA,L,0,15,4,8,0.5,4,5,0.8,0,3,0,4,5,0.8,0,2,2
7547,Joffrey Lauvergne,25-053,C-F,11/22/16,OKC,@,LAL,L,0,23,5,9,0.556,3,5,0.6,2,4,0.5,0,0,,0,7,7
7548,Ty Lawson,29-053,G,12/26/16,SAC,,PHI,W,0,20,4,8,0.5,4,6,0.667,0,2,0,4,4,1,3,1,4
7549,Ty Lawson,29-025,G,11/28/16,SAC,@,WAS,L,0,24,5,9,0.556,5,9,0.556,0,0,,2,2,1,0,0,0
7550,Ty Lawson,29-022,G,11/25/16,SAC,,HOU,L,1,24,3,6,0.5,2,5,0.4,1,1,1,5,6,0.833,2,2,4
7551,Courtney Lee,31-156,G,3/8/17,NYK,@,MIL,L,1,37,4,12,0.333,2,7,0.286,2,5,0.4,2,2,1,1,6,7
7552,Courtney Lee,31-053,G,11/25/16,NYK,,CHO,W,1,38,4,10,0.4,2,6,0.333,2,4,0.5,2,2,1,1,1,2
7553,David Lee,33-181,F,10/27/16,SAS,@,SAC,W,0,16,5,6,0.833,5,6,0.833,0,0,,2,2,1,2,3,5
7554,David Lee,33-320,F,3/15/17,SAS,,POR,L,0,19,5,6,0.833,5,6,0.833,0,0,,2,3,0.667,2,3,5
7555,David Lee,33-279,F,2/2/17,SAS,,PHI,W,0,17,4,7,0.571,4,7,0.571,0,0,,4,6,0.667,3,6,9
7556,David Lee,33-316,F,3/11/17,SAS,,GSW,W,1,18,4,6,0.667,4,6,0.667,0,0,,4,4,1,1,5,6
7557,David Lee,33-243,F,12/28/16,SAS,,PHO,W,0,16,6,7,0.857,6,7,0.857,0,0,,0,0,,2,1,3
7558,David Lee,33-290,F,2/13/17,SAS,@,IND,W,0,22,4,5,0.8,4,5,0.8,0,0,,4,5,0.8,3,8,11
7559,David Lee,33-206,F,11/21/16,SAS,,DAL,W,0,28,6,10,0.6,6,10,0.6,0,0,,0,1,0,2,2,4
7560,Alex Len,23-278,C,3/21/17,PHO,@,MIA,L,1,36,5,13,0.385,5,11,0.455,0,2,0,2,2,1,3,8,11
7561,Alex Len,23-257,C,2/28/17,PHO,@,MEM,L,1,25,4,7,0.571,4,7,0.571,0,0,,4,4,1,2,3,5
7562,Kawhi Leonard,25-263,F,3/19/17,SAS,,SAC,W,1,26,3,12,0.25,2,6,0.333,1,6,0.167,5,6,0.833,1,1,2
7563,Meyers Leonard,25-008,C-F,3/7/17,POR,@,OKC,W,0,20,5,8,0.625,3,4,0.75,2,4,0.5,0,0,,0,1,1
7564,Meyers Leonard,24-249,C-F,11/2/16,POR,@,PHO,L,0,27,5,10,0.5,3,5,0.6,2,5,0.4,0,0,,1,4,5
7565,Meyers Leonard,24-339,C-F,1/31/17,POR,,CHO,W,0,25,4,11,0.364,2,5,0.4,2,6,0.333,2,2,1,0,3,3
7566,Jon Leuer,27-307,F,3/17/17,DET,,TOR,L,0,29,5,8,0.625,4,5,0.8,1,3,0.333,1,1,1,2,3,5
7567,Jon Leuer,27-191,F,11/21/16,DET,,HOU,L,0,31,4,9,0.444,4,9,0.444,0,0,,4,4,1,2,6,8
7568,Jon Leuer,27-268,F,2/6/17,DET,,PHI,W,1,23,5,9,0.556,4,7,0.571,1,2,0.5,1,1,1,3,2,5
7569,Jon Leuer,27-200,F,11/30/16,DET,@,BOS,W,0,23,4,5,0.8,2,2,1,2,3,0.667,2,2,1,0,7,7
7570,Jon Leuer,27-199,F,11/29/16,DET,@,CHO,W,0,32,5,12,0.417,4,9,0.444,1,3,0.333,1,1,1,2,5,7
7571,Caris LeVert,22-153,G-F,1/25/17,BRK,,MIA,L,0,26,4,8,0.5,3,3,1,1,5,0.2,3,4,0.75,0,1,1
7572,Caris LeVert,22-127,G-F,12/30/16,BRK,@,WAS,L,0,24,4,5,0.8,2,2,1,2,3,0.667,2,2,1,0,3,3
7573,Jeremy Lin,28-067,G,10/29/16,BRK,@,MIL,L,1,33,4,16,0.25,3,9,0.333,1,7,0.143,3,5,0.6,1,2,3
7574,Jeremy Lin,28-119,G,12/20/16,BRK,@,TOR,L,1,25,4,8,0.5,2,4,0.5,2,4,0.5,2,4,0.5,0,2,2
7575,Brook Lopez,28-297,C,1/23/17,BRK,,SAS,L,1,21,4,10,0.4,4,9,0.444,0,1,0,4,4,1,3,1,4
7576,Brook Lopez,28-279,C,1/5/17,BRK,@,IND,L,1,26,5,14,0.357,4,9,0.444,1,5,0.2,1,2,0.5,0,6,6
7577,Robin Lopez,28-271,C,12/28/16,CHI,,BRK,W,1,31,5,8,0.625,5,8,0.625,0,0,,2,2,1,1,4,5
7578,Robin Lopez,28-354,C,3/21/17,CHI,@,TOR,L,1,25,5,8,0.625,5,8,0.625,0,0,,2,2,1,3,1,4
7579,Robin Lopez,28-235,C,11/22/16,CHI,@,DEN,L,1,35,6,12,0.5,6,12,0.5,0,0,,0,0,,4,4,8
7580,Robin Lopez,28-251,C,12/8/16,CHI,,SAS,W,1,28,6,9,0.667,6,9,0.667,0,0,,0,0,,1,3,4
7581,Robin Lopez,28-315,C,2/10/17,CHI,@,PHO,L,1,23,5,9,0.556,5,9,0.556,0,0,,2,2,1,5,2,7
7582,Robin Lopez,28-218,C,11/5/16,CHI,@,IND,L,1,27,6,8,0.75,6,8,0.75,0,0,,0,0,,3,4,7
7583,Robin Lopez,28-337,C,3/4/17,CHI,,LAC,L,1,27,6,14,0.429,6,14,0.429,0,0,,0,0,,4,2,6
7584,Robin Lopez,28-233,C,11/20/16,CHI,@,LAL,W,1,28,6,11,0.545,6,11,0.545,0,0,,0,0,,4,7,11
7585,Robin Lopez,28-274,C,12/31/16,CHI,,MIL,L,1,31,6,11,0.545,6,11,0.545,0,0,,0,0,,3,7,10
7586,Robin Lopez,28-289,C,1/15/17,CHI,@,MEM,W,1,37,5,11,0.455,5,11,0.455,0,0,,2,5,0.4,3,4,7
7587,Robin Lopez,28-211,C,10/29/16,CHI,,IND,W,1,19,5,7,0.714,5,7,0.714,0,0,,2,2,1,2,4,6
7588,Kevin Love,28-125,F,1/10/17,CLE,@,UTA,L,1,37,4,14,0.286,2,8,0.25,2,6,0.333,2,2,1,0,9,9
7589,Kevin Love,28-117,F,1/2/17,CLE,,NOP,W,1,24,5,19,0.263,5,12,0.417,0,7,0,2,3,0.667,3,8,11
7590,Kevin Love,28-072,F,11/18/16,CLE,,DET,W,1,27,5,10,0.5,5,9,0.556,0,1,0,2,2,1,1,12,13
7591,Kyle Lowry,30-289,G,1/8/17,TOR,,HOU,L,1,40,2,7,0.286,1,4,0.25,1,3,0.333,7,10,0.7,0,5,5
7592,Timothe Luwawu-Cabarrot,21-250,F,1/14/17,PHI,@,WAS,L,0,26,5,10,0.5,3,7,0.429,2,3,0.667,0,2,0,2,4,6
7593,Timothe Luwawu-Cabarrot,21-263,F,1/27/17,PHI,,HOU,L,0,13,5,5,1,4,4,1,1,1,1,1,1,1,0,1,1
7594,Timothe Luwawu-Cabarrot,21-312,F,3/17/17,PHI,,DAL,W,1,30,4,8,0.5,2,5,0.4,2,3,0.667,2,2,1,1,3,4
7595,Trey Lyles,21-066,F,1/10/17,UTA,,CLE,W,0,17,4,11,0.364,2,4,0.5,2,7,0.286,2,3,0.667,3,2,5
7596,Trey Lyles,21-028,F,12/3/16,UTA,,DEN,W,0,20,4,9,0.444,2,4,0.5,2,5,0.4,2,2,1,0,4,4
7597,Shelvin Mack,26-204,G,11/12/16,UTA,@,MIA,W,0,23,6,8,0.75,6,6,1,0,2,0,0,0,,0,2,2
7598,Shelvin Mack,26-228,G,12/6/16,UTA,,PHO,W,0,30,4,7,0.571,2,3,0.667,2,4,0.5,2,2,1,0,2,2
7599,Thon Maker,19-342,F-C,2/1/17,MIL,@,UTA,L,1,24,4,8,0.5,1,4,0.25,3,4,0.75,1,4,0.25,3,2,5
7600,Thon Maker,19-352,F-C,2/11/17,MIL,@,IND,W,1,22,4,8,0.5,1,3,0.333,3,5,0.6,1,2,0.5,1,2,3
7601,Wesley Matthews,30-019,G,11/2/16,DAL,@,UTA,L,1,36,4,9,0.444,1,4,0.25,3,5,0.6,1,1,1,0,1,1
7602,Wesley Matthews,30-081,G,1/3/17,DAL,,WAS,W,1,38,5,11,0.455,3,7,0.429,2,4,0.5,0,0,,0,2,2
7603,Luc Mbah a Moute,30-176,F,3/4/17,LAC,@,CHI,W,1,30,5,6,0.833,5,6,0.833,0,0,,2,3,0.667,1,2,3
7604,Luc Mbah a Moute,30-136,F,1/23/17,LAC,@,ATL,W,1,29,4,5,0.8,3,4,0.75,1,1,1,3,4,0.75,1,6,7
7605,C.J. McCollum,25-119,G,1/16/17,POR,@,WAS,L,1,23,5,12,0.417,4,9,0.444,1,3,0.333,1,2,0.5,1,1,2
7606,T.J. McConnell,24-261,G,12/11/16,PHI,@,DET,W,1,37,6,9,0.667,6,9,0.667,0,0,,0,0,,1,9,10
7607,T.J. McConnell,24-327,G,2/15/17,PHI,@,BOS,L,1,28,6,9,0.667,6,9,0.667,0,0,,0,0,,0,3,3
7608,Doug McDermott,24-302,F,10/31/16,CHI,@,BRK,W,0,24,4,10,0.4,4,7,0.571,0,3,0,4,4,1,0,3,3
7609,Doug McDermott,25-021,F,1/24/17,CHI,@,ORL,W,0,17,4,7,0.571,0,1,0,4,6,0.667,0,0,,0,1,1
7610,Doug McDermott,25-031,F,2/3/17,CHI,@,HOU,L,0,21,4,9,0.444,2,5,0.4,2,4,0.5,2,2,1,0,1,1
7611,Doug McDermott,24-307,F,11/5/16,CHI,@,IND,L,0,21,3,7,0.429,2,5,0.4,1,2,0.5,5,6,0.833,0,4,4
7612,Rodney McGruder,25-117,G,11/23/16,MIA,@,DET,L,0,31,5,8,0.625,3,4,0.75,2,4,0.5,0,0,,3,1,4
7613,Rodney McGruder,25-183,G,1/28/17,MIA,,DET,W,1,26,3,7,0.429,1,3,0.333,2,4,0.5,4,4,1,1,2,3
7614,Ben McLemore,23-263,G,10/31/16,SAC,@,ATL,L,0,26,5,11,0.455,4,9,0.444,1,2,0.5,1,2,0.5,1,1,2
7615,Jodie Meeks,29-146,G,1/14/17,ORL,@,UTA,L,1,38,3,8,0.375,0,0,,3,8,0.375,3,4,0.75,0,3,3
7616,Jodie Meeks,29-145,G,1/13/17,ORL,@,POR,W,0,19,3,6,0.5,1,4,0.25,2,2,1,4,4,1,0,1,1
7617,C.J. Miles,29-205,G-F,11/9/16,IND,,PHI,W,0,32,3,7,0.429,0,3,0,3,4,0.75,3,4,0.75,0,4,4
7618,C.J. Miles,29-230,G-F,12/4/16,IND,@,LAC,W,0,15,4,7,0.571,3,4,0.75,1,3,0.333,3,3,1,2,3,5
7619,Patty Mills,28-175,G,2/2/17,SAS,,PHI,W,0,18,5,9,0.556,3,6,0.5,2,3,0.667,0,0,,0,2,2
7620,Paul Millsap,31-322,F,12/28/16,ATL,,NYK,W,1,41,4,20,0.2,3,14,0.214,1,6,0.167,3,4,0.75,3,4,7
7621,Nikola Mirotic,25-331,F,1/7/17,CHI,,TOR,W,0,33,4,10,0.4,1,2,0.5,3,8,0.375,1,2,0.5,0,9,9
7622,Nikola Mirotic,25-326,F,1/2/17,CHI,,CHO,W,0,28,4,10,0.4,2,3,0.667,2,7,0.286,2,2,1,1,1,2
7623,Greg Monroe,26-280,C-F,3/11/17,MIL,,MIN,W,0,33,6,14,0.429,6,14,0.429,0,0,,0,0,,4,2,6
7624,Greg Monroe,26-275,C-F,3/6/17,MIL,@,PHI,W,0,22,5,10,0.5,5,10,0.5,0,0,,2,2,1,2,0,2
7625,Greg Monroe,26-287,C-F,3/18/17,MIL,@,GSW,L,0,17,6,13,0.462,6,13,0.462,0,0,,0,0,,4,3,7
7626,Greg Monroe,26-286,C-F,3/17/17,MIL,@,LAL,W,0,16,6,6,1,6,6,1,0,0,,0,0,,1,5,6
7627,Greg Monroe,26-202,C-F,12/23/16,MIL,,WAS,W,0,21,5,7,0.714,5,7,0.714,0,0,,2,2,1,1,10,11
7628,Greg Monroe,26-218,C-F,1/8/17,MIL,,WAS,L,0,33,5,12,0.417,5,12,0.417,0,0,,2,2,1,2,10,12
7629,Greg Monroe,26-284,C-F,3/15/17,MIL,@,LAC,W,0,27,5,10,0.5,5,10,0.5,0,0,,2,4,0.5,1,5,6
7630,E'Twaun Moore,27-344,G,2/6/17,NOP,,PHO,W,0,30,5,10,0.5,3,5,0.6,2,5,0.4,0,0,,1,3,4
7631,E'Twaun Moore,27-269,G,11/23/16,NOP,,MIN,W,1,25,6,9,0.667,6,8,0.75,0,1,0,0,0,,0,3,3
7632,E'Twaun Moore,27-306,G,12/30/16,NOP,,NYK,W,0,27,5,10,0.5,3,7,0.429,2,3,0.667,0,0,,1,3,4
7633,Marcus Morris,27-188,F,3/9/17,DET,,CLE,W,1,32,4,11,0.364,2,4,0.5,2,7,0.286,2,2,1,0,5,5
7634,Marcus Morris,27-110,F,12/21/16,DET,,MEM,L,1,39,1,11,0.091,1,4,0.25,0,7,0,10,14,0.714,0,5,5
7635,Marcus Morris,27-091,F,12/2/16,DET,@,ATL,W,1,29,5,12,0.417,3,9,0.333,2,3,0.667,0,0,,0,4,4
7636,Marcus Morris,27-103,F,12/14/16,DET,@,DAL,W,1,37,4,10,0.4,2,5,0.4,2,5,0.4,2,2,1,0,6,6
7637,Markieff Morris,27-091,F,12/2/16,WAS,@,SAS,L,1,38,4,7,0.571,4,7,0.571,0,0,,4,4,1,1,3,4
7638,Markieff Morris,27-122,F,1/2/17,WAS,@,HOU,L,1,33,5,11,0.455,5,7,0.714,0,4,0,2,3,0.667,1,7,8
7639,Markieff Morris,27-153,F,2/2/17,WAS,,LAL,W,1,35,3,14,0.214,3,9,0.333,0,5,0,6,8,0.75,2,9,11
7640,Markieff Morris,27-085,F,11/26/16,WAS,,SAS,L,1,18,4,9,0.444,2,6,0.333,2,3,0.667,2,2,1,1,0,1
7641,Anthony Morrow,31-073,G,12/9/16,OKC,,HOU,L,0,26,5,11,0.455,3,6,0.5,2,5,0.4,0,0,,1,1,2
7642,Timofey Mozgov,30-151,C,12/14/16,LAL,@,BRK,L,1,33,4,10,0.4,4,10,0.4,0,0,,4,6,0.667,7,6,13
7643,Timofey Mozgov,30-199,C,1/31/17,LAL,,DEN,W,1,23,4,5,0.8,4,5,0.8,0,0,,4,4,1,1,5,6
7644,Timofey Mozgov,30-102,C,10/26/16,LAL,,HOU,W,1,22,6,10,0.6,6,10,0.6,0,0,,0,0,,4,4,8
7645,Timofey Mozgov,30-130,C,11/23/16,LAL,@,GSW,L,1,17,5,7,0.714,5,7,0.714,0,0,,2,2,1,1,3,4
7646,Emmanuel Mudiay,20-243,G,11/3/16,DEN,@,MIN,W,1,33,4,18,0.222,4,14,0.286,0,4,0,4,4,1,0,6,6
7647,Emmanuel Mudiay,20-273,G,12/3/16,DEN,@,UTA,L,1,22,5,11,0.455,3,7,0.429,2,4,0.5,0,0,,0,3,3
7648,Emmanuel Mudiay,20-320,G,1/19/17,DEN,@,SAS,L,1,26,4,10,0.4,2,6,0.333,2,4,0.5,2,2,1,0,1,1
7649,Shabazz Muhammad,24-043,F-G,12/26/16,MIN,,ATL,W,0,29,4,13,0.308,3,10,0.3,1,3,0.333,3,4,0.75,2,1,3
7650,Shabazz Muhammad,24-091,F-G,2/12/17,MIN,,CHI,W,0,19,5,7,0.714,5,5,1,0,2,0,2,3,0.667,1,1,2
7651,Shabazz Muhammad,24-020,F-G,12/3/16,MIN,@,CHO,W,0,25,5,10,0.5,5,9,0.556,0,1,0,2,3,0.667,2,4,6
7652,Shabazz Muhammad,24-085,F-G,2/6/17,MIN,,MIA,L,0,21,4,11,0.364,4,11,0.364,0,0,,4,4,1,1,2,3
7653,Shabazz Muhammad,24-049,F-G,1/1/17,MIN,,POR,L,0,23,5,11,0.455,3,7,0.429,2,4,0.5,0,0,,1,5,6
7654,Jamal Murray,19-288,G,12/7/16,DEN,@,BRK,L,0,34,4,14,0.286,2,6,0.333,2,8,0.25,2,2,1,1,4,5
7655,Jamal Murray,20-023,G,3/18/17,DEN,,HOU,L,0,23,4,13,0.308,2,8,0.25,2,5,0.4,2,4,0.5,0,4,4
7656,Larry Nance Jr.,23-308,F,11/4/16,LAL,,GSW,W,0,30,6,6,1,6,6,1,0,0,,0,0,,2,7,9
7657,Larry Nance Jr.,23-306,F,11/2/16,LAL,@,ATL,W,0,26,6,8,0.75,6,7,0.857,0,1,0,0,0,,1,6,7
7658,Larry Nance Jr.,23-334,F,11/30/16,LAL,@,CHI,W,0,26,5,8,0.625,5,8,0.625,0,0,,2,3,0.667,3,8,11
7659,Larry Nance Jr.,23-331,F,11/27/16,LAL,,ATL,W,0,32,6,10,0.6,6,9,0.667,0,1,0,0,0,,4,6,10
7660,Jameer Nelson,35-002,G,2/11/17,DEN,@,CLE,L,1,37,5,12,0.417,3,7,0.429,2,5,0.4,0,0,,1,7,8
7661,Jameer Nelson,35-019,G,2/28/17,DEN,@,CHI,W,1,30,5,6,0.833,3,3,1,2,3,0.667,0,0,,0,2,2
7662,Jameer Nelson,35-017,G,2/26/17,DEN,,MEM,L,1,32,5,8,0.625,3,4,0.75,2,4,0.5,0,0,,0,2,2
7663,Jameer Nelson,35-014,G,2/23/17,DEN,@,SAC,L,1,29,5,9,0.556,3,5,0.6,2,4,0.5,0,0,,0,4,4
7664,Joakim Noah,31-322,C,1/12/17,NYK,,CHI,W,1,27,6,10,0.6,6,10,0.6,0,0,,0,0,,9,7,16
7665,Nerlens Noel,22-295,C-F,1/30/17,PHI,,SAC,W,0,25,5,5,1,5,5,1,0,0,,2,4,0.5,2,1,3
7666,Nerlens Noel,22-294,C-F,1/29/17,PHI,@,CHI,L,1,25,6,11,0.545,6,11,0.545,0,0,,0,0,,1,5,6
7667,Nerlens Noel,22-309,C-F,2/13/17,PHI,@,CHO,W,1,28,5,6,0.833,5,6,0.833,0,0,,2,3,0.667,1,6,7
7668,Nerlens Noel,22-339,C-F,3/15/17,DAL,@,WAS,W,0,23,4,8,0.5,4,8,0.5,0,0,,4,4,1,1,2,3
7669,Jusuf Nurkic,22-184,C,2/23/17,POR,@,ORL,W,1,34,6,12,0.5,6,12,0.5,0,0,,0,0,,4,8,12
7670,Jusuf Nurkic,22-201,C,3/12/17,POR,@,PHO,W,1,30,6,9,0.667,6,9,0.667,0,0,,0,0,,2,9,11
7671,Jusuf Nurkic,22-151,C,1/21/17,DEN,,LAC,W,0,20,4,7,0.571,4,7,0.571,0,0,,4,7,0.571,0,5,5
7672,Jusuf Nurkic,22-067,C,10/29/16,DEN,,POR,L,1,23,4,9,0.444,4,9,0.444,0,0,,4,6,0.667,4,5,9
7673,Jusuf Nurkic,22-207,C,3/18/17,POR,@,ATL,W,1,32,6,11,0.545,6,11,0.545,0,0,,0,0,,2,7,9
7674,Kyle O'Quinn,26-292,F-C,1/12/17,NYK,,CHI,W,0,17,5,7,0.714,5,7,0.714,0,0,,2,2,1,2,9,11
7675,Kyle O'Quinn,26-255,F-C,12/6/16,NYK,@,MIA,W,0,27,6,8,0.75,6,8,0.75,0,0,,0,1,0,5,2,7
7676,Jahlil Okafor,21-078,C-F,3/3/17,PHI,,NYK,W,1,20,5,10,0.5,5,10,0.5,0,0,,2,2,1,4,4,8
7677,Jahlil Okafor,20-323,C-F,11/2/16,PHI,@,CHO,L,0,24,4,8,0.5,4,8,0.5,0,0,,4,5,0.8,1,4,5
7678,Jahlil Okafor,21-037,C-F,1/21/17,PHI,@,ATL,L,1,30,5,8,0.625,5,8,0.625,0,0,,2,2,1,0,4,4
7679,Victor Oladipo,24-193,G,11/13/16,OKC,,ORL,L,1,31,6,9,0.667,6,8,0.75,0,1,0,0,0,,0,1,1
7680,Victor Oladipo,24-273,G,2/1/17,OKC,,CHI,L,1,25,5,14,0.357,4,8,0.5,1,6,0.167,1,1,1,2,3,5
7681,Victor Oladipo,24-219,G,12/9/16,OKC,,HOU,L,1,38,5,13,0.385,3,6,0.5,2,7,0.286,0,0,,0,7,7
7682,Victor Oladipo,24-185,G,11/5/16,OKC,,MIN,W,1,31,5,9,0.556,4,7,0.571,1,2,0.5,1,3,0.333,0,3,3
7683,Kelly Olynyk,25-263,C-F,1/7/17,BOS,,NOP,W,0,22,5,9,0.556,3,6,0.5,2,3,0.667,0,0,,1,3,4
7684,Kelly Olynyk,25-334,C-F,3/19/17,BOS,@,PHI,L,0,11,3,4,0.75,3,3,1,0,1,0,6,7,0.857,0,1,1
7685,Kelly Oubre,20-357,F,11/30/16,WAS,@,OKC,L,0,28,4,6,0.667,2,3,0.667,2,3,0.667,2,2,1,0,6,6
7686,Zaza Pachulia,33-018,C,2/28/17,GSW,@,WAS,L,1,18,4,8,0.5,4,8,0.5,0,0,,4,5,0.8,6,2,8
7687,Jabari Parker,21-276,F,12/16/16,MIL,@,CHI,W,1,27,6,8,0.75,6,8,0.75,0,0,,0,0,,2,5,7
7688,Tony Parker,34-215,G,12/18/16,SAS,,NOP,W,1,24,6,12,0.5,6,12,0.5,0,0,,0,0,,2,2,4
7689,Tony Parker,34-272,G,2/13/17,SAS,@,IND,W,1,29,4,8,0.5,4,8,0.5,0,0,,4,4,1,0,1,1
7690,Tony Parker,34-207,G,12/10/16,SAS,,BRK,W,1,20,5,8,0.625,4,7,0.571,1,1,1,1,1,1,0,1,1
7691,Chandler Parsons,28-132,F,3/6/17,MEM,,BRK,L,1,22,3,6,0.5,1,3,0.333,2,3,0.667,4,4,1,0,1,1
7692,Chandler Parsons,28-101,F,2/3/17,MEM,@,OKC,L,1,25,3,6,0.5,3,5,0.6,0,1,0,6,6,1,0,3,3
7693,Chandler Parsons,28-024,F,11/18/16,MEM,@,DAL,W,1,23,4,7,0.571,1,2,0.5,3,5,0.6,1,2,0.5,1,1,2
7694,Chandler Parsons,28-088,F,1/21/17,MEM,,HOU,L,1,22,4,11,0.364,3,7,0.429,1,4,0.25,3,4,0.75,0,2,2
7695,Chandler Parsons,28-018,F,11/12/16,MEM,@,MIL,L,1,23,5,11,0.455,3,5,0.6,2,6,0.333,0,0,,0,4,4
7696,Patrick Patterson,27-316,F,1/24/17,TOR,,SAS,L,0,21,5,6,0.833,3,3,1,2,3,0.667,0,0,,0,4,4
7697,Patrick Patterson,27-266,F,12/5/16,TOR,,CLE,L,0,30,3,12,0.25,0,5,0,3,7,0.429,3,4,0.75,3,6,9
7698,Cameron Payne,22-189,G,2/13/17,OKC,@,WAS,L,0,23,5,9,0.556,3,5,0.6,2,4,0.5,0,0,,0,3,3
7699,Elfrid Payton,22-340,G,1/27/17,ORL,@,BOS,L,1,24,4,10,0.4,3,9,0.333,1,1,1,3,3,1,1,4,5
7700,Elfrid Payton,22-319,G,1/6/17,ORL,,HOU,L,1,25,6,10,0.6,6,9,0.667,0,1,0,0,0,,1,1,2
7701,Elfrid Payton,22-319,G,1/6/17,ORL,,HOU,L,1,25,6,10,0.6,6,9,0.667,0,1,0,0,0,,1,1,2
7702,Elfrid Payton,23-009,G,3/3/17,ORL,,MIA,W,1,27,5,8,0.625,5,8,0.625,0,0,,2,3,0.667,0,10,10
7703,Elfrid Payton,22-348,G,2/4/17,ORL,@,ATL,L,1,26,3,12,0.25,3,8,0.375,0,4,0,6,8,0.75,2,1,3
7704,Mason Plumlee,26-265,C-F,11/25/16,POR,,NOP,W,1,33,5,12,0.417,5,12,0.417,0,0,,2,3,0.667,3,11,14
7705,Mason Plumlee,26-298,C-F,12/28/16,POR,,SAC,W,1,23,4,6,0.667,4,6,0.667,0,0,,4,5,0.8,2,12,14
7706,Mason Plumlee,26-356,C-F,2/24/17,DEN,,BRK,W,0,23,5,8,0.625,5,8,0.625,0,0,,2,4,0.5,2,10,12
7707,Mason Plumlee,26-339,C-F,2/7/17,POR,@,DAL,W,1,27,3,4,0.75,3,4,0.75,0,0,,6,6,1,4,11,15
7708,Jakob Poeltl,21-155,C,3/19/17,TOR,,IND,W,0,23,4,6,0.667,4,6,0.667,0,0,,4,4,1,3,4,7
7709,Otto Porter,23-246,F,2/4/17,WAS,,NOP,W,1,34,4,10,0.4,2,4,0.5,2,6,0.333,2,2,1,1,8,9
7710,Otto Porter,23-210,F,12/30/16,WAS,,BRK,W,1,31,5,10,0.5,3,6,0.5,2,4,0.5,0,0,,0,4,4
7711,Otto Porter,23-227,F,1/16/17,WAS,,POR,W,1,30,4,9,0.444,1,4,0.25,3,5,0.6,1,3,0.333,0,4,4
7712,Bobby Portis,22-018,F,2/28/17,CHI,,DEN,L,1,28,5,10,0.5,3,5,0.6,2,5,0.4,0,0,,0,6,6
7713,Bobby Portis,22-030,F,3/12/17,CHI,@,BOS,L,1,21,6,15,0.4,6,12,0.5,0,3,0,0,0,,3,5,8
7714,Kristaps Porzingis,21-127,F-C,12/7/16,NYK,,CLE,L,1,30,5,15,0.333,3,10,0.3,2,5,0.4,0,0,,1,2,3
7715,Kristaps Porzingis,21-142,F-C,12/22/16,NYK,,ORL,W,1,27,5,11,0.455,3,9,0.333,2,2,1,0,0,,2,2,4
7716,Norman Powell,23-174,G,11/15/16,TOR,@,CLE,L,1,29,4,7,0.571,1,2,0.5,3,5,0.6,1,2,0.5,0,3,3
7717,Norman Powell,23-252,G,2/1/17,TOR,@,BOS,L,1,32,6,9,0.667,6,7,0.857,0,2,0,0,0,,0,5,5
7718,Norman Powell,23-289,G,3/10/17,TOR,@,ATL,L,0,18,4,10,0.4,4,7,0.571,0,3,0,4,5,0.8,1,3,4
7719,Norman Powell,23-283,G,3/4/17,TOR,@,MIL,L,0,26,4,8,0.5,4,7,0.571,0,1,0,4,4,1,0,2,2
7720,Chasson Randle,24-034,G,3/11/17,NYK,@,DET,L,0,19,4,10,0.4,0,3,0,4,7,0.571,0,0,,0,3,3
7721,Julius Randle,22-000,F,11/29/16,LAL,@,NOP,L,1,22,6,9,0.667,6,8,0.75,0,1,0,0,2,0,0,10,10
7722,Zach Randolph,35-155,F,12/18/16,MEM,,UTA,L,0,23,5,13,0.385,5,11,0.455,0,2,0,2,2,1,3,8,11
7723,Zach Randolph,35-119,F,11/12/16,MEM,@,MIL,L,0,23,6,13,0.462,6,12,0.5,0,1,0,0,0,,1,6,7
7724,Zach Randolph,35-143,F,12/6/16,MEM,,PHI,W,0,22,5,16,0.313,5,16,0.313,0,0,,2,4,0.5,6,8,14
7725,J.J. Redick,32-260,G,3/11/17,LAC,,PHI,W,1,29,4,11,0.364,2,3,0.667,2,8,0.25,2,2,1,0,2,2
7726,J.J. Redick,32-244,G,2/23/17,LAC,@,GSW,L,1,30,4,10,0.4,2,4,0.5,2,6,0.333,2,2,1,0,2,2
7727,J.J. Redick,32-133,G,11/4/16,LAC,@,MEM,W,1,28,4,10,0.4,3,6,0.5,1,4,0.25,3,3,1,0,1,1
7728,J.J. Redick,32-227,G,2/6/17,LAC,@,TOR,L,1,33,5,13,0.385,4,7,0.571,1,6,0.167,1,1,1,1,3,4
7729,Willie Reed,26-284,F-C,2/24/17,MIA,@,ATL,W,0,23,6,8,0.75,6,8,0.75,0,0,,0,0,,5,5,10
7730,Willie Reed,26-309,F-C,3/21/17,MIA,,PHO,W,0,17,4,5,0.8,4,5,0.8,0,0,,4,4,1,6,1,7
7731,Josh Richardson,23-074,G,11/28/16,MIA,,BOS,L,0,29,4,9,0.444,1,1,1,3,8,0.375,1,2,0.5,1,3,4
7732,Josh Richardson,23-058,G,11/12/16,MIA,,UTA,L,1,33,6,16,0.375,6,13,0.462,0,3,0,0,0,,0,3,3
7733,Josh Richardson,23-071,G,11/25/16,MIA,@,MEM,W,1,27,4,9,0.444,0,2,0,4,7,0.571,0,0,,0,3,3
7734,Malachi Richardson,21-020,G,1/25/17,SAC,@,CLE,W,0,14,5,6,0.833,4,4,1,1,2,0.5,1,1,1,1,2,3
7735,Austin Rivers,24-109,G,11/18/16,LAC,@,SAC,W,0,23,5,7,0.714,4,5,0.8,1,2,0.5,1,1,1,0,1,1
7736,Austin Rivers,24-122,G,12/1/16,LAC,@,CLE,W,0,23,4,8,0.5,2,4,0.5,2,4,0.5,2,2,1,1,3,4
7737,Glenn Robinson,22-344,G-F,12/17/16,IND,@,DET,W,1,36,4,9,0.444,4,7,0.571,0,2,0,4,4,1,3,9,12
7738,Glenn Robinson,22-357,G-F,12/30/16,IND,,CHI,W,1,24,4,4,1,3,3,1,1,1,1,3,4,0.75,2,8,10
7739,Thomas Robinson,25-290,F,1/1/17,LAL,,TOR,L,0,17,6,9,0.667,6,9,0.667,0,0,,0,0,,7,2,9
7740,Sergio Rodriguez,30-142,G,11/1/16,PHI,,ORL,L,1,32,5,11,0.455,3,6,0.5,2,5,0.4,0,0,,0,5,5
7741,Sergio Rodriguez,30-136,G,10/26/16,PHI,,OKC,L,1,32,5,11,0.455,3,5,0.6,2,6,0.333,0,0,,0,4,4
7742,Sergio Rodriguez,30-265,G,3/4/17,PHI,,DET,L,0,30,4,7,0.571,0,1,0,4,6,0.667,0,0,,0,1,1
7743,Sergio Rodriguez,30-168,G,11/27/16,PHI,,CLE,L,1,28,5,9,0.556,3,6,0.5,2,3,0.667,0,0,,0,2,2
7744,Sergio Rodriguez,30-242,G,2/9/17,PHI,@,ORL,W,0,18,4,7,0.571,0,3,0,4,4,1,0,0,,0,3,3
7745,Rajon Rondo,30-352,G,2/8/17,CHI,@,GSW,L,0,23,6,11,0.545,6,10,0.6,0,1,0,0,1,0,1,5,6
7746,Rajon Rondo,30-254,G,11/2/16,CHI,@,BOS,L,1,34,6,11,0.545,6,9,0.667,0,2,0,0,0,,2,7,9
7747,Rajon Rondo,30-290,G,12/8/16,CHI,,SAS,W,1,36,6,12,0.5,6,11,0.545,0,1,0,0,0,,1,9,10
7748,Rajon Rondo,30-358,G,2/14/17,CHI,,TOR,W,0,24,5,8,0.625,3,6,0.5,2,2,1,0,0,,1,2,3
7749,Rajon Rondo,30-323,G,1/10/17,CHI,@,WAS,L,0,27,6,13,0.462,6,10,0.6,0,3,0,0,0,,0,4,4
7750,Derrick Rose,28-094,G,1/6/17,NYK,@,MIL,W,1,32,4,14,0.286,4,13,0.308,0,1,0,4,4,1,0,2,2
7751,Derrick Rose,28-153,G,3/6/17,NYK,@,ORL,W,1,27,2,9,0.222,2,9,0.222,0,0,,8,8,1,0,5,5
7752,Terrence Ross,25-335,F-G,1/5/17,TOR,,UTA,W,0,30,5,12,0.417,3,4,0.75,2,8,0.25,0,0,,0,0,0
7753,Terrence Ross,25-364,F-G,2/3/17,TOR,@,ORL,L,0,28,4,10,0.4,0,4,0,4,6,0.667,0,0,,1,3,4
7754,Terrence Ross,25-345,F-G,1/15/17,TOR,,NYK,W,0,23,4,7,0.571,0,1,0,4,6,0.667,0,0,,0,2,2
7755,Terrence Ross,25-343,F-G,1/13/17,TOR,,BRK,W,0,31,5,11,0.455,3,5,0.6,2,6,0.333,0,0,,0,2,2
7756,Terry Rozier,22-267,G,12/9/16,BOS,,TOR,L,0,25,4,12,0.333,3,7,0.429,1,5,0.2,3,4,0.75,0,3,3
7757,Terry Rozier,22-249,G,11/21/16,BOS,@,MIN,W,0,16,5,8,0.625,3,4,0.75,2,4,0.5,0,0,,1,3,4
7758,Terry Rozier,22-272,G,12/14/16,BOS,@,SAS,L,0,25,5,13,0.385,3,8,0.375,2,5,0.4,0,0,,2,1,3
7759,Ricky Rubio,26-078,G,1/7/17,MIN,,UTA,L,1,34,5,7,0.714,5,6,0.833,0,1,0,2,3,0.667,0,3,3
7760,Brandon Rush,31-188,G-F,1/11/17,MIN,,HOU,W,1,36,4,8,0.5,0,1,0,4,7,0.571,0,0,,2,1,3
7761,Brandon Rush,31-249,G-F,3/13/17,MIN,,WAS,W,1,33,4,8,0.5,0,1,0,4,7,0.571,0,0,,0,2,2
7762,D'Angelo Russell,20-259,G,11/8/16,LAL,,DAL,L,1,26,5,9,0.556,3,5,0.6,2,4,0.5,0,1,0,0,5,5
7763,Domantas Sabonis,20-192,F,11/11/16,OKC,,LAC,L,1,28,4,5,0.8,0,0,,4,5,0.8,0,0,,0,1,1
7764,Domantas Sabonis,20-271,F,1/29/17,OKC,@,CLE,L,1,26,6,12,0.5,6,9,0.667,0,3,0,0,0,,2,3,5
7765,Dario Saric,22-294,F,1/27/17,PHI,,HOU,L,0,21,4,9,0.444,4,8,0.5,0,1,0,4,6,0.667,0,4,4
7766,Dario Saric,22-218,F,11/12/16,PHI,@,ATL,L,1,28,5,13,0.385,3,9,0.333,2,4,0.5,0,0,,1,6,7
7767,Dario Saric,22-262,F,12/26/16,PHI,@,SAC,L,0,27,5,11,0.455,3,6,0.5,2,5,0.4,0,0,,1,8,9
7768,Tomas Satoransky,25-013,G,11/12/16,WAS,@,CHI,L,1,31,4,12,0.333,3,10,0.3,1,2,0.5,3,3,1,0,4,4
7769,Dennis Schroder,23-093,G,12/17/16,ATL,,CHO,L,1,32,6,12,0.5,6,12,0.5,0,0,,0,2,0,1,3,4
7770,Dennis Schroder,23-062,G,11/16/16,ATL,,MIL,W,1,31,3,8,0.375,1,4,0.25,2,4,0.5,4,4,1,0,3,3
7771,Dennis Schroder,23-139,G,2/1/17,ATL,@,MIA,L,1,26,5,11,0.455,5,9,0.556,0,2,0,2,2,1,0,1,1
7772,Thabo Sefolosha,32-301,G-F,2/27/17,ATL,@,BOS,W,1,21,5,6,0.833,3,4,0.75,2,2,1,0,0,,0,3,3
7773,Thabo Sefolosha,32-235,G-F,12/23/16,ATL,@,DEN,W,1,29,4,8,0.5,2,5,0.4,2,3,0.667,2,2,1,2,2,4
7774,Thabo Sefolosha,32-307,G-F,3/5/17,ATL,,IND,L,1,36,4,12,0.333,2,6,0.333,2,6,0.333,2,2,1,1,5,6
7775,Kevin Seraphin,27-068,F,2/13/17,IND,,SAS,L,1,27,6,9,0.667,6,8,0.75,0,1,0,0,2,0,0,4,4
7776,Ramon Sessions,30-242,G,12/9/16,CHO,,ORL,W,0,18,5,8,0.625,3,6,0.5,2,2,1,0,0,,0,3,3
7777,Jonathon Simmons,27-120,G-F,1/12/17,SAS,,LAL,W,0,21,6,8,0.75,6,7,0.857,0,1,0,0,0,,0,3,3
7778,Jonathon Simmons,27-095,G-F,12/18/16,SAS,,NOP,W,0,17,5,6,0.833,3,4,0.75,2,2,1,0,0,,0,1,1
7779,Marcus Smart,22-278,G,12/9/16,BOS,,TOR,L,1,36,3,11,0.273,0,4,0,3,7,0.429,3,5,0.6,1,3,4
7780,Marcus Smart,23-011,G,3/17/17,BOS,@,BRK,W,1,29,3,14,0.214,2,9,0.222,1,5,0.2,5,5,1,0,3,3
7781,Marcus Smart,22-291,G,12/22/16,BOS,@,IND,W,0,25,2,8,0.25,1,4,0.25,1,4,0.25,7,8,0.875,0,4,4
7782,Marcus Smart,23-006,G,3/12/17,BOS,,CHI,W,0,27,4,10,0.4,2,3,0.667,2,7,0.286,2,2,1,1,5,6
7783,Marcus Smart,22-269,G,11/30/16,BOS,,DET,L,0,24,4,14,0.286,2,6,0.333,2,8,0.25,2,2,1,2,0,2
7784,Marcus Smart,22-267,G,11/28/16,BOS,@,MIA,W,0,33,3,8,0.375,2,5,0.4,1,3,0.333,5,9,0.556,0,2,2
7785,Marcus Smart,22-250,G,11/11/16,BOS,,NYK,W,1,34,5,13,0.385,3,6,0.5,2,7,0.286,0,0,,1,5,6
7786,Ish Smith,28-247,G,3/9/17,DET,,CLE,W,0,17,5,9,0.556,4,8,0.5,1,1,1,1,2,0.5,0,3,3
7787,Ish Smith,28-209,G,1/30/17,DET,@,BOS,L,0,19,6,7,0.857,6,7,0.857,0,0,,0,0,,1,2,3
7788,Ish Smith,28-137,G,11/19/16,DET,,BOS,L,1,33,5,10,0.5,5,9,0.556,0,1,0,2,2,1,0,4,4
7789,Ish Smith,28-238,G,2/28/17,DET,,POR,W,0,29,5,13,0.385,5,12,0.417,0,1,0,2,2,1,0,1,1
7790,Ish Smith,28-252,G,3/14/17,DET,@,CLE,L,0,21,6,12,0.5,6,12,0.5,0,0,,0,0,,0,1,1
7791,Ish Smith,28-129,G,11/11/16,DET,@,SAS,L,1,30,6,10,0.6,6,9,0.667,0,1,0,0,2,0,0,4,4
7792,J.R. Smith,31-188,G-F,3/16/17,CLE,,UTA,W,0,30,4,10,0.4,0,2,0,4,8,0.5,0,0,,2,4,6
7793,J.R. Smith,31-186,G-F,3/14/17,CLE,,DET,W,0,23,4,5,0.8,1,1,1,3,4,0.75,1,2,0.5,0,5,5
7794,Jason Smith,30-287,F-C,12/14/16,WAS,,CHO,W,0,18,5,9,0.556,5,9,0.556,0,0,,2,2,1,3,4,7
7795,Tony Snell,25-079,G-F,1/28/17,MIL,,BOS,L,1,33,4,6,0.667,0,1,0,4,5,0.8,0,0,,0,3,3
7796,Tony Snell,25-128,G-F,3/18/17,MIL,@,GSW,L,1,28,5,8,0.625,3,4,0.75,2,4,0.5,0,1,0,1,2,3
7797,Marreese Speights,29-097,C-F,11/9/16,LAC,,POR,W,0,15,4,9,0.444,2,5,0.4,2,4,0.5,2,2,1,1,7,8
7798,Marreese Speights,29-216,C-F,3/8/17,LAC,@,MIN,L,0,15,5,10,0.5,3,6,0.5,2,4,0.5,0,0,,0,7,7
7799,Nik Stauskas,23-038,G,11/14/16,PHI,@,HOU,L,0,29,4,9,0.444,3,4,0.75,1,5,0.2,3,4,0.75,0,2,2
7800,Nik Stauskas,23-070,G,12/16/16,PHI,,LAL,L,0,26,4,9,0.444,2,5,0.4,2,4,0.5,2,2,1,0,1,1
7801,Nik Stauskas,23-036,G,11/12/16,PHI,@,ATL,L,0,24,4,6,0.667,2,2,1,2,4,0.5,2,2,1,2,2,4
7802,Nik Stauskas,23-060,G,12/6/16,PHI,@,MEM,L,1,38,3,10,0.3,2,2,1,1,8,0.125,5,10,0.5,0,4,4
7803,Rodney Stuckey,30-301,G,2/16/17,IND,,WAS,L,0,21,4,6,0.667,2,3,0.667,2,3,0.667,2,2,1,0,0,0
7804,Rodney Stuckey,30-220,G,11/27/16,IND,,LAC,W,0,27,4,10,0.4,4,8,0.5,0,2,0,4,5,0.8,1,4,5
7805,Rodney Stuckey,30-230,G,12/7/16,IND,@,PHO,W,0,26,5,9,0.556,5,7,0.714,0,2,0,2,3,0.667,0,3,3
7806,Rodney Stuckey,30-310,G,2/25/17,IND,@,MIA,L,0,18,3,8,0.375,3,8,0.375,0,0,,6,7,0.857,0,1,1
7807,Jeff Teague,28-205,G,1/1/17,IND,,ORL,W,1,27,5,9,0.556,5,7,0.714,0,2,0,2,2,1,1,2,3
7808,Jeff Teague,28-275,G,3/12/17,IND,,MIA,W,1,31,4,11,0.364,3,10,0.3,1,1,1,3,3,1,1,4,5
7809,Garrett Temple,30-171,G,10/26/16,SAC,@,PHO,W,0,18,6,8,0.75,6,7,0.857,0,1,0,0,0,,1,1,2
7810,Garrett Temple,30-262,G,1/25/17,SAC,@,CLE,W,1,38,4,9,0.444,3,5,0.6,1,4,0.25,3,3,1,0,4,4
7811,Lance Thomas,28-309,F,2/27/17,NYK,,TOR,L,1,29,3,4,0.75,1,1,1,2,3,0.667,4,6,0.667,1,5,6
7812,Tristan Thompson,25-339,F-C,2/15/17,CLE,,IND,W,1,37,6,11,0.545,6,11,0.545,0,0,,0,0,,7,5,12
7813,Tristan Thompson,25-259,F-C,11/27/16,CLE,@,PHI,W,1,36,5,8,0.625,5,8,0.625,0,0,,2,4,0.5,5,7,12
7814,Tristan Thompson,25-303,F-C,1/10/17,CLE,@,UTA,L,1,35,5,8,0.625,5,8,0.625,0,0,,2,5,0.4,6,6,12
7815,Tristan Thompson,25-328,F-C,2/4/17,CLE,@,NYK,W,1,32,6,8,0.75,6,8,0.75,0,0,,0,0,,4,1,5
7816,Anthony Tolliver,31-196,F-C,12/14/16,SAC,@,HOU,L,1,35,5,13,0.385,4,5,0.8,1,8,0.125,1,2,0.5,3,7,10
7817,P.J. Tucker,31-268,F,1/28/17,PHO,,DEN,L,0,36,5,10,0.5,3,6,0.5,2,4,0.5,0,0,,1,5,6
7818,Evan Turner,28-021,G,11/17/16,POR,@,HOU,L,0,28,5,13,0.385,5,12,0.417,0,1,0,2,2,1,1,3,4
7819,Evan Turner,28-086,G,1/21/17,POR,@,BOS,W,1,40,4,9,0.444,4,8,0.5,0,1,0,4,4,1,0,4,4
7820,Myles Turner,20-340,F-C,2/27/17,IND,@,HOU,W,1,28,4,6,0.667,3,5,0.6,1,1,1,3,4,0.75,0,6,6
7821,Myles Turner,20-255,F-C,12/4/16,IND,@,LAC,W,1,30,3,7,0.429,3,5,0.6,0,2,0,6,10,0.6,0,3,3
7822,Myles Turner,20-337,F-C,2/24/17,IND,,MEM,W,1,34,6,7,0.857,6,7,0.857,0,0,,0,0,,0,6,6
7823,Myles Turner,20-228,F-C,11/7/16,IND,@,CHO,L,1,21,5,8,0.625,5,6,0.833,0,2,0,2,2,1,0,5,5
7824,Myles Turner,20-237,F-C,11/16/16,IND,,CLE,W,1,33,6,11,0.545,6,11,0.545,0,0,,0,3,0,1,8,9
7825,Beno Udrih,34-129,G,11/11/16,DET,@,SAS,L,0,18,4,7,0.571,3,5,0.6,1,2,0.5,3,3,1,0,2,2
7826,Beno Udrih,34-141,G,11/23/16,DET,,MIA,W,0,30,5,11,0.455,4,8,0.5,1,3,0.333,1,2,0.5,2,1,3
7827,Jonas Valanciunas,24-234,C,12/26/16,TOR,@,POR,W,1,27,5,13,0.385,5,13,0.385,0,0,,2,2,1,3,10,13
7828,Jonas Valanciunas,24-178,C,10/31/16,TOR,,DEN,W,1,31,6,12,0.5,6,12,0.5,0,0,,0,0,,3,6,9
7829,Jonas Valanciunas,24-194,C,11/16/16,TOR,,GSW,L,1,18,6,6,1,6,6,1,0,0,,0,0,,3,5,8
7830,Jonas Valanciunas,24-206,C,11/28/16,TOR,,PHI,W,1,22,6,12,0.5,6,12,0.5,0,0,,0,0,,3,8,11
7831,Jonas Valanciunas,24-189,C,11/11/16,TOR,@,CHO,W,1,21,5,8,0.625,5,8,0.625,0,0,,2,2,1,2,6,8
7832,Jonas Valanciunas,24-203,C,11/25/16,TOR,@,MIL,W,1,31,6,11,0.545,6,11,0.545,0,0,,0,0,,3,4,7
7833,Jonas Valanciunas,24-254,C,1/15/17,TOR,,NYK,W,1,28,6,11,0.545,6,11,0.545,0,0,,0,0,,5,11,16
7834,Jonas Valanciunas,24-268,C,1/29/17,TOR,,ORL,L,1,28,4,6,0.667,4,6,0.667,0,0,,4,5,0.8,1,8,9
7835,Jonas Valanciunas,24-284,C,2/14/17,TOR,@,CHI,L,1,22,6,11,0.545,6,11,0.545,0,0,,0,0,,5,4,9
7836,Noah Vonleh,21-203,F,3/15/17,POR,@,SAS,W,1,26,4,4,1,4,4,1,0,0,,4,4,1,1,5,6
7837,Nikola Vucevic,26-036,C,11/29/16,ORL,@,SAS,W,0,25,6,16,0.375,6,15,0.4,0,1,0,0,0,,3,7,10
7838,Nikola Vucevic,26-044,C,12/7/16,ORL,,BOS,L,0,27,5,14,0.357,5,12,0.417,0,2,0,2,2,1,1,9,10
7839,Nikola Vucevic,26-026,C,11/19/16,ORL,,DAL,W,1,26,5,16,0.313,5,15,0.333,0,1,0,2,2,1,1,11,12
7840,Nikola Vucevic,26-039,C,12/2/16,ORL,@,PHI,W,0,27,5,9,0.556,3,7,0.429,2,2,1,0,0,,0,11,11
7841,Nikola Vucevic,26-090,C,1/22/17,ORL,,GSW,L,1,24,6,8,0.75,6,8,0.75,0,0,,0,0,,1,3,4
7842,Sasha Vujacic,32-330,G,2/1/17,NYK,@,BRK,W,0,22,4,10,0.4,2,5,0.4,2,5,0.4,2,2,1,0,2,2
7843,Dwyane Wade,34-334,G,12/16/16,CHI,,MIL,L,1,24,5,14,0.357,4,12,0.333,1,2,0.5,1,2,0.5,0,5,5
7844,Dwyane Wade,34-331,G,12/13/16,CHI,,MIN,L,1,32,4,13,0.308,3,10,0.3,1,3,0.333,3,6,0.5,1,4,5
7845,Dwyane Wade,35-044,G,3/2/17,CHI,,GSW,W,1,34,5,15,0.333,5,12,0.417,0,3,0,2,4,0.5,0,5,5
7846,Dwyane Wade,34-341,G,12/23/16,CHI,@,CHO,L,1,26,5,16,0.313,5,15,0.333,0,1,0,2,2,1,1,6,7
7847,Dwyane Wade,34-288,G,10/31/16,CHI,@,BRK,W,1,29,5,13,0.385,4,10,0.4,1,3,0.333,1,1,1,0,3,3
7848,Dion Waiters,25-058,G,2/6/17,MIA,@,MIN,W,1,33,4,13,0.308,4,9,0.444,0,4,0,4,4,1,0,3,3
7849,Dion Waiters,25-040,G,1/19/17,MIA,,DAL,W,1,32,5,12,0.417,4,10,0.4,1,2,0.5,1,2,0.5,0,3,3
7850,Dion Waiters,25-079,G,2/27/17,MIA,@,DAL,L,1,33,4,12,0.333,2,7,0.286,2,5,0.4,2,5,0.4,0,3,3
7851,Kemba Walker,26-218,G,12/12/16,CHO,@,IND,L,1,35,4,16,0.25,3,12,0.25,1,4,0.25,3,3,1,1,1,2
7852,Kemba Walker,26-293,G,2/25/17,CHO,@,SAC,W,1,36,5,12,0.417,3,7,0.429,2,5,0.4,0,0,,1,2,3
7853,John Wall,26-051,G,10/27/16,WAS,@,ATL,L,1,30,3,15,0.2,3,13,0.231,0,2,0,6,7,0.857,2,1,3
7854,John Wall,26-176,G,3/1/17,WAS,@,TOR,W,1,34,4,12,0.333,4,10,0.4,0,2,0,4,4,1,1,3,4
7855,John Wall,26-175,G,2/28/17,WAS,,GSW,W,1,40,6,20,0.3,6,19,0.316,0,1,0,0,0,,2,4,6
7856,T.J. Warren,23-197,F,3/21/17,PHO,@,MIA,L,1,31,6,14,0.429,6,14,0.429,0,0,,0,1,0,3,2,5
7857,T.J. Warren,23-064,F,11/8/16,PHO,@,POR,L,1,31,6,12,0.5,6,11,0.545,0,1,0,0,2,0,3,0,3
7858,T.J. Warren,23-131,F,1/14/17,PHO,,SAS,W,1,26,6,10,0.6,6,10,0.6,0,0,,0,0,,0,1,1
7859,C.J. Watson,32-280,G,1/22/17,ORL,,GSW,L,1,36,4,10,0.4,3,5,0.6,1,5,0.2,3,5,0.6,1,1,2
7860,Isaiah Whitehead,21-300,G,1/2/17,BRK,,UTA,L,1,31,4,11,0.364,3,8,0.375,1,3,0.333,3,4,0.75,1,5,6
7861,Isaiah Whitehead,21-353,G,2/24/17,BRK,@,DEN,L,0,19,4,7,0.571,2,4,0.5,2,3,0.667,2,2,1,0,2,2
7862,Hassan Whiteside,27-231,C,1/30/17,MIA,,BRK,W,1,30,6,10,0.6,6,10,0.6,0,0,,0,0,,1,8,9
7863,Hassan Whiteside,27-245,C,2/13/17,MIA,,ORL,L,1,36,5,7,0.714,5,7,0.714,0,0,,2,3,0.667,1,18,19
7864,Hassan Whiteside,27-157,C,11/17/16,MIA,,MIL,W,1,29,5,12,0.417,5,12,0.417,0,0,,2,4,0.5,7,10,17
7865,Hassan Whiteside,27-243,C,2/11/17,MIA,@,PHI,L,1,34,5,11,0.455,5,11,0.455,0,0,,2,2,1,2,17,19
7866,Hassan Whiteside,27-197,C,12/27/16,MIA,,OKC,L,1,31,4,11,0.364,4,11,0.364,0,0,,4,6,0.667,4,4,8
7867,Hassan Whiteside,27-271,C,3/11/17,MIA,,TOR,W,1,33,4,8,0.5,4,8,0.5,0,0,,4,4,1,2,12,14
7868,Alan Williams,24-043,F-C,3/12/17,PHO,,POR,L,0,25,4,11,0.364,4,11,0.364,0,0,,4,5,0.8,2,8,10
7869,Alan Williams,23-296,F-C,11/19/16,PHO,@,PHI,L,0,23,5,8,0.625,5,8,0.625,0,0,,2,4,0.5,4,7,11
7870,Alan Williams,24-048,F-C,3/17/17,PHO,,ORL,L,0,16,4,6,0.667,4,6,0.667,0,0,,4,6,0.667,1,6,7
7871,Deron Williams,32-131,G,11/4/16,DAL,,POR,L,1,37,3,14,0.214,2,7,0.286,1,7,0.143,5,6,0.833,0,5,5
7872,Deron Williams,32-129,G,11/2/16,DAL,@,UTA,L,1,34,5,11,0.455,3,6,0.5,2,5,0.4,0,0,,0,2,2
7873,Deron Williams,32-126,G,10/30/16,DAL,@,HOU,L,1,31,4,11,0.364,1,6,0.167,3,5,0.6,1,2,0.5,0,1,1
7874,Deron Williams,32-234,G,2/15/17,DAL,@,DET,L,1,30,4,14,0.286,2,7,0.286,2,7,0.286,2,2,1,0,2,2
7875,Deron Williams,32-180,G,12/23/16,DAL,@,LAC,W,1,35,5,16,0.313,3,11,0.273,2,5,0.4,0,0,,0,5,5
7876,Derrick Williams,25-260,F,2/9/17,CLE,@,OKC,L,0,22,3,3,1,3,3,1,0,0,,6,8,0.75,0,0,0
7877,Derrick Williams,25-178,F,11/19/16,MIA,@,WAS,W,1,17,5,9,0.556,3,5,0.6,2,4,0.5,0,0,,2,3,5
7878,Lou Williams,29-365,G,10/26/16,LAL,,HOU,W,0,14,2,5,0.4,0,1,0,2,4,0.5,6,7,0.857,0,0,0
7879,Lou Williams,30-132,G,3/8/17,HOU,,UTA,L,0,23,2,10,0.2,0,5,0,2,5,0.4,6,7,0.857,0,3,3
7880,Lou Williams,30-142,G,3/18/17,HOU,@,DEN,W,0,23,4,9,0.444,4,5,0.8,0,4,0,4,5,0.8,0,1,1
7881,Lou Williams,30-051,G,12/17/16,LAL,@,CLE,L,0,27,2,10,0.2,2,6,0.333,0,4,0,8,10,0.8,1,2,3
7882,Marvin Williams,30-171,F,12/7/16,CHO,,DET,W,1,26,5,10,0.5,3,5,0.6,2,5,0.4,0,0,,0,5,5
7883,Marvin Williams,30-235,F,2/9/17,CHO,,HOU,L,1,35,3,8,0.375,2,4,0.5,1,4,0.25,5,6,0.833,1,6,7
7884,Marvin Williams,30-141,F,11/7/16,CHO,,IND,W,1,19,4,10,0.4,2,5,0.4,2,5,0.4,2,3,0.667,0,4,4
7885,Marvin Williams,30-180,F,12/16/16,CHO,@,BOS,L,1,31,5,11,0.455,3,7,0.429,2,4,0.5,0,0,,3,3,6
7886,Marvin Williams,30-264,F,3/10/17,CHO,,ORL,W,1,33,4,6,0.667,4,5,0.8,0,1,0,4,5,0.8,2,16,18
7887,Justise Winslow,20-272,F,12/23/16,MIA,@,NOP,L,1,38,6,15,0.4,6,13,0.462,0,2,0,0,0,,0,7,7
7888,James Young,21-088,G-F,11/12/16,BOS,@,IND,W,0,16,5,6,0.833,3,3,1,2,3,0.667,0,0,,2,1,3
7889,Joe Young,24-161,G,12/5/16,IND,@,GSW,L,0,10,5,10,0.5,5,8,0.625,0,2,0,2,2,1,0,2,2
7890,Nick Young,31-156,G-F,11/4/16,LAL,,GSW,W,1,24,4,11,0.364,3,5,0.6,1,6,0.167,3,3,1,1,2,3
7891,Thaddeus Young,28-137,F,11/5/16,IND,,CHI,W,1,25,6,10,0.6,6,8,0.75,0,2,0,0,0,,3,2,5
7892,Thaddeus Young,28-181,F,12/19/16,IND,,WAS,W,1,38,5,9,0.556,3,6,0.5,2,3,0.667,0,0,,3,8,11
7893,Thaddeus Young,28-179,F,12/17/16,IND,@,DET,W,1,33,6,8,0.75,6,8,0.75,0,0,,0,0,,0,2,2
7894,Thaddeus Young,28-188,F,12/26/16,IND,@,CHI,L,1,32,5,11,0.455,3,6,0.5,2,5,0.4,0,0,,3,3,6
7895,Thaddeus Young,28-225,F,2/1/17,IND,@,ORL,W,1,29,6,11,0.545,6,9,0.667,0,2,0,0,0,,1,4,5
7896,Cody Zeller,24-037,F-C,11/11/16,CHO,,TOR,L,1,26,5,8,0.625,5,8,0.625,0,0,,2,4,0.5,3,4,7
7897,Cody Zeller,24-035,F-C,11/9/16,CHO,,UTA,W,1,27,4,7,0.571,4,7,0.571,0,0,,4,8,0.5,1,2,3
7898,Cody Zeller,24-108,F-C,1/21/17,CHO,,BRK,W,1,31,5,7,0.714,5,7,0.714,0,0,,2,2,1,0,9,9
7899,Cody Zeller,24-061,F-C,12/5/16,CHO,@,DAL,W,1,24,5,5,1,5,5,1,0,0,,2,2,1,1,1,2
7900,Paul Zipser,23-031,G-F,3/21/17,CHI,@,TOR,L,1,41,5,9,0.556,3,4,0.75,2,5,0.4,0,0,,1,4,5
7901,Ivica Zubac,19-313,C,1/25/17,LAL,@,POR,L,0,28,5,15,0.333,5,15,0.333,0,0,,2,2,1,4,6,10
7902,Alex Abrines,23-177,G-F,1/25/17,OKC,@,NOP,W,0,18,4,5,0.8,2,3,0.667,2,2,1,1,1,1,0,0,0
7903,Alex Abrines,23-211,G-F,2/28/17,OKC,,UTA,W,1,26,4,4,1,1,1,1,3,3,1,0,0,,0,0,0
7904,Quincy Acy,26-164,F,3/19/17,BRK,,DAL,L,0,21,2,5,0.4,0,2,0,2,3,0.667,5,7,0.714,1,2,3
7905,Steven Adams,23-106,C,11/3/16,OKC,@,GSW,L,1,24,5,7,0.714,5,7,0.714,0,0,,1,2,0.5,3,1,4
7906,Steven Adams,23-164,C,12/31/16,OKC,,LAC,W,1,29,4,5,0.8,4,5,0.8,0,0,,3,5,0.6,2,3,5
7907,Steven Adams,23-237,C,3/14/17,OKC,@,BRK,W,1,29,4,6,0.667,4,6,0.667,0,0,,3,4,0.75,3,3,6
7908,Steven Adams,23-234,C,3/11/17,OKC,,UTA,W,1,32,5,8,0.625,5,8,0.625,0,0,,1,2,0.5,4,5,9
7909,Steven Adams,23-126,C,11/23/16,OKC,@,SAC,L,1,28,4,7,0.571,4,7,0.571,0,0,,3,4,0.75,0,4,4
7910,Steven Adams,23-210,C,2/15/17,OKC,,NYK,W,1,31,4,9,0.444,4,9,0.444,0,0,,3,4,0.75,4,4,8
7911,Steven Adams,23-232,C,3/9/17,OKC,,SAS,W,1,29,5,8,0.625,5,8,0.625,0,0,,1,5,0.2,3,3,6
7912,Arron Afflalo,31-095,G,1/18/17,SAC,,IND,L,1,31,3,6,0.5,1,2,0.5,2,4,0.5,3,3,1,0,1,1
7913,Arron Afflalo,31-066,G,12/20/16,SAC,,POR,W,0,31,4,7,0.571,3,4,0.75,1,3,0.333,2,3,0.667,0,1,1
7914,Tony Allen,35-052,G-F,3/4/17,MEM,@,HOU,L,1,27,5,11,0.455,4,10,0.4,1,1,1,0,0,,3,3,6
7915,Tony Allen,34-355,G-F,12/31/16,MEM,@,SAC,W,1,21,5,7,0.714,4,6,0.667,1,1,1,0,0,,2,2,4
7916,Tony Allen,35-023,G-F,2/3/17,MEM,@,OKC,L,1,29,4,9,0.444,4,8,0.5,0,1,0,3,4,0.75,2,2,4
7917,Tony Allen,34-312,G-F,11/18/16,MEM,@,DAL,W,0,18,5,6,0.833,5,6,0.833,0,0,,1,1,1,2,1,3
7918,Tony Allen,35-048,G-F,2/28/17,MEM,,PHO,W,1,27,5,7,0.714,5,6,0.833,0,1,0,1,2,0.5,2,2,4
7919,Tony Allen,34-300,G-F,11/6/16,MEM,,POR,L,1,22,3,5,0.6,2,4,0.5,1,1,1,4,4,1,2,5,7
7920,Tony Allen,35-044,G-F,2/24/17,MEM,@,IND,L,1,25,5,9,0.556,4,8,0.5,1,1,1,0,0,,2,5,7
7921,Tony Allen,34-320,G-F,11/26/16,MEM,@,MIA,W,1,34,4,9,0.444,4,8,0.5,0,1,0,3,4,0.75,0,8,8
7922,Tony Allen,34-361,G-F,1/6/17,MEM,@,GSW,W,1,48,5,16,0.313,5,15,0.333,0,1,0,1,2,0.5,6,6,12
7923,Al-Farouq Aminu,26-112,F,1/11/17,POR,,CLE,W,1,31,5,16,0.313,5,11,0.455,0,5,0,1,1,1,5,7,12
7924,Al-Farouq Aminu,26-122,F,1/21/17,POR,@,BOS,W,0,37,2,6,0.333,1,2,0.5,1,4,0.25,6,6,1,1,6,7
7925,Al-Farouq Aminu,26-171,F,3/11/17,POR,,WAS,L,0,34,3,6,0.5,0,2,0,3,4,0.75,2,2,1,0,8,8
7926,Justin Anderson,23-067,G,1/25/17,DAL,,NYK,W,0,20,3,8,0.375,3,4,0.75,0,4,0,5,7,0.714,1,2,3
7927,Justin Anderson,22-355,G,11/8/16,DAL,@,LAL,W,0,21,4,8,0.5,3,7,0.429,1,1,1,2,2,1,2,3,5
7928,Justin Anderson,23-023,G,12/12/16,DAL,,DEN,W,0,24,5,10,0.5,5,6,0.833,0,4,0,1,1,1,1,5,6
7929,Kyle Anderson,23-077,F-G,12/6/16,SAS,@,MIN,W,0,22,2,4,0.5,1,2,0.5,1,2,0.5,6,6,1,0,6,6
7930,Ryan Anderson,28-272,F,2/2/17,HOU,,ATL,L,1,34,4,12,0.333,1,3,0.333,3,9,0.333,0,0,,0,2,2
7931,Ryan Anderson,28-207,F,11/29/16,HOU,@,UTA,L,1,21,4,7,0.571,1,2,0.5,3,5,0.6,0,0,,1,1,2
7932,Ryan Anderson,28-266,F,1/27/17,HOU,@,PHI,W,1,42,3,11,0.273,0,2,0,3,9,0.333,2,2,1,1,4,5
7933,Giannis Antetokounmpo,21-336,F-G,11/6/16,MIL,@,DAL,L,1,26,4,12,0.333,3,7,0.429,1,5,0.2,2,4,0.5,2,5,7
7934,Trevor Ariza,31-251,F,3/8/17,HOU,,UTA,L,1,37,3,6,0.5,0,1,0,3,5,0.6,2,4,0.5,2,3,5
7935,Trevor Ariza,31-224,F,2/9/17,HOU,@,CHO,W,1,42,4,11,0.364,1,1,1,3,10,0.3,0,0,,0,7,7
7936,Trevor Ariza,31-146,F,11/23/16,HOU,,TOR,L,1,31,4,11,0.364,1,2,0.5,3,9,0.333,0,0,,2,0,2
7937,Trevor Ariza,31-160,F,12/7/16,HOU,,LAL,W,1,27,4,6,0.667,3,4,0.75,1,2,0.5,2,2,1,1,1,2
7938,Trevor Ariza,31-170,F,12/17/16,HOU,@,MIN,W,1,38,4,16,0.25,1,5,0.2,3,11,0.273,0,0,,1,4,5
7939,Trevor Ariza,31-201,F,1/17/17,HOU,@,MIA,L,1,39,5,11,0.455,4,6,0.667,1,5,0.2,0,0,,0,7,7
7940,Trevor Ariza,31-124,F,11/1/16,HOU,@,CLE,L,1,31,4,11,0.364,1,1,1,3,10,0.3,0,0,,0,1,1
7941,Trevor Ariza,31-139,F,11/16/16,HOU,@,OKC,L,1,37,4,11,0.364,2,2,1,2,9,0.222,1,1,1,0,7,7
7942,D.J. Augustin,29-017,G,11/27/16,ORL,,MIL,L,1,25,5,7,0.714,4,4,1,1,3,0.333,0,0,,0,2,2
7943,D.J. Augustin,29-043,G,12/23/16,ORL,,LAL,W,1,18,4,5,0.8,1,1,1,3,4,0.75,0,0,,1,1,2
7944,D.J. Augustin,29-089,G,2/7/17,ORL,@,HOU,L,0,24,1,5,0.2,0,2,0,1,3,0.333,8,12,0.667,1,2,3
7945,D.J. Augustin,29-006,G,11/16/16,ORL,,NOP,W,0,18,4,10,0.4,3,6,0.5,1,4,0.25,2,2,1,0,1,1
7946,Luke Babbitt,27-217,F,1/23/17,MIA,,GSW,W,1,26,3,6,0.5,0,2,0,3,4,0.75,2,2,1,1,5,6
7947,Luke Babbitt,27-163,F,11/30/16,MIA,@,DEN,W,1,23,4,9,0.444,1,3,0.333,3,6,0.5,0,0,,0,1,1
7948,Luke Babbitt,27-140,F,11/7/16,MIA,@,OKC,L,1,23,4,8,0.5,3,4,0.75,1,4,0.25,2,2,1,2,2,4
7949,Wade Baldwin,20-252,G,12/6/16,MEM,,PHI,W,0,24,2,6,0.333,2,5,0.4,0,1,0,7,8,0.875,0,1,1
7950,Leandro Barbosa,33-351,G,11/13/16,PHO,@,GSW,L,0,15,5,8,0.625,4,5,0.8,1,3,0.333,0,0,,0,1,1
7951,J.J. Barea,32-176,G,12/19/16,DAL,@,DEN,L,0,13,5,9,0.556,4,7,0.571,1,2,0.5,0,0,,0,3,3
7952,J.J. Barea,32-264,G,3/17/17,DAL,@,PHI,L,0,17,4,10,0.4,2,6,0.333,2,4,0.5,1,2,0.5,1,0,1
7953,Harrison Barnes,24-191,F,12/7/16,DAL,,SAC,L,1,32,5,16,0.313,5,12,0.417,0,4,0,1,2,0.5,2,2,4
7954,Harrison Barnes,24-173,F,11/19/16,DAL,@,ORL,L,1,39,3,13,0.231,2,10,0.2,1,3,0.333,4,5,0.8,1,5,6
7955,Matt Barnes,36-332,F,2/4/17,SAC,,GSW,W,0,34,4,10,0.4,2,6,0.333,2,4,0.5,1,2,0.5,3,14,17
7956,Will Barton,25-359,G,12/30/16,DEN,,PHI,L,0,28,4,13,0.308,3,10,0.3,1,3,0.333,2,3,0.667,0,5,5
7957,Will Barton,26-049,G,2/24/17,DEN,,BRK,W,0,30,3,9,0.333,3,8,0.375,0,1,0,5,7,0.714,0,5,5
7958,Will Barton,25-337,G,12/8/16,DEN,@,WAS,L,1,43,5,13,0.385,4,7,0.571,1,6,0.167,0,0,,2,0,2
7959,Will Barton,26-010,G,1/16/17,DEN,,ORL,W,0,24,5,9,0.556,4,6,0.667,1,3,0.333,0,0,,0,0,0
7960,Will Barton,25-348,G,12/19/16,DEN,,DAL,W,0,24,4,7,0.571,3,4,0.75,1,3,0.333,2,2,1,1,1,2
7961,Brandon Bass,31-240,F,12/26/16,LAC,,DEN,L,0,20,2,4,0.5,2,4,0.5,0,0,,7,8,0.875,1,3,4
7962,Nicolas Batum,28-052,F-G,2/4/17,CHO,@,UTA,L,1,33,4,9,0.444,3,6,0.5,1,3,0.333,2,2,1,0,3,3
7963,Jerryd Bayless,28-097,G,11/25/16,PHI,,CHI,L,1,26,4,10,0.4,3,9,0.333,1,1,1,2,2,1,1,3,4
7964,Kent Bazemore,27-180,G-F,12/28/16,ATL,,NYK,W,1,40,4,12,0.333,3,8,0.375,1,4,0.25,2,2,1,0,1,1
7965,Kent Bazemore,27-124,G-F,11/2/16,ATL,,LAL,L,1,31,5,13,0.385,4,7,0.571,1,6,0.167,0,0,,0,0,0
7966,Kent Bazemore,27-122,G-F,10/31/16,ATL,,SAC,W,1,28,3,9,0.333,2,4,0.5,1,5,0.2,4,4,1,0,2,2
7967,Michael Beasley,28-030,F,2/8/17,MIL,,MIA,L,0,12,4,6,0.667,4,6,0.667,0,0,,3,7,0.429,0,2,2
7968,Michael Beasley,28-049,F,2/27/17,MIL,@,CLE,L,1,9,4,7,0.571,4,7,0.571,0,0,,3,3,1,0,2,2
7969,Michael Beasley,28-006,F,1/15/17,MIL,@,ATL,L,0,18,3,7,0.429,3,6,0.5,0,1,0,5,6,0.833,1,2,3
7970,Michael Beasley,28-004,F,1/13/17,MIL,,MIA,W,0,21,5,5,1,5,5,1,0,0,,1,1,1,0,7,7
7971,Marco Belinelli,30-222,G-F,11/2/16,CHO,,PHI,W,0,21,4,9,0.444,1,3,0.333,3,6,0.5,0,0,,0,3,3
7972,Marco Belinelli,30-266,G-F,12/16/16,CHO,@,BOS,L,0,27,4,13,0.308,3,7,0.429,1,6,0.167,2,3,0.667,2,0,2
7973,Marco Belinelli,30-249,G-F,11/29/16,CHO,,DET,L,0,25,4,10,0.4,3,6,0.5,1,4,0.25,2,2,1,0,2,2
7974,Marco Belinelli,30-358,G-F,3/18/17,CHO,,WAS,W,0,28,3,9,0.333,2,8,0.25,1,1,1,4,5,0.8,0,1,1
7975,Marco Belinelli,30-340,G-F,2/28/17,CHO,@,LAL,W,0,22,4,9,0.444,2,4,0.5,2,5,0.4,1,2,0.5,0,2,2
7976,Marco Belinelli,30-355,G-F,3/15/17,CHO,@,IND,L,0,26,4,10,0.4,2,4,0.5,2,6,0.333,1,2,0.5,0,1,1
7977,Dragan Bender,19-039,F,12/26/16,PHO,@,HOU,L,0,27,5,11,0.455,4,7,0.571,1,4,0.25,0,0,,2,11,13
7978,Anthony Bennett,23-284,F,12/23/16,BRK,@,CLE,L,0,14,4,8,0.5,4,6,0.667,0,2,0,3,4,0.75,1,1,2
7979,Davis Bertans,24-011,F,11/23/16,SAS,@,CHO,W,0,11,4,4,1,1,1,1,3,3,1,0,0,,0,0,0
7980,Davis Bertans,24-072,F,1/23/17,SAS,@,BRK,W,0,12,3,5,0.6,1,1,1,2,4,0.5,3,3,1,0,2,2
7981,Davis Bertans,24-059,F,1/10/17,SAS,,MIL,L,0,19,4,7,0.571,1,1,1,3,6,0.5,0,0,,0,0,0
7982,Patrick Beverley,28-237,G,3/6/17,HOU,@,SAS,L,1,33,4,9,0.444,1,4,0.25,3,5,0.6,0,0,,0,10,10
7983,Patrick Beverley,28-128,G,11/17/16,HOU,,POR,W,1,25,5,8,0.625,4,6,0.667,1,2,0.5,0,0,,1,1,2
7984,Patrick Beverley,28-143,G,12/2/16,HOU,@,DEN,W,1,28,4,9,0.444,2,4,0.5,2,5,0.4,1,2,0.5,1,2,3
7985,Patrick Beverley,28-177,G,1/5/17,HOU,,OKC,W,1,31,4,6,0.667,1,2,0.5,3,4,0.75,0,0,,2,6,8
7986,Patrick Beverley,28-153,G,12/12/16,HOU,,BRK,W,1,32,4,11,0.364,1,4,0.25,3,7,0.429,0,0,,3,2,5
7987,Patrick Beverley,28-167,G,12/26/16,HOU,,PHO,W,1,26,4,10,0.4,1,6,0.167,3,4,0.75,0,0,,0,7,7
7988,Tarik Black,25-098,C-F,2/28/17,LAL,,CHO,L,1,14,5,7,0.714,5,7,0.714,0,0,,1,1,1,2,2,4
7989,Eric Bledsoe,27-079,G,2/26/17,PHO,@,MIL,L,1,34,4,10,0.4,4,8,0.5,0,2,0,3,4,0.75,0,4,4
7990,Eric Bledsoe,27-034,G,1/12/17,PHO,,DAL,L,1,28,2,4,0.5,2,4,0.5,0,0,,7,7,1,1,5,6
7991,Bojan Bogdanovic,27-301,G-F,2/13/17,BRK,,MEM,L,1,25,3,6,0.5,3,4,0.75,0,2,0,5,6,0.833,1,4,5
7992,Bojan Bogdanovic,27-198,G-F,11/2/16,BRK,,DET,W,1,32,3,7,0.429,0,0,,3,7,0.429,2,2,1,1,3,4
7993,Bojan Bogdanovic,27-274,G-F,1/17/17,BRK,,TOR,L,1,21,3,7,0.429,1,2,0.5,2,5,0.4,3,3,1,0,3,3
7994,Bojan Bogdanovic,27-327,G-F,3/11/17,WAS,@,POR,W,0,19,4,9,0.444,2,5,0.4,2,4,0.5,1,2,0.5,0,2,2
7995,Devin Booker,20-142,G,3/21/17,PHO,@,MIA,L,1,34,4,16,0.25,4,12,0.333,0,4,0,3,4,0.75,2,2,4
7996,Devin Booker,20-013,G,11/12/16,PHO,,BRK,L,1,32,5,18,0.278,5,14,0.357,0,4,0,1,1,1,1,5,6
7997,Devin Booker,20-010,G,11/9/16,PHO,,DET,W,1,33,3,9,0.333,2,4,0.5,1,5,0.2,4,5,0.8,0,2,2
7998,Devin Booker,20-026,G,11/25/16,PHO,,MIN,L,1,33,4,10,0.4,3,7,0.429,1,3,0.333,2,2,1,0,2,2
7999,Devin Booker,20-024,G,11/23/16,PHO,@,ORL,W,1,34,4,10,0.4,3,7,0.429,1,3,0.333,2,2,1,0,3,3
8000,Trevor Booker,28-356,F,11/15/16,BRK,@,LAL,L,1,29,5,8,0.625,4,7,0.571,1,1,1,0,0,,3,7,10
8001,Trevor Booker,28-356,F,11/15/16,BRK,@,LAL,L,1,29,5,8,0.625,4,7,0.571,1,1,1,0,0,,3,7,10
8002,Avery Bradley,26-029,G,12/25/16,BOS,@,NYK,W,1,32,5,12,0.417,4,11,0.364,1,1,1,0,0,,0,6,6
8003,Avery Bradley,26-095,G,3/1/17,BOS,,CLE,W,1,22,4,11,0.364,2,6,0.333,2,5,0.4,1,2,0.5,0,2,2
8004,Malcolm Brogdon,23-365,G,12/10/16,MIL,@,WAS,L,0,20,4,7,0.571,1,4,0.25,3,3,1,0,0,,0,1,1
8005,Malcolm Brogdon,24-010,G,12/21/16,MIL,@,CLE,L,0,27,4,7,0.571,3,5,0.6,1,2,0.5,2,4,0.5,0,5,5
8006,Malcolm Brogdon,24-094,G,3/15/17,MIL,@,LAC,W,1,26,5,10,0.5,4,7,0.571,1,3,0.333,0,0,,0,2,2
8007,Malcolm Brogdon,24-036,G,1/16/17,MIL,,PHI,L,1,28,5,11,0.455,4,9,0.444,1,2,0.5,0,0,,0,2,2
8008,Malcolm Brogdon,24-019,G,12/30/16,MIL,@,MIN,L,1,33,4,8,0.5,3,6,0.5,1,2,0.5,2,2,1,1,3,4
8009,Malcolm Brogdon,24-048,G,1/28/17,MIL,,BOS,L,0,32,4,12,0.333,4,9,0.444,0,3,0,3,3,1,1,1,2
8010,Jaylen Brown,20-025,F,11/18/16,BOS,,GSW,L,0,23,4,9,0.444,2,3,0.667,2,6,0.333,1,2,0.5,0,1,1
8011,Jaylen Brown,20-104,F,2/5/17,BOS,,LAC,W,1,25,4,10,0.4,3,5,0.6,1,5,0.2,2,4,0.5,0,3,3
8012,Jaylen Brown,20-139,F,3/12/17,BOS,,CHI,W,0,26,4,9,0.444,1,3,0.333,3,6,0.5,0,0,,0,3,3
8013,Nicolas Brussino,24-013,G-F,3/15/17,DAL,@,WAS,W,0,23,4,5,0.8,1,1,1,3,4,0.75,0,0,,2,7,9
8014,Trey Burke,24-093,G,2/13/17,WAS,,OKC,W,0,26,4,8,0.5,4,6,0.667,0,2,0,3,3,1,0,4,4
8015,Alec Burks,25-190,G,1/26/17,UTA,,LAL,W,0,14,5,9,0.556,4,7,0.571,1,2,0.5,0,1,0,0,1,1
8016,Kentavious Caldwell-Pope,23-300,G,12/14/16,DET,@,DAL,W,1,36,4,9,0.444,3,5,0.6,1,4,0.25,2,2,1,0,2,2
8017,Kentavious Caldwell-Pope,24-024,G,3/14/17,DET,@,CLE,L,1,27,3,10,0.3,3,8,0.375,0,2,0,5,5,1,1,1,2
8018,Isaiah Canaan,25-161,G,10/29/16,CHI,,IND,W,0,14,4,6,0.667,1,1,1,3,5,0.6,0,0,,0,0,0
8019,Clint Capela,22-201,F-C,12/5/16,HOU,,BOS,W,1,22,5,7,0.714,5,7,0.714,0,0,,1,2,0.5,2,7,9
8020,Clint Capela,22-267,F-C,2/9/17,HOU,@,CHO,W,1,26,5,8,0.625,5,8,0.625,0,0,,1,3,0.333,4,4,8
8021,DeMarre Carroll,30-226,F,3/10/17,TOR,@,ATL,L,1,33,3,9,0.333,3,6,0.5,0,3,0,5,7,0.714,3,4,7
8022,DeMarre Carroll,30-114,F,11/18/16,TOR,@,DEN,W,1,22,4,9,0.444,3,5,0.6,1,4,0.25,2,2,1,0,3,3
8023,DeMarre Carroll,30-167,F,1/10/17,TOR,,BOS,W,1,35,4,10,0.4,1,4,0.25,3,6,0.5,0,0,,1,3,4
8024,DeMarre Carroll,30-182,F,1/25/17,TOR,@,MEM,L,1,22,5,9,0.556,4,6,0.667,1,3,0.333,0,0,,1,5,6
8025,Vince Carter,40-029,G-F,2/24/17,MEM,@,IND,L,0,24,3,6,0.5,1,3,0.333,2,3,0.667,3,4,0.75,1,2,3
8026,Vince Carter,39-351,G-F,1/11/17,MEM,@,OKC,L,0,29,3,6,0.5,0,2,0,3,4,0.75,2,4,0.5,1,2,3
8027,Vince Carter,39-344,G-F,1/4/17,MEM,@,LAC,L,0,30,4,10,0.4,1,5,0.2,3,5,0.6,0,2,0,2,5,7
8028,Vince Carter,39-285,G-F,11/6/16,MEM,,POR,L,0,26,4,10,0.4,3,5,0.6,1,5,0.2,2,2,1,2,3,5
8029,Vince Carter,39-360,G-F,1/20/17,MEM,,SAC,W,0,22,3,5,0.6,1,1,1,2,4,0.5,3,3,1,0,4,4
8030,Vince Carter,40-009,G-F,2/4/17,MEM,@,MIN,W,0,31,3,7,0.429,0,2,0,3,5,0.6,2,2,1,0,3,3
8031,Michael Carter-Williams,25-096,G,1/14/17,CHI,,NOP,W,1,29,5,12,0.417,5,11,0.455,0,1,0,1,2,0.5,0,3,3
8032,Willie Cauley-Stein,23-118,F-C,12/14/16,SAC,@,HOU,L,0,23,5,8,0.625,5,8,0.625,0,0,,1,1,1,1,4,5
8033,Willie Cauley-Stein,23-090,F-C,11/16/16,SAC,,SAS,L,0,13,3,5,0.6,3,5,0.6,0,0,,5,7,0.714,1,3,4
8034,Tyson Chandler,34-127,C,2/6/17,PHO,@,NOP,L,1,24,3,6,0.5,3,6,0.5,0,0,,5,6,0.833,5,8,13
8035,Tyson Chandler,34-122,C,2/1/17,PHO,,LAC,L,1,27,5,5,1,5,5,1,0,0,,1,2,0.5,1,3,4
8036,Wilson Chandler,29-172,F,10/29/16,DEN,,POR,L,0,30,5,11,0.455,4,8,0.5,1,3,0.333,0,2,0,1,6,7
8037,Wilson Chandler,29-240,F,1/5/17,DEN,,SAS,L,0,24,5,10,0.5,4,6,0.667,1,4,0.25,0,0,,1,6,7
8038,Marquese Chriss,19-241,F,2/28/17,PHO,@,MEM,L,1,33,4,8,0.5,3,5,0.6,1,3,0.333,2,3,0.667,2,4,6
8039,Marquese Chriss,19-154,F,12/3/16,PHO,@,GSW,L,1,25,3,8,0.375,2,4,0.5,1,4,0.25,4,4,1,2,2,4
8040,Semaj Christon,24-062,G,1/2/17,OKC,@,MIL,L,0,12,5,6,0.833,4,4,1,1,2,0.5,0,2,0,0,1,1
8041,Ian Clark,25-273,G,12/5/16,GSW,,IND,W,0,19,5,9,0.556,4,6,0.667,1,3,0.333,0,0,,1,0,1
8042,Ian Clark,25-332,G,2/2/17,GSW,@,LAC,W,0,21,5,9,0.556,4,7,0.571,1,2,0.5,0,0,,0,1,1
8043,Jordan Clarkson,24-248,G,2/10/17,LAL,@,MIL,W,0,21,4,9,0.444,1,3,0.333,3,6,0.5,0,0,,0,0,0
8044,Darren Collison,29-190,G,3/1/17,SAC,,BRK,L,1,31,5,10,0.5,4,9,0.444,1,1,1,0,0,,0,4,4
8045,Darren Collison,29-115,G,12/16/16,SAC,@,MEM,W,1,38,4,13,0.308,3,10,0.3,1,3,0.333,2,2,1,0,2,2
8046,Darren Collison,29-148,G,1/18/17,SAC,,IND,L,1,37,4,8,0.5,4,8,0.5,0,0,,3,4,0.75,0,2,2
8047,Mike Conley,29-106,G,1/25/17,MEM,,TOR,W,1,36,4,16,0.25,3,12,0.25,1,4,0.25,2,2,1,1,2,3
8048,Mike Conley,29-018,G,10/29/16,MEM,@,NYK,L,1,24,4,9,0.444,4,8,0.5,0,1,0,3,4,0.75,2,3,5
8049,DeMarcus Cousins,26-210,C-F,3/11/17,NOP,@,CHO,W,1,25,4,11,0.364,3,9,0.333,1,2,0.5,2,5,0.4,0,4,4
8050,Robert Covington,26-054,F,2/6/17,PHI,@,DET,L,1,29,2,10,0.2,0,5,0,2,5,0.4,5,7,0.714,1,3,4
8051,Robert Covington,26-033,F,1/16/17,PHI,@,MIL,W,1,28,4,8,0.5,2,2,1,2,6,0.333,1,2,0.5,2,4,6
8052,Robert Covington,26-030,F,1/13/17,PHI,,CHO,W,1,28,4,10,0.4,1,4,0.25,3,6,0.5,0,0,,2,4,6
8053,Robert Covington,26-042,F,1/25/17,PHI,@,MIL,W,1,35,3,9,0.333,2,4,0.5,1,5,0.2,4,4,1,1,4,5
8054,Robert Covington,25-334,F,11/12/16,PHI,@,ATL,L,1,26,3,8,0.375,0,1,0,3,7,0.429,2,2,1,0,3,3
8055,Robert Covington,26-006,F,12/20/16,PHI,,NOP,L,1,34,4,11,0.364,2,5,0.4,2,6,0.333,1,2,0.5,1,7,8
8056,Allen Crabbe,24-346,G-F,3/21/17,POR,,MIL,L,0,31,4,11,0.364,3,6,0.5,1,5,0.2,2,2,1,0,5,5
8057,Allen Crabbe,24-327,G-F,3/2/17,POR,,OKC,W,0,24,4,8,0.5,2,4,0.5,2,4,0.5,1,1,1,0,1,1
8058,Allen Crabbe,24-248,G-F,12/13/16,POR,,OKC,W,0,26,4,8,0.5,2,5,0.4,2,3,0.667,1,2,0.5,1,2,3
8059,Allen Crabbe,24-265,G-F,12/30/16,POR,@,SAS,L,1,33,5,9,0.556,4,7,0.571,1,2,0.5,0,0,,0,1,1
8060,Jamal Crawford,36-330,G,2/13/17,LAC,@,UTA,W,0,22,5,9,0.556,4,6,0.667,1,3,0.333,0,0,,0,2,2
8061,Jamal Crawford,36-277,G,12/22/16,LAC,,SAS,W,0,28,5,9,0.556,4,6,0.667,1,3,0.333,0,0,,0,1,1
8062,Jamal Crawford,36-358,G,3/13/17,LAC,@,UTA,L,0,16,4,8,0.5,3,6,0.5,1,2,0.5,2,2,1,0,1,1
8063,Jamal Crawford,36-254,G,11/29/16,LAC,@,BRK,L,0,35,4,15,0.267,3,11,0.273,1,4,0.25,2,2,1,0,3,3
8064,Jae Crowder,26-214,F,2/5/17,BOS,,LAC,W,1,34,4,11,0.364,1,2,0.5,3,9,0.333,0,0,,0,6,6
8065,Dante Cunningham,29-327,F,3/15/17,NOP,@,MIA,L,0,23,5,7,0.714,4,5,0.8,1,2,0.5,0,0,,1,2,3
8066,Dante Cunningham,29-248,F,12/26/16,NOP,,DAL,W,1,37,4,7,0.571,3,4,0.75,1,3,0.333,2,2,1,0,6,6
8067,Dante Cunningham,29-276,F,1/23/17,NOP,,CLE,W,1,31,4,10,0.4,2,3,0.667,2,7,0.286,1,2,0.5,1,5,6
8068,Seth Curry,26-129,G,12/30/16,DAL,@,GSW,L,0,26,4,8,0.5,3,5,0.6,1,3,0.333,2,2,1,1,0,1
8069,Seth Curry,26-126,G,12/27/16,DAL,,HOU,L,0,22,4,10,0.4,1,4,0.25,3,6,0.5,0,0,,1,2,3
8070,Seth Curry,26-087,G,11/18/16,DAL,,MEM,L,1,34,4,14,0.286,2,10,0.2,2,4,0.5,1,1,1,2,2,4
8071,Seth Curry,26-156,G,1/26/17,DAL,@,OKC,L,1,34,4,12,0.333,1,6,0.167,3,6,0.5,0,0,,0,1,1
8072,Stephen Curry,28-336,G,2/13/17,GSW,@,DEN,L,1,27,4,18,0.222,3,7,0.429,1,11,0.091,2,2,1,1,1,2
8073,Troy Daniels,25-246,G,3/18/17,MEM,,SAS,W,0,20,4,9,0.444,1,3,0.333,3,6,0.5,0,0,,0,0,0
8074,Troy Daniels,25-204,G,2/4/17,MEM,@,MIN,W,0,15,4,8,0.5,2,2,1,2,6,0.333,1,2,0.5,0,0,0
8075,Troy Daniels,25-169,G,12/31/16,MEM,@,SAC,W,0,12,4,8,0.5,1,3,0.333,3,5,0.6,0,0,,0,1,1
8076,Ed Davis,27-253,F,2/13/17,POR,,ATL,L,0,27,5,8,0.625,5,8,0.625,0,0,,1,6,0.167,6,7,13
8077,Dewayne Dedmon,27-125,C,12/15/16,SAS,@,PHO,W,0,23,5,6,0.833,5,6,0.833,0,0,,1,2,0.5,1,8,9
8078,Dewayne Dedmon,27-198,C,2/26/17,SAS,@,LAL,W,1,20,4,4,1,4,4,1,0,0,,3,4,0.75,4,5,9
8079,Sam Dekker,22-209,F,12/1/16,HOU,@,GSW,W,0,26,4,9,0.444,2,6,0.333,2,3,0.667,1,2,0.5,4,4,8
8080,Malcolm Delaney,27-299,G,1/4/17,ATL,@,ORL,W,0,20,5,7,0.714,4,6,0.667,1,1,1,0,0,,0,3,3
8081,Matthew Dellavedova,26-078,G,11/25/16,MIL,,TOR,L,1,29,4,9,0.444,1,4,0.25,3,5,0.6,0,1,0,1,2,3
8082,Matthew Dellavedova,26-111,G,12/28/16,MIL,@,DET,W,1,20,4,7,0.571,2,5,0.4,2,2,1,1,1,1,0,2,2
8083,Matthew Dellavedova,26-092,G,12/9/16,MIL,,ATL,L,1,27,4,12,0.333,3,8,0.375,1,4,0.25,2,3,0.667,0,4,4
8084,Matthew Dellavedova,26-054,G,11/1/16,MIL,@,NOP,W,1,29,4,8,0.5,2,4,0.5,2,4,0.5,1,1,1,0,4,4
8085,Matthew Dellavedova,26-141,G,1/27/17,MIL,@,TOR,L,1,23,3,9,0.333,0,3,0,3,6,0.5,2,2,1,1,1,2
8086,Matthew Dellavedova,26-048,G,10/26/16,MIL,,CHO,L,1,29,5,10,0.5,4,7,0.571,1,3,0.333,0,0,,0,3,3
8087,Luol Deng,31-242,F,12/14/16,LAL,@,BRK,L,1,32,5,12,0.417,4,8,0.5,1,4,0.25,0,2,0,3,5,8
8088,Luol Deng,31-251,F,12/23/16,LAL,@,ORL,L,1,31,3,8,0.375,2,6,0.333,1,2,0.5,4,4,1,1,9,10
8089,Luol Deng,31-267,F,1/8/17,LAL,,ORL,W,1,31,4,11,0.364,2,5,0.4,2,6,0.333,1,2,0.5,1,2,3
8090,Luol Deng,31-248,F,12/20/16,LAL,@,CHO,L,1,34,5,10,0.5,4,6,0.667,1,4,0.25,0,0,,0,7,7
8091,DeMar DeRozan,27-209,G,3/4/17,TOR,@,MIL,L,1,31,5,13,0.385,5,12,0.417,0,1,0,1,1,1,0,3,3
8092,Boris Diaw,34-246,F-C,12/18/16,UTA,@,MEM,W,1,30,4,5,0.8,3,4,0.75,1,1,1,2,2,1,1,5,6
8093,Boris Diaw,34-221,F-C,11/23/16,UTA,,DEN,W,0,23,4,7,0.571,3,5,0.6,1,2,0.5,2,3,0.667,0,3,3
8094,Gorgui Dieng,26-355,C,1/7/17,MIN,,UTA,L,1,40,4,11,0.364,3,9,0.333,1,2,0.5,2,2,1,1,7,8
8095,Gorgui Dieng,27-021,C,2/8/17,MIN,,TOR,W,1,32,4,8,0.5,3,7,0.429,1,1,1,2,2,1,3,6,9
8096,Gorgui Dieng,26-315,C,11/28/16,MIN,,UTA,L,1,32,3,8,0.375,3,8,0.375,0,0,,5,5,1,4,2,6
8097,Gorgui Dieng,26-328,C,12/11/16,MIN,,GSW,L,1,36,4,10,0.4,4,10,0.4,0,0,,3,4,0.75,3,3,6
8098,Gorgui Dieng,26-312,C,11/25/16,MIN,@,PHO,W,1,37,4,10,0.4,3,8,0.375,1,2,0.5,2,2,1,4,3,7
8099,Toney Douglas,30-331,G,2/10/17,MEM,,GSW,L,0,18,3,8,0.375,2,4,0.5,1,4,0.25,4,4,1,0,1,1
8100,Toney Douglas,30-329,G,2/8/17,MEM,,PHO,W,0,25,2,6,0.333,1,4,0.25,1,2,0.5,6,6,1,1,3,4
8101,Toney Douglas,30-331,G,2/10/17,MEM,,GSW,L,0,18,3,8,0.375,2,4,0.5,1,4,0.25,4,4,1,0,1,1
8102,Goran Dragic,30-185,G,11/7/16,MIA,@,OKC,L,1,25,5,12,0.417,5,11,0.455,0,1,0,1,1,1,0,1,1
8103,Goran Dragic,30-222,G,12/14/16,MIA,,IND,W,1,35,4,15,0.267,4,13,0.308,0,2,0,3,4,0.75,0,5,5
8104,Andre Drummond,23-138,C,12/26/16,DET,,CLE,W,1,28,5,15,0.333,5,14,0.357,0,1,0,1,7,0.143,7,10,17
8105,Mike Dunleavy,36-047,F-G,11/1/16,CLE,,HOU,W,0,18,3,4,0.75,1,1,1,2,3,0.667,3,4,0.75,0,4,4
8106,Mike Dunleavy,36-090,F-G,12/14/16,CLE,@,MEM,L,1,23,3,6,0.5,1,2,0.5,2,4,0.5,3,5,0.6,1,5,6
8107,Mike Dunleavy,36-139,F-G,2/1/17,ATL,@,MIA,L,0,20,3,7,0.429,2,2,1,1,5,0.2,4,4,1,2,4,6
8108,Kris Dunn,22-289,G,1/1/17,MIN,,POR,L,0,21,5,7,0.714,4,6,0.667,1,1,1,0,0,,0,3,3
8109,Wayne Ellington,29-044,G,12/12/16,MIA,,WAS,W,1,33,3,11,0.273,1,2,0.5,2,9,0.222,3,3,1,0,2,2
8110,Wayne Ellington,29-098,G,2/4/17,MIA,,PHI,W,0,16,4,7,0.571,2,3,0.667,2,4,0.5,1,1,1,1,1,2
8111,Wayne Ellington,29-133,G,3/11/17,MIA,,TOR,W,0,19,3,8,0.375,0,0,,3,8,0.375,2,2,1,0,3,3
8112,Wayne Ellington,29-143,G,3/21/17,MIA,,PHO,W,0,27,4,8,0.5,1,2,0.5,3,6,0.5,0,0,,0,1,1
8113,Monta Ellis,31-126,G,3/1/17,IND,@,SAS,L,0,24,5,9,0.556,5,8,0.625,0,1,0,1,4,0.25,1,2,3
8114,Monta Ellis,31-002,G,10/28/16,IND,@,BRK,L,1,33,5,12,0.417,5,12,0.417,0,0,,1,2,0.5,1,1,2
8115,Joel Embiid,22-279,C-F,12/20/16,PHI,,NOP,L,1,25,4,12,0.333,4,9,0.444,0,3,0,3,5,0.6,0,6,6
8116,James Ennis,26-141,F,11/19/16,MEM,,MIN,W,1,36,4,11,0.364,4,8,0.5,0,3,0,3,4,0.75,3,4,7
8117,James Ennis,26-179,F,12/27/16,MEM,@,BOS,L,1,22,4,7,0.571,1,3,0.333,3,4,0.75,0,0,,0,1,1
8118,James Ennis,26-178,F,12/26/16,MEM,@,ORL,L,0,22,3,4,0.75,1,2,0.5,2,2,1,3,4,0.75,1,1,2
8119,Tyreke Evans,27-159,G-F,2/25/17,SAC,,CHO,L,1,22,4,10,0.4,4,7,0.571,0,3,0,3,3,1,0,5,5
8120,Tyreke Evans,27-130,G-F,1/27/17,NOP,,SAS,W,0,21,5,11,0.455,4,8,0.5,1,3,0.333,0,0,,0,2,2
8121,Dante Exum,21-210,G,2/8/17,UTA,@,NOP,W,0,23,5,7,0.714,4,5,0.8,1,2,0.5,0,0,,0,3,3
8122,Dante Exum,21-206,G,2/4/17,UTA,,CHO,W,0,22,5,12,0.417,4,8,0.5,1,4,0.25,0,0,,0,1,1
8123,Dante Exum,21-156,G,12/16/16,UTA,,DAL,W,1,19,4,6,0.667,3,3,1,1,3,0.333,2,2,1,0,1,1
8124,Dante Exum,21-117,G,11/7/16,UTA,@,PHI,W,0,20,4,6,0.667,1,2,0.5,3,4,0.75,0,0,,1,1,2
8125,Kenneth Faried,27-074,F,2/1/17,DEN,,MEM,L,1,28,5,6,0.833,5,6,0.833,0,0,,1,1,1,5,6,11
8126,Kenneth Faried,27-119,F,3/18/17,DEN,,HOU,L,0,23,5,7,0.714,5,7,0.714,0,0,,1,2,0.5,3,5,8
8127,Kenneth Faried,27-026,F,12/15/16,DEN,,POR,W,0,26,3,5,0.6,3,5,0.6,0,0,,5,6,0.833,2,7,9
8128,Kenneth Faried,27-066,F,1/24/17,DEN,,UTA,W,1,28,4,8,0.5,4,8,0.5,0,0,,3,6,0.5,2,5,7
8129,Derrick Favors,25-185,F-C,1/16/17,UTA,@,PHO,W,1,24,5,11,0.455,5,11,0.455,0,0,,1,3,0.333,3,1,4
8130,Kay Felder,21-272,G,12/26/16,CLE,@,DET,L,0,20,2,8,0.25,2,7,0.286,0,1,0,7,8,0.875,0,3,3
8131,Kay Felder,21-269,G,12/23/16,CLE,,BRK,W,0,16,4,7,0.571,4,5,0.8,0,2,0,3,4,0.75,0,1,1
8132,Cristiano Felicio,24-209,F-C,2/1/17,CHI,@,OKC,W,0,24,3,3,1,3,3,1,0,0,,5,8,0.625,0,4,4
8133,Cristiano Felicio,24-244,F-C,3/8/17,CHI,@,ORL,L,0,12,5,7,0.714,5,7,0.714,0,0,,1,2,0.5,0,2,2
8134,Cristiano Felicio,24-186,F-C,1/9/17,CHI,,OKC,L,0,24,5,6,0.833,5,6,0.833,0,0,,1,1,1,4,7,11
8135,Raymond Felton,32-234,G,2/15/17,LAC,,ATL,W,0,27,5,6,0.833,4,4,1,1,2,0.5,0,0,,1,3,4
8136,Raymond Felton,32-192,G,1/4/17,LAC,,MEM,W,1,37,4,9,0.444,4,9,0.444,0,0,,3,4,0.75,0,4,4
8137,Raymond Felton,32-141,G,11/14/16,LAC,,BRK,W,0,22,4,6,0.667,1,2,0.5,3,4,0.75,0,0,,0,0,0
8138,Raymond Felton,32-256,G,3/9/17,LAC,@,MEM,W,0,26,5,10,0.5,4,7,0.571,1,3,0.333,0,0,,0,4,4
8139,Yogi Ferrell,23-296,G,3/1/17,DAL,@,ATL,L,1,32,5,10,0.5,4,7,0.571,1,3,0.333,0,0,,0,2,2
8140,Yogi Ferrell,23-268,G,2/1/17,DAL,,PHI,W,1,38,3,13,0.231,3,9,0.333,0,4,0,5,5,1,1,2,3
8141,Yogi Ferrell,23-190,G,11/15/16,BRK,@,LAL,L,0,19,3,5,0.6,1,2,0.5,2,3,0.667,3,4,0.75,0,1,1
8142,Dorian Finney-Smith,23-220,F,12/10/16,DAL,@,HOU,L,1,30,5,9,0.556,4,6,0.667,1,3,0.333,0,0,,1,3,4
8143,Dorian Finney-Smith,23-267,F,1/26/17,DAL,@,OKC,L,1,41,3,7,0.429,1,3,0.333,2,4,0.5,3,4,0.75,1,4,5
8144,Dorian Finney-Smith,23-213,F,12/3/16,DAL,,CHI,W,1,35,3,5,0.6,1,1,1,2,4,0.5,3,4,0.75,1,1,2
8145,Evan Fournier,24-021,G-F,11/19/16,ORL,,DAL,W,1,32,3,13,0.231,1,7,0.143,2,6,0.333,3,3,1,2,5,7
8146,Evan Fournier,24-125,G-F,3/3/17,ORL,,MIA,W,1,34,4,10,0.4,3,9,0.333,1,1,1,2,3,0.667,0,2,2
8147,Evan Fournier,24-027,G-F,11/25/16,ORL,,WAS,L,1,32,2,9,0.222,1,5,0.2,1,4,0.25,6,6,1,2,0,2
8148,Randy Foye,33-176,G,3/19/17,BRK,,DAL,L,1,28,3,7,0.429,2,4,0.5,1,3,0.333,4,4,1,0,6,6
8149,Randy Foye,33-119,G,1/21/17,BRK,@,CHO,L,0,24,4,12,0.333,1,5,0.2,3,7,0.429,0,0,,0,2,2
8150,Randy Foye,33-095,G,12/28/16,BRK,@,CHI,L,0,28,5,9,0.556,4,5,0.8,1,4,0.25,0,2,0,0,5,5
8151,Randy Foye,33-118,G,1/20/17,BRK,@,NOP,W,0,22,4,7,0.571,1,2,0.5,3,5,0.6,0,0,,0,3,3
8152,Tim Frazier,26-024,G,11/25/16,NOP,@,POR,L,1,32,3,12,0.25,2,9,0.222,1,3,0.333,4,5,0.8,0,1,1
8153,Tim Frazier,26-022,G,11/23/16,NOP,,MIN,W,1,33,4,5,0.8,2,3,0.667,2,2,1,1,1,1,0,4,4
8154,Tim Frazier,26-099,G,2/8/17,NOP,,UTA,L,0,24,1,4,0.25,1,3,0.333,0,1,0,9,10,0.9,0,3,3
8155,Tim Frazier,26-047,G,12/18/16,NOP,@,SAS,L,0,24,4,7,0.571,1,2,0.5,3,5,0.6,0,0,,0,3,3
8156,Channing Frye,33-170,C-F,11/3/16,CLE,,BOS,W,0,15,4,7,0.571,1,4,0.25,3,3,1,0,0,,0,1,1
8157,Channing Frye,33-284,C-F,2/25/17,CLE,,CHI,L,1,32,4,11,0.364,1,4,0.25,3,7,0.429,0,0,,0,5,5
8158,Channing Frye,33-168,C-F,11/1/16,CLE,,HOU,W,0,15,4,12,0.333,3,9,0.333,1,3,0.333,2,2,1,1,3,4
8159,Channing Frye,33-223,C-F,12/26/16,CLE,@,DET,L,0,18,4,8,0.5,1,3,0.333,3,5,0.6,0,0,,0,4,4
8160,Channing Frye,33-290,C-F,3/3/17,CLE,@,ATL,W,1,25,4,7,0.571,1,1,1,3,6,0.5,0,0,,1,3,4
8161,Channing Frye,33-199,C-F,12/2/16,CLE,@,CHI,L,0,21,5,6,0.833,4,4,1,1,2,0.5,0,0,,0,2,2
8162,Danilo Gallinari,28-094,F,11/10/16,DEN,,GSW,L,1,26,2,9,0.222,1,4,0.25,1,5,0.2,6,7,0.857,0,1,1
8163,Danilo Gallinari,28-169,F,1/24/17,DEN,,UTA,W,1,31,3,10,0.3,2,9,0.222,1,1,1,4,4,1,0,3,3
8164,Langston Galloway,25-014,G,12/23/16,NOP,,MIA,W,0,29,4,11,0.364,1,4,0.25,3,7,0.429,0,0,,0,1,1
8165,Marc Gasol,31-332,C,12/26/16,MEM,@,ORL,L,1,28,4,9,0.444,4,8,0.5,0,1,0,3,4,0.75,0,4,4
8166,Marc Gasol,31-294,C,11/18/16,MEM,@,DAL,W,1,24,5,12,0.417,4,11,0.364,1,1,1,0,0,,0,3,3
8167,Pau Gasol,36-258,F-C,3/21/17,SAS,@,MIN,W,0,24,4,7,0.571,3,4,0.75,1,3,0.333,2,2,1,0,6,6
8168,Pau Gasol,36-153,F-C,12/6/16,SAS,@,MIN,W,1,26,4,10,0.4,2,7,0.286,2,3,0.667,1,2,0.5,1,6,7
8169,Pau Gasol,36-122,F-C,11/5/16,SAS,,LAC,L,1,21,3,5,0.6,2,3,0.667,1,2,0.5,4,6,0.667,1,3,4
8170,Rudy Gay,30-091,F,11/16/16,SAC,,SAS,L,1,32,3,11,0.273,2,9,0.222,1,2,0.5,4,4,1,1,2,3
8171,Rudy Gay,30-146,F,1/10/17,SAC,,DET,W,1,38,3,11,0.273,2,9,0.222,1,2,0.5,4,4,1,2,5,7
8172,Jonathan Gibson,29-015,G,11/23/16,DAL,,LAC,L,0,26,3,10,0.3,2,5,0.4,1,5,0.2,4,4,1,0,0,0
8173,Jonathan Gibson,29-010,G,11/18/16,DAL,,MEM,L,0,20,3,6,0.5,3,3,1,0,3,0,5,8,0.625,0,4,4
8174,Jonathan Gibson,29-023,G,12/1/16,DAL,@,CHO,L,0,27,5,15,0.333,4,11,0.364,1,4,0.25,0,2,0,0,2,2
8175,Taj Gibson,31-162,F,12/3/16,CHI,@,DAL,L,1,27,5,8,0.625,5,8,0.625,0,0,,1,2,0.5,1,3,4
8176,Taj Gibson,31-190,F,12/31/16,CHI,,MIL,L,1,28,3,12,0.25,3,12,0.25,0,0,,5,5,1,4,1,5
8177,Taj Gibson,31-159,F,11/30/16,CHI,,LAL,L,1,31,4,9,0.444,4,9,0.444,0,0,,3,6,0.5,1,9,10
8178,Taj Gibson,31-148,F,11/19/16,CHI,@,LAC,L,1,32,5,8,0.625,5,8,0.625,0,0,,1,2,0.5,0,4,4
8179,Taj Gibson,31-165,F,12/6/16,CHI,@,DET,L,1,29,5,10,0.5,5,9,0.556,0,1,0,1,2,0.5,1,9,10
8180,Manu Ginobili,39-161,G,1/5/17,SAS,@,DEN,W,0,18,4,10,0.4,1,4,0.25,3,6,0.5,0,0,,0,3,3
8181,Manu Ginobili,39-236,G,3/21/17,SAS,@,MIN,W,0,19,4,7,0.571,3,4,0.75,1,3,0.333,2,2,1,2,1,3
8182,Rudy Gobert,24-260,C,3/13/17,UTA,,LAC,W,1,37,5,6,0.833,5,6,0.833,0,0,,1,1,1,3,7,10
8183,Rudy Gobert,24-198,C,1/10/17,UTA,,CLE,W,1,36,5,7,0.714,5,7,0.714,0,0,,1,1,1,4,10,14
8184,Rudy Gobert,24-212,C,1/24/17,UTA,@,DEN,L,1,25,4,8,0.5,4,8,0.5,0,0,,3,5,0.6,3,6,9
8185,Rudy Gobert,24-250,C,3/3/17,UTA,,BRK,W,1,33,4,4,1,4,4,1,0,0,,3,6,0.5,0,7,7
8186,Rudy Gobert,24-177,C,12/20/16,UTA,@,GSW,L,1,31,5,6,0.833,5,6,0.833,0,0,,1,3,0.333,2,14,16
8187,Aaron Gordon,21-085,F,12/10/16,ORL,,DEN,L,1,22,4,7,0.571,3,4,0.75,1,3,0.333,2,2,1,1,5,6
8188,Aaron Gordon,21-152,F,2/15/17,ORL,,SAS,L,1,33,3,9,0.333,3,7,0.429,0,2,0,5,5,1,2,4,6
8189,Aaron Gordon,21-059,F,11/14/16,ORL,@,IND,L,0,22,5,11,0.455,4,7,0.571,1,4,0.25,0,0,,0,3,3
8190,Aaron Gordon,21-074,F,11/29/16,ORL,@,SAS,W,1,19,5,9,0.556,4,8,0.5,1,1,1,0,0,,2,1,3
8191,Eric Gordon,27-318,G,11/7/16,HOU,@,WAS,W,0,32,4,10,0.4,1,4,0.25,3,6,0.5,0,0,,0,1,1
8192,Marcin Gortat,33-007,C-F,2/24/17,WAS,@,PHI,L,1,36,3,10,0.3,3,10,0.3,0,0,,5,8,0.625,5,6,11
8193,Marcin Gortat,33-019,C-F,3/8/17,WAS,@,DEN,W,1,33,5,10,0.5,5,10,0.5,0,0,,1,4,0.25,3,12,15
8194,Jerami Grant,22-247,F,11/14/16,OKC,@,DET,L,0,26,5,8,0.625,4,4,1,1,4,0.25,0,0,,1,4,5
8195,Jerami Grant,22-276,F,12/13/16,OKC,@,POR,L,1,26,3,8,0.375,3,7,0.429,0,1,0,5,6,0.833,0,1,1
8196,Jerian Grant,24-092,G,1/9/17,CHI,,OKC,L,0,21,4,7,0.571,3,4,0.75,1,3,0.333,2,2,1,0,2,2
8197,Danny Green,29-156,G-F,11/25/16,SAS,@,BOS,W,1,32,3,4,0.75,0,0,,3,4,0.75,2,2,1,0,7,7
8198,Danny Green,29-189,G-F,12/28/16,SAS,,PHO,W,1,30,4,8,0.5,1,2,0.5,3,6,0.5,0,0,,2,1,3
8199,Danny Green,29-231,G-F,2/8/17,SAS,@,PHI,W,1,25,4,8,0.5,1,4,0.25,3,4,0.75,0,0,,0,4,4
8200,Danny Green,29-161,G-F,11/30/16,SAS,@,DAL,W,1,28,4,8,0.5,2,4,0.5,2,4,0.5,1,2,0.5,1,2,3
8201,Draymond Green,26-318,F,1/16/17,GSW,,CLE,W,1,35,4,6,0.667,4,6,0.667,0,0,,3,4,0.75,2,11,13
8202,Draymond Green,26-259,F,11/18/16,GSW,@,BOS,W,1,35,3,11,0.273,1,5,0.2,2,6,0.333,3,4,0.75,1,7,8
8203,Draymond Green,26-257,F,11/16/16,GSW,@,TOR,W,1,35,5,13,0.385,4,9,0.444,1,4,0.25,0,0,,0,7,7
8204,Draymond Green,26-308,F,1/6/17,GSW,,MEM,L,1,40,3,6,0.5,2,3,0.667,1,3,0.333,4,5,0.8,0,8,8
8205,Gerald Green,31-014,G-F,2/9/17,BOS,@,POR,W,0,18,5,6,0.833,4,5,0.8,1,1,1,0,0,,1,0,1
8206,Gerald Green,31-050,G-F,3/17/17,BOS,@,BRK,W,0,17,4,8,0.5,3,5,0.6,1,3,0.333,2,2,1,0,3,3
8207,JaMychal Green,26-232,F,2/8/17,MEM,,PHO,W,1,30,4,4,1,3,3,1,1,1,1,2,2,1,4,6,10
8208,Jeff Green,30-139,F,1/14/17,ORL,@,UTA,L,0,18,4,9,0.444,3,6,0.5,1,3,0.333,2,4,0.5,1,4,5
8209,Jeff Green,30-171,F,2/15/17,ORL,,SAS,L,1,35,4,11,0.364,4,7,0.571,0,4,0,3,3,1,0,3,3
8210,Jeff Green,30-085,F,11/21/16,ORL,@,MIL,L,1,31,4,9,0.444,3,5,0.6,1,4,0.25,2,2,1,1,3,4
8211,Jeff Green,30-187,F,3/3/17,ORL,,MIA,W,0,16,5,8,0.625,5,7,0.714,0,1,0,1,2,0.5,0,3,3
8212,Jeff Green,30-185,F,3/1/17,ORL,,NYK,L,0,24,4,10,0.4,3,5,0.6,1,5,0.2,2,2,1,0,2,2
8213,Jeff Green,30-077,F,11/13/16,ORL,@,OKC,W,1,28,4,8,0.5,3,5,0.6,1,3,0.333,2,2,1,0,0,0
8214,Justin Hamilton,26-233,C,11/20/16,BRK,,POR,L,0,22,4,7,0.571,1,1,1,3,6,0.5,0,0,,0,3,3
8215,Justin Hamilton,26-289,C,1/15/17,BRK,,HOU,L,1,18,5,7,0.714,4,5,0.8,1,2,0.5,0,0,,1,2,3
8216,Justin Hamilton,26-287,C,1/13/17,BRK,@,TOR,L,0,14,4,8,0.5,3,4,0.75,1,4,0.25,2,2,1,0,2,2
8217,Tim Hardaway,24-238,G,11/9/16,ATL,,CHI,W,0,19,5,9,0.556,4,6,0.667,1,3,0.333,0,0,,0,3,3
8218,Tim Hardaway,24-345,G,2/24/17,ATL,,MIA,L,1,25,3,13,0.231,0,7,0,3,6,0.5,2,2,1,0,2,2
8219,Tim Hardaway,24-336,G,2/15/17,ATL,@,LAC,L,1,28,5,11,0.455,4,7,0.571,1,4,0.25,0,0,,1,2,3
8220,Tim Hardaway,25-004,G,3/20/17,ATL,@,CHO,L,1,33,5,11,0.455,4,6,0.667,1,5,0.2,0,0,,0,1,1
8221,Tim Hardaway,24-261,G,12/2/16,ATL,,DET,L,0,27,5,14,0.357,5,8,0.625,0,6,0,1,2,0.5,0,2,2
8222,Maurice Harkless,23-210,F-G,12/7/16,POR,@,MIL,L,1,32,5,13,0.385,4,8,0.5,1,5,0.2,0,0,,4,0,4
8223,Maurice Harkless,23-208,F-G,12/5/16,POR,@,CHI,W,1,31,4,11,0.364,3,7,0.429,1,4,0.25,2,3,0.667,4,5,9
8224,Maurice Harkless,23-223,F-G,12/20/16,POR,@,SAC,L,1,24,5,9,0.556,5,8,0.625,0,1,0,1,3,0.333,5,5,10
8225,Maurice Harkless,23-196,F-G,11/23/16,POR,@,CLE,L,1,34,4,10,0.4,3,5,0.6,1,5,0.2,2,2,1,3,4,7
8226,Montrezl Harrell,22-365,F-C,1/25/17,HOU,@,BOS,L,0,25,5,6,0.833,5,6,0.833,0,0,,1,2,0.5,0,2,2
8227,Devin Harris,33-315,G,1/7/17,DAL,,ATL,L,0,15,3,8,0.375,2,2,1,1,6,0.167,4,4,1,0,1,1
8228,Devin Harris,34-020,G,3/19/17,DAL,@,BRK,W,0,17,4,6,0.667,3,4,0.75,1,2,0.5,2,2,1,0,2,2
8229,Gary Harris,22-110,G,1/2/17,DEN,@,GSW,L,1,31,5,12,0.417,5,9,0.556,0,3,0,1,2,0.5,3,1,4
8230,Gary Harris,22-057,G,11/10/16,DEN,,GSW,L,1,18,5,7,0.714,4,5,0.8,1,2,0.5,0,2,0,1,1,2
8231,Joe Harris,25-128,G,1/13/17,BRK,@,TOR,L,1,25,4,7,0.571,1,2,0.5,3,5,0.6,0,0,,1,3,4
8232,Joe Harris,25-085,G,12/1/16,BRK,,MIL,L,0,23,4,11,0.364,1,3,0.333,3,8,0.375,0,0,,0,4,4
8233,Joe Harris,25-098,G,12/14/16,BRK,,LAL,W,0,26,3,10,0.3,0,3,0,3,7,0.429,2,2,1,0,4,4
8234,Joe Harris,25-062,G,11/8/16,BRK,,MIN,W,0,23,5,9,0.556,4,4,1,1,5,0.2,0,0,,0,1,1
8235,Tobias Harris,24-228,F,2/28/17,DET,,POR,W,0,23,5,12,0.417,4,9,0.444,1,3,0.333,0,0,,1,1,2
8236,Tobias Harris,24-142,F,12/4/16,DET,,ORL,L,1,35,5,12,0.417,4,9,0.444,1,3,0.333,0,1,0,2,2,4
8237,Andrew Harrison,22-043,G,12/10/16,MEM,,GSW,W,1,35,2,9,0.222,2,5,0.4,0,4,0,7,7,1,0,2,2
8238,Andrew Harrison,22-034,G,12/1/16,MEM,,ORL,W,1,30,4,8,0.5,4,8,0.5,0,0,,3,6,0.5,0,4,4
8239,Andrew Harrison,22-049,G,12/16/16,MEM,,SAC,L,0,19,2,4,0.5,1,2,0.5,1,2,0.5,6,8,0.75,0,0,0
8240,Spencer Hawes,28-209,C-F,11/23/16,CHO,,SAS,L,0,20,4,10,0.4,4,9,0.444,0,1,0,3,4,0.75,1,2,3
8241,Spencer Hawes,28-195,C-F,11/9/16,CHO,,UTA,W,0,19,5,7,0.714,5,6,0.833,0,1,0,1,3,0.333,0,3,3
8242,Gerald Henderson,29-068,G,2/15/17,PHI,@,BOS,L,1,25,4,9,0.444,4,7,0.571,0,2,0,3,4,0.75,0,0,0
8243,Gerald Henderson,29-038,G,1/16/17,PHI,@,MIL,W,0,28,3,7,0.429,1,4,0.25,2,3,0.667,3,4,0.75,2,2,4
8244,Gerald Henderson,28-341,G,11/14/16,PHI,@,HOU,L,1,28,4,8,0.5,3,7,0.429,1,1,1,2,2,1,1,0,1
8245,Gerald Henderson,29-046,G,1/24/17,PHI,,LAC,W,0,22,3,7,0.429,2,4,0.5,1,3,0.333,4,4,1,0,1,1
8246,Gerald Henderson,28-332,G,11/5/16,PHI,,CLE,L,1,24,5,9,0.556,4,5,0.8,1,4,0.25,0,0,,0,2,2
8247,Gerald Henderson,28-346,G,11/19/16,PHI,,PHO,W,1,22,4,8,0.5,4,7,0.571,0,1,0,3,4,0.75,2,3,5
8248,Gerald Henderson,28-329,G,11/2/16,PHI,@,CHO,L,1,25,5,8,0.625,4,6,0.667,1,2,0.5,0,0,,0,3,3
8249,Gerald Henderson,29-014,G,12/23/16,PHI,@,PHO,L,1,26,5,10,0.5,4,8,0.5,1,2,0.5,0,0,,0,1,1
8250,John Henson,26-073,C-F,3/11/17,MIL,,MIN,W,0,19,5,8,0.625,5,8,0.625,0,0,,1,2,0.5,3,3,6
8251,John Henson,26-024,C-F,1/21/17,MIL,@,MIA,L,1,22,4,7,0.571,4,7,0.571,0,0,,3,4,0.75,2,7,9
8252,Juan Hernangomez,21-043,F,11/10/16,DEN,,GSW,L,0,30,4,10,0.4,2,7,0.286,2,3,0.667,1,2,0.5,3,6,9
8253,Willy Hernangomez,22-274,C,2/25/17,NYK,,PHI,W,1,23,4,6,0.667,4,6,0.667,0,0,,3,3,1,3,6,9
8254,Willy Hernangomez,22-272,C,2/23/17,NYK,@,CLE,L,1,27,4,9,0.444,4,8,0.5,0,1,0,3,4,0.75,3,7,10
8255,Mario Hezonja,22-013,F-G,3/10/17,ORL,@,CHO,L,0,22,3,10,0.3,2,4,0.5,1,6,0.167,4,4,1,3,1,4
8256,Mario Hezonja,21-354,F-G,2/13/17,ORL,@,MIA,W,0,16,4,6,0.667,1,3,0.333,3,3,1,0,0,,0,1,1
8257,Mario Hezonja,21-258,F-G,11/9/16,ORL,,MIN,L,0,14,4,8,0.5,3,4,0.75,1,4,0.25,2,2,1,0,1,1
8258,Roy Hibbert,29-356,C,12/1/16,CHO,,DAL,W,0,17,5,7,0.714,5,7,0.714,0,0,,1,5,0.2,0,4,4
8259,Buddy Hield,23-081,G,3/8/17,SAC,@,SAS,L,0,18,4,9,0.444,1,4,0.25,3,5,0.6,0,0,,0,2,2
8260,Buddy Hield,23-023,G,1/9/17,NOP,@,NYK,W,1,27,4,7,0.571,1,2,0.5,3,5,0.6,0,0,,0,3,3
8261,Buddy Hield,23-091,G,3/18/17,SAC,@,OKC,L,1,32,4,12,0.333,2,4,0.5,2,8,0.25,1,1,1,0,1,1
8262,Buddy Hield,23-034,G,1/20/17,NOP,,BRK,L,1,22,4,8,0.5,3,5,0.6,1,3,0.333,2,2,1,1,2,3
8263,Buddy Hield,23-051,G,2/6/17,NOP,,PHO,W,1,28,4,9,0.444,1,4,0.25,3,5,0.6,0,0,,1,2,3
8264,Buddy Hield,22-365,G,12/16/16,NOP,@,HOU,L,1,26,4,10,0.4,1,6,0.167,3,4,0.75,0,0,,0,5,5
8265,Nene Hilario,34-087,F-C,12/9/16,HOU,@,OKC,W,0,15,5,7,0.714,5,7,0.714,0,0,,1,2,0.5,0,3,3
8266,Nene Hilario,34-047,F-C,10/30/16,HOU,,DAL,W,0,22,5,6,0.833,5,6,0.833,0,0,,1,1,1,0,3,3
8267,Nene Hilario,34-165,F-C,2/25/17,HOU,,MIN,W,0,19,5,6,0.833,5,6,0.833,0,0,,1,3,0.333,2,2,4
8268,Nene Hilario,34-064,F-C,11/16/16,HOU,@,OKC,L,0,20,5,8,0.625,5,8,0.625,0,0,,1,2,0.5,2,3,5
8269,Nene Hilario,34-172,F-C,3/4/17,HOU,,MEM,W,0,16,4,5,0.8,4,5,0.8,0,0,,3,5,0.6,1,3,4
8270,Nene Hilario,34-140,F-C,1/31/17,HOU,,SAC,W,0,13,5,7,0.714,5,7,0.714,0,0,,1,1,1,0,1,1
8271,Solomon Hill,25-249,F,11/22/16,NOP,@,ATL,W,0,26,4,6,0.667,1,2,0.5,3,4,0.75,0,0,,0,3,3
8272,Darrun Hilliard,23-233,G,12/2/16,DET,@,ATL,W,0,18,4,8,0.5,1,3,0.333,3,5,0.6,0,0,,0,1,1
8273,Jrue Holiday,26-282,G,3/21/17,NOP,,MEM,W,1,41,5,17,0.294,4,11,0.364,1,6,0.167,0,0,,1,2,3
8274,Jrue Holiday,26-187,G,12/16/16,NOP,@,HOU,L,1,35,5,15,0.333,4,8,0.5,1,7,0.143,0,0,,1,4,5
8275,Jrue Holiday,26-204,G,1/2/17,NOP,@,CLE,L,1,35,4,11,0.364,2,8,0.25,2,3,0.667,1,2,0.5,0,4,4
8276,Jrue Holiday,26-276,G,3/15/17,NOP,@,MIA,L,1,32,4,12,0.333,3,9,0.333,1,3,0.333,2,3,0.667,0,4,4
8277,Jrue Holiday,26-199,G,12/28/16,NOP,,LAC,W,1,34,5,12,0.417,5,11,0.455,0,1,0,1,2,0.5,0,4,4
8278,Jrue Holiday,26-218,G,1/16/17,NOP,@,IND,L,1,26,4,9,0.444,2,6,0.333,2,3,0.667,1,2,0.5,1,1,2
8279,Justin Holiday,27-286,G,1/16/17,NYK,,ATL,L,0,23,5,10,0.5,5,7,0.714,0,3,0,1,2,0.5,1,3,4
8280,Justin Holiday,27-349,G,3/20/17,NYK,@,LAC,L,0,27,4,8,0.5,3,5,0.6,1,3,0.333,2,2,1,0,4,4
8281,Justin Holiday,27-289,G,1/19/17,NYK,,WAS,L,0,21,4,6,0.667,3,3,1,1,3,0.333,2,2,1,0,2,2
8282,Rondae Hollis-Jefferson,21-344,F,12/12/16,BRK,@,HOU,L,0,15,3,4,0.75,3,4,0.75,0,0,,5,6,0.833,2,3,5
8283,Rondae Hollis-Jefferson,21-306,F,11/4/16,BRK,,CHO,L,1,32,4,5,0.8,2,3,0.667,2,2,1,1,2,0.5,0,8,8
8284,Rondae Hollis-Jefferson,21-365,F,1/2/17,BRK,,UTA,L,0,14,3,5,0.6,3,5,0.6,0,0,,5,7,0.714,0,1,1
8285,Richaun Holmes,23-051,F-C,12/5/16,PHI,,DEN,L,0,18,5,8,0.625,5,7,0.714,0,1,0,1,2,0.5,5,3,8
8286,Richaun Holmes,23-044,F-C,11/28/16,PHI,@,TOR,L,0,23,4,10,0.4,3,7,0.429,1,3,0.333,2,2,1,4,5,9
8287,Richaun Holmes,23-018,F-C,11/2/16,PHI,@,CHO,L,1,12,4,4,1,3,3,1,1,1,1,2,2,1,1,2,3
8288,Rodney Hood,24-129,G-F,2/26/17,UTA,@,WAS,W,1,27,2,7,0.286,0,3,0,2,4,0.5,5,5,1,0,3,3
8289,Rodney Hood,24-151,G-F,3/20/17,UTA,@,IND,L,1,16,4,10,0.4,2,5,0.4,2,5,0.4,1,1,1,0,2,2
8290,Al Horford,30-255,C-F,2/13/17,BOS,@,DAL,W,1,32,5,12,0.417,4,10,0.4,1,2,0.5,0,0,,1,4,5
8291,Al Horford,30-146,C-F,10/27/16,BOS,@,CHI,L,1,30,4,9,0.444,4,7,0.571,0,2,0,3,4,0.75,0,7,7
8292,Al Horford,30-183,C-F,12/3/16,BOS,@,PHI,W,1,34,4,10,0.4,3,7,0.429,1,3,0.333,2,2,1,0,4,4
8293,Al Horford,30-145,C-F,10/26/16,BOS,,BRK,W,1,27,5,8,0.625,4,4,1,1,4,0.25,0,0,,1,4,5
8294,Al Horford,30-207,C-F,12/27/16,BOS,,MEM,W,1,34,5,14,0.357,4,10,0.4,1,4,0.25,0,0,,2,2,4
8295,Al Horford,30-245,C-F,2/3/17,BOS,,LAL,W,1,31,4,11,0.364,3,7,0.429,1,4,0.25,2,4,0.5,2,6,8
8296,Al Horford,30-243,C-F,2/1/17,BOS,,TOR,W,1,32,4,13,0.308,3,8,0.375,1,5,0.2,2,2,1,1,2,3
8297,Dwight Howard,30-324,C,10/27/16,ATL,,WAS,W,1,30,4,9,0.444,4,9,0.444,0,0,,3,4,0.75,7,12,19
8298,Dwight Howard,31-062,C,2/8/17,ATL,,DEN,W,1,25,5,9,0.556,5,9,0.556,0,0,,1,2,0.5,5,8,13
8299,Dwight Howard,31-043,C,1/20/17,ATL,,CHI,W,1,25,3,11,0.273,3,11,0.273,0,0,,5,8,0.625,1,5,6
8300,Dwight Howard,31-058,C,2/4/17,ATL,,ORL,W,1,24,5,6,0.833,5,6,0.833,0,0,,1,3,0.333,4,9,13
8301,Dwight Howard,31-036,C,1/13/17,ATL,,BOS,L,1,24,4,4,1,4,4,1,0,0,,3,3,1,2,6,8
8302,Dwight Howard,31-069,C,2/15/17,ATL,@,LAC,L,1,24,5,8,0.625,5,7,0.714,0,1,0,1,4,0.25,5,10,15
8303,Dwight Howard,30-343,C,11/15/16,ATL,@,MIA,W,1,25,5,9,0.556,5,9,0.556,0,0,,1,3,0.333,2,9,11
8304,Dwight Howard,30-324,C,10/27/16,ATL,,WAS,W,1,30,4,9,0.444,4,9,0.444,0,0,,3,4,0.75,7,12,19
8305,Dwight Howard,31-062,C,2/8/17,ATL,,DEN,W,1,25,5,9,0.556,5,9,0.556,0,0,,1,2,0.5,5,8,13
8306,Kris Humphries,31-270,F-C,11/2/16,ATL,,LAL,L,0,14,3,6,0.5,2,4,0.5,1,2,0.5,4,4,1,1,0,1
8307,Serge Ibaka,27-122,F-C,1/18/17,ORL,@,NOP,L,1,25,5,10,0.5,4,6,0.667,1,4,0.25,0,0,,1,6,7
8308,Serge Ibaka,27-074,F-C,12/1/16,ORL,@,MEM,L,1,32,4,10,0.4,4,6,0.667,0,4,0,3,4,0.75,2,6,8
8309,Serge Ibaka,27-052,F-C,11/9/16,ORL,,MIN,L,1,27,4,8,0.5,3,7,0.429,1,1,1,2,3,0.667,1,1,2
8310,Serge Ibaka,27-048,F-C,11/5/16,ORL,,WAS,W,1,21,5,13,0.385,4,11,0.364,1,2,0.5,0,0,,2,5,7
8311,Andre Iguodala,32-278,G-F,11/1/16,GSW,@,POR,W,0,24,4,7,0.571,3,6,0.5,1,1,1,2,3,0.667,0,5,5
8312,Andre Iguodala,32-335,G-F,12/28/16,GSW,,TOR,W,0,30,5,5,1,5,5,1,0,0,,1,2,0.5,1,2,3
8313,Ersan Ilyasova,29-269,F,2/8/17,PHI,,SAS,L,1,28,4,11,0.364,2,5,0.4,2,6,0.333,1,3,0.333,0,2,2
8314,Ersan Ilyasova,29-186,F,11/17/16,PHI,@,MIN,L,1,21,5,12,0.417,4,8,0.5,1,4,0.25,0,0,,0,3,3
8315,Ersan Ilyasova,29-197,F,11/28/16,PHI,@,TOR,L,1,23,4,8,0.5,3,5,0.6,1,3,0.333,2,2,1,0,6,6
8316,Ersan Ilyasova,29-188,F,11/19/16,PHI,,PHO,W,1,24,5,9,0.556,4,5,0.8,1,4,0.25,0,0,,0,2,2
8317,Joe Ingles,29-079,F-G,12/20/16,UTA,@,GSW,L,0,27,4,13,0.308,1,6,0.167,3,7,0.429,0,0,,1,4,5
8318,Joe Ingles,29-106,F-G,1/16/17,UTA,@,PHO,W,1,34,4,6,0.667,1,2,0.5,3,4,0.75,0,0,,0,2,2
8319,Joe Ingles,29-073,F-G,12/14/16,UTA,,OKC,W,0,21,4,5,0.8,1,2,0.5,3,3,1,0,0,,0,4,4
8320,Joe Ingles,29-069,F-G,12/10/16,UTA,,SAC,W,1,38,4,5,0.8,1,1,1,3,4,0.75,0,0,,0,6,6
8321,Brandon Ingram,19-081,F,11/22/16,LAL,,OKC,W,0,25,4,6,0.667,1,3,0.333,3,3,1,0,0,,0,2,2
8322,Brandon Ingram,19-125,F,1/5/17,LAL,@,POR,L,1,37,3,6,0.5,1,2,0.5,2,4,0.5,3,4,0.75,1,3,4
8323,Brandon Ingram,19-196,F,3/17/17,LAL,,MIL,L,1,35,4,11,0.364,3,7,0.429,1,4,0.25,2,4,0.5,0,1,1
8324,Brandon Ingram,19-175,F,2/24/17,LAL,@,OKC,L,1,39,4,12,0.333,3,7,0.429,1,5,0.2,2,5,0.4,1,4,5
8325,Brandon Ingram,19-130,F,1/10/17,LAL,,POR,L,0,26,3,6,0.5,1,4,0.25,2,2,1,3,6,0.5,0,4,4
8326,Kyrie Irving,24-262,G,12/10/16,CLE,,CHO,W,1,36,4,13,0.308,2,10,0.2,2,3,0.667,1,1,1,1,3,4
8327,Kyrie Irving,24-294,G,1/11/17,CLE,@,POR,L,1,32,4,16,0.25,3,14,0.214,1,2,0.5,2,2,1,3,0,3
8328,Al Jefferson,32-030,C-F,2/3/17,IND,@,BRK,W,0,15,4,9,0.444,4,9,0.444,0,0,,3,4,0.75,2,3,5
8329,Al Jefferson,31-357,C-F,12/26/16,IND,@,CHI,L,0,20,5,9,0.556,5,9,0.556,0,0,,1,1,1,2,3,5
8330,Richard Jefferson,36-256,F,3/4/17,CLE,@,MIA,L,0,25,5,8,0.625,4,5,0.8,1,3,0.333,0,1,0,0,0,0
8331,Richard Jefferson,36-255,F,3/3/17,CLE,@,ATL,W,0,16,4,7,0.571,1,2,0.5,3,5,0.6,0,0,,0,2,2
8332,Richard Jefferson,36-251,F,2/27/17,CLE,,MIL,W,1,30,3,6,0.5,2,3,0.667,1,3,0.333,4,4,1,1,5,6
8333,Richard Jefferson,36-209,F,1/16/17,CLE,@,GSW,L,0,20,3,8,0.375,1,3,0.333,2,5,0.4,3,5,0.6,0,2,2
8334,Richard Jefferson,36-191,F,12/29/16,CLE,,BOS,W,0,19,2,2,1,2,2,1,0,0,,7,9,0.778,0,3,3
8335,Richard Jefferson,36-223,F,1/30/17,CLE,@,DAL,L,1,25,4,5,0.8,1,2,0.5,3,3,1,0,0,,1,2,3
8336,Brandon Jennings,27-117,G,1/18/17,NYK,@,BOS,W,0,27,3,7,0.429,1,2,0.5,2,5,0.4,3,4,0.75,1,3,4
8337,Amir Johnson,29-213,F,11/30/16,BOS,,DET,L,1,15,4,7,0.571,4,6,0.667,0,1,0,3,3,1,3,2,5
8338,Amir Johnson,29-192,F,11/9/16,BOS,@,WAS,L,1,24,5,5,1,4,4,1,1,1,1,0,0,,1,2,3
8339,Amir Johnson,29-220,F,12/7/16,BOS,@,ORL,W,1,23,5,7,0.714,5,7,0.714,0,0,,1,1,1,2,3,5
8340,Amir Johnson,29-272,F,1/28/17,BOS,@,MIL,W,1,25,5,7,0.714,4,6,0.667,1,1,1,0,1,0,1,6,7
8341,Amir Johnson,29-235,F,12/22/16,BOS,@,IND,W,1,24,5,7,0.714,4,5,0.8,1,2,0.5,0,2,0,1,5,6
8342,James Johnson,29-307,F,12/23/16,MIA,@,NOP,L,0,22,4,12,0.333,3,10,0.3,1,2,0.5,2,2,1,2,8,10
8343,James Johnson,29-249,F,10/26/16,MIA,@,ORL,W,0,25,4,8,0.5,2,4,0.5,2,4,0.5,1,1,1,0,2,2
8344,James Johnson,29-352,F,2/6/17,MIA,@,MIN,W,0,29,5,9,0.556,4,7,0.571,1,2,0.5,0,2,0,0,4,4
8345,James Johnson,29-258,F,11/4/16,MIA,@,TOR,L,0,19,4,8,0.5,3,5,0.6,1,3,0.333,2,2,1,1,2,3
8346,Joe Johnson,35-121,G-F,10/28/16,UTA,,LAL,W,1,32,4,11,0.364,3,7,0.429,1,4,0.25,2,2,1,2,5,7
8347,Joe Johnson,35-153,G-F,11/29/16,UTA,,HOU,W,0,26,4,7,0.571,1,2,0.5,3,5,0.6,0,0,,0,3,3
8348,Stanley Johnson,20-162,F,11/7/16,DET,@,LAC,L,0,25,4,7,0.571,2,4,0.5,2,3,0.667,1,2,0.5,1,3,4
8349,Stanley Johnson,20-259,F,2/12/17,DET,@,TOR,W,0,24,4,9,0.444,1,4,0.25,3,5,0.6,0,0,,0,2,2
8350,Tyler Johnson,24-230,G,12/23/16,MIA,@,NOP,L,0,30,5,13,0.385,4,11,0.364,1,2,0.5,0,0,,0,3,3
8351,Tyler Johnson,24-244,G,1/6/17,MIA,@,LAL,L,0,35,4,13,0.308,4,9,0.444,0,4,0,3,4,0.75,1,4,5
8352,Tyler Johnson,24-270,G,2/1/17,MIA,,ATL,W,0,32,4,11,0.364,3,6,0.5,1,5,0.2,2,2,1,1,2,3
8353,Tyler Johnson,24-191,G,11/14/16,MIA,@,SAS,L,0,33,4,9,0.444,4,9,0.444,0,0,,3,6,0.5,0,8,8
8354,Tyler Johnson,24-239,G,1/1/17,MIA,,DET,L,0,29,3,10,0.3,2,8,0.25,1,2,0.5,4,5,0.8,0,1,1
8355,Tyler Johnson,24-219,G,12/12/16,MIA,,WAS,W,0,30,5,10,0.5,4,8,0.5,1,2,0.5,0,0,,0,3,3
8356,Wesley Johnson,29-219,F-G,2/15/17,LAC,,ATL,W,0,19,4,8,0.5,1,3,0.333,3,5,0.6,0,0,,0,4,4
8357,Nikola Jokic,21-351,C-F,2/4/17,DEN,@,SAS,L,1,15,5,9,0.556,4,7,0.571,1,2,0.5,0,0,,1,0,1
8358,Terrence Jones,24-321,F,11/25/16,NOP,@,POR,L,0,30,4,10,0.4,2,6,0.333,2,4,0.5,1,2,0.5,0,3,3
8359,Terrence Jones,25-023,F,2/1/17,NOP,@,DET,L,1,27,5,9,0.556,5,9,0.556,0,0,,1,1,1,0,3,3
8360,Terrence Jones,25-000,F,1/9/17,NOP,@,NYK,W,0,14,4,6,0.667,4,6,0.667,0,0,,3,4,0.75,1,2,3
8361,Tyus Jones,20-290,G,2/24/17,MIN,,DAL,W,0,25,4,6,0.667,1,3,0.333,3,3,1,0,1,0,0,2,2
8362,DeAndre Jordan,28-154,C,12/22/16,LAC,,SAS,W,1,26,4,6,0.667,4,6,0.667,0,0,,3,4,0.75,2,7,9
8363,Cory Joseph,25-188,G,2/24/17,TOR,,BOS,W,1,36,5,12,0.417,5,11,0.455,0,1,0,1,2,0.5,1,0,1
8364,Cory Joseph,25-200,G,3/8/17,TOR,@,NOP,W,1,32,4,11,0.364,3,5,0.6,1,6,0.167,2,2,1,0,5,5
8365,Cory Joseph,25-211,G,3/19/17,TOR,,IND,W,1,31,5,9,0.556,4,8,0.5,1,1,1,0,0,,1,3,4
8366,Cory Joseph,25-193,G,3/1/17,TOR,,WAS,L,1,28,5,11,0.455,4,7,0.571,1,4,0.25,0,0,,0,4,4
8367,Cory Joseph,25-122,G,12/20/16,TOR,,BRK,W,0,26,4,11,0.364,3,10,0.3,1,1,1,2,3,0.667,1,6,7
8368,Cory Joseph,25-208,G,3/16/17,TOR,,OKC,L,1,30,5,8,0.625,4,7,0.571,1,1,1,0,2,0,0,2,2
8369,Cory Joseph,25-136,G,1/3/17,TOR,@,SAS,L,0,24,3,11,0.273,2,9,0.222,1,2,0.5,4,5,0.8,0,3,3
8370,Frank Kaminsky,23-260,F-C,12/20/16,CHO,,LAL,W,0,18,4,6,0.667,3,4,0.75,1,2,0.5,2,4,0.5,0,3,3
8371,Frank Kaminsky,23-208,F-C,10/29/16,CHO,,BOS,L,0,24,4,8,0.5,3,6,0.5,1,2,0.5,2,2,1,1,3,4
8372,Frank Kaminsky,23-289,F-C,1/18/17,CHO,,POR,W,0,24,4,10,0.4,1,4,0.25,3,6,0.5,0,0,,0,3,3
8373,Frank Kaminsky,23-217,F-C,11/7/16,CHO,,IND,W,0,30,5,14,0.357,5,8,0.625,0,6,0,1,2,0.5,0,2,2
8374,Enes Kanter,24-287,C,3/3/17,OKC,@,PHO,L,0,23,4,9,0.444,4,8,0.5,0,1,0,3,3,1,2,3,5
8375,Enes Kanter,24-189,C,11/25/16,OKC,@,DEN,W,0,19,5,9,0.556,5,7,0.714,0,2,0,1,1,1,1,1,2
8376,Enes Kanter,24-291,C,3/7/17,OKC,,POR,L,0,18,5,6,0.833,5,6,0.833,0,0,,1,1,1,2,5,7
8377,Michael Kidd-Gilchrist,23-079,F,12/14/16,CHO,@,WAS,L,1,26,5,7,0.714,5,7,0.714,0,0,,1,2,0.5,0,3,3
8378,Michael Kidd-Gilchrist,23-048,F,11/13/16,CHO,@,CLE,L,1,41,4,13,0.308,4,13,0.308,0,0,,3,3,1,2,8,10
8379,Michael Kidd-Gilchrist,23-061,F,11/26/16,CHO,,NYK,W,1,35,4,6,0.667,4,6,0.667,0,0,,3,4,0.75,0,8,8
8380,Michael Kidd-Gilchrist,23-161,F,3/6/17,CHO,,IND,W,1,31,4,8,0.5,4,8,0.5,0,0,,3,3,1,3,10,13
8381,Michael Kidd-Gilchrist,23-056,F,11/21/16,CHO,,MEM,L,1,32,4,7,0.571,4,7,0.571,0,0,,3,7,0.429,5,5,10
8382,Michael Kidd-Gilchrist,23-070,F,12/5/16,CHO,@,DAL,W,1,28,5,11,0.455,5,11,0.455,0,0,,1,1,1,4,8,12
8383,Brandon Knight,24-361,G,11/27/16,PHO,,DEN,L,0,17,2,10,0.2,2,10,0.2,0,0,,7,10,0.7,1,1,2
8384,Brandon Knight,25-013,G,12/15/16,PHO,,SAS,L,0,22,2,7,0.286,2,6,0.333,0,1,0,7,8,0.875,0,1,1
8385,Brandon Knight,25-050,G,1/21/17,PHO,@,NYK,W,0,20,5,12,0.417,4,8,0.5,1,4,0.25,0,0,,1,4,5
8386,Brandon Knight,24-342,G,11/8/16,PHO,@,POR,L,0,19,5,10,0.5,4,7,0.571,1,3,0.333,0,0,,0,4,4
8387,Brandon Knight,25-075,G,2/15/17,PHO,,LAL,W,0,21,5,10,0.5,4,6,0.667,1,4,0.25,0,0,,0,2,2
8388,Brandon Knight,25-073,G,2/13/17,PHO,,NOP,L,0,18,4,8,0.5,3,7,0.429,1,1,1,2,3,0.667,0,1,1
8389,Kyle Korver,35-324,G-F,2/4/17,CLE,@,NYK,W,0,31,3,9,0.333,1,4,0.25,2,5,0.4,3,3,1,0,4,4
8390,Kyle Korver,35-305,G-F,1/16/17,CLE,@,GSW,L,0,27,4,10,0.4,1,2,0.5,3,8,0.375,0,0,,0,2,2
8391,Kyle Korver,35-244,G-F,11/16/16,ATL,,MIL,W,1,27,3,9,0.333,1,2,0.5,2,7,0.286,3,3,1,0,6,6
8392,Kyle Korver,35-237,G-F,11/9/16,ATL,,CHI,W,1,26,4,5,0.8,2,3,0.667,2,2,1,1,1,1,0,2,2
8393,Kosta Koufos,27-329,C,1/18/17,SAC,,IND,L,1,24,5,8,0.625,5,8,0.625,0,0,,1,2,0.5,1,3,4
8394,Skal Labissiere,20-360,F,3/13/17,SAC,,ORL,W,1,20,5,9,0.556,5,9,0.556,0,0,,1,3,0.333,1,6,7
8395,Jeremy Lamb,24-225,G-F,1/10/17,CHO,@,HOU,L,1,28,4,11,0.364,3,8,0.375,1,3,0.333,2,2,1,0,5,5
8396,Nicolas Laprovittola,26-279,G,11/5/16,SAS,,LAC,L,0,22,4,5,0.8,1,1,1,3,4,0.75,0,0,,1,1,2
8397,Zach LaVine,21-252,G,11/17/16,MIN,,PHI,W,1,39,5,14,0.357,4,7,0.571,1,7,0.143,0,0,,1,0,1
8398,Zach LaVine,21-320,G,1/24/17,MIN,@,PHO,W,1,34,5,9,0.556,4,5,0.8,1,4,0.25,0,2,0,0,1,1
8399,Zach LaVine,21-311,G,1/15/17,MIN,@,DAL,L,1,34,3,8,0.375,0,4,0,3,4,0.75,2,2,1,0,5,5
8400,Zach LaVine,21-326,G,1/30/17,MIN,,ORL,W,1,43,3,9,0.333,2,3,0.667,1,6,0.167,4,5,0.8,0,3,3
8401,Zach LaVine,21-256,G,11/21/16,MIN,,BOS,L,1,38,4,12,0.333,4,5,0.8,0,7,0,3,3,1,0,3,3
8402,Ty Lawson,29-007,G,11/10/16,SAC,,LAL,L,1,25,4,6,0.667,2,3,0.667,2,3,0.667,1,2,0.5,0,1,1
8403,Ty Lawson,29-116,G,2/27/17,SAC,,MIN,L,1,35,5,13,0.385,5,11,0.455,0,2,0,1,1,1,0,1,1
8404,Ty Lawson,29-000,G,11/3/16,SAC,@,ORL,L,1,35,5,9,0.556,4,7,0.571,1,2,0.5,0,2,0,3,4,7
8405,Ty Lawson,29-132,G,3/15/17,SAC,@,PHO,W,1,26,2,7,0.286,2,7,0.286,0,0,,7,8,0.875,1,2,3
8406,Courtney Lee,31-095,G,1/6/17,NYK,@,MIL,W,1,35,3,5,0.6,1,2,0.5,2,3,0.667,3,4,0.75,1,1,2
8407,Courtney Lee,31-093,G,1/4/17,NYK,,MIL,L,1,38,4,9,0.444,1,4,0.25,3,5,0.6,0,0,,1,1,2
8408,Courtney Lee,31-083,G,12/25/16,NYK,,BOS,L,1,34,4,9,0.444,2,3,0.667,2,6,0.333,1,2,0.5,1,2,3
8409,David Lee,33-270,F,1/24/17,SAS,@,TOR,W,1,21,4,7,0.571,4,7,0.571,0,0,,3,4,0.75,0,5,5
8410,David Lee,33-287,F,2/10/17,SAS,@,DET,W,0,20,5,10,0.5,5,10,0.5,0,0,,1,1,1,3,4,7
8411,David Lee,33-324,F,3/19/17,SAS,,SAC,W,0,20,4,7,0.571,4,7,0.571,0,0,,3,3,1,3,4,7
8412,Alex Len,23-222,C,1/24/17,PHO,,MIN,L,0,24,4,5,0.8,4,5,0.8,0,0,,3,3,1,5,5,10
8413,Alex Len,23-237,C,2/8/17,PHO,@,MEM,L,0,28,5,8,0.625,4,7,0.571,1,1,1,0,0,,1,4,5
8414,Alex Len,23-276,C,3/19/17,PHO,@,DET,L,1,21,5,11,0.455,4,9,0.444,1,2,0.5,0,4,0,4,3,7
8415,Alex Len,23-158,C,11/21/16,PHO,@,WAS,L,1,31,3,5,0.6,3,5,0.6,0,0,,5,6,0.833,3,7,10
8416,Meyers Leonard,24-260,C-F,11/13/16,POR,,DEN,W,1,25,4,9,0.444,3,3,1,1,6,0.167,2,2,1,0,4,4
8417,Meyers Leonard,24-258,C-F,11/11/16,POR,,SAC,W,1,29,4,9,0.444,3,5,0.6,1,4,0.25,2,2,1,0,4,4
8418,Jon Leuer,27-172,F,11/2/16,DET,@,BRK,L,0,27,5,8,0.625,4,5,0.8,1,3,0.333,0,0,,2,5,7
8419,Jon Leuer,27-301,F,3/11/17,DET,,NYK,W,0,21,5,9,0.556,4,7,0.571,1,2,0.5,0,0,,0,3,3
8420,Jon Leuer,27-195,F,11/25/16,DET,,LAC,W,0,33,5,12,0.417,4,8,0.5,1,4,0.25,0,0,,2,9,11
8421,Jon Leuer,27-179,F,11/9/16,DET,@,PHO,L,0,24,3,8,0.375,1,4,0.25,2,4,0.5,3,3,1,2,7,9
8422,Jon Leuer,27-193,F,11/23/16,DET,,MIA,W,0,27,4,6,0.667,2,2,1,2,4,0.5,1,1,1,1,3,4
8423,Caris LeVert,22-138,G-F,1/10/17,BRK,,ATL,L,0,23,4,9,0.444,3,5,0.6,1,4,0.25,2,3,0.667,1,2,3
8424,Caris LeVert,22-156,G-F,1/28/17,BRK,@,MIN,L,0,27,4,8,0.5,3,6,0.5,1,2,0.5,2,3,0.667,0,4,4
8425,Shaun Livingston,31-054,G,11/4/16,GSW,@,LAL,L,0,20,5,5,1,5,5,1,0,0,,1,1,1,1,0,1
8426,Kevon Looney,20-272,F-C,11/4/16,GSW,@,LAL,L,0,13,5,5,1,5,5,1,0,0,,1,2,0.5,2,3,5
8427,Brook Lopez,28-273,C,12/30/16,BRK,@,WAS,L,1,31,3,9,0.333,2,4,0.5,1,5,0.2,4,4,1,1,4,5
8428,Brook Lopez,28-225,C,11/12/16,BRK,@,PHO,W,1,28,3,11,0.273,2,6,0.333,1,5,0.2,4,4,1,0,5,5
8429,Trey Lyles,21-064,F,1/8/17,UTA,@,MEM,L,0,12,3,4,0.75,0,1,0,3,3,1,2,3,0.667,1,1,2
8430,Trey Lyles,21-012,F,11/17/16,UTA,,CHI,L,0,21,4,11,0.364,4,8,0.5,0,3,0,3,3,1,3,3,6
8431,Trey Lyles,21-045,F,12/20/16,UTA,@,GSW,L,0,24,2,10,0.2,0,6,0,2,4,0.5,5,6,0.833,3,0,3
8432,Trey Lyles,21-054,F,12/29/16,UTA,,PHI,W,0,19,4,7,0.571,1,2,0.5,3,5,0.6,0,0,,1,1,2
8433,Shelvin Mack,26-223,G,12/1/16,UTA,,MIA,L,0,33,4,9,0.444,3,7,0.429,1,2,0.5,2,4,0.5,0,5,5
8434,Shelvin Mack,26-238,G,12/16/16,UTA,,DAL,W,0,29,4,7,0.571,4,5,0.8,0,2,0,3,4,0.75,1,2,3
8435,Jarell Martin,22-188,F,11/28/16,MEM,,CHO,L,0,20,5,13,0.385,4,12,0.333,1,1,1,0,2,0,2,10,12
8436,Wesley Matthews,30-098,G,1/20/17,DAL,,UTA,L,1,39,4,10,0.4,3,6,0.5,1,4,0.25,2,2,1,1,7,8
8437,Wesley Matthews,30-095,G,1/17/17,DAL,@,CHI,W,1,40,4,10,0.4,1,5,0.2,3,5,0.6,0,0,,0,4,4
8438,Luc Mbah a Moute,30-066,F,11/14/16,LAC,,BRK,W,1,24,5,5,1,5,5,1,0,0,,1,1,1,0,2,2
8439,Patrick McCaw,21-128,G,3/2/17,GSW,@,CHI,L,1,29,4,5,0.8,3,4,0.75,1,1,1,2,2,1,0,4,4
8440,T.J. McConnell,24-323,G,2/11/17,PHI,,MIA,W,1,32,3,7,0.429,3,7,0.429,0,0,,5,6,0.833,1,3,4
8441,T.J. McConnell,24-343,G,3/3/17,PHI,,NYK,W,1,32,5,11,0.455,5,10,0.5,0,1,0,1,2,0.5,0,4,4
8442,T.J. McConnell,24-316,G,2/4/17,PHI,@,MIA,L,1,28,5,6,0.833,5,6,0.833,0,0,,1,1,1,0,2,2
8443,K.J. McDaniels,23-260,G-F,10/26/16,HOU,@,LAL,L,0,12,5,5,1,4,4,1,1,1,1,0,0,,1,0,1
8444,K.J. McDaniels,24-040,G-F,3/21/17,BRK,,DET,W,0,21,4,8,0.5,2,4,0.5,2,4,0.5,1,2,0.5,0,2,2
8445,Doug McDermott,25-038,F,2/10/17,CHI,@,PHO,L,0,20,4,6,0.667,3,3,1,1,3,0.333,2,2,1,0,1,1
8446,Doug McDermott,24-309,F,11/7/16,CHI,,ORL,W,0,25,5,8,0.625,5,6,0.833,0,2,0,1,1,1,0,4,4
8447,Doug McDermott,24-365,F,1/2/17,CHI,,CHO,W,1,30,5,12,0.417,5,9,0.556,0,3,0,1,1,1,0,1,1
8448,Doug McDermott,25-029,F,2/1/17,CHI,@,OKC,W,0,14,4,7,0.571,3,4,0.75,1,3,0.333,2,2,1,0,1,1
8449,Doug McDermott,25-044,F,2/16/17,CHI,,BOS,W,0,30,4,12,0.333,3,6,0.5,1,6,0.167,2,2,1,0,2,2
8450,Doug McDermott,25-065,F,3/9/17,OKC,,SAS,W,0,22,5,10,0.5,4,7,0.571,1,3,0.333,0,0,,0,0,0
8451,JaVale McGee,28-333,C,12/17/16,GSW,,POR,W,0,11,5,5,1,5,5,1,0,0,,1,3,0.333,0,5,5
8452,JaVale McGee,28-319,C,12/3/16,GSW,,PHO,W,0,13,4,6,0.667,4,6,0.667,0,0,,3,6,0.5,2,0,2
8453,JaVale McGee,29-014,C,2/2/17,GSW,@,LAC,W,1,15,5,6,0.833,5,6,0.833,0,0,,1,2,0.5,4,4,8
8454,Rodney McGruder,25-120,G,11/26/16,MIA,,MEM,L,1,34,5,10,0.5,4,6,0.667,1,4,0.25,0,0,,2,2,4
8455,Rodney McGruder,25-131,G,12/7/16,MIA,@,ATL,L,1,31,3,8,0.375,1,3,0.333,2,5,0.4,3,5,0.6,3,2,5
8456,Rodney McGruder,25-201,G,2/15/17,MIA,@,HOU,W,1,27,4,8,0.5,1,2,0.5,3,6,0.5,0,0,,1,0,1
8457,Rodney McGruder,25-199,G,2/13/17,MIA,,ORL,L,1,22,5,10,0.5,4,6,0.667,1,4,0.25,0,0,,2,2,4
8458,Rodney McGruder,25-220,G,3/6/17,MIA,@,CLE,W,1,28,4,9,0.444,1,4,0.25,3,5,0.6,0,0,,1,3,4
8459,Rodney McGruder,25-196,G,2/10/17,MIA,@,BRK,W,1,35,5,12,0.417,4,9,0.444,1,3,0.333,0,0,,1,5,6
8460,Rodney McGruder,25-122,G,11/28/16,MIA,,BOS,L,1,38,4,7,0.571,3,4,0.75,1,3,0.333,2,2,1,2,3,5
8461,Ben McLemore,24-027,G,3/10/17,SAC,,WAS,L,0,16,3,9,0.333,1,5,0.2,2,4,0.5,3,4,0.75,1,3,4
8462,Ben McLemore,24-001,G,2/12/17,SAC,,NOP,W,1,28,4,7,0.571,1,2,0.5,3,5,0.6,0,0,,2,0,2
8463,Ben McLemore,23-266,G,11/3/16,SAC,@,ORL,L,0,28,5,7,0.714,4,5,0.8,1,2,0.5,0,0,,1,3,4
8464,Jordan McRae,25-308,G,1/30/17,CLE,@,DAL,L,0,30,5,9,0.556,4,6,0.667,1,3,0.333,0,0,,0,2,2
8465,Josh McRoberts,29-292,F,12/16/16,MIA,,LAC,L,1,17,4,10,0.4,1,5,0.2,3,5,0.6,0,0,,0,0,0
8466,Jodie Meeks,29-133,G,1/1/17,ORL,@,IND,L,1,30,3,9,0.333,0,1,0,3,8,0.375,2,2,1,0,3,3
8467,Jodie Meeks,29-148,G,1/16/17,ORL,@,DEN,L,1,34,4,9,0.444,3,6,0.5,1,3,0.333,2,2,1,1,3,4
8468,Jodie Meeks,29-129,G,12/28/16,ORL,,CHO,L,1,22,5,9,0.556,4,5,0.8,1,4,0.25,0,0,,0,1,1
8469,Khris Middleton,25-218,F-G,3/18/17,MIL,@,GSW,L,1,29,4,8,0.5,2,6,0.333,2,2,1,1,1,1,0,2,2
8470,Khris Middleton,25-213,F-G,3/13/17,MIL,@,MEM,L,1,35,2,8,0.25,0,2,0,2,6,0.333,5,6,0.833,1,2,3
8471,Khris Middleton,25-211,F-G,3/11/17,MIL,,MIN,W,1,33,3,9,0.333,3,6,0.5,0,3,0,5,5,1,1,8,9
8472,Khris Middleton,25-185,F-G,2/13/17,MIL,,DET,W,0,18,4,7,0.571,4,7,0.571,0,0,,3,3,1,0,2,2
8473,C.J. Miles,29-238,G-F,12/12/16,IND,,CHO,W,0,19,4,11,0.364,1,2,0.5,3,9,0.333,0,0,,0,2,2
8474,C.J. Miles,29-246,G-F,12/20/16,IND,@,NYK,L,0,26,2,8,0.25,0,3,0,2,5,0.4,5,6,0.833,1,6,7
8475,Patty Mills,28-099,G,11/18/16,SAS,@,LAL,W,0,20,5,9,0.556,4,4,1,1,5,0.2,0,0,,0,0,0
8476,Patty Mills,28-129,G,12/18/16,SAS,,NOP,W,0,20,3,7,0.429,1,3,0.333,2,4,0.5,3,3,1,0,3,3
8477,Patty Mills,28-075,G,10/25/16,SAS,@,GSW,W,0,18,4,9,0.444,1,4,0.25,3,5,0.6,0,0,,0,1,1
8478,Patty Mills,28-159,G,1/17/17,SAS,,MIN,W,0,19,4,10,0.4,1,5,0.2,3,5,0.6,0,0,,0,0,0
8479,Paul Millsap,32-015,F,2/25/17,ATL,@,ORL,L,1,29,3,10,0.3,2,6,0.333,1,4,0.25,4,4,1,0,7,7
8480,Paul Millsap,31-289,F,11/25/16,ATL,@,UTA,L,1,28,4,11,0.364,3,9,0.333,1,2,0.5,2,2,1,1,4,5
8481,Nikola Mirotic,25-345,F,1/21/17,CHI,,SAC,W,0,22,5,11,0.455,4,9,0.444,1,2,0.5,0,0,,2,3,5
8482,Nikola Mirotic,25-285,F,11/22/16,CHI,@,DEN,L,0,22,4,10,0.4,3,8,0.375,1,2,0.5,2,4,0.5,0,3,3
8483,Nikola Mirotic,25-358,F,2/3/17,CHI,@,HOU,L,0,17,4,8,0.5,3,6,0.5,1,2,0.5,2,3,0.667,0,7,7
8484,Nikola Mirotic,25-318,F,12/25/16,CHI,@,SAS,L,0,32,4,10,0.4,1,4,0.25,3,6,0.5,0,0,,0,5,5
8485,Nikola Mirotic,25-316,F,12/23/16,CHI,@,CHO,L,0,19,5,16,0.313,4,9,0.444,1,7,0.143,0,0,,5,5,10
8486,Nikola Mirotic,25-314,F,12/21/16,CHI,,WAS,L,0,22,4,10,0.4,1,4,0.25,3,6,0.5,0,0,,2,4,6
8487,Greg Monroe,26-176,C-F,11/27/16,MIL,@,ORL,W,0,17,4,6,0.667,4,6,0.667,0,0,,3,4,0.75,2,5,7
8488,Greg Monroe,26-191,C-F,12/12/16,MIL,@,TOR,L,0,16,5,5,1,5,5,1,0,0,,1,1,1,1,1,2
8489,Greg Monroe,26-148,C-F,10/30/16,MIL,@,DET,L,0,18,4,9,0.444,4,9,0.444,0,0,,3,3,1,1,4,5
8490,Greg Monroe,26-147,C-F,10/29/16,MIL,,BRK,W,0,19,3,7,0.429,3,7,0.429,0,0,,5,5,1,1,2,3
8491,Greg Monroe,26-270,C-F,3/1/17,MIL,,DEN,L,0,23,4,10,0.4,4,10,0.4,0,0,,3,3,1,4,5,9
8492,E'Twaun Moore,28-001,G,3/1/17,NOP,,DET,W,0,26,4,10,0.4,2,7,0.286,2,3,0.667,1,1,1,0,1,1
8493,E'Twaun Moore,28-014,G,3/14/17,NOP,,POR,W,0,30,5,9,0.556,5,8,0.625,0,1,0,1,2,0.5,0,3,3
8494,E'Twaun Moore,27-264,G,11/18/16,NOP,,POR,W,1,29,5,7,0.714,4,4,1,1,3,0.333,0,0,,0,3,3
8495,Marcus Morris,27-163,F,2/12/17,DET,@,TOR,W,1,32,3,9,0.333,3,5,0.6,0,4,0,5,6,0.833,0,3,3
8496,Marcus Morris,27-180,F,3/1/17,DET,@,NOP,L,1,25,5,12,0.417,4,9,0.444,1,3,0.333,0,2,0,4,1,5
8497,Marcus Morris,27-121,F,1/1/17,DET,@,MIA,W,1,31,4,9,0.444,2,6,0.333,2,3,0.667,1,2,0.5,0,1,1
8498,Marcus Morris,27-058,F,10/30/16,DET,,MIL,W,1,36,4,16,0.25,3,8,0.375,1,8,0.125,2,2,1,1,4,5
8499,Marcus Morris,27-117,F,12/28/16,DET,,MIL,L,1,23,3,10,0.3,1,4,0.25,2,6,0.333,3,4,0.75,1,1,2
8500,Marcus Morris,27-133,F,1/13/17,DET,@,UTA,L,1,30,3,15,0.2,2,11,0.182,1,4,0.25,4,4,1,0,5,5
8501,Markieff Morris,27-058,F,10/30/16,WAS,@,MEM,L,1,36,5,8,0.625,4,6,0.667,1,2,0.5,0,0,,0,7,7
8502,Markieff Morris,27-182,F,3/3/17,WAS,,TOR,L,1,37,4,13,0.308,3,10,0.3,1,3,0.333,2,2,1,2,6,8
8503,Markieff Morris,27-105,F,12/16/16,WAS,,DET,W,1,18,5,9,0.556,4,7,0.571,1,2,0.5,0,0,,0,3,3
8504,Markieff Morris,27-192,F,3/13/17,WAS,@,MIN,L,1,33,5,9,0.556,5,8,0.625,0,1,0,1,1,1,1,6,7
8505,Markieff Morris,27-084,F,11/25/16,WAS,@,ORL,W,1,32,5,10,0.5,5,7,0.714,0,3,0,1,2,0.5,0,3,3
8506,Markieff Morris,27-187,F,3/8/17,WAS,@,DEN,W,1,26,3,3,1,2,2,1,1,1,1,4,4,1,1,5,6
8507,Anthony Morrow,31-126,G,1/31/17,OKC,@,SAS,L,0,30,3,12,0.25,2,6,0.333,1,6,0.167,4,4,1,1,0,1
8508,Anthony Morrow,31-081,G,12/17/16,OKC,,PHO,W,1,21,4,6,0.667,1,2,0.5,3,4,0.75,0,0,,0,0,0
8509,Donatas Motiejunas,26-109,F-C,1/7/17,NOP,@,BOS,L,0,20,4,5,0.8,3,4,0.75,1,1,1,2,4,0.5,2,3,5
8510,Timofey Mozgov,30-144,C,12/7/16,LAL,@,HOU,L,1,15,5,9,0.556,5,9,0.556,0,0,,1,1,1,2,3,5
8511,Emmanuel Mudiay,20-235,G,10/26/16,DEN,@,NOP,W,1,28,2,8,0.25,2,7,0.286,0,1,0,7,8,0.875,0,7,7
8512,Emmanuel Mudiay,20-298,G,12/28/16,DEN,,MIN,W,1,27,5,10,0.5,4,8,0.5,1,2,0.5,0,0,,1,1,2
8513,Shabazz Muhammad,24-117,F-G,3/10/17,MIN,,GSW,W,0,28,5,9,0.556,5,7,0.714,0,2,0,1,2,0.5,2,5,7
8514,Shabazz Muhammad,24-010,F-G,11/23/16,MIN,@,NOP,L,0,17,4,6,0.667,4,5,0.8,0,1,0,3,5,0.6,1,1,2
8515,Shabazz Muhammad,24-057,F-G,1/9/17,MIN,,DAL,W,0,20,5,9,0.556,4,7,0.571,1,2,0.5,0,0,,0,2,2
8516,Shabazz Muhammad,24-083,F-G,2/4/17,MIN,,MEM,L,0,26,5,11,0.455,4,8,0.5,1,3,0.333,0,1,0,2,1,3
8517,Shabazz Muhammad,24-104,F-G,2/25/17,MIN,@,HOU,L,0,13,4,8,0.5,3,6,0.5,1,2,0.5,2,2,1,2,1,3
8518,Dejounte Murray,20-127,G,1/24/17,SAS,@,TOR,W,1,23,4,7,0.571,4,7,0.571,0,0,,3,4,0.75,0,3,3
8519,Jamal Murray,19-351,G,2/8/17,DEN,@,ATL,L,0,22,4,9,0.444,3,4,0.75,1,5,0.2,2,2,1,1,4,5
8520,Jamal Murray,20-003,G,2/26/17,DEN,,MEM,L,0,16,5,9,0.556,4,7,0.571,1,2,0.5,0,0,,0,4,4
8521,Mike Muscala,25-131,F-C,11/9/16,ATL,,CHI,W,0,16,4,8,0.5,3,5,0.6,1,3,0.333,2,2,1,3,3,6
8522,Mike Muscala,25-161,F-C,12/9/16,ATL,@,MIL,W,0,20,4,6,0.667,1,3,0.333,3,3,1,0,0,,2,1,3
8523,Mike Muscala,25-157,F-C,12/5/16,ATL,,OKC,L,0,22,3,3,1,2,2,1,1,1,1,4,4,1,0,5,5
8524,Mike Muscala,25-190,F-C,1/7/17,ATL,@,DAL,W,0,21,4,7,0.571,3,4,0.75,1,3,0.333,2,2,1,1,1,2
8525,Mike Muscala,25-140,F-C,11/18/16,ATL,@,CHO,L,0,25,4,8,0.5,2,3,0.667,2,5,0.4,1,1,1,1,4,5
8526,Mike Muscala,25-154,F-C,12/2/16,ATL,,DET,L,0,24,5,7,0.714,4,6,0.667,1,1,1,0,0,,0,0,0
8527,Larry Nance Jr.,24-040,F,2/10/17,LAL,@,MIL,W,0,28,1,3,0.333,1,3,0.333,0,0,,9,10,0.9,2,3,5
8528,Larry Nance Jr.,23-305,F,11/1/16,LAL,@,IND,L,0,30,4,10,0.4,4,9,0.444,0,1,0,3,4,0.75,4,1,5
8529,Larry Nance Jr.,23-329,F,11/25/16,LAL,,GSW,L,0,20,5,8,0.625,5,8,0.625,0,0,,1,2,0.5,2,5,7
8530,Shabazz Napier,25-118,G,11/9/16,POR,@,LAC,L,0,21,4,10,0.4,3,4,0.75,1,6,0.167,2,3,0.667,0,2,2
8531,Jameer Nelson,34-277,G,11/12/16,DEN,,DET,L,0,22,5,8,0.625,4,6,0.667,1,2,0.5,0,0,,0,1,1
8532,Jameer Nelson,34-325,G,12/30/16,DEN,,PHI,L,0,19,4,5,0.8,1,2,0.5,3,3,1,0,0,,0,0,0
8533,Jameer Nelson,34-338,G,1/12/17,DEN,,IND,W,0,24,4,7,0.571,1,1,1,3,6,0.5,0,0,,0,0,0
8534,Andrew Nicholson,27-099,F,3/17/17,BRK,,BOS,L,0,17,4,9,0.444,3,7,0.429,1,2,0.5,2,2,1,1,1,2
8535,Joakim Noah,31-299,C,12/20/16,NYK,,IND,W,1,30,4,8,0.5,4,8,0.5,0,0,,3,4,0.75,2,9,11
8536,Nerlens Noel,22-331,C-F,3/7/17,DAL,,LAL,W,0,23,4,8,0.5,4,8,0.5,0,0,,3,4,0.75,3,10,13
8537,Lucas Nogueira,24-130,C,12/3/16,TOR,,ATL,W,0,23,5,5,1,5,5,1,0,0,,1,1,1,3,5,8
8538,Dirk Nowitzki,38-198,F,1/3/17,DAL,,WAS,W,1,24,4,9,0.444,3,5,0.6,1,4,0.25,2,2,1,0,9,9
8539,Dirk Nowitzki,38-255,F,3/1/17,DAL,@,ATL,L,1,28,5,12,0.417,5,6,0.833,0,6,0,1,1,1,2,8,10
8540,Dirk Nowitzki,38-194,F,12/30/16,DAL,@,GSW,L,1,23,3,12,0.25,3,9,0.333,0,3,0,5,5,1,0,5,5
8541,Dirk Nowitzki,38-202,F,1/7/17,DAL,,ATL,L,1,30,4,10,0.4,4,7,0.571,0,3,0,3,3,1,0,3,3
8542,Jusuf Nurkic,22-106,C,12/7/16,DEN,@,BRK,L,1,17,4,6,0.667,4,6,0.667,0,0,,3,4,0.75,3,0,3
8543,Jusuf Nurkic,22-210,C,3/21/17,POR,,MIL,L,1,27,5,9,0.556,5,9,0.556,0,0,,1,3,0.333,5,9,14
8544,Jusuf Nurkic,22-137,C,1/7/17,DEN,@,OKC,L,1,26,5,14,0.357,5,14,0.357,0,0,,1,4,0.25,5,4,9
8545,Jusuf Nurkic,22-077,C,11/8/16,DEN,@,MEM,L,1,29,5,7,0.714,5,7,0.714,0,0,,1,1,1,1,6,7
8546,Kyle O'Quinn,26-217,F-C,10/29/16,NYK,,MEM,W,0,19,3,5,0.6,3,5,0.6,0,0,,5,7,0.714,2,4,6
8547,Kyle O'Quinn,26-345,F-C,3/6/17,NYK,@,ORL,W,0,12,5,6,0.833,5,6,0.833,0,0,,1,2,0.5,4,4,8
8548,Jahlil Okafor,21-005,C-F,12/20/16,PHI,,NOP,L,1,25,5,8,0.625,5,8,0.625,0,0,,1,2,0.5,1,6,7
8549,Jahlil Okafor,21-071,C-F,2/24/17,PHI,,WAS,W,1,22,3,6,0.5,3,6,0.5,0,0,,5,8,0.625,0,2,2
8550,Kelly Olynyk,25-327,C-F,3/12/17,BOS,,CHI,W,0,31,5,10,0.5,4,8,0.5,1,2,0.5,0,0,,3,6,9
8551,Kelly Olynyk,25-247,C-F,12/22/16,BOS,@,IND,W,0,20,4,8,0.5,2,3,0.667,2,5,0.4,1,1,1,0,5,5
8552,Kelly Oubre,21-046,F,1/24/17,WAS,,BOS,W,0,30,4,10,0.4,1,4,0.25,3,6,0.5,0,0,,0,3,3
8553,Kelly Oubre,21-043,F,1/21/17,WAS,@,DET,L,0,27,5,9,0.556,4,7,0.571,1,2,0.5,0,0,,2,2,4
8554,Kelly Oubre,21-059,F,2/6/17,WAS,,CLE,L,0,28,4,10,0.4,3,7,0.429,1,3,0.333,2,2,1,3,4,7
8555,Zaza Pachulia,32-327,C,1/2/17,GSW,,DEN,W,1,19,4,8,0.5,4,8,0.5,0,0,,3,3,1,4,5,9
8556,Zaza Pachulia,33-029,C,3/11/17,GSW,@,SAS,L,1,20,4,9,0.444,4,9,0.444,0,0,,3,5,0.6,6,6,12
8557,Jabari Parker,21-247,F,11/17/16,MIL,@,MIA,L,1,33,5,20,0.25,4,14,0.286,1,6,0.167,0,0,,2,6,8
8558,Tony Parker,34-190,G,11/23/16,SAS,@,CHO,W,1,29,3,10,0.3,2,6,0.333,1,4,0.25,4,4,1,0,1,1
8559,Tony Parker,34-212,G,12/15/16,SAS,@,PHO,W,1,26,4,8,0.5,3,5,0.6,1,3,0.333,2,2,1,0,1,1
8560,Tony Parker,34-181,G,11/14/16,SAS,,MIA,W,1,26,4,10,0.4,4,9,0.444,0,1,0,3,4,0.75,1,2,3
8561,Patrick Patterson,27-347,F,2/24/17,TOR,,BOS,W,0,17,4,6,0.667,3,3,1,1,3,0.333,2,2,1,1,1,2
8562,Patrick Patterson,27-256,F,11/25/16,TOR,@,MIL,W,0,25,3,7,0.429,0,1,0,3,6,0.5,2,2,1,1,4,5
8563,Patrick Patterson,27-251,F,11/20/16,TOR,@,SAC,L,0,27,4,7,0.571,1,1,1,3,6,0.5,0,0,,1,4,5
8564,Patrick Patterson,27-364,F,3/13/17,TOR,,DAL,W,0,21,4,6,0.667,1,1,1,3,5,0.6,0,0,,1,6,7
8565,Chris Paul,31-196,G,11/18/16,LAC,@,SAC,W,1,33,2,10,0.2,1,4,0.25,1,6,0.167,6,8,0.75,1,8,9
8566,Cameron Payne,22-214,G,3/10/17,CHI,,HOU,L,0,16,4,8,0.5,2,4,0.5,2,4,0.5,1,4,0.25,0,2,2
8567,Elfrid Payton,22-345,G,2/1/17,ORL,,IND,L,1,32,5,10,0.5,5,9,0.556,0,1,0,1,1,1,0,6,6
8568,Elfrid Payton,22-342,G,1/29/17,ORL,@,TOR,W,1,36,4,13,0.308,4,10,0.4,0,3,0,3,4,0.75,0,4,4
8569,Mason Plumlee,26-347,C-F,2/15/17,DEN,,MIN,L,1,34,4,8,0.5,4,7,0.571,0,1,0,3,6,0.5,2,7,9
8570,Mason Plumlee,26-273,C-F,12/3/16,POR,,MIA,W,1,33,5,8,0.625,5,8,0.625,0,0,,1,2,0.5,1,8,9
8571,Mason Plumlee,26-253,C-F,11/13/16,POR,,DEN,W,1,24,5,7,0.714,5,7,0.714,0,0,,1,3,0.333,4,5,9
8572,Mason Plumlee,26-267,C-F,11/27/16,POR,,HOU,L,1,33,5,7,0.714,5,7,0.714,0,0,,1,4,0.25,5,3,8
8573,Mason Plumlee,26-311,C-F,1/10/17,POR,@,LAL,W,1,24,5,7,0.714,5,7,0.714,0,0,,1,2,0.5,1,6,7
8574,Otto Porter,23-221,F,1/10/17,WAS,,CHI,W,1,34,5,10,0.5,4,6,0.667,1,4,0.25,0,0,,0,2,2
8575,Otto Porter,23-275,F,3/5/17,WAS,,ORL,W,1,31,4,9,0.444,3,5,0.6,1,4,0.25,2,2,1,1,3,4
8576,Otto Porter,23-232,F,1/21/17,WAS,@,DET,L,1,34,4,13,0.308,2,7,0.286,2,6,0.333,1,2,0.5,1,6,7
8577,Otto Porter,23-283,F,3/13/17,WAS,@,MIN,L,1,31,5,12,0.417,4,9,0.444,1,3,0.333,0,0,,2,4,6
8578,Otto Porter,23-244,F,2/2/17,WAS,,LAL,W,1,38,4,9,0.444,1,3,0.333,3,6,0.5,0,0,,0,6,6
8579,Otto Porter,23-180,F,11/30/16,WAS,@,OKC,L,1,39,5,9,0.556,4,7,0.571,1,2,0.5,0,0,,0,8,8
8580,Otto Porter,23-161,F,11/11/16,WAS,,CLE,L,1,34,5,11,0.455,4,8,0.5,1,3,0.333,0,0,,3,5,8
8581,Bobby Portis,22-022,F,3/4/17,CHI,,LAC,L,1,21,5,11,0.455,5,9,0.556,0,2,0,1,2,0.5,1,6,7
8582,Kristaps Porzingis,21-122,F-C,12/2/16,NYK,,MIN,W,1,40,2,12,0.167,0,6,0,2,6,0.333,5,7,0.714,2,3,5
8583,Kristaps Porzingis,21-224,F-C,3/14/17,NYK,,IND,W,1,25,5,17,0.294,4,11,0.364,1,6,0.167,0,0,,2,1,3
8584,Kristaps Porzingis,21-197,F-C,2/15/17,NYK,@,OKC,L,1,33,4,13,0.308,3,9,0.333,1,4,0.25,2,2,1,0,7,7
8585,Dwight Powell,25-152,F-C,12/19/16,DAL,@,DEN,L,0,29,5,8,0.625,4,7,0.571,1,1,1,0,0,,3,6,9
8586,Dwight Powell,25-105,F-C,11/2/16,DAL,@,UTA,L,0,16,5,8,0.625,5,8,0.625,0,0,,1,2,0.5,0,1,1
8587,Norman Powell,23-180,G,11/21/16,TOR,@,LAC,L,1,26,4,9,0.444,2,4,0.5,2,5,0.4,1,1,1,0,0,0
8588,Norman Powell,23-298,G,3/19/17,TOR,,IND,W,0,14,4,11,0.364,3,5,0.6,1,6,0.167,2,2,1,1,2,3
8589,Norman Powell,23-296,G,3/17/17,TOR,@,DET,W,0,19,4,10,0.4,4,7,0.571,0,3,0,3,4,0.75,0,2,2
8590,Julius Randle,22-077,F,2/14/17,LAL,,SAC,L,1,21,5,11,0.455,4,10,0.4,1,1,1,0,0,,3,4,7
8591,Julius Randle,22-006,F,12/5/16,LAL,,UTA,L,1,37,5,12,0.417,5,12,0.417,0,0,,1,2,0.5,4,7,11
8592,Zach Randolph,35-130,F,11/23/16,MEM,@,PHI,W,0,27,5,14,0.357,5,13,0.385,0,1,0,1,2,0.5,1,5,6
8593,Zach Randolph,35-189,F,1/21/17,MEM,,HOU,L,0,24,4,11,0.364,4,9,0.444,0,2,0,3,5,0.6,1,7,8
8594,Zach Randolph,35-171,F,1/3/17,MEM,@,LAL,L,0,28,3,12,0.25,2,10,0.2,1,2,0.5,4,4,1,3,6,9
8595,Zach Randolph,35-223,F,2/24/17,MEM,@,IND,L,0,26,4,13,0.308,4,12,0.333,0,1,0,3,5,0.6,2,6,8
8596,J.J. Redick,32-182,G,12/23/16,LAC,,DAL,L,1,30,4,10,0.4,2,3,0.667,2,7,0.286,1,2,0.5,0,3,3
8597,J.J. Redick,32-181,G,12/22/16,LAC,,SAS,W,1,21,3,7,0.429,0,3,0,3,4,0.75,2,2,1,0,0,0
8598,Willie Reed,26-175,F-C,11/7/16,MIA,@,OKC,L,0,17,4,4,1,4,4,1,0,0,,3,4,0.75,3,1,4
8599,Josh Richardson,23-110,G,1/3/17,MIA,@,PHO,L,1,37,5,16,0.313,4,11,0.364,1,5,0.2,0,0,,0,2,2
8600,Josh Richardson,23-086,G,12/10/16,MIA,@,CHI,L,0,26,5,12,0.417,5,6,0.833,0,6,0,1,2,0.5,1,2,3
8601,Austin Rivers,24-229,G,3/18/17,LAC,,CLE,W,0,29,4,9,0.444,4,4,1,0,5,0,3,4,0.75,0,3,3
8602,Austin Rivers,24-098,G,11/7/16,LAC,,DET,W,0,23,5,10,0.5,4,7,0.571,1,3,0.333,0,0,,0,2,2
8603,Andre Roberson,25-064,G-F,2/6/17,OKC,@,IND,L,1,36,5,8,0.625,5,8,0.625,0,0,,1,3,0.333,3,8,11
8604,Andre Roberson,25-013,G-F,12/17/16,OKC,,PHO,W,1,35,4,7,0.571,3,5,0.6,1,2,0.5,2,4,0.5,0,1,1
8605,Glenn Robinson,23-059,G-F,3/8/17,IND,,DET,W,0,19,4,8,0.5,3,5,0.6,1,3,0.333,2,3,0.667,0,4,4
8606,Glenn Robinson,23-056,G-F,3/5/17,IND,@,ATL,W,0,23,3,5,0.6,0,0,,3,5,0.6,2,2,1,0,4,4
8607,Glenn Robinson,22-295,G-F,10/29/16,IND,@,CHI,L,0,18,4,7,0.571,4,5,0.8,0,2,0,3,3,1,2,1,3
8608,Sergio Rodriguez,30-169,G,11/28/16,PHI,@,TOR,L,1,28,4,7,0.571,2,4,0.5,2,3,0.667,1,1,1,1,2,3
8609,Sergio Rodriguez,30-215,G,1/13/17,PHI,,CHO,W,0,16,4,7,0.571,2,2,1,2,5,0.4,1,1,1,0,1,1
8610,Derrick Rose,28-057,G,11/30/16,NYK,@,MIN,W,1,24,5,12,0.417,4,9,0.444,1,3,0.333,0,0,,0,0,0
8611,Derrick Rose,28-158,G,3/11/17,NYK,@,DET,L,1,27,5,12,0.417,5,11,0.455,0,1,0,1,2,0.5,1,1,2
8612,Derrick Rose,28-038,G,11/11/16,NYK,@,BOS,L,1,27,3,10,0.3,2,7,0.286,1,3,0.333,4,4,1,0,4,4
8613,Terrence Ross,25-281,F-G,11/12/16,TOR,,NYK,W,0,18,3,8,0.375,2,6,0.333,1,2,0.5,4,4,1,0,0,0
8614,Terrence Ross,25-331,F-G,1/1/17,TOR,@,LAL,W,0,24,4,9,0.444,1,3,0.333,3,6,0.5,0,0,,0,5,5
8615,Terrence Ross,26-034,F-G,3/11/17,ORL,,CLE,L,1,32,4,11,0.364,4,7,0.571,0,4,0,3,4,0.75,0,4,4
8616,Terrence Ross,26-003,F-G,2/8/17,TOR,@,MIN,L,0,14,5,9,0.556,4,5,0.8,1,4,0.25,0,0,,0,2,2
8617,Terrence Ross,25-285,F-G,11/16/16,TOR,,GSW,L,0,22,2,8,0.25,0,4,0,2,4,0.5,5,5,1,1,2,3
8618,Terrence Ross,25-317,F-G,12/18/16,TOR,@,ORL,W,0,23,4,13,0.308,1,5,0.2,3,8,0.375,0,0,,0,2,2
8619,Terry Rozier,22-336,G,2/16/17,BOS,@,CHI,L,0,23,3,8,0.375,0,2,0,3,6,0.5,2,2,1,0,3,3
8620,Terry Rozier,22-246,G,11/18/16,BOS,,GSW,L,0,26,3,5,0.6,1,2,0.5,2,3,0.667,3,4,0.75,1,6,7
8621,Terry Rozier,22-300,G,1/11/17,BOS,,WAS,W,0,25,4,6,0.667,2,3,0.667,2,3,0.667,1,1,1,0,4,4
8622,Terry Rozier,22-240,G,11/12/16,BOS,@,IND,W,0,22,4,7,0.571,2,3,0.667,2,4,0.5,1,2,0.5,0,6,6
8623,Terry Rozier,22-329,G,2/9/17,BOS,@,POR,W,0,25,4,9,0.444,2,5,0.4,2,4,0.5,1,1,1,1,3,4
8624,Ricky Rubio,26-038,G,11/28/16,MIN,,UTA,L,1,25,4,5,0.8,3,3,1,1,2,0.5,2,2,1,0,2,2
8625,Ricky Rubio,26-053,G,12/13/16,MIN,@,CHI,W,1,35,3,6,0.5,2,5,0.4,1,1,1,4,4,1,2,3,5
8626,Ricky Rubio,26-035,G,11/25/16,MIN,@,PHO,W,1,25,4,7,0.571,3,5,0.6,1,2,0.5,2,2,1,0,1,1
8627,Ricky Rubio,26-134,G,3/4/17,MIN,@,SAS,L,1,43,4,12,0.333,3,10,0.3,1,2,0.5,2,4,0.5,2,11,13
8628,Ricky Rubio,26-131,G,3/1/17,MIN,@,UTA,W,1,29,4,7,0.571,4,7,0.571,0,0,,3,4,0.75,2,4,6
8629,Ricky Rubio,26-025,G,11/15/16,MIN,,CHO,L,1,35,2,5,0.4,0,2,0,2,3,0.667,5,6,0.833,2,6,8
8630,Damjan Rudez,30-152,F,11/16/16,ORL,,NOP,W,0,15,4,5,0.8,1,1,1,3,4,0.75,0,0,,2,1,3
8631,Brandon Rush,31-190,G-F,1/13/17,MIN,,OKC,W,1,40,4,9,0.444,1,3,0.333,3,6,0.5,0,0,,3,1,4
8632,D'Angelo Russell,20-295,G,12/14/16,LAL,@,BRK,L,1,23,2,10,0.2,0,5,0,2,5,0.4,5,8,0.625,1,2,3
8633,D'Angelo Russell,20-257,G,11/6/16,LAL,,PHO,W,1,28,2,11,0.182,0,5,0,2,6,0.333,5,6,0.833,2,3,5
8634,D'Angelo Russell,20-252,G,11/1/16,LAL,@,IND,L,1,19,3,10,0.3,3,6,0.5,0,4,0,5,5,1,0,0,0
8635,D'Angelo Russell,21-017,G,3/12/17,LAL,,PHI,L,1,33,5,17,0.294,4,11,0.364,1,6,0.167,0,0,,0,4,4
8636,Domantas Sabonis,20-304,F,3/3/17,OKC,@,PHO,L,1,13,4,5,0.8,2,3,0.667,2,2,1,1,2,0.5,1,2,3
8637,Dario Saric,22-220,F,11/14/16,PHI,@,HOU,L,1,24,4,11,0.364,3,8,0.375,1,3,0.333,2,2,1,1,5,6
8638,Dennis Schroder,23-044,G,10/29/16,ATL,@,PHI,W,1,28,4,7,0.571,4,6,0.667,0,1,0,3,4,0.75,0,3,3
8639,Dennis Schroder,23-073,G,11/27/16,ATL,@,LAL,L,1,32,5,15,0.333,4,10,0.4,1,5,0.2,0,0,,1,3,4
8640,Dennis Schroder,23-163,G,2/25/17,ATL,@,ORL,L,0,31,4,17,0.235,3,12,0.25,1,5,0.2,2,3,0.667,0,5,5
8641,Dennis Schroder,23-064,G,11/18/16,ATL,@,CHO,L,1,31,5,12,0.417,5,7,0.714,0,5,0,1,2,0.5,0,1,1
8642,Dennis Schroder,23-048,G,11/2/16,ATL,,LAL,L,1,29,4,11,0.364,3,8,0.375,1,3,0.333,2,2,1,0,2,2
8643,Luis Scola,36-230,F,12/16/16,BRK,@,ORL,L,0,12,4,7,0.571,1,4,0.25,3,3,1,0,0,,0,0,0
8644,Mike Scott,28-195,F,1/27/17,ATL,,WAS,L,0,11,4,6,0.667,3,4,0.75,1,2,0.5,2,2,1,1,3,4
8645,Thabo Sefolosha,32-207,G-F,11/25/16,ATL,@,UTA,L,0,23,4,7,0.571,4,6,0.667,0,1,0,3,4,0.75,3,4,7
8646,Thabo Sefolosha,32-240,G-F,12/28/16,ATL,,NYK,W,1,31,3,7,0.429,2,3,0.667,1,4,0.25,4,4,1,1,5,6
8647,Thabo Sefolosha,32-180,G-F,10/29/16,ATL,@,PHI,W,0,19,4,4,1,4,4,1,0,0,,3,4,0.75,0,4,4
8648,Thabo Sefolosha,32-322,G-F,3/20/17,ATL,@,CHO,L,1,28,4,7,0.571,1,2,0.5,3,5,0.6,0,2,0,2,6,8
8649,Thabo Sefolosha,32-266,G-F,1/23/17,ATL,,LAC,L,1,30,5,11,0.455,4,10,0.4,1,1,1,0,0,,1,2,3
8650,Wayne Selden,22-168,G-F,3/17/17,NOP,,HOU,W,1,19,4,5,0.8,1,1,1,3,4,0.75,0,0,,0,1,1
8651,Iman Shumpert,26-183,G,12/26/16,CLE,@,DET,L,0,33,4,10,0.4,3,7,0.429,1,3,0.333,2,2,1,0,1,1
8652,Iman Shumpert,26-209,G,1/21/17,CLE,,SAS,L,1,38,4,8,0.5,1,3,0.333,3,5,0.6,0,0,,1,2,3
8653,Pascal Siakam,22-298,F,11/28/16,TOR,,PHI,W,1,23,4,6,0.667,4,6,0.667,0,0,,3,4,0.75,0,2,2
8654,Jonathon Simmons,27-141,G-F,2/2/17,SAS,,PHI,W,0,19,3,8,0.375,3,7,0.429,0,1,0,5,6,0.833,0,3,3
8655,Jonathon Simmons,27-131,G-F,1/23/17,SAS,@,BRK,W,0,19,3,7,0.429,2,5,0.4,1,2,0.5,4,4,1,0,4,4
8656,Jonathon Simmons,27-045,G-F,10/29/16,SAS,,NOP,W,0,26,5,12,0.417,5,11,0.455,0,1,0,1,2,0.5,0,3,3
8657,Marcus Smart,22-283,G,12/14/16,BOS,@,SAS,L,1,37,5,12,0.417,5,8,0.625,0,4,0,1,1,1,1,1,2
8658,Marcus Smart,22-280,G,12/11/16,BOS,@,OKC,L,1,36,5,11,0.455,4,7,0.571,1,4,0.25,0,1,0,1,5,6
8659,Marcus Smart,22-364,G,3/5/17,BOS,@,PHO,L,0,28,1,5,0.2,1,2,0.5,0,3,0,9,12,0.75,0,3,3
8660,Ish Smith,28-123,G,11/5/16,DET,,DEN,W,1,28,5,13,0.385,5,12,0.417,0,1,0,1,2,0.5,1,4,5
8661,Ish Smith,28-152,G,12/4/16,DET,,ORL,L,0,25,5,10,0.5,5,8,0.625,0,2,0,1,2,0.5,1,0,1
8662,Ish Smith,28-242,G,3/4/17,DET,@,PHI,W,0,23,5,8,0.625,5,7,0.714,0,1,0,1,1,1,0,4,4
8663,Ish Smith,28-150,G,12/2/16,DET,@,ATL,W,1,29,5,10,0.5,4,7,0.571,1,3,0.333,0,0,,0,5,5
8664,Ish Smith,28-216,G,2/6/17,DET,,PHI,W,0,20,5,10,0.5,5,10,0.5,0,0,,1,1,1,0,1,1
8665,Ish Smith,28-117,G,10/30/16,DET,,MIL,W,1,31,5,17,0.294,5,14,0.357,0,3,0,1,1,1,0,2,2
8666,Ish Smith,28-132,G,11/14/16,DET,,OKC,W,1,30,4,8,0.5,4,8,0.5,0,0,,3,4,0.75,0,6,6
8667,J.R. Smith,31-183,G-F,3/11/17,CLE,@,ORL,W,0,21,4,8,0.5,1,1,1,3,7,0.429,0,0,,0,1,1
8668,J.R. Smith,31-057,G-F,11/5/16,CLE,@,PHI,W,1,32,3,7,0.429,0,0,,3,7,0.429,2,2,1,0,1,1
8669,Jason Smith,30-323,F-C,1/19/17,WAS,@,NYK,W,0,23,5,8,0.625,4,6,0.667,1,2,0.5,0,0,,1,3,4
8670,Tony Snell,25-048,G-F,12/28/16,MIL,@,DET,W,1,28,4,4,1,1,1,1,3,3,1,0,0,,0,6,6
8671,Tony Snell,25-043,G-F,12/23/16,MIL,,WAS,W,1,27,5,8,0.625,4,4,1,1,4,0.25,0,0,,0,3,3
8672,Tony Snell,25-006,G-F,11/16/16,MIL,@,ATL,L,1,31,4,10,0.4,2,3,0.667,2,7,0.286,1,2,0.5,2,2,4
8673,Marreese Speights,29-185,C-F,2/5/17,LAC,@,BOS,L,0,17,2,5,0.4,0,1,0,2,4,0.5,5,6,0.833,1,4,5
8674,Marreese Speights,29-219,C-F,3/11/17,LAC,,PHI,W,0,12,5,6,0.833,4,4,1,1,2,0.5,0,0,,0,2,2
8675,Marreese Speights,29-146,C-F,12/28/16,LAC,@,NOP,L,0,18,4,11,0.364,2,4,0.5,2,7,0.286,1,1,1,0,4,4
8676,Nik Stauskas,23-140,G,2/24/17,PHI,,WAS,W,0,24,3,7,0.429,2,4,0.5,1,3,0.333,4,4,1,0,3,3
8677,Nik Stauskas,23-131,G,2/15/17,PHI,@,BOS,L,0,28,3,8,0.375,2,2,1,1,6,0.167,4,6,0.667,1,5,6
8678,Nik Stauskas,23-129,G,2/13/17,PHI,@,CHO,W,0,25,3,8,0.375,1,5,0.2,2,3,0.667,3,4,0.75,1,5,6
8679,Nik Stauskas,23-127,G,2/11/17,PHI,,MIA,W,0,30,4,8,0.5,2,4,0.5,2,4,0.5,1,2,0.5,0,1,1
8680,Nik Stauskas,23-052,G,11/28/16,PHI,@,TOR,L,0,29,4,9,0.444,1,3,0.333,3,6,0.5,0,0,,0,0,0
8681,Nik Stauskas,23-110,G,1/25/17,PHI,@,MIL,W,1,26,4,7,0.571,1,2,0.5,3,5,0.6,0,0,,0,0,0
8682,Nik Stauskas,23-051,G,11/27/16,PHI,,CLE,L,0,25,4,6,0.667,2,2,1,2,4,0.5,1,2,0.5,0,3,3
8683,Jeff Teague,28-157,G,11/14/16,IND,,ORL,W,1,29,4,9,0.444,3,6,0.5,1,3,0.333,2,2,1,0,8,8
8684,Jeff Teague,28-224,G,1/20/17,IND,@,LAL,L,1,33,3,9,0.333,2,6,0.333,1,3,0.333,4,4,1,1,2,3
8685,Jeff Teague,28-166,G,11/23/16,IND,,ATL,L,1,39,5,15,0.333,5,10,0.5,0,5,0,1,1,1,1,5,6
8686,Jeff Teague,28-164,G,11/21/16,IND,,GSW,L,1,26,5,14,0.357,5,11,0.455,0,3,0,1,1,1,1,3,4
8687,Mirza Teletovic,31-178,F,3/15/17,MIL,@,LAC,W,0,20,3,9,0.333,0,1,0,3,8,0.375,2,2,1,0,1,1
8688,Mirza Teletovic,31-110,F,1/6/17,MIL,,NYK,L,0,17,3,5,0.6,0,0,,3,5,0.6,2,2,1,0,1,1
8689,Mirza Teletovic,31-078,F,12/5/16,MIL,,SAS,L,0,21,4,10,0.4,1,2,0.5,3,8,0.375,0,0,,0,2,2
8690,Garrett Temple,30-247,G,1/10/17,SAC,,DET,W,1,30,4,8,0.5,1,4,0.25,3,4,0.75,0,0,,0,1,1
8691,Garrett Temple,30-227,G,12/21/16,SAC,@,UTA,W,0,28,4,7,0.571,1,2,0.5,3,5,0.6,0,0,,0,2,2
8692,Garrett Temple,30-260,G,1/23/17,SAC,@,DET,W,1,34,3,6,0.5,2,4,0.5,1,2,0.5,4,5,0.8,1,2,3
8693,Garrett Temple,30-301,G,3/5/17,SAC,,UTA,L,0,24,4,9,0.444,2,5,0.4,2,4,0.5,1,1,1,0,2,2
8694,Lance Thomas,28-251,F,12/31/16,NYK,@,HOU,L,1,33,3,9,0.333,2,5,0.4,1,4,0.25,4,4,1,0,1,1
8695,Lance Thomas,28-311,F,3/1/17,NYK,@,ORL,W,1,31,4,5,0.8,4,5,0.8,0,0,,3,4,0.75,1,4,5
8696,Lance Thomas,28-226,F,12/6/16,NYK,@,MIA,W,0,21,5,6,0.833,4,5,0.8,1,1,1,0,0,,0,3,3
8697,Lance Thomas,28-307,F,2/25/17,NYK,,PHI,W,1,37,4,10,0.4,3,8,0.375,1,2,0.5,2,3,0.667,0,6,6
8698,Hollis Thompson,25-236,G-F,11/25/16,PHI,,CHI,L,0,21,4,5,0.8,1,2,0.5,3,3,1,0,0,,0,5,5
8699,Hollis Thompson,25-227,G-F,11/16/16,PHI,,WAS,W,0,23,5,8,0.625,4,6,0.667,1,2,0.5,0,1,0,0,1,1
8700,Klay Thompson,26-260,G,10/25/16,GSW,,SAS,L,1,33,5,13,0.385,4,7,0.571,1,6,0.167,0,0,,0,1,1
8701,Tristan Thompson,26-005,F-C,3/18/17,CLE,@,LAC,L,1,31,5,6,0.833,5,6,0.833,0,0,,1,2,0.5,3,3,6
8702,Tristan Thompson,25-229,F-C,10/28/16,CLE,@,TOR,W,1,36,5,5,1,5,5,1,0,0,,1,2,0.5,3,7,10
8703,Tristan Thompson,25-264,F-C,12/2/16,CLE,@,CHI,L,1,27,5,5,1,5,5,1,0,0,,1,4,0.25,2,4,6
8704,Tristan Thompson,25-293,F-C,12/31/16,CLE,@,CHO,W,1,29,4,5,0.8,4,5,0.8,0,0,,3,3,1,2,4,6
8705,Tristan Thompson,25-291,F-C,12/29/16,CLE,,BOS,W,1,32,5,9,0.556,5,8,0.625,0,1,0,1,2,0.5,3,6,9
8706,Tristan Thompson,25-257,F-C,11/25/16,CLE,,DAL,W,1,29,4,5,0.8,4,5,0.8,0,0,,3,4,0.75,4,8,12
8707,Marcus Thornton,29-178,G,11/30/16,WAS,@,OKC,L,0,17,4,7,0.571,3,4,0.75,1,3,0.333,2,2,1,1,2,3
8708,Marcus Thornton,29-194,G,12/16/16,WAS,,DET,W,0,15,4,6,0.667,3,4,0.75,1,2,0.5,2,2,1,0,1,1
8709,Marcus Thornton,29-147,G,10/30/16,WAS,@,MEM,L,0,16,4,6,0.667,3,4,0.75,1,2,0.5,2,3,0.667,2,3,5
8710,Marcus Thornton,29-183,G,12/5/16,WAS,@,BRK,W,0,18,4,10,0.4,2,5,0.4,2,5,0.4,1,2,0.5,2,1,3
8711,Anthony Tolliver,31-252,F-C,2/8/17,SAC,,BOS,W,1,37,5,12,0.417,4,5,0.8,1,7,0.143,0,0,,0,4,4
8712,Anthony Tolliver,31-202,F-C,12/20/16,SAC,,POR,W,0,34,3,5,0.6,0,1,0,3,4,0.75,2,2,1,1,3,4
8713,Anthony Tolliver,31-269,F-C,2/25/17,SAC,,CHO,L,1,20,3,7,0.429,0,1,0,3,6,0.5,2,4,0.5,0,4,4
8714,Anthony Tolliver,31-248,F-C,2/4/17,SAC,,GSW,W,0,36,4,5,0.8,1,2,0.5,3,3,1,0,0,,1,5,6
8715,Karl-Anthony Towns,21-047,F-C,1/1/17,MIN,,POR,L,1,34,3,15,0.2,3,9,0.333,0,6,0,5,5,1,4,9,13
8716,Karl-Anthony Towns,21-021,F-C,12/6/16,MIN,,SAS,L,1,37,3,16,0.188,2,13,0.154,1,3,0.333,4,4,1,3,11,14
8717,Karl-Anthony Towns,20-352,F-C,11/1/16,MIN,,MEM,W,1,30,4,10,0.4,4,10,0.4,0,0,,3,4,0.75,2,9,11
8718,P.J. Tucker,31-262,F,1/22/17,PHO,@,TOR,W,0,32,5,10,0.5,5,8,0.625,0,2,0,1,2,0.5,2,8,10
8719,P.J. Tucker,31-270,F,1/30/17,PHO,,MEM,L,0,25,5,7,0.714,4,4,1,1,3,0.333,0,0,,0,2,2
8720,P.J. Tucker,31-284,F,2/13/17,PHO,,NOP,L,0,33,5,11,0.455,4,7,0.571,1,4,0.25,0,0,,7,10,17
8721,P.J. Tucker,31-187,F,11/8/16,PHO,@,POR,L,0,30,3,5,0.6,3,5,0.6,0,0,,5,6,0.833,5,4,9
8722,P.J. Tucker,31-266,F,1/26/17,PHO,@,DEN,L,0,39,4,10,0.4,1,6,0.167,3,4,0.75,0,0,,1,3,4
8723,Evan Turner,28-006,G,11/2/16,POR,@,PHO,L,0,27,5,9,0.556,5,8,0.625,0,1,0,1,1,1,2,8,10
8724,Evan Turner,28-090,G,1/25/17,POR,,LAL,W,1,33,5,10,0.5,5,9,0.556,0,1,0,1,3,0.333,1,2,3
8725,Evan Turner,28-002,G,10/29/16,POR,@,DEN,W,0,25,5,9,0.556,4,7,0.571,1,2,0.5,0,0,,0,3,3
8726,Evan Turner,28-069,G,1/4/17,POR,@,GSW,L,0,30,5,10,0.5,4,8,0.5,1,2,0.5,0,0,,0,3,3
8727,Evan Turner,28-103,G,2/7/17,POR,@,DAL,W,1,23,4,7,0.571,3,3,1,1,4,0.25,2,2,1,0,2,2
8728,Evan Turner,28-066,G,1/1/17,POR,@,MIN,W,0,30,5,7,0.714,4,6,0.667,1,1,1,0,2,0,0,3,3
8729,Evan Turner,28-026,G,11/22/16,POR,@,NYK,L,0,24,4,8,0.5,4,8,0.5,0,0,,3,3,1,0,1,1
8730,Evan Turner,28-062,G,12/28/16,POR,,SAC,W,0,30,5,8,0.625,5,7,0.714,0,1,0,1,1,1,0,6,6
8731,Myles Turner,20-316,F-C,2/3/17,IND,@,BRK,W,1,27,4,8,0.5,3,5,0.6,1,3,0.333,2,2,1,1,3,4
8732,Myles Turner,20-314,F-C,2/1/17,IND,@,ORL,W,1,32,4,9,0.444,3,6,0.5,1,3,0.333,2,2,1,0,3,3
8733,Myles Turner,20-265,F-C,12/14/16,IND,@,MIA,L,1,37,5,13,0.385,5,10,0.5,0,3,0,1,1,1,2,5,7
8734,Beno Udrih,34-150,G,12/2/16,DET,@,ATL,W,0,16,5,6,0.833,5,6,0.833,0,0,,1,1,1,0,2,2
8735,Jonas Valanciunas,24-259,C,1/20/17,TOR,@,CHO,L,1,25,5,8,0.625,5,8,0.625,0,0,,1,1,1,3,3,6
8736,Jonas Valanciunas,24-224,C,12/16/16,TOR,,ATL,L,1,26,5,5,1,5,5,1,0,0,,1,2,0.5,1,5,6
8737,Jonas Valanciunas,24-308,C,3/10/17,TOR,@,ATL,L,1,30,5,12,0.417,5,12,0.417,0,0,,1,1,1,4,8,12
8738,Jonas Valanciunas,24-220,C,12/12/16,TOR,,MIL,W,1,23,4,9,0.444,4,9,0.444,0,0,,3,4,0.75,4,8,12
8739,Jonas Valanciunas,24-317,C,3/19/17,TOR,,IND,W,1,24,4,8,0.5,4,8,0.5,0,0,,3,4,0.75,6,7,13
8740,Denzel Valentine,23-121,G,3/17/17,CHI,@,WAS,L,0,31,4,10,0.4,2,3,0.667,2,7,0.286,1,1,1,0,4,4
8741,Denzel Valentine,23-119,G,3/15/17,CHI,,MEM,L,0,28,4,10,0.4,1,3,0.333,3,7,0.429,0,0,,0,7,7
8742,Denzel Valentine,23-101,G,2/25/17,CHI,@,CLE,W,0,20,4,6,0.667,1,1,1,3,5,0.6,0,0,,0,2,2
8743,Denzel Valentine,23-117,G,3/13/17,CHI,@,CHO,W,0,28,3,8,0.375,0,0,,3,8,0.375,2,2,1,2,3,5
8744,Denzel Valentine,23-122,G,3/18/17,CHI,,UTA,W,0,28,4,12,0.333,1,5,0.2,3,7,0.429,0,0,,1,11,12
8745,Noah Vonleh,21-207,F,3/19/17,POR,@,MIA,W,1,29,5,7,0.714,5,7,0.714,0,0,,1,2,0.5,2,5,7
8746,Noah Vonleh,21-062,F,10/25/16,POR,,UTA,W,0,16,5,5,1,4,4,1,1,1,1,0,0,,0,1,1
8747,Noah Vonleh,21-195,F,3/7/17,POR,@,OKC,W,1,22,5,6,0.833,5,6,0.833,0,0,,1,2,0.5,4,1,5
8748,Nikola Vucevic,26-014,C,11/7/16,ORL,@,CHI,L,1,23,5,8,0.625,5,8,0.625,0,0,,1,2,0.5,0,6,6
8749,Nikola Vucevic,26-060,C,12/23/16,ORL,,LAL,W,0,26,5,11,0.455,5,11,0.455,0,0,,1,2,0.5,0,7,7
8750,Nikola Vucevic,26-005,C,10/29/16,ORL,@,CLE,L,1,25,5,8,0.625,5,8,0.625,0,0,,1,2,0.5,2,7,9
8751,Dion Waiters,24-349,G,11/23/16,MIA,@,DET,L,1,21,3,10,0.3,2,7,0.286,1,3,0.333,4,4,1,0,2,2
8752,Dion Waiters,24-341,G,11/15/16,MIA,,ATL,L,1,34,5,18,0.278,4,13,0.308,1,5,0.2,0,0,,0,1,1
8753,Taurean Waller-Prince,22-363,F,3/20/17,ATL,@,CHO,L,0,30,4,13,0.308,3,10,0.3,1,3,0.333,2,4,0.5,1,3,4
8754,Taurean Waller-Prince,22-340,F,2/25/17,ATL,@,ORL,L,0,27,4,7,0.571,2,4,0.5,2,3,0.667,1,2,0.5,2,2,4
8755,T.J. Warren,23-163,F,2/15/17,PHO,,LAL,W,1,21,4,5,0.8,4,5,0.8,0,0,,3,3,1,1,2,3
8756,T.J. Warren,23-112,F,12/26/16,PHO,@,HOU,L,0,31,5,16,0.313,4,12,0.333,1,4,0.25,0,1,0,2,2,4
8757,C.J. Watson,32-298,G,2/9/17,ORL,,PHI,L,1,28,2,6,0.333,1,4,0.25,1,2,0.5,6,6,1,0,3,3
8758,C.J. Watson,32-250,G,12/23/16,ORL,,LAL,W,0,23,5,7,0.714,4,5,0.8,1,2,0.5,0,0,,0,1,1
8759,Isaiah Whitehead,21-285,G,12/18/16,BRK,@,PHI,L,1,21,3,6,0.5,1,3,0.333,2,3,0.667,3,4,0.75,0,1,1
8760,Isaiah Whitehead,21-336,G,2/7/17,BRK,@,CHO,L,0,26,4,11,0.364,3,9,0.333,1,2,0.5,2,2,1,0,1,1
8761,Isaiah Whitehead,21-264,G,11/27/16,BRK,,SAC,L,1,29,4,6,0.667,1,3,0.333,3,3,1,0,0,,0,4,4
8762,Isaiah Whitehead,21-257,G,11/20/16,BRK,,POR,L,1,24,2,10,0.2,1,6,0.167,1,4,0.25,6,6,1,0,1,1
8763,Hassan Whiteside,27-186,C,12/16/16,MIA,,LAC,L,1,31,5,12,0.417,5,12,0.417,0,0,,1,5,0.2,2,15,17
8764,Hassan Whiteside,27-200,C,12/30/16,MIA,@,BOS,L,1,32,5,9,0.556,5,9,0.556,0,0,,1,2,0.5,0,8,8
8765,Andrew Wiggins,21-287,F-G,12/6/16,MIN,,SAS,L,1,38,5,12,0.417,5,10,0.5,0,2,0,1,3,0.333,2,5,7
8766,Andrew Wiggins,22-016,F-G,3/11/17,MIN,@,MIL,L,1,37,3,13,0.231,3,11,0.273,0,2,0,5,6,0.833,2,2,4
8767,Alan Williams,24-036,F-C,3/5/17,PHO,,BOS,W,0,31,5,12,0.417,5,12,0.417,0,0,,1,3,0.333,4,11,15
8768,Alan Williams,24-050,F-C,3/19/17,PHO,@,DET,L,0,26,4,11,0.364,4,11,0.364,0,0,,3,5,0.6,0,12,12
8769,Alan Williams,24-031,F-C,2/28/17,PHO,@,MEM,L,0,22,5,8,0.625,5,8,0.625,0,0,,1,2,0.5,2,2,4
8770,Deron Williams,32-265,G,3/18/17,CLE,@,LAC,L,1,26,4,8,0.5,3,7,0.429,1,1,1,2,2,1,0,3,3
8771,Deron Williams,32-187,G,12/30/16,DAL,@,GSW,L,1,20,4,7,0.571,3,4,0.75,1,3,0.333,2,3,0.667,0,2,2
8772,Deron Williams,32-205,G,1/17/17,DAL,@,CHI,W,1,30,5,11,0.455,4,6,0.667,1,5,0.2,0,0,,0,6,6
8773,Deron Williams,32-197,G,1/9/17,DAL,@,MIN,L,1,33,5,9,0.556,4,6,0.667,1,3,0.333,0,0,,1,1,2
8774,Derrick Williams,25-171,F,11/12/16,MIA,,UTA,L,0,20,5,8,0.625,4,6,0.667,1,2,0.5,0,2,0,1,3,4
8775,Marvin Williams,30-136,F,11/2/16,CHO,,PHI,W,1,30,4,12,0.333,2,5,0.4,2,7,0.286,1,2,0.5,1,7,8
8776,Marvin Williams,30-174,F,12/10/16,CHO,@,CLE,L,1,30,5,13,0.385,4,8,0.5,1,5,0.2,0,1,0,1,4,5
8777,Marvin Williams,30-202,F,1/7/17,CHO,@,SAS,L,1,27,3,10,0.3,2,4,0.5,1,6,0.167,4,4,1,2,3,5
8778,Troy Williams,21-341,F,12/5/16,MEM,@,NOP,W,1,20,5,9,0.556,4,6,0.667,1,3,0.333,0,0,,0,4,4
8779,Troy Williams,21-346,F,12/10/16,MEM,,GSW,W,1,19,4,7,0.571,3,4,0.75,1,3,0.333,2,2,1,0,2,2
8780,Justise Winslow,20-279,F,12/30/16,MIA,@,BOS,L,1,31,5,13,0.385,5,13,0.385,0,0,,1,2,0.5,4,5,9
8781,Justise Winslow,20-231,F,11/12/16,MIA,,UTA,L,1,34,5,13,0.385,5,12,0.417,0,1,0,1,1,1,0,6,6
8782,Delon Wright,24-306,G,2/26/17,TOR,,POR,W,0,15,5,9,0.556,4,6,0.667,1,3,0.333,0,0,,0,2,2
8783,Delon Wright,24-321,G,3/13/17,TOR,,DAL,W,0,20,4,8,0.5,3,5,0.6,1,3,0.333,2,2,1,0,4,4
8784,Delon Wright,24-295,G,2/15/17,TOR,,CHO,W,0,28,3,5,0.6,3,4,0.75,0,1,0,5,6,0.833,1,0,1
8785,Joe Young,24-124,G,10/29/16,IND,@,CHI,L,0,20,4,7,0.571,2,4,0.5,2,3,0.667,1,1,1,0,2,2
8786,Nick Young,31-227,G-F,1/14/17,LAL,@,LAC,L,1,29,4,8,0.5,2,3,0.667,2,5,0.4,1,2,0.5,0,0,0
8787,Thaddeus Young,28-146,F,11/14/16,IND,,ORL,W,1,30,5,8,0.625,4,7,0.571,1,1,1,0,0,,0,5,5
8788,Thaddeus Young,28-159,F,11/27/16,IND,,LAC,W,1,32,5,10,0.5,4,6,0.667,1,4,0.25,0,0,,1,5,6
8789,Thaddeus Young,28-190,F,12/28/16,IND,@,WAS,L,1,35,5,10,0.5,5,6,0.833,0,4,0,1,3,0.333,3,3,6
8790,Thaddeus Young,28-127,F,10/26/16,IND,,DAL,W,1,34,5,10,0.5,4,9,0.444,1,1,1,0,0,,0,5,5
8791,Thaddeus Young,28-143,F,11/11/16,IND,@,PHI,L,1,34,4,6,0.667,3,4,0.75,1,2,0.5,2,2,1,1,9,10
8792,Thaddeus Young,28-157,F,11/25/16,IND,,BRK,W,1,24,5,9,0.556,4,5,0.8,1,4,0.25,0,1,0,1,3,4
8793,Thaddeus Young,28-222,F,1/29/17,IND,,HOU,W,1,30,5,9,0.556,5,8,0.625,0,1,0,1,2,0.5,2,3,5
8794,Cody Zeller,24-052,F-C,11/26/16,CHO,,NYK,W,1,25,2,7,0.286,2,7,0.286,0,0,,7,12,0.583,5,5,10
8795,Cody Zeller,24-107,F-C,1/20/17,CHO,,TOR,W,1,23,4,6,0.667,4,6,0.667,0,0,,3,4,0.75,2,1,3
8796,Cody Zeller,24-076,F-C,12/20/16,CHO,,LAL,W,1,25,4,8,0.5,4,8,0.5,0,0,,3,4,0.75,2,3,5
8797,Cody Zeller,24-150,F-C,3/4/17,CHO,@,DEN,W,1,26,4,10,0.4,4,10,0.4,0,0,,3,6,0.5,1,7,8
8798,Cody Zeller,24-159,F-C,3/13/17,CHO,,CHI,L,1,34,4,10,0.4,4,10,0.4,0,0,,3,3,1,1,6,7
8799,Tyler Zeller,26-290,F-C,11/2/16,BOS,,CHI,W,1,25,5,11,0.455,5,11,0.455,0,0,,1,2,0.5,3,1,4
8800,Tyler Zeller,26-299,F-C,11/11/16,BOS,,NYK,W,0,21,3,6,0.5,3,6,0.5,0,0,,5,7,0.714,1,3,4
8801,Tyler Zeller,26-290,F-C,11/2/16,BOS,,CHI,W,1,25,5,11,0.455,5,11,0.455,0,0,,1,2,0.5,3,1,4
8802,Paul Zipser,22-351,G-F,2/3/17,CHI,@,HOU,L,0,29,4,10,0.4,3,4,0.75,1,6,0.167,2,2,1,2,1,3
8803,Ivica Zubac,19-305,C,1/17/17,LAL,,DEN,L,0,26,5,11,0.455,5,11,0.455,0,0,,1,2,0.5,5,8,13
8804,Ivica Zubac,19-343,C,2/24/17,LAL,@,OKC,L,0,27,5,9,0.556,5,9,0.556,0,0,,1,2,0.5,1,5,6
8805,Alex Abrines,23-150,G-F,12/29/16,OKC,@,MEM,L,0,27,2,11,0.182,0,3,0,2,8,0.25,4,4,1,2,1,3
8806,Alex Abrines,23-227,G-F,3/16/17,OKC,@,TOR,W,0,20,3,7,0.429,1,1,1,2,6,0.333,2,2,1,0,2,2
8807,Alex Abrines,23-146,G-F,12/25/16,OKC,,MIN,W,0,21,3,9,0.333,0,2,0,3,7,0.429,1,1,1,0,2,2
8808,Alex Abrines,23-109,G-F,11/18/16,OKC,,BRK,W,0,22,4,10,0.4,2,3,0.667,2,7,0.286,0,0,,0,2,2
8809,Quincy Acy,26-162,F,3/17/17,BRK,,BOS,L,0,32,3,11,0.273,1,3,0.333,2,8,0.25,2,4,0.5,0,8,8
8810,Steven Adams,23-239,C,3/16/17,OKC,@,TOR,W,1,25,5,8,0.625,5,8,0.625,0,0,,0,0,,2,3,5
8811,Steven Adams,23-147,C,12/14/16,OKC,@,UTA,L,1,28,4,7,0.571,4,7,0.571,0,0,,2,2,1,3,2,5
8812,Arron Afflalo,31-122,G,2/14/17,SAC,@,LAL,W,1,37,5,7,0.714,5,7,0.714,0,0,,0,0,,0,2,2
8813,Arron Afflalo,31-120,G,2/12/17,SAC,,NOP,W,1,32,3,7,0.429,2,4,0.5,1,3,0.333,3,3,1,0,1,1
8814,Alexis Ajinca,28-299,C,3/1/17,NOP,,DET,W,0,19,4,7,0.571,4,7,0.571,0,0,,2,2,1,1,7,8
8815,Cole Aldrich,28-032,C,12/2/16,MIN,@,NYK,L,0,27,4,6,0.667,4,6,0.667,0,0,,2,2,1,5,7,12
8816,LaMarcus Aldridge,31-156,F-C,12/22/16,SAS,@,LAC,L,1,23,5,13,0.385,5,12,0.417,0,1,0,0,0,,2,2,4
8817,LaMarcus Aldridge,31-129,F-C,11/25/16,SAS,@,BOS,W,1,32,4,12,0.333,4,12,0.333,0,0,,2,4,0.5,3,1,4
8818,LaMarcus Aldridge,31-184,F-C,1/19/17,SAS,,DEN,W,1,29,4,9,0.444,4,9,0.444,0,0,,2,2,1,1,2,3
8819,LaMarcus Aldridge,31-142,F-C,12/8/16,SAS,@,CHI,L,1,31,5,15,0.333,5,14,0.357,0,1,0,0,0,,3,3,6
8820,Lavoy Allen,27-360,F-C,1/29/17,IND,,HOU,W,0,15,5,5,1,5,5,1,0,0,,0,0,,0,2,2
8821,Lavoy Allen,28-020,F-C,2/24/17,IND,,MEM,W,0,21,5,5,1,5,5,1,0,0,,0,0,,2,8,10
8822,Lavoy Allen,28-006,F-C,2/10/17,IND,@,WAS,L,1,23,5,6,0.833,5,6,0.833,0,0,,0,0,,3,2,5
8823,Tony Allen,35-028,G-F,2/8/17,MEM,,PHO,W,1,29,4,12,0.333,4,12,0.333,0,0,,2,4,0.5,2,5,7
8824,Tony Allen,34-344,G-F,12/20/16,MEM,,BOS,L,1,38,5,8,0.625,5,7,0.714,0,1,0,0,0,,5,3,8
8825,Tony Allen,35-064,G-F,3/16/17,MEM,@,ATL,W,1,28,4,8,0.5,3,6,0.5,1,2,0.5,1,2,0.5,4,2,6
8826,Tony Allen,35-063,G-F,3/15/17,MEM,@,CHI,W,1,24,4,10,0.4,4,9,0.444,0,1,0,2,2,1,3,3,6
8827,Tony Allen,34-350,G-F,12/26/16,MEM,@,ORL,L,1,23,4,7,0.571,4,7,0.571,0,0,,2,2,1,0,2,2
8828,Al-Farouq Aminu,26-082,F,12/12/16,POR,@,LAC,L,1,21,4,6,0.667,2,3,0.667,2,3,0.667,0,0,,1,3,4
8829,Alan Anderson,34-075,G-F,12/30/16,LAC,@,HOU,L,0,25,4,9,0.444,4,7,0.571,0,2,0,2,2,1,0,3,3
8830,Justin Anderson,23-027,G,12/16/16,DAL,@,UTA,L,0,18,2,6,0.333,0,2,0,2,4,0.5,4,5,0.8,2,1,3
8831,Justin Anderson,23-006,G,11/25/16,DAL,@,CLE,L,0,14,4,7,0.571,3,5,0.6,1,2,0.5,1,2,0.5,1,0,1
8832,Ryan Anderson,28-199,F,11/21/16,HOU,@,DET,W,1,29,4,9,0.444,4,6,0.667,0,3,0,2,2,1,1,5,6
8833,Ryan Anderson,28-318,F,3/20/17,HOU,,DEN,W,1,25,4,8,0.5,2,2,1,2,6,0.333,0,0,,1,1,2
8834,Ryan Anderson,28-252,F,1/13/17,HOU,,MEM,L,1,26,3,11,0.273,2,3,0.667,1,8,0.125,3,4,0.75,0,0,0
8835,Ryan Anderson,28-316,F,3/18/17,HOU,@,DEN,W,1,27,3,7,0.429,2,3,0.667,1,4,0.25,3,3,1,0,4,4
8836,Carmelo Anthony,32-213,F,12/28/16,NYK,@,ATL,L,1,15,4,9,0.444,3,7,0.429,1,2,0.5,1,2,0.5,1,4,5
8837,Trevor Ariza,31-189,F,1/5/17,HOU,,OKC,W,1,35,4,14,0.286,2,6,0.333,2,8,0.25,0,0,,1,2,3
8838,Trevor Ariza,31-186,F,1/2/17,HOU,,WAS,W,1,44,4,10,0.4,2,4,0.5,2,6,0.333,0,0,,0,6,6
8839,Trevor Ariza,31-174,F,12/21/16,HOU,@,PHO,W,1,34,4,6,0.667,3,5,0.6,1,1,1,1,4,0.25,1,2,3
8840,Trevor Ariza,31-218,F,2/3/17,HOU,,CHI,W,1,39,3,7,0.429,1,1,1,2,6,0.333,2,4,0.5,0,6,6
8841,Trevor Ariza,31-128,F,11/5/16,HOU,@,ATL,L,1,31,4,10,0.4,2,3,0.667,2,7,0.286,0,0,,0,3,3
8842,Darrell Arthur,28-288,F,1/7/17,DEN,@,OKC,L,1,24,4,9,0.444,2,5,0.4,2,4,0.5,0,0,,1,3,4
8843,Darrell Arthur,28-315,F,2/3/17,DEN,,MIL,W,0,17,4,9,0.444,2,6,0.333,2,3,0.667,0,0,,1,2,3
8844,Darrell Arthur,28-312,F,1/31/17,DEN,@,LAL,L,0,20,4,8,0.5,3,6,0.5,1,2,0.5,1,2,0.5,4,2,6
8845,Darrell Arthur,28-303,F,1/22/17,DEN,@,MIN,L,0,21,4,9,0.444,2,3,0.667,2,6,0.333,0,0,,1,3,4
8846,Darrell Arthur,28-320,F,2/8/17,DEN,@,ATL,L,0,21,4,10,0.4,2,6,0.333,2,4,0.5,0,0,,2,2,4
8847,Omer Asik,30-148,C,11/29/16,NOP,,LAL,W,1,26,4,6,0.667,4,6,0.667,0,0,,2,2,1,4,7,11
8848,Omer Asik,30-129,C,11/10/16,NOP,@,MIL,W,0,19,4,5,0.8,4,5,0.8,0,0,,2,4,0.5,3,3,6
8849,D.J. Augustin,29-071,G,1/20/17,ORL,,MIL,W,0,28,3,9,0.333,2,3,0.667,1,6,0.167,3,4,0.75,0,2,2
8850,D.J. Augustin,29-069,G,1/18/17,ORL,@,NOP,L,0,34,4,14,0.286,2,6,0.333,2,8,0.25,0,0,,0,2,2
8851,D.J. Augustin,29-083,G,2/1/17,ORL,,IND,L,0,21,3,6,0.5,2,4,0.5,1,2,0.5,3,4,0.75,1,0,1
8852,D.J. Augustin,29-030,G,12/10/16,ORL,,DEN,L,1,24,3,8,0.375,1,3,0.333,2,5,0.4,2,2,1,0,1,1
8853,D.J. Augustin,29-046,G,12/26/16,ORL,,MEM,W,1,20,4,8,0.5,2,6,0.333,2,2,1,0,0,,0,0,0
8854,D.J. Augustin,28-365,G,11/9/16,ORL,,MIN,L,0,19,2,6,0.333,1,3,0.333,1,3,0.333,5,5,1,0,2,2
8855,Luke Babbitt,27-134,F,11/1/16,MIA,,SAC,W,1,24,3,9,0.333,0,0,,3,9,0.333,1,1,1,0,2,2
8856,Leandro Barbosa,33-346,G,11/8/16,PHO,@,POR,L,0,15,3,5,0.6,3,3,1,0,2,0,4,4,1,0,2,2
8857,Leandro Barbosa,34-009,G,12/7/16,PHO,,IND,L,0,12,5,7,0.714,5,6,0.833,0,1,0,0,0,,0,1,1
8858,Leandro Barbosa,34-021,G,12/19/16,PHO,@,MIN,L,0,14,4,6,0.667,2,4,0.5,2,2,1,0,0,,0,0,0
8859,Leandro Barbosa,34-036,G,1/3/17,PHO,,MIA,W,0,13,4,5,0.8,2,3,0.667,2,2,1,0,0,,0,0,0
8860,J.J. Barea,32-208,G,1/20/17,DAL,,UTA,L,0,23,5,10,0.5,5,8,0.625,0,2,0,0,0,,0,5,5
8861,J.J. Barea,32-124,G,10/28/16,DAL,,HOU,L,1,29,3,10,0.3,2,7,0.286,1,3,0.333,3,4,0.75,1,4,5
8862,Harrison Barnes,24-153,F,10/30/16,DAL,@,HOU,L,1,38,3,11,0.273,3,10,0.3,0,1,0,4,4,1,0,5,5
8863,Matt Barnes,36-320,F,1/23/17,SAC,@,DET,W,0,25,4,9,0.444,3,6,0.5,1,3,0.333,1,1,1,1,7,8
8864,Matt Barnes,37-005,F,3/14/17,GSW,,PHI,W,0,22,3,7,0.429,1,3,0.333,2,4,0.5,2,2,1,3,6,9
8865,Matt Barnes,36-289,F,12/23/16,SAC,@,MIN,W,1,32,4,6,0.667,2,2,1,2,4,0.5,0,0,,0,5,5
8866,Will Barton,26-071,G,3/18/17,DEN,,HOU,L,0,33,2,13,0.154,1,4,0.25,1,9,0.111,5,9,0.556,0,1,1
8867,Will Barton,25-321,G,11/22/16,DEN,,CHI,W,1,26,3,13,0.231,1,9,0.111,2,4,0.5,2,2,1,2,1,3
8868,Brandon Bass,31-325,F,3/21/17,LAC,@,LAL,W,0,15,3,6,0.5,3,6,0.5,0,0,,4,4,1,0,2,2
8869,Brandon Bass,31-247,F,1/2/17,LAC,,PHO,W,0,14,4,6,0.667,4,6,0.667,0,0,,2,3,0.667,1,0,1
8870,Brandon Bass,31-264,F,1/19/17,LAC,,MIN,L,0,19,5,5,1,5,5,1,0,0,,0,1,0,1,3,4
8871,Brandon Bass,31-261,F,1/16/17,LAC,,OKC,W,0,18,4,6,0.667,4,6,0.667,0,0,,2,2,1,2,4,6
8872,Nicolas Batum,28-063,F-G,2/15/17,CHO,@,TOR,L,1,31,3,9,0.333,1,2,0.5,2,7,0.286,2,3,0.667,0,4,4
8873,Aron Baynes,30-061,C,2/8/17,DET,,LAL,W,0,16,4,7,0.571,4,7,0.571,0,0,,2,2,1,2,4,6
8874,Kent Bazemore,27-201,G-F,1/18/17,ATL,@,DET,L,1,21,4,10,0.4,3,7,0.429,1,3,0.333,1,2,0.5,0,2,2
8875,Kent Bazemore,27-238,G-F,2/24/17,ATL,,MIA,L,1,23,4,9,0.444,2,6,0.333,2,3,0.667,0,0,,0,3,3
8876,Kent Bazemore,27-182,G-F,12/30/16,ATL,,DET,W,1,29,4,8,0.5,4,7,0.571,0,1,0,2,3,0.667,0,2,2
8877,Bradley Beal,23-178,G,12/23/16,WAS,@,MIL,L,1,31,3,10,0.3,2,5,0.4,1,5,0.2,3,3,1,1,1,2
8878,Michael Beasley,27-301,F,11/5/16,MIL,,SAC,W,0,16,5,10,0.5,5,9,0.556,0,1,0,0,0,,1,3,4
8879,Marco Belinelli,30-321,G-F,2/9/17,CHO,,HOU,L,0,21,5,13,0.385,5,10,0.5,0,3,0,0,0,,1,3,4
8880,DeAndre' Bembry,22-219,F,2/8/17,ATL,,DEN,W,0,17,5,7,0.714,5,7,0.714,0,0,,0,0,,1,3,4
8881,DeAndre' Bembry,22-213,F,2/2/17,ATL,@,HOU,W,0,21,5,6,0.833,5,5,1,0,1,0,0,0,,1,3,4
8882,Dragan Bender,19-016,F,12/3/16,PHO,@,GSW,L,0,25,4,6,0.667,2,2,1,2,4,0.5,0,0,,0,4,4
8883,Dragan Bender,18-357,F,11/8/16,PHO,@,POR,L,0,23,4,9,0.444,2,5,0.4,2,4,0.5,0,0,,1,1,2
8884,Dragan Bender,18-344,F,10/26/16,PHO,,SAC,L,0,12,4,5,0.8,2,2,1,2,3,0.667,0,0,,1,1,2
8885,Dragan Bender,19-041,F,12/28/16,PHO,@,SAS,L,0,27,4,4,1,2,2,1,2,2,1,0,0,,0,4,4
8886,Patrick Beverley,28-134,G,11/23/16,HOU,,TOR,L,1,35,4,6,0.667,2,3,0.667,2,3,0.667,0,0,,4,6,10
8887,Patrick Beverley,28-148,G,12/7/16,HOU,,LAL,W,1,32,4,9,0.444,2,3,0.667,2,6,0.333,0,0,,2,5,7
8888,Patrick Beverley,28-155,G,12/14/16,HOU,,SAC,W,1,29,4,9,0.444,2,3,0.667,2,6,0.333,0,0,,0,4,4
8889,Bismack Biyombo,24-120,C-F,12/26/16,ORL,,MEM,W,1,24,4,6,0.667,4,6,0.667,0,0,,2,4,0.5,5,5,10
8890,Bismack Biyombo,24-152,C-F,1/27/17,ORL,@,BOS,L,0,25,5,8,0.625,5,8,0.625,0,0,,0,1,0,0,7,7
8891,Bismack Biyombo,24-190,C-F,3/6/17,ORL,,NYK,L,1,42,3,6,0.5,3,6,0.5,0,0,,4,8,0.5,5,9,14
8892,Bismack Biyombo,24-133,C-F,1/8/17,ORL,@,LAL,L,1,26,4,6,0.667,4,6,0.667,0,0,,2,4,0.5,3,8,11
8893,Nemanja Bjelica,28-235,F,12/30/16,MIN,,MIL,W,0,19,4,6,0.667,2,3,0.667,2,3,0.667,0,0,,0,3,3
8894,Nemanja Bjelica,28-251,F,1/15/17,MIN,@,DAL,L,0,22,4,7,0.571,4,4,1,0,3,0,2,3,0.667,1,3,4
8895,Nemanja Bjelica,28-305,F,3/10/17,MIN,,GSW,W,0,34,4,10,0.4,3,6,0.5,1,4,0.25,1,2,0.5,5,7,12
8896,Nemanja Bjelica,28-196,F,11/21/16,MIN,,BOS,L,0,10,3,5,0.6,2,3,0.667,1,2,0.5,3,4,0.75,0,1,1
8897,Nemanja Bjelica,28-294,F,2/27/17,MIN,@,SAC,W,0,35,4,15,0.267,2,7,0.286,2,8,0.25,0,0,,4,8,12
8898,Nemanja Bjelica,28-292,F,2/25/17,MIN,@,HOU,L,0,14,4,5,0.8,2,3,0.667,2,2,1,0,0,,1,0,1
8899,Nemanja Bjelica,28-222,F,12/17/16,MIN,,HOU,L,0,15,4,6,0.667,2,3,0.667,2,3,0.667,0,0,,1,3,4
8900,Tarik Black,25-045,C-F,1/6/17,LAL,,MIA,W,0,25,3,5,0.6,3,5,0.6,0,0,,4,4,1,6,5,11
8901,Bojan Bogdanovic,27-254,G-F,12/28/16,BRK,@,CHI,L,1,28,4,11,0.364,3,7,0.429,1,4,0.25,1,1,1,0,2,2
8902,Bojan Bogdanovic,27-285,G-F,1/28/17,BRK,@,MIN,L,1,24,4,12,0.333,4,11,0.364,0,1,0,2,3,0.667,0,1,1
8903,Bojan Bogdanovic,27-324,G-F,3/8/17,WAS,@,DEN,W,0,22,4,10,0.4,4,8,0.5,0,2,0,2,2,1,0,2,2
8904,Bojan Bogdanovic,27-269,G-F,1/12/17,BRK,,NOP,L,1,25,4,11,0.364,2,4,0.5,2,7,0.286,0,0,,0,3,3
8905,Bojan Bogdanovic,27-298,G-F,2/10/17,BRK,,MIA,L,1,29,4,12,0.333,2,7,0.286,2,5,0.4,0,0,,0,6,6
8906,Devin Booker,20-020,G,11/19/16,PHO,@,PHI,L,1,18,4,13,0.308,4,11,0.364,0,2,0,2,3,0.667,0,1,1
8907,Devin Booker,20-138,G,3/17/17,PHO,,ORL,L,1,30,3,13,0.231,3,11,0.273,0,2,0,4,4,1,0,4,4
8908,Trevor Booker,28-338,F,10/28/16,BRK,,IND,W,1,27,5,11,0.455,5,9,0.556,0,2,0,0,0,,2,9,11
8909,Trevor Booker,29-000,F,11/25/16,BRK,@,IND,L,1,28,5,8,0.625,5,7,0.714,0,1,0,0,1,0,3,7,10
8910,Trevor Booker,29-074,F,2/7/17,BRK,@,CHO,L,0,24,5,11,0.455,5,9,0.556,0,2,0,0,0,,1,11,12
8911,Trevor Booker,29-017,F,12/12/16,BRK,@,HOU,L,1,32,4,8,0.5,4,8,0.5,0,0,,2,3,0.667,0,13,13
8912,Corey Brewer,30-300,F-G,12/30/16,HOU,,LAC,W,0,16,3,5,0.6,3,3,1,0,2,0,4,4,1,1,2,3
8913,Corey Brewer,30-265,F-G,11/25/16,HOU,@,SAC,W,0,13,4,5,0.8,2,3,0.667,2,2,1,0,0,,0,2,2
8914,Malcolm Brogdon,24-045,G,1/25/17,MIL,,PHI,L,0,26,3,7,0.429,2,5,0.4,1,2,0.5,3,4,0.75,1,1,2
8915,Malcolm Brogdon,24-026,G,1/6/17,MIL,,NYK,L,1,31,4,9,0.444,4,8,0.5,0,1,0,2,2,1,0,6,6
8916,Malcolm Brogdon,24-052,G,2/1/17,MIL,@,UTA,L,0,31,4,8,0.5,2,6,0.333,2,2,1,0,0,,1,2,3
8917,Malcolm Brogdon,23-335,G,11/10/16,MIL,,NOP,L,0,22,4,6,0.667,4,6,0.667,0,0,,2,2,1,0,3,3
8918,Malcolm Brogdon,23-354,G,11/29/16,MIL,,CLE,W,0,23,4,5,0.8,2,3,0.667,2,2,1,0,0,,0,1,1
8919,Aaron Brooks,31-296,G,11/5/16,IND,,CHI,W,0,22,4,7,0.571,2,3,0.667,2,4,0.5,0,0,,0,0,0
8920,Aaron Brooks,31-311,G,11/20/16,IND,@,OKC,W,0,13,4,6,0.667,2,3,0.667,2,3,0.667,0,0,,1,0,1
8921,Jaylen Brown,20-071,F,1/3/17,BOS,,UTA,W,0,13,4,6,0.667,3,4,0.75,1,2,0.5,1,1,1,0,3,3
8922,Jaylen Brown,20-018,F,11/11/16,BOS,,NYK,W,0,17,3,9,0.333,2,6,0.333,1,3,0.333,3,8,0.375,0,4,4
8923,Jaylen Brown,20-048,F,12/11/16,BOS,@,OKC,L,0,18,4,5,0.8,3,4,0.75,1,1,1,1,1,1,1,1,2
8924,Nicolas Brussino,23-346,G-F,2/11/17,DAL,,ORL,W,0,12,4,6,0.667,2,3,0.667,2,3,0.667,0,0,,0,3,3
8925,Alec Burks,25-231,G,3/8/17,UTA,@,HOU,W,0,15,4,8,0.5,2,3,0.667,2,5,0.4,0,0,,0,4,4
8926,Alec Burks,25-229,G,3/6/17,UTA,,NOP,W,0,16,3,9,0.333,1,4,0.25,2,5,0.4,2,2,1,1,7,8
8927,Alec Burks,25-241,G,3/18/17,UTA,@,CHI,L,0,19,4,11,0.364,3,8,0.375,1,3,0.333,1,2,0.5,2,2,4
8928,Kentavious Caldwell-Pope,23-282,G,11/26/16,DET,@,OKC,L,1,34,4,13,0.308,4,7,0.571,0,6,0,2,2,1,0,2,2
8929,Kentavious Caldwell-Pope,23-295,G,12/9/16,DET,@,MIN,W,1,31,3,12,0.25,1,6,0.167,2,6,0.333,2,2,1,0,1,1
8930,Kentavious Caldwell-Pope,23-358,G,2/10/17,DET,,SAS,L,1,35,5,12,0.417,5,8,0.625,0,4,0,0,0,,0,4,4
8931,Kentavious Caldwell-Pope,23-267,G,11/11/16,DET,@,SAS,L,1,40,3,9,0.333,1,4,0.25,2,5,0.4,2,3,0.667,1,2,3
8932,Kentavious Caldwell-Pope,24-025,G,3/15/17,DET,,UTA,L,1,29,4,12,0.333,2,9,0.222,2,3,0.667,0,2,0,0,1,1
8933,Isaiah Canaan,25-170,G,11/7/16,CHI,,ORL,W,0,21,3,6,0.5,2,3,0.667,1,3,0.333,3,4,0.75,0,4,4
8934,Isaiah Canaan,25-198,G,12/5/16,CHI,,POR,L,0,29,4,11,0.364,4,8,0.5,0,3,0,2,2,1,3,1,4
8935,Isaiah Canaan,25-196,G,12/3/16,CHI,@,DAL,L,0,29,4,6,0.667,3,4,0.75,1,2,0.5,1,1,1,0,3,3
8936,Clint Capela,22-213,F-C,12/17/16,HOU,@,MIN,W,1,15,5,5,1,5,5,1,0,0,,0,0,,1,3,4
8937,Clint Capela,22-256,F-C,1/29/17,HOU,@,IND,L,0,22,4,6,0.667,4,6,0.667,0,0,,2,2,1,1,3,4
8938,Clint Capela,22-197,F-C,12/1/16,HOU,@,GSW,W,1,25,5,8,0.625,5,8,0.625,0,0,,0,3,0,1,3,4
8939,DeMarre Carroll,30-124,F,11/28/16,TOR,,PHI,W,1,21,4,5,0.8,2,2,1,2,3,0.667,0,0,,1,4,5
8940,DeMarre Carroll,30-160,F,1/3/17,TOR,@,SAS,L,1,19,3,7,0.429,2,4,0.5,1,3,0.333,3,4,0.75,4,1,5
8941,DeMarre Carroll,30-140,F,12/14/16,TOR,@,PHI,W,1,20,3,9,0.333,1,3,0.333,2,6,0.333,2,2,1,2,1,3
8942,DeMarre Carroll,30-096,F,10/31/16,TOR,,DEN,W,1,29,4,8,0.5,2,3,0.667,2,5,0.4,0,0,,0,2,2
8943,DeMarre Carroll,30-134,F,12/8/16,TOR,,MIN,W,1,33,3,7,0.429,0,1,0,3,6,0.5,1,2,0.5,1,4,5
8944,DeMarre Carroll,30-107,F,11/11/16,TOR,@,CHO,W,1,23,4,7,0.571,4,5,0.8,0,2,0,2,2,1,0,4,4
8945,DeMarre Carroll,30-129,F,12/3/16,TOR,,ATL,W,1,26,4,10,0.4,2,4,0.5,2,6,0.333,0,0,,1,4,5
8946,DeMarre Carroll,30-105,F,11/9/16,TOR,@,OKC,W,1,22,4,6,0.667,2,3,0.667,2,3,0.667,0,0,,1,3,4
8947,Vince Carter,39-355,G-F,1/15/17,MEM,,CHI,L,0,31,4,8,0.5,2,3,0.667,2,5,0.4,0,0,,0,1,1
8948,Vince Carter,40-036,G-F,3/3/17,MEM,@,DAL,L,0,27,3,7,0.429,0,1,0,3,6,0.5,1,2,0.5,0,2,2
8949,Vince Carter,40-051,G-F,3/18/17,MEM,,SAS,W,1,30,3,9,0.333,1,2,0.5,2,7,0.286,2,2,1,0,4,4
8950,Vince Carter,39-300,G-F,11/21/16,MEM,@,CHO,W,0,33,3,8,0.375,1,2,0.5,2,6,0.333,2,3,0.667,1,4,5
8951,Michael Carter-Williams,25-099,G,1/17/17,CHI,,DAL,L,1,21,4,6,0.667,2,4,0.5,2,2,1,0,0,,0,5,5
8952,Michael Carter-Williams,25-084,G,1/2/17,CHI,,CHO,W,1,31,4,12,0.333,4,10,0.4,0,2,0,2,2,1,1,8,9
8953,Omri Casspi,28-168,F,12/7/16,SAC,@,DAL,W,0,18,5,7,0.714,5,6,0.833,0,1,0,0,0,,0,5,5
8954,Omri Casspi,28-175,F,12/14/16,SAC,@,HOU,L,1,27,4,12,0.333,3,9,0.333,1,3,0.333,1,2,0.5,1,4,5
8955,Willie Cauley-Stein,23-166,F-C,1/31/17,SAC,@,HOU,L,0,24,4,10,0.4,4,9,0.444,0,1,0,2,2,1,2,4,6
8956,Willie Cauley-Stein,23-200,F-C,3/6/17,SAC,@,DEN,L,1,28,5,11,0.455,5,11,0.455,0,0,,0,0,,2,4,6
8957,Tyson Chandler,34-066,C,12/7/16,PHO,,IND,L,1,32,5,6,0.833,5,6,0.833,0,0,,0,0,,3,7,10
8958,Tyson Chandler,34-098,C,1/8/17,PHO,,CLE,L,1,32,4,7,0.571,4,7,0.571,0,0,,2,2,1,4,11,15
8959,Tyson Chandler,34-065,C,12/6/16,PHO,@,UTA,L,1,28,3,7,0.429,3,7,0.429,0,0,,4,4,1,4,1,5
8960,Tyson Chandler,34-076,C,12/17/16,PHO,@,OKC,L,1,27,5,5,1,5,5,1,0,0,,0,1,0,3,6,9
8961,Tyson Chandler,34-056,C,11/27/16,PHO,,DEN,L,1,38,5,6,0.833,5,6,0.833,0,0,,0,0,,4,11,15
8962,Wilson Chandler,29-238,F,1/3/17,DEN,,SAC,L,1,30,3,10,0.3,1,3,0.333,2,7,0.286,2,2,1,0,3,3
8963,Wilson Chandler,29-270,F,2/4/17,DEN,@,SAS,L,1,26,4,11,0.364,2,5,0.4,2,6,0.333,0,0,,0,2,2
8964,Wilson Chandler,29-234,F,12/30/16,DEN,,PHI,L,1,36,4,8,0.5,3,5,0.6,1,3,0.333,1,2,0.5,2,7,9
8965,Wilson Chandler,29-209,F,12/5/16,DEN,@,PHI,W,0,26,3,7,0.429,1,4,0.25,2,3,0.667,2,2,1,0,4,4
8966,Marquese Chriss,19-166,F,12/15/16,PHO,,SAS,L,1,31,4,9,0.444,2,5,0.4,2,4,0.5,0,0,,1,1,2
8967,Marquese Chriss,19-144,F,11/23/16,PHO,@,ORL,W,1,17,3,4,0.75,2,3,0.667,1,1,1,3,4,0.75,1,2,3
8968,Marquese Chriss,19-246,F,3/5/17,PHO,,BOS,W,1,25,5,9,0.556,5,6,0.833,0,3,0,0,0,,1,5,6
8969,Marquese Chriss,19-158,F,12/7/16,PHO,,IND,L,1,19,3,6,0.5,1,2,0.5,2,4,0.5,2,2,1,0,3,3
8970,Rakeem Christmas,25-088,F,2/27/17,IND,@,HOU,W,0,20,4,5,0.8,4,5,0.8,0,0,,2,2,1,1,2,3
8971,Semaj Christon,24-004,G,11/5/16,OKC,,MIN,W,0,20,4,8,0.5,4,7,0.571,0,1,0,2,2,1,0,0,0
8972,Semaj Christon,24-139,G,3/20/17,OKC,,GSW,L,0,22,4,4,1,3,3,1,1,1,1,1,2,0.5,0,2,2
8973,Ian Clark,25-278,G,12/10/16,GSW,@,MEM,L,0,23,5,9,0.556,5,7,0.714,0,2,0,0,1,0,0,3,3
8974,Ian Clark,26-003,G,3/10/17,GSW,@,MIN,L,0,13,4,7,0.571,2,4,0.5,2,3,0.667,0,0,,1,3,4
8975,Ian Clark,25-259,G,11/21/16,GSW,@,IND,W,0,21,4,10,0.4,2,5,0.4,2,5,0.4,0,0,,1,5,6
8976,Ian Clark,25-309,G,1/10/17,GSW,,MIA,W,0,22,4,9,0.444,2,6,0.333,2,3,0.667,0,0,,0,1,1
8977,Ian Clark,25-364,G,3/6/17,GSW,@,ATL,W,0,10,3,4,0.75,1,2,0.5,2,2,1,2,2,1,0,0,0
8978,Jordan Clarkson,24-229,G,1/22/17,LAL,@,DAL,L,0,25,5,13,0.385,5,11,0.455,0,2,0,0,0,,0,3,3
8979,Jordan Clarkson,24-192,G,12/16/16,LAL,@,PHI,W,0,26,4,9,0.444,2,5,0.4,2,4,0.5,0,0,,0,3,3
8980,Darren Collison,29-119,G,12/20/16,SAC,,POR,W,1,21,3,8,0.375,3,7,0.429,0,1,0,4,5,0.8,1,2,3
8981,Darren Collison,29-188,G,2/27/17,SAC,,MIN,L,1,30,5,13,0.385,5,12,0.417,0,1,0,0,0,,1,1,2
8982,Darren Collison,29-085,G,11/16/16,SAC,,SAS,L,0,30,4,7,0.571,4,6,0.667,0,1,0,2,2,1,1,3,4
8983,Darren Collison,29-207,G,3/18/17,SAC,@,OKC,L,1,27,4,13,0.308,4,11,0.364,0,2,0,2,2,1,0,3,3
8984,Darren Collison,29-134,G,1/4/17,SAC,,MIA,L,1,27,4,11,0.364,3,10,0.3,1,1,1,1,1,1,0,2,2
8985,Darren Collison,29-186,G,2/25/17,SAC,,CHO,L,1,28,4,8,0.5,2,5,0.4,2,3,0.667,0,0,,0,2,2
8986,Mike Conley,29-136,G,2/24/17,MEM,@,IND,L,1,32,5,9,0.556,5,6,0.833,0,3,0,0,4,0,1,4,5
8987,Mike Conley,29-028,G,11/8/16,MEM,,DEN,W,1,30,4,15,0.267,4,12,0.333,0,3,0,2,4,0.5,0,3,3
8988,Quinn Cook,23-349,G,3/7/17,DAL,,LAL,W,0,17,4,6,0.667,2,3,0.667,2,3,0.667,0,0,,0,0,0
8989,Robert Covington,26-035,F,1/18/17,PHI,,TOR,W,1,36,4,6,0.667,3,4,0.75,1,2,0.5,1,2,0.5,0,5,5
8990,Robert Covington,26-044,F,1/27/17,PHI,,HOU,L,1,36,2,5,0.4,2,3,0.667,0,2,0,6,7,0.857,0,5,5
8991,Robert Covington,25-317,F,10/26/16,PHI,,OKC,L,1,32,3,6,0.5,1,2,0.5,2,4,0.5,2,2,1,1,4,5
8992,Robert Covington,25-333,F,11/11/16,PHI,,IND,W,1,40,3,13,0.231,1,4,0.25,2,9,0.222,2,2,1,1,3,4
8993,Allen Crabbe,24-258,G-F,12/23/16,POR,,SAS,L,0,30,4,7,0.571,2,4,0.5,2,3,0.667,0,0,,0,1,1
8994,Allen Crabbe,24-267,G-F,1/1/17,POR,@,MIN,W,1,40,4,10,0.4,3,5,0.6,1,5,0.2,1,2,0.5,0,8,8
8995,Allen Crabbe,24-302,G-F,2/5/17,POR,@,OKC,L,0,30,4,10,0.4,2,3,0.667,2,7,0.286,0,0,,0,1,1
8996,Allen Crabbe,24-340,G-F,3/15/17,POR,@,SAS,W,0,35,4,7,0.571,2,3,0.667,2,4,0.5,0,0,,0,2,2
8997,Allen Crabbe,24-201,G-F,10/27/16,POR,,LAC,L,0,32,3,7,0.429,3,5,0.6,0,2,0,4,4,1,0,1,1
8998,Jamal Crawford,36-237,G,11/12/16,LAC,@,MIN,W,0,21,4,8,0.5,3,6,0.5,1,2,0.5,1,2,0.5,0,1,1
8999,Jordan Crawford,28-136,G,3/8/17,NOP,,TOR,L,0,26,4,8,0.5,2,4,0.5,2,4,0.5,0,0,,0,3,3
9000,Jordan Crawford,28-149,G,3/21/17,NOP,,MEM,W,0,16,3,5,0.6,1,1,1,2,4,0.5,2,2,1,0,2,2
9001,Jordan Crawford,28-149,G,3/21/17,NOP,,MEM,W,0,16,3,5,0.6,1,1,1,2,4,0.5,2,2,1,0,2,2
9002,Jae Crowder,26-222,F,2/13/17,BOS,@,DAL,W,1,29,3,9,0.333,1,4,0.25,2,5,0.4,2,3,0.667,0,4,4
9003,Jae Crowder,26-119,F,11/2/16,BOS,,CHI,W,1,14,4,6,0.667,2,4,0.5,2,2,1,0,0,,0,5,5
9004,Jae Crowder,26-150,F,12/3/16,BOS,@,PHI,W,1,33,4,8,0.5,2,4,0.5,2,4,0.5,0,0,,1,3,4
9005,Seth Curry,26-210,G,3/21/17,DAL,,GSW,L,1,27,4,12,0.333,3,8,0.375,1,4,0.25,1,1,1,0,3,3
9006,Seth Curry,26-078,G,11/9/16,DAL,@,GSW,L,1,35,4,17,0.235,2,8,0.25,2,9,0.222,0,1,0,0,1,1
9007,Seth Curry,26-096,G,11/27/16,DAL,,NOP,W,0,34,4,8,0.5,4,6,0.667,0,2,0,2,2,1,1,4,5
9008,Seth Curry,26-111,G,12/12/16,DAL,,DEN,W,0,16,4,7,0.571,2,4,0.5,2,3,0.667,0,0,,0,0,0
9009,Troy Daniels,25-144,G,12/6/16,MEM,,PHI,W,0,25,4,14,0.286,3,6,0.5,1,8,0.125,1,1,1,0,1,1
9010,Anthony Davis,23-236,F-C,11/2/16,NOP,@,MEM,L,1,36,3,13,0.231,2,9,0.222,1,4,0.25,3,5,0.6,1,6,7
9011,Ed Davis,27-186,F,12/8/16,POR,@,MEM,L,0,18,3,6,0.5,3,6,0.5,0,0,,4,6,0.667,6,4,10
9012,Dewayne Dedmon,27-124,C,12/14/16,SAS,,BOS,W,0,16,5,6,0.833,5,6,0.833,0,0,,0,0,,1,4,5
9013,Dewayne Dedmon,27-187,C,2/15/17,SAS,@,ORL,W,1,29,5,6,0.833,5,6,0.833,0,0,,0,1,0,2,9,11
9014,Dewayne Dedmon,27-115,C,12/5/16,SAS,@,MIL,W,0,14,5,5,1,5,5,1,0,0,,0,1,0,4,2,6
9015,Dewayne Dedmon,27-164,C,1/23/17,SAS,@,BRK,W,1,29,4,5,0.8,4,5,0.8,0,0,,2,2,1,1,7,8
9016,Dewayne Dedmon,27-180,C,2/8/17,SAS,@,PHI,W,1,26,4,5,0.8,4,5,0.8,0,0,,2,3,0.667,2,9,11
9017,Sam Dekker,22-228,F,12/20/16,HOU,,SAS,L,0,21,3,9,0.333,3,6,0.5,0,3,0,4,4,1,5,2,7
9018,Sam Dekker,22-194,F,11/16/16,HOU,@,OKC,L,0,19,4,5,0.8,2,3,0.667,2,2,1,0,0,,0,2,2
9019,Sam Dekker,22-207,F,11/29/16,HOU,@,UTA,L,0,27,4,8,0.5,3,6,0.5,1,2,0.5,1,2,0.5,4,2,6
9020,Sam Dekker,22-187,F,11/9/16,HOU,@,SAS,W,0,18,4,5,0.8,2,3,0.667,2,2,1,0,0,,0,7,7
9021,Sam Dekker,22-277,F,2/7/17,HOU,,ORL,W,0,18,3,5,0.6,0,1,0,3,4,0.75,1,2,0.5,0,1,1
9022,Malcolm Delaney,27-256,G,11/22/16,ATL,,NOP,L,0,18,5,11,0.455,5,9,0.556,0,2,0,0,0,,0,2,2
9023,Malcolm Delaney,27-280,G,12/16/16,ATL,@,TOR,W,0,22,4,7,0.571,4,6,0.667,0,1,0,2,3,0.667,0,1,1
9024,Malcolm Delaney,27-243,G,11/9/16,ATL,,CHI,W,0,17,4,6,0.667,4,5,0.8,0,1,0,2,2,1,0,1,1
9025,Matthew Dellavedova,26-072,G,11/19/16,MIL,,GSW,L,1,34,4,7,0.571,3,6,0.5,1,1,1,1,1,1,0,3,3
9026,Matthew Dellavedova,26-052,G,10/30/16,MIL,@,DET,L,1,31,4,7,0.571,2,4,0.5,2,3,0.667,0,0,,1,1,2
9027,Matthew Dellavedova,26-160,G,2/15/17,MIL,@,BRK,W,1,32,3,5,0.6,2,4,0.5,1,1,1,3,6,0.5,0,0,0
9028,Matthew Dellavedova,26-181,G,3/8/17,MIL,,NYK,W,0,26,3,8,0.375,1,2,0.5,2,6,0.333,2,2,1,0,2,2
9029,Matthew Dellavedova,26-179,G,3/6/17,MIL,@,PHI,W,0,27,3,6,0.5,1,4,0.25,2,2,1,2,2,1,1,2,3
9030,Matthew Dellavedova,26-058,G,11/5/16,MIL,,SAC,W,1,21,4,7,0.571,2,4,0.5,2,3,0.667,0,0,,1,4,5
9031,Luol Deng,31-216,F,11/18/16,LAL,,SAS,L,1,34,4,10,0.4,2,6,0.333,2,4,0.5,0,0,,3,3,6
9032,Luol Deng,31-199,F,11/1/16,LAL,@,IND,L,1,21,5,10,0.5,5,9,0.556,0,1,0,0,0,,1,5,6
9033,Luol Deng,31-228,F,11/30/16,LAL,@,CHI,W,1,25,3,9,0.333,2,7,0.286,1,2,0.5,3,6,0.5,1,7,8
9034,DeMar DeRozan,27-192,G,2/15/17,TOR,,CHO,W,1,31,5,19,0.263,5,16,0.313,0,3,0,0,2,0,0,3,3
9035,Cheick Diallo,20-094,F,12/16/16,NOP,@,HOU,L,0,22,4,5,0.8,4,5,0.8,0,0,,2,2,1,2,5,7
9036,Boris Diaw,34-255,F-C,12/27/16,UTA,@,LAL,W,0,23,4,9,0.444,2,5,0.4,2,4,0.5,0,0,,0,0,0
9037,Gorgui Dieng,27-054,C,3/13/17,MIN,,WAS,W,1,32,4,6,0.667,4,6,0.667,0,0,,2,2,1,2,8,10
9038,Gorgui Dieng,26-359,C,1/11/17,MIN,,HOU,W,1,26,5,5,1,5,5,1,0,0,,0,0,,0,2,2
9039,Gorgui Dieng,27-025,C,2/12/17,MIN,,CHI,W,1,34,5,9,0.556,5,8,0.625,0,1,0,0,0,,3,10,13
9040,Gorgui Dieng,26-325,C,12/8/16,MIN,@,TOR,L,1,33,4,9,0.444,4,8,0.5,0,1,0,2,2,1,1,6,7
9041,Gorgui Dieng,26-336,C,12/19/16,MIN,,PHO,W,1,40,5,10,0.5,5,10,0.5,0,0,,0,0,,4,5,9
9042,Gorgui Dieng,26-351,C,1/3/17,MIN,@,PHI,L,1,27,4,6,0.667,4,6,0.667,0,0,,2,2,1,1,7,8
9043,Spencer Dinwiddie,23-289,G,1/20/17,BRK,@,NOP,W,1,28,2,4,0.5,1,3,0.333,1,1,1,5,6,0.833,0,2,2
9044,Spencer Dinwiddie,23-299,G,1/30/17,BRK,@,MIA,L,1,24,3,7,0.429,3,7,0.429,0,0,,4,4,1,1,4,5
9045,Spencer Dinwiddie,23-282,G,1/13/17,BRK,@,TOR,L,1,28,3,7,0.429,0,3,0,3,4,0.75,1,2,0.5,0,5,5
9046,Spencer Dinwiddie,23-296,G,1/27/17,BRK,@,CLE,L,1,26,3,5,0.6,1,3,0.333,2,2,1,2,2,1,0,1,1
9047,Spencer Dinwiddie,23-349,G,3/21/17,BRK,,DET,W,1,30,3,9,0.333,3,6,0.5,0,3,0,4,6,0.667,2,6,8
9048,Spencer Dinwiddie,23-294,G,1/25/17,BRK,,MIA,L,1,33,4,8,0.5,3,5,0.6,1,3,0.333,1,2,0.5,0,5,5
9049,Goran Dragic,30-199,G,11/21/16,MIA,@,PHI,L,1,35,4,13,0.308,4,9,0.444,0,4,0,2,2,1,2,2,4
9050,Andre Drummond,23-186,C,2/12/17,DET,@,TOR,W,1,27,3,10,0.3,3,10,0.3,0,0,,4,8,0.5,8,10,18
9051,Andre Drummond,23-116,C,12/4/16,DET,,ORL,L,1,35,5,11,0.455,5,11,0.455,0,0,,0,4,0,4,6,10
9052,Andre Drummond,23-108,C,11/26/16,DET,@,OKC,L,1,36,5,10,0.5,5,10,0.5,0,0,,0,0,,2,6,8
9053,Jared Dudley,31-158,F-G,12/15/16,PHO,,SAS,L,0,20,4,5,0.8,2,2,1,2,3,0.667,0,0,,0,4,4
9054,Jared Dudley,31-119,F-G,11/6/16,PHO,@,LAL,L,1,25,3,6,0.5,2,3,0.667,1,3,0.333,3,5,0.6,2,1,3
9055,Kris Dunn,22-310,G,1/22/17,MIN,,DEN,W,1,34,3,8,0.375,1,6,0.167,2,2,1,2,4,0.5,1,7,8
9056,Kris Dunn,22-228,G,11/1/16,MIN,,MEM,W,1,29,3,7,0.429,1,4,0.25,2,3,0.667,2,2,1,1,3,4
9057,Kevin Durant,28-128,F-G,2/4/17,GSW,@,SAC,L,1,42,2,10,0.2,2,4,0.5,0,6,0,6,7,0.857,0,9,9
9058,Wayne Ellington,29-041,G,12/9/16,MIA,@,CLE,L,1,33,4,12,0.333,2,3,0.667,2,9,0.222,0,0,,0,1,1
9059,Monta Ellis,31-045,G,12/10/16,IND,,POR,W,1,19,2,3,0.667,2,2,1,0,1,0,6,7,0.857,0,0,0
9060,Monta Ellis,31-110,G,2/13/17,IND,,SAS,L,0,30,4,10,0.4,3,8,0.375,1,2,0.5,1,2,0.5,0,2,2
9061,Monta Ellis,31-144,G,3/19/17,IND,@,TOR,L,0,25,4,11,0.364,4,8,0.5,0,3,0,2,3,0.667,0,1,1
9062,Joel Embiid,22-246,C-F,11/17/16,PHI,@,MIN,L,1,22,4,9,0.444,4,8,0.5,0,1,0,2,4,0.5,4,6,10
9063,James Ennis,26-194,F,1/11/17,MEM,@,OKC,L,0,19,4,5,0.8,4,5,0.8,0,0,,2,4,0.5,2,2,4
9064,James Ennis,26-138,F,11/16/16,MEM,@,LAC,W,1,31,2,8,0.25,1,5,0.2,1,3,0.333,5,6,0.833,1,2,3
9065,James Ennis,26-224,F,2/10/17,MEM,,GSW,L,1,30,4,6,0.667,2,3,0.667,2,3,0.667,0,0,,0,1,1
9066,James Ennis,26-203,F,1/20/17,MEM,,SAC,W,1,35,4,7,0.571,3,4,0.75,1,3,0.333,1,4,0.25,3,3,6
9067,James Ennis,26-242,F,2/28/17,MEM,,PHO,W,0,18,2,6,0.333,1,3,0.333,1,3,0.333,5,6,0.833,0,2,2
9068,Dante Exum,21-215,G,2/13/17,UTA,,LAC,L,0,22,4,8,0.5,4,6,0.667,0,2,0,2,2,1,0,3,3
9069,Dante Exum,21-130,G,11/20/16,UTA,@,DEN,L,1,35,5,12,0.417,5,7,0.714,0,5,0,0,0,,4,2,6
9070,Dante Exum,21-129,G,11/19/16,UTA,@,HOU,L,1,28,4,11,0.364,3,8,0.375,1,3,0.333,1,2,0.5,0,1,1
9071,Dante Exum,21-112,G,11/2/16,UTA,,DAL,W,0,20,4,6,0.667,2,4,0.5,2,2,1,0,0,,1,1,2
9072,Dante Exum,21-145,G,12/5/16,UTA,@,LAL,W,1,18,4,5,0.8,2,3,0.667,2,2,1,0,0,,0,0,0
9073,Dante Exum,21-143,G,12/3/16,UTA,,DEN,W,1,22,3,7,0.429,3,4,0.75,0,3,0,4,4,1,0,2,2
9074,Dante Exum,21-109,G,10/30/16,UTA,@,LAC,L,0,26,3,6,0.5,3,5,0.6,0,1,0,4,4,1,0,2,2
9075,Dante Exum,21-122,G,11/12/16,UTA,@,MIA,W,1,29,3,10,0.3,1,6,0.167,2,4,0.5,2,2,1,1,2,3
9076,Kenneth Faried,27-014,F,12/3/16,DEN,@,UTA,L,1,29,4,8,0.5,4,8,0.5,0,0,,2,3,0.667,2,4,6
9077,Kenneth Faried,27-011,F,11/30/16,DEN,,MIA,L,1,27,4,8,0.5,4,8,0.5,0,0,,2,4,0.5,3,5,8
9078,Derrick Favors,25-226,F-C,2/26/17,UTA,@,WAS,W,1,24,5,9,0.556,5,9,0.556,0,0,,0,0,,3,3,6
9079,Derrick Favors,25-192,F-C,1/23/17,UTA,,OKC,L,1,27,5,12,0.417,5,11,0.455,0,1,0,0,0,,4,6,10
9080,Derrick Favors,25-229,F-C,3/1/17,UTA,,MIN,L,1,27,5,13,0.385,5,13,0.385,0,0,,0,0,,8,4,12
9081,Kay Felder,21-354,G,3/18/17,CLE,@,LAC,L,0,15,4,12,0.333,4,10,0.4,0,2,0,2,2,1,0,2,2
9082,Cristiano Felicio,24-233,F-C,2/25/17,CHI,@,CLE,W,0,24,4,6,0.667,4,6,0.667,0,0,,2,3,0.667,4,1,5
9083,Cristiano Felicio,24-248,F-C,3/12/17,CHI,@,BOS,L,0,21,4,8,0.5,4,8,0.5,0,0,,2,2,1,1,3,4
9084,Cristiano Felicio,24-222,F-C,2/14/17,CHI,,TOR,W,0,27,4,6,0.667,4,6,0.667,0,0,,2,2,1,3,3,6
9085,Raymond Felton,32-134,G,11/7/16,LAC,,DET,W,0,23,3,5,0.6,2,4,0.5,1,1,1,3,4,0.75,0,4,4
9086,Raymond Felton,32-169,G,12/12/16,LAC,,POR,W,0,24,4,8,0.5,2,5,0.4,2,3,0.667,0,0,,0,0,0
9087,Raymond Felton,32-183,G,12/26/16,LAC,,DEN,L,0,31,5,14,0.357,5,11,0.455,0,3,0,0,0,,0,4,4
9088,Raymond Felton,32-216,G,1/28/17,LAC,@,GSW,L,0,28,3,12,0.25,1,7,0.143,2,5,0.4,2,2,1,2,5,7
9089,Raymond Felton,32-207,G,1/19/17,LAC,,MIN,L,1,34,5,12,0.417,5,9,0.556,0,3,0,0,0,,1,3,4
9090,Yogi Ferrell,23-278,G,2/11/17,DAL,,ORL,W,0,32,4,8,0.5,2,5,0.4,2,3,0.667,0,0,,0,3,3
9091,Yogi Ferrell,23-200,G,11/25/16,BRK,@,IND,L,0,21,3,9,0.333,1,3,0.333,2,6,0.333,2,4,0.5,0,2,2
9092,Evan Fournier,24-038,G-F,12/6/16,ORL,@,WAS,W,1,28,4,10,0.4,2,4,0.5,2,6,0.333,0,0,,0,3,3
9093,Evan Fournier,24-069,G-F,1/6/17,ORL,,HOU,L,1,35,4,13,0.308,4,11,0.364,0,2,0,2,3,0.667,3,6,9
9094,Randy Foye,33-173,G,3/16/17,BRK,@,NYK,W,1,28,3,9,0.333,1,5,0.2,2,4,0.5,2,3,0.667,0,4,4
9095,Randy Foye,33-062,G,11/25/16,BRK,@,IND,L,0,18,4,6,0.667,2,3,0.667,2,3,0.667,0,1,0,0,1,1
9096,Tim Frazier,26-049,G,12/20/16,NOP,@,PHI,W,0,27,4,7,0.571,2,5,0.4,2,2,1,0,1,0,1,3,4
9097,Tim Frazier,26-013,G,11/14/16,NOP,,BOS,W,1,30,2,5,0.4,2,3,0.667,0,2,0,6,8,0.75,1,2,3
9098,Tim Frazier,26-050,G,12/21/16,NOP,,OKC,L,0,29,4,9,0.444,4,7,0.571,0,2,0,2,2,1,0,3,3
9099,Channing Frye,33-202,C-F,12/5/16,CLE,@,TOR,W,0,19,3,7,0.429,1,2,0.5,2,5,0.4,2,2,1,1,4,5
9100,Channing Frye,33-222,C-F,12/25/16,CLE,,GSW,W,0,17,4,7,0.571,2,2,1,2,5,0.4,0,0,,0,2,2
9101,Channing Frye,33-202,C-F,12/5/16,CLE,@,TOR,W,0,19,3,7,0.429,1,2,0.5,2,5,0.4,2,2,1,1,4,5
9102,Channing Frye,33-236,C-F,1/8/17,CLE,@,PHO,W,0,18,4,8,0.5,2,2,1,2,6,0.333,0,0,,0,4,4
9103,Channing Frye,33-305,C-F,3/18/17,CLE,@,LAC,L,1,28,4,10,0.4,2,3,0.667,2,7,0.286,0,0,,0,4,4
9104,Channing Frye,33-218,C-F,12/21/16,CLE,,MIL,W,0,22,4,8,0.5,2,3,0.667,2,5,0.4,0,0,,0,1,1
9105,Marc Gasol,32-051,C,3/21/17,MEM,@,NOP,L,1,37,5,13,0.385,5,10,0.5,0,3,0,0,1,0,0,8,8
9106,Pau Gasol,36-248,F-C,3/11/17,SAS,,GSW,W,0,20,3,8,0.375,3,7,0.429,0,1,0,4,6,0.667,0,7,7
9107,Pau Gasol,36-177,F-C,12/30/16,SAS,,POR,W,1,23,4,11,0.364,4,11,0.364,0,0,,2,2,1,2,5,7
9108,Pau Gasol,36-167,F-C,12/20/16,SAS,@,HOU,W,1,26,5,8,0.625,5,8,0.625,0,0,,0,0,,1,9,10
9109,Rudy Gay,30-100,F,11/25/16,SAC,,HOU,L,1,37,4,12,0.333,4,8,0.5,0,4,0,2,2,1,0,4,4
9110,Paul George,26-255,F,1/12/17,IND,@,DEN,L,1,31,2,12,0.167,0,6,0,2,6,0.333,4,4,1,0,4,4
9111,Paul George,26-189,F,11/7/16,IND,@,CHO,L,1,33,4,12,0.333,3,6,0.5,1,6,0.167,1,1,1,2,5,7
9112,Paul George,26-299,F,2/25/17,IND,@,MIA,L,1,19,3,8,0.375,3,7,0.429,0,1,0,4,4,1,1,0,1
9113,Taj Gibson,31-189,F,12/30/16,CHI,@,IND,L,1,28,4,12,0.333,4,12,0.333,0,0,,2,2,1,3,2,5
9114,Taj Gibson,31-172,F,12/13/16,CHI,,MIN,L,1,28,5,11,0.455,5,11,0.455,0,0,,0,0,,2,2,4
9115,Taj Gibson,31-185,F,12/26/16,CHI,,IND,W,1,22,5,12,0.417,5,12,0.417,0,0,,0,0,,0,2,2
9116,Taj Gibson,31-200,F,1/10/17,CHI,@,WAS,L,1,29,3,11,0.273,2,10,0.2,1,1,1,3,3,1,4,8,12
9117,Taj Gibson,31-182,F,12/23/16,CHI,@,CHO,L,1,30,4,10,0.4,4,10,0.4,0,0,,2,2,1,1,2,3
9118,Taj Gibson,31-269,F,3/20/17,OKC,,GSW,L,1,21,5,10,0.5,5,10,0.5,0,0,,0,2,0,2,0,2
9119,Taj Gibson,31-231,F,2/10/17,CHI,@,PHO,L,1,26,5,10,0.5,5,10,0.5,0,0,,0,0,,1,5,6
9120,Taj Gibson,31-265,F,3/16/17,OKC,@,TOR,W,1,24,4,8,0.5,4,8,0.5,0,0,,2,3,0.667,3,1,4
9121,Manu Ginobili,39-113,G,11/18/16,SAS,@,LAL,W,0,21,4,6,0.667,2,2,1,2,4,0.5,0,0,,0,0,0
9122,Manu Ginobili,39-157,G,1/1/17,SAS,@,ATL,L,0,21,2,5,0.4,1,2,0.5,1,3,0.333,5,5,1,0,3,3
9123,Manu Ginobili,39-089,G,10/25/16,SAS,@,GSW,W,0,21,4,10,0.4,2,4,0.5,2,6,0.333,0,0,,0,5,5
9124,Manu Ginobili,39-106,G,11/11/16,SAS,,DET,W,0,16,4,4,1,2,2,1,2,2,1,0,1,0,0,1,1
9125,Manu Ginobili,39-185,G,1/29/17,SAS,,DAL,L,0,24,3,7,0.429,0,3,0,3,4,0.75,1,4,0.25,1,4,5
9126,Rudy Gobert,24-152,C,11/25/16,UTA,,ATL,W,1,29,2,2,1,2,2,1,0,0,,6,7,0.857,0,10,10
9127,Rudy Gobert,24-232,C,2/13/17,UTA,,LAC,L,1,25,5,12,0.417,5,12,0.417,0,0,,0,0,,8,6,14
9128,Rudy Gobert,24-227,C,2/8/17,UTA,@,NOP,W,1,30,4,10,0.4,4,10,0.4,0,0,,2,2,1,7,9,16
9129,Archie Goodwin,22-216,G,3/21/17,BRK,,DET,W,0,18,5,10,0.5,5,7,0.714,0,3,0,0,1,0,2,3,5
9130,Aaron Gordon,21-079,F,12/4/16,ORL,@,DET,W,1,22,4,8,0.5,4,6,0.667,0,2,0,2,4,0.5,0,3,3
9131,Aaron Gordon,21-061,F,11/16/16,ORL,,NOP,W,0,26,4,11,0.364,3,9,0.333,1,2,0.5,1,3,0.333,0,4,4
9132,Aaron Gordon,21-166,F,3/1/17,ORL,,NYK,L,1,24,4,12,0.333,4,9,0.444,0,3,0,2,2,1,2,3,5
9133,Eric Gordon,28-083,G,3/18/17,HOU,@,DEN,W,0,33,4,7,0.571,3,4,0.75,1,3,0.333,1,2,0.5,0,3,3
9134,Eric Gordon,28-080,G,3/15/17,HOU,,LAL,W,0,30,4,12,0.333,2,5,0.4,2,7,0.286,0,1,0,1,2,3
9135,Marcin Gortat,32-285,C-F,11/28/16,WAS,,SAC,W,1,36,4,6,0.667,4,6,0.667,0,0,,2,4,0.5,3,4,7
9136,Marcin Gortat,32-283,C-F,11/26/16,WAS,,SAS,L,1,33,5,7,0.714,5,7,0.714,0,0,,0,0,,2,8,10
9137,Marcin Gortat,32-329,C-F,1/11/17,WAS,@,BOS,L,1,32,5,8,0.625,5,8,0.625,0,0,,0,0,,5,4,9
9138,Marcin Gortat,32-278,C-F,11/21/16,WAS,,PHO,W,1,38,5,9,0.556,5,9,0.556,0,0,,0,2,0,4,9,13
9139,Marcin Gortat,32-328,C-F,1/10/17,WAS,,CHI,W,1,42,5,8,0.625,5,8,0.625,0,0,,0,0,,3,9,12
9140,Marcin Gortat,32-276,C-F,11/19/16,WAS,,MIA,L,1,38,4,6,0.667,4,6,0.667,0,0,,2,4,0.5,6,10,16
9141,Marcin Gortat,32-292,C-F,12/5/16,WAS,@,BRK,W,1,33,5,9,0.556,5,9,0.556,0,0,,0,0,,3,9,12
9142,Marcin Gortat,32-273,C-F,11/16/16,WAS,@,PHI,L,1,39,5,6,0.833,5,6,0.833,0,0,,0,1,0,2,12,14
9143,Jerami Grant,22-228,F,10/26/16,PHI,,OKC,L,0,22,4,10,0.4,4,9,0.444,0,1,0,2,4,0.5,0,4,4
9144,Jerami Grant,22-290,F,12/27/16,OKC,@,MIA,W,0,24,3,7,0.429,3,4,0.75,0,3,0,4,4,1,0,0,0
9145,Jerami Grant,22-305,F,1/11/17,OKC,,MEM,W,0,18,4,6,0.667,3,4,0.75,1,2,0.5,1,1,1,1,3,4
9146,Jerian Grant,24-078,G,12/26/16,CHI,,IND,W,0,29,4,7,0.571,2,3,0.667,2,4,0.5,0,0,,1,2,3
9147,Jerian Grant,24-130,G,2/16/17,CHI,,BOS,W,1,28,3,10,0.3,1,3,0.333,2,7,0.286,2,2,1,0,2,2
9148,Danny Green,29-272,G-F,3/21/17,SAS,@,MIN,W,1,32,4,7,0.571,2,2,1,2,5,0.4,0,0,,0,3,3
9149,Danny Green,29-149,G-F,11/18/16,SAS,@,LAL,W,1,27,4,6,0.667,2,3,0.667,2,3,0.667,0,0,,0,4,4
9150,Danny Green,29-183,G-F,12/22/16,SAS,@,LAC,L,1,30,4,8,0.5,2,3,0.667,2,5,0.4,0,0,,1,4,5
9151,Draymond Green,26-262,F,11/21/16,GSW,@,IND,W,1,29,4,7,0.571,4,5,0.8,0,2,0,2,2,1,3,6,9
9152,Draymond Green,26-260,F,11/19/16,GSW,@,MIL,W,1,36,3,7,0.429,3,6,0.5,0,1,0,4,4,1,1,1,2
9153,Gerald Green,31-018,G-F,2/13/17,BOS,@,DAL,W,0,14,4,8,0.5,2,5,0.4,2,3,0.667,0,0,,0,1,1
9154,JaMychal Green,26-180,F,12/18/16,MEM,,UTA,L,1,32,5,11,0.455,5,8,0.625,0,3,0,0,0,,4,7,11
9155,JaMychal Green,26-130,F,10/29/16,MEM,@,NYK,L,1,30,5,12,0.417,5,9,0.556,0,3,0,0,0,,1,7,8
9156,JaMychal Green,26-183,F,12/21/16,MEM,@,DET,W,1,28,3,10,0.3,1,6,0.167,2,4,0.5,2,2,1,3,6,9
9157,JaMychal Green,26-237,F,2/13/17,MEM,@,BRK,W,1,19,4,5,0.8,4,5,0.8,0,0,,2,2,1,0,6,6
9158,JaMychal Green,26-155,F,11/23/16,MEM,@,PHI,W,1,34,4,6,0.667,3,5,0.6,1,1,1,1,2,0.5,3,8,11
9159,JaMychal Green,26-220,F,1/27/17,MEM,@,POR,L,1,22,2,3,0.667,2,2,1,0,1,0,6,7,0.857,2,3,5
9160,Jeff Green,30-136,F,1/11/17,ORL,@,LAC,L,1,25,3,13,0.231,3,10,0.3,0,3,0,4,5,0.8,2,3,5
9161,Jeff Green,30-116,F,12/22/16,ORL,@,NYK,L,0,29,3,8,0.375,3,6,0.5,0,2,0,4,4,1,0,1,1
9162,Jeff Green,30-129,F,1/4/17,ORL,,ATL,L,0,21,3,4,0.75,2,3,0.667,1,1,1,3,4,0.75,0,1,1
9163,Jeff Green,30-127,F,1/2/17,ORL,@,NYK,W,0,27,3,10,0.3,2,7,0.286,1,3,0.333,3,4,0.75,1,2,3
9164,Jeff Green,30-062,F,10/29/16,ORL,@,CLE,L,0,28,2,9,0.222,0,3,0,2,6,0.333,4,6,0.667,1,9,10
9165,Jeff Green,30-061,F,10/28/16,ORL,@,DET,L,0,19,4,9,0.444,2,3,0.667,2,6,0.333,0,0,,0,2,2
9166,Jeff Green,30-155,F,1/30/17,ORL,@,MIN,L,0,25,4,6,0.667,3,4,0.75,1,2,0.5,1,1,1,0,3,3
9167,Justin Hamilton,26-231,C,11/18/16,BRK,@,OKC,L,0,21,4,6,0.667,2,2,1,2,4,0.5,0,0,,0,2,2
9168,Tim Hardaway,24-348,G,2/27/17,ATL,@,BOS,W,0,27,4,10,0.4,2,3,0.667,2,7,0.286,0,0,,0,4,4
9169,Tim Hardaway,24-308,G,1/18/17,ATL,@,DET,L,0,19,4,8,0.5,2,4,0.5,2,4,0.5,0,0,,0,1,1
9170,Tim Hardaway,24-322,G,2/1/17,ATL,@,MIA,L,1,26,2,9,0.222,0,4,0,2,5,0.4,4,4,1,0,4,4
9171,Tim Hardaway,24-251,G,11/22/16,ATL,,NOP,L,0,18,4,7,0.571,2,4,0.5,2,3,0.667,0,0,,0,1,1
9172,Tim Hardaway,24-233,G,11/4/16,ATL,@,WAS,L,0,28,3,7,0.429,3,4,0.75,0,3,0,4,4,1,0,4,4
9173,Tim Hardaway,24-350,G,3/1/17,ATL,,DAL,W,0,22,4,9,0.444,3,5,0.6,1,4,0.25,1,2,0.5,0,3,3
9174,Tim Hardaway,24-257,G,11/28/16,ATL,@,GSW,L,0,14,3,8,0.375,2,2,1,1,6,0.167,3,4,0.75,0,1,1
9175,James Harden,27-158,G,1/31/17,HOU,,SAC,W,1,32,3,9,0.333,3,4,0.75,0,5,0,4,4,1,0,7,7
9176,Maurice Harkless,23-265,F-G,1/31/17,POR,,CHO,W,0,28,5,10,0.5,5,8,0.625,0,2,0,0,0,,3,2,5
9177,Maurice Harkless,23-191,F-G,11/18/16,POR,@,NOP,L,1,35,4,13,0.308,2,6,0.333,2,7,0.286,0,0,,2,4,6
9178,Maurice Harkless,23-263,F-G,1/29/17,POR,,GSW,L,0,21,5,9,0.556,5,7,0.714,0,2,0,0,0,,1,1,2
9179,Maurice Harkless,23-238,F-G,1/4/17,POR,@,GSW,L,1,30,4,9,0.444,2,6,0.333,2,3,0.667,0,0,,3,4,7
9180,Maurice Harkless,23-302,F-G,3/9/17,POR,,PHI,W,1,39,5,9,0.556,5,9,0.556,0,0,,0,2,0,4,5,9
9181,Maurice Harkless,23-295,F-G,3/2/17,POR,,OKC,W,1,34,2,7,0.286,1,4,0.25,1,3,0.333,5,8,0.625,2,7,9
9182,Maurice Harkless,23-229,F-G,12/26/16,POR,,TOR,L,1,33,5,9,0.556,5,8,0.625,0,1,0,0,2,0,0,5,5
9183,Maurice Harkless,23-193,F-G,11/20/16,POR,@,BRK,W,1,22,5,7,0.714,5,5,1,0,2,0,0,0,,2,2,4
9184,Montrezl Harrell,22-353,F-C,1/13/17,HOU,,MEM,L,1,24,5,9,0.556,5,9,0.556,0,0,,0,0,,1,4,5
9185,Montrezl Harrell,23-003,F-C,1/29/17,HOU,@,IND,L,1,26,5,9,0.556,5,9,0.556,0,0,,0,0,,6,1,7
9186,Montrezl Harrell,23-028,F-C,2/23/17,HOU,@,NOP,W,0,14,5,6,0.833,5,6,0.833,0,0,,0,2,0,2,1,3
9187,Montrezl Harrell,23-048,F-C,3/15/17,HOU,,LAL,W,0,13,4,5,0.8,4,5,0.8,0,0,,2,4,0.5,0,0,0
9188,Devin Harris,33-330,G,1/22/17,DAL,,LAL,W,0,12,3,5,0.6,1,1,1,2,4,0.5,2,2,1,0,2,2
9189,Devin Harris,33-328,G,1/20/17,DAL,,UTA,L,0,18,2,4,0.5,0,0,,2,4,0.5,4,4,1,0,0,0
9190,Devin Harris,34-016,G,3/15/17,DAL,@,WAS,W,0,18,3,5,0.6,1,3,0.333,2,2,1,2,2,1,0,1,1
9191,Devin Harris,33-323,G,1/15/17,DAL,,MIN,W,0,16,2,4,0.5,2,2,1,0,2,0,6,6,1,1,2,3
9192,Gary Harris,22-132,G,1/24/17,DEN,,UTA,W,1,27,4,10,0.4,3,4,0.75,1,6,0.167,1,2,0.5,0,2,2
9193,Gary Harris,22-103,G,12/26/16,DEN,@,LAC,W,1,31,2,9,0.222,1,5,0.2,1,4,0.25,5,6,0.833,1,3,4
9194,Joe Harris,25-120,G,1/5/17,BRK,@,IND,L,1,26,4,8,0.5,2,3,0.667,2,5,0.4,0,0,,1,1,2
9195,Joe Harris,25-094,G,12/10/16,BRK,@,SAS,L,0,19,4,8,0.5,3,6,0.5,1,2,0.5,1,2,0.5,0,4,4
9196,Tobias Harris,24-152,F,12/14/16,DET,@,DAL,W,1,27,5,10,0.5,5,9,0.556,0,1,0,0,1,0,1,1,2
9197,Tobias Harris,24-157,F,12/19/16,DET,@,CHI,L,1,26,4,11,0.364,3,7,0.429,1,4,0.25,1,1,1,1,3,4
9198,Andrew Harrison,22-011,G,11/8/16,MEM,,DEN,W,0,26,3,6,0.5,1,2,0.5,2,4,0.5,2,2,1,0,3,3
9199,Andrew Harrison,22-067,G,1/3/17,MEM,@,LAL,L,0,17,1,3,0.333,1,1,1,0,2,0,8,10,0.8,0,1,1
9200,Andrew Harrison,22-062,G,12/29/16,MEM,,OKC,W,1,31,3,7,0.429,1,5,0.2,2,2,1,2,2,1,1,1,2
9201,Andrew Harrison,22-062,G,12/29/16,MEM,,OKC,W,1,31,3,7,0.429,1,5,0.2,2,2,1,2,2,1,1,1,2
9202,Spencer Hawes,28-272,C-F,1/25/17,CHO,,GSW,L,0,29,4,13,0.308,3,11,0.273,1,2,0.5,1,1,1,3,10,13
9203,Spencer Hawes,28-183,C-F,10/28/16,CHO,@,MIA,W,0,20,4,10,0.4,4,9,0.444,0,1,0,2,2,1,4,5,9
9204,Spencer Hawes,28-249,C-F,1/2/17,CHO,@,CHI,L,0,26,5,9,0.556,5,8,0.625,0,1,0,0,0,,1,2,3
9205,Gerald Henderson,29-054,G,2/1/17,PHI,@,DAL,L,0,24,3,7,0.429,3,6,0.5,0,1,0,4,4,1,1,2,3
9206,Gerald Henderson,29-009,G,12/18/16,PHI,,BRK,W,1,29,4,6,0.667,3,5,0.6,1,1,1,1,1,1,0,2,2
9207,Gerald Henderson,29-043,G,1/21/17,PHI,@,ATL,L,0,19,3,8,0.375,1,2,0.5,2,6,0.333,2,3,0.667,0,2,2
9208,John Henson,25-354,C-F,12/16/16,MIL,@,CHI,W,1,20,4,10,0.4,4,10,0.4,0,0,,2,2,1,0,4,4
9209,John Henson,26-061,C-F,2/27/17,MIL,@,CLE,L,0,20,5,9,0.556,5,9,0.556,0,0,,0,0,,3,2,5
9210,Mario Hezonja,21-307,F-G,12/28/16,ORL,,CHO,L,0,12,4,6,0.667,2,2,1,2,4,0.5,0,0,,0,2,2
9211,Mario Hezonja,21-364,F-G,2/23/17,ORL,,POR,L,0,25,4,5,0.8,2,3,0.667,2,2,1,0,0,,0,1,1
9212,Roy Hibbert,30-027,C,1/7/17,CHO,@,SAS,L,0,15,4,6,0.667,4,6,0.667,0,0,,2,2,1,1,4,5
9213,Roy Hibbert,29-336,C,11/11/16,CHO,,TOR,L,0,13,3,5,0.6,3,5,0.6,0,0,,4,4,1,2,0,2
9214,Roy Hibbert,29-348,C,11/23/16,CHO,,SAS,L,1,17,4,8,0.5,4,8,0.5,0,0,,2,2,1,1,1,2
9215,Buddy Hield,23-030,G,1/16/17,NOP,@,IND,L,1,15,4,5,0.8,2,2,1,2,3,0.667,0,0,,0,4,4
9216,Buddy Hield,22-323,G,11/4/16,NOP,,PHO,L,0,23,4,14,0.286,2,4,0.5,2,10,0.2,0,0,,0,3,3
9217,Buddy Hield,23-078,G,3/5/17,SAC,,UTA,L,0,19,4,7,0.571,2,3,0.667,2,4,0.5,0,0,,0,2,2
9218,Buddy Hield,23-003,G,12/20/16,NOP,@,PHI,W,1,21,4,9,0.444,2,7,0.286,2,2,1,0,0,,0,1,1
9219,Buddy Hield,22-320,G,11/1/16,NOP,,MIL,L,0,14,4,10,0.4,3,4,0.75,1,6,0.167,1,1,1,0,0,0
9220,Buddy Hield,23-032,G,1/18/17,NOP,,ORL,W,1,24,4,11,0.364,2,3,0.667,2,8,0.25,0,1,0,0,4,4
9221,Nene Hilario,34-119,F-C,1/10/17,HOU,,CHO,W,0,19,3,6,0.5,3,6,0.5,0,0,,4,6,0.667,1,4,5
9222,Nene Hilario,34-183,F-C,3/15/17,HOU,,LAL,W,0,14,5,7,0.714,5,7,0.714,0,0,,0,0,,1,2,3
9223,Nene Hilario,34-098,F-C,12/20/16,HOU,,SAS,L,1,18,4,6,0.667,4,6,0.667,0,0,,2,2,1,5,2,7
9224,Nene Hilario,34-073,F-C,11/25/16,HOU,@,SAC,W,0,15,4,5,0.8,4,5,0.8,0,0,,2,2,1,0,0,0
9225,Solomon Hill,25-283,F,12/26/16,NOP,,DAL,W,1,31,2,5,0.4,0,0,,2,5,0.4,4,4,1,0,7,7
9226,Solomon Hill,25-302,F,1/14/17,NOP,@,CHI,L,1,36,3,8,0.375,1,2,0.5,2,6,0.333,2,4,0.5,0,6,6
9227,Solomon Hill,25-287,F,12/30/16,NOP,,NYK,W,1,28,4,6,0.667,2,2,1,2,4,0.5,0,0,,0,0,0
9228,Jrue Holiday,26-184,G,12/13/16,NOP,,GSW,L,1,30,3,12,0.25,2,7,0.286,1,5,0.2,3,6,0.5,2,5,7
9229,Jrue Holiday,26-175,G,12/4/16,NOP,@,OKC,L,1,36,4,12,0.333,4,7,0.571,0,5,0,2,2,1,1,4,5
9230,Jrue Holiday,26-275,G,3/14/17,NOP,,POR,W,1,27,4,6,0.667,3,3,1,1,3,0.333,1,2,0.5,0,1,1
9231,Justin Holiday,27-256,G,12/17/16,NYK,@,DEN,L,0,20,3,6,0.5,2,3,0.667,1,3,0.333,3,4,0.75,0,1,1
9232,Justin Holiday,27-220,G,11/11/16,NYK,@,BOS,L,0,26,4,11,0.364,2,6,0.333,2,5,0.4,0,0,,4,1,5
9233,Justin Holiday,27-335,G,3/6/17,NYK,@,ORL,W,0,25,4,6,0.667,2,3,0.667,2,3,0.667,0,0,,0,4,4
9234,Justin Holiday,27-334,G,3/5/17,NYK,,GSW,L,0,15,4,6,0.667,2,2,1,2,4,0.5,0,0,,0,3,3
9235,Justin Holiday,27-345,G,3/16/17,NYK,,BRK,L,0,25,4,7,0.571,2,3,0.667,2,4,0.5,0,0,,0,1,1
9236,Rondae Hollis-Jefferson,21-358,F,12/26/16,BRK,,CHO,W,0,26,1,6,0.167,1,6,0.167,0,0,,8,10,0.8,1,3,4
9237,Rondae Hollis-Jefferson,22-007,F,1/10/17,BRK,,ATL,L,1,20,2,9,0.222,2,9,0.222,0,0,,6,6,1,1,6,7
9238,Rondae Hollis-Jefferson,22-073,F,3/17/17,BRK,,BOS,L,1,16,3,7,0.429,3,6,0.5,0,1,0,4,6,0.667,0,5,5
9239,Richaun Holmes,23-014,F-C,10/29/16,PHI,,ATL,L,0,20,5,8,0.625,5,8,0.625,0,0,,0,0,,1,5,6
9240,Richaun Holmes,23-052,F-C,12/6/16,PHI,@,MEM,L,1,34,5,13,0.385,5,11,0.455,0,2,0,0,1,0,3,3,6
9241,Richaun Holmes,23-148,F-C,3/12/17,PHI,@,LAL,W,0,22,3,6,0.5,2,3,0.667,1,3,0.333,3,4,0.75,0,5,5
9242,Richaun Holmes,23-145,F-C,3/9/17,PHI,@,POR,L,0,22,4,6,0.667,3,5,0.6,1,1,1,1,2,0.5,2,4,6
9243,Richaun Holmes,23-139,F-C,3/3/17,PHI,,NYK,W,0,25,3,4,0.75,3,4,0.75,0,0,,4,4,1,1,3,4
9244,Rodney Hood,24-031,G-F,11/20/16,UTA,@,DEN,L,1,31,3,12,0.25,3,7,0.429,0,5,0,4,6,0.667,0,5,5
9245,Rodney Hood,24-059,G-F,12/18/16,UTA,@,MEM,W,1,33,5,16,0.313,5,8,0.625,0,8,0,0,0,,1,3,4
9246,Al Horford,30-187,C-F,12/7/16,BOS,@,ORL,W,1,29,3,9,0.333,3,6,0.5,0,3,0,4,4,1,1,5,6
9247,Al Horford,30-278,C-F,3/8/17,BOS,@,GSW,W,1,32,4,8,0.5,3,7,0.429,1,1,1,1,1,1,1,5,6
9248,Al Horford,30-250,C-F,2/8/17,BOS,@,SAC,L,1,32,4,8,0.5,3,6,0.5,1,2,0.5,1,1,1,0,6,6
9249,Al Horford,30-224,C-F,1/13/17,BOS,@,ATL,W,1,35,4,8,0.5,2,3,0.667,2,5,0.4,0,2,0,0,6,6
9250,Dwight Howard,31-009,C,12/17/16,ATL,,CHO,L,1,35,4,6,0.667,4,6,0.667,0,0,,2,4,0.5,5,18,23
9251,Dwight Howard,30-340,C,11/12/16,ATL,,PHI,W,1,28,5,7,0.714,5,7,0.714,0,0,,0,1,0,5,6,11
9252,Dwight Howard,31-001,C,12/9/16,ATL,@,MIL,W,1,28,3,4,0.75,3,4,0.75,0,0,,4,6,0.667,2,5,7
9253,Dwight Howard,31-060,C,2/6/17,ATL,,UTA,L,1,25,4,5,0.8,4,5,0.8,0,0,,2,5,0.4,3,5,8
9254,Dwight Howard,31-098,C,3/16/17,ATL,,MEM,L,1,32,3,5,0.6,3,5,0.6,0,0,,4,6,0.667,3,8,11
9255,Dwight Howard,31-022,C,12/30/16,ATL,,DET,W,1,30,4,7,0.571,4,7,0.571,0,0,,2,3,0.667,5,10,15
9256,Dwight Howard,30-361,C,12/3/16,ATL,@,TOR,L,1,28,4,9,0.444,4,9,0.444,0,0,,2,4,0.5,7,10,17
9257,Dwight Howard,30-346,C,11/18/16,ATL,@,CHO,L,1,31,4,9,0.444,4,9,0.444,0,0,,2,6,0.333,2,16,18
9258,Marcelo Huertas,33-196,G,12/7/16,LAL,@,HOU,L,1,31,3,7,0.429,3,3,1,0,4,0,4,4,1,0,3,3
9259,Kris Humphries,31-301,F-C,12/3/16,ATL,@,TOR,L,0,17,4,8,0.5,3,6,0.5,1,2,0.5,1,1,1,1,2,3
9260,Kris Humphries,31-300,F-C,12/2/16,ATL,,DET,L,0,19,3,12,0.25,2,10,0.2,1,2,0.5,3,4,0.75,3,2,5
9261,Kris Humphries,31-321,F-C,12/23/16,ATL,@,DEN,W,1,22,4,10,0.4,4,9,0.444,0,1,0,2,2,1,3,5,8
9262,Serge Ibaka,27-079,F-C,12/6/16,ORL,@,WAS,W,1,31,5,15,0.333,5,11,0.455,0,4,0,0,0,,0,5,5
9263,Serge Ibaka,27-091,F-C,12/18/16,ORL,,TOR,L,1,22,5,9,0.556,5,8,0.625,0,1,0,0,0,,0,4,4
9264,Serge Ibaka,27-126,F-C,1/22/17,ORL,,GSW,L,1,21,4,9,0.444,2,5,0.4,2,4,0.5,0,0,,0,3,3
9265,Serge Ibaka,27-179,F-C,3/16/17,TOR,,OKC,L,1,27,5,11,0.455,5,7,0.714,0,4,0,0,0,,0,3,3
9266,Andre Iguodala,32-314,G-F,12/7/16,GSW,@,LAC,W,0,25,5,8,0.625,5,6,0.833,0,2,0,0,0,,1,5,6
9267,Andre Iguodala,32-296,G-F,11/19/16,GSW,@,MIL,W,0,25,4,8,0.5,2,3,0.667,2,5,0.4,0,0,,2,1,3
9268,Andre Iguodala,33-033,G-F,3/2/17,GSW,@,CHI,L,0,26,4,6,0.667,4,4,1,0,2,0,2,3,0.667,0,7,7
9269,Andre Iguodala,32-293,G-F,11/16/16,GSW,@,TOR,W,0,25,4,4,1,2,2,1,2,2,1,0,0,,0,3,3
9270,Andre Iguodala,32-308,G-F,12/1/16,GSW,,HOU,L,0,42,3,4,0.75,1,1,1,2,3,0.667,2,4,0.5,1,2,3
9271,Ersan Ilyasova,29-260,F,1/30/17,PHI,,SAC,W,1,23,3,8,0.375,2,3,0.667,1,5,0.2,3,4,0.75,1,1,2
9272,Ersan Ilyasova,29-176,F,11/7/16,PHI,,UTA,L,0,26,2,12,0.167,1,7,0.143,1,5,0.2,5,5,1,1,2,3
9273,Ersan Ilyasova,29-190,F,11/21/16,PHI,,MIA,W,1,31,4,7,0.571,2,2,1,2,5,0.4,0,0,,0,11,11
9274,Ersan Ilyasova,29-292,F,3/3/17,ATL,,CLE,L,0,23,4,4,1,4,4,1,0,0,,2,2,1,1,7,8
9275,Ersan Ilyasova,29-254,F,1/24/17,PHI,,LAC,W,1,22,3,9,0.333,1,4,0.25,2,5,0.4,2,2,1,0,5,5
9276,Ersan Ilyasova,29-164,F,10/26/16,OKC,@,PHI,W,0,20,4,7,0.571,2,2,1,2,5,0.4,0,0,,1,4,5
9277,Ersan Ilyasova,29-297,F,3/8/17,ATL,,BRK,W,0,26,3,7,0.429,2,5,0.4,1,2,0.5,3,4,0.75,2,5,7
9278,Joe Ingles,29-080,F-G,12/21/16,UTA,,SAC,L,1,39,3,9,0.333,1,2,0.5,2,7,0.286,2,2,1,1,3,4
9279,Joe Ingles,29-167,F-G,3/18/17,UTA,@,CHI,L,1,36,4,9,0.444,3,4,0.75,1,5,0.2,1,2,0.5,1,2,3
9280,Brandon Ingram,19-071,F,11/12/16,LAL,@,NOP,W,0,22,4,7,0.571,4,7,0.571,0,0,,2,3,0.667,0,0,0
9281,Brandon Ingram,19-114,F,12/25/16,LAL,,LAC,W,0,28,3,8,0.375,3,7,0.429,0,1,0,4,5,0.8,1,5,6
9282,Brandon Ingram,19-072,F,11/13/16,LAL,@,MIN,L,0,27,3,5,0.6,2,3,0.667,1,2,0.5,3,4,0.75,0,1,1
9283,Pierre Jackson,25-146,G,1/22/17,DAL,,LAL,W,0,18,4,9,0.444,3,6,0.5,1,3,0.333,1,1,1,0,2,2
9284,Reggie Jackson,26-318,G,2/28/17,DET,,POR,W,1,24,4,12,0.333,4,8,0.5,0,4,0,2,2,1,1,0,1
9285,Reggie Jackson,26-293,G,2/3/17,DET,,MIN,W,1,27,4,13,0.308,4,11,0.364,0,2,0,2,2,1,0,3,3
9286,Reggie Jackson,26-239,G,12/11/16,DET,,PHI,L,1,28,5,17,0.294,5,14,0.357,0,3,0,0,0,,0,1,1
9287,Reggie Jackson,26-235,G,12/7/16,DET,@,CHO,L,1,26,4,12,0.333,2,4,0.5,2,8,0.25,0,0,,0,3,3
9288,Al Jefferson,31-350,C-F,12/19/16,IND,,WAS,W,0,15,5,10,0.5,5,10,0.5,0,0,,0,0,,0,2,2
9289,Al Jefferson,31-313,C-F,11/12/16,IND,,BOS,L,0,17,5,9,0.556,5,9,0.556,0,0,,0,0,,0,3,3
9290,Al Jefferson,31-312,C-F,11/11/16,IND,@,PHI,L,0,22,4,9,0.444,4,9,0.444,0,0,,2,3,0.667,0,3,3
9291,Al Jefferson,31-341,C-F,12/10/16,IND,,POR,W,0,15,4,9,0.444,4,9,0.444,0,0,,2,3,0.667,2,6,8
9292,Al Jefferson,32-012,C-F,1/16/17,IND,,NOP,W,0,10,5,7,0.714,5,7,0.714,0,0,,0,0,,1,0,1
9293,Al Jefferson,32-028,C-F,2/1/17,IND,@,ORL,W,0,16,4,7,0.571,4,7,0.571,0,0,,2,2,1,2,5,7
9294,Al Jefferson,32-075,C-F,3/20/17,IND,,UTA,W,0,11,5,9,0.556,5,9,0.556,0,0,,0,0,,1,3,4
9295,Al Jefferson,31-340,C-F,12/9/16,IND,@,DAL,L,0,17,4,9,0.444,4,9,0.444,0,0,,2,2,1,1,2,3
9296,Richard Jefferson,36-183,F,12/21/16,CLE,,MIL,W,1,32,4,8,0.5,2,3,0.667,2,5,0.4,0,0,,0,0,0
9297,Brandon Jennings,27-178,G,3/20/17,WAS,@,BOS,L,0,15,3,7,0.429,2,4,0.5,1,3,0.333,3,3,1,0,1,1
9298,Brandon Jennings,27-083,G,12/15/16,NYK,@,GSW,L,1,29,4,13,0.308,4,11,0.364,0,2,0,2,4,0.5,1,5,6
9299,Jonas Jerebko,29-266,F,11/23/16,BOS,@,BRK,W,0,17,4,4,1,3,3,1,1,1,1,1,1,1,1,0,1
9300,Amir Johnson,29-271,F,1/27/17,BOS,,ORL,W,1,22,5,6,0.833,5,6,0.833,0,0,,0,0,,0,4,4
9301,Amir Johnson,29-262,F,1/18/17,BOS,,NYK,L,1,18,5,6,0.833,5,6,0.833,0,0,,0,0,,1,6,7
9302,Amir Johnson,29-291,F,2/16/17,BOS,@,CHI,L,1,17,5,6,0.833,5,6,0.833,0,0,,0,0,,0,2,2
9303,James Johnson,29-328,F,1/13/17,MIA,@,MIL,L,0,38,4,7,0.571,3,5,0.6,1,2,0.5,1,1,1,0,2,2
9304,James Johnson,30-016,F,3/8/17,MIA,,CHO,W,0,30,4,9,0.444,2,4,0.5,2,5,0.4,0,2,0,0,6,6
9305,James Johnson,29-284,F,11/30/16,MIA,@,DEN,W,0,33,4,12,0.333,4,8,0.5,0,4,0,2,3,0.667,0,7,7
9306,James Johnson,30-029,F,3/21/17,MIA,,PHO,W,0,23,3,9,0.333,2,7,0.286,1,2,0.5,3,6,0.5,0,1,1
9307,James Johnson,29-280,F,11/26/16,MIA,,MEM,L,0,32,4,8,0.5,4,5,0.8,0,3,0,2,3,0.667,0,4,4
9308,James Johnson,30-023,F,3/15/17,MIA,,NOP,W,0,25,3,7,0.429,1,5,0.2,2,2,1,2,2,1,0,4,4
9309,James Johnson,29-350,F,2/4/17,MIA,,PHI,W,0,16,4,5,0.8,4,4,1,0,1,0,2,2,1,0,6,6
9310,Joe Johnson,35-136,G-F,11/12/16,UTA,@,MIA,W,0,28,4,10,0.4,2,6,0.333,2,4,0.5,0,0,,0,6,6
9311,Joe Johnson,35-181,G-F,12/27/16,UTA,@,LAL,W,0,16,5,9,0.556,5,8,0.625,0,1,0,0,0,,0,0,0
9312,Joe Johnson,35-130,G-F,11/6/16,UTA,@,NYK,W,0,24,2,6,0.333,0,2,0,2,4,0.5,4,4,1,1,1,2
9313,Joe Johnson,35-144,G-F,11/20/16,UTA,@,DEN,L,0,27,4,8,0.5,3,6,0.5,1,2,0.5,1,2,0.5,0,5,5
9314,Stanley Johnson,20-229,F,1/13/17,DET,@,UTA,L,0,26,4,5,0.8,2,2,1,2,3,0.667,0,0,,0,0,0
9315,Tyler Johnson,24-300,G,3/3/17,MIA,@,ORL,L,0,28,4,14,0.286,4,12,0.333,0,2,0,2,2,1,1,4,5
9316,Tyler Johnson,24-184,G,11/7/16,MIA,@,OKC,L,0,27,4,9,0.444,4,8,0.5,0,1,0,2,2,1,1,3,4
9317,Tyler Johnson,24-296,G,2/27/17,MIA,@,DAL,L,0,24,4,7,0.571,3,6,0.5,1,1,1,1,2,0.5,1,3,4
9318,Tyler Johnson,24-312,G,3/15/17,MIA,,NOP,W,0,28,4,9,0.444,3,6,0.5,1,3,0.333,1,1,1,0,3,3
9319,Wesley Johnson,29-172,F-G,12/30/16,LAC,@,HOU,L,1,24,3,7,0.429,1,2,0.5,2,5,0.4,2,3,0.667,1,4,5
9320,Wesley Johnson,29-152,F-G,12/10/16,LAC,,NOP,W,0,22,4,6,0.667,2,2,1,2,4,0.5,0,0,,0,6,6
9321,Nikola Jokic,21-302,C-F,12/17/16,DEN,,NYK,W,1,20,5,8,0.625,5,8,0.625,0,0,,0,0,,2,7,9
9322,Nikola Jokic,22-007,C-F,2/26/17,DEN,,MEM,L,1,33,5,11,0.455,5,9,0.556,0,2,0,0,0,,2,9,11
9323,Nikola Jokic,21-271,C-F,11/16/16,DEN,,PHO,W,0,19,3,4,0.75,3,4,0.75,0,0,,4,5,0.8,0,2,2
9324,Terrence Jones,24-331,F,12/5/16,NOP,,MEM,L,0,32,4,11,0.364,4,11,0.364,0,0,,2,2,1,1,7,8
9325,Terrence Jones,24-341,F,12/15/16,NOP,,IND,W,0,26,4,9,0.444,4,9,0.444,0,0,,2,4,0.5,2,9,11
9326,Terrence Jones,24-354,F,12/28/16,NOP,,LAC,W,0,23,4,12,0.333,4,11,0.364,0,1,0,2,5,0.4,3,2,5
9327,Terrence Jones,24-306,F,11/10/16,NOP,@,MIL,W,1,34,2,6,0.333,2,5,0.4,0,1,0,6,6,1,3,4,7
9328,Tyus Jones,20-270,G,2/4/17,MIN,,MEM,L,0,24,3,6,0.5,1,1,1,2,5,0.4,2,2,1,1,2,3
9329,Tyus Jones,20-183,G,11/9/16,MIN,@,ORL,W,0,31,3,9,0.333,1,5,0.2,2,4,0.5,2,2,1,1,3,4
9330,DeAndre Jordan,28-174,C,1/11/17,LAC,,ORL,W,1,32,4,8,0.5,4,8,0.5,0,0,,2,4,0.5,8,12,20
9331,DeAndre Jordan,28-187,C,1/24/17,LAC,@,PHI,L,1,31,3,4,0.75,3,4,0.75,0,0,,4,12,0.333,6,14,20
9332,DeAndre Jordan,28-207,C,2/13/17,LAC,@,UTA,W,1,31,5,7,0.714,5,7,0.714,0,0,,0,2,0,2,11,13
9333,DeAndre Jordan,28-139,C,12/7/16,LAC,,GSW,L,1,32,5,7,0.714,5,7,0.714,0,0,,0,4,0,5,7,12
9334,DeAndre Jordan,28-223,C,3/1/17,LAC,,HOU,L,1,35,5,6,0.833,5,6,0.833,0,0,,0,2,0,3,6,9
9335,Cory Joseph,25-178,G,2/14/17,TOR,@,CHI,L,0,28,4,8,0.5,3,7,0.429,1,1,1,1,2,0.5,1,4,5
9336,Cory Joseph,25-105,G,12/3/16,TOR,,ATL,W,0,23,5,12,0.417,5,11,0.455,0,1,0,0,0,,1,4,5
9337,Cory Joseph,25-141,G,1/8/17,TOR,,HOU,L,0,23,4,8,0.5,4,8,0.5,0,0,,2,2,1,0,1,1
9338,Cory Joseph,25-157,G,1/24/17,TOR,,SAS,L,0,26,5,6,0.833,5,6,0.833,0,0,,0,0,,0,3,3
9339,Frank Kaminsky,23-292,F-C,1/21/17,CHO,,BRK,W,0,25,4,5,0.8,2,3,0.667,2,2,1,0,0,,0,2,2
9340,Frank Kaminsky,23-254,F-C,12/14/16,CHO,@,WAS,L,0,22,3,9,0.333,0,3,0,3,6,0.5,1,2,0.5,0,4,4
9341,Frank Kaminsky,23-302,F-C,1/31/17,CHO,@,POR,L,0,25,4,10,0.4,4,6,0.667,0,4,0,2,3,0.667,0,1,1
9342,Enes Kanter,24-199,C,12/5/16,OKC,@,ATL,W,0,15,3,6,0.5,2,4,0.5,1,2,0.5,3,4,0.75,0,3,3
9343,Enes Kanter,24-178,C,11/14/16,OKC,@,DET,L,0,17,4,9,0.444,4,7,0.571,0,2,0,2,2,1,2,1,3
9344,Enes Kanter,24-187,C,11/23/16,OKC,@,SAC,L,0,21,3,9,0.333,3,8,0.375,0,1,0,4,4,1,2,5,7
9345,Enes Kanter,24-186,C,11/22/16,OKC,@,LAL,L,0,19,4,8,0.5,4,8,0.5,0,0,,2,2,1,3,2,5
9346,Enes Kanter,24-203,C,12/9/16,OKC,,HOU,L,0,14,3,6,0.5,3,5,0.6,0,1,0,4,4,1,1,2,3
9347,Michael Kidd-Gilchrist,23-155,F,2/28/17,CHO,@,LAL,W,1,27,4,7,0.571,4,7,0.571,0,0,,2,4,0.5,3,2,5
9348,Michael Kidd-Gilchrist,23-054,F,11/19/16,CHO,@,NOP,L,1,35,2,6,0.333,2,6,0.333,0,0,,6,10,0.6,4,9,13
9349,Michael Kidd-Gilchrist,23-170,F,3/15/17,CHO,@,IND,L,1,26,5,8,0.625,5,8,0.625,0,0,,0,0,,0,1,1
9350,Michael Kidd-Gilchrist,23-064,F,11/29/16,CHO,,DET,L,1,32,3,7,0.429,3,7,0.429,0,0,,4,4,1,1,3,4
9351,Michael Kidd-Gilchrist,23-058,F,11/23/16,CHO,,SAS,L,1,29,5,11,0.455,5,11,0.455,0,0,,0,1,0,0,3,3
9352,Sean Kilpatrick,27-033,G,2/8/17,BRK,,WAS,L,0,18,3,7,0.429,1,4,0.25,2,3,0.667,2,4,0.5,0,4,4
9353,Sean Kilpatrick,26-317,G,11/18/16,BRK,@,OKC,L,0,20,3,9,0.333,3,6,0.5,0,3,0,4,5,0.8,1,1,2
9354,Sean Kilpatrick,27-002,G,1/8/17,BRK,,PHI,L,0,25,4,9,0.444,2,5,0.4,2,4,0.5,0,0,,0,3,3
9355,Sean Kilpatrick,27-056,G,3/3/17,BRK,@,UTA,L,0,23,4,10,0.4,4,9,0.444,0,1,0,2,3,0.667,0,2,2
9356,Brandon Knight,24-338,G,11/4/16,PHO,@,NOP,W,0,23,4,10,0.4,3,7,0.429,1,3,0.333,1,1,1,0,1,1
9357,Brandon Knight,25-005,G,12/7/16,PHO,,IND,L,0,25,3,10,0.3,1,5,0.2,2,5,0.4,2,2,1,1,2,3
9358,Brandon Knight,24-347,G,11/13/16,PHO,@,GSW,L,0,25,3,8,0.375,2,5,0.4,1,3,0.333,3,4,0.75,0,2,2
9359,Brandon Knight,25-053,G,1/24/17,PHO,,MIN,L,0,22,3,7,0.429,3,6,0.5,0,1,0,4,4,1,0,2,2
9360,Kyle Korver,35-255,G-F,11/27/16,ATL,@,LAL,L,1,32,3,10,0.3,1,2,0.5,2,8,0.25,2,2,1,0,4,4
9361,Kyle Korver,35-233,G-F,11/5/16,ATL,,HOU,W,1,30,4,6,0.667,2,3,0.667,2,3,0.667,0,0,,0,2,2
9362,Kyle Korver,35-279,G-F,12/21/16,ATL,,MIN,L,1,33,4,10,0.4,2,4,0.5,2,6,0.333,0,0,,0,5,5
9363,Kosta Koufos,27-348,C,2/6/17,SAC,,CHI,L,1,21,5,5,1,5,5,1,0,0,,0,0,,0,2,2
9364,Kosta Koufos,27-261,C,11/11/16,SAC,@,POR,L,1,19,4,7,0.571,4,7,0.571,0,0,,2,4,0.5,3,3,6
9365,Kosta Koufos,28-015,C,3/11/17,SAC,,DEN,L,1,28,5,8,0.625,5,8,0.625,0,0,,0,0,,3,5,8
9366,Kosta Koufos,27-294,C,12/14/16,SAC,@,HOU,L,1,25,5,11,0.455,5,11,0.455,0,0,,0,0,,5,2,7
9367,Kosta Koufos,27-275,C,11/25/16,SAC,,HOU,L,0,18,5,5,1,5,5,1,0,0,,0,0,,2,3,5
9368,Kosta Koufos,27-292,C,12/12/16,SAC,,LAL,W,1,32,5,7,0.714,5,7,0.714,0,0,,0,0,,4,3,7
9369,Mindaugas Kuzminskas,27-034,F,11/22/16,NYK,,POR,W,0,21,4,6,0.667,2,3,0.667,2,3,0.667,0,0,,0,3,3
9370,Skal Labissiere,20-353,F,3/6/17,SAC,@,DEN,L,0,20,4,8,0.5,4,8,0.5,0,0,,2,2,1,3,4,7
9371,Skal Labissiere,20-348,F,3/1/17,SAC,,BRK,L,1,15,4,5,0.8,4,5,0.8,0,0,,2,2,1,3,2,5
9372,Jeremy Lamb,24-200,G-F,12/16/16,CHO,@,BOS,L,0,16,5,10,0.5,5,8,0.625,0,2,0,0,0,,1,5,6
9373,Jeremy Lamb,24-213,G-F,12/29/16,CHO,,MIA,W,0,23,4,10,0.4,4,9,0.444,0,1,0,2,2,1,0,9,9
9374,Jeremy Lamb,24-284,G-F,3/10/17,CHO,,ORL,W,0,28,4,8,0.5,2,4,0.5,2,4,0.5,0,0,,0,5,5
9375,Jeremy Lamb,24-194,G-F,12/10/16,CHO,@,CLE,L,0,13,3,7,0.429,2,5,0.4,1,2,0.5,3,3,1,2,3,5
9376,Nicolas Laprovittola,26-310,G,12/6/16,SAS,@,MIN,W,1,21,4,5,0.8,2,2,1,2,3,0.667,0,0,,0,0,0
9377,Joffrey Lauvergne,25-082,C-F,12/21/16,OKC,@,NOP,W,0,25,5,7,0.714,5,6,0.833,0,1,0,0,0,,1,5,6
9378,Ty Lawson,29-045,G,12/18/16,SAC,@,DAL,L,0,29,4,9,0.444,2,5,0.4,2,4,0.5,0,0,,0,2,2
9379,Courtney Lee,31-080,G,12/22/16,NYK,,ORL,W,1,29,4,7,0.571,2,4,0.5,2,3,0.667,0,0,,1,2,3
9380,Courtney Lee,31-040,G,11/12/16,NYK,@,TOR,L,1,34,4,7,0.571,2,4,0.5,2,3,0.667,0,0,,0,5,5
9381,Courtney Lee,31-075,G,12/17/16,NYK,@,DEN,L,1,36,4,12,0.333,2,9,0.222,2,3,0.667,0,0,,2,0,2
9382,Courtney Lee,31-034,G,11/6/16,NYK,,UTA,L,1,36,3,8,0.375,1,6,0.167,2,2,1,2,2,1,1,5,6
9383,David Lee,33-265,F,1/19/17,SAS,,DEN,W,1,33,5,7,0.714,5,7,0.714,0,0,,0,0,,5,11,16
9384,David Lee,33-194,F,11/9/16,SAS,,HOU,L,0,16,4,6,0.667,4,6,0.667,0,0,,2,4,0.5,1,3,4
9385,David Lee,33-256,F,1/10/17,SAS,,MIL,L,1,26,5,6,0.833,5,6,0.833,0,0,,0,0,,4,3,7
9386,David Lee,33-289,F,2/12/17,SAS,@,NYK,L,0,21,5,8,0.625,5,8,0.625,0,0,,0,0,,4,3,7
9387,Alex Len,23-155,C,11/18/16,PHO,@,IND,W,1,22,5,7,0.714,5,7,0.714,0,0,,0,0,,3,7,10
9388,Alex Len,23-242,C,2/13/17,PHO,,NOP,L,0,19,4,10,0.4,4,10,0.4,0,0,,2,2,1,2,5,7
9389,Alex Len,23-149,C,11/12/16,PHO,,BRK,L,1,29,4,10,0.4,4,10,0.4,0,0,,2,4,0.5,3,8,11
9390,Alex Len,23-200,C,1/2/17,PHO,@,LAC,L,0,20,5,10,0.5,5,10,0.5,0,0,,0,0,,4,3,7
9391,Meyers Leonard,24-354,C-F,2/15/17,POR,@,UTA,L,1,23,4,8,0.5,2,4,0.5,2,4,0.5,0,0,,0,1,1
9392,Jon Leuer,27-252,F,1/21/17,DET,,WAS,W,0,25,4,6,0.667,3,5,0.6,1,1,1,1,1,1,2,3,5
9393,Jon Leuer,27-288,F,2/26/17,DET,,BOS,L,1,25,4,11,0.364,2,4,0.5,2,7,0.286,0,2,0,1,3,4
9394,Jon Leuer,27-285,F,2/23/17,DET,,CHO,W,1,41,5,14,0.357,5,11,0.455,0,3,0,0,0,,2,7,9
9395,Jon Leuer,27-272,F,2/10/17,DET,,SAS,L,1,35,4,9,0.444,4,8,0.5,0,1,0,2,2,1,0,2,2
9396,Jon Leuer,27-309,F,3/19/17,DET,,PHO,W,0,24,4,10,0.4,3,9,0.333,1,1,1,1,1,1,1,6,7
9397,Caris LeVert,22-160,G-F,2/1/17,BRK,,NYK,L,0,27,4,9,0.444,2,5,0.4,2,4,0.5,0,0,,0,4,4
9398,Caris LeVert,22-140,G-F,1/12/17,BRK,,NOP,L,0,25,4,8,0.5,3,3,1,1,5,0.2,1,2,0.5,0,3,3
9399,Caris LeVert,22-183,G-F,2/24/17,BRK,@,DEN,L,1,26,4,9,0.444,3,4,0.75,1,5,0.2,1,2,0.5,0,2,2
9400,DeAndre Liggins,28-258,G,12/14/16,CLE,@,MEM,L,1,25,3,9,0.333,2,7,0.286,1,2,0.5,3,3,1,1,2,3
9401,Jeremy Lin,28-111,G,12/12/16,BRK,@,HOU,L,0,20,4,8,0.5,3,5,0.6,1,3,0.333,1,4,0.25,0,3,3
9402,Jeremy Lin,28-071,G,11/2/16,BRK,,DET,W,1,16,4,6,0.667,4,5,0.8,0,1,0,2,2,1,0,2,2
9403,Jeremy Lin,28-122,G,12/23/16,BRK,@,CLE,L,1,25,5,10,0.5,5,8,0.625,0,2,0,0,0,,0,2,2
9404,Jeremy Lin,28-121,G,12/22/16,BRK,,GSW,L,1,32,4,12,0.333,2,5,0.4,2,7,0.286,0,0,,0,8,8
9405,Jeremy Lin,28-206,G,3/17/17,BRK,,BOS,L,1,21,3,6,0.5,1,2,0.5,2,4,0.5,2,2,1,1,6,7
9406,Shaun Livingston,31-095,G,12/15/16,GSW,,NYK,W,0,19,5,8,0.625,5,8,0.625,0,0,,0,0,,0,1,1
9407,Shaun Livingston,31-123,G,1/12/17,GSW,,DET,W,0,21,5,7,0.714,5,7,0.714,0,0,,0,0,,1,0,1
9408,Kevon Looney,21-002,F-C,2/8/17,GSW,,CHI,W,0,14,5,6,0.833,5,6,0.833,0,0,,0,1,0,0,4,4
9409,Brook Lopez,28-306,C,2/1/17,BRK,,NYK,L,1,31,4,11,0.364,4,9,0.444,0,2,0,2,4,0.5,2,4,6
9410,Robin Lopez,28-225,C,11/12/16,CHI,,WAS,W,1,38,5,16,0.313,5,16,0.313,0,0,,0,0,,6,7,13
9411,Robin Lopez,28-245,C,12/2/16,CHI,,CLE,W,1,26,5,10,0.5,5,10,0.5,0,0,,0,0,,4,1,5
9412,Robin Lopez,28-243,C,11/30/16,CHI,,LAL,L,1,32,4,12,0.333,4,12,0.333,0,0,,2,2,1,4,5,9
9413,Robin Lopez,28-341,C,3/8/17,CHI,@,ORL,L,1,36,5,9,0.556,5,9,0.556,0,0,,0,0,,3,6,9
9414,Robin Lopez,28-238,C,11/25/16,CHI,@,PHI,W,1,23,4,11,0.364,4,11,0.364,0,0,,2,2,1,3,2,5
9415,Robin Lopez,28-286,C,1/12/17,CHI,@,NYK,L,1,24,5,10,0.5,5,10,0.5,0,0,,0,0,,2,5,7
9416,Robin Lopez,28-317,C,2/12/17,CHI,@,MIN,L,1,24,5,11,0.455,5,11,0.455,0,0,,0,1,0,3,1,4
9417,Robin Lopez,28-268,C,12/25/16,CHI,@,SAS,L,1,19,4,6,0.667,4,6,0.667,0,0,,2,4,0.5,3,1,4
9418,Robin Lopez,28-335,C,3/2/17,CHI,,GSW,W,1,22,5,15,0.333,5,15,0.333,0,0,,0,0,,2,1,3
9419,Robin Lopez,28-232,C,11/19/16,CHI,@,LAC,L,1,26,5,6,0.833,5,6,0.833,0,0,,0,0,,3,3,6
9420,Robin Lopez,28-333,C,2/28/17,CHI,,DEN,L,1,26,5,14,0.357,5,14,0.357,0,0,,0,0,,3,0,3
9421,Robin Lopez,28-230,C,11/17/16,CHI,@,UTA,W,1,38,5,16,0.313,5,16,0.313,0,0,,0,0,,7,5,12
9422,Robin Lopez,28-294,C,1/20/17,CHI,@,ATL,L,1,25,5,7,0.714,5,7,0.714,0,0,,0,0,,1,3,4
9423,Robin Lopez,28-330,C,2/25/17,CHI,@,CLE,W,1,21,5,10,0.5,5,10,0.5,0,0,,0,0,,0,1,1
9424,Kevin Love,28-190,F,3/16/17,CLE,,UTA,W,1,20,5,9,0.556,5,6,0.833,0,3,0,0,0,,2,7,9
9425,Kyle Lowry,30-215,G,10/26/16,TOR,,DET,W,1,38,3,13,0.231,2,8,0.25,1,5,0.2,3,3,1,1,4,5
9426,Timothe Luwawu-Cabarrot,21-309,F,3/14/17,PHI,@,GSW,L,1,23,4,7,0.571,3,5,0.6,1,2,0.5,1,2,0.5,0,3,3
9427,Timothe Luwawu-Cabarrot,21-257,F,1/21/17,PHI,@,ATL,L,0,21,2,3,0.667,1,2,0.5,1,1,1,5,6,0.833,0,0,0
9428,Timothe Luwawu-Cabarrot,21-298,F,3/3/17,PHI,,NYK,W,0,25,4,12,0.333,2,8,0.25,2,4,0.5,0,0,,2,7,9
9429,Trey Lyles,21-004,F,11/9/16,UTA,@,CHO,L,0,18,5,10,0.5,5,6,0.833,0,4,0,0,0,,1,5,6
9430,Trey Lyles,21-126,F,3/11/17,UTA,@,OKC,L,0,26,4,10,0.4,2,5,0.4,2,5,0.4,0,0,,1,5,6
9431,Shelvin Mack,26-240,G,12/18/16,UTA,@,MEM,W,0,29,4,7,0.571,2,5,0.4,2,2,1,0,3,0,0,6,6
9432,Shelvin Mack,26-227,G,12/5/16,UTA,@,LAL,W,0,30,4,9,0.444,2,3,0.667,2,6,0.333,0,0,,0,2,2
9433,Wesley Matthews,30-115,G,2/6/17,DAL,@,DEN,L,1,34,3,8,0.375,2,5,0.4,1,3,0.333,3,4,0.75,0,7,7
9434,Wesley Matthews,30-134,G,2/25/17,DAL,,NOP,W,1,30,3,7,0.429,1,1,1,2,6,0.333,2,2,1,0,2,2
9435,Luc Mbah a Moute,30-132,F,1/19/17,LAC,,MIN,L,1,28,4,6,0.667,4,4,1,0,2,0,2,2,1,1,0,1
9436,Luc Mbah a Moute,30-094,F,12/12/16,LAC,,POR,W,1,22,3,5,0.6,1,3,0.333,2,2,1,2,2,1,0,2,2
9437,Luc Mbah a Moute,30-073,F,11/21/16,LAC,,TOR,W,1,24,4,5,0.8,2,2,1,2,3,0.667,0,0,,1,2,3
9438,James Michael McAdoo,24-024,F,1/28/17,GSW,,LAC,W,0,19,5,8,0.625,5,8,0.625,0,0,,0,0,,3,1,4
9439,James Michael McAdoo,24-029,F,2/2/17,GSW,@,LAC,W,0,17,5,6,0.833,5,6,0.833,0,0,,0,0,,4,5,9
9440,Patrick McCaw,21-089,G,1/22/17,GSW,@,ORL,W,0,20,4,11,0.364,2,6,0.333,2,5,0.4,0,0,,1,0,1
9441,Patrick McCaw,21-044,G,12/8/16,GSW,@,UTA,W,0,16,4,5,0.8,2,2,1,2,3,0.667,0,0,,0,1,1
9442,Patrick McCaw,21-147,G,3/21/17,GSW,@,DAL,W,1,30,4,7,0.571,2,4,0.5,2,3,0.667,0,0,,0,3,3
9443,C.J. McCollum,25-089,G,12/17/16,POR,@,GSW,L,1,25,5,12,0.417,5,8,0.625,0,4,0,0,0,,2,1,3
9444,T.J. McConnell,24-318,G,2/6/17,PHI,@,DET,L,1,25,5,9,0.556,5,8,0.625,0,1,0,0,0,,1,6,7
9445,T.J. McConnell,24-336,G,2/24/17,PHI,,WAS,W,1,30,4,8,0.5,4,8,0.5,0,0,,2,4,0.5,2,2,4
9446,T.J. McConnell,24-299,G,1/18/17,PHI,,TOR,W,1,29,4,6,0.667,4,6,0.667,0,0,,2,2,1,0,5,5
9447,T.J. McConnell,24-344,G,3/4/17,PHI,,DET,L,1,23,5,7,0.714,5,7,0.714,0,0,,0,0,,2,1,3
9448,T.J. McConnell,24-270,G,12/20/16,PHI,,NOP,L,0,17,5,8,0.625,5,7,0.714,0,1,0,0,0,,0,0,0
9449,Doug McDermott,24-362,F,12/30/16,CHI,@,IND,L,0,29,4,5,0.8,2,3,0.667,2,2,1,0,2,0,0,4,4
9450,Doug McDermott,25-022,F,1/25/17,CHI,,ATL,L,0,23,4,9,0.444,2,4,0.5,2,5,0.4,0,0,,0,2,2
9451,Doug McDermott,24-353,F,12/21/16,CHI,,WAS,L,0,26,4,11,0.364,2,5,0.4,2,6,0.333,0,0,,1,2,3
9452,JaVale McGee,28-296,C,11/10/16,GSW,@,DEN,W,0,15,4,6,0.667,4,6,0.667,0,0,,2,2,1,1,2,3
9453,JaVale McGee,29-060,C,3/20/17,GSW,@,OKC,W,0,13,5,7,0.714,5,7,0.714,0,0,,0,0,,3,2,5
9454,JaVale McGee,29-004,C,1/23/17,GSW,@,MIA,L,0,14,5,6,0.833,5,6,0.833,0,0,,0,1,0,1,4,5
9455,Rodney McGruder,25-194,G,2/8/17,MIA,@,MIL,W,1,36,4,13,0.308,2,5,0.4,2,8,0.25,0,0,,3,3,6
9456,Rodney McGruder,25-119,G,11/25/16,MIA,@,MEM,W,1,32,4,10,0.4,2,4,0.5,2,6,0.333,0,0,,1,2,3
9457,Ben McLemore,23-302,G,12/9/16,SAC,,NYK,L,1,22,4,7,0.571,2,5,0.4,2,2,1,0,0,,1,3,4
9458,Ben McLemore,23-359,G,2/4/17,SAC,,GSW,W,1,29,2,6,0.333,1,2,0.5,1,4,0.25,5,6,0.833,1,1,2
9459,Ben McLemore,24-012,G,2/23/17,SAC,,DEN,W,1,23,3,6,0.5,1,3,0.333,2,3,0.667,2,2,1,0,2,2
9460,Ben McLemore,23-259,G,10/27/16,SAC,,SAS,L,0,10,3,4,0.75,3,4,0.75,0,0,,4,4,1,0,2,2
9461,Josh McRoberts,29-277,F,12/1/16,MIA,@,UTA,W,1,24,5,10,0.5,5,9,0.556,0,1,0,0,0,,2,3,5
9462,Jodie Meeks,29-103,G,12/2/16,ORL,@,PHI,W,0,17,2,6,0.333,0,3,0,2,3,0.667,4,4,1,0,1,1
9463,C.J. Miles,29-212,G-F,11/16/16,IND,,CLE,W,0,23,4,7,0.571,2,2,1,2,5,0.4,0,0,,0,0,0
9464,C.J. Miles,29-245,G-F,12/19/16,IND,,WAS,W,0,30,3,7,0.429,2,4,0.5,1,3,0.333,3,3,1,1,1,2
9465,C.J. Miles,29-243,G-F,12/17/16,IND,@,DET,W,0,24,3,7,0.429,1,1,1,2,6,0.333,2,2,1,0,3,3
9466,C.J. Miles,29-280,G-F,1/23/17,IND,,NYK,L,1,34,4,14,0.286,2,5,0.4,2,9,0.222,0,0,,1,2,3
9467,Patty Mills,28-095,G,11/14/16,SAS,,MIA,W,0,24,2,3,0.667,0,1,0,2,2,1,4,4,1,1,2,3
9468,Patty Mills,28-092,G,11/11/16,SAS,,DET,W,0,26,3,7,0.429,2,3,0.667,1,4,0.25,3,3,1,0,2,2
9469,Patty Mills,28-125,G,12/14/16,SAS,,BOS,W,0,24,4,9,0.444,2,4,0.5,2,5,0.4,0,0,,0,0,0
9470,Patty Mills,28-177,G,2/4/17,SAS,,DEN,W,0,16,4,6,0.667,2,4,0.5,2,2,1,0,0,,0,4,4
9471,Patty Mills,28-220,G,3/19/17,SAS,,SAC,W,0,18,2,7,0.286,0,0,,2,7,0.286,4,4,1,0,1,1
9472,Patty Mills,28-113,G,12/2/16,SAS,,WAS,W,0,28,4,9,0.444,2,5,0.4,2,4,0.5,0,0,,1,3,4
9473,Paul Millsap,31-266,F,11/2/16,ATL,,LAL,L,1,35,3,10,0.3,2,6,0.333,1,4,0.25,3,4,0.75,1,6,7
9474,Paul Millsap,32-034,F,3/16/17,ATL,,MEM,L,1,31,3,9,0.333,1,6,0.167,2,3,0.667,2,4,0.5,0,3,3
9475,Paul Millsap,31-286,F,11/22/16,ATL,,NOP,L,1,23,4,9,0.444,3,6,0.5,1,3,0.333,1,2,0.5,1,7,8
9476,Nikola Mirotic,25-273,F,11/10/16,CHI,@,MIA,W,0,22,3,7,0.429,1,4,0.25,2,3,0.667,2,2,1,1,4,5
9477,Nikola Mirotic,25-324,F,12/31/16,CHI,,MIL,L,0,22,4,5,0.8,2,3,0.667,2,2,1,0,0,,1,3,4
9478,Nikola Mirotic,25-363,F,2/8/17,CHI,@,GSW,L,0,24,3,10,0.3,1,2,0.5,2,8,0.25,2,2,1,0,2,2
9479,Greg Monroe,26-184,C-F,12/5/16,MIL,,SAS,L,0,21,5,9,0.556,5,9,0.556,0,0,,0,1,0,2,11,13
9480,E'Twaun Moore,27-364,G,2/26/17,NOP,@,OKC,L,0,27,3,8,0.375,1,6,0.167,2,2,1,2,2,1,0,1,1
9481,E'Twaun Moore,27-280,G,12/4/16,NOP,@,OKC,L,1,23,5,11,0.455,5,9,0.556,0,2,0,0,0,,0,2,2
9482,E'Twaun Moore,27-241,G,10/26/16,NOP,,DEN,L,1,28,3,8,0.375,1,4,0.25,2,4,0.5,2,2,1,0,1,1
9483,E'Twaun Moore,28-006,G,3/6/17,NOP,@,UTA,L,0,18,4,8,0.5,2,4,0.5,2,4,0.5,0,0,,0,1,1
9484,Marcus Morris,27-085,F,11/26/16,DET,@,OKC,L,1,35,5,15,0.333,5,10,0.5,0,5,0,0,2,0,1,4,5
9485,Marcus Morris,27-066,F,11/7/16,DET,@,LAC,L,1,26,5,9,0.556,5,8,0.625,0,1,0,0,0,,1,1,2
9486,Marcus Morris,27-187,F,3/8/17,DET,@,IND,L,1,29,4,13,0.308,3,8,0.375,1,5,0.2,1,3,0.333,0,1,1
9487,Marcus Morris,27-128,F,1/8/17,DET,@,POR,W,1,46,5,17,0.294,5,13,0.385,0,4,0,0,0,,1,4,5
9488,Marcus Morris,27-161,F,2/10/17,DET,,SAS,L,1,29,4,10,0.4,3,7,0.429,1,3,0.333,1,2,0.5,1,4,5
9489,Markieff Morris,27-189,F,3/10/17,WAS,@,SAC,W,1,26,4,9,0.444,4,8,0.5,0,1,0,2,2,1,2,4,6
9490,Markieff Morris,27-117,F,12/28/16,WAS,,IND,W,1,26,4,11,0.364,4,9,0.444,0,2,0,2,2,1,2,5,7
9491,Markieff Morris,27-095,F,12/6/16,WAS,,ORL,L,1,33,3,10,0.3,3,8,0.375,0,2,0,4,5,0.8,2,5,7
9492,Markieff Morris,27-101,F,12/12/16,WAS,@,MIA,L,1,37,4,10,0.4,3,7,0.429,1,3,0.333,1,2,0.5,2,3,5
9493,Markieff Morris,27-119,F,12/30/16,WAS,,BRK,W,1,21,5,8,0.625,5,6,0.833,0,2,0,0,0,,2,4,6
9494,Anthony Morrow,31-059,G,11/25/16,OKC,@,DEN,W,0,22,4,8,0.5,2,6,0.333,2,2,1,0,0,,0,0,0
9495,Donatas Motiejunas,26-131,F-C,1/29/17,NOP,,WAS,L,0,22,5,6,0.833,5,5,1,0,1,0,0,3,0,2,2,4
9496,Donatas Motiejunas,26-129,F-C,1/27/17,NOP,,SAS,W,0,22,4,6,0.667,3,4,0.75,1,2,0.5,1,1,1,2,5,7
9497,Donatas Motiejunas,26-127,F-C,1/25/17,NOP,,OKC,L,0,17,4,6,0.667,3,4,0.75,1,2,0.5,1,2,0.5,0,4,4
9498,Timofey Mozgov,30-146,C,12/9/16,LAL,,PHO,L,1,20,4,10,0.4,4,10,0.4,0,0,,2,2,1,3,1,4
9499,Timofey Mozgov,30-117,C,11/10/16,LAL,@,SAC,W,1,33,5,6,0.833,5,6,0.833,0,0,,0,0,,1,2,3
9500,Timofey Mozgov,30-142,C,12/5/16,LAL,,UTA,L,1,20,4,7,0.571,4,7,0.571,0,0,,2,3,0.667,2,2,4
9501,Timofey Mozgov,30-136,C,11/29/16,LAL,@,NOP,L,1,21,5,8,0.625,5,8,0.625,0,0,,0,0,,4,5,9
9502,Emmanuel Mudiay,20-285,G,12/15/16,DEN,,POR,W,1,22,3,6,0.5,1,3,0.333,2,3,0.667,2,2,1,0,0,0
9503,Emmanuel Mudiay,20-250,G,11/10/16,DEN,,GSW,L,1,24,4,15,0.267,2,10,0.2,2,5,0.4,0,0,,1,3,4
9504,Emmanuel Mudiay,20-260,G,11/20/16,DEN,,UTA,W,1,32,5,13,0.385,5,10,0.5,0,3,0,0,0,,1,7,8
9505,Shabazz Muhammad,24-106,F-G,2/27/17,MIN,@,SAC,W,0,15,4,7,0.571,3,5,0.6,1,2,0.5,1,2,0.5,0,0,0
9506,Shabazz Muhammad,24-051,F-G,1/3/17,MIN,@,PHI,L,0,19,3,6,0.5,2,5,0.4,1,1,1,3,4,0.75,1,4,5
9507,Shabazz Muhammad,24-015,F-G,11/28/16,MIN,,UTA,L,0,17,3,6,0.5,3,5,0.6,0,1,0,4,4,1,0,1,1
9508,Shabazz Muhammad,24-078,F-G,1/30/17,MIN,,ORL,W,0,22,4,10,0.4,2,5,0.4,2,5,0.4,0,0,,0,5,5
9509,Dejounte Murray,20-115,G,1/12/17,SAS,,LAL,W,0,10,3,5,0.6,1,3,0.333,2,2,1,2,2,1,0,1,1
9510,Jamal Murray,19-259,G,11/8/16,DEN,@,MEM,L,0,17,4,7,0.571,2,3,0.667,2,4,0.5,0,0,,0,0,0
9511,Jamal Murray,20-006,G,3/1/17,DEN,@,MIL,W,1,30,4,13,0.308,2,4,0.5,2,9,0.222,0,0,,1,0,1
9512,Jamal Murray,20-021,G,3/16/17,DEN,,LAC,W,0,25,4,14,0.286,3,9,0.333,1,5,0.2,1,1,1,1,5,6
9513,Mike Muscala,25-126,F-C,11/4/16,ATL,@,WAS,L,0,22,5,7,0.714,5,5,1,0,2,0,0,0,,1,6,7
9514,Mike Muscala,25-122,F-C,10/31/16,ATL,,SAC,W,0,20,2,4,0.5,2,3,0.667,0,1,0,6,8,0.75,2,0,2
9515,Mike Muscala,25-149,F-C,11/27/16,ATL,@,LAL,L,0,25,4,7,0.571,2,4,0.5,2,3,0.667,0,0,,0,5,5
9516,Mike Muscala,25-222,F-C,2/8/17,ATL,,DEN,W,0,20,3,7,0.429,3,5,0.6,0,2,0,4,5,0.8,1,5,6
9517,Mike Muscala,25-130,F-C,11/8/16,ATL,@,CLE,W,0,22,5,8,0.625,5,6,0.833,0,2,0,0,0,,3,0,3
9518,Larry Nance Jr.,24-036,F,2/6/17,LAL,@,NYK,W,0,31,4,9,0.444,4,9,0.444,0,0,,2,2,1,4,6,10
9519,Larry Nance Jr.,23-343,F,12/9/16,LAL,,PHO,L,0,21,4,8,0.5,4,7,0.571,0,1,0,2,3,0.667,1,4,5
9520,Larry Nance Jr.,23-354,F,12/20/16,LAL,@,CHO,L,0,21,4,5,0.8,3,4,0.75,1,1,1,1,2,0.5,2,2,4
9521,Shabazz Napier,25-165,G,12/26/16,POR,,TOR,L,0,14,2,5,0.4,0,1,0,2,4,0.5,4,4,1,0,1,1
9522,Shabazz Napier,25-160,G,12/21/16,POR,,DAL,L,0,16,3,6,0.5,1,4,0.25,2,2,1,2,2,1,1,0,1
9523,Shabazz Napier,25-243,G,3/14/17,POR,@,NOP,L,0,19,3,7,0.429,1,3,0.333,2,4,0.5,2,3,0.667,0,1,1
9524,Shabazz Napier,25-224,G,2/23/17,POR,@,ORL,W,0,26,4,9,0.444,2,3,0.667,2,6,0.333,0,0,,1,6,7
9525,Jameer Nelson,34-303,G,12/8/16,DEN,@,WAS,L,1,36,5,10,0.5,5,9,0.556,0,1,0,0,2,0,0,4,4
9526,Jameer Nelson,34-287,G,11/22/16,DEN,,CHI,W,0,21,4,9,0.444,2,5,0.4,2,4,0.5,0,0,,0,4,4
9527,Joakim Noah,31-285,C,12/6/16,NYK,@,MIA,W,1,14,5,6,0.833,5,6,0.833,0,0,,0,0,,7,3,10
9528,Nerlens Noel,22-305,C-F,2/9/17,PHI,@,ORL,W,0,22,4,6,0.667,4,6,0.667,0,0,,2,2,1,0,7,7
9529,Lucas Nogueira,24-108,C,11/11/16,TOR,@,CHO,W,0,27,4,6,0.667,4,6,0.667,0,0,,2,2,1,2,5,7
9530,Lucas Nogueira,24-106,C,11/9/16,TOR,@,OKC,W,0,29,5,5,1,5,5,1,0,0,,0,0,,2,5,7
9531,Lucas Nogueira,24-190,C,2/1/17,TOR,@,BOS,L,0,28,3,4,0.75,3,3,1,0,1,0,4,4,1,1,4,5
9532,Lucas Nogueira,24-171,C,1/13/17,TOR,,BRK,W,1,30,5,5,1,5,5,1,0,0,,0,1,0,2,7,9
9533,Dirk Nowitzki,38-190,F,12/26/16,DAL,@,NOP,L,1,17,4,9,0.444,2,5,0.4,2,4,0.5,0,0,,0,2,2
9534,Dirk Nowitzki,38-157,F,11/23/16,DAL,,LAC,L,1,20,3,10,0.3,2,7,0.286,1,3,0.333,3,3,1,0,6,6
9535,Dirk Nowitzki,38-257,F,3/3/17,DAL,,MEM,W,1,29,4,10,0.4,3,6,0.5,1,4,0.25,1,1,1,0,7,7
9536,Dirk Nowitzki,38-271,F,3/17/17,DAL,@,PHI,L,1,19,5,9,0.556,5,9,0.556,0,0,,0,0,,0,1,1
9537,Dirk Nowitzki,38-212,F,1/17/17,DAL,@,CHI,W,1,27,3,9,0.333,3,6,0.5,0,3,0,4,6,0.667,0,10,10
9538,Jusuf Nurkic,22-101,C,12/2/16,DEN,,HOU,L,1,20,5,9,0.556,5,9,0.556,0,0,,0,2,0,4,3,7
9539,Jusuf Nurkic,22-074,C,11/5/16,DEN,@,DET,L,1,24,5,8,0.625,5,8,0.625,0,0,,0,0,,4,8,12
9540,Kyle O'Quinn,26-256,F-C,12/7/16,NYK,,CLE,L,0,21,5,7,0.714,5,7,0.714,0,0,,0,0,,3,4,7
9541,Kyle O'Quinn,26-307,F-C,1/27/17,NYK,,CHO,W,0,16,4,7,0.571,3,6,0.5,1,1,1,1,1,1,2,5,7
9542,Kyle O'Quinn,26-291,F-C,1/11/17,NYK,@,PHI,L,0,24,5,6,0.833,5,5,1,0,1,0,0,0,,3,12,15
9543,Kyle O'Quinn,26-317,F-C,2/6/17,NYK,,LAL,L,1,16,2,5,0.4,2,5,0.4,0,0,,6,6,1,1,1,2
9544,Kyle O'Quinn,26-231,F-C,11/12/16,NYK,@,TOR,L,0,14,5,7,0.714,5,7,0.714,0,0,,0,0,,2,2,4
9545,Jahlil Okafor,21-092,C-F,3/17/17,PHI,,DAL,W,0,21,4,8,0.5,4,8,0.5,0,0,,2,2,1,0,3,3
9546,Jahlil Okafor,20-346,C-F,11/25/16,PHI,,CHI,L,1,27,5,11,0.455,5,11,0.455,0,0,,0,2,0,1,5,6
9547,Jahlil Okafor,21-032,C-F,1/16/17,PHI,@,MIL,W,0,20,4,5,0.8,4,5,0.8,0,0,,2,2,1,0,2,2
9548,Victor Oladipo,24-175,G,10/26/16,OKC,@,PHI,W,1,26,4,16,0.25,4,11,0.364,0,5,0,2,3,0.667,2,3,5
9549,Kelly Olynyk,25-218,C-F,11/23/16,BOS,@,BRK,W,0,19,3,9,0.333,1,4,0.25,2,5,0.4,2,2,1,1,1,2
9550,Kelly Olynyk,25-316,C-F,3/1/17,BOS,,CLE,W,0,19,4,5,0.8,4,5,0.8,0,0,,2,2,1,1,1,2
9551,Kelly Olynyk,25-245,C-F,12/20/16,BOS,@,MEM,W,0,26,2,7,0.286,1,5,0.2,1,2,0.5,5,6,0.833,1,2,3
9552,Kelly Olynyk,25-277,C-F,1/21/17,BOS,,POR,L,0,25,4,4,1,4,4,1,0,0,,2,2,1,2,6,8
9553,Kelly Olynyk,25-211,C-F,11/16/16,BOS,,DAL,W,1,29,5,8,0.625,5,7,0.714,0,1,0,0,0,,0,4,4
9554,Kelly Olynyk,25-330,C-F,3/15/17,BOS,,MIN,W,0,13,3,4,0.75,3,3,1,0,1,0,4,6,0.667,0,1,1
9555,Kelly Oubre,20-334,F,11/7/16,WAS,,HOU,L,0,14,3,7,0.429,1,4,0.25,2,3,0.667,2,2,1,1,0,1
9556,Kelly Oubre,20-362,F,12/5/16,WAS,@,BRK,W,0,18,3,8,0.375,1,3,0.333,2,5,0.4,2,2,1,1,4,5
9557,Kelly Oubre,21-045,F,1/23/17,WAS,@,CHO,W,0,23,4,5,0.8,2,2,1,2,3,0.667,0,2,0,0,2,2
9558,Kelly Oubre,21-041,F,1/19/17,WAS,@,NYK,W,0,25,3,6,0.5,2,2,1,1,4,0.25,3,3,1,0,3,3
9559,Kelly Oubre,21-057,F,2/4/17,WAS,,NOP,W,0,23,3,6,0.5,1,1,1,2,5,0.4,2,2,1,0,2,2
9560,Kelly Oubre,20-338,F,11/11/16,WAS,,CLE,L,0,21,5,8,0.625,5,7,0.714,0,1,0,0,0,,0,6,6
9561,Kelly Oubre,20-355,F,11/28/16,WAS,,SAC,W,0,24,2,3,0.667,2,2,1,0,1,0,6,6,1,4,7,11
9562,Zaza Pachulia,33-023,C,3/5/17,GSW,@,NYK,W,1,18,5,6,0.833,5,6,0.833,0,0,,0,0,,0,1,1
9563,Zaza Pachulia,32-261,C,10/28/16,GSW,@,NOP,W,1,17,4,6,0.667,4,6,0.667,0,0,,2,2,1,2,9,11
9564,Zaza Pachulia,32-333,C,1/8/17,GSW,@,SAC,W,1,22,4,5,0.8,4,5,0.8,0,0,,2,2,1,5,2,7
9565,Zaza Pachulia,32-331,C,1/6/17,GSW,,MEM,L,1,30,3,4,0.75,3,4,0.75,0,0,,4,4,1,0,5,5
9566,Zaza Pachulia,33-034,C,3/16/17,GSW,,ORL,W,1,21,5,8,0.625,5,8,0.625,0,0,,0,0,,3,7,10
9567,Zaza Pachulia,32-345,C,1/20/17,GSW,@,HOU,W,1,20,3,5,0.6,3,5,0.6,0,0,,4,6,0.667,2,7,9
9568,Chandler Parsons,28-073,F,1/6/17,MEM,@,GSW,W,1,16,4,7,0.571,2,3,0.667,2,4,0.5,0,0,,0,1,1
9569,Patrick Patterson,27-323,F,1/31/17,TOR,,NOP,W,1,35,4,8,0.5,2,3,0.667,2,5,0.4,0,0,,0,7,7
9570,Patrick Patterson,27-319,F,1/27/17,TOR,,MIL,W,1,27,4,6,0.667,2,2,1,2,4,0.5,0,0,,2,5,7
9571,Patrick Patterson,27-233,F,11/2/16,TOR,@,WAS,W,0,30,4,9,0.444,2,3,0.667,2,6,0.333,0,0,,1,2,3
9572,Patrick Patterson,27-277,F,12/16/16,TOR,,ATL,L,0,35,4,8,0.5,2,4,0.5,2,4,0.5,0,0,,3,2,5
9573,Patrick Patterson,27-243,F,11/12/16,TOR,,NYK,W,0,28,3,8,0.375,1,1,1,2,7,0.286,2,2,1,0,5,5
9574,Patrick Patterson,27-324,F,2/1/17,TOR,@,BOS,L,1,21,3,6,0.5,2,2,1,1,4,0.25,3,5,0.6,1,2,3
9575,Adreian Payne,25-268,F-C,11/13/16,MIN,,LAL,W,0,9,4,5,0.8,2,3,0.667,2,2,1,0,0,,1,1,2
9576,Elfrid Payton,22-347,G,2/3/17,ORL,,TOR,W,1,32,5,12,0.417,5,10,0.5,0,2,0,0,0,,0,4,4
9577,Elfrid Payton,22-298,G,12/16/16,ORL,,BRK,W,0,21,4,11,0.364,4,10,0.4,0,1,0,2,2,1,0,5,5
9578,Elfrid Payton,22-250,G,10/29/16,ORL,@,CLE,L,1,34,5,11,0.455,5,9,0.556,0,2,0,0,2,0,0,4,4
9579,Elfrid Payton,22-281,G,11/29/16,ORL,@,SAS,W,0,23,5,9,0.556,5,9,0.556,0,0,,0,0,,1,2,3
9580,Elfrid Payton,22-337,G,1/24/17,ORL,,CHI,L,1,38,5,16,0.313,5,13,0.385,0,3,0,0,2,0,3,4,7
9581,Elfrid Payton,23-026,G,3/20/17,ORL,,PHI,W,1,31,5,9,0.556,5,9,0.556,0,0,,0,0,,5,8,13
9582,Elfrid Payton,22-289,G,12/7/16,ORL,,BOS,L,0,28,5,8,0.625,5,8,0.625,0,0,,0,2,0,1,3,4
9583,Elfrid Payton,22-304,G,12/22/16,ORL,@,NYK,L,0,31,4,11,0.364,3,7,0.429,1,4,0.25,1,2,0.5,2,6,8
9584,Elfrid Payton,22-351,G,2/7/17,ORL,@,HOU,L,1,27,5,11,0.455,5,10,0.5,0,1,0,0,0,,0,2,2
9585,Elfrid Payton,23-023,G,3/17/17,ORL,@,PHO,W,1,31,4,9,0.444,4,9,0.444,0,0,,2,2,1,0,4,4
9586,Mason Plumlee,27-011,C-F,3/16/17,DEN,,LAC,W,1,30,5,9,0.556,5,9,0.556,0,0,,0,2,0,2,7,9
9587,Mason Plumlee,26-355,C-F,2/23/17,DEN,@,SAC,L,0,22,3,3,1,3,3,1,0,0,,4,7,0.571,1,2,3
9588,Mason Plumlee,26-248,C-F,11/8/16,POR,,PHO,W,1,31,5,6,0.833,5,6,0.833,0,0,,0,2,0,0,5,5
9589,Mason Plumlee,26-277,C-F,12/7/16,POR,@,MIL,L,1,33,4,10,0.4,4,10,0.4,0,0,,2,4,0.5,2,8,10
9590,Mason Plumlee,26-291,C-F,12/21/16,POR,,DAL,L,1,29,4,4,1,4,4,1,0,0,,2,7,0.286,1,6,7
9591,Mason Plumlee,26-275,C-F,12/5/16,POR,@,CHI,W,1,23,4,9,0.444,4,9,0.444,0,0,,2,2,1,1,4,5
9592,Mason Plumlee,26-322,C-F,1/21/17,POR,@,BOS,W,1,28,4,8,0.5,4,8,0.5,0,0,,2,4,0.5,3,8,11
9593,Mason Plumlee,27-001,C-F,3/6/17,DEN,,SAC,W,1,31,3,9,0.333,3,9,0.333,0,0,,4,6,0.667,2,9,11
9594,Miles Plumlee,28-144,C-F,1/23/17,MIL,,HOU,W,1,20,4,5,0.8,4,5,0.8,0,0,,2,2,1,1,1,2
9595,Otto Porter,23-146,F,10/27/16,WAS,@,ATL,L,1,26,5,7,0.714,5,7,0.714,0,0,,0,1,0,2,4,6
9596,Otto Porter,23-194,F,12/14/16,WAS,,CHO,W,1,36,5,9,0.556,5,7,0.714,0,2,0,0,0,,2,3,5
9597,Otto Porter,23-242,F,1/31/17,WAS,,NYK,W,1,29,5,9,0.556,5,6,0.833,0,3,0,0,1,0,0,6,6
9598,Otto Porter,23-225,F,1/14/17,WAS,,PHI,W,1,30,4,12,0.333,4,10,0.4,0,2,0,2,4,0.5,3,3,6
9599,Otto Porter,23-190,F,12/10/16,WAS,,MIL,W,1,33,4,9,0.444,2,5,0.4,2,4,0.5,0,0,,1,0,1
9600,Otto Porter,23-155,F,11/5/16,WAS,@,ORL,L,1,29,4,8,0.5,2,5,0.4,2,3,0.667,0,0,,3,10,13
9601,Bobby Portis,21-345,F,1/20/17,CHI,@,ATL,L,0,17,5,8,0.625,5,7,0.714,0,1,0,0,0,,1,6,7
9602,Bobby Portis,22-024,F,3/6/17,CHI,@,DET,L,1,26,4,9,0.444,4,8,0.5,0,1,0,2,2,1,2,4,6
9603,Bobby Portis,21-310,F,12/16/16,CHI,,MIL,L,0,19,4,8,0.5,2,6,0.333,2,2,1,0,2,0,2,6,8
9604,Dwight Powell,25-149,F-C,12/16/16,DAL,@,UTA,L,0,24,3,9,0.333,3,7,0.429,0,2,0,4,5,0.8,1,3,4
9605,Dwight Powell,25-163,F-C,12/30/16,DAL,@,GSW,L,0,26,5,7,0.714,5,7,0.714,0,0,,0,0,,3,10,13
9606,Dwight Powell,25-133,F-C,11/30/16,DAL,,SAS,L,0,15,4,6,0.667,4,6,0.667,0,0,,2,2,1,2,2,4
9607,Dwight Powell,25-236,F-C,3/13/17,DAL,@,TOR,L,0,21,4,9,0.444,4,9,0.444,0,0,,2,3,0.667,3,7,10
9608,Dwight Powell,25-128,F-C,11/25/16,DAL,@,CLE,L,0,12,4,6,0.667,4,5,0.8,0,1,0,2,2,1,0,1,1
9609,Dwight Powell,25-176,F-C,1/12/17,DAL,@,PHO,W,0,15,3,7,0.429,3,7,0.429,0,0,,4,4,1,3,2,5
9610,Dwight Powell,25-111,F-C,11/8/16,DAL,@,LAL,W,0,27,5,9,0.556,5,9,0.556,0,0,,0,0,,1,3,4
9611,Norman Powell,23-256,G,2/5/17,TOR,@,BRK,W,1,33,5,14,0.357,5,13,0.385,0,1,0,0,0,,4,2,6
9612,Norman Powell,23-228,G,1/8/17,TOR,,HOU,L,1,22,3,7,0.429,1,2,0.5,2,5,0.4,2,2,1,0,1,1
9613,Chasson Randle,23-346,G,1/16/17,PHI,@,MIL,W,0,16,3,6,0.5,1,2,0.5,2,4,0.5,2,2,1,0,2,2
9614,Julius Randle,22-110,F,3/19/17,LAL,,CLE,L,1,38,3,9,0.333,2,6,0.333,1,3,0.333,3,4,0.75,2,5,7
9615,Zach Randolph,35-109,F,11/2/16,MEM,,NOP,W,0,20,5,18,0.278,5,16,0.313,0,2,0,0,1,0,4,7,11
9616,Zach Randolph,35-153,F,12/16/16,MEM,,SAC,L,0,27,4,9,0.444,4,9,0.444,0,0,,2,2,1,3,6,9
9617,Zach Randolph,35-125,F,11/18/16,MEM,@,DAL,W,0,22,4,12,0.333,4,10,0.4,0,2,0,2,2,1,2,6,8
9618,Zach Randolph,35-233,F,3/6/17,MEM,,BRK,L,0,16,4,12,0.333,4,12,0.333,0,0,,2,4,0.5,2,5,7
9619,J.J. Redick,32-148,G,11/19/16,LAC,,CHI,W,1,25,3,9,0.333,2,4,0.5,1,5,0.2,3,4,0.75,0,2,2
9620,J.J. Redick,32-232,G,2/11/17,LAC,@,CHO,W,1,24,3,11,0.273,1,3,0.333,2,8,0.25,2,2,1,1,3,4
9621,J.J. Redick,32-252,G,3/3/17,LAC,@,MIL,L,1,31,4,8,0.5,3,6,0.5,1,2,0.5,1,1,1,0,3,3
9622,J.J. Redick,32-173,G,12/14/16,LAC,@,ORL,W,1,29,3,11,0.273,0,5,0,3,6,0.5,1,1,1,0,3,3
9623,J.J. Redick,32-138,G,11/9/16,LAC,,POR,W,1,18,3,5,0.6,2,3,0.667,1,2,0.5,3,4,0.75,0,1,1
9624,J.J. Redick,32-152,G,11/23/16,LAC,@,DAL,W,1,22,4,9,0.444,3,5,0.6,1,4,0.25,1,1,1,0,2,2
9625,J.J. Redick,32-204,G,1/14/17,LAC,,LAL,W,1,30,4,12,0.333,2,5,0.4,2,7,0.286,0,0,,0,1,1
9626,Willie Reed,26-163,F-C,10/26/16,MIA,@,ORL,W,0,17,5,6,0.833,5,6,0.833,0,0,,0,0,,3,3,6
9627,Willie Reed,26-207,F-C,12/9/16,MIA,@,CLE,L,0,20,2,7,0.286,2,7,0.286,0,0,,6,8,0.75,8,3,11
9628,Josh Richardson,23-185,G,3/19/17,MIA,,POR,L,1,33,4,8,0.5,3,5,0.6,1,3,0.333,1,2,0.5,0,1,1
9629,Josh Richardson,23-090,G,12/14/16,MIA,,IND,W,0,30,4,8,0.5,2,4,0.5,2,4,0.5,0,0,,1,4,5
9630,Josh Richardson,23-088,G,12/12/16,MIA,,WAS,W,0,29,4,7,0.571,2,4,0.5,2,3,0.667,0,0,,0,4,4
9631,Malachi Richardson,21-041,G,2/15/17,SAC,@,GSW,L,0,27,4,10,0.4,4,9,0.444,0,1,0,2,2,1,1,6,7
9632,Austin Rivers,24-219,G,3/8/17,LAC,@,MIN,L,0,29,3,10,0.3,1,6,0.167,2,4,0.5,2,3,0.667,0,2,2
9633,Austin Rivers,24-180,G,1/28/17,LAC,@,GSW,L,1,38,3,11,0.273,2,7,0.286,1,4,0.25,3,6,0.5,0,2,2
9634,Andre Roberson,24-362,G-F,11/30/16,OKC,,WAS,W,1,35,4,6,0.667,2,3,0.667,2,3,0.667,0,0,,0,5,5
9635,Andre Roberson,24-360,G-F,11/28/16,OKC,@,NYK,W,1,31,4,8,0.5,2,4,0.5,2,4,0.5,0,0,,1,2,3
9636,Andre Roberson,25-073,G-F,2/15/17,OKC,,NYK,W,1,34,3,8,0.375,2,7,0.286,1,1,1,3,4,0.75,2,5,7
9637,Andre Roberson,24-355,G-F,11/23/16,OKC,@,SAC,L,1,35,4,7,0.571,3,3,1,1,4,0.25,1,2,0.5,1,4,5
9638,Glenn Robinson,23-039,G-F,2/16/17,IND,,WAS,L,1,24,4,6,0.667,3,4,0.75,1,2,0.5,1,1,1,0,1,1
9639,Thomas Robinson,25-285,F,12/27/16,LAL,,UTA,L,0,18,5,6,0.833,5,6,0.833,0,0,,0,0,,1,2,3
9640,Sergio Rodriguez,30-143,G,11/2/16,PHI,@,CHO,L,1,26,3,9,0.333,0,2,0,3,7,0.429,1,1,1,1,2,3
9641,Sergio Rodriguez,30-218,G,1/16/17,PHI,@,MIL,W,1,32,4,10,0.4,3,4,0.75,1,6,0.167,1,1,1,0,5,5
9642,Sergio Rodriguez,30-262,G,3/1/17,PHI,@,MIA,L,0,18,5,10,0.5,5,10,0.5,0,0,,0,0,,1,0,1
9643,Sergio Rodriguez,30-239,G,2/6/17,PHI,@,DET,L,0,18,4,8,0.5,2,4,0.5,2,4,0.5,0,0,,0,2,2
9644,Sergio Rodriguez,30-260,G,2/27/17,PHI,,GSW,L,0,28,4,12,0.333,2,5,0.4,2,7,0.286,0,0,,0,5,5
9645,Sergio Rodriguez,30-237,G,2/4/17,PHI,@,MIA,L,0,12,4,7,0.571,2,5,0.4,2,2,1,0,0,,0,1,1
9646,Rajon Rondo,30-252,G,10/31/16,CHI,@,BRK,W,1,25,5,8,0.625,5,7,0.714,0,1,0,0,0,,1,3,4
9647,Rajon Rondo,30-288,G,12/6/16,CHI,@,DET,L,1,37,4,10,0.4,3,8,0.375,1,2,0.5,1,3,0.333,1,2,3
9648,Rajon Rondo,30-301,G,12/19/16,CHI,,DET,W,1,28,4,7,0.571,2,4,0.5,2,3,0.667,0,0,,0,8,8
9649,Rajon Rondo,30-356,G,2/12/17,CHI,@,MIN,L,0,24,5,9,0.556,5,6,0.833,0,3,0,0,0,,0,3,3
9650,Derrick Rose,28-063,G,12/6/16,NYK,@,MIA,W,1,25,4,12,0.333,4,11,0.364,0,1,0,2,2,1,1,1,2
9651,Terrence Ross,25-315,F-G,12/16/16,TOR,,ATL,L,0,22,4,7,0.571,3,3,1,1,4,0.25,1,1,1,0,1,1
9652,Terrence Ross,25-322,F-G,12/23/16,TOR,@,UTA,W,0,20,4,7,0.571,2,3,0.667,2,4,0.5,0,0,,0,1,1
9653,Terrence Ross,26-026,F-G,3/3/17,ORL,,MIA,W,1,35,5,9,0.556,5,7,0.714,0,2,0,0,0,,0,4,4
9654,Terry Rozier,22-323,G,2/3/17,BOS,,LAL,W,0,18,4,4,1,2,2,1,2,2,1,0,0,,1,3,4
9655,Terry Rozier,22-239,G,11/11/16,BOS,,NYK,W,0,27,1,8,0.125,0,7,0,1,1,1,7,8,0.875,2,3,5
9656,Ricky Rubio,26-023,G,11/13/16,MIN,,LAL,W,1,34,4,6,0.667,3,3,1,1,3,0.333,1,2,0.5,0,4,4
9657,Ricky Rubio,26-082,G,1/11/17,MIN,,HOU,W,1,35,1,5,0.2,1,3,0.333,0,2,0,8,8,1,0,3,3
9658,Ricky Rubio,26-049,G,12/9/16,MIN,,DET,L,1,28,4,5,0.8,4,5,0.8,0,0,,2,2,1,1,2,3
9659,Ricky Rubio,26-149,G,3/19/17,MIN,@,NOP,L,1,35,4,10,0.4,2,5,0.4,2,5,0.4,0,0,,0,3,3
9660,Ricky Rubio,26-061,G,12/21/16,MIN,@,ATL,W,1,33,3,5,0.6,1,2,0.5,2,3,0.667,2,2,1,1,4,5
9661,Brandon Rush,31-183,G-F,1/6/17,MIN,@,WAS,L,0,20,4,4,1,2,2,1,2,2,1,0,0,,1,0,1
9662,D'Angelo Russell,21-018,G,3/13/17,LAL,@,DEN,L,0,28,4,14,0.286,2,8,0.25,2,6,0.333,0,2,0,1,1,2
9663,Domantas Sabonis,20-268,F,1/26/17,OKC,,DAL,W,1,29,3,4,0.75,2,3,0.667,1,1,1,3,4,0.75,0,5,5
9664,Domantas Sabonis,20-211,F,11/30/16,OKC,,WAS,W,1,19,5,5,1,5,5,1,0,0,,0,0,,0,3,3
9665,Domantas Sabonis,20-258,F,1/16/17,OKC,@,LAC,L,1,27,4,7,0.571,2,4,0.5,2,3,0.667,0,0,,0,0,0
9666,Dario Saric,22-233,F,11/27/16,PHI,,CLE,L,0,20,4,9,0.444,2,5,0.4,2,4,0.5,0,0,,1,3,4
9667,Dario Saric,22-299,F,2/1/17,PHI,@,DAL,L,0,24,3,9,0.333,2,5,0.4,1,4,0.25,3,6,0.5,2,5,7
9668,Dario Saric,22-225,F,11/19/16,PHI,,PHO,W,0,25,3,7,0.429,1,3,0.333,2,4,0.5,2,2,1,0,7,7
9669,Dario Saric,22-327,F,3/1/17,PHI,@,MIA,L,1,28,4,12,0.333,2,9,0.222,2,3,0.667,0,0,,3,3,6
9670,Dario Saric,22-343,F,3/17/17,PHI,,DAL,W,1,26,3,9,0.333,3,7,0.429,0,2,0,4,4,1,1,6,7
9671,Tomas Satoransky,25-078,G,1/16/17,WAS,,POR,W,0,19,4,7,0.571,3,4,0.75,1,3,0.333,1,1,1,3,7,10
9672,Dennis Schroder,23-182,G,3/16/17,ATL,,MEM,L,1,26,4,16,0.25,3,10,0.3,1,6,0.167,1,1,1,1,2,3
9673,Luis Scola,36-196,F,11/12/16,BRK,@,PHO,W,0,14,4,5,0.8,2,3,0.667,2,2,1,0,0,,0,5,5
9674,Thabo Sefolosha,32-258,G-F,1/15/17,ATL,,MIL,W,1,35,4,11,0.364,3,8,0.375,1,3,0.333,1,1,1,1,1,2
9675,Thabo Sefolosha,32-219,G-F,12/7/16,ATL,,MIA,W,1,29,5,11,0.455,5,8,0.625,0,3,0,0,0,,3,2,5
9676,Thabo Sefolosha,32-253,G-F,1/10/17,ATL,@,BRK,W,1,27,5,10,0.5,5,8,0.625,0,2,0,0,0,,0,4,4
9677,Thabo Sefolosha,32-263,G-F,1/20/17,ATL,,CHI,W,1,26,4,6,0.667,4,6,0.667,0,0,,2,2,1,2,2,4
9678,Kevin Seraphin,27-036,F,1/12/17,IND,@,DEN,L,0,20,5,6,0.833,5,6,0.833,0,0,,0,0,,1,4,5
9679,Kevin Seraphin,27-027,F,1/3/17,IND,@,DET,W,0,15,4,5,0.8,4,5,0.8,0,0,,2,2,1,2,3,5
9680,Ramon Sessions,30-210,G,11/7/16,CHO,,IND,W,0,21,3,7,0.429,3,5,0.6,0,2,0,4,5,0.8,0,1,1
9681,Ramon Sessions,30-284,G,1/20/17,CHO,,TOR,W,0,21,4,8,0.5,3,7,0.429,1,1,1,1,1,1,0,1,1
9682,Iman Shumpert,26-166,G,12/9/16,CLE,,MIA,W,0,21,4,8,0.5,2,4,0.5,2,4,0.5,0,0,,0,4,4
9683,Iman Shumpert,26-196,G,1/8/17,CLE,@,PHO,W,0,26,4,7,0.571,2,3,0.667,2,4,0.5,0,0,,0,3,3
9684,Iman Shumpert,26-178,G,12/21/16,CLE,,MIL,W,0,29,3,7,0.429,0,3,0,3,4,0.75,1,2,0.5,0,3,3
9685,Iman Shumpert,26-211,G,1/23/17,CLE,@,NOP,L,1,28,4,10,0.4,2,4,0.5,2,6,0.333,0,0,,0,2,2
9686,Iman Shumpert,26-265,G,3/18/17,CLE,@,LAC,L,1,25,5,11,0.455,5,9,0.556,0,2,0,0,0,,0,5,5
9687,Pascal Siakam,22-286,F,11/16/16,TOR,,GSW,L,1,30,5,10,0.5,5,10,0.5,0,0,,0,0,,4,5,9
9688,Pascal Siakam,22-276,F,11/6/16,TOR,,SAC,L,1,24,4,8,0.5,4,8,0.5,0,0,,2,3,0.667,3,3,6
9689,Jonathon Simmons,27-100,G-F,12/23/16,SAS,@,POR,W,0,18,5,8,0.625,5,7,0.714,0,1,0,0,0,,1,3,4
9690,Jonathon Simmons,27-186,G-F,3/19/17,SAS,,SAC,W,0,27,3,6,0.5,1,2,0.5,2,4,0.5,2,2,1,0,0,0
9691,Marcus Smart,22-257,G,11/18/16,BOS,,GSW,L,1,25,4,10,0.4,2,6,0.333,2,4,0.5,0,0,,0,0,0
9692,Marcus Smart,23-009,G,3/15/17,BOS,,MIN,W,0,26,5,10,0.5,5,6,0.833,0,4,0,0,0,,0,2,2
9693,Marcus Smart,22-339,G,2/8/17,BOS,@,SAC,L,0,28,3,7,0.429,1,1,1,2,6,0.333,2,2,1,0,2,2
9694,Marcus Smart,22-332,G,2/1/17,BOS,,TOR,W,0,35,4,11,0.364,3,6,0.5,1,5,0.2,1,2,0.5,2,3,5
9695,Marcus Smart,23-014,G,3/20/17,BOS,,WAS,W,0,20,3,9,0.333,3,8,0.375,0,1,0,4,6,0.667,1,1,2
9696,Marcus Smart,22-342,G,2/11/17,BOS,@,UTA,W,1,37,4,11,0.364,4,6,0.667,0,5,0,2,2,1,1,4,5
9697,Ish Smith,28-218,G,2/8/17,DET,,LAL,W,0,21,5,6,0.833,5,6,0.833,0,0,,0,0,,0,4,4
9698,Ish Smith,28-119,G,11/1/16,DET,,NYK,W,1,32,5,14,0.357,5,14,0.357,0,0,,0,0,,0,2,2
9699,Ish Smith,28-130,G,11/12/16,DET,@,DEN,W,1,29,5,12,0.417,5,12,0.417,0,0,,0,0,,1,2,3
9700,Ish Smith,28-213,G,2/3/17,DET,,MIN,W,0,21,5,8,0.625,5,7,0.714,0,1,0,0,0,,0,3,3
9701,Ish Smith,28-130,G,11/12/16,DET,@,DEN,W,1,29,5,12,0.417,5,12,0.417,0,0,,0,0,,1,2,3
9702,Ish Smith,28-213,G,2/3/17,DET,,MIN,W,0,21,5,8,0.625,5,7,0.714,0,1,0,0,0,,0,3,3
9703,J.R. Smith,31-190,G-F,3/18/17,CLE,@,LAC,L,1,28,4,17,0.235,4,10,0.4,0,7,0,2,4,0.5,0,6,6
9704,Jason Smith,30-310,F-C,1/6/17,WAS,,MIN,W,0,22,5,8,0.625,5,8,0.625,0,0,,0,0,,0,3,3
9705,Jason Smith,30-303,F-C,12/30/16,WAS,,BRK,W,0,18,5,7,0.714,5,7,0.714,0,0,,0,0,,3,5,8
9706,Tony Snell,25-120,G-F,3/10/17,MIL,,IND,W,1,32,2,5,0.4,1,3,0.333,1,2,0.5,5,5,1,0,1,1
9707,Tony Snell,25-097,G-F,2/15/17,MIL,@,BRK,W,1,33,4,7,0.571,2,2,1,2,5,0.4,0,0,,1,5,6
9708,Tony Snell,25-118,G-F,3/8/17,MIL,,NYK,W,1,38,3,9,0.333,1,6,0.167,2,3,0.667,2,2,1,1,6,7
9709,Tony Snell,25-127,G-F,3/17/17,MIL,@,LAL,W,1,32,3,8,0.375,2,4,0.5,1,4,0.25,3,3,1,0,5,5
9710,Tony Snell,25-123,G-F,3/13/17,MIL,@,MEM,L,1,28,4,7,0.571,2,4,0.5,2,3,0.667,0,0,,1,2,3
9711,Tony Snell,25-023,G-F,12/3/16,MIL,,BRK,W,1,27,4,10,0.4,2,3,0.667,2,7,0.286,0,0,,0,3,3
9712,Tony Snell,25-036,G-F,12/16/16,MIL,@,CHI,W,1,25,4,8,0.5,2,5,0.4,2,3,0.667,0,0,,1,4,5
9713,Marreese Speights,29-229,C-F,3/21/17,LAC,@,LAL,W,0,19,4,8,0.5,2,4,0.5,2,4,0.5,0,0,,3,4,7
9714,Marreese Speights,29-141,C-F,12/23/16,LAC,,DAL,L,0,14,4,7,0.571,2,4,0.5,2,3,0.667,0,0,,1,3,4
9715,Marreese Speights,29-138,C-F,12/20/16,LAC,,DEN,W,0,17,4,5,0.8,2,2,1,2,3,0.667,0,1,0,0,2,2
9716,Nik Stauskas,23-143,G,2/27/17,PHI,,GSW,L,0,24,3,7,0.429,1,3,0.333,2,4,0.5,2,3,0.667,0,3,3
9717,Nik Stauskas,23-065,G,12/11/16,PHI,@,DET,W,0,25,2,3,0.667,1,1,1,1,2,0.5,5,6,0.833,0,2,2
9718,Nik Stauskas,23-047,G,11/23/16,PHI,,MEM,L,0,43,3,12,0.25,1,5,0.2,2,7,0.286,2,2,1,0,5,5
9719,Nik Stauskas,23-084,G,12/30/16,PHI,@,DEN,W,1,29,2,7,0.286,0,2,0,2,5,0.4,4,4,1,0,0,0
9720,Nik Stauskas,23-057,G,12/3/16,PHI,,BOS,L,1,33,3,11,0.273,1,3,0.333,2,8,0.25,2,2,1,0,2,2
9721,Lance Stephenson,26-060,G-F,11/4/16,NOP,,PHO,L,0,28,5,15,0.333,5,11,0.455,0,4,0,0,2,0,0,1,1
9722,Rodney Stuckey,30-237,G,12/14/16,IND,@,MIA,L,0,22,3,12,0.25,2,10,0.2,1,2,0.5,3,4,0.75,0,5,5
9723,Rodney Stuckey,30-295,G,2/10/17,IND,@,WAS,L,0,17,4,10,0.4,4,8,0.5,0,2,0,2,2,1,0,1,1
9724,Jeff Teague,28-271,G,3/8/17,IND,,DET,W,1,24,2,5,0.4,2,4,0.5,0,1,0,6,6,1,1,4,5
9725,Jeff Teague,28-182,G,12/9/16,IND,@,DAL,L,1,31,3,7,0.429,3,7,0.429,0,0,,4,5,0.8,0,3,3
9726,Jeff Teague,28-269,G,3/6/17,IND,@,CHO,L,1,29,4,11,0.364,3,9,0.333,1,2,0.5,1,2,0.5,1,4,5
9727,Jeff Teague,28-187,G,12/14/16,IND,@,MIA,L,1,29,3,9,0.333,2,6,0.333,1,3,0.333,3,3,1,0,3,3
9728,Jeff Teague,28-259,G,2/24/17,IND,,MEM,W,1,31,2,8,0.25,1,5,0.2,1,3,0.333,5,5,1,0,4,4
9729,Mirza Teletovic,31-181,F,3/18/17,MIL,@,GSW,L,0,22,4,8,0.5,4,6,0.667,0,2,0,2,2,1,0,3,3
9730,Mirza Teletovic,31-129,F,1/25/17,MIL,,PHI,L,0,19,3,9,0.333,0,1,0,3,8,0.375,1,2,0.5,0,1,1
9731,Lance Thomas,28-253,F,1/2/17,NYK,,ORL,L,1,20,4,8,0.5,3,6,0.5,1,2,0.5,1,2,0.5,2,1,3
9732,Lance Thomas,28-257,F,1/6/17,NYK,@,MIL,W,0,20,4,4,1,2,2,1,2,2,1,0,0,,1,1,2
9733,Klay Thompson,26-304,G,12/8/16,GSW,@,UTA,W,1,28,5,13,0.385,5,9,0.556,0,4,0,0,0,,2,4,6
9734,Klay Thompson,26-270,G,11/4/16,GSW,@,LAL,L,1,38,4,18,0.222,2,8,0.25,2,10,0.2,0,0,,0,3,3
9735,Tristan Thompson,25-320,F-C,1/27/17,CLE,,BRK,W,1,28,5,5,1,5,5,1,0,0,,0,2,0,2,8,10
9736,Tristan Thompson,25-356,F-C,3/4/17,CLE,@,MIA,L,1,28,4,9,0.444,4,9,0.444,0,0,,2,4,0.5,5,1,6
9737,Tristan Thompson,25-333,F-C,2/9/17,CLE,@,OKC,L,1,32,3,7,0.429,3,7,0.429,0,0,,4,5,0.8,1,4,5
9738,Tristan Thompson,25-299,F-C,1/6/17,CLE,@,BRK,W,1,30,3,3,1,3,3,1,0,0,,4,13,0.308,2,7,9
9739,Tristan Thompson,25-282,F-C,12/20/16,CLE,@,MIL,W,1,26,4,7,0.571,4,7,0.571,0,0,,2,3,0.667,5,7,12
9740,Tristan Thompson,25-347,F-C,2/23/17,CLE,,NYK,W,1,31,5,7,0.714,5,7,0.714,0,0,,0,0,,6,8,14
9741,Marcus Thornton,29-164,G,11/16/16,WAS,@,PHI,L,0,37,4,13,0.308,2,7,0.286,2,6,0.333,0,0,,0,2,2
9742,Marcus Thornton,29-199,G,12/21/16,WAS,@,CHI,W,0,15,5,9,0.556,5,6,0.833,0,3,0,0,0,,1,1,2
9743,Anthony Tolliver,31-244,F-C,1/31/17,SAC,@,HOU,L,0,22,3,4,0.75,1,1,1,2,3,0.667,2,5,0.4,0,3,3
9744,Anthony Tolliver,31-282,F-C,3/10/17,SAC,,WAS,L,0,17,4,5,0.8,2,3,0.667,2,2,1,0,0,,0,3,3
9745,Anthony Tolliver,31-228,F-C,1/15/17,SAC,,OKC,L,1,32,4,6,0.667,2,2,1,2,4,0.5,0,0,,0,4,4
9746,Anthony Tolliver,31-240,F-C,1/27/17,SAC,@,IND,L,0,26,3,5,0.6,1,2,0.5,2,3,0.667,2,2,1,2,3,5
9747,Anthony Tolliver,31-191,F-C,12/9/16,SAC,,NYK,L,0,27,4,9,0.444,2,3,0.667,2,6,0.333,0,0,,1,4,5
9748,Anthony Tolliver,31-290,F-C,3/18/17,SAC,@,OKC,L,0,20,4,7,0.571,2,5,0.4,2,2,1,0,0,,0,2,2
9749,P.J. Tucker,31-248,F,1/8/17,PHO,,CLE,L,0,28,4,6,0.667,4,4,1,0,2,0,2,2,1,0,4,4
9750,P.J. Tucker,31-230,F,12/21/16,PHO,,HOU,L,1,31,4,6,0.667,2,3,0.667,2,3,0.667,0,0,,3,3,6
9751,P.J. Tucker,31-272,F,2/1/17,PHO,,LAC,L,0,34,3,9,0.333,1,6,0.167,2,3,0.667,2,2,1,4,10,14
9752,P.J. Tucker,31-202,F,11/23/16,PHO,@,ORL,W,0,27,4,9,0.444,2,5,0.4,2,4,0.5,0,0,,1,6,7
9753,Evan Turner,28-039,G,12/5/16,POR,@,CHI,W,0,29,5,6,0.833,5,5,1,0,1,0,0,0,,0,2,2
9754,Myles Turner,20-319,F-C,2/6/17,IND,,OKC,W,1,36,3,12,0.25,3,10,0.3,0,2,0,4,7,0.571,3,2,5
9755,Myles Turner,20-273,F-C,12/22/16,IND,,BOS,L,1,30,5,11,0.455,5,10,0.5,0,1,0,0,0,,1,6,7
9756,Myles Turner,20-323,F-C,2/10/17,IND,@,WAS,L,1,31,4,9,0.444,4,8,0.5,0,1,0,2,2,1,2,5,7
9757,Myles Turner,20-268,F-C,12/17/16,IND,@,DET,W,1,28,3,7,0.429,2,6,0.333,1,1,1,3,4,0.75,1,4,5
9758,Beno Udrih,34-120,G,11/2/16,DET,@,BRK,L,0,17,4,9,0.444,4,8,0.5,0,1,0,2,2,1,1,0,1
9759,Beno Udrih,34-132,G,11/14/16,DET,,OKC,W,0,18,5,7,0.714,5,6,0.833,0,1,0,0,0,,0,4,4
9760,Tyler Ulis,21-066,G,3/12/17,PHO,,POR,L,0,19,5,8,0.625,5,7,0.714,0,1,0,0,0,,1,1,2
9761,Tyler Ulis,20-318,G,11/18/16,PHO,@,IND,W,0,14,4,8,0.5,4,6,0.667,0,2,0,2,2,1,0,0,0
9762,Tyler Ulis,20-359,G,12/29/16,PHO,,TOR,W,0,15,4,6,0.667,2,4,0.5,2,2,1,0,0,,0,2,2
9763,Jonas Valanciunas,24-315,C,3/17/17,TOR,@,DET,W,1,24,5,7,0.714,5,7,0.714,0,0,,0,0,,2,6,8
9764,Jonas Valanciunas,24-175,C,10/28/16,TOR,,CLE,L,1,31,5,15,0.333,5,15,0.333,0,0,,0,0,,6,11,17
9765,Jonas Valanciunas,24-297,C,2/27/17,TOR,@,NYK,W,1,19,4,4,1,4,4,1,0,0,,2,2,1,1,4,5
9766,Jonas Valanciunas,24-228,C,12/20/16,TOR,,BRK,W,1,22,3,8,0.375,3,8,0.375,0,0,,4,4,1,3,11,14
9767,Jonas Valanciunas,24-257,C,1/18/17,TOR,@,PHI,L,1,30,5,11,0.455,5,11,0.455,0,0,,0,0,,5,10,15
9768,Jonas Valanciunas,24-309,C,3/11/17,TOR,@,MIA,L,1,21,5,6,0.833,5,6,0.833,0,0,,0,0,,4,6,10
9769,Jonas Valanciunas,24-285,C,2/15/17,TOR,,CHO,W,1,20,4,6,0.667,4,6,0.667,0,0,,2,2,1,1,9,10
9770,Jonas Valanciunas,24-180,C,11/2/16,TOR,@,WAS,W,1,31,4,6,0.667,4,6,0.667,0,0,,2,2,1,0,7,7
9771,Fred VanVleet,22-346,G,2/5/17,TOR,@,BRK,W,0,20,2,10,0.2,2,7,0.286,0,3,0,6,6,1,0,3,3
9772,Fred VanVleet,22-327,G,1/17/17,TOR,@,BRK,W,0,25,4,6,0.667,2,3,0.667,2,3,0.667,0,2,0,0,4,4
9773,Rashad Vaughn,20-207,G,3/11/17,MIL,,MIN,W,0,23,5,9,0.556,5,7,0.714,0,2,0,0,0,,0,1,1
9774,Noah Vonleh,21-149,F,1/20/17,POR,@,PHI,L,1,26,4,6,0.667,3,5,0.6,1,1,1,1,3,0.333,1,4,5
9775,Noah Vonleh,21-206,F,3/18/17,POR,@,ATL,W,1,27,4,7,0.571,4,7,0.571,0,0,,2,3,0.667,3,8,11
9776,Noah Vonleh,21-145,F,1/16/17,POR,@,WAS,L,0,20,4,5,0.8,4,5,0.8,0,0,,2,5,0.4,2,6,8
9777,Nikola Vucevic,26-086,C,1/18/17,ORL,@,NOP,L,1,26,4,9,0.444,4,9,0.444,0,0,,2,2,1,0,8,8
9778,Nikola Vucevic,26-143,C,3/16/17,ORL,@,GSW,L,1,25,4,12,0.333,4,10,0.4,0,2,0,2,3,0.667,2,6,8
9779,Nikola Vucevic,26-043,C,12/6/16,ORL,@,WAS,W,0,25,4,9,0.444,4,7,0.571,0,2,0,2,2,1,3,7,10
9780,Nikola Vucevic,26-010,C,11/3/16,ORL,,SAC,W,1,29,4,11,0.364,4,11,0.364,0,0,,2,6,0.333,4,5,9
9781,Nikola Vucevic,26-023,C,11/16/16,ORL,,NOP,W,1,27,5,12,0.417,5,12,0.417,0,0,,0,2,0,3,11,14
9782,Nikola Vucevic,26-059,C,12/22/16,ORL,@,NYK,L,0,27,4,11,0.364,4,10,0.4,0,1,0,2,4,0.5,3,2,5
9783,Nikola Vucevic,26-055,C,12/18/16,ORL,,TOR,L,0,25,5,12,0.417,5,12,0.417,0,0,,0,0,,5,4,9
9784,Nikola Vucevic,26-072,C,1/4/17,ORL,,ATL,L,0,30,5,13,0.385,5,12,0.417,0,1,0,0,0,,0,6,6
9785,Dwyane Wade,34-353,G,1/4/17,CHI,@,CLE,W,1,27,3,9,0.333,0,5,0,3,4,0.75,1,2,0.5,1,3,4
9786,Dwyane Wade,35-046,G,3/4/17,CHI,,LAC,L,1,33,2,11,0.182,1,10,0.1,1,1,1,5,6,0.833,1,5,6
9787,Kemba Walker,26-279,G,2/11/17,CHO,,LAC,L,1,42,4,17,0.235,3,8,0.375,1,9,0.111,1,2,0.5,1,3,4
9788,Taurean Waller-Prince,22-245,F,11/22/16,ATL,,NOP,L,0,17,4,6,0.667,2,2,1,2,4,0.5,0,0,,0,1,1
9789,Taurean Waller-Prince,22-302,F,1/18/17,ATL,@,DET,L,0,20,2,5,0.4,2,4,0.5,0,1,0,6,6,1,0,2,2
9790,T.J. Warren,23-152,F,2/4/17,PHO,,MIL,L,1,37,5,18,0.278,5,13,0.385,0,5,0,0,0,,3,3,6
9791,T.J. Warren,23-188,F,3/12/17,PHO,,POR,L,1,34,4,10,0.4,4,8,0.5,0,2,0,2,2,1,1,5,6
9792,C.J. Watson,32-300,G,2/11/17,ORL,@,DAL,L,1,29,3,7,0.429,2,5,0.4,1,2,0.5,3,4,0.75,0,2,2
9793,David West,36-096,F,12/3/16,GSW,,PHO,W,0,13,5,6,0.833,5,6,0.833,0,0,,0,0,,0,2,2
9794,David West,36-189,F,3/6/17,GSW,@,ATL,W,0,13,5,7,0.714,5,7,0.714,0,0,,0,0,,0,3,3
9795,David West,36-115,F,12/22/16,GSW,@,BRK,W,0,16,4,5,0.8,4,5,0.8,0,0,,2,2,1,1,5,6
9796,Okaro White,24-181,F,2/10/17,MIA,@,BRK,W,0,31,2,6,0.333,1,4,0.25,1,2,0.5,5,6,0.833,4,1,5
9797,Okaro White,24-165,F,1/25/17,MIA,@,BRK,W,0,27,3,4,0.75,1,1,1,2,3,0.667,2,2,1,0,7,7
9798,Isaiah Whitehead,22-004,G,3/12/17,BRK,,NYK,W,0,26,4,10,0.4,2,5,0.4,2,5,0.4,0,0,,0,3,3
9799,Isaiah Whitehead,21-326,G,1/28/17,BRK,@,MIN,L,0,27,3,9,0.333,3,7,0.429,0,2,0,4,4,1,0,2,2
9800,Isaiah Whitehead,22-011,G,3/19/17,BRK,,DAL,L,0,23,3,7,0.429,2,3,0.667,1,4,0.25,3,6,0.5,1,1,2
9801,Isaiah Whitehead,21-326,G,1/28/17,BRK,@,MIN,L,0,27,3,9,0.333,3,7,0.429,0,2,0,4,4,1,0,2,2
9802,Hassan Whiteside,27-193,C,12/23/16,MIA,@,NOP,L,1,36,4,10,0.4,4,10,0.4,0,0,,2,6,0.333,7,11,18
9803,Hassan Whiteside,27-268,C,3/8/17,MIA,,CHO,W,1,35,4,7,0.571,4,7,0.571,0,0,,2,3,0.667,5,10,15
9804,Hassan Whiteside,27-224,C,1/23/17,MIA,,GSW,W,1,36,4,13,0.308,4,13,0.308,0,0,,2,5,0.4,4,11,15
9805,Andrew Wiggins,21-329,F-G,1/17/17,MIN,@,SAS,L,1,38,3,8,0.375,3,7,0.429,0,1,0,4,6,0.667,0,3,3
9806,Alan Williams,24-042,F-C,3/11/17,PHO,@,DAL,W,0,26,5,7,0.714,5,7,0.714,0,0,,0,0,,0,5,5
9807,Deron Williams,32-258,G,3/11/17,CLE,@,ORL,W,0,25,4,9,0.444,2,5,0.4,2,4,0.5,0,0,,0,1,1
9808,Deron Williams,32-251,G,3/4/17,CLE,@,MIA,L,1,27,4,11,0.364,4,7,0.571,0,4,0,2,2,1,0,5,5
9809,Derrick Williams,25-274,F,2/23/17,CLE,,NYK,W,0,27,4,8,0.5,2,3,0.667,2,5,0.4,0,0,,0,1,1
9810,Derrick Williams,25-283,F,3/4/17,CLE,@,MIA,L,0,29,2,5,0.4,1,3,0.333,1,2,0.5,5,6,0.833,1,5,6
9811,Derrick Williams,25-221,F,1/1/17,MIA,,DET,L,0,13,4,6,0.667,3,4,0.75,1,2,0.5,1,2,0.5,0,6,6
9812,Derrick Williams,25-199,F,12/10/16,MIA,@,CHI,L,0,25,3,9,0.333,3,8,0.375,0,1,0,4,6,0.667,3,5,8
9813,Lou Williams,30-063,G,12/29/16,LAL,,DAL,L,0,21,3,7,0.429,3,5,0.6,0,2,0,4,5,0.8,0,1,1
9814,Lou Williams,30-077,G,1/12/17,LAL,@,SAS,L,0,18,2,7,0.286,1,3,0.333,1,4,0.25,5,6,0.833,1,1,2
9815,Lou Williams,30-075,G,1/10/17,LAL,,POR,L,0,16,4,10,0.4,2,7,0.286,2,3,0.667,0,0,,0,0,0
9816,Lou Williams,30-073,G,1/8/17,LAL,,ORL,W,0,17,3,12,0.25,3,5,0.6,0,7,0,4,4,1,0,1,1
9817,Lou Williams,30-070,G,1/5/17,LAL,@,POR,L,0,24,3,8,0.375,2,6,0.333,1,2,0.5,3,4,0.75,0,3,3
9818,Marvin Williams,30-157,F,11/23/16,CHO,,SAS,L,1,29,4,6,0.667,2,3,0.667,2,3,0.667,0,0,,2,3,5
9819,Marvin Williams,30-215,F,1/20/17,CHO,,TOR,W,1,21,3,6,0.5,1,2,0.5,2,4,0.5,2,2,1,0,8,8
9820,Marvin Williams,30-195,F,12/31/16,CHO,,CLE,L,1,28,4,12,0.333,2,7,0.286,2,5,0.4,0,0,,0,4,4
9821,Marvin Williams,30-226,F,1/31/17,CHO,@,POR,L,1,33,3,9,0.333,2,2,1,1,7,0.143,3,3,1,0,5,5
9822,Marvin Williams,30-145,F,11/11/16,CHO,,TOR,L,1,35,3,15,0.2,0,5,0,3,10,0.3,1,2,0.5,3,10,13
9823,Troy Williams,21-336,F,11/30/16,MEM,@,TOR,L,1,28,4,10,0.4,4,6,0.667,0,4,0,2,3,0.667,0,0,0
9824,Justise Winslow,20-216,F,10/28/16,MIA,,CHO,L,1,32,4,14,0.286,3,8,0.375,1,6,0.167,1,2,0.5,0,6,6
9825,Brandan Wright,29-157,F-C,3/11/17,MEM,,ATL,L,0,13,4,6,0.667,4,6,0.667,0,0,,2,2,1,0,4,4
9826,Brandan Wright,29-162,F-C,3/16/17,MEM,@,ATL,W,0,14,3,4,0.75,3,4,0.75,0,0,,4,4,1,3,0,3
9827,Delon Wright,24-324,G,3/16/17,TOR,,OKC,L,0,20,2,6,0.333,2,5,0.4,0,1,0,6,7,0.857,0,2,2
9828,James Young,21-183,G-F,2/15/17,BOS,,PHI,W,0,22,4,7,0.571,3,5,0.6,1,2,0.5,1,1,1,1,2,3
9829,James Young,21-179,G-F,2/11/17,BOS,@,UTA,W,0,15,4,7,0.571,2,2,1,2,5,0.4,0,1,0,0,0,0
9830,Nick Young,31-258,G-F,2/14/17,LAL,,SAC,L,1,30,3,10,0.3,0,2,0,3,8,0.375,1,2,0.5,0,1,1
9831,Thaddeus Young,28-194,F,1/1/17,IND,,ORL,W,1,32,4,12,0.333,2,8,0.25,2,4,0.5,0,0,,1,2,3
9832,Thaddeus Young,28-130,F,10/29/16,IND,@,CHI,L,1,27,5,8,0.625,5,6,0.833,0,2,0,0,0,,1,4,5
9833,Thaddeus Young,28-144,F,11/12/16,IND,,BOS,L,1,24,5,8,0.625,5,6,0.833,0,2,0,0,2,0,4,4,8
9834,Thaddeus Young,28-248,F,2/24/17,IND,,MEM,W,1,26,5,7,0.714,5,7,0.714,0,0,,0,0,,0,5,5
9835,Thaddeus Young,28-227,F,2/3/17,IND,@,BRK,W,1,22,5,9,0.556,5,9,0.556,0,0,,0,0,,4,5,9
9836,Thaddeus Young,28-262,F,3/10/17,IND,@,MIL,L,1,19,5,8,0.625,5,8,0.625,0,0,,0,1,0,1,2,3
9837,Thaddeus Young,28-167,F,12/5/16,IND,@,GSW,L,1,23,5,10,0.5,5,8,0.625,0,2,0,0,0,,1,1,2
9838,Thaddeus Young,28-198,F,1/5/17,IND,,BRK,W,1,32,3,10,0.3,2,7,0.286,1,3,0.333,3,4,0.75,0,6,6
9839,Cody Zeller,24-030,F-C,11/4/16,CHO,@,BRK,W,1,21,3,7,0.429,3,7,0.429,0,0,,4,5,0.8,2,4,6
9840,Cody Zeller,24-084,F-C,12/28/16,CHO,@,ORL,W,1,24,4,6,0.667,4,6,0.667,0,0,,2,2,1,3,2,5
9841,Cody Zeller,24-023,F-C,10/28/16,CHO,@,MIA,W,0,23,4,8,0.5,4,8,0.5,0,0,,2,3,0.667,2,1,3
9842,Tyler Zeller,26-316,F-C,11/28/16,BOS,@,MIA,W,1,25,4,7,0.571,4,7,0.571,0,0,,2,2,1,3,4,7
9843,Tyler Zeller,27-010,F-C,1/27/17,BOS,,ORL,W,0,20,5,9,0.556,5,9,0.556,0,0,,0,0,,1,2,3
9844,Paul Zipser,22-337,G-F,1/20/17,CHI,@,ATL,L,0,15,3,7,0.429,2,4,0.5,1,3,0.333,3,3,1,0,1,1
9845,Paul Zipser,23-014,G-F,3/4/17,CHI,,LAC,L,0,18,4,6,0.667,3,4,0.75,1,2,0.5,1,2,0.5,0,2,2
9846,Ivica Zubac,19-359,C,3/12/17,LAL,,PHI,L,1,19,4,5,0.8,4,5,0.8,0,0,,2,3,0.667,0,6,6
9847,Ivica Zubac,19-325,C,2/6/17,LAL,@,NYK,W,0,17,5,9,0.556,5,9,0.556,0,0,,0,0,,2,5,7
9848,Ivica Zubac,20-001,C,3/19/17,LAL,,CLE,L,1,19,4,7,0.571,4,7,0.571,0,0,,2,2,1,2,4,6
9849,Alex Abrines,23-140,G-F,12/19/16,OKC,,ATL,L,0,17,3,8,0.375,2,3,0.667,1,5,0.2,2,2,1,0,1,1
9850,Quincy Acy,26-099,F,1/13/17,BRK,@,TOR,L,0,5,3,3,1,2,2,1,1,1,1,2,2,1,1,1,2
9851,Quincy Acy,26-161,F,3/16/17,BRK,@,NYK,W,0,23,3,6,0.5,2,4,0.5,1,2,0.5,2,3,0.667,1,4,5
9852,Steven Adams,23-100,C,10/28/16,OKC,,PHO,W,1,40,3,8,0.375,3,8,0.375,0,0,,3,3,1,6,4,10
9853,Steven Adams,23-208,C,2/13/17,OKC,@,WAS,L,1,19,2,7,0.286,2,7,0.286,0,0,,5,6,0.833,7,4,11
9854,Steven Adams,23-226,C,3/3/17,OKC,@,PHO,L,1,30,3,4,0.75,3,4,0.75,0,0,,3,6,0.5,3,7,10
9855,Steven Adams,23-243,C,3/20/17,OKC,,GSW,L,1,22,4,5,0.8,4,5,0.8,0,0,,1,4,0.25,1,0,1
9856,Steven Adams,23-187,C,1/23/17,OKC,@,UTA,W,1,37,4,10,0.4,4,10,0.4,0,0,,1,2,0.5,3,3,6
9857,Arron Afflalo,31-116,G,2/8/17,SAC,,BOS,W,1,34,3,9,0.333,3,7,0.429,0,2,0,3,4,0.75,0,3,3
9858,Arron Afflalo,31-098,G,1/21/17,SAC,@,CHI,L,1,35,3,9,0.333,0,5,0,3,4,0.75,0,0,,1,0,1
9859,Arron Afflalo,31-016,G,10/31/16,SAC,@,ATL,L,1,25,3,3,1,3,3,1,0,0,,3,3,1,0,2,2
9860,Arron Afflalo,31-108,G,1/31/17,SAC,@,HOU,L,1,27,3,9,0.333,2,5,0.4,1,4,0.25,2,3,0.667,0,1,1
9861,Arron Afflalo,31-026,G,11/10/16,SAC,,LAL,L,1,31,3,10,0.3,2,8,0.25,1,2,0.5,2,2,1,0,6,6
9862,Alexis Ajinca,28-306,C,3/8/17,NOP,,TOR,L,0,9,4,4,1,4,4,1,0,0,,1,1,1,1,1,2
9863,Alexis Ajinca,28-213,C,12/5/16,NOP,,MEM,L,0,21,4,6,0.667,4,5,0.8,0,1,0,1,1,1,1,5,6
9864,Tony Allen,34-347,G-F,12/23/16,MEM,,HOU,W,1,29,3,5,0.6,2,4,0.5,1,1,1,2,4,0.5,2,2,4
9865,Tony Allen,35-057,G-F,3/9/17,MEM,,LAC,L,0,24,4,8,0.5,4,8,0.5,0,0,,1,2,0.5,0,2,2
9866,Tony Allen,34-317,G-F,11/23/16,MEM,@,PHI,W,1,23,4,10,0.4,4,10,0.4,0,0,,1,1,1,1,2,3
9867,Tony Allen,34-330,G-F,12/6/16,MEM,,PHI,W,1,27,4,7,0.571,4,7,0.571,0,0,,1,2,0.5,0,4,4
9868,Tony Allen,35-026,G-F,2/6/17,MEM,,SAS,W,1,21,4,6,0.667,4,6,0.667,0,0,,1,2,0.5,1,5,6
9869,Tony Allen,34-342,G-F,12/18/16,MEM,,UTA,L,1,34,4,7,0.571,4,7,0.571,0,0,,1,1,1,4,4,8
9870,Tony Allen,34-325,G-F,12/1/16,MEM,,ORL,W,1,27,4,11,0.364,4,10,0.4,0,1,0,1,2,0.5,4,2,6
9871,Tony Allen,34-322,G-F,11/28/16,MEM,,CHO,L,1,21,4,8,0.5,4,8,0.5,0,0,,1,1,1,2,2,4
9872,Al-Farouq Aminu,26-172,F,3/12/17,POR,@,PHO,W,0,30,3,8,0.375,2,6,0.333,1,2,0.5,2,3,0.667,0,12,12
9873,Al-Farouq Aminu,26-121,F,1/20/17,POR,@,PHI,L,0,22,3,6,0.5,2,5,0.4,1,1,1,2,2,1,1,8,9
9874,Al-Farouq Aminu,26-034,F,10/25/16,POR,,UTA,W,1,28,3,6,0.5,1,3,0.333,2,3,0.667,1,1,1,0,4,4
9875,Alan Anderson,34-151,G-F,3/16/17,LAC,@,DEN,L,0,17,3,3,1,2,2,1,1,1,1,2,3,0.667,0,0,0
9876,Justin Anderson,23-037,G,12/26/16,DAL,@,NOP,L,0,13,4,6,0.667,3,4,0.75,1,2,0.5,0,0,,1,1,2
9877,Justin Anderson,23-000,G,11/19/16,DAL,@,ORL,L,0,23,3,8,0.375,2,5,0.4,1,3,0.333,2,3,0.667,0,0,0
9878,Justin Anderson,22-344,G,10/28/16,DAL,,HOU,L,0,20,2,5,0.4,1,2,0.5,1,3,0.333,4,6,0.667,1,2,3
9879,Justin Anderson,23-084,G,2/11/17,DAL,,ORL,W,0,17,3,5,0.6,3,3,1,0,2,0,3,4,0.75,0,3,3
9880,Justin Anderson,23-025,G,12/14/16,DAL,,DET,L,0,13,3,7,0.429,1,4,0.25,2,3,0.667,1,2,0.5,0,5,5
9881,Kyle Anderson,23-139,F-G,2/6/17,SAS,@,MEM,L,0,22,4,8,0.5,4,8,0.5,0,0,,1,4,0.25,2,3,5
9882,Kyle Anderson,23-159,F-G,2/26/17,SAS,@,LAL,W,0,14,4,8,0.5,3,7,0.429,1,1,1,0,0,,1,2,3
9883,Kyle Anderson,23-169,F-G,3/8/17,SAS,,SAC,W,0,24,4,8,0.5,3,6,0.5,1,2,0.5,0,0,,1,3,4
9884,Ryan Anderson,28-247,F,1/8/17,HOU,@,TOR,W,1,32,2,8,0.25,1,3,0.333,1,5,0.2,4,4,1,2,2,4
9885,Giannis Antetokounmpo,22-102,F-G,3/18/17,MIL,@,GSW,L,1,31,4,14,0.286,4,13,0.308,0,1,0,1,2,0.5,1,2,3
9886,Giannis Antetokounmpo,22-083,F-G,2/27/17,MIL,@,CLE,L,1,42,4,13,0.308,4,11,0.364,0,2,0,1,4,0.25,0,7,7
9887,Giannis Antetokounmpo,22-057,F-G,2/1/17,MIL,@,UTA,L,1,39,2,10,0.2,2,8,0.25,0,2,0,5,6,0.833,2,4,6
9888,Trevor Ariza,31-238,F,2/23/17,HOU,@,NOP,W,1,27,3,10,0.3,0,2,0,3,8,0.375,0,0,,1,6,7
9889,Trevor Ariza,31-180,F,12/27/16,HOU,@,DAL,W,1,30,3,5,0.6,0,1,0,3,4,0.75,0,0,,0,7,7
9890,Trevor Ariza,31-226,F,2/11/17,HOU,,PHO,W,1,31,4,13,0.308,3,8,0.375,1,5,0.2,0,0,,1,8,9
9891,Trevor Ariza,31-132,F,11/9/16,HOU,@,SAS,W,1,41,4,8,0.5,3,3,1,1,5,0.2,0,0,,0,5,5
9892,D.J. Augustin,29-091,G,2/9/17,ORL,,PHI,L,0,24,3,5,0.6,1,2,0.5,2,3,0.667,1,2,0.5,0,3,3
9893,D.J. Augustin,29-126,G,3/16/17,ORL,@,GSW,L,0,20,2,9,0.222,2,5,0.4,0,4,0,5,5,1,0,1,1
9894,D.J. Augustin,29-022,G,12/2/16,ORL,@,PHI,W,1,22,3,6,0.5,0,2,0,3,4,0.75,0,0,,0,3,3
9895,D.J. Augustin,28-357,G,11/1/16,ORL,@,PHI,W,0,13,4,10,0.4,3,4,0.75,1,6,0.167,0,0,,0,0,0
9896,Luke Babbitt,27-240,F,2/15/17,MIA,@,HOU,W,1,17,3,4,0.75,0,0,,3,4,0.75,0,0,,0,0,0
9897,Luke Babbitt,27-222,F,1/28/17,MIA,,DET,W,1,13,3,3,1,0,0,,3,3,1,0,0,,1,2,3
9898,Luke Babbitt,27-257,F,3/4/17,MIA,,CLE,W,1,14,3,4,0.75,0,0,,3,4,0.75,0,0,,0,0,0
9899,Luke Babbitt,27-198,F,1/4/17,MIA,@,SAC,W,1,17,3,4,0.75,0,1,0,3,3,1,0,0,,0,4,4
9900,Luke Babbitt,27-254,F,3/1/17,MIA,,PHI,W,1,23,3,5,0.6,0,0,,3,5,0.6,0,0,,0,4,4
9901,Luke Babbitt,27-198,F,1/4/17,MIA,@,SAC,W,1,17,3,4,0.75,0,1,0,3,3,1,0,0,,0,4,4
9902,Ron Baker,23-340,G,3/5/17,NYK,,GSW,L,0,23,3,7,0.429,2,4,0.5,1,3,0.333,2,4,0.5,1,4,5
9903,Leandro Barbosa,34-065,G,2/1/17,PHO,,LAC,L,0,20,3,9,0.333,3,9,0.333,0,0,,3,4,0.75,1,2,3
9904,Leandro Barbosa,34-061,G,1/28/17,PHO,,DEN,L,0,16,4,6,0.667,3,5,0.6,1,1,1,0,0,,0,2,2
9905,Leandro Barbosa,33-338,G,10/31/16,PHO,@,LAC,L,0,13,4,5,0.8,3,3,1,1,2,0.5,0,0,,0,2,2
9906,J.J. Barea,32-129,G,11/2/16,DAL,@,UTA,L,0,27,3,9,0.333,2,5,0.4,1,4,0.25,2,2,1,1,4,5
9907,J.J. Barea,32-257,G,3/10/17,DAL,,BRK,W,0,14,3,6,0.5,2,3,0.667,1,3,0.333,2,2,1,0,1,1
9908,J.J. Barea,32-143,G,11/16/16,DAL,@,BOS,L,0,28,4,11,0.364,3,8,0.375,1,3,0.333,0,0,,0,2,2
9909,Matt Barnes,36-280,F,12/14/16,SAC,@,HOU,L,0,21,3,5,0.6,0,1,0,3,4,0.75,0,0,,0,2,2
9910,Will Barton,26-028,G,2/3/17,DEN,,MIL,W,0,25,3,10,0.3,2,6,0.333,1,4,0.25,2,4,0.5,0,2,2
9911,Will Barton,26-006,G,1/12/17,DEN,,IND,W,0,24,3,10,0.3,2,8,0.25,1,2,0.5,2,2,1,3,4,7
9912,Will Barton,26-059,G,3/6/17,DEN,,SAC,W,0,27,3,9,0.333,1,3,0.333,2,6,0.333,1,2,0.5,1,1,2
9913,Will Barton,26-057,G,3/4/17,DEN,,CHO,L,0,31,3,11,0.273,2,7,0.286,1,4,0.25,2,2,1,1,3,4
9914,Brandon Bass,31-273,F,1/28/17,LAC,@,GSW,L,0,15,4,6,0.667,4,6,0.667,0,0,,1,2,0.5,2,3,5
9915,Brandon Bass,31-299,F,2/23/17,LAC,@,GSW,L,0,13,3,5,0.6,3,5,0.6,0,0,,3,4,0.75,1,3,4
9916,Nicolas Batum,27-329,F-G,11/7/16,CHO,,IND,W,1,30,2,6,0.333,1,4,0.25,1,2,0.5,4,4,1,0,6,6
9917,Nicolas Batum,28-022,F-G,1/5/17,CHO,@,DET,L,1,25,1,8,0.125,1,6,0.167,0,2,0,7,7,1,0,4,4
9918,Nicolas Batum,27-317,F-G,10/26/16,CHO,@,MIL,W,1,34,2,9,0.222,1,2,0.5,1,7,0.143,4,5,0.8,0,6,6
9919,Nicolas Batum,27-331,F-G,11/9/16,CHO,,UTA,W,1,34,3,10,0.3,3,5,0.6,0,5,0,3,5,0.6,0,2,2
9920,Nicolas Batum,27-362,F-G,12/10/16,CHO,@,CLE,L,1,33,4,12,0.333,4,8,0.5,0,4,0,1,2,0.5,0,6,6
9921,Aron Baynes,30-081,C,2/28/17,DET,,POR,W,0,23,3,4,0.75,3,4,0.75,0,0,,3,5,0.6,1,5,6
9922,Aron Baynes,30-043,C,1/21/17,DET,,WAS,W,0,16,3,4,0.75,3,4,0.75,0,0,,3,3,1,1,2,3
9923,Kent Bazemore,27-173,G-F,12/21/16,ATL,,MIN,L,1,33,3,9,0.333,2,7,0.286,1,2,0.5,2,4,0.5,0,4,4
9924,Kent Bazemore,27-239,G-F,2/25/17,ATL,@,ORL,L,1,24,4,9,0.444,3,7,0.429,1,2,0.5,0,0,,1,3,4
9925,Michael Beasley,27-315,F,11/19/16,MIL,,GSW,L,0,20,4,9,0.444,3,8,0.375,1,1,1,0,2,0,2,1,3
9926,Michael Beasley,27-306,F,11/10/16,MIL,,NOP,L,0,12,3,6,0.5,2,5,0.4,1,1,1,2,2,1,0,4,4
9927,Marco Belinelli,30-233,G-F,11/13/16,CHO,@,CLE,L,0,21,3,7,0.429,0,3,0,3,4,0.75,0,0,,0,1,1
9928,DeAndre' Bembry,22-172,F,12/23/16,ATL,@,DEN,W,0,19,4,6,0.667,4,5,0.8,0,1,0,1,1,1,2,2,4
9929,Anthony Bennett,23-229,F,10/29/16,BRK,@,MIL,L,0,18,3,9,0.333,1,4,0.25,2,5,0.4,1,2,0.5,0,1,1
9930,Davis Bertans,24-088,F,2/8/17,SAS,@,PHI,W,0,15,3,5,0.6,1,1,1,2,4,0.5,1,2,0.5,0,1,1
9931,Patrick Beverley,28-146,G,12/5/16,HOU,,BOS,W,1,32,4,8,0.5,3,5,0.6,1,3,0.333,0,0,,1,4,5
9932,Patrick Beverley,28-206,G,2/3/17,HOU,,CHI,W,1,32,3,8,0.375,1,3,0.333,2,5,0.4,1,1,1,0,7,7
9933,Patrick Beverley,28-205,G,2/2/17,HOU,,ATL,L,1,31,3,8,0.375,1,2,0.5,2,6,0.333,1,2,0.5,0,6,6
9934,Patrick Beverley,28-246,G,3/15/17,HOU,,LAL,W,1,27,1,5,0.2,0,1,0,1,4,0.25,6,6,1,0,4,4
9935,Patrick Beverley,28-132,G,11/21/16,HOU,@,DET,W,1,23,4,7,0.571,3,5,0.6,1,2,0.5,0,0,,1,0,1
9936,Bismack Biyombo,24-093,C-F,11/29/16,ORL,@,SAS,W,1,34,3,11,0.273,3,11,0.273,0,0,,3,4,0.75,0,6,6
9937,Bismack Biyombo,24-103,C-F,12/9/16,ORL,@,CHO,L,1,16,4,5,0.8,4,5,0.8,0,0,,1,3,0.333,1,2,3
9938,Bismack Biyombo,24-116,C-F,12/22/16,ORL,@,NYK,L,1,27,3,6,0.5,3,6,0.5,0,0,,3,4,0.75,1,5,6
9939,Bismack Biyombo,24-165,C-F,2/9/17,ORL,,PHI,L,0,17,3,3,1,3,3,1,0,0,,3,4,0.75,1,7,8
9940,Bismack Biyombo,24-069,C-F,11/5/16,ORL,,WAS,W,0,24,4,6,0.667,4,6,0.667,0,0,,1,4,0.25,3,9,12
9941,Bismack Biyombo,24-078,C-F,11/14/16,ORL,@,IND,L,0,21,4,4,1,4,4,1,0,0,,1,2,0.5,3,6,9
9942,Bismack Biyombo,24-108,C-F,12/14/16,ORL,,LAC,L,1,34,4,7,0.571,4,7,0.571,0,0,,1,7,0.143,4,8,12
9943,Bismack Biyombo,24-126,C-F,1/1/17,ORL,@,IND,L,1,23,4,6,0.667,4,6,0.667,0,0,,1,1,1,2,4,6
9944,Nemanja Bjelica,28-213,F,12/8/16,MIN,@,TOR,L,0,13,3,5,0.6,1,1,1,2,4,0.5,1,2,0.5,0,4,4
9945,Tarik Black,25-076,C-F,2/6/17,LAL,@,NYK,W,1,20,4,8,0.5,4,8,0.5,0,0,,1,2,0.5,6,4,10
9946,Tarik Black,25-040,C-F,1/1/17,LAL,,TOR,L,0,14,2,6,0.333,2,6,0.333,0,0,,5,5,1,3,6,9
9947,Tarik Black,25-001,C-F,11/23/16,LAL,@,GSW,L,0,15,2,9,0.222,2,8,0.25,0,1,0,5,6,0.833,1,4,5
9948,Tarik Black,25-107,C-F,3/9/17,LAL,@,PHO,W,1,14,3,3,1,3,3,1,0,0,,3,4,0.75,4,2,6
9949,Tarik Black,25-007,C-F,11/29/16,LAL,@,NOP,L,0,24,4,6,0.667,4,6,0.667,0,0,,1,2,0.5,2,3,5
9950,Devin Booker,20-121,G,2/28/17,PHO,@,MEM,L,1,36,3,11,0.273,1,6,0.167,2,5,0.4,1,1,1,0,3,3
9951,Trevor Booker,29-015,F,12/10/16,BRK,@,SAS,L,1,27,4,6,0.667,4,5,0.8,0,1,0,1,1,1,0,4,4
9952,Trevor Booker,29-006,F,12/1/16,BRK,,MIL,L,1,27,4,7,0.571,4,7,0.571,0,0,,1,1,1,5,3,8
9953,Trevor Booker,29-059,F,1/23/17,BRK,,SAS,L,1,19,4,7,0.571,4,5,0.8,0,2,0,1,1,1,0,4,4
9954,Corey Brewer,30-343,F-G,2/11/17,HOU,,PHO,W,0,27,4,8,0.5,3,5,0.6,1,3,0.333,0,0,,0,1,1
9955,Corey Brewer,30-312,F-G,1/11/17,HOU,@,MIN,L,0,27,4,9,0.444,3,7,0.429,1,2,0.5,0,0,,1,1,2
9956,Corey Brewer,31-002,F-G,3/7/17,LAL,@,DAL,L,0,13,4,7,0.571,3,5,0.6,1,2,0.5,0,0,,0,2,2
9957,Corey Brewer,30-335,F-G,2/3/17,HOU,,CHI,W,0,12,4,5,0.8,4,5,0.8,0,0,,1,2,0.5,1,1,2
9958,Corey Brewer,31-014,F-G,3/19/17,LAL,,CLE,L,0,19,4,8,0.5,4,6,0.667,0,2,0,1,1,1,2,7,9
9959,Corey Brewer,30-277,F-G,12/7/16,HOU,,LAL,W,0,21,4,9,0.444,4,7,0.571,0,2,0,1,1,1,0,1,1
9960,Corey Brewer,30-241,F-G,11/1/16,HOU,@,CLE,L,0,21,4,7,0.571,4,6,0.667,0,1,0,1,2,0.5,1,2,3
9961,Corey Brewer,30-257,F-G,11/17/16,HOU,,POR,W,0,18,4,8,0.5,4,7,0.571,0,1,0,1,1,1,1,2,3
9962,Corey Brewer,30-256,F-G,11/16/16,HOU,@,OKC,L,0,17,4,6,0.667,3,4,0.75,1,2,0.5,0,0,,2,0,2
9963,Aaron Brooks,31-303,G,11/12/16,IND,,BOS,L,0,15,3,8,0.375,1,3,0.333,2,5,0.4,1,2,0.5,0,1,1
9964,Aaron Brooks,31-312,G,11/21/16,IND,,GSW,L,0,20,3,7,0.429,2,5,0.4,1,2,0.5,2,2,1,0,0,0
9965,Aaron Brooks,31-357,G,1/5/17,IND,,BRK,W,0,17,4,7,0.571,3,4,0.75,1,3,0.333,0,0,,0,0,0
9966,Aaron Brooks,31-307,G,11/16/16,IND,,CLE,W,0,11,4,7,0.571,3,3,1,1,4,0.25,0,0,,0,0,0
9967,Anthony Brown,24-056,F-G,12/5/16,NOP,,MEM,L,0,29,4,10,0.4,3,6,0.5,1,4,0.25,0,0,,1,5,6
9968,Anthony Brown,24-053,F-G,12/2/16,NOP,,LAC,L,0,25,4,7,0.571,3,3,1,1,4,0.25,0,0,,1,2,3
9969,Bobby Brown,32-172,G,3/15/17,HOU,,LAL,W,0,6,3,4,0.75,0,0,,3,4,0.75,0,0,,0,0,0
9970,Jaylen Brown,20-002,F,10/26/16,BOS,,BRK,W,0,19,3,4,0.75,3,4,0.75,0,0,,3,4,0.75,0,2,2
9971,Jaylen Brown,20-084,F,1/16/17,BOS,,CHO,W,0,20,4,7,0.571,4,7,0.571,0,0,,1,1,1,0,2,2
9972,Jaylen Brown,20-096,F,1/28/17,BOS,@,MIL,W,1,28,3,9,0.333,2,6,0.333,1,3,0.333,2,2,1,1,7,8
9973,Reggie Bullock,25-311,G-F,1/21/17,DET,,WAS,W,1,35,3,8,0.375,0,0,,3,8,0.375,0,0,,0,5,5
9974,Trey Burke,23-365,G,11/11/16,WAS,,CLE,L,0,22,4,7,0.571,4,7,0.571,0,0,,1,1,1,0,2,2
9975,Trey Burke,24-076,G,1/27/17,WAS,@,ATL,W,0,19,4,7,0.571,3,4,0.75,1,3,0.333,0,0,,0,1,1
9976,Alec Burks,25-243,G,3/20/17,UTA,@,IND,L,0,16,2,4,0.5,2,4,0.5,0,0,,5,5,1,1,3,4
9977,Jose Calderon,35-034,G,11/1/16,LAL,@,IND,L,0,17,3,4,0.75,2,2,1,1,2,0.5,2,2,1,0,2,2
9978,Jose Calderon,35-060,G,11/27/16,LAL,,ATL,W,1,13,4,5,0.8,4,5,0.8,0,0,,1,1,1,0,1,1
9979,Kentavious Caldwell-Pope,23-356,G,2/8/17,DET,,LAL,W,1,28,2,7,0.286,1,3,0.333,1,4,0.25,4,5,0.8,1,2,3
9980,Kentavious Caldwell-Pope,24-027,G,3/17/17,DET,,TOR,L,1,36,4,13,0.308,3,4,0.75,1,9,0.111,0,0,,0,2,2
9981,Kentavious Caldwell-Pope,23-290,G,12/4/16,DET,,ORL,L,1,34,4,12,0.333,3,6,0.5,1,6,0.167,0,0,,2,8,10
9982,Kentavious Caldwell-Pope,24-021,G,3/11/17,DET,,NYK,W,1,29,3,8,0.375,3,4,0.75,0,4,0,3,3,1,1,2,3
9983,Kentavious Caldwell-Pope,23-274,G,11/18/16,DET,@,CLE,L,1,28,4,12,0.333,3,9,0.333,1,3,0.333,0,0,,0,1,1
9984,Isaiah Canaan,25-195,G,12/2/16,CHI,,CLE,W,0,28,4,8,0.5,3,3,1,1,5,0.2,0,0,,0,0,0
9985,Clint Capela,22-269,F-C,2/11/17,HOU,,PHO,W,1,18,3,4,0.75,3,4,0.75,0,0,,3,4,0.75,2,3,5
9986,DeMarre Carroll,30-194,F,2/6/17,TOR,,LAC,W,1,23,3,6,0.5,2,3,0.667,1,3,0.333,2,2,1,2,3,5
9987,DeMarre Carroll,30-164,F,1/7/17,TOR,@,CHI,L,1,41,3,8,0.375,1,1,1,2,7,0.286,1,2,0.5,0,2,2
9988,DeMarre Carroll,30-215,F,2/27/17,TOR,@,NYK,W,1,30,3,8,0.375,2,4,0.5,1,4,0.25,2,2,1,1,4,5
9989,DeMarre Carroll,30-174,F,1/17/17,TOR,@,BRK,W,1,26,3,8,0.375,0,4,0,3,4,0.75,0,0,,2,1,3
9990,Vince Carter,39-297,G-F,11/18/16,MEM,@,DAL,W,0,24,4,11,0.364,3,6,0.5,1,5,0.2,0,0,,0,3,3
9991,Michael Carter-Williams,25-159,G,3/18/17,CHI,,UTA,W,0,27,4,10,0.4,4,9,0.444,0,1,0,1,1,1,0,2,2
9992,Willie Cauley-Stein,23-130,F-C,12/26/16,SAC,,PHI,W,0,12,4,7,0.571,4,7,0.571,0,0,,1,2,0.5,2,2,4
9993,Willie Cauley-Stein,23-108,F-C,12/4/16,SAC,@,NYK,L,0,23,4,7,0.571,4,7,0.571,0,0,,1,3,0.333,3,1,4
9994,Willie Cauley-Stein,23-176,F-C,2/10/17,SAC,,ATL,W,0,16,4,6,0.667,4,6,0.667,0,0,,1,2,0.5,0,4,4
9995,Willie Cauley-Stein,23-082,F-C,11/8/16,SAC,,NOP,W,0,12,4,6,0.667,4,6,0.667,0,0,,1,3,0.333,0,3,3
9996,Willie Cauley-Stein,23-195,F-C,3/1/17,SAC,,BRK,L,0,25,2,6,0.333,2,6,0.333,0,0,,5,6,0.833,2,3,5
9997,Tyson Chandler,34-078,C,12/19/16,PHO,@,MIN,L,1,32,2,2,1,2,2,1,0,0,,5,8,0.625,1,11,12
9998,Tyson Chandler,34-111,C,1/21/17,PHO,@,NYK,W,1,32,2,5,0.4,2,5,0.4,0,0,,5,5,1,4,12,16
9999,Tyson Chandler,34-035,C,11/6/16,PHO,@,LAL,L,1,30,4,4,1,4,4,1,0,0,,1,2,0.5,2,10,12
10000,Wilson Chandler,29-251,F,1/16/17,DEN,,ORL,W,0,21,4,12,0.333,3,6,0.5,1,6,0.167,0,0,,3,5,8
10001,Wilson Chandler,29-174,F,10/31/16,DEN,@,TOR,L,0,31,2,7,0.286,1,2,0.5,1,5,0.2,4,6,0.667,0,3,3
10002,Wilson Chandler,29-261,F,1/26/17,DEN,,PHO,W,0,31,2,6,0.333,1,5,0.2,1,1,1,4,5,0.8,3,6,9
10003,Marquese Chriss,19-146,F,11/25/16,PHO,,MIN,L,1,23,4,11,0.364,4,8,0.5,0,3,0,1,2,0.5,0,2,2
10004,Marquese Chriss,19-214,F,2/1/17,PHO,,LAC,L,1,28,3,15,0.2,2,9,0.222,1,6,0.167,2,2,1,3,2,5
10005,Marquese Chriss,19-248,F,3/7/17,PHO,,WAS,L,1,26,3,5,0.6,1,3,0.333,2,2,1,1,2,0.5,2,3,5
10006,Marquese Chriss,19-121,F,10/31/16,PHO,@,LAC,L,0,18,2,4,0.5,2,3,0.667,0,1,0,5,6,0.833,0,2,2
10007,Semaj Christon,24-040,G,12/11/16,OKC,,BOS,W,0,21,3,3,1,2,2,1,1,1,1,2,4,0.5,0,0,0
10008,Semaj Christon,24-010,G,11/11/16,OKC,,LAC,L,0,20,3,7,0.429,2,6,0.333,1,1,1,2,2,1,0,0,0
10009,Ian Clark,25-271,G,12/3/16,GSW,,PHO,W,0,16,3,4,0.75,3,3,1,0,1,0,3,4,0.75,0,1,1
10010,Ian Clark,25-283,G,12/15/16,GSW,,NYK,W,0,11,4,7,0.571,3,6,0.5,1,1,1,0,0,,0,0,0
10011,Ian Clark,26-011,G,3/18/17,GSW,,MIL,W,0,18,4,7,0.571,4,5,0.8,0,2,0,1,1,1,1,1,2
10012,Ian Clark,25-296,G,12/28/16,GSW,,TOR,W,0,16,3,7,0.429,2,5,0.4,1,2,0.5,2,2,1,4,1,5
10013,Ian Clark,25-355,G,2/25/17,GSW,,BRK,W,0,19,4,8,0.5,3,4,0.75,1,4,0.25,0,0,,3,1,4
10014,Jordan Clarkson,24-252,G,2/14/17,LAL,,SAC,L,0,28,4,8,0.5,4,7,0.571,0,1,0,1,2,0.5,1,6,7
10015,Jordan Clarkson,24-215,G,1/8/17,LAL,,ORL,W,0,29,3,9,0.333,2,4,0.5,1,5,0.2,2,2,1,0,4,4
10016,Jordan Clarkson,24-150,G,11/4/16,LAL,,GSW,W,0,29,4,13,0.308,3,10,0.3,1,3,0.333,0,0,,0,1,1
10017,Jordan Clarkson,24-175,G,11/29/16,LAL,@,NOP,L,0,29,4,14,0.286,3,7,0.429,1,7,0.143,0,0,,0,3,3
10018,Jordan Clarkson,24-217,G,1/10/17,LAL,,POR,L,0,23,3,9,0.333,1,4,0.25,2,5,0.4,1,1,1,0,1,1
10019,Darren Collison,29-077,G,11/8/16,SAC,,NOP,W,1,28,4,9,0.444,3,6,0.5,1,3,0.333,0,0,,1,0,1
10020,Darren Collison,29-125,G,12/26/16,SAC,,PHI,W,1,28,4,10,0.4,3,7,0.429,1,3,0.333,0,0,,1,0,1
10021,Darren Collison,29-140,G,1/10/17,SAC,,DET,W,1,28,4,9,0.444,3,6,0.5,1,3,0.333,0,0,,0,0,0
10022,Mike Conley,29-071,G,12/21/16,MEM,@,DET,W,1,24,3,10,0.3,0,3,0,3,7,0.429,0,0,,0,5,5
10023,Robert Covington,25-354,F,12/2/16,PHI,,ORL,L,1,23,3,9,0.333,0,2,0,3,7,0.429,0,0,,2,4,6
10024,Robert Covington,26-023,F,1/6/17,PHI,@,BOS,L,1,36,2,6,0.333,0,3,0,2,3,0.667,3,4,0.75,0,3,3
10025,Robert Covington,25-343,F,11/21/16,PHI,,MIA,W,1,31,4,13,0.308,3,8,0.375,1,5,0.2,0,0,,5,4,9
10026,Allen Crabbe,24-223,G-F,11/18/16,POR,@,NOP,L,0,27,3,6,0.5,3,3,1,0,3,0,3,5,0.6,0,2,2
10027,Allen Crabbe,24-255,G-F,12/20/16,POR,@,SAC,L,0,36,4,7,0.571,4,6,0.667,0,1,0,1,2,0.5,0,0,0
10028,Allen Crabbe,24-252,G-F,12/17/16,POR,@,GSW,L,0,24,2,5,0.4,1,2,0.5,1,3,0.333,4,4,1,1,4,5
10029,Allen Crabbe,24-250,G-F,12/15/16,POR,@,DEN,L,0,28,2,6,0.333,1,3,0.333,1,3,0.333,4,4,1,1,3,4
10030,Allen Crabbe,24-323,G-F,2/26/17,POR,@,TOR,L,0,31,2,6,0.333,2,5,0.4,0,1,0,5,5,1,1,2,3
10031,Allen Crabbe,24-214,G-F,11/9/16,POR,@,LAC,L,0,23,4,6,0.667,3,4,0.75,1,2,0.5,0,0,,0,2,2
10032,Allen Crabbe,24-276,G-F,1/10/17,POR,@,LAL,W,0,26,4,8,0.5,3,5,0.6,1,3,0.333,0,0,,0,1,1
10033,Jamal Crawford,36-292,G,1/6/17,LAC,@,SAC,W,0,32,4,13,0.308,3,8,0.375,1,5,0.2,0,2,0,0,0,0
10034,Jamal Crawford,36-229,G,11/4/16,LAC,@,MEM,W,0,24,3,12,0.25,2,9,0.222,1,3,0.333,2,2,1,0,3,3
10035,Jamal Crawford,36-348,G,3/3/17,LAC,@,MIL,L,0,18,4,5,0.8,3,4,0.75,1,1,1,0,0,,0,1,1
10036,Jamal Crawford,36-346,G,3/1/17,LAC,,HOU,L,0,16,4,8,0.5,3,5,0.6,1,3,0.333,0,0,,0,0,0
10037,Jamal Crawford,36-271,G,12/16/16,LAC,@,MIA,W,0,20,4,13,0.308,3,8,0.375,1,5,0.2,0,0,,0,3,3
10038,Jamal Crawford,36-297,G,1/11/17,LAC,,ORL,W,0,25,3,5,0.6,3,4,0.75,0,1,0,3,3,1,0,0,0
10039,Jae Crowder,26-245,F,3/8/17,BOS,@,GSW,W,1,30,3,9,0.333,1,3,0.333,2,6,0.333,1,2,0.5,2,8,10
10040,Jae Crowder,26-243,F,3/6/17,BOS,@,LAC,L,1,35,3,13,0.231,2,6,0.333,1,7,0.143,2,2,1,0,8,8
10041,Jae Crowder,26-188,F,1/10/17,BOS,@,TOR,L,1,38,4,10,0.4,3,5,0.6,1,5,0.2,0,0,,0,2,2
10042,Jae Crowder,26-136,F,11/19/16,BOS,@,DET,W,1,27,3,9,0.333,2,5,0.4,1,4,0.25,2,2,1,0,4,4
10043,Jae Crowder,26-115,F,10/29/16,BOS,@,CHO,W,1,34,3,9,0.333,0,2,0,3,7,0.429,0,0,,0,9,9
10044,Jae Crowder,26-177,F,12/30/16,BOS,,MIA,W,1,31,3,8,0.375,0,2,0,3,6,0.5,0,0,,0,2,2
10045,Dante Cunningham,29-190,F,10/29/16,NOP,@,SAS,L,0,23,3,5,0.6,1,2,0.5,2,3,0.667,1,2,0.5,2,3,5
10046,Dante Cunningham,29-262,F,1/9/17,NOP,@,NYK,W,1,30,3,5,0.6,0,2,0,3,3,1,0,0,,1,2,3
10047,Dante Cunningham,29-242,F,12/20/16,NOP,@,PHI,W,0,19,3,6,0.5,0,2,0,3,4,0.75,0,0,,0,5,5
10048,Dante Cunningham,29-214,F,11/22/16,NOP,@,ATL,W,1,25,4,7,0.571,3,6,0.5,1,1,1,0,0,,1,4,5
10049,Seth Curry,26-083,G,11/14/16,DAL,@,NYK,L,0,30,4,12,0.333,3,5,0.6,1,7,0.143,0,0,,2,3,5
10050,Troy Daniels,25-173,G,1/4/17,MEM,@,LAC,L,0,24,3,13,0.231,0,2,0,3,11,0.273,0,0,,0,2,2
10051,Troy Daniels,25-172,G,1/3/17,MEM,@,LAL,L,0,19,3,7,0.429,0,0,,3,7,0.429,0,0,,0,2,2
10052,Ed Davis,27-163,F,11/15/16,POR,,CHI,L,0,19,4,5,0.8,4,5,0.8,0,0,,1,3,0.333,4,5,9
10053,Ed Davis,27-173,F,11/25/16,POR,,NOP,W,1,28,4,6,0.667,4,6,0.667,0,0,,1,1,1,2,4,6
10054,Ed Davis,27-198,F,12/20/16,POR,@,SAC,L,0,19,4,4,1,4,4,1,0,0,,1,2,0.5,2,3,5
10055,Dewayne Dedmon,27-079,C,10/30/16,SAS,@,MIA,W,0,16,2,5,0.4,2,5,0.4,0,0,,5,6,0.833,4,4,8
10056,Dewayne Dedmon,27-211,C,3/11/17,SAS,,GSW,W,1,22,4,6,0.667,4,6,0.667,0,0,,1,1,1,1,6,7
10057,Dewayne Dedmon,27-135,C,12/25/16,SAS,,CHI,W,0,15,4,5,0.8,4,5,0.8,0,0,,1,1,1,2,4,6
10058,Sam Dekker,22-244,F,1/5/17,HOU,,OKC,W,0,16,3,4,0.75,2,2,1,1,2,0.5,2,2,1,1,1,2
10059,Sam Dekker,22-177,F,10/30/16,HOU,,DAL,W,0,15,3,5,0.6,0,2,0,3,3,1,0,0,,0,1,1
10060,Sam Dekker,22-252,F,1/13/17,HOU,,MEM,L,0,14,2,6,0.333,0,2,0,2,4,0.5,3,6,0.5,2,2,4
10061,Sam Dekker,22-266,F,1/27/17,HOU,@,PHI,W,0,25,3,5,0.6,2,3,0.667,1,2,0.5,2,2,1,0,3,3
10062,Sam Dekker,22-235,F,12/27/16,HOU,@,DAL,W,0,27,4,7,0.571,3,4,0.75,1,3,0.333,0,0,,3,8,11
10063,Sam Dekker,22-218,F,12/10/16,HOU,,DAL,W,0,23,4,7,0.571,3,6,0.5,1,1,1,0,0,,1,3,4
10064,Malcolm Delaney,27-262,G,11/28/16,ATL,@,GSW,L,0,15,3,5,0.6,2,3,0.667,1,2,0.5,2,2,1,0,1,1
10065,Malcolm Delaney,27-246,G,11/12/16,ATL,,PHI,W,0,17,3,8,0.375,3,7,0.429,0,1,0,3,3,1,2,1,3
10066,Malcolm Delaney,27-310,G,1/15/17,ATL,,MIL,W,0,26,4,7,0.571,3,4,0.75,1,3,0.333,0,0,,0,0,0
10067,Matthew Dellavedova,26-149,G,2/4/17,MIL,@,PHO,W,1,22,4,5,0.8,3,4,0.75,1,1,1,0,0,,0,0,0
10068,Matthew Dellavedova,26-127,G,1/13/17,MIL,,MIA,W,0,18,1,5,0.2,0,4,0,1,1,1,6,6,1,0,2,2
10069,Matthew Dellavedova,26-084,G,12/1/16,MIL,@,BRK,W,1,24,3,6,0.5,0,2,0,3,4,0.75,0,0,,0,0,0
10070,Matthew Dellavedova,26-139,G,1/25/17,MIL,,PHI,L,1,29,4,10,0.4,3,8,0.375,1,2,0.5,0,0,,0,0,0
10071,Matthew Dellavedova,26-156,G,2/11/17,MIL,@,IND,W,1,33,2,6,0.333,0,3,0,2,3,0.667,3,4,0.75,0,1,1
10072,Matthew Dellavedova,26-098,G,12/15/16,MIL,,CHI,W,1,29,4,7,0.571,3,6,0.5,1,1,1,0,0,,1,0,1
10073,Luol Deng,31-281,F,1/22/17,LAL,@,DAL,L,1,19,4,7,0.571,3,4,0.75,1,3,0.333,0,0,,0,2,2
10074,Luol Deng,31-255,F,12/27/16,LAL,,UTA,L,1,33,4,10,0.4,3,7,0.429,1,3,0.333,0,0,,1,8,9
10075,Luol Deng,31-305,F,2/15/17,LAL,@,PHO,L,0,23,3,6,0.5,2,3,0.667,1,3,0.333,2,2,1,0,2,2
10076,Gorgui Dieng,26-302,C,11/15/16,MIN,,CHO,L,1,33,3,6,0.5,3,5,0.6,0,1,0,3,3,1,3,8,11
10077,Gorgui Dieng,27-062,C,3/21/17,MIN,,SAS,L,1,33,4,6,0.667,3,4,0.75,1,2,0.5,0,0,,2,2,4
10078,Gorgui Dieng,27-060,C,3/19/17,MIN,@,NOP,L,1,35,3,4,0.75,3,4,0.75,0,0,,3,3,1,3,7,10
10079,Gorgui Dieng,26-306,C,11/19/16,MIN,@,MEM,L,1,36,3,7,0.429,3,7,0.429,0,0,,3,6,0.5,2,9,11
10080,Spencer Dinwiddie,23-277,G,1/8/17,BRK,,PHI,L,0,25,3,5,0.6,3,5,0.6,0,0,,3,4,0.75,0,3,3
10081,Spencer Dinwiddie,23-340,G,3/12/17,BRK,,NYK,W,0,28,3,5,0.6,1,3,0.333,2,2,1,1,2,0.5,1,1,2
10082,Andre Drummond,23-189,C,2/15/17,DET,,DAL,W,1,19,4,8,0.5,4,8,0.5,0,0,,1,2,0.5,4,7,11
10083,Andre Drummond,23-153,C,1/10/17,DET,@,SAC,L,1,35,4,5,0.8,4,5,0.8,0,0,,1,6,0.167,3,9,12
10084,Andre Drummond,23-131,C,12/19/16,DET,@,CHI,L,1,23,4,8,0.5,4,8,0.5,0,0,,1,2,0.5,2,2,4
10085,Andre Drummond,23-083,C,11/1/16,DET,,NYK,W,1,35,4,13,0.308,4,13,0.308,0,0,,1,6,0.167,2,11,13
10086,Andre Drummond,23-129,C,12/17/16,DET,,IND,L,1,35,4,11,0.364,4,11,0.364,0,0,,1,4,0.25,7,8,15
10087,Andre Drummond,23-156,C,1/13/17,DET,@,UTA,L,1,33,4,7,0.571,4,7,0.571,0,0,,1,4,0.25,2,17,19
10088,Jared Dudley,31-252,F-G,3/19/17,PHO,@,DET,L,0,22,4,7,0.571,3,4,0.75,1,3,0.333,0,0,,1,4,5
10089,Jared Dudley,31-149,F-G,12/6/16,PHO,@,UTA,L,0,26,3,5,0.6,1,2,0.5,2,3,0.667,1,2,0.5,0,7,7
10090,Jared Dudley,31-112,F-G,10/30/16,PHO,,GSW,L,1,27,3,7,0.429,1,3,0.333,2,4,0.5,1,2,0.5,1,1,2
10091,Wayne Ellington,29-130,G,3/8/17,MIA,,CHO,W,0,22,3,10,0.3,0,2,0,3,8,0.375,0,0,,0,1,1
10092,Wayne Ellington,29-104,G,2/10/17,MIA,@,BRK,W,1,25,3,9,0.333,0,1,0,3,8,0.375,0,0,,0,4,4
10093,Wayne Ellington,29-141,G,3/19/17,MIA,,POR,L,0,23,3,10,0.3,0,0,,3,10,0.3,0,0,,2,3,5
10094,Wayne Ellington,29-030,G,11/28/16,MIA,,BOS,L,0,27,4,9,0.444,3,4,0.75,1,5,0.2,0,0,,0,2,2
10095,Wayne Ellington,29-086,G,1/23/17,MIA,,GSW,W,0,33,3,12,0.25,1,4,0.25,2,8,0.25,1,1,1,0,2,2
10096,Wayne Ellington,29-118,G,2/24/17,MIA,@,ATL,W,0,22,3,11,0.273,0,2,0,3,9,0.333,0,1,0,0,1,1
10097,Monta Ellis,31-100,G,2/3/17,IND,@,BRK,W,0,25,3,8,0.375,3,8,0.375,0,0,,3,5,0.6,0,6,6
10098,Monta Ellis,31-113,G,2/16/17,IND,,WAS,L,0,31,4,7,0.571,4,6,0.667,0,1,0,1,2,0.5,0,3,3
10099,Monta Ellis,31-014,G,11/9/16,IND,,PHI,W,1,40,4,9,0.444,3,7,0.429,1,2,0.5,0,0,,0,5,5
10100,Monta Ellis,31-073,G,1/7/17,IND,,NYK,W,0,21,2,5,0.4,1,3,0.333,1,2,0.5,4,4,1,0,2,2
10101,Monta Ellis,31-100,G,2/3/17,IND,@,BRK,W,0,25,3,8,0.375,3,8,0.375,0,0,,3,5,0.6,0,6,6
10102,Monta Ellis,31-113,G,2/16/17,IND,,WAS,L,0,31,4,7,0.571,4,6,0.667,0,1,0,1,2,0.5,0,3,3
10103,Monta Ellis,31-014,G,11/9/16,IND,,PHI,W,1,40,4,9,0.444,3,7,0.429,1,2,0.5,0,0,,0,5,5
10104,Joel Embiid,22-273,C-F,12/14/16,PHI,,TOR,L,1,27,3,6,0.5,3,4,0.75,0,2,0,3,5,0.6,1,5,6
10105,James Ennis,26-134,F,11/12/16,MEM,@,MIL,L,1,26,3,6,0.5,2,2,1,1,4,0.25,2,2,1,0,2,2
10106,James Ennis,26-130,F,11/8/16,MEM,,DEN,W,1,32,2,4,0.5,1,1,1,1,3,0.333,4,4,1,2,1,3
10107,James Ennis,26-126,F,11/4/16,MEM,,LAC,L,1,36,3,9,0.333,3,8,0.375,0,1,0,3,4,0.75,7,4,11
10108,Tyler Ennis,22-084,G,11/16/16,HOU,@,OKC,L,0,11,4,5,0.8,3,4,0.75,1,1,1,0,0,,0,2,2
10109,Tyreke Evans,27-126,G-F,1/23/17,NOP,,CLE,W,0,12,3,8,0.375,2,5,0.4,1,3,0.333,2,2,1,0,2,2
10110,Tyreke Evans,27-135,G-F,2/1/17,NOP,@,DET,L,0,18,3,7,0.429,3,5,0.6,0,2,0,3,4,0.75,0,0,0
10111,Dante Exum,21-124,G,11/14/16,UTA,,MEM,L,1,30,4,9,0.444,4,6,0.667,0,3,0,1,2,0.5,1,2,3
10112,Kenneth Faried,27-097,F,2/24/17,DEN,,BRK,W,1,16,3,4,0.75,3,4,0.75,0,0,,3,4,0.75,2,4,6
10113,Kenneth Faried,26-342,F,10/26/16,DEN,@,NOP,W,0,28,3,9,0.333,3,8,0.375,0,1,0,3,6,0.5,6,8,14
10114,Jordan Farmar,29-341,G,11/5/16,SAC,@,MIL,L,0,25,3,10,0.3,0,2,0,3,8,0.375,0,0,,1,1,2
10115,Derrick Favors,25-174,F-C,1/5/17,UTA,@,TOR,L,1,26,4,10,0.4,4,10,0.4,0,0,,1,2,0.5,1,7,8
10116,Derrick Favors,25-233,F-C,3/5/17,UTA,@,SAC,W,1,26,4,5,0.8,4,5,0.8,0,0,,1,2,0.5,0,2,2
10117,Derrick Favors,25-169,F-C,12/31/16,UTA,,PHO,W,1,24,4,8,0.5,4,8,0.5,0,0,,1,4,0.25,2,6,8
10118,Derrick Favors,25-182,F-C,1/13/17,UTA,,DET,W,1,27,4,10,0.4,4,10,0.4,0,0,,1,3,0.333,2,7,9
10119,Kay Felder,21-304,G,1/27/17,CLE,,BRK,W,0,17,4,7,0.571,3,5,0.6,1,2,0.5,0,0,,1,1,2
10120,Kay Felder,21-281,G,1/4/17,CLE,,CHI,L,0,16,3,11,0.273,3,9,0.333,0,2,0,3,3,1,0,5,5
10121,Kay Felder,21-309,G,2/1/17,CLE,,MIN,W,0,17,3,5,0.6,1,3,0.333,2,2,1,1,2,0.5,0,1,1
10122,Kay Felder,21-232,G,11/16/16,CLE,@,IND,L,0,13,2,4,0.5,2,4,0.5,0,0,,5,6,0.833,0,3,3
10123,Cristiano Felicio,24-236,F-C,2/28/17,CHI,,DEN,L,0,13,4,4,1,4,4,1,0,0,,1,2,0.5,2,1,3
10124,Cristiano Felicio,24-191,F-C,1/14/17,CHI,,NOP,W,0,21,4,4,1,4,4,1,0,0,,1,2,0.5,3,4,7
10125,Cristiano Felicio,24-154,F-C,12/8/16,CHI,,SAS,W,0,18,3,5,0.6,3,5,0.6,0,0,,3,4,0.75,4,3,7
10126,Raymond Felton,32-253,G,3/6/17,LAC,,BOS,W,0,20,2,3,0.667,2,3,0.667,0,0,,5,5,1,0,3,3
10127,Raymond Felton,32-230,G,2/11/17,LAC,@,CHO,W,0,28,4,7,0.571,3,4,0.75,1,3,0.333,0,0,,0,7,7
10128,Raymond Felton,32-188,G,12/31/16,LAC,@,OKC,L,0,32,4,9,0.444,3,7,0.429,1,2,0.5,0,0,,0,2,2
10129,Raymond Felton,32-221,G,2/2/17,LAC,,GSW,L,1,33,3,6,0.5,3,5,0.6,0,1,0,3,4,0.75,1,3,4
10130,Yogi Ferrell,23-310,G,3/15/17,DAL,@,WAS,W,1,25,2,7,0.286,0,3,0,2,4,0.5,3,4,0.75,0,1,1
10131,Yogi Ferrell,23-265,G,1/29/17,DAL,@,SAS,W,1,36,3,9,0.333,2,5,0.4,1,4,0.25,2,2,1,2,0,2
10132,Yogi Ferrell,23-276,G,2/9/17,DAL,,UTA,W,1,26,3,8,0.375,2,4,0.5,1,4,0.25,2,2,1,0,4,4
10133,Evan Fournier,24-093,G-F,1/30/17,ORL,@,MIN,L,0,23,4,11,0.364,3,7,0.429,1,4,0.25,0,0,,1,0,1
10134,Evan Fournier,24-109,G-F,2/15/17,ORL,,SAS,L,1,34,3,11,0.273,2,6,0.333,1,5,0.2,2,3,0.667,0,5,5
10135,Evan Fournier,24-098,G-F,2/4/17,ORL,@,ATL,L,1,32,3,12,0.25,3,9,0.333,0,3,0,3,3,1,2,2,4
10136,Randy Foye,33-064,G,11/27/16,BRK,,SAC,L,0,22,3,8,0.375,1,2,0.5,2,6,0.333,1,1,1,0,4,4
10137,Randy Foye,33-111,G,1/13/17,BRK,@,TOR,L,0,23,3,7,0.429,0,3,0,3,4,0.75,0,0,,1,2,3
10138,Randy Foye,33-097,G,12/30/16,BRK,@,WAS,L,0,27,2,7,0.286,1,3,0.333,1,4,0.25,4,4,1,0,2,2
10139,Tim Frazier,26-045,G,12/16/16,NOP,@,HOU,L,0,25,3,8,0.375,1,5,0.2,2,3,0.667,1,1,1,2,2,4
10140,Langston Galloway,24-350,G,11/23/16,NOP,,MIN,W,0,25,3,6,0.5,0,1,0,3,5,0.6,0,0,,1,3,4
10141,Langston Galloway,24-334,G,11/7/16,NOP,@,GSW,L,0,21,3,8,0.375,2,6,0.333,1,2,0.5,2,3,0.667,1,1,2
10142,Langston Galloway,25-066,G,2/13/17,NOP,@,PHO,W,0,23,3,6,0.5,0,1,0,3,5,0.6,0,0,,0,2,2
10143,Langston Galloway,25-065,G,2/12/17,NOP,@,SAC,L,0,25,3,8,0.375,0,2,0,3,6,0.5,0,1,0,0,0,0
10144,Langston Galloway,25-063,G,2/10/17,NOP,@,MIN,W,0,25,3,4,0.75,0,0,,3,4,0.75,0,0,,0,4,4
10145,Langston Galloway,25-038,G,1/16/17,NOP,@,IND,L,0,24,3,8,0.375,0,2,0,3,6,0.5,0,0,,0,4,4
10146,Marc Gasol,31-301,C,11/25/16,MEM,,MIA,L,1,26,4,11,0.364,4,9,0.444,0,2,0,1,2,0.5,0,1,1
10147,Marc Gasol,31-348,C,1/11/17,MEM,@,OKC,L,1,36,4,12,0.333,4,10,0.4,0,2,0,1,3,0.333,1,6,7
10148,Pau Gasol,36-115,F-C,10/29/16,SAS,,NOP,W,1,22,3,6,0.5,2,5,0.4,1,1,1,2,2,1,1,7,8
10149,Pau Gasol,36-140,F-C,11/23/16,SAS,@,CHO,W,1,30,4,8,0.5,3,6,0.5,1,2,0.5,0,0,,1,7,8
10150,Rudy Gay,30-093,F,11/18/16,SAC,,LAC,L,1,33,3,11,0.273,3,9,0.333,0,2,0,3,4,0.75,0,3,3
10151,Paul George,26-298,F,2/24/17,IND,,MEM,W,1,34,3,12,0.25,2,7,0.286,1,5,0.2,2,2,1,1,8,9
10152,Taj Gibson,31-199,F,1/9/17,CHI,,OKC,L,1,20,4,8,0.5,4,8,0.5,0,0,,1,1,1,1,6,7
10153,Taj Gibson,31-134,F,11/5/16,CHI,@,IND,L,1,25,4,8,0.5,4,8,0.5,0,0,,1,1,1,5,5,10
10154,Manu Ginobili,39-221,G,3/6/17,SAS,,HOU,W,0,20,4,9,0.444,3,5,0.6,1,4,0.25,0,0,,2,1,3
10155,Manu Ginobili,39-099,G,11/4/16,SAS,@,UTA,W,0,14,4,7,0.571,3,6,0.5,1,1,1,0,0,,0,3,3
10156,Manu Ginobili,39-216,G,3/1/17,SAS,,IND,W,0,23,3,6,0.5,2,3,0.667,1,3,0.333,2,4,0.5,0,1,1
10157,Manu Ginobili,39-173,G,1/17/17,SAS,,MIN,W,0,20,3,5,0.6,1,1,1,2,4,0.5,1,1,1,0,2,2
10158,Rudy Gobert,24-186,C,12/29/16,UTA,,PHI,W,1,33,3,5,0.6,3,5,0.6,0,0,,3,11,0.273,2,11,13
10159,Rudy Gobert,24-214,C,1/26/17,UTA,,LAL,W,1,38,3,6,0.5,3,6,0.5,0,0,,3,4,0.75,3,10,13
10160,Rudy Gobert,24-248,C,3/1/17,UTA,,MIN,L,1,21,4,7,0.571,4,7,0.571,0,0,,1,2,0.5,4,4,8
10161,Aaron Gordon,21-160,F,2/23/17,ORL,,POR,L,1,29,4,9,0.444,4,7,0.571,0,2,0,1,2,0.5,5,4,9
10162,Aaron Gordon,21-056,F,11/11/16,ORL,,UTA,L,0,25,4,9,0.444,4,8,0.5,0,1,0,1,2,0.5,1,6,7
10163,Aaron Gordon,21-084,F,12/9/16,ORL,@,CHO,L,1,29,4,8,0.5,3,6,0.5,1,2,0.5,0,0,,2,1,3
10164,Aaron Gordon,21-098,F,12/23/16,ORL,,LAL,W,1,24,3,10,0.3,2,8,0.25,1,2,0.5,2,2,1,2,5,7
10165,Aaron Gordon,21-070,F,11/25/16,ORL,,WAS,L,0,25,4,10,0.4,3,6,0.5,1,4,0.25,0,2,0,3,4,7
10166,Aaron Gordon,21-068,F,11/23/16,ORL,,PHO,L,0,20,4,11,0.364,3,8,0.375,1,3,0.333,0,0,,0,2,2
10167,Aaron Gordon,21-081,F,12/6/16,ORL,@,WAS,W,1,28,4,9,0.444,3,8,0.375,1,1,1,0,0,,0,5,5
10168,Aaron Gordon,21-050,F,11/5/16,ORL,,WAS,W,1,24,3,7,0.429,1,3,0.333,2,4,0.5,1,2,0.5,1,3,4
10169,Eric Gordon,27-355,G,12/14/16,HOU,,SAC,W,0,26,3,12,0.25,0,3,0,3,9,0.333,0,0,,0,2,2
10170,Eric Gordon,28-064,G,2/27/17,HOU,,IND,L,0,26,3,11,0.273,2,6,0.333,1,5,0.2,2,4,0.5,1,0,1
10171,Eric Gordon,27-334,G,11/23/16,HOU,,TOR,L,0,28,4,13,0.308,3,5,0.6,1,8,0.125,0,0,,0,1,1
10172,Eric Gordon,27-316,G,11/5/16,HOU,@,ATL,L,1,30,3,11,0.273,3,7,0.429,0,4,0,3,4,0.75,0,2,2
10173,Eric Gordon,28-029,G,1/23/17,HOU,@,MIL,L,0,28,3,9,0.333,0,1,0,3,8,0.375,0,0,,0,2,2
10174,Marcin Gortat,32-305,C-F,12/18/16,WAS,,LAC,W,1,39,4,8,0.5,4,8,0.5,0,0,,1,1,1,2,5,7
10175,Marcin Gortat,32-297,C-F,12/10/16,WAS,,MIL,W,1,35,4,8,0.5,4,8,0.5,0,0,,1,2,0.5,7,7,14
10176,Jerami Grant,22-253,F,11/20/16,OKC,,IND,L,0,15,3,3,1,2,2,1,1,1,1,2,2,1,0,1,1
10177,Jerami Grant,22-310,F,1/16/17,OKC,@,LAC,L,1,34,3,4,0.75,0,1,0,3,3,1,0,0,,1,7,8
10178,Jerami Grant,22-259,F,11/26/16,OKC,,DET,W,0,26,4,8,0.5,3,5,0.6,1,3,0.333,0,0,,1,2,3
10179,Jerami Grant,22-292,F,12/29/16,OKC,@,MEM,L,0,24,2,4,0.5,2,4,0.5,0,0,,5,8,0.625,0,1,1
10180,Jerami Grant,22-255,F,11/22/16,OKC,@,LAL,L,0,23,4,5,0.8,3,3,1,1,2,0.5,0,0,,0,3,3
10181,Jerami Grant,22-288,F,12/25/16,OKC,,MIN,W,0,28,3,5,0.6,2,3,0.667,1,2,0.5,2,2,1,0,4,4
10182,Jerian Grant,24-093,G,1/10/17,CHI,@,WAS,L,1,25,2,5,0.4,1,4,0.25,1,1,1,4,4,1,0,2,2
10183,Jerian Grant,24-085,G,1/2/17,CHI,,CHO,W,0,27,4,10,0.4,3,8,0.375,1,2,0.5,0,0,,1,2,3
10184,Danny Green,29-260,G-F,3/9/17,SAS,@,OKC,L,1,28,3,5,0.6,1,1,1,2,4,0.5,1,1,1,0,2,2
10185,Danny Green,29-169,G-F,12/8/16,SAS,@,CHI,L,1,26,3,8,0.375,0,0,,3,8,0.375,0,0,,0,1,1
10186,Danny Green,29-215,G-F,1/23/17,SAS,@,BRK,W,1,33,4,8,0.5,3,5,0.6,1,3,0.333,0,0,,0,2,2
10187,Danny Green,29-147,G-F,11/16/16,SAS,@,SAC,W,1,28,3,7,0.429,0,0,,3,7,0.429,0,0,,1,3,4
10188,Danny Green,29-179,G-F,12/18/16,SAS,,NOP,W,1,25,3,5,0.6,0,0,,3,5,0.6,0,0,,0,5,5
10189,Danny Green,29-193,G-F,1/1/17,SAS,@,ATL,L,1,31,3,8,0.375,0,0,,3,8,0.375,0,0,,0,6,6
10190,Draymond Green,26-274,F,12/3/16,GSW,,PHO,W,1,28,2,6,0.333,1,3,0.333,1,3,0.333,4,5,0.8,1,4,5
10191,Draymond Green,26-306,F,1/4/17,GSW,,POR,W,1,30,3,6,0.5,1,2,0.5,2,4,0.5,1,3,0.333,1,6,7
10192,Draymond Green,27-012,F,3/16/17,GSW,,ORL,W,1,25,4,8,0.5,4,6,0.667,0,2,0,1,2,0.5,0,11,11
10193,Draymond Green,26-244,F,11/3/16,GSW,,OKC,W,1,29,2,9,0.222,2,7,0.286,0,2,0,5,6,0.833,4,6,10
10194,Draymond Green,26-310,F,1/8/17,GSW,@,SAC,W,1,32,4,9,0.444,3,5,0.6,1,4,0.25,0,0,,1,6,7
10195,Gerald Green,30-274,G-F,10/26/16,BOS,,BRK,W,0,15,4,7,0.571,3,5,0.6,1,2,0.5,0,0,,1,4,5
10196,JaMychal Green,26-221,F,1/28/17,MEM,@,UTA,W,1,26,3,7,0.429,2,4,0.5,1,3,0.333,2,2,1,3,1,4
10197,JaMychal Green,26-258,F,3/6/17,MEM,,BRK,L,0,26,3,5,0.6,2,4,0.5,1,1,1,2,2,1,2,7,9
10198,JaMychal Green,26-250,F,2/26/17,MEM,@,DEN,W,1,28,1,3,0.333,0,0,,1,3,0.333,6,6,1,2,8,10
10199,JaMychal Green,26-188,F,12/26/16,MEM,@,ORL,L,1,30,3,6,0.5,1,1,1,2,5,0.4,1,2,0.5,0,2,2
10200,Jeff Green,30-192,F,3/8/17,ORL,,CHI,W,0,19,4,10,0.4,3,6,0.5,1,4,0.25,0,0,,2,3,5
10201,Justin Hamilton,26-221,C,11/8/16,BRK,,MIN,W,0,24,3,4,0.75,0,0,,3,4,0.75,0,0,,0,6,6
10202,Justin Hamilton,26-280,C,1/6/17,BRK,,CLE,L,0,16,4,9,0.444,3,6,0.5,1,3,0.333,0,0,,4,2,6
10203,Justin Hamilton,26-217,C,11/4/16,BRK,,CHO,L,0,20,4,7,0.571,3,3,1,1,4,0.25,0,0,,0,4,4
10204,Justin Hamilton,26-312,C,2/7/17,BRK,@,CHO,L,0,21,3,6,0.5,2,2,1,1,4,0.25,2,2,1,2,5,7
10205,Justin Hamilton,26-291,C,1/17/17,BRK,,TOR,L,0,13,4,8,0.5,3,4,0.75,1,4,0.25,0,0,,2,3,5
10206,Justin Hamilton,26-228,C,11/15/16,BRK,@,LAL,L,0,24,3,6,0.5,2,2,1,1,4,0.25,2,2,1,0,6,6
10207,Justin Hamilton,26-306,C,2/1/17,BRK,,NYK,L,0,19,3,4,0.75,2,3,0.667,1,1,1,2,2,1,2,1,3
10208,Justin Hamilton,26-304,C,1/30/17,BRK,@,MIA,L,0,17,4,5,0.8,3,3,1,1,2,0.5,0,0,,1,2,3
10209,Justin Hamilton,26-302,C,1/28/17,BRK,@,MIN,L,0,20,4,7,0.571,3,5,0.6,1,2,0.5,0,0,,1,6,7
10210,A.J. Hammons,24-074,C,11/9/16,DAL,@,GSW,L,0,6,3,5,0.6,2,4,0.5,1,1,1,2,2,1,2,1,3
10211,Tim Hardaway,24-310,G,1/20/17,ATL,,CHI,W,0,21,4,10,0.4,3,7,0.429,1,3,0.333,0,0,,0,3,3
10212,Tim Hardaway,24-247,G,11/18/16,ATL,@,CHO,L,0,23,4,9,0.444,3,5,0.6,1,4,0.25,0,0,,0,3,3
10213,Tim Hardaway,24-300,G,1/10/17,ATL,@,BRK,W,0,22,3,9,0.333,2,6,0.333,1,3,0.333,2,4,0.5,0,2,2
10214,Maurice Harkless,23-177,F-G,11/4/16,POR,@,DAL,W,1,32,4,8,0.5,3,5,0.6,1,3,0.333,0,0,,0,1,1
10215,Maurice Harkless,23-239,F-G,1/5/17,POR,,LAL,W,1,29,4,6,0.667,3,4,0.75,1,2,0.5,0,0,,0,6,6
10216,Maurice Harkless,23-218,F-G,12/15/16,POR,@,DEN,L,1,36,3,7,0.429,2,4,0.5,1,3,0.333,2,2,1,1,2,3
10217,Maurice Harkless,23-252,F-G,1/18/17,POR,@,CHO,L,1,27,4,10,0.4,3,6,0.5,1,4,0.25,0,0,,0,1,1
10218,Justin Harper,27-186,F,3/4/17,PHI,,DET,L,0,23,4,10,0.4,3,5,0.6,1,5,0.2,0,0,,2,2,4
10219,Montrezl Harrell,22-323,F-C,12/14/16,HOU,,SAC,W,0,16,4,6,0.667,4,6,0.667,0,0,,1,2,0.5,0,4,4
10220,Montrezl Harrell,22-351,F-C,1/11/17,HOU,@,MIN,L,1,20,2,4,0.5,2,4,0.5,0,0,,5,5,1,1,4,5
10221,Montrezl Harrell,22-296,F-C,11/17/16,HOU,,POR,W,0,21,4,13,0.308,4,13,0.308,0,0,,1,1,1,4,5,9
10222,Montrezl Harrell,22-346,F-C,1/6/17,HOU,@,ORL,W,1,22,3,6,0.5,3,6,0.5,0,0,,3,6,0.5,1,3,4
10223,Montrezl Harrell,22-329,F-C,12/20/16,HOU,,SAS,L,0,22,4,7,0.571,4,7,0.571,0,0,,1,3,0.333,2,3,5
10224,Devin Harris,33-352,G,2/13/17,DAL,,BOS,L,0,19,2,6,0.333,1,3,0.333,1,3,0.333,4,5,0.8,0,1,1
10225,Gary Harris,22-177,G,3/10/17,DEN,,BOS,W,1,36,3,9,0.333,2,5,0.4,1,4,0.25,2,2,1,1,2,3
10226,Joe Harris,25-054,G,10/31/16,BRK,,CHI,L,0,23,4,8,0.5,3,3,1,1,5,0.2,0,1,0,0,2,2
10227,Joe Harris,25-106,G,12/22/16,BRK,,GSW,L,0,19,3,4,0.75,0,1,0,3,3,1,0,0,,0,3,3
10228,Joe Harris,25-096,G,12/12/16,BRK,@,HOU,L,0,22,2,7,0.286,1,3,0.333,1,4,0.25,4,4,1,0,7,7
10229,Tobias Harris,24-206,F,2/6/17,DET,,PHI,W,0,27,3,10,0.3,3,9,0.333,0,1,0,3,3,1,2,6,8
10230,Tobias Harris,24-117,F,11/9/16,DET,@,PHO,L,1,32,3,12,0.25,2,10,0.2,1,2,0.5,2,2,1,0,3,3
10231,Tobias Harris,24-129,F,11/21/16,DET,,HOU,L,1,21,4,8,0.5,4,7,0.571,0,1,0,1,1,1,1,1,2
10232,Tobias Harris,24-113,F,11/5/16,DET,,DEN,W,1,34,4,11,0.364,4,8,0.5,0,3,0,1,1,1,0,4,4
10233,Tobias Harris,24-126,F,11/18/16,DET,@,CLE,L,1,20,3,10,0.3,2,7,0.286,1,3,0.333,2,2,1,0,2,2
10234,Andrew Harrison,22-054,G,12/21/16,MEM,@,DET,W,0,27,1,1,1,0,0,,1,1,1,6,6,1,1,3,4
10235,Andrew Harrison,22-091,G,1/27/17,MEM,@,POR,L,0,16,3,4,0.75,2,2,1,1,2,0.5,2,3,0.667,0,0,0
10236,Andrew Harrison,22-136,G,3/13/17,MEM,,MIL,W,0,21,2,6,0.333,1,5,0.2,1,1,1,4,5,0.8,0,1,1
10237,Andrew Harrison,22-002,G,10/30/16,MEM,,WAS,W,0,30,3,8,0.375,2,4,0.5,1,4,0.25,2,3,0.667,1,0,1
10238,Andrew Harrison,22-064,G,12/31/16,MEM,@,SAC,W,0,19,4,6,0.667,3,3,1,1,3,0.333,0,0,,1,1,2
10239,Gordon Hayward,26-241,F-G,11/19/16,UTA,@,HOU,L,1,39,4,13,0.308,3,9,0.333,1,4,0.25,0,1,0,0,7,7
10240,Gordon Hayward,26-307,F-G,1/24/17,UTA,@,DEN,L,1,35,2,10,0.2,0,7,0,2,3,0.667,3,3,1,1,5,6
10241,Gordon Hayward,26-353,F-G,3/11/17,UTA,@,OKC,L,1,21,3,9,0.333,2,7,0.286,1,2,0.5,2,3,0.667,1,2,3
10242,Gerald Henderson,29-093,G,3/12/17,PHI,@,LAL,W,1,25,3,7,0.429,2,5,0.4,1,2,0.5,2,3,0.667,0,2,2
10243,Gerald Henderson,28-359,G,12/2/16,PHI,,ORL,L,1,22,4,7,0.571,3,6,0.5,1,1,1,0,0,,1,2,3
10244,Gerald Henderson,28-322,G,10/26/16,PHI,,OKC,L,1,25,3,6,0.5,1,3,0.333,2,3,0.667,1,2,0.5,0,2,2
10245,Gerald Henderson,29-035,G,1/13/17,PHI,,CHO,W,0,24,3,6,0.5,2,4,0.5,1,2,0.5,2,3,0.667,0,3,3
10246,Gerald Henderson,29-078,G,2/25/17,PHI,@,NYK,L,1,30,3,11,0.273,3,8,0.375,0,3,0,3,5,0.6,1,2,3
10247,Gerald Henderson,29-100,G,3/19/17,PHI,,BOS,W,0,17,1,7,0.143,0,4,0,1,3,0.333,6,8,0.75,0,3,3
10248,Gerald Henderson,29-040,G,1/18/17,PHI,,TOR,W,0,26,2,3,0.667,1,2,0.5,1,1,1,4,5,0.8,0,2,2
10249,Gerald Henderson,29-095,G,3/14/17,PHI,@,GSW,L,0,20,3,7,0.429,2,4,0.5,1,3,0.333,2,5,0.4,2,3,5
10250,Juan Hernangomez,21-056,F,11/23/16,DEN,@,UTA,L,1,28,2,5,0.4,1,2,0.5,1,3,0.333,4,8,0.5,1,5,6
10251,Juan Hernangomez,21-169,F,3/16/17,DEN,,LAC,W,1,26,3,7,0.429,2,4,0.5,1,3,0.333,2,2,1,1,4,5
10252,Willy Hernangomez,22-179,C,11/22/16,NYK,,POR,W,0,21,4,5,0.8,4,5,0.8,0,0,,1,1,1,0,4,4
10253,Willy Hernangomez,22-194,C,12/7/16,NYK,,CLE,L,0,15,2,5,0.4,1,4,0.25,1,1,1,4,4,1,4,3,7
10254,Mario Hezonja,22-016,F-G,3/13/17,ORL,@,SAC,L,0,19,4,7,0.571,3,6,0.5,1,1,1,0,0,,1,2,3
10255,Mario Hezonja,21-256,F-G,11/7/16,ORL,@,CHI,L,0,21,4,13,0.308,3,7,0.429,1,6,0.167,0,0,,0,3,3
10256,Mario Hezonja,21-254,F-G,11/5/16,ORL,,WAS,W,0,26,4,9,0.444,4,5,0.8,0,4,0,1,2,0.5,0,2,2
10257,Roy Hibbert,29-340,C,11/15/16,CHO,@,MIN,W,0,12,4,5,0.8,4,5,0.8,0,0,,1,2,0.5,2,2,4
10258,Buddy Hield,22-326,G,11/7/16,NOP,@,GSW,L,0,28,4,10,0.4,3,5,0.6,1,5,0.2,0,0,,2,4,6
10259,Buddy Hield,23-021,G,1/7/17,NOP,@,BOS,L,1,24,3,9,0.333,0,4,0,3,5,0.6,0,0,,0,5,5
10260,Buddy Hield,22-329,G,11/10/16,NOP,@,MIL,W,0,16,3,7,0.429,0,1,0,3,6,0.5,0,0,,1,3,4
10261,Buddy Hield,22-360,G,12/11/16,NOP,@,PHO,W,1,13,3,7,0.429,1,3,0.333,2,4,0.5,1,2,0.5,0,1,1
10262,Nene Hilario,34-085,F-C,12/7/16,HOU,,LAL,W,0,19,3,4,0.75,3,4,0.75,0,0,,3,6,0.5,3,5,8
10263,Nene Hilario,34-163,F-C,2/23/17,HOU,@,NOP,W,1,19,4,8,0.5,4,8,0.5,0,0,,1,3,0.333,1,2,3
10264,Nene Hilario,34-111,F-C,1/2/17,HOU,,WAS,W,0,14,4,6,0.667,4,6,0.667,0,0,,1,4,0.25,1,2,3
10265,Nene Hilario,34-124,F-C,1/15/17,HOU,@,BRK,W,0,14,4,6,0.667,4,6,0.667,0,0,,1,4,0.25,2,1,3
10266,Nene Hilario,34-174,F-C,3/6/17,HOU,@,SAS,L,0,19,4,6,0.667,4,6,0.667,0,0,,1,3,0.333,1,2,3
10267,Nene Hilario,34-120,F-C,1/11/17,HOU,@,MIN,L,0,15,4,6,0.667,3,5,0.6,1,1,1,0,0,,0,2,2
10268,George Hill,30-311,G,3/11/17,UTA,@,OKC,L,1,18,3,6,0.5,2,5,0.4,1,1,1,2,2,1,0,1,1
10269,George Hill,30-264,G,1/23/17,UTA,,OKC,L,1,32,2,10,0.2,2,6,0.333,0,4,0,5,6,0.833,0,2,2
10270,George Hill,30-316,G,3/16/17,UTA,@,CLE,L,1,31,3,10,0.3,2,5,0.4,1,5,0.2,2,3,0.667,0,2,2
10271,Solomon Hill,25-262,F,12/5/16,NOP,,MEM,L,1,47,2,6,0.333,2,4,0.5,0,2,0,5,5,1,2,5,7
10272,Solomon Hill,25-331,F,2/12/17,NOP,@,SAC,L,1,34,3,5,0.6,0,0,,3,5,0.6,0,0,,0,2,2
10273,Solomon Hill,25-241,F,11/14/16,NOP,,BOS,W,0,32,2,5,0.4,1,1,1,1,4,0.25,4,4,1,1,6,7
10274,Solomon Hill,25-325,F,2/6/17,NOP,,PHO,W,1,31,3,8,0.375,3,6,0.5,0,2,0,3,3,1,2,0,2
10275,Solomon Hill,25-254,F,11/27/16,NOP,@,DAL,L,1,42,4,6,0.667,3,3,1,1,3,0.333,0,0,,0,4,4
10276,Solomon Hill,25-320,F,2/1/17,NOP,@,DET,L,1,35,3,7,0.429,0,1,0,3,6,0.5,0,0,,0,4,4
10277,Darrun Hilliard,23-226,G,11/25/16,DET,,LAC,W,0,19,4,6,0.667,4,5,0.8,0,1,0,1,1,1,1,2,3
10278,Darrun Hilliard,23-237,G,12/6/16,DET,,CHI,W,0,17,4,7,0.571,3,4,0.75,1,3,0.333,0,0,,0,0,0
10279,Jrue Holiday,26-211,G,1/9/17,NOP,@,NYK,W,1,25,3,8,0.375,2,5,0.4,1,3,0.333,2,3,0.667,0,4,4
10280,Jrue Holiday,26-173,G,12/2/16,NOP,,LAC,L,1,28,4,12,0.333,3,9,0.333,1,3,0.333,0,0,,1,3,4
10281,Justin Holiday,27-250,G,12/11/16,NYK,@,LAL,W,0,16,3,6,0.5,2,3,0.667,1,3,0.333,2,3,0.667,0,3,3
10282,Justin Holiday,27-297,G,1/27/17,NYK,,CHO,W,0,20,3,6,0.5,2,2,1,1,4,0.25,2,2,1,0,5,5
10283,Justin Holiday,27-234,G,11/25/16,NYK,,CHO,W,0,16,4,6,0.667,3,4,0.75,1,2,0.5,0,0,,0,1,1
10284,Justin Holiday,27-311,G,2/10/17,NYK,,DEN,L,0,20,3,8,0.375,0,0,,3,8,0.375,0,0,,0,2,2
10285,Justin Holiday,27-279,G,1/9/17,NYK,,NOP,L,0,21,3,10,0.3,2,5,0.4,1,5,0.2,2,2,1,0,1,1
10286,Justin Holiday,27-225,G,11/16/16,NYK,,DET,W,0,24,3,7,0.429,2,4,0.5,1,3,0.333,2,2,1,2,3,5
10287,Rondae Hollis-Jefferson,21-348,F,12/16/16,BRK,@,ORL,L,0,19,3,3,1,3,3,1,0,0,,3,4,0.75,1,4,5
10288,Richaun Holmes,23-102,F-C,1/25/17,PHI,@,MIL,W,0,20,3,4,0.75,3,3,1,0,1,0,3,3,1,2,6,8
10289,Rodney Hood,24-080,G-F,1/8/17,UTA,@,MEM,L,1,31,4,14,0.286,3,7,0.429,1,7,0.143,0,0,,0,3,3
10290,Rodney Hood,24-039,G-F,11/28/16,UTA,@,MIN,W,1,32,4,12,0.333,3,7,0.429,1,5,0.2,0,0,,0,3,3
10291,Rodney Hood,24-075,G-F,1/3/17,UTA,@,BOS,L,1,35,3,10,0.3,3,7,0.429,0,3,0,3,6,0.5,0,3,3
10292,Rodney Hood,24-137,G-F,3/6/17,UTA,,NOP,W,0,20,2,7,0.286,1,3,0.333,1,4,0.25,4,4,1,0,1,1
10293,Al Horford,30-271,C-F,3/1/17,BOS,,CLE,W,1,32,3,6,0.5,2,5,0.4,1,1,1,2,2,1,2,8,10
10294,Al Horford,30-180,C-F,11/30/16,BOS,,DET,L,1,32,3,5,0.6,2,3,0.667,1,2,0.5,2,2,1,0,5,5
10295,Dwight Howard,31-087,C,3/5/17,ATL,,IND,L,1,35,2,3,0.667,2,3,0.667,0,0,,5,11,0.455,4,10,14
10296,Serge Ibaka,27-108,F-C,1/4/17,ORL,,ATL,L,1,33,4,13,0.308,4,9,0.444,0,4,0,1,1,1,4,7,11
10297,Serge Ibaka,27-174,F-C,3/11/17,TOR,@,MIA,L,1,28,3,11,0.273,2,7,0.286,1,4,0.25,2,2,1,0,4,4
10298,Andre Iguodala,33-039,G-F,3/8/17,GSW,,BOS,L,0,29,4,6,0.667,3,4,0.75,1,2,0.5,0,0,,0,3,3
10299,Andre Iguodala,32-298,G-F,11/21/16,GSW,@,IND,W,0,18,3,7,0.429,0,2,0,3,5,0.6,0,0,,0,0,0
10300,Andre Iguodala,32-348,G-F,1/10/17,GSW,,MIA,W,0,29,4,6,0.667,3,4,0.75,1,2,0.5,0,0,,1,4,5
10301,Andre Iguodala,33-000,G-F,1/28/17,GSW,,LAC,W,0,24,3,6,0.5,2,3,0.667,1,3,0.333,2,2,1,0,6,6
10302,Andre Iguodala,32-324,G-F,12/17/16,GSW,,POR,W,0,19,4,6,0.667,3,4,0.75,1,2,0.5,0,0,,0,3,3
10303,Andre Iguodala,32-274,G-F,10/28/16,GSW,@,NOP,W,0,30,4,7,0.571,3,4,0.75,1,3,0.333,0,0,,0,2,2
10304,Ersan Ilyasova,29-300,F,3/11/17,ATL,@,MEM,W,0,18,2,5,0.4,1,3,0.333,1,2,0.5,4,4,1,0,2,2
10305,Ersan Ilyasova,29-285,F,2/24/17,ATL,,MIA,L,0,16,3,7,0.429,3,5,0.6,0,2,0,3,3,1,1,1,2
10306,Ersan Ilyasova,29-181,F,11/12/16,PHI,@,ATL,L,0,24,4,12,0.333,3,7,0.429,1,5,0.2,0,0,,0,5,5
10307,Ersan Ilyasova,29-299,F,3/10/17,ATL,,TOR,W,0,25,3,7,0.429,1,3,0.333,2,4,0.5,1,2,0.5,0,6,6
10308,Joe Ingles,29-097,F-G,1/7/17,UTA,@,MIN,W,0,24,3,6,0.5,2,2,1,1,4,0.25,2,2,1,1,1,2
10309,Joe Ingles,29-090,F-G,12/31/16,UTA,,PHO,W,0,23,3,5,0.6,0,2,0,3,3,1,0,0,,0,0,0
10310,Joe Ingles,29-082,F-G,12/23/16,UTA,,TOR,L,0,29,2,6,0.333,0,2,0,2,4,0.5,3,3,1,0,2,2
10311,Brandon Ingram,19-065,F,11/6/16,LAL,,PHO,W,0,25,2,7,0.286,1,5,0.2,1,2,0.5,4,6,0.667,0,2,2
10312,Brandon Ingram,19-092,F,12/3/16,LAL,@,MEM,L,1,39,2,5,0.4,1,3,0.333,1,2,0.5,4,4,1,1,4,5
10313,Brandon Ingram,19-106,F,12/17/16,LAL,@,CLE,L,1,41,4,10,0.4,3,5,0.6,1,5,0.2,0,0,,2,8,10
10314,Brandon Ingram,19-103,F,12/14/16,LAL,@,BRK,L,0,26,3,9,0.333,3,7,0.429,0,2,0,3,6,0.5,0,1,1
10315,Brandon Ingram,19-058,F,10/30/16,LAL,@,OKC,L,0,21,3,10,0.3,3,7,0.429,0,3,0,3,4,0.75,1,4,5
10316,Brandon Ingram,19-088,F,11/29/16,LAL,@,NOP,L,0,29,4,10,0.4,3,7,0.429,1,3,0.333,0,1,0,0,3,3
10317,Brandon Ingram,19-132,F,1/12/17,LAL,@,SAS,L,0,32,3,7,0.429,2,4,0.5,1,3,0.333,2,4,0.5,0,2,2
10318,Brandon Ingram,19-054,F,10/26/16,LAL,,HOU,W,0,24,4,6,0.667,3,4,0.75,1,2,0.5,0,0,,0,3,3
10319,Brandon Ingram,19-098,F,12/9/16,LAL,,PHO,L,1,31,3,8,0.375,2,6,0.333,1,2,0.5,2,4,0.5,2,5,7
10320,Brandon Ingram,19-112,F,12/23/16,LAL,@,ORL,L,1,23,3,9,0.333,3,7,0.429,0,2,0,3,3,1,1,2,3
10321,Pierre Jackson,25-150,G,1/26/17,DAL,@,OKC,L,1,13,4,8,0.5,3,7,0.429,1,1,1,0,0,,1,1,2
10322,Reggie Jackson,26-303,G,2/13/17,DET,@,MIL,L,1,31,3,7,0.429,2,4,0.5,1,3,0.333,2,2,1,0,2,2
10323,Al Jefferson,32-023,C-F,1/27/17,IND,,SAC,W,0,12,4,9,0.444,4,9,0.444,0,0,,1,1,1,0,1,1
10324,Richard Jefferson,36-179,F,12/17/16,CLE,,LAL,W,0,18,4,7,0.571,3,5,0.6,1,2,0.5,0,0,,1,1,2
10325,Richard Jefferson,36-249,F,2/25/17,CLE,,CHI,L,1,31,3,4,0.75,2,2,1,1,2,0.5,2,2,1,0,3,3
10326,Richard Jefferson,36-261,F,3/9/17,CLE,@,DET,L,1,34,3,6,0.5,2,3,0.667,1,3,0.333,2,2,1,0,7,7
10327,Brandon Jennings,27-114,G,1/15/17,NYK,@,TOR,L,0,24,2,8,0.25,1,4,0.25,1,4,0.25,4,4,1,0,2,2
10328,Brandon Jennings,27-110,G,1/11/17,NYK,@,PHI,L,0,24,4,6,0.667,3,5,0.6,1,1,1,0,0,,0,3,3
10329,Brandon Jennings,27-122,G,1/23/17,NYK,@,IND,W,0,29,2,5,0.4,1,3,0.333,1,2,0.5,4,4,1,0,2,2
10330,Jonas Jerebko,29-262,F,11/19/16,BOS,@,DET,W,0,18,3,4,0.75,0,1,0,3,3,1,0,0,,1,5,6
10331,Jonas Jerebko,29-289,F,12/16/16,BOS,,CHO,W,0,25,4,8,0.5,3,3,1,1,5,0.2,0,0,,1,2,3
10332,Amir Johnson,29-231,F,12/18/16,BOS,@,MIA,W,1,20,4,5,0.8,3,4,0.75,1,1,1,0,0,,2,2,4
10333,Amir Johnson,29-197,F,11/14/16,BOS,@,NOP,L,1,27,3,7,0.429,2,4,0.5,1,3,0.333,2,2,1,2,3,5
10334,Amir Johnson,29-238,F,12/25/16,BOS,@,NYK,W,1,24,3,6,0.5,3,6,0.5,0,0,,3,4,0.75,4,1,5
10335,Amir Johnson,29-320,F,3/17/17,BOS,@,BRK,W,1,23,3,5,0.6,3,3,1,0,2,0,3,4,0.75,0,2,2
10336,James Johnson,29-271,F,11/17/16,MIA,,MIL,W,0,30,4,9,0.444,3,5,0.6,1,4,0.25,0,2,0,2,8,10
10337,James Johnson,29-338,F,1/23/17,MIA,,GSW,W,0,27,4,8,0.5,3,6,0.5,1,2,0.5,0,0,,1,1,2
10338,James Johnson,29-275,F,11/21/16,MIA,@,PHI,L,0,17,3,7,0.429,3,4,0.75,0,3,0,3,4,0.75,2,1,3
10339,Joe Johnson,35-131,G-F,11/7/16,UTA,@,PHI,W,0,22,4,8,0.5,3,6,0.5,1,2,0.5,0,0,,2,3,5
10340,Joe Johnson,35-143,G-F,11/19/16,UTA,@,HOU,L,0,22,4,8,0.5,3,4,0.75,1,4,0.25,0,0,,0,3,3
10341,Joe Johnson,35-141,G-F,11/17/16,UTA,,CHI,L,0,22,3,4,0.75,2,2,1,1,2,0.5,2,2,1,0,5,5
10342,Stanley Johnson,20-231,F,1/15/17,DET,@,LAL,W,0,34,4,9,0.444,3,6,0.5,1,3,0.333,0,0,,0,4,4
10343,Stanley Johnson,20-237,F,1/21/17,DET,,WAS,W,0,16,4,4,1,3,3,1,1,1,1,0,0,,0,0,0
10344,Tyler Johnson,24-210,G,12/3/16,MIA,@,POR,L,0,34,3,14,0.214,1,9,0.111,2,5,0.4,1,2,0.5,1,6,7
10345,Wesley Johnson,29-196,F-G,1/23/17,LAC,@,ATL,W,0,19,4,7,0.571,3,5,0.6,1,2,0.5,0,0,,2,6,8
10346,Nikola Jokic,21-278,C-F,11/23/16,DEN,@,UTA,L,0,23,4,6,0.667,4,6,0.667,0,0,,1,2,0.5,1,4,5
10347,Nikola Jokic,21-261,C-F,11/6/16,DEN,@,BOS,W,1,22,4,5,0.8,4,4,1,0,1,0,1,1,1,0,5,5
10348,Nikola Jokic,21-305,C-F,12/20/16,DEN,@,LAC,L,1,21,4,7,0.571,4,5,0.8,0,2,0,1,2,0.5,2,4,6
10349,James Jones,36-064,F-G,12/7/16,CLE,@,NYK,W,0,8,3,3,1,0,0,,3,3,1,0,0,,0,0,0
10350,James Jones,36-052,F-G,11/25/16,CLE,,DAL,W,0,6,3,3,1,0,0,,3,3,1,0,0,,0,0,0
10351,Terrence Jones,25-005,F,1/14/17,NOP,@,CHI,L,1,34,4,6,0.667,4,6,0.667,0,0,,1,2,0.5,1,7,8
10352,Terrence Jones,24-330,F,12/4/16,NOP,@,OKC,L,0,25,4,6,0.667,4,6,0.667,0,0,,1,2,0.5,1,6,7
10353,Terrence Jones,24-344,F,12/18/16,NOP,@,SAS,L,0,17,3,5,0.6,3,5,0.6,0,0,,3,6,0.5,1,1,2
10354,Tyus Jones,20-257,G,1/22/17,MIN,,DEN,W,0,19,3,8,0.375,2,7,0.286,1,1,1,2,3,0.667,0,0,0
10355,DeAndre Jordan,28-136,C,12/4/16,LAC,,IND,L,1,35,3,3,1,3,3,1,0,0,,3,5,0.6,4,11,15
10356,DeAndre Jordan,28-165,C,1/2/17,LAC,,PHO,W,1,31,3,6,0.5,3,6,0.5,0,0,,3,8,0.375,7,13,20
10357,DeAndre Jordan,28-200,C,2/6/17,LAC,@,TOR,L,1,25,4,6,0.667,4,6,0.667,0,0,,1,2,0.5,2,10,12
10358,DeAndre Jordan,28-133,C,12/1/16,LAC,@,CLE,W,1,30,4,8,0.5,4,8,0.5,0,0,,1,3,0.333,8,7,15
10359,DeAndre Jordan,28-163,C,12/31/16,LAC,@,OKC,L,1,27,4,5,0.8,4,5,0.8,0,0,,1,2,0.5,3,8,11
10360,DeAndre Jordan,28-196,C,2/2/17,LAC,,GSW,L,1,25,2,2,1,2,2,1,0,0,,5,8,0.625,0,7,7
10361,DeAndre Jordan,28-144,C,12/12/16,LAC,,POR,W,1,33,3,6,0.5,3,6,0.5,0,0,,3,4,0.75,6,6,12
10362,Cory Joseph,25-097,G,11/25/16,TOR,@,MIL,W,0,27,4,11,0.364,3,8,0.375,1,3,0.333,0,0,,1,3,4
10363,Cory Joseph,25-209,G,3/17/17,TOR,@,DET,W,1,36,3,10,0.3,2,5,0.4,1,5,0.2,2,2,1,0,7,7
10364,Cory Joseph,25-087,G,11/15/16,TOR,@,CLE,L,0,18,4,7,0.571,4,6,0.667,0,1,0,1,2,0.5,0,1,1
10365,Cory Joseph,25-205,G,3/13/17,TOR,,DAL,W,1,26,4,10,0.4,3,6,0.5,1,4,0.25,0,0,,1,0,1
10366,Frank Kaminsky,23-311,F-C,2/9/17,CHO,,HOU,L,0,20,3,9,0.333,3,6,0.5,0,3,0,3,3,1,0,3,3
10367,Frank Kaminsky,23-257,F-C,12/17/16,CHO,@,ATL,W,0,18,4,7,0.571,3,4,0.75,1,3,0.333,0,0,,0,2,2
10368,Frank Kaminsky,23-268,F-C,12/28/16,CHO,@,ORL,W,0,26,3,11,0.273,2,5,0.4,1,6,0.167,2,2,1,1,2,3
10369,Michael Kidd-Gilchrist,23-114,F,1/18/17,CHO,,POR,W,1,31,3,7,0.429,3,7,0.429,0,0,,3,4,0.75,1,4,5
10370,Michael Kidd-Gilchrist,23-124,F,1/28/17,CHO,,SAC,L,1,19,3,5,0.6,3,5,0.6,0,0,,3,4,0.75,1,5,6
10371,Michael Kidd-Gilchrist,23-060,F,11/25/16,CHO,@,NYK,L,1,29,4,6,0.667,4,6,0.667,0,0,,1,2,0.5,0,2,2
10372,Michael Kidd-Gilchrist,23-175,F,3/20/17,CHO,,ATL,W,1,21,4,8,0.5,4,8,0.5,0,0,,1,2,0.5,1,1,2
10373,Sean Kilpatrick,27-063,G,3/10/17,BRK,@,DAL,L,0,24,3,11,0.273,2,3,0.667,1,8,0.125,2,2,1,0,2,2
10374,Brandon Knight,24-333,G,10/30/16,PHO,,GSW,L,0,26,3,12,0.25,2,9,0.222,1,3,0.333,2,2,1,1,0,1
10375,Kyle Korver,35-265,G-F,12/7/16,ATL,,MIA,W,0,34,3,9,0.333,1,3,0.333,2,6,0.333,1,1,1,0,3,3
10376,Kyle Korver,35-308,G-F,1/19/17,CLE,,PHO,W,0,25,3,10,0.3,0,1,0,3,9,0.333,0,0,,0,5,5
10377,Kyle Korver,35-351,G-F,3/3/17,CLE,@,ATL,W,0,30,3,8,0.375,0,1,0,3,7,0.429,0,0,,0,2,2
10378,Kosta Koufos,28-022,C,3/18/17,SAC,@,OKC,L,1,23,3,8,0.375,3,8,0.375,0,0,,3,4,0.75,2,4,6
10379,Kosta Koufos,27-345,C,2/3/17,SAC,,PHO,L,1,16,4,6,0.667,4,6,0.667,0,0,,1,1,1,1,4,5
10380,Kosta Koufos,27-273,C,11/23/16,SAC,,OKC,W,0,17,4,7,0.571,4,7,0.571,0,0,,1,1,1,4,6,10
10381,Kosta Koufos,27-338,C,1/27/17,SAC,@,IND,L,1,28,4,6,0.667,4,6,0.667,0,0,,1,4,0.25,2,10,12
10382,Mindaugas Kuzminskas,27-105,F,2/1/17,NYK,@,BRK,W,0,17,4,10,0.4,3,8,0.375,1,2,0.5,0,0,,3,2,5
10383,Mindaugas Kuzminskas,27-075,F,1/2/17,NYK,,ORL,L,0,16,3,6,0.5,0,3,0,3,3,1,0,0,,0,1,1
10384,Mindaugas Kuzminskas,27-133,F,3/1/17,NYK,@,ORL,W,0,15,2,7,0.286,1,4,0.25,1,3,0.333,4,4,1,3,4,7
10385,Mindaugas Kuzminskas,27-088,F,1/15/17,NYK,@,TOR,L,0,23,3,8,0.375,2,3,0.667,1,5,0.2,2,2,1,1,1,2
10386,Jeremy Lamb,24-219,G-F,1/4/17,CHO,,OKC,W,0,12,3,4,0.75,2,3,0.667,1,1,1,2,3,0.667,0,1,1
10387,Joffrey Lauvergne,25-138,C-F,2/15/17,OKC,,NYK,W,0,17,3,8,0.375,2,6,0.333,1,2,0.5,2,2,1,0,2,2
10388,Joffrey Lauvergne,25-044,C-F,11/13/16,OKC,,ORL,L,0,15,3,4,0.75,0,1,0,3,3,1,0,0,,0,1,1
10389,Joffrey Lauvergne,25-074,C-F,12/13/16,OKC,@,POR,L,0,16,3,7,0.429,2,5,0.4,1,2,0.5,2,2,1,3,0,3
10390,Zach LaVine,21-315,G,1/19/17,MIN,@,LAC,W,1,40,3,13,0.231,2,7,0.286,1,6,0.167,2,2,1,0,6,6
10391,Ty Lawson,28-358,G,10/26/16,SAC,@,PHO,W,1,36,3,9,0.333,2,5,0.4,1,4,0.25,2,2,1,3,3,6
10392,Jake Layman,22-247,F,11/9/16,POR,@,LAC,L,0,16,4,8,0.5,3,3,1,1,5,0.2,0,0,,0,1,1
10393,Courtney Lee,31-073,G,12/15/16,NYK,@,GSW,L,1,33,4,11,0.364,4,8,0.5,0,3,0,1,2,0.5,0,4,4
10394,Courtney Lee,31-096,G,1/7/17,NYK,@,IND,L,1,28,3,9,0.333,2,6,0.333,1,3,0.333,2,2,1,0,4,4
10395,Courtney Lee,31-107,G,1/18/17,NYK,@,BOS,W,0,38,4,8,0.5,3,5,0.6,1,3,0.333,0,0,,2,6,8
10396,Courtney Lee,31-064,G,12/6/16,NYK,@,MIA,W,1,30,4,7,0.571,3,6,0.5,1,1,1,0,0,,1,6,7
10397,Courtney Lee,31-132,G,2/12/17,NYK,,SAS,W,1,35,4,9,0.444,3,7,0.429,1,2,0.5,0,0,,1,4,5
10398,David Lee,33-223,F,12/8/16,SAS,@,CHI,L,0,21,4,6,0.667,4,6,0.667,0,0,,1,2,0.5,2,2,4
10399,David Lee,33-240,F,12/25/16,SAS,,CHI,W,0,16,4,5,0.8,4,5,0.8,0,0,,1,1,1,0,2,2
10400,Alex Len,23-150,C,11/13/16,PHO,@,GSW,L,1,18,4,5,0.8,4,5,0.8,0,0,,1,1,1,1,5,6
10401,Alex Len,23-174,C,12/7/16,PHO,,IND,L,0,16,2,5,0.4,2,5,0.4,0,0,,5,5,1,1,1,2
10402,Alex Len,23-150,C,11/13/16,PHO,@,GSW,L,1,18,4,5,0.8,4,5,0.8,0,0,,1,1,1,1,5,6
10403,Alex Len,23-188,C,12/21/16,PHO,,HOU,L,0,24,4,5,0.8,4,5,0.8,0,0,,1,2,0.5,0,5,5
10404,Alex Len,23-201,C,1/3/17,PHO,,MIA,W,0,16,4,7,0.571,4,7,0.571,0,0,,1,2,0.5,2,6,8
10405,Alex Len,23-274,C,3/17/17,PHO,,ORL,L,1,28,3,12,0.25,3,12,0.25,0,0,,3,4,0.75,4,6,10
10406,Meyers Leonard,25-005,C-F,3/4/17,POR,,BRK,W,0,18,4,4,1,3,3,1,1,1,1,0,0,,1,2,3
10407,Meyers Leonard,24-284,C-F,12/7/16,POR,@,MIL,L,0,15,3,6,0.5,0,1,0,3,5,0.6,0,0,,0,3,3
10408,Meyers Leonard,25-015,C-F,3/14/17,POR,@,NOP,L,0,25,3,8,0.375,0,3,0,3,5,0.6,0,0,,1,6,7
10409,Jon Leuer,27-206,F,12/6/16,DET,,CHI,W,0,23,3,6,0.5,3,5,0.6,0,1,0,3,4,0.75,1,4,5
10410,Jon Leuer,27-228,F,12/28/16,DET,,MIL,L,1,29,4,11,0.364,3,9,0.333,1,2,0.5,0,0,,3,4,7
10411,Jon Leuer,27-165,F,10/26/16,DET,@,TOR,L,0,23,3,8,0.375,2,6,0.333,1,2,0.5,2,2,1,1,8,9
10412,Caris LeVert,22-169,G-F,2/10/17,BRK,,MIA,L,0,19,4,7,0.571,3,6,0.5,1,1,1,0,1,0,1,2,3
10413,Caris LeVert,22-167,G-F,2/8/17,BRK,,WAS,L,0,26,2,6,0.333,1,3,0.333,1,3,0.333,4,6,0.667,1,4,5
10414,Caris LeVert,22-120,G-F,12/23/16,BRK,@,CLE,L,0,24,2,7,0.286,0,2,0,2,5,0.4,3,4,0.75,1,6,7
10415,Caris LeVert,22-149,G-F,1/21/17,BRK,@,CHO,L,0,18,2,4,0.5,2,2,1,0,2,0,5,6,0.833,0,1,1
10416,DeAndre Liggins,28-317,G,2/11/17,CLE,,DEN,W,1,22,3,4,0.75,2,2,1,1,2,0.5,2,2,1,0,5,5
10417,Jeremy Lin,28-186,G,2/25/17,BRK,@,GSW,L,1,15,4,9,0.444,3,6,0.5,1,3,0.333,0,0,,0,0,0
10418,Shaun Livingston,31-091,G,12/11/16,GSW,@,MIN,W,0,19,4,5,0.8,4,5,0.8,0,0,,1,1,1,0,4,4
10419,Shaun Livingston,31-115,G,1/4/17,GSW,,POR,W,0,18,4,6,0.667,4,6,0.667,0,0,,1,1,1,1,3,4
10420,Brook Lopez,28-330,C,2/25/17,BRK,@,GSW,L,1,31,3,13,0.231,1,7,0.143,2,6,0.333,1,4,0.25,0,4,4
10421,Robin Lopez,28-295,C,1/21/17,CHI,,SAC,W,1,29,4,8,0.5,4,8,0.5,0,0,,1,2,0.5,4,4,8
10422,Timothe Luwawu-Cabarrot,21-273,F,2/6/17,PHI,@,DET,L,0,21,2,4,0.5,2,3,0.667,0,1,0,5,5,1,0,5,5
10423,Timothe Luwawu-Cabarrot,21-271,F,2/4/17,PHI,@,MIA,L,0,26,3,8,0.375,2,4,0.5,1,4,0.25,2,3,0.667,1,0,1
10424,Timothe Luwawu-Cabarrot,21-269,F,2/2/17,PHI,@,SAS,L,0,30,3,10,0.3,2,7,0.286,1,3,0.333,2,2,1,1,1,2
10425,Timothe Luwawu-Cabarrot,21-291,F,2/24/17,PHI,,WAS,W,0,18,2,3,0.667,1,1,1,1,2,0.5,4,4,1,0,0,0
10426,Timothe Luwawu-Cabarrot,21-306,F,3/11/17,PHI,@,LAC,L,1,33,3,8,0.375,2,3,0.667,1,5,0.2,2,2,1,1,4,5
10427,Trey Lyles,21-033,F,12/8/16,UTA,,GSW,L,0,23,4,13,0.308,3,7,0.429,1,6,0.167,0,0,,2,4,6
10428,Trey Lyles,21-079,F,1/23/17,UTA,,OKC,L,0,17,3,9,0.333,1,6,0.167,2,3,0.667,1,2,0.5,0,4,4
10429,Trey Lyles,21-030,F,12/5/16,UTA,@,LAL,W,0,25,4,10,0.4,3,7,0.429,1,3,0.333,0,0,,1,1,2
10430,Trey Lyles,21-061,F,1/5/17,UTA,@,TOR,L,0,12,3,6,0.5,0,2,0,3,4,0.75,0,0,,1,1,2
10431,Shelvin Mack,26-189,G,10/28/16,UTA,,LAL,W,0,23,4,8,0.5,4,7,0.571,0,1,0,1,2,0.5,0,4,4
10432,Shelvin Mack,26-203,G,11/11/16,UTA,@,ORL,W,0,26,3,9,0.333,2,6,0.333,1,3,0.333,2,2,1,1,5,6
10433,Shelvin Mack,26-249,G,12/27/16,UTA,@,LAL,W,1,33,4,8,0.5,4,5,0.8,0,3,0,1,3,0.333,0,1,1
10434,Shelvin Mack,26-221,G,11/29/16,UTA,,HOU,W,0,20,4,5,0.8,3,3,1,1,2,0.5,0,0,,0,0,0
10435,Ian Mahinmi,30-125,C,3/10/17,WAS,@,SAC,W,0,22,4,5,0.8,4,5,0.8,0,0,,1,2,0.5,3,4,7
10436,Thon Maker,20-021,F-C,3/18/17,MIL,@,GSW,L,1,13,3,5,0.6,3,3,1,0,2,0,3,4,0.75,3,2,5
10437,Jarell Martin,22-168,F,11/8/16,MEM,,DEN,W,0,17,3,4,0.75,2,3,0.667,1,1,1,2,2,1,1,2,3
10438,Wesley Matthews,30-025,G,11/8/16,DAL,@,LAL,W,1,38,4,10,0.4,3,6,0.5,1,4,0.25,0,0,,1,2,3
10439,Wesley Matthews,30-110,G,2/1/17,DAL,,PHI,W,1,31,3,9,0.333,2,5,0.4,1,4,0.25,2,2,1,0,6,6
10440,Wesley Matthews,30-023,G,11/6/16,DAL,,MIL,W,1,44,3,17,0.176,0,3,0,3,14,0.214,0,0,,0,1,1
10441,Wesley Matthews,30-085,G,1/7/17,DAL,,ATL,L,1,33,3,12,0.25,0,5,0,3,7,0.429,0,0,,0,4,4
10442,Wesley Matthews,30-147,G,3/10/17,DAL,,BRK,W,1,33,2,11,0.182,1,5,0.2,1,6,0.167,4,4,1,0,7,7
10443,Wesley Matthews,30-066,G,12/19/16,DAL,@,DEN,L,1,36,3,11,0.273,1,5,0.2,2,6,0.333,1,1,1,0,0,0
10444,Wesley Matthews,30-083,G,1/5/17,DAL,,PHO,L,1,36,3,12,0.25,2,4,0.5,1,8,0.125,2,2,1,0,2,2
10445,Wesley Matthews,30-035,G,11/18/16,DAL,,MEM,L,1,31,3,10,0.3,1,3,0.333,2,7,0.286,1,1,1,0,2,2
10446,Wesley Matthews,30-142,G,3/5/17,DAL,,OKC,W,1,32,3,8,0.375,2,4,0.5,1,4,0.25,2,2,1,0,0,0
10447,Wesley Matthews,30-136,G,2/27/17,DAL,,MIA,W,1,34,1,4,0.25,0,2,0,1,2,0.5,6,6,1,0,4,4
10448,Luc Mbah a Moute,30-117,F,1/4/17,LAC,,MEM,W,1,28,3,5,0.6,2,4,0.5,1,1,1,2,3,0.667,1,3,4
10449,Luc Mbah a Moute,30-187,F,3/15/17,LAC,,MIL,L,1,19,4,5,0.8,4,5,0.8,0,0,,1,1,1,0,1,1
10450,James Michael McAdoo,24-076,F,3/21/17,GSW,@,DAL,W,0,5,1,1,1,1,1,1,0,0,,7,8,0.875,0,2,2
10451,Patrick McCaw,21-132,G,3/6/17,GSW,@,ATL,W,1,27,3,6,0.5,0,2,0,3,4,0.75,0,0,,2,5,7
10452,Patrick McCaw,21-123,G,2/25/17,GSW,,BRK,W,1,25,3,7,0.429,2,2,1,1,5,0.2,2,2,1,0,4,4
10453,Patrick McCaw,21-041,G,12/5/16,GSW,,IND,W,0,15,3,8,0.375,0,2,0,3,6,0.5,0,0,,2,2,4
10454,C.J. McCollum,25-046,G,11/4/16,POR,@,DAL,W,1,23,4,11,0.364,3,6,0.5,1,5,0.2,0,1,0,1,4,5
10455,T.J. McConnell,24-351,G,3/11/17,PHI,@,LAC,L,1,30,4,9,0.444,3,5,0.6,1,4,0.25,0,0,,0,1,1
10456,T.J. McConnell,24-229,G,11/9/16,PHI,@,IND,L,0,21,4,7,0.571,4,4,1,0,3,0,1,2,0.5,0,1,1
10457,T.J. McConnell,24-311,G,1/30/17,PHI,,SAC,W,1,34,4,8,0.5,4,8,0.5,0,0,,1,1,1,0,2,2
10458,T.J. McConnell,24-287,G,1/6/17,PHI,@,BOS,L,1,37,4,6,0.667,4,6,0.667,0,0,,1,2,0.5,0,4,4
10459,T.J. McConnell,24-305,G,1/24/17,PHI,,LAC,W,1,28,4,9,0.444,4,8,0.5,0,1,0,1,1,1,0,0,0
10460,K.J. McDaniels,23-262,G-F,10/28/16,HOU,@,DAL,W,0,22,4,7,0.571,3,3,1,1,4,0.25,0,0,,1,1,2
10461,K.J. McDaniels,24-035,G-F,3/16/17,BRK,@,NYK,W,0,18,2,5,0.4,1,3,0.333,1,2,0.5,4,5,0.8,1,4,5
10462,Doug McDermott,25-024,F,1/27/17,CHI,,MIA,L,1,24,3,6,0.5,2,4,0.5,1,2,0.5,2,2,1,0,5,5
10463,Doug McDermott,25-058,F,3/2/17,OKC,@,POR,L,0,37,4,12,0.333,3,6,0.5,1,6,0.167,0,0,,1,3,4
10464,JaVale McGee,29-009,C,1/28/17,GSW,,LAC,W,0,10,4,5,0.8,4,5,0.8,0,0,,1,1,1,2,1,3
10465,JaVale McGee,28-321,C,12/5/16,GSW,,IND,W,0,15,4,8,0.5,4,7,0.571,0,1,0,1,2,0.5,5,3,8
10466,JaVale McGee,28-349,C,1/2/17,GSW,,DEN,W,0,9,4,4,1,4,4,1,0,0,,1,3,0.333,1,3,4
10467,JaVale McGee,28-329,C,12/13/16,GSW,@,NOP,W,1,16,4,5,0.8,4,5,0.8,0,0,,1,2,0.5,1,4,5
10468,JaVale McGee,29-013,C,2/1/17,GSW,,CHO,W,1,17,4,7,0.571,4,7,0.571,0,0,,1,1,1,1,3,4
10469,Rodney McGruder,25-182,G,1/27/17,MIA,@,CHI,W,1,28,3,4,0.75,2,3,0.667,1,1,1,2,2,1,0,4,4
10470,Rodney McGruder,25-091,G,10/28/16,MIA,,CHO,L,0,20,3,9,0.333,0,4,0,3,5,0.6,0,0,,1,1,2
10471,Rodney McGruder,25-125,G,12/1/16,MIA,@,UTA,W,1,36,2,4,0.5,1,2,0.5,1,2,0.5,4,4,1,1,4,5
10472,Ben McLemore,23-286,G,11/23/16,SAC,,OKC,W,0,17,4,10,0.4,3,7,0.429,1,3,0.333,0,0,,0,2,2
10473,Ben McLemore,24-004,G,2/15/17,SAC,@,GSW,L,1,33,3,10,0.3,0,4,0,3,6,0.5,0,0,,0,4,4
10474,Ben McLemore,23-300,G,12/7/16,SAC,@,DAL,W,1,21,3,11,0.273,2,5,0.4,1,6,0.167,2,2,1,0,1,1
10475,Jordan McRae,25-246,G,11/29/16,CLE,@,MIL,L,0,11,4,7,0.571,3,5,0.6,1,2,0.5,0,0,,2,1,3
10476,Jordan McRae,25-261,G,12/14/16,CLE,@,MEM,L,0,16,3,9,0.333,3,6,0.5,0,3,0,3,3,1,0,1,1
10477,Jordan McRae,25-233,G,11/16/16,CLE,@,IND,L,0,24,3,12,0.25,1,9,0.111,2,3,0.667,1,2,0.5,0,0,0
10478,Jodie Meeks,29-211,G,3/20/17,ORL,,PHI,W,0,20,1,9,0.111,1,6,0.167,0,3,0,7,9,0.778,0,4,4
10479,Jodie Meeks,29-108,G,12/7/16,ORL,,BOS,L,0,16,3,7,0.429,2,4,0.5,1,3,0.333,2,2,1,0,0,0
10480,Jodie Meeks,29-124,G,12/23/16,ORL,,LAL,W,1,27,3,11,0.273,2,5,0.4,1,6,0.167,2,2,1,0,5,5
10481,Khris Middleton,25-196,F-G,2/24/17,MIL,,UTA,L,0,24,2,9,0.222,1,7,0.143,1,2,0.5,4,4,1,1,2,3
10482,C.J. Miles,29-231,G-F,12/5/16,IND,@,GSW,L,0,18,3,6,0.5,1,1,1,2,5,0.4,1,1,1,0,3,3
10483,C.J. Miles,29-283,G-F,1/26/17,IND,@,MIN,W,1,29,3,5,0.6,0,1,0,3,4,0.75,0,0,,0,6,6
10484,C.J. Miles,29-315,G-F,2/27/17,IND,@,HOU,W,1,17,3,7,0.429,0,2,0,3,5,0.6,0,0,,0,1,1
10485,C.J. Miles,29-331,G-F,3/15/17,IND,,CHO,W,1,18,3,6,0.5,2,2,1,1,4,0.25,2,2,1,0,1,1
10486,C.J. Miles,29-194,G-F,10/29/16,IND,@,CHI,L,0,20,4,11,0.364,3,9,0.333,1,2,0.5,0,0,,0,1,1
10487,C.J. Miles,29-275,G-F,1/18/17,IND,@,SAC,W,0,21,3,8,0.375,1,2,0.5,2,6,0.333,1,3,0.333,1,1,2
10488,C.J. Miles,29-291,G-F,2/3/17,IND,@,BRK,W,1,30,3,10,0.3,0,2,0,3,8,0.375,0,0,,0,4,4
10489,Mike Miller,36-265,F-G,11/10/16,DEN,,GSW,L,0,9,3,4,0.75,0,0,,3,4,0.75,0,0,,0,1,1
10490,Patty Mills,28-186,G,2/13/17,SAS,@,IND,W,0,18,3,8,0.375,0,2,0,3,6,0.5,0,0,,0,0,0
10491,Patty Mills,28-199,G,2/26/17,SAS,@,LAL,W,0,17,4,8,0.5,3,4,0.75,1,4,0.25,0,0,,0,2,2
10492,Paul Millsap,31-291,F,11/27/16,ATL,@,LAL,L,1,30,4,11,0.364,3,7,0.429,1,4,0.25,0,0,,1,4,5
10493,Paul Millsap,31-357,F,2/1/17,ATL,@,MIA,L,1,24,4,12,0.333,4,9,0.444,0,3,0,1,1,1,2,5,7
10494,Nikola Mirotic,25-349,F,1/25/17,CHI,,ATL,L,0,18,3,11,0.273,2,6,0.333,1,5,0.2,2,2,1,0,3,3
10495,Nikola Mirotic,25-303,F,12/10/16,CHI,,MIA,W,0,22,4,6,0.667,3,3,1,1,3,0.333,0,0,,0,5,5
10496,Nikola Mirotic,25-301,F,12/8/16,CHI,,SAS,W,0,22,4,8,0.5,3,3,1,1,5,0.2,0,0,,0,6,6
10497,Nikola Mirotic,25-361,F,2/6/17,CHI,@,SAC,W,0,25,3,11,0.273,0,2,0,3,9,0.333,0,0,,0,3,3
10498,Greg Monroe,26-290,C-F,3/21/17,MIL,@,POR,W,0,22,4,12,0.333,4,12,0.333,0,0,,1,2,0.5,6,3,9
10499,Greg Monroe,26-231,C-F,1/21/17,MIL,@,MIA,L,0,17,3,7,0.429,3,7,0.429,0,0,,3,4,0.75,3,3,6
10500,E'Twaun Moore,27-325,G,1/18/17,NOP,,ORL,W,0,26,4,7,0.571,3,5,0.6,1,2,0.5,0,0,,0,1,1
10501,E'Twaun Moore,27-304,G,12/28/16,NOP,,LAC,W,0,20,4,7,0.571,3,4,0.75,1,3,0.333,0,0,,0,3,3
10502,E'Twaun Moore,27-339,G,2/1/17,NOP,@,DET,L,0,28,4,8,0.5,3,6,0.5,1,2,0.5,0,0,,0,2,2
10503,E'Twaun Moore,28-017,G,3/17/17,NOP,,HOU,W,0,26,3,9,0.333,2,5,0.4,1,4,0.25,2,2,1,0,5,5
10504,E'Twaun Moore,27-287,G,12/11/16,NOP,@,PHO,W,0,22,3,7,0.429,1,3,0.333,2,4,0.5,1,2,0.5,0,2,2
10505,Marcus Morris,27-130,F,1/10/17,DET,@,SAC,L,1,31,4,11,0.364,3,7,0.429,1,4,0.25,0,0,,1,2,3
10506,Marcus Morris,27-106,F,12/17/16,DET,,IND,L,1,34,4,7,0.571,3,4,0.75,1,3,0.333,0,0,,0,1,1
10507,Anthony Morrow,31-077,G,12/13/16,OKC,@,POR,L,0,20,4,11,0.364,3,6,0.5,1,5,0.2,0,0,,1,1,2
10508,Anthony Morrow,31-091,G,12/27/16,OKC,@,MIA,W,1,20,3,7,0.429,2,2,1,1,5,0.2,2,2,1,0,0,0
10509,Timofey Mozgov,30-164,C,12/27/16,LAL,,UTA,L,1,26,3,8,0.375,3,8,0.375,0,0,,3,4,0.75,4,0,4
10510,Timofey Mozgov,30-194,C,1/26/17,LAL,@,UTA,L,1,17,4,9,0.444,4,9,0.444,0,0,,1,2,0.5,2,7,9
10511,Emmanuel Mudiay,20-313,G,1/12/17,DEN,,IND,W,1,22,3,7,0.429,1,2,0.5,2,5,0.4,1,2,0.5,0,2,2
10512,Emmanuel Mudiay,20-272,G,12/2/16,DEN,,HOU,L,1,29,3,12,0.25,2,6,0.333,1,6,0.167,2,2,1,1,2,3
10513,Emmanuel Mudiay,20-296,G,12/26/16,DEN,@,LAC,W,1,18,3,7,0.429,1,2,0.5,2,5,0.4,1,2,0.5,0,2,2
10514,Emmanuel Mudiay,20-361,G,3/1/17,DEN,@,MIL,W,0,18,4,9,0.444,3,6,0.5,1,3,0.333,0,0,,0,4,4
10515,Shabazz Muhammad,23-351,F-G,10/29/16,MIN,@,SAC,L,0,11,3,3,1,3,3,1,0,0,,3,3,1,0,1,1
10516,Dejounte Murray,20-095,G,12/23/16,SAS,@,POR,W,1,20,4,8,0.5,3,7,0.429,1,1,1,0,0,,1,2,3
10517,Jamal Murray,19-256,G,11/5/16,DEN,@,DET,L,1,27,4,10,0.4,3,6,0.5,1,4,0.25,0,0,,0,1,1
10518,Jamal Murray,19-267,G,11/16/16,DEN,,PHO,W,0,20,3,8,0.375,0,4,0,3,4,0.75,0,0,,0,1,1
10519,Jamal Murray,19-281,G,11/30/16,DEN,,MIA,L,0,23,3,10,0.3,1,4,0.25,2,6,0.333,1,1,1,0,3,3
10520,Jamal Murray,20-001,G,2/24/17,DEN,,BRK,W,0,26,3,14,0.214,1,9,0.111,2,5,0.4,1,2,0.5,0,2,2
10521,Jamal Murray,19-278,G,11/27/16,DEN,@,PHO,W,0,22,3,8,0.375,2,4,0.5,1,4,0.25,2,2,1,1,3,4
10522,Jamal Murray,19-344,G,2/1/17,DEN,,MEM,L,0,32,3,16,0.188,2,9,0.222,1,7,0.143,2,2,1,1,3,4
10523,Jamal Murray,19-257,G,11/6/16,DEN,@,BOS,W,0,13,3,7,0.429,1,3,0.333,2,4,0.5,1,1,1,0,1,1
10524,Mike Muscala,25-193,F-C,1/10/17,ATL,@,BRK,W,0,23,3,6,0.5,2,4,0.5,1,2,0.5,2,2,1,0,4,4
10525,Mike Muscala,25-188,F-C,1/5/17,ATL,@,NOP,W,0,20,4,9,0.444,3,8,0.375,1,1,1,0,0,,4,2,6
10526,Mike Muscala,25-216,F-C,2/2/17,ATL,@,HOU,W,0,20,4,7,0.571,4,4,1,0,3,0,1,2,0.5,2,6,8
10527,Mike Muscala,25-150,F-C,11/28/16,ATL,@,GSW,L,0,20,4,5,0.8,3,3,1,1,2,0.5,0,1,0,2,2,4
10528,Mike Muscala,25-118,F-C,10/27/16,ATL,,WAS,W,0,26,3,6,0.5,2,4,0.5,1,2,0.5,2,2,1,1,3,4
10529,Jameer Nelson,34-348,G,1/22/17,DEN,@,MIN,L,1,28,4,9,0.444,4,6,0.667,0,3,0,1,2,0.5,0,2,2
10530,Jameer Nelson,34-260,G,10/26/16,DEN,@,NOP,W,0,20,4,8,0.5,3,4,0.75,1,4,0.25,0,0,,0,2,2
10531,Jameer Nelson,34-305,G,12/10/16,DEN,@,ORL,W,0,26,4,9,0.444,3,7,0.429,1,2,0.5,0,0,,0,2,2
10532,Jameer Nelson,34-357,G,1/31/17,DEN,@,LAL,L,1,37,4,15,0.267,3,13,0.231,1,2,0.5,0,0,,1,4,5
10533,Jameer Nelson,34-273,G,11/8/16,DEN,@,MEM,L,0,23,3,5,0.6,2,3,0.667,1,2,0.5,2,2,1,0,1,1
10534,Jameer Nelson,34-271,G,11/6/16,DEN,@,BOS,W,0,36,3,7,0.429,2,4,0.5,1,3,0.333,2,2,1,0,3,3
10535,Jameer Nelson,34-315,G,12/20/16,DEN,@,LAC,L,0,22,4,7,0.571,3,4,0.75,1,3,0.333,0,0,,0,1,1
10536,Andrew Nicholson,26-333,F,11/5/16,WAS,@,ORL,L,0,10,4,10,0.4,4,9,0.444,0,1,0,1,1,1,3,1,4
10537,Andrew Nicholson,26-324,F,10/27/16,WAS,@,ATL,L,0,19,3,6,0.5,2,4,0.5,1,2,0.5,2,2,1,2,5,7
10538,Joakim Noah,31-260,C,11/11/16,NYK,@,BOS,L,1,22,4,5,0.8,4,5,0.8,0,0,,1,1,1,3,7,10
10539,Nerlens Noel,22-321,C-F,2/25/17,DAL,,NOP,W,0,30,3,8,0.375,3,8,0.375,0,0,,3,4,0.75,4,6,10
10540,Nerlens Noel,22-341,C-F,3/17/17,DAL,@,PHI,L,0,19,4,7,0.571,4,7,0.571,0,0,,1,2,0.5,3,2,5
10541,Nerlens Noel,22-264,C-F,12/30/16,PHI,@,DEN,W,0,19,4,7,0.571,4,7,0.571,0,0,,1,4,0.25,1,1,2
10542,Lucas Nogueira,24-150,C,12/23/16,TOR,@,UTA,W,0,32,4,5,0.8,3,4,0.75,1,1,1,0,0,,2,4,6
10543,Lucas Nogueira,24-185,C,1/27/17,TOR,,MIL,W,0,24,4,7,0.571,4,7,0.571,0,0,,1,1,1,4,1,5
10544,Lucas Nogueira,24-165,C,1/7/17,TOR,@,CHI,L,1,42,2,5,0.4,2,4,0.5,0,1,0,5,7,0.714,2,6,8
10545,Dirk Nowitzki,38-232,F,2/6/17,DAL,@,DEN,L,1,24,4,8,0.5,4,7,0.571,0,1,0,1,2,0.5,0,6,6
10546,Dirk Nowitzki,38-229,F,2/3/17,DAL,@,POR,W,1,32,3,9,0.333,0,4,0,3,5,0.6,0,0,,0,5,5
10547,Dirk Nowitzki,38-136,F,11/2/16,DAL,@,UTA,L,1,29,4,14,0.286,4,9,0.444,0,5,0,1,1,1,1,4,5
10548,Jusuf Nurkic,22-165,C,2/4/17,DEN,@,SAS,L,0,24,4,8,0.5,4,8,0.5,0,0,,1,4,0.25,5,3,8
10549,Jusuf Nurkic,22-079,C,11/10/16,DEN,,GSW,L,1,17,4,5,0.8,4,5,0.8,0,0,,1,2,0.5,1,2,3
10550,Kyle O'Quinn,26-286,F-C,1/6/17,NYK,@,MIL,W,0,26,4,9,0.444,4,9,0.444,0,0,,1,2,0.5,4,4,8
10551,Kyle O'Quinn,26-336,F-C,2/25/17,NYK,,PHI,W,0,25,3,6,0.5,3,6,0.5,0,0,,3,4,0.75,3,2,5
10552,Jahlil Okafor,21-049,C-F,2/2/17,PHI,@,SAS,L,1,25,4,12,0.333,4,12,0.333,0,0,,1,1,1,3,6,9
10553,Victor Oladipo,24-194,G,11/14/16,OKC,@,DET,L,1,23,4,17,0.235,3,10,0.3,1,7,0.143,0,1,0,1,1,2
10554,Victor Oladipo,24-318,G,3/18/17,OKC,,SAC,W,1,31,4,15,0.267,3,10,0.3,1,5,0.2,0,0,,0,4,4
10555,Victor Oladipo,24-182,G,11/2/16,OKC,@,LAC,W,1,33,3,11,0.273,2,6,0.333,1,5,0.2,2,3,0.667,0,5,5
10556,Kelly Olynyk,25-220,C-F,11/25/16,BOS,,SAS,L,0,20,4,6,0.667,3,4,0.75,1,2,0.5,0,0,,1,0,1
10557,Kelly Olynyk,25-335,C-F,3/20/17,BOS,,WAS,W,0,18,4,8,0.5,3,6,0.5,1,2,0.5,0,0,,4,7,11
10558,Kelly Olynyk,25-232,C-F,12/7/16,BOS,@,ORL,W,0,20,4,8,0.5,4,5,0.8,0,3,0,1,1,1,1,3,4
10559,Kelly Olynyk,25-332,C-F,3/17/17,BOS,@,BRK,W,0,19,4,6,0.667,4,5,0.8,0,1,0,1,2,0.5,1,5,6
10560,Kelly Olynyk,25-295,C-F,2/8/17,BOS,@,SAC,L,0,15,4,7,0.571,4,7,0.571,0,0,,1,2,0.5,3,5,8
10561,Zaza Pachulia,33-028,C,3/10/17,GSW,@,MIN,L,1,26,4,4,1,4,4,1,0,0,,1,2,0.5,1,4,5
10562,Jabari Parker,21-257,F,11/27/16,MIL,@,ORL,W,1,29,3,8,0.375,2,6,0.333,1,2,0.5,2,3,0.667,1,6,7
10563,Tony Parker,34-161,G,10/25/16,SAS,@,GSW,W,1,26,4,9,0.444,3,7,0.429,1,2,0.5,0,0,,0,3,3
10564,Chandler Parsons,28-075,F,1/8/17,MEM,,UTA,W,1,16,3,4,0.75,1,1,1,2,3,0.667,1,1,1,0,1,1
10565,Chandler Parsons,28-020,F,11/14/16,MEM,@,UTA,W,1,23,3,6,0.5,3,4,0.75,0,2,0,3,3,1,0,4,4
10566,Chandler Parsons,28-113,F,2/15/17,MEM,,NOP,L,1,19,3,6,0.5,2,2,1,1,4,0.25,2,2,1,0,1,1
10567,Chandler Parsons,28-014,F,11/8/16,MEM,,DEN,W,1,21,4,8,0.5,4,5,0.8,0,3,0,1,1,1,0,3,3
10568,Patrick Patterson,27-359,F,3/8/17,TOR,@,NOP,W,0,24,3,4,0.75,1,1,1,2,3,0.667,1,2,0.5,0,1,1
10569,Patrick Patterson,27-275,F,12/14/16,TOR,@,PHI,W,0,28,3,6,0.5,1,2,0.5,2,4,0.5,1,2,0.5,2,3,5
10570,Chris Paul,31-177,G,10/30/16,LAC,,UTA,W,1,29,3,8,0.375,2,5,0.4,1,3,0.333,2,2,1,0,3,3
10571,Chris Paul,31-183,G,11/5/16,LAC,@,SAS,W,1,29,4,11,0.364,4,10,0.4,0,1,0,1,1,1,1,7,8
10572,Chris Paul,31-194,G,11/16/16,LAC,,MEM,L,1,34,3,11,0.273,2,7,0.286,1,4,0.25,2,4,0.5,0,2,2
10573,Cameron Payne,22-163,G,1/18/17,OKC,@,GSW,L,0,25,3,8,0.375,2,3,0.667,1,5,0.2,2,2,1,0,1,1
10574,Cameron Payne,22-179,G,2/3/17,OKC,,MEM,W,0,19,4,7,0.571,3,5,0.6,1,2,0.5,0,0,,0,1,1
10575,Elfrid Payton,22-296,G,12/14/16,ORL,,LAC,L,0,26,4,12,0.333,3,9,0.333,1,3,0.333,0,0,,0,3,3
10576,Elfrid Payton,23-001,G,2/23/17,ORL,,POR,L,1,22,4,8,0.5,4,7,0.571,0,1,0,1,4,0.25,1,1,2
10577,Elfrid Payton,22-275,G,11/23/16,ORL,,PHO,L,1,31,3,11,0.273,3,10,0.3,0,1,0,3,5,0.6,3,3,6
10578,Elfrid Payton,22-321,G,1/8/17,ORL,@,LAL,L,1,19,4,11,0.364,3,9,0.333,1,2,0.5,0,0,,3,3,6
10579,Mason Plumlee,26-341,C-F,2/9/17,POR,,BOS,L,1,30,3,5,0.6,3,5,0.6,0,0,,3,6,0.5,3,4,7
10580,Mason Plumlee,26-255,C-F,11/15/16,POR,,CHI,L,1,22,3,7,0.429,3,7,0.429,0,0,,3,6,0.5,4,2,6
10581,Mason Plumlee,27-013,C-F,3/18/17,DEN,,HOU,L,1,31,3,5,0.6,3,5,0.6,0,0,,3,4,0.75,1,8,9
10582,Mason Plumlee,26-335,C-F,2/3/17,POR,,DAL,L,1,31,4,7,0.571,4,7,0.571,0,0,,1,2,0.5,4,5,9
10583,Mason Plumlee,26-293,C-F,12/23/16,POR,,SAS,L,1,15,4,6,0.667,4,6,0.667,0,0,,1,2,0.5,1,4,5
10584,Mason Plumlee,26-262,C-F,11/22/16,POR,@,NYK,L,1,28,4,5,0.8,4,5,0.8,0,0,,1,3,0.333,4,5,9
10585,Miles Plumlee,28-079,C-F,11/19/16,MIL,,GSW,L,0,15,3,4,0.75,3,4,0.75,0,0,,3,3,1,5,0,5
10586,Otto Porter,23-171,F,11/21/16,WAS,,PHO,W,1,23,3,7,0.429,3,4,0.75,0,3,0,3,4,0.75,2,7,9
10587,Otto Porter,23-188,F,12/8/16,WAS,,DEN,W,1,36,4,9,0.444,3,5,0.6,1,4,0.25,0,0,,0,5,5
10588,Otto Porter,23-198,F,12/18/16,WAS,,LAC,W,1,33,3,7,0.429,3,5,0.6,0,2,0,3,4,0.75,2,2,4
10589,Otto Porter,23-192,F,12/12/16,WAS,@,MIA,L,1,37,4,7,0.571,3,4,0.75,1,3,0.333,0,1,0,0,4,4
10590,Bobby Portis,21-271,F,11/7/16,CHI,,ORL,W,0,17,3,4,0.75,3,4,0.75,0,0,,3,4,0.75,3,3,6
10591,Bobby Portis,22-039,F,3/21/17,CHI,@,TOR,L,0,21,3,8,0.375,2,4,0.5,1,4,0.25,2,2,1,0,5,5
10592,Bobby Portis,22-014,F,2/24/17,CHI,,PHO,W,1,16,4,9,0.444,3,8,0.375,1,1,1,0,0,,2,5,7
10593,Kristaps Porzingis,21-186,F-C,2/4/17,NYK,,CLE,L,1,29,3,10,0.3,2,7,0.286,1,3,0.333,2,5,0.4,1,7,8
10594,Kristaps Porzingis,21-160,F-C,1/9/17,NYK,,NOP,L,1,24,3,13,0.231,3,9,0.333,0,4,0,3,4,0.75,0,4,4
10595,Dwight Powell,25-206,F-C,2/11/17,DAL,,ORL,W,0,17,4,6,0.667,3,5,0.6,1,1,1,0,0,,2,1,3
10596,Dwight Powell,25-154,F-C,12/21/16,DAL,@,POR,W,0,24,1,2,0.5,1,2,0.5,0,0,,7,9,0.778,5,3,8
10597,Dwight Powell,25-147,F-C,12/14/16,DAL,,DET,L,0,20,4,6,0.667,4,6,0.667,0,0,,1,1,1,0,1,1
10598,Norman Powell,23-300,G,3/21/17,TOR,,CHI,W,0,17,3,9,0.333,3,7,0.429,0,2,0,3,5,0.6,1,1,2
10599,Norman Powell,23-168,G,11/9/16,TOR,@,OKC,W,0,23,4,8,0.5,4,7,0.571,0,1,0,1,3,0.333,0,2,2
10600,Julius Randle,21-339,F,11/2/16,LAL,@,ATL,W,1,28,3,7,0.429,3,6,0.5,0,1,0,3,4,0.75,2,4,6
10601,Julius Randle,21-338,F,11/1/16,LAL,@,IND,L,1,20,3,6,0.5,3,5,0.6,0,1,0,3,3,1,0,10,10
10602,Julius Randle,22-054,F,1/22/17,LAL,@,DAL,L,1,23,4,4,1,4,4,1,0,0,,1,2,0.5,0,6,6
10603,Zach Randolph,35-157,F,12/20/16,MEM,,BOS,L,0,21,4,14,0.286,4,12,0.333,0,2,0,1,2,0.5,2,3,5
10604,Zach Randolph,35-203,F,2/4/17,MEM,@,MIN,W,1,31,3,15,0.2,3,12,0.25,0,3,0,3,5,0.6,4,6,10
10605,Zach Randolph,35-238,F,3/11/17,MEM,,ATL,L,0,18,4,7,0.571,4,6,0.667,0,1,0,1,2,0.5,1,1,2
10606,J.J. Redick,32-234,G,2/13/17,LAC,@,UTA,W,1,25,3,10,0.3,1,3,0.333,2,7,0.286,1,1,1,0,2,2
10607,J.J. Redick,32-128,G,10/30/16,LAC,,UTA,W,1,28,4,8,0.5,3,5,0.6,1,3,0.333,0,0,,0,0,0
10608,J.J. Redick,32-209,G,1/19/17,LAC,,MIN,L,1,31,4,11,0.364,3,8,0.375,1,3,0.333,0,0,,1,1,2
10609,Josh Richardson,23-178,G,3/12/17,MIA,@,IND,L,1,37,2,7,0.286,2,4,0.5,0,3,0,5,6,0.833,5,3,8
10610,Josh Richardson,23-098,G,12/22/16,MIA,,LAL,W,1,37,4,11,0.364,3,8,0.375,1,3,0.333,0,0,,1,4,5
10611,Josh Richardson,23-096,G,12/20/16,MIA,,ORL,L,1,44,2,12,0.167,0,4,0,2,8,0.25,3,4,0.75,1,3,4
10612,Josh Richardson,23-111,G,1/4/17,MIA,@,SAC,W,1,37,4,11,0.364,3,4,0.75,1,7,0.143,0,0,,0,8,8
10613,Josh Richardson,23-092,G,12/16/16,MIA,,LAC,L,0,30,3,11,0.273,3,8,0.375,0,3,0,3,3,1,0,1,1
10614,Austin Rivers,24-163,G,1/11/17,LAC,,ORL,W,1,33,3,7,0.429,2,4,0.5,1,3,0.333,2,4,0.5,0,4,4
10615,Austin Rivers,24-141,G,12/20/16,LAC,,DEN,W,0,22,3,8,0.375,2,4,0.5,1,4,0.25,2,4,0.5,0,0,0
10616,Austin Rivers,24-154,G,1/2/17,LAC,,PHO,W,1,37,2,11,0.182,1,8,0.125,1,3,0.333,4,5,0.8,0,4,4
10617,Austin Rivers,24-151,G,12/30/16,LAC,@,HOU,L,1,15,3,8,0.375,2,5,0.4,1,3,0.333,2,3,0.667,0,1,1
10618,Austin Rivers,24-100,G,11/9/16,LAC,,POR,W,0,30,3,10,0.3,1,5,0.2,2,5,0.4,1,1,1,0,4,4
10619,Andre Roberson,25-093,G-F,3/7/17,OKC,,POR,L,1,35,4,7,0.571,3,3,1,1,4,0.25,0,0,,2,4,6
10620,Andre Roberson,25-005,G-F,12/9/16,OKC,,HOU,L,1,37,3,7,0.429,1,2,0.5,2,5,0.4,1,4,0.25,1,7,8
10621,Andre Roberson,24-337,G-F,11/5/16,OKC,,MIN,W,1,25,3,6,0.5,1,3,0.333,2,3,0.667,1,2,0.5,0,1,1
10622,Andre Roberson,25-017,G-F,12/21/16,OKC,@,NOP,W,1,29,4,7,0.571,3,4,0.75,1,3,0.333,0,0,,1,6,7
10623,Andre Roberson,25-084,G-F,2/26/17,OKC,,NOP,W,1,30,4,4,1,3,3,1,1,1,1,0,0,,0,6,6
10624,Andre Roberson,25-027,G-F,12/31/16,OKC,,LAC,W,1,31,3,11,0.273,2,4,0.5,1,7,0.143,2,2,1,1,2,3
10625,Andre Roberson,24-329,G-F,10/28/16,OKC,,PHO,W,1,40,3,4,0.75,2,3,0.667,1,1,1,2,2,1,0,11,11
10626,Glenn Robinson,23-066,G-F,3/15/17,IND,,CHO,W,0,16,4,5,0.8,3,3,1,1,2,0.5,0,0,,0,5,5
10627,Glenn Robinson,22-359,G-F,1/1/17,IND,,ORL,W,1,32,2,6,0.333,1,3,0.333,1,3,0.333,4,4,1,0,8,8
10628,Glenn Robinson,23-008,G-F,1/16/17,IND,,NOP,W,1,30,4,6,0.667,3,3,1,1,3,0.333,0,2,0,1,4,5
10629,Glenn Robinson,22-315,G-F,11/18/16,IND,,PHO,L,0,25,4,6,0.667,4,6,0.667,0,0,,1,1,1,0,3,3
10630,Thomas Robinson,25-346,F,2/26/17,LAL,,SAS,L,0,17,4,7,0.571,4,7,0.571,0,0,,1,2,0.5,4,4,8
10631,Thomas Robinson,25-255,F,11/27/16,LAL,,ATL,W,1,15,4,11,0.364,4,11,0.364,0,0,,1,2,0.5,5,3,8
10632,Sergio Rodriguez,30-226,G,1/24/17,PHI,,LAC,W,0,20,4,12,0.333,3,7,0.429,1,5,0.2,0,0,,0,3,3
10633,Sergio Rodriguez,30-162,G,11/21/16,PHI,,MIA,W,1,20,4,4,1,3,3,1,1,1,1,0,0,,0,0,0
10634,Sergio Rodriguez,30-191,G,12/20/16,PHI,,NOP,L,1,31,3,11,0.273,1,4,0.25,2,7,0.286,1,2,0.5,0,2,2
10635,Sergio Rodriguez,30-189,G,12/18/16,PHI,,BRK,W,1,23,3,11,0.273,0,6,0,3,5,0.6,0,0,,1,1,2
10636,Sergio Rodriguez,30-280,G,3/19/17,PHI,,BOS,W,0,20,4,6,0.667,3,4,0.75,1,2,0.5,0,0,,1,2,3
10637,Rajon Rondo,30-271,G,11/19/16,CHI,@,LAC,L,1,35,4,7,0.571,3,4,0.75,1,3,0.333,0,0,,4,6,10
10638,Rajon Rondo,30-259,G,11/7/16,CHI,,ORL,W,1,22,3,7,0.429,3,7,0.429,0,0,,3,6,0.5,1,2,3
10639,Rajon Rondo,30-257,G,11/5/16,CHI,@,IND,L,1,29,4,11,0.364,3,9,0.333,1,2,0.5,0,0,,0,1,1
10640,Terrence Ross,25-307,F-G,12/8/16,TOR,,MIN,W,0,16,3,7,0.429,2,2,1,1,5,0.2,2,2,1,0,0,0
10641,Terry Rozier,22-347,G,2/27/17,BOS,,ATL,L,0,20,4,9,0.444,3,7,0.429,1,2,0.5,0,0,,1,4,5
10642,Ricky Rubio,26-129,G,2/27/17,MIN,@,SAC,W,1,32,3,8,0.375,2,7,0.286,1,1,1,2,2,1,0,5,5
10643,Ricky Rubio,26-151,G,3/21/17,MIN,,SAS,L,1,30,3,10,0.3,2,8,0.25,1,2,0.5,2,2,1,1,6,7
10644,Ricky Rubio,26-043,G,12/3/16,MIN,@,CHO,W,1,37,2,7,0.286,1,5,0.2,1,2,0.5,4,5,0.8,1,6,7
10645,Damjan Rudez,30-175,F,12/9/16,ORL,@,CHO,L,0,8,4,6,0.667,3,3,1,1,3,0.333,0,0,,0,2,2
10646,Brandon Rush,31-218,G-F,2/10/17,MIN,,NOP,L,1,25,3,7,0.429,1,2,0.5,2,5,0.4,1,2,0.5,0,3,3
10647,Brandon Rush,31-117,G-F,11/1/16,MIN,,MEM,W,0,19,3,6,0.5,1,3,0.333,2,3,0.667,1,2,0.5,0,1,1
10648,D'Angelo Russell,20-248,G,10/28/16,LAL,@,UTA,L,1,32,3,14,0.214,2,9,0.222,1,5,0.2,2,5,0.4,2,3,5
10649,D'Angelo Russell,20-324,G,1/12/17,LAL,@,SAS,L,1,27,4,13,0.308,3,10,0.3,1,3,0.333,0,0,,0,1,1
10650,D'Angelo Russell,20-322,G,1/10/17,LAL,,POR,L,1,30,4,14,0.286,4,7,0.571,0,7,0,1,4,0.25,0,8,8
10651,Domantas Sabonis,20-228,F,12/17/16,OKC,,PHO,W,1,24,3,9,0.333,2,8,0.25,1,1,1,2,4,0.5,0,4,4
10652,Domantas Sabonis,20-297,F,2/24/17,OKC,,LAL,W,1,23,4,7,0.571,3,5,0.6,1,2,0.5,0,1,0,0,3,3
10653,Domantas Sabonis,20-242,F,12/31/16,OKC,,LAC,W,1,25,4,10,0.4,3,6,0.5,1,4,0.25,0,0,,2,2,4
10654,Domantas Sabonis,20-284,F,2/11/17,OKC,,GSW,L,1,26,3,7,0.429,3,6,0.5,0,1,0,3,4,0.75,1,3,4
10655,Domantas Sabonis,20-249,F,1/7/17,OKC,,DEN,W,1,19,2,7,0.286,2,5,0.4,0,2,0,5,5,1,1,4,5
10656,Dario Saric,22-281,F,1/14/17,PHI,@,WAS,L,0,26,3,7,0.429,1,2,0.5,2,5,0.4,1,2,0.5,0,4,4
10657,Tomas Satoransky,25-089,G,1/27/17,WAS,@,ATL,W,0,18,4,5,0.8,3,4,0.75,1,1,1,0,0,,1,2,3
10658,Dennis Schroder,23-069,G,11/23/16,ATL,@,IND,W,1,25,3,11,0.273,2,8,0.25,1,3,0.333,2,2,1,1,2,3
10659,Dennis Schroder,23-134,G,1/27/17,ATL,,WAS,L,1,23,3,11,0.273,2,6,0.333,1,5,0.2,2,2,1,0,0,0
10660,Luis Scola,36-192,F,11/8/16,BRK,,MIN,W,0,17,4,6,0.667,4,5,0.8,0,1,0,1,2,0.5,3,3,6
10661,Luis Scola,36-234,F,12/20/16,BRK,@,TOR,L,1,18,4,10,0.4,3,7,0.429,1,3,0.333,0,0,,4,1,5
10662,Thabo Sefolosha,32-315,G-F,3/13/17,ATL,@,SAS,L,1,27,3,8,0.375,3,7,0.429,0,1,0,3,4,0.75,1,4,5
10663,Thabo Sefolosha,32-210,G-F,11/28/16,ATL,@,GSW,L,0,26,3,8,0.375,3,8,0.375,0,0,,3,4,0.75,0,5,5
10664,Thabo Sefolosha,32-299,G-F,2/25/17,ATL,@,ORL,L,0,19,4,9,0.444,3,6,0.5,1,3,0.333,0,0,,0,0,0
10665,Thabo Sefolosha,32-310,G-F,3/8/17,ATL,,BRK,W,1,31,4,8,0.5,4,5,0.8,0,3,0,1,2,0.5,1,7,8
10666,Kevin Seraphin,27-071,F,2/16/17,IND,,WAS,L,1,25,4,8,0.5,4,8,0.5,0,0,,1,2,0.5,2,3,5
10667,Ramon Sessions,30-262,G,12/29/16,CHO,,MIA,W,0,18,3,9,0.333,3,7,0.429,0,2,0,3,3,1,1,0,1
10668,Ramon Sessions,30-229,G,11/26/16,CHO,,NYK,W,0,15,2,3,0.667,1,1,1,1,2,0.5,4,7,0.571,1,1,2
10669,Ramon Sessions,30-259,G,12/26/16,CHO,@,BRK,L,0,15,2,6,0.333,1,3,0.333,1,3,0.333,4,4,1,0,0,0
10670,Ramon Sessions,30-287,G,1/23/17,CHO,,WAS,L,0,14,3,6,0.5,2,4,0.5,1,2,0.5,2,2,1,0,1,1
10671,Ramon Sessions,30-236,G,12/3/16,CHO,,MIN,L,0,16,2,5,0.4,2,3,0.667,0,2,0,5,6,0.833,0,0,0
10672,Ramon Sessions,30-268,G,1/4/17,CHO,,OKC,W,0,15,3,5,0.6,2,3,0.667,1,2,0.5,2,3,0.667,0,2,2
10673,Iman Shumpert,26-220,G,2/1/17,CLE,,MIN,W,1,28,3,9,0.333,0,2,0,3,7,0.429,0,0,,1,6,7
10674,Iman Shumpert,26-263,G,3/16/17,CLE,,UTA,W,1,22,4,11,0.364,3,5,0.6,1,6,0.167,0,0,,0,3,3
10675,Iman Shumpert,26-145,G,11/18/16,CLE,,DET,W,0,17,3,5,0.6,1,2,0.5,2,3,0.667,1,1,1,0,0,0
10676,Iman Shumpert,26-233,G,2/14/17,CLE,@,MIN,W,1,26,3,9,0.333,0,1,0,3,8,0.375,0,0,,0,0,0
10677,Iman Shumpert,26-251,G,3/4/17,CLE,@,MIA,L,1,27,3,7,0.429,2,5,0.4,1,2,0.5,2,2,1,0,0,0
10678,Iman Shumpert,26-159,G,12/2/16,CLE,@,CHI,L,0,19,4,6,0.667,3,4,0.75,1,2,0.5,0,0,,0,3,3
10679,Pascal Siakam,22-320,F,12/20/16,TOR,,BRK,W,1,28,3,3,1,3,3,1,0,0,,3,4,0.75,0,3,3
10680,Pascal Siakam,22-282,F,11/12/16,TOR,,NYK,W,1,20,4,5,0.8,4,5,0.8,0,0,,1,1,1,0,2,2
10681,Jonathon Simmons,27-056,G-F,11/9/16,SAS,,HOU,L,0,21,3,4,0.75,3,4,0.75,0,0,,3,3,1,0,3,3
10682,Marcus Smart,22-328,G,1/28/17,BOS,@,MIL,W,0,35,2,6,0.333,2,5,0.4,0,1,0,5,7,0.714,0,4,4
10683,Marcus Smart,22-311,G,1/11/17,BOS,,WAS,W,1,36,3,11,0.273,3,6,0.5,0,5,0,3,3,1,2,2,4
10684,Marcus Smart,22-260,G,11/21/16,BOS,@,MIN,W,0,31,3,9,0.333,0,3,0,3,6,0.5,0,0,,0,6,6
10685,Marcus Smart,22-360,G,3/1/17,BOS,,CLE,W,0,33,4,9,0.444,3,7,0.429,1,2,0.5,0,0,,0,2,2
10686,Marcus Smart,22-303,G,1/3/17,BOS,,UTA,W,0,28,3,5,0.6,2,4,0.5,1,1,1,2,2,1,1,0,1
10687,Marcus Smart,22-334,G,2/3/17,BOS,,LAL,W,0,32,3,10,0.3,1,5,0.2,2,5,0.4,1,2,0.5,0,3,3
10688,Marcus Smart,22-251,G,11/12/16,BOS,@,IND,W,1,34,4,11,0.364,4,9,0.444,0,2,0,1,2,0.5,1,1,2
10689,Marcus Smart,22-298,G,12/29/16,BOS,@,CLE,L,0,31,3,7,0.429,2,2,1,1,5,0.2,2,2,1,0,1,1
10690,Marcus Smart,22-264,G,11/25/16,BOS,,SAS,L,0,27,3,9,0.333,3,6,0.5,0,3,0,3,3,1,3,1,4
10691,Marcus Smart,22-313,G,1/13/17,BOS,@,ATL,W,1,37,2,13,0.154,1,9,0.111,1,4,0.25,4,6,0.667,2,0,2
10692,Ish Smith,28-171,G,12/23/16,DET,,GSW,L,0,18,4,7,0.571,3,6,0.5,1,1,1,0,1,0,0,1,1
10693,Ish Smith,28-127,G,11/9/16,DET,@,PHO,L,1,32,3,13,0.231,3,12,0.25,0,1,0,3,4,0.75,1,2,3
10694,Ish Smith,28-187,G,1/8/17,DET,@,POR,W,0,21,4,6,0.667,3,5,0.6,1,1,1,0,0,,0,2,2
10695,Ish Smith,28-120,G,11/2/16,DET,@,BRK,L,1,31,3,9,0.333,2,8,0.25,1,1,1,2,2,1,0,2,2
10696,Ish Smith,28-200,G,1/21/17,DET,,WAS,W,0,16,4,8,0.5,4,8,0.5,0,0,,1,2,0.5,0,2,2
10697,Ish Smith,28-174,G,12/26/16,DET,,CLE,W,0,18,4,7,0.571,3,6,0.5,1,1,1,0,0,,0,2,2
10698,J.R. Smith,31-070,G-F,11/18/16,CLE,,DET,W,1,25,3,7,0.429,0,1,0,3,6,0.5,0,0,,0,1,1
10699,J.R. Smith,31-084,G-F,12/2/16,CLE,@,CHI,L,1,33,3,8,0.375,0,0,,3,8,0.375,0,0,,0,2,2
10700,Jason Smith,31-008,F-C,3/10/17,WAS,@,SAC,W,0,24,4,4,1,3,3,1,1,1,1,0,0,,0,6,6
10701,Jason Smith,30-339,F-C,2/4/17,WAS,,NOP,W,0,14,4,4,1,4,4,1,0,0,,1,2,0.5,1,4,5
10702,Jason Smith,30-348,F-C,2/13/17,WAS,,OKC,W,0,21,4,5,0.8,3,4,0.75,1,1,1,0,0,,3,3,6
10703,Tony Snell,25-002,G-F,11/12/16,MIL,,MEM,W,1,26,3,8,0.375,0,1,0,3,7,0.429,0,0,,0,1,1
10704,Tony Snell,25-035,G-F,12/15/16,MIL,,CHI,W,1,31,4,10,0.4,3,8,0.375,1,2,0.5,0,0,,0,4,4
10705,Tony Snell,25-076,G-F,1/25/17,MIL,,PHI,L,1,31,3,6,0.5,1,1,1,2,5,0.4,1,2,0.5,0,3,3
10706,Tony Snell,25-074,G-F,1/23/17,MIL,,HOU,W,1,24,3,3,1,0,0,,3,3,1,0,0,,0,2,2
10707,Tony Snell,25-009,G-F,11/19/16,MIL,,GSW,L,1,29,4,7,0.571,3,5,0.6,1,2,0.5,0,0,,0,6,6
10708,Tony Snell,25-027,G-F,12/7/16,MIL,,POR,W,1,29,2,5,0.4,0,0,,2,5,0.4,3,4,0.75,0,2,2
10709,Marreese Speights,29-102,C-F,11/14/16,LAC,,BRK,W,0,18,3,8,0.375,1,4,0.25,2,4,0.5,1,2,0.5,1,5,6
10710,Marreese Speights,29-163,C-F,1/14/17,LAC,,LAL,W,0,15,3,4,0.75,1,1,1,2,3,0.667,1,1,1,0,2,2
10711,Marreese Speights,29-130,C-F,12/12/16,LAC,,POR,W,0,15,3,7,0.429,2,4,0.5,1,3,0.333,2,2,1,2,2,4
10712,Marreese Speights,29-144,C-F,12/26/16,LAC,,DEN,L,0,15,3,7,0.429,1,3,0.333,2,4,0.5,1,2,0.5,0,2,2
10713,Marreese Speights,29-181,C-F,2/1/17,LAC,@,PHO,W,0,21,2,7,0.286,1,5,0.2,1,2,0.5,4,4,1,2,5,7
10714,Marreese Speights,29-173,C-F,1/24/17,LAC,@,PHI,L,0,13,3,6,0.5,0,1,0,3,5,0.6,0,0,,0,1,1
10715,Marreese Speights,29-151,C-F,1/2/17,LAC,,PHO,W,0,18,1,4,0.25,0,2,0,1,2,0.5,6,6,1,0,6,6
10716,Marreese Speights,29-092,C-F,11/4/16,LAC,@,MEM,W,0,12,3,6,0.5,1,2,0.5,2,4,0.5,1,2,0.5,1,1,2
10717,Nik Stauskas,23-163,G,3/19/17,PHI,,BOS,W,0,30,3,7,0.429,0,0,,3,7,0.429,0,0,,0,6,6
10718,Nik Stauskas,23-112,G,1/27/17,PHI,,HOU,L,1,28,4,12,0.333,3,7,0.429,1,5,0.2,0,0,,0,2,2
10719,Nik Stauskas,23-145,G,3/1/17,PHI,@,MIA,L,0,26,3,12,0.25,2,9,0.222,1,3,0.333,2,3,0.667,0,2,2
10720,Nik Stauskas,23-161,G,3/17/17,PHI,,DAL,W,0,26,3,10,0.3,0,2,0,3,8,0.375,0,0,,2,5,7
10721,Nik Stauskas,23-155,G,3/11/17,PHI,@,LAC,L,0,28,3,10,0.3,1,4,0.25,2,6,0.333,1,3,0.333,0,3,3
10722,Nik Stauskas,23-031,G,11/7/16,PHI,,UTA,L,0,22,3,6,0.5,2,3,0.667,1,3,0.333,2,2,1,1,2,3
10723,Nik Stauskas,23-083,G,12/29/16,PHI,@,UTA,L,1,34,3,9,0.333,2,5,0.4,1,4,0.25,2,2,1,0,5,5
10724,Rodney Stuckey,30-309,G,2/24/17,IND,,MEM,W,0,15,2,7,0.286,1,5,0.2,1,2,0.5,4,4,1,1,2,3
10725,Rodney Stuckey,30-325,G,3/12/17,IND,,MIA,W,0,20,3,6,0.5,2,5,0.4,1,1,1,2,2,1,0,2,2
10726,Rodney Stuckey,30-223,G,11/30/16,IND,@,POR,L,0,24,2,6,0.333,2,5,0.4,0,1,0,5,6,0.833,0,1,1
10727,Rodney Stuckey,30-232,G,12/9/16,IND,@,DAL,L,0,27,2,3,0.667,1,1,1,1,2,0.5,4,4,1,0,5,5
10728,Rodney Stuckey,30-291,G,2/6/17,IND,,OKC,W,0,14,2,6,0.333,2,5,0.4,0,1,0,5,5,1,0,1,1
10729,Jared Sullinger,24-324,F,1/22/17,TOR,,PHO,L,0,12,3,6,0.5,2,4,0.5,1,2,0.5,2,2,1,0,3,3
10730,Jeff Teague,28-168,G,11/25/16,IND,,BRK,W,1,24,4,8,0.5,4,7,0.571,0,1,0,1,1,1,1,8,9
10731,Jeff Teague,28-183,G,12/10/16,IND,,POR,W,1,30,3,7,0.429,1,5,0.2,2,2,1,1,2,0.5,0,1,1
10732,Jeff Teague,28-150,G,11/7/16,IND,@,CHO,L,1,19,3,8,0.375,2,5,0.4,1,3,0.333,2,2,1,1,0,1
10733,Jeff Teague,28-144,G,11/1/16,IND,,LAL,W,1,33,4,15,0.267,3,8,0.375,1,7,0.143,0,2,0,1,5,6
10734,Jeff Teague,28-277,G,3/14/17,IND,@,NYK,L,1,32,4,15,0.267,3,9,0.333,1,6,0.167,0,1,0,1,8,9
10735,Mirza Teletovic,31-074,F,12/1/16,MIL,@,BRK,W,0,19,3,8,0.375,0,0,,3,8,0.375,0,0,,0,7,7
10736,Mirza Teletovic,31-049,F,11/6/16,MIL,@,DAL,L,0,23,3,9,0.333,0,2,0,3,7,0.429,0,0,,3,3,6
10737,Mirza Teletovic,31-093,F,12/20/16,MIL,,CLE,L,0,19,4,9,0.444,3,4,0.75,1,5,0.2,0,0,,1,4,5
10738,Mirza Teletovic,31-106,F,1/2/17,MIL,,OKC,W,0,16,3,7,0.429,1,2,0.5,2,5,0.4,1,1,1,0,2,2
10739,Garrett Temple,30-255,G,1/18/17,SAC,,IND,L,0,29,4,8,0.5,3,3,1,1,5,0.2,0,0,,1,3,4
10740,Garrett Temple,30-201,G,11/25/16,SAC,,HOU,L,0,24,3,6,0.5,2,2,1,1,4,0.25,2,2,1,0,3,3
10741,Garrett Temple,30-229,G,12/23/16,SAC,@,MIN,W,0,26,3,6,0.5,2,3,0.667,1,3,0.333,2,2,1,2,4,6
10742,Garrett Temple,30-176,G,10/31/16,SAC,@,ATL,L,0,25,4,8,0.5,3,6,0.5,1,2,0.5,0,0,,0,2,2
10743,Jason Terry,39-085,G,12/9/16,MIL,,ATL,L,0,20,3,5,0.6,0,0,,3,5,0.6,0,0,,1,3,4
10744,Jason Terry,39-065,G,11/19/16,MIL,,GSW,L,0,19,3,5,0.6,0,1,0,3,4,0.75,0,0,,0,2,2
10745,Jason Terry,39-141,G,2/3/17,MIL,@,DEN,L,0,26,3,4,0.75,0,0,,3,4,0.75,0,0,,0,2,2
10746,Lance Thomas,28-305,F,2/23/17,NYK,@,CLE,L,0,31,3,7,0.429,2,5,0.4,1,2,0.5,2,2,1,2,3,5
10747,Lance Thomas,28-260,F,1/9/17,NYK,,NOP,L,0,19,2,5,0.4,0,3,0,2,2,1,3,4,0.75,1,0,1
10748,Lance Thomas,28-324,F,3/14/17,NYK,,IND,W,1,33,3,9,0.333,0,2,0,3,7,0.429,0,0,,2,5,7
10749,Lance Thomas,28-224,F,12/4/16,NYK,,SAC,W,0,17,2,8,0.25,0,4,0,2,4,0.5,3,4,0.75,0,3,3
10750,Tristan Thompson,25-306,F-C,1/13/17,CLE,@,SAC,W,1,26,3,6,0.5,3,5,0.6,0,1,0,3,6,0.5,1,3,4
10751,Tristan Thompson,25-304,F-C,1/11/17,CLE,@,POR,L,1,28,4,6,0.667,4,6,0.667,0,0,,1,2,0.5,5,5,10
10752,Tristan Thompson,25-353,F-C,3/1/17,CLE,@,BOS,L,1,35,4,11,0.364,4,11,0.364,0,0,,1,4,0.25,6,7,13
10753,Marcus Thornton,29-160,G,11/12/16,WAS,@,CHI,L,0,23,4,14,0.286,4,10,0.4,0,4,0,1,1,1,2,2,4
10754,Marcus Thornton,29-153,G,11/5/16,WAS,@,ORL,L,0,17,4,8,0.5,3,5,0.6,1,3,0.333,0,0,,0,4,4
10755,Marcus Thornton,29-169,G,11/21/16,WAS,,PHO,W,0,21,3,9,0.333,0,4,0,3,5,0.6,0,0,,0,0,0
10756,Anthony Tolliver,31-198,F-C,12/16/16,SAC,@,MEM,W,0,30,2,6,0.333,1,2,0.5,1,4,0.25,4,4,1,2,0,2
10757,Anthony Tolliver,31-256,F-C,2/12/17,SAC,,NOP,W,0,24,3,9,0.333,0,2,0,3,7,0.429,0,0,,0,6,6
10758,Anthony Tolliver,31-291,F-C,3/19/17,SAC,@,SAS,L,0,19,3,4,0.75,1,2,0.5,2,2,1,1,2,0.5,1,2,3
10759,Karl-Anthony Towns,21-008,F-C,11/23/16,MIN,@,NOP,L,1,27,4,11,0.364,3,8,0.375,1,3,0.333,0,0,,3,8,11
10760,P.J. Tucker,31-303,F,3/4/17,TOR,@,MIL,L,0,29,3,10,0.3,1,5,0.2,2,5,0.4,1,2,0.5,0,4,4
10761,P.J. Tucker,31-318,F,3/19/17,TOR,,IND,W,0,26,4,9,0.444,3,5,0.6,1,4,0.25,0,0,,0,4,4
10762,P.J. Tucker,31-212,F,12/3/16,PHO,@,GSW,L,1,28,4,11,0.364,3,6,0.5,1,5,0.2,0,0,,5,2,7
10763,P.J. Tucker,31-191,F,11/12/16,PHO,,BRK,L,0,19,2,5,0.4,2,2,1,0,3,0,5,5,1,2,4,6
10764,P.J. Tucker,31-295,F,2/24/17,TOR,,BOS,W,0,29,2,5,0.4,1,4,0.25,1,1,1,4,6,0.667,3,7,10
10765,P.J. Tucker,31-286,F,2/15/17,PHO,,LAL,W,0,21,3,6,0.5,2,4,0.5,1,2,0.5,2,2,1,1,2,3
10766,P.J. Tucker,31-220,F,12/11/16,PHO,,NOP,L,1,42,3,11,0.273,0,5,0,3,6,0.5,0,0,,2,8,10
10767,Evan Turner,28-060,G,12/26/16,POR,,TOR,L,0,27,3,9,0.333,2,6,0.333,1,3,0.333,2,2,1,0,3,3
10768,Evan Turner,28-037,G,12/3/16,POR,,MIA,W,0,28,3,10,0.3,3,8,0.375,0,2,0,3,5,0.6,1,5,6
10769,Evan Turner,28-049,G,12/15/16,POR,@,DEN,L,0,25,3,11,0.273,3,10,0.3,0,1,0,3,4,0.75,2,3,5
10770,Myles Turner,20-235,F-C,11/14/16,IND,,ORL,W,1,24,4,11,0.364,4,11,0.364,0,0,,1,1,1,0,7,7
10771,Myles Turner,20-294,F-C,1/12/17,IND,@,DEN,L,1,21,4,13,0.308,3,12,0.25,1,1,1,0,0,,2,4,6
10772,Myles Turner,20-222,F-C,11/1/16,IND,,LAL,W,1,25,2,7,0.286,2,6,0.333,0,1,0,5,7,0.714,0,6,6
10773,Beno Udrih,34-192,G,1/13/17,DET,@,UTA,L,0,21,4,8,0.5,3,5,0.6,1,3,0.333,0,0,,0,1,1
10774,Beno Udrih,34-130,G,11/12/16,DET,@,DEN,W,0,18,4,7,0.571,3,4,0.75,1,3,0.333,0,0,,0,0,0
10775,Tyler Ulis,20-319,G,11/19/16,PHO,@,PHI,L,0,22,3,7,0.429,3,7,0.429,0,0,,3,4,0.75,0,4,4
10776,Tyler Ulis,21-054,G,2/28/17,PHO,@,MEM,L,0,17,3,6,0.5,2,5,0.4,1,1,1,2,2,1,0,0,0
10777,Tyler Ulis,21-075,G,3/21/17,PHO,@,MIA,L,1,42,4,11,0.364,4,10,0.4,0,1,0,1,3,0.333,0,3,3
10778,Jonas Valanciunas,24-263,C,1/24/17,TOR,,SAS,L,1,29,2,7,0.286,2,7,0.286,0,0,,5,6,0.833,3,10,13
10779,Denzel Valentine,23-047,G,1/2/17,CHI,,CHO,W,0,18,3,6,0.5,0,1,0,3,5,0.6,0,0,,0,0,0
10780,Noah Vonleh,21-085,F,11/17/16,POR,@,HOU,L,0,16,3,5,0.6,2,3,0.667,1,2,0.5,2,2,1,0,3,3
10781,Nikola Vucevic,26-074,C,1/6/17,ORL,,HOU,L,0,28,4,15,0.267,3,14,0.214,1,1,1,0,0,,5,7,12
10782,Dion Waiters,24-321,G,10/26/16,MIA,@,ORL,W,1,34,4,13,0.308,4,12,0.333,0,1,0,1,2,0.5,1,5,6
10783,Dion Waiters,24-325,G,10/30/16,MIA,,SAS,L,1,33,3,9,0.333,1,6,0.167,2,3,0.667,1,2,0.5,0,2,2
10784,Dion Waiters,25-027,G,1/6/17,MIA,@,LAL,L,0,21,4,12,0.333,4,9,0.444,0,3,0,1,1,1,0,1,1
10785,John Wall,26-127,G,1/11/17,WAS,@,BOS,L,1,39,4,21,0.19,4,16,0.25,0,5,0,1,2,0.5,3,4,7
10786,Taurean Waller-Prince,22-248,F,11/25/16,ATL,@,UTA,L,0,19,3,6,0.5,0,1,0,3,5,0.6,0,0,,0,4,4
10787,T.J. Warren,23-122,F,1/5/17,PHO,@,DAL,W,1,24,4,11,0.364,4,9,0.444,0,2,0,1,2,0.5,1,4,5
10788,C.J. Watson,32-276,G,1/18/17,ORL,@,NOP,L,0,19,3,5,0.6,1,2,0.5,2,3,0.667,1,1,1,1,2,3
10789,C.J. Watson,32-330,G,3/13/17,ORL,@,SAC,L,0,18,4,8,0.5,3,4,0.75,1,4,0.25,0,0,,0,1,1
10790,C.J. Watson,32-285,G,1/27/17,ORL,@,BOS,L,1,32,3,7,0.429,2,4,0.5,1,3,0.333,2,2,1,0,1,1
10791,C.J. Watson,32-328,G,3/11/17,ORL,,CLE,L,0,18,2,4,0.5,1,2,0.5,1,2,0.5,4,4,1,0,2,2
10792,C.J. Watson,32-216,G,11/19/16,ORL,,DAL,W,0,19,2,4,0.5,1,2,0.5,1,2,0.5,4,4,1,0,0,0
10793,David West,36-203,F,3/20/17,GSW,@,OKC,W,0,16,4,7,0.571,4,7,0.571,0,0,,1,2,0.5,0,6,6
10794,David West,36-103,F,12/10/16,GSW,@,MEM,L,0,15,3,3,1,1,1,1,2,2,1,1,2,0.5,0,3,3
10795,Isaiah Whitehead,21-354,G,2/25/17,BRK,@,GSW,L,0,23,4,10,0.4,4,9,0.444,0,1,0,1,2,0.5,1,4,5
10796,Isaiah Whitehead,21-293,G,12/26/16,BRK,,CHO,W,0,16,4,7,0.571,3,5,0.6,1,2,0.5,0,0,,0,2,2
10797,Hassan Whiteside,27-229,C,1/28/17,MIA,,DET,W,1,29,4,9,0.444,4,9,0.444,0,0,,1,2,0.5,4,8,12
10798,Hassan Whiteside,27-171,C,12/1/16,MIA,@,UTA,W,1,36,4,11,0.364,4,11,0.364,0,0,,1,2,0.5,2,8,10
10799,Deron Williams,32-160,G,12/3/16,DAL,,CHI,W,1,31,3,11,0.273,3,8,0.375,0,3,0,3,3,1,0,2,2
10800,Deron Williams,32-157,G,11/30/16,DAL,,SAS,L,1,26,4,12,0.333,3,9,0.333,1,3,0.333,0,0,,1,7,8
10801,Deron Williams,32-154,G,11/27/16,DAL,,NOP,W,1,20,3,10,0.3,3,6,0.5,0,4,0,3,3,1,0,2,2
10802,Deron Williams,32-167,G,12/10/16,DAL,@,HOU,L,1,32,3,10,0.3,2,6,0.333,1,4,0.25,2,2,1,0,3,3
10803,Derrick Williams,25-187,F,11/28/16,MIA,,BOS,L,1,21,3,9,0.333,3,6,0.5,0,3,0,3,6,0.5,0,4,4
10804,Derrick Williams,25-216,F,12/27/16,MIA,,OKC,L,1,15,4,4,1,3,3,1,1,1,1,0,0,,0,2,2
10805,Derrick Williams,25-282,F,3/3/17,CLE,@,ATL,W,0,18,3,5,0.6,0,1,0,3,4,0.75,0,0,,0,1,1
10806,Lou Williams,30-128,G,3/4/17,HOU,,MEM,W,0,21,3,8,0.375,2,2,1,1,6,0.167,2,2,1,0,1,1
10807,Marvin Williams,30-132,F,10/29/16,CHO,,BOS,L,1,30,3,10,0.3,1,1,1,2,9,0.222,1,2,0.5,0,3,3
10808,Marvin Williams,30-190,F,12/26/16,CHO,@,BRK,L,1,28,3,8,0.375,2,5,0.4,1,3,0.333,2,2,1,2,2,4
10809,Marvin Williams,30-187,F,12/23/16,CHO,,CHI,W,1,24,3,7,0.429,2,4,0.5,1,3,0.333,2,2,1,0,2,2
10810,Marvin Williams,30-237,F,2/11/17,CHO,,LAC,L,1,33,4,6,0.667,3,3,1,1,3,0.333,0,0,,1,4,5
10811,Marvin Williams,30-197,F,1/2/17,CHO,@,CHI,L,1,28,3,9,0.333,2,6,0.333,1,3,0.333,2,2,1,1,1,2
10812,Troy Williams,21-334,F,11/28/16,MEM,,CHO,L,1,31,4,9,0.444,4,7,0.571,0,2,0,1,3,0.333,0,2,2
10813,Troy Williams,21-331,F,11/25/16,MEM,,MIA,L,0,20,4,8,0.5,3,7,0.429,1,1,1,0,2,0,1,5,6
10814,Justise Winslow,20-220,F,11/1/16,MIA,,SAC,W,1,41,3,15,0.2,1,10,0.1,2,5,0.4,1,2,0.5,1,2,3
10815,Brandan Wright,29-152,F-C,3/6/17,MEM,,BRK,L,1,18,4,6,0.667,4,6,0.667,0,0,,1,1,1,0,4,4
10816,Brandan Wright,29-146,F-C,2/28/17,MEM,,PHO,W,0,17,4,6,0.667,4,6,0.667,0,0,,1,2,0.5,3,2,5
10817,Brandan Wright,29-124,F-C,2/6/17,MEM,,SAS,W,0,14,4,4,1,4,4,1,0,0,,1,2,0.5,2,1,3
10818,Delon Wright,24-311,G,3/3/17,TOR,@,WAS,W,0,22,2,2,1,1,1,1,1,1,1,4,6,0.667,0,1,1
10819,Joe Young,24-133,G,11/7/16,IND,@,CHO,L,0,16,4,10,0.4,4,8,0.5,0,2,0,1,2,0.5,0,2,2
10820,Nick Young,31-165,G-F,11/13/16,LAL,@,MIN,L,1,24,3,9,0.333,2,2,1,1,7,0.143,2,2,1,0,1,1
10821,Nick Young,31-235,G-F,1/22/17,LAL,@,DAL,L,1,27,3,9,0.333,2,4,0.5,1,5,0.2,2,2,1,0,2,2
10822,Nick Young,31-252,G-F,2/8/17,LAL,@,DET,L,1,20,3,9,0.333,2,5,0.4,1,4,0.25,2,3,0.667,0,2,2
10823,Nick Young,31-275,G-F,3/3/17,LAL,,BOS,L,1,16,3,10,0.3,0,1,0,3,9,0.333,0,0,,0,0,0
10824,Thaddeus Young,28-169,F,12/7/16,IND,@,PHO,W,1,30,2,3,0.667,1,2,0.5,1,1,1,4,4,1,3,6,9
10825,Thaddeus Young,28-219,F,1/26/17,IND,@,MIN,W,1,31,4,10,0.4,4,9,0.444,0,1,0,1,2,0.5,2,3,5
10826,Thaddeus Young,28-135,F,11/3/16,IND,@,MIL,L,1,28,4,8,0.5,4,7,0.571,0,1,0,1,2,0.5,1,3,4
10827,Thaddeus Young,28-150,F,11/18/16,IND,,PHO,L,1,32,4,10,0.4,3,9,0.333,1,1,1,0,0,,3,2,5
10828,Thaddeus Young,28-213,F,1/20/17,IND,@,LAL,L,1,33,3,9,0.333,2,6,0.333,1,3,0.333,2,2,1,2,6,8
10829,Thaddeus Young,28-174,F,12/12/16,IND,,CHO,W,1,30,4,10,0.4,3,8,0.375,1,2,0.5,0,0,,0,5,5
10830,Cody Zeller,24-094,F-C,1/7/17,CHO,@,SAS,L,1,33,3,5,0.6,3,5,0.6,0,0,,3,4,0.75,3,6,9
10831,Cody Zeller,24-127,F-C,2/9/17,CHO,,HOU,L,1,22,4,8,0.5,4,8,0.5,0,0,,1,1,1,2,2,4
10832,Cody Zeller,24-085,F-C,12/29/16,CHO,,MIA,W,1,33,3,4,0.75,3,4,0.75,0,0,,3,6,0.5,2,5,7
10833,Cody Zeller,24-065,F-C,12/9/16,CHO,,ORL,W,1,22,4,5,0.8,4,5,0.8,0,0,,1,2,0.5,4,3,7
10834,Cody Zeller,24-063,F-C,12/7/16,CHO,,DET,W,1,32,2,9,0.222,2,9,0.222,0,0,,5,7,0.714,1,5,6
10835,Paul Zipser,23-012,G-F,3/2/17,CHI,,GSW,W,0,23,4,5,0.8,3,3,1,1,2,0.5,0,0,,0,4,4
10836,Alex Abrines,23-111,G-F,11/20/16,OKC,,IND,L,0,23,4,9,0.444,4,5,0.8,0,4,0,0,0,,0,0,0
10837,Alex Abrines,23-196,G-F,2/13/17,OKC,@,WAS,L,0,20,2,7,0.286,0,1,0,2,6,0.333,2,2,1,0,2,2
10838,Quincy Acy,26-120,F,2/3/17,BRK,,IND,L,0,13,2,7,0.286,0,2,0,2,5,0.4,2,2,1,2,1,3
10839,Steven Adams,23-156,C,12/23/16,OKC,@,BOS,W,1,29,4,6,0.667,4,6,0.667,0,0,,0,2,0,3,8,11
10840,Steven Adams,23-123,C,11/20/16,OKC,,IND,L,1,34,3,7,0.429,3,7,0.429,0,0,,2,2,1,4,4,8
10841,Steven Adams,23-169,C,1/5/17,OKC,@,HOU,L,1,29,2,6,0.333,2,6,0.333,0,0,,4,4,1,1,7,8
10842,Steven Adams,23-196,C,2/1/17,OKC,,CHI,L,1,29,3,7,0.429,3,7,0.429,0,0,,2,2,1,3,3,6
10843,Arron Afflalo,31-067,G,12/21/16,SAC,@,UTA,W,0,27,3,8,0.375,1,4,0.25,2,4,0.5,0,0,,1,3,4
10844,Arron Afflalo,31-107,G,1/30/17,SAC,@,PHI,L,1,36,3,9,0.333,1,2,0.5,2,7,0.286,0,0,,0,4,4
10845,Arron Afflalo,31-011,G,10/26/16,SAC,@,PHO,W,1,26,2,7,0.286,0,5,0,2,2,1,2,2,1,0,3,3
10846,Arron Afflalo,31-039,G,11/23/16,SAC,,OKC,W,1,30,3,7,0.429,3,6,0.5,0,1,0,2,2,1,0,1,1
10847,Arron Afflalo,31-147,G,3/11/17,SAC,,DEN,L,1,23,3,9,0.333,1,5,0.2,2,4,0.5,0,0,,0,3,3
10848,Arron Afflalo,31-118,G,2/10/17,SAC,,ATL,W,1,29,3,7,0.429,2,5,0.4,1,2,0.5,1,1,1,0,1,1
10849,Arron Afflalo,31-144,G,3/8/17,SAC,@,SAS,L,1,27,3,8,0.375,3,8,0.375,0,0,,2,2,1,0,4,4
10850,Alexis Ajinca,28-216,C,12/8/16,NOP,,PHI,L,1,14,4,6,0.667,4,6,0.667,0,0,,0,0,,1,3,4
10851,Alexis Ajinca,28-224,C,12/16/16,NOP,@,HOU,L,1,22,2,7,0.286,2,7,0.286,0,0,,4,5,0.8,2,6,8
10852,Cole Aldrich,28-012,C,11/12/16,MIN,,LAC,L,0,14,4,6,0.667,4,6,0.667,0,0,,0,0,,2,1,3
10853,LaMarcus Aldridge,31-164,F-C,12/30/16,SAS,,POR,W,1,29,2,3,0.667,2,3,0.667,0,0,,4,4,1,1,5,6
10854,Tony Allen,34-327,G-F,12/3/16,MEM,,LAL,W,1,24,4,7,0.571,4,6,0.667,0,1,0,0,0,,3,6,9
10855,Tony Allen,34-358,G-F,1/3/17,MEM,@,LAL,L,1,24,3,4,0.75,2,3,0.667,1,1,1,1,2,0.5,1,3,4
10856,Tony Allen,35-066,G-F,3/18/17,MEM,,SAS,W,1,31,3,10,0.3,2,7,0.286,1,3,0.333,1,2,0.5,3,4,7
10857,Tony Allen,34-353,G-F,12/29/16,MEM,,OKC,W,1,31,4,10,0.4,4,10,0.4,0,0,,0,0,,5,4,9
10858,Tony Allen,34-337,G-F,12/13/16,MEM,@,CLE,L,1,25,4,9,0.444,4,9,0.444,0,0,,0,1,0,0,1,1
10859,Tony Allen,35-019,G-F,1/30/17,MEM,@,PHO,W,1,19,4,9,0.444,4,8,0.5,0,1,0,0,0,,3,2,5
10860,Tony Allen,35-046,G-F,2/26/17,MEM,@,DEN,W,1,28,3,8,0.375,3,7,0.429,0,1,0,2,2,1,4,3,7
10861,Al-Farouq Aminu,26-098,F,12/28/16,POR,,SAC,W,1,31,3,6,0.5,3,5,0.6,0,1,0,2,2,1,1,6,7
10862,Al-Farouq Aminu,26-114,F,1/13/17,POR,,ORL,L,1,31,3,9,0.333,3,8,0.375,0,1,0,2,4,0.5,3,4,7
10863,Al-Farouq Aminu,26-178,F,3/18/17,POR,@,ATL,W,0,27,3,4,0.75,3,3,1,0,1,0,2,2,1,2,5,7
10864,Al-Farouq Aminu,26-046,F,11/6/16,POR,@,MEM,W,1,34,3,10,0.3,2,6,0.333,1,4,0.25,1,2,0.5,1,3,4
10865,Al-Farouq Aminu,26-096,F,12/26/16,POR,,TOR,L,1,33,3,7,0.429,1,3,0.333,2,4,0.5,0,0,,0,8,8
10866,Al-Farouq Aminu,26-111,F,1/10/17,POR,@,LAL,W,1,29,3,6,0.5,2,4,0.5,1,2,0.5,1,2,0.5,2,13,15
10867,Al-Farouq Aminu,26-042,F,11/2/16,POR,@,PHO,L,1,23,2,9,0.222,0,5,0,2,4,0.5,2,2,1,1,4,5
10868,Justin Anderson,23-113,G,3/12/17,PHI,@,LAL,W,0,21,3,6,0.5,1,3,0.333,2,3,0.667,0,0,,1,1,2
10869,Justin Anderson,22-346,G,10/30/16,DAL,@,HOU,L,0,17,3,8,0.375,2,6,0.333,1,2,0.5,1,1,1,1,2,3
10870,Kyle Anderson,23-148,F-G,2/15/17,SAS,@,ORL,W,0,15,3,6,0.5,2,3,0.667,1,3,0.333,1,1,1,1,5,6
10871,Kyle Anderson,23-052,F-G,11/11/16,SAS,,DET,W,1,24,3,6,0.5,2,4,0.5,1,2,0.5,1,2,0.5,3,3,6
10872,Kyle Anderson,23-093,F-G,12/22/16,SAS,@,LAC,L,0,13,4,5,0.8,4,5,0.8,0,0,,0,0,,1,6,7
10873,Kyle Anderson,23-126,F-G,1/24/17,SAS,@,TOR,W,1,32,2,6,0.333,2,6,0.333,0,0,,4,4,1,2,5,7
10874,Ryan Anderson,28-241,F,1/2/17,HOU,,WAS,W,1,32,3,7,0.429,1,2,0.5,2,5,0.4,0,0,,1,3,4
10875,Ryan Anderson,28-224,F,12/16/16,HOU,,NOP,W,1,27,3,11,0.273,1,3,0.333,2,8,0.25,0,0,,0,3,3
10876,Ryan Anderson,28-315,F,3/17/17,HOU,@,NOP,L,1,28,3,9,0.333,1,2,0.5,2,7,0.286,0,0,,1,1,2
10877,Giannis Antetokounmpo,22-069,F-G,2/13/17,MIL,,DET,W,1,37,2,9,0.222,2,7,0.286,0,2,0,4,4,1,0,4,4
10878,Carmelo Anthony,32-192,F,12/7/16,NYK,,CLE,L,1,24,4,9,0.444,4,7,0.571,0,2,0,0,0,,1,3,4
10879,Trevor Ariza,31-207,F,1/23/17,HOU,@,MIL,L,1,40,2,7,0.286,0,2,0,2,5,0.4,2,2,1,0,5,5
10880,Trevor Ariza,31-179,F,12/26/16,HOU,,PHO,W,1,26,3,9,0.333,2,2,1,1,7,0.143,1,1,1,0,10,10
10881,Trevor Ariza,31-244,F,3/1/17,HOU,@,LAC,W,1,33,3,7,0.429,1,1,1,2,6,0.333,0,1,0,0,7,7
10882,Trevor Ariza,31-125,F,11/2/16,HOU,@,NYK,W,1,30,3,10,0.3,2,5,0.4,1,5,0.2,1,2,0.5,0,4,4
10883,Trevor Ariza,31-260,F,3/17/17,HOU,@,NOP,L,1,30,3,8,0.375,1,1,1,2,7,0.286,0,0,,0,8,8
10884,Darrell Arthur,28-252,F,12/2/16,DEN,,HOU,L,0,9,4,4,1,4,4,1,0,0,,0,0,,2,2,4
10885,Darrell Arthur,28-247,F,11/27/16,DEN,@,PHO,W,0,21,3,9,0.333,1,5,0.2,2,4,0.5,0,0,,0,1,1
10886,Darrell Arthur,28-307,F,1/26/17,DEN,,PHO,W,0,15,3,5,0.6,1,2,0.5,2,3,0.667,0,0,,0,2,2
10887,Darrell Arthur,28-243,F,11/23/16,DEN,@,UTA,L,0,16,3,8,0.375,1,3,0.333,2,5,0.4,0,0,,1,0,1
10888,Omer Asik,30-157,C,12/8/16,NOP,,PHI,L,0,20,3,4,0.75,3,4,0.75,0,0,,2,3,0.667,5,4,9
10889,Omer Asik,30-126,C,11/7/16,NOP,@,GSW,L,1,14,3,6,0.5,3,6,0.5,0,0,,2,3,0.667,3,3,6
10890,D.J. Augustin,29-086,G,2/4/17,ORL,@,ATL,L,0,28,2,8,0.25,0,2,0,2,6,0.333,2,2,1,0,1,1
10891,D.J. Augustin,29-107,G,2/25/17,ORL,,ATL,W,0,21,3,6,0.5,1,2,0.5,2,4,0.5,0,0,,0,0,0
10892,D.J. Augustin,29-015,G,11/25/16,ORL,,WAS,L,0,26,3,9,0.333,2,4,0.5,1,5,0.2,1,1,1,0,0,0
10893,D.J. Augustin,29-029,G,12/9/16,ORL,@,CHO,L,1,19,3,10,0.3,1,3,0.333,2,7,0.286,0,0,,0,2,2
10894,D.J. Augustin,29-115,G,3/5/17,ORL,@,WAS,L,0,18,3,4,0.75,1,1,1,2,3,0.667,0,0,,0,1,1
10895,D.J. Augustin,29-026,G,12/6/16,ORL,@,WAS,W,1,20,2,5,0.4,1,2,0.5,1,3,0.333,3,5,0.6,0,1,1
10896,D.J. Augustin,28-359,G,11/3/16,ORL,,SAC,W,0,14,3,8,0.375,1,4,0.25,2,4,0.5,0,0,,0,0,0
10897,D.J. Augustin,29-113,G,3/3/17,ORL,,MIA,W,0,21,2,8,0.25,0,3,0,2,5,0.4,2,2,1,1,2,3
10898,Luke Babbitt,27-183,F,12/20/16,MIA,,ORL,L,0,15,2,4,0.5,0,1,0,2,3,0.667,2,2,1,0,2,2
10899,Luke Babbitt,27-270,F,3/17/17,MIA,,MIN,W,1,18,3,5,0.6,1,2,0.5,2,3,0.667,0,0,,0,2,2
10900,Luke Babbitt,27-229,F,2/4/17,MIA,,PHI,W,1,25,2,5,0.4,0,1,0,2,4,0.5,2,2,1,0,1,1
10901,Luke Babbitt,27-128,F,10/26/16,MIA,@,ORL,W,1,19,3,10,0.3,1,4,0.25,2,6,0.333,0,0,,0,1,1
10902,Luke Babbitt,27-183,F,12/20/16,MIA,,ORL,L,0,15,2,4,0.5,0,1,0,2,3,0.667,2,2,1,0,2,2
10903,Ron Baker,23-305,G,1/29/17,NYK,@,ATL,L,0,16,3,4,0.75,1,1,1,2,3,0.667,0,0,,0,1,1
10904,Ron Baker,23-355,G,3/20/17,NYK,@,LAC,L,0,20,3,5,0.6,1,3,0.333,2,2,1,0,0,,0,3,3
10905,Wade Baldwin,20-247,G,12/1/16,MEM,,ORL,W,0,18,3,7,0.429,3,6,0.5,0,1,0,2,2,1,1,3,4
10906,Wade Baldwin,20-217,G,11/1/16,MEM,@,MIN,L,1,23,2,8,0.25,2,4,0.5,0,4,0,4,4,1,1,2,3
10907,Leandro Barbosa,34-088,G,2/24/17,PHO,@,CHI,L,0,16,3,7,0.429,2,3,0.667,1,4,0.25,1,1,1,0,3,3
10908,Leandro Barbosa,34-002,G,11/30/16,PHO,,ATL,W,0,13,4,8,0.5,4,8,0.5,0,0,,0,0,,0,2,2
10909,Leandro Barbosa,34-017,G,12/15/16,PHO,,SAS,L,0,17,4,9,0.444,4,9,0.444,0,0,,0,1,0,1,2,3
10910,Leandro Barbosa,34-092,G,2/28/17,PHO,@,MEM,L,0,15,3,5,0.6,3,4,0.75,0,1,0,2,2,1,0,1,1
10911,Harrison Barnes,24-257,F,2/11/17,DAL,,ORL,W,1,30,4,13,0.308,4,12,0.333,0,1,0,0,0,,3,1,4
10912,Matt Barnes,36-256,F,11/20/16,SAC,,TOR,W,1,36,3,10,0.3,1,4,0.25,2,6,0.333,0,0,,0,1,1
10913,Matt Barnes,36-310,F,1/13/17,SAC,,CLE,L,0,18,4,8,0.5,4,4,1,0,4,0,0,0,,1,4,5
10914,Matt Barnes,36-287,F,12/21/16,SAC,@,UTA,W,1,27,3,7,0.429,1,4,0.25,2,3,0.667,0,1,0,2,1,3
10915,Matt Barnes,36-242,F,11/6/16,SAC,@,TOR,W,0,30,2,7,0.286,2,4,0.5,0,3,0,4,5,0.8,3,7,10
10916,Matt Barnes,36-317,F,1/20/17,SAC,@,MEM,L,0,18,3,9,0.333,2,5,0.4,1,4,0.25,1,1,1,0,1,1
10917,Will Barton,26-061,G,3/8/17,DEN,,WAS,L,0,26,3,9,0.333,2,5,0.4,1,4,0.25,1,3,0.333,1,1,2
10918,Brandon Bass,31-193,F,11/9/16,LAC,,POR,W,0,9,2,3,0.667,2,3,0.667,0,0,,4,4,1,1,1,2
10919,Brandon Bass,31-244,F,12/30/16,LAC,@,HOU,L,0,14,3,5,0.6,3,5,0.6,0,0,,2,3,0.667,1,0,1
10920,Brandon Bass,31-239,F,12/25/16,LAC,@,LAL,L,0,19,3,3,1,3,3,1,0,0,,2,2,1,0,4,4
10921,Brandon Bass,31-277,F,2/1/17,LAC,@,PHO,W,0,6,3,3,1,3,3,1,0,0,,2,2,1,0,1,1
10922,Brandon Bass,31-234,F,12/20/16,LAC,,DEN,W,0,11,3,3,1,3,3,1,0,0,,2,2,1,1,0,1
10923,Nicolas Batum,28-033,F-G,1/16/17,CHO,@,BOS,L,1,37,2,11,0.182,2,7,0.286,0,4,0,4,5,0.8,1,9,10
10924,Nicolas Batum,27-343,F-G,11/21/16,CHO,,MEM,L,1,34,1,7,0.143,0,0,,1,7,0.143,5,6,0.833,0,4,4
10925,Nicolas Batum,27-351,F-G,11/29/16,CHO,,DET,L,1,30,3,11,0.273,1,6,0.167,2,5,0.4,0,0,,1,10,11
10926,Nicolas Batum,28-094,F-G,3/18/17,CHO,,WAS,W,1,27,4,9,0.444,4,6,0.667,0,3,0,0,0,,1,9,10
10927,Aron Baynes,29-322,C,10/26/16,DET,@,TOR,L,0,15,3,4,0.75,3,4,0.75,0,0,,2,2,1,1,2,3
10928,Aron Baynes,30-056,C,2/3/17,DET,,MIN,W,0,19,3,7,0.429,3,7,0.429,0,0,,2,2,1,5,1,6
10929,Aron Baynes,29-363,C,12/6/16,DET,,CHI,W,0,23,3,6,0.5,3,6,0.5,0,0,,2,2,1,3,6,9
10930,Aron Baynes,30-054,C,2/1/17,DET,,NOP,W,0,19,4,5,0.8,4,5,0.8,0,0,,0,0,,1,6,7
10931,Aron Baynes,29-356,C,11/29/16,DET,@,CHO,W,0,23,3,7,0.429,3,7,0.429,0,0,,2,2,1,3,5,8
10932,Aron Baynes,30-005,C,12/14/16,DET,@,DAL,W,0,20,3,5,0.6,3,5,0.6,0,0,,2,2,1,2,8,10
10933,Kent Bazemore,27-227,G-F,2/13/17,ATL,@,POR,W,1,37,2,7,0.286,2,5,0.4,0,2,0,4,7,0.571,1,5,6
10934,Kent Bazemore,27-155,G-F,12/3/16,ATL,@,TOR,L,1,26,3,12,0.25,3,7,0.429,0,5,0,2,4,0.5,1,1,2
10935,Kent Bazemore,27-220,G-F,2/6/17,ATL,,UTA,L,1,29,2,8,0.25,1,5,0.2,1,3,0.333,3,4,0.75,0,1,1
10936,Kent Bazemore,27-120,G-F,10/29/16,ATL,@,PHI,W,1,24,4,11,0.364,4,9,0.444,0,2,0,0,0,,0,4,4
10937,Kent Bazemore,27-150,G-F,11/28/16,ATL,@,GSW,L,1,28,4,15,0.267,4,9,0.444,0,6,0,0,0,,2,5,7
10938,Kent Bazemore,27-218,G-F,2/4/17,ATL,,ORL,W,1,27,4,6,0.667,4,4,1,0,2,0,0,0,,1,2,3
10939,Kent Bazemore,27-184,G-F,1/1/17,ATL,,SAS,W,1,19,3,10,0.3,2,8,0.25,1,2,0.5,1,4,0.25,1,1,2
10940,Kent Bazemore,27-145,G-F,11/23/16,ATL,@,IND,W,1,26,3,13,0.231,3,10,0.3,0,3,0,2,2,1,0,4,4
10941,Bradley Beal,23-205,G,1/19/17,WAS,@,NYK,W,1,38,4,13,0.308,4,6,0.667,0,7,0,0,0,,1,1,2
10942,Michael Beasley,27-331,F,12/5/16,MIL,,SAS,L,0,14,3,3,1,3,3,1,0,0,,2,2,1,0,1,1
10943,Michael Beasley,28-025,F,2/3/17,MIL,@,DEN,L,0,14,3,7,0.429,3,6,0.5,0,1,0,2,4,0.5,1,2,3
10944,Michael Beasley,28-023,F,2/1/17,MIL,@,UTA,L,0,17,2,7,0.286,1,3,0.333,1,4,0.25,3,6,0.5,1,2,3
10945,Michael Beasley,27-352,F,12/26/16,MIL,@,WAS,L,0,18,4,11,0.364,4,10,0.4,0,1,0,0,0,,1,3,4
10946,Marco Belinelli,30-348,G-F,3/8/17,CHO,@,MIA,L,0,27,2,8,0.25,1,5,0.2,1,3,0.333,3,3,1,0,1,1
10947,Marco Belinelli,30-251,G-F,12/1/16,CHO,,DAL,W,0,20,3,5,0.6,3,4,0.75,0,1,0,2,2,1,0,1,1
10948,Marco Belinelli,30-325,G-F,2/13/17,CHO,,PHI,L,0,27,3,10,0.3,1,5,0.2,2,5,0.4,0,0,,0,4,4
10949,Anthony Bennett,23-281,F,12/20/16,BRK,@,TOR,L,0,21,2,8,0.25,1,4,0.25,1,4,0.25,3,4,0.75,4,6,10
10950,Anthony Bennett,23-256,F,11/25/16,BRK,@,IND,L,0,10,3,5,0.6,3,3,1,0,2,0,2,3,0.667,2,2,4
10951,Anthony Bennett,23-277,F,12/16/16,BRK,@,ORL,L,0,14,2,3,0.667,1,1,1,1,2,0.5,3,4,0.75,0,0,0
10952,Davis Bertans,24-116,F,3/8/17,SAS,,SAC,W,0,19,3,7,0.429,2,3,0.667,1,4,0.25,1,1,1,1,3,4
10953,Davis Bertans,24-121,F,3/13/17,SAS,,ATL,W,0,14,3,6,0.5,1,1,1,2,5,0.4,0,0,,0,1,1
10954,Patrick Beverley,28-182,G,1/10/17,HOU,,CHO,W,1,32,2,10,0.2,0,2,0,2,8,0.25,2,2,1,1,7,8
10955,Bismack Biyombo,24-117,C-F,12/23/16,ORL,,LAL,W,1,28,4,8,0.5,4,8,0.5,0,0,,0,3,0,1,8,9
10956,Bismack Biyombo,24-112,C-F,12/18/16,ORL,,TOR,L,1,27,3,5,0.6,3,5,0.6,0,0,,2,2,1,2,10,12
10957,Bismack Biyombo,24-185,C-F,3/1/17,ORL,,NYK,L,0,21,3,6,0.5,3,6,0.5,0,0,,2,4,0.5,3,4,7
10958,Nemanja Bjelica,28-192,F,11/17/16,MIN,,PHI,W,0,15,3,7,0.429,2,3,0.667,1,4,0.25,1,1,1,1,3,4
10959,Nemanja Bjelica,28-258,F,1/22/17,MIN,,DEN,W,0,19,3,5,0.6,3,4,0.75,0,1,0,2,2,1,2,2,4
10960,Nemanja Bjelica,28-203,F,11/28/16,MIN,,UTA,L,0,26,2,6,0.333,1,3,0.333,1,3,0.333,3,3,1,1,5,6
10961,Nemanja Bjelica,28-187,F,11/12/16,MIN,,LAC,L,0,18,3,6,0.5,1,3,0.333,2,3,0.667,0,0,,0,1,1
10962,Nemanja Bjelica,28-306,F,3/11/17,MIN,@,MIL,L,0,32,4,8,0.5,4,8,0.5,0,0,,0,0,,3,2,5
10963,Nemanja Bjelica,28-268,F,2/1/17,MIN,@,CLE,L,0,20,4,7,0.571,4,6,0.667,0,1,0,0,2,0,2,2,4
10964,Nemanja Bjelica,28-198,F,11/23/16,MIN,@,NOP,L,0,20,2,6,0.333,1,2,0.5,1,4,0.25,3,4,0.75,1,5,6
10965,Nemanja Bjelica,28-249,F,1/13/17,MIN,,OKC,W,0,14,3,6,0.5,2,4,0.5,1,2,0.5,1,1,1,1,2,3
10966,Nemanja Bjelica,28-231,F,12/26/16,MIN,,ATL,W,0,25,3,9,0.333,3,4,0.75,0,5,0,2,2,1,1,4,5
10967,Nemanja Bjelica,28-247,F,1/11/17,MIN,,HOU,W,0,21,2,7,0.286,2,3,0.667,0,4,0,4,4,1,2,5,7
10968,Tarik Black,24-341,C-F,10/28/16,LAL,@,UTA,L,0,10,4,6,0.667,4,6,0.667,0,0,,0,0,,4,3,7
10969,Tarik Black,25-003,C-F,11/25/16,LAL,,GSW,L,0,17,2,4,0.5,2,4,0.5,0,0,,4,4,1,4,1,5
10970,Tarik Black,25-053,C-F,1/14/17,LAL,@,LAC,L,0,21,3,4,0.75,3,4,0.75,0,0,,2,3,0.667,1,5,6
10971,Tarik Black,24-348,C-F,11/4/16,LAL,,GSW,W,0,15,4,6,0.667,4,6,0.667,0,0,,0,0,,1,4,5
10972,Tarik Black,25-059,C-F,1/20/17,LAL,,IND,W,0,28,4,6,0.667,4,6,0.667,0,0,,0,1,0,6,7,13
10973,Tarik Black,25-078,C-F,2/8/17,LAL,@,DET,L,1,19,4,9,0.444,4,9,0.444,0,0,,0,0,,3,7,10
10974,Eric Bledsoe,26-343,G,11/16/16,PHO,@,DEN,L,1,34,2,4,0.5,2,3,0.667,0,1,0,4,6,0.667,1,2,3
10975,Eric Bledsoe,26-339,G,11/12/16,PHO,,BRK,L,1,30,1,8,0.125,0,5,0,1,3,0.333,5,7,0.714,2,6,8
10976,Bojan Bogdanovic,27-221,G-F,11/25/16,BRK,@,IND,L,1,26,3,10,0.3,1,5,0.2,2,5,0.4,0,0,,0,3,3
10977,Bojan Bogdanovic,27-259,G-F,1/2/17,BRK,,UTA,L,1,25,4,7,0.571,4,6,0.667,0,1,0,0,0,,0,3,3
10978,Bojan Bogdanovic,27-272,G-F,1/15/17,BRK,,HOU,L,1,22,3,8,0.375,1,3,0.333,2,5,0.4,0,1,0,0,2,2
10979,Andrew Bogut,32-005,C,12/3/16,DAL,,CHI,W,1,22,4,4,1,4,4,1,0,0,,0,0,,1,10,11
10980,Joel Bolomboy,23-042,F,3/11/17,UTA,@,OKC,L,0,15,4,7,0.571,4,6,0.667,0,1,0,0,0,,0,1,1
10981,Devin Booker,20-059,G,12/28/16,PHO,@,SAS,L,1,29,2,13,0.154,2,11,0.182,0,2,0,4,4,1,0,3,3
10982,Trevor Booker,29-019,F,12/14/16,BRK,,LAL,W,1,29,3,8,0.375,2,7,0.286,1,1,1,1,5,0.2,5,13,18
10983,Trevor Booker,29-057,F,1/21/17,BRK,@,CHO,L,1,27,4,7,0.571,4,6,0.667,0,1,0,0,0,,3,6,9
10984,Trevor Booker,29-098,F,3/3/17,BRK,@,UTA,L,0,25,3,9,0.333,3,7,0.429,0,2,0,2,2,1,3,8,11
10985,Trevor Booker,29-053,F,1/17/17,BRK,,TOR,L,1,22,4,8,0.5,4,7,0.571,0,1,0,0,0,,2,5,7
10986,Trevor Booker,29-070,F,2/3/17,BRK,,IND,L,0,21,3,8,0.375,3,8,0.375,0,0,,2,2,1,3,4,7
10987,Trevor Booker,29-109,F,3/14/17,BRK,,OKC,L,0,18,3,8,0.375,1,6,0.167,2,2,1,0,0,,0,2,2
10988,Trevor Booker,29-048,F,1/12/17,BRK,,NOP,L,1,30,4,9,0.444,4,8,0.5,0,1,0,0,2,0,3,9,12
10989,Trevor Booker,29-077,F,2/10/17,BRK,,MIA,L,0,25,4,7,0.571,4,7,0.571,0,0,,0,0,,2,8,10
10990,Trevor Booker,28-336,F,10/26/16,BRK,@,BOS,L,1,24,4,5,0.8,4,4,1,0,1,0,0,0,,1,6,7
10991,Trevor Booker,29-101,F,3/6/17,BRK,@,MEM,W,0,26,4,6,0.667,4,6,0.667,0,0,,0,1,0,3,6,9
10992,Trevor Booker,29-002,F,11/27/16,BRK,,SAC,L,1,26,4,8,0.5,4,8,0.5,0,0,,0,0,,1,7,8
10993,Corey Brewer,30-297,F-G,12/27/16,HOU,@,DAL,W,1,20,3,6,0.5,1,3,0.333,2,3,0.667,0,0,,0,3,3
10994,Corey Brewer,30-296,F-G,12/26/16,HOU,,PHO,W,0,18,3,3,1,2,2,1,1,1,1,1,1,1,0,0,0
10995,Corey Brewer,30-318,F-G,1/17/17,HOU,@,MIA,L,1,26,2,5,0.4,0,2,0,2,3,0.667,2,2,1,1,0,1
10996,Malcolm Brogdon,23-320,G,10/26/16,MIL,,CHO,L,0,21,3,9,0.333,3,6,0.5,0,3,0,2,2,1,0,6,6
10997,Malcolm Brogdon,24-075,G,2/24/17,MIL,,UTA,L,0,22,2,6,0.333,1,3,0.333,1,3,0.333,3,3,1,0,1,1
10998,Malcolm Brogdon,24-066,G,2/15/17,MIL,@,BRK,W,0,16,1,3,0.333,0,2,0,1,1,1,5,6,0.833,0,2,2
10999,Malcolm Brogdon,23-350,G,11/25/16,MIL,,TOR,L,0,19,3,5,0.6,1,3,0.333,2,2,1,0,0,,0,0,0
11000,Malcolm Brogdon,24-017,G,12/28/16,MIL,@,DET,W,0,28,4,6,0.667,4,5,0.8,0,1,0,0,0,,0,1,1
11001,Malcolm Brogdon,24-075,G,2/24/17,MIL,,UTA,L,0,22,2,6,0.333,1,3,0.333,1,3,0.333,3,3,1,0,1,1
11002,Aaron Brooks,31-294,G,11/3/16,IND,@,MIL,L,0,14,3,4,0.75,1,2,0.5,2,2,1,0,0,,0,0,0
11003,Aaron Brooks,31-292,G,11/1/16,IND,,LAL,W,0,16,3,7,0.429,2,4,0.5,1,3,0.333,1,2,0.5,1,0,1
11004,Aaron Brooks,31-351,G,12/30/16,IND,,CHI,W,0,13,3,5,0.6,1,1,1,2,4,0.5,0,0,,0,1,1
11005,Jaylen Brown,20-133,F,3/6/17,BOS,@,LAC,L,1,26,3,5,0.6,2,3,0.667,1,2,0.5,1,1,1,1,4,5
11006,Jaylen Brown,20-092,F,1/24/17,BOS,@,WAS,L,0,24,3,6,0.5,2,4,0.5,1,2,0.5,1,1,1,0,5,5
11007,Jaylen Brown,20-003,F,10/27/16,BOS,@,CHI,L,0,20,4,7,0.571,4,6,0.667,0,1,0,0,0,,0,1,1
11008,Jaylen Brown,20-021,F,11/14/16,BOS,@,NOP,L,0,17,3,5,0.6,3,5,0.6,0,0,,2,2,1,4,0,4
11009,Jaylen Brown,20-128,F,3/1/17,BOS,,CLE,W,0,23,3,7,0.429,2,3,0.667,1,4,0.25,1,1,1,1,5,6
11010,Jaylen Brown,20-100,F,2/1/17,BOS,,TOR,W,1,23,2,6,0.333,2,5,0.4,0,1,0,4,6,0.667,1,0,1
11011,Nicolas Brussino,23-326,G-F,1/22/17,DAL,,LAL,W,0,12,3,4,0.75,1,1,1,2,3,0.667,0,0,,0,2,2
11012,Trey Burke,24-034,G,12/16/16,WAS,,DET,W,0,15,2,4,0.5,1,2,0.5,1,2,0.5,3,4,0.75,0,0,0
11013,Trey Burke,24-014,G,11/26/16,WAS,,SAS,L,0,9,4,7,0.571,4,6,0.667,0,1,0,0,0,,0,0,0
11014,Trey Burke,23-350,G,10/27/16,WAS,@,ATL,L,0,18,4,7,0.571,4,5,0.8,0,2,0,0,1,0,0,0,0
11015,Trey Burke,24-023,G,12/5/16,WAS,@,BRK,W,0,12,3,5,0.6,1,1,1,2,4,0.5,0,0,,0,0,0
11016,Alec Burks,25-178,G,1/14/17,UTA,,ORL,W,0,15,3,5,0.6,2,4,0.5,1,1,1,1,3,0.333,2,4,6
11017,Alec Burks,25-226,G,3/3/17,UTA,,BRK,W,0,23,3,11,0.273,1,8,0.125,2,3,0.667,0,0,,2,4,6
11018,Alec Burks,25-224,G,3/1/17,UTA,,MIN,L,0,28,3,11,0.273,3,10,0.3,0,1,0,2,2,1,1,6,7
11019,Alec Burks,25-239,G,3/16/17,UTA,@,CLE,L,0,21,3,9,0.333,3,8,0.375,0,1,0,2,2,1,0,4,4
11020,Jimmy Butler,27-167,G-F,2/28/17,CHI,,DEN,L,1,35,3,13,0.231,3,11,0.273,0,2,0,2,2,1,3,1,4
11021,Kentavious Caldwell-Pope,23-307,G,12/21/16,DET,,MEM,L,1,31,3,10,0.3,1,5,0.2,2,5,0.4,0,0,,1,2,3
11022,Isaiah Canaan,25-175,G,11/12/16,CHI,,WAS,W,0,27,3,7,0.429,2,2,1,1,5,0.2,1,1,1,0,2,2
11023,Isaiah Canaan,25-172,G,11/9/16,CHI,@,ATL,L,0,22,3,9,0.333,1,4,0.25,2,5,0.4,0,0,,0,3,3
11024,Isaiah Canaan,25-188,G,11/25/16,CHI,@,PHI,W,0,26,2,9,0.222,0,2,0,2,7,0.286,2,2,1,0,5,5
11025,Isaiah Canaan,25-182,G,11/19/16,CHI,@,LAC,L,0,17,2,5,0.4,1,1,1,1,4,0.25,3,4,0.75,0,0,0
11026,Isaiah Canaan,25-180,G,11/17/16,CHI,@,UTA,W,0,26,4,9,0.444,4,8,0.5,0,1,0,0,0,,0,2,2
11027,Isaiah Canaan,25-178,G,11/15/16,CHI,@,POR,W,0,24,2,6,0.333,1,2,0.5,1,4,0.25,3,3,1,0,1,1
11028,Clint Capela,22-285,F-C,2/27/17,HOU,,IND,L,1,24,4,6,0.667,4,6,0.667,0,0,,0,0,,1,6,7
11029,Clint Capela,22-168,F-C,11/2/16,HOU,@,NYK,W,1,21,4,6,0.667,4,6,0.667,0,0,,0,3,0,5,1,6
11030,Clint Capela,22-298,F-C,3/12/17,HOU,,CLE,W,1,26,4,8,0.5,4,8,0.5,0,0,,0,2,0,4,7,11
11031,Clint Capela,22-167,F-C,11/1/16,HOU,@,CLE,L,1,19,3,5,0.6,3,5,0.6,0,0,,2,3,0.667,1,3,4
11032,Clint Capela,22-212,F-C,12/16/16,HOU,,NOP,W,1,22,4,6,0.667,4,6,0.667,0,0,,0,2,0,2,9,11
11033,Clint Capela,22-180,F-C,11/14/16,HOU,,PHI,W,1,26,3,7,0.429,3,7,0.429,0,0,,2,3,0.667,3,10,13
11034,Clint Capela,22-195,F-C,11/29/16,HOU,@,UTA,L,1,28,4,6,0.667,4,6,0.667,0,0,,0,0,,2,4,6
11035,Clint Capela,22-208,F-C,12/12/16,HOU,,BRK,W,1,19,4,4,1,4,4,1,0,0,,0,4,0,0,6,6
11036,DeMarre Carroll,30-237,F,3/21/17,TOR,,CHI,W,1,17,2,5,0.4,0,1,0,2,4,0.5,2,2,1,0,1,1
11037,DeMarre Carroll,30-144,F,12/18/16,TOR,@,ORL,W,1,21,3,4,0.75,3,3,1,0,1,0,2,5,0.4,0,3,3
11038,DeMarre Carroll,30-162,F,1/5/17,TOR,,UTA,W,1,39,3,6,0.5,1,2,0.5,2,4,0.5,0,0,,1,3,4
11039,DeMarre Carroll,30-188,F,1/31/17,TOR,,NOP,W,1,37,3,10,0.3,3,7,0.429,0,3,0,2,2,1,2,6,8
11040,DeMarre Carroll,30-093,F,10/28/16,TOR,,CLE,L,1,36,2,7,0.286,0,3,0,2,4,0.5,2,2,1,2,4,6
11041,DeMarre Carroll,30-091,F,10/26/16,TOR,,DET,W,1,29,2,8,0.25,0,2,0,2,6,0.333,2,4,0.5,0,7,7
11042,DeMarre Carroll,30-112,F,11/16/16,TOR,,GSW,L,1,24,3,7,0.429,1,2,0.5,2,5,0.4,0,0,,0,3,3
11043,DeMarre Carroll,30-131,F,12/5/16,TOR,,CLE,L,1,33,3,10,0.3,2,4,0.5,1,6,0.167,1,2,0.5,0,0,0
11044,Vince Carter,39-307,G-F,11/28/16,MEM,,CHO,L,0,20,2,9,0.222,1,3,0.333,1,6,0.167,3,4,0.75,0,2,2
11045,Vince Carter,40-037,G-F,3/4/17,MEM,@,HOU,L,0,24,3,9,0.333,1,5,0.2,2,4,0.5,0,0,,0,2,2
11046,Vince Carter,39-361,G-F,1/21/17,MEM,,HOU,L,0,20,1,6,0.167,1,3,0.333,0,3,0,6,6,1,1,2,3
11047,Michael Carter-Williams,25-114,G,2/1/17,CHI,@,OKC,W,0,6,3,4,0.75,3,3,1,0,1,0,2,2,1,0,2,2
11048,Michael Carter-Williams,25-127,G,2/14/17,CHI,,TOR,W,1,29,2,2,1,2,2,1,0,0,,4,6,0.667,0,5,5
11049,Omri Casspi,28-158,F,11/27/16,SAC,@,BRK,W,0,18,3,3,1,1,1,1,2,2,1,0,0,,0,5,5
11050,Willie Cauley-Stein,23-102,F-C,11/28/16,SAC,@,WAS,L,0,14,3,4,0.75,3,4,0.75,0,0,,2,3,0.667,0,2,2
11051,Willie Cauley-Stein,23-160,F-C,1/25/17,SAC,@,CLE,W,0,26,3,8,0.375,3,8,0.375,0,0,,2,2,1,3,7,10
11052,Willie Cauley-Stein,23-116,F-C,12/12/16,SAC,,LAL,W,0,11,4,6,0.667,4,6,0.667,0,0,,0,0,,4,0,4
11053,Willie Cauley-Stein,23-180,F-C,2/14/17,SAC,@,LAL,W,0,15,3,5,0.6,3,5,0.6,0,0,,2,2,1,2,1,3
11054,Willie Cauley-Stein,23-202,F-C,3/8/17,SAC,@,SAS,L,0,27,4,7,0.571,4,7,0.571,0,0,,0,0,,1,2,3
11055,Willie Cauley-Stein,23-178,F-C,2/12/17,SAC,,NOP,W,0,18,3,6,0.5,3,6,0.5,0,0,,2,2,1,0,4,4
11056,Tyson Chandler,34-104,C,1/14/17,PHO,,SAS,W,1,31,4,7,0.571,4,7,0.571,0,0,,0,0,,8,7,15
11057,Tyson Chandler,34-136,C,2/15/17,PHO,,LAL,W,1,21,3,5,0.6,3,5,0.6,0,0,,2,2,1,1,7,8
11058,Tyson Chandler,34-028,C,10/30/16,PHO,,GSW,L,1,28,3,5,0.6,3,5,0.6,0,0,,2,4,0.5,3,15,18
11059,Tyson Chandler,34-090,C,12/31/16,PHO,@,UTA,L,1,24,4,5,0.8,4,5,0.8,0,0,,0,1,0,3,8,11
11060,Tyson Chandler,34-024,C,10/26/16,PHO,,SAC,L,1,23,4,5,0.8,4,5,0.8,0,0,,0,2,0,3,7,10
11061,Marquese Chriss,19-239,F,2/26/17,PHO,@,MIL,L,1,16,4,8,0.5,4,7,0.571,0,1,0,0,3,0,1,0,1
11062,Marquese Chriss,19-253,F,3/12/17,PHO,,POR,L,1,24,3,9,0.333,2,5,0.4,1,4,0.25,1,2,0.5,0,5,5
11063,Marquese Chriss,19-168,F,12/17/16,PHO,@,OKC,L,1,24,3,11,0.273,2,9,0.222,1,2,0.5,1,2,0.5,3,5,8
11064,Marquese Chriss,19-180,F,12/29/16,PHO,,TOR,W,1,19,3,6,0.5,2,3,0.667,1,3,0.333,1,2,0.5,1,1,2
11065,Ian Clark,25-241,G,11/3/16,GSW,,OKC,W,0,19,3,5,0.6,2,3,0.667,1,2,0.5,1,1,1,0,3,3
11066,Ian Clark,25-290,G,12/22/16,GSW,@,BRK,W,0,15,4,6,0.667,4,5,0.8,0,1,0,0,0,,0,0,0
11067,Ian Clark,25-345,G,2/15/17,GSW,,SAC,W,0,17,3,6,0.5,1,3,0.333,2,3,0.667,0,0,,0,1,1
11068,Ian Clark,25-266,G,11/28/16,GSW,,ATL,W,0,11,3,6,0.5,1,1,1,2,5,0.4,0,0,,0,2,2
11069,Jordan Clarkson,24-179,G,12/3/16,LAL,@,MEM,L,0,28,4,16,0.25,4,14,0.286,0,2,0,0,0,,3,1,4
11070,Darren Collison,29-120,G,12/21/16,SAC,@,UTA,W,1,22,4,9,0.444,4,8,0.5,0,1,0,0,0,,0,1,1
11071,Darren Collison,29-151,G,1/21/17,SAC,@,CHI,L,1,25,4,11,0.364,4,9,0.444,0,2,0,0,0,,2,1,3
11072,Darren Collison,29-200,G,3/11/17,SAC,,DEN,L,1,24,4,5,0.8,4,5,0.8,0,0,,0,1,0,0,1,1
11073,Darren Collison,29-160,G,1/30/17,SAC,@,PHI,L,1,24,3,7,0.429,3,6,0.5,0,1,0,2,2,1,0,0,0
11074,Darren Collison,29-094,G,11/25/16,SAC,,HOU,L,1,25,2,6,0.333,2,3,0.667,0,3,0,4,4,1,0,3,3
11075,Mike Conley,29-038,G,11/18/16,MEM,@,DAL,W,1,29,2,7,0.286,1,4,0.25,1,3,0.333,3,3,1,0,4,4
11076,Mike Conley,29-066,G,12/16/16,MEM,,SAC,L,1,29,2,7,0.286,2,4,0.5,0,3,0,4,5,0.8,0,3,3
11077,Robert Covington,26-080,F,3/4/17,PHI,,DET,L,1,25,3,10,0.3,1,5,0.2,2,5,0.4,0,0,,0,4,4
11078,Robert Covington,26-057,F,2/9/17,PHI,@,ORL,W,1,36,3,12,0.25,3,9,0.333,0,3,0,2,4,0.5,5,4,9
11079,Robert Covington,25-349,F,11/27/16,PHI,,CLE,L,1,21,3,9,0.333,1,3,0.333,2,6,0.333,0,0,,1,5,6
11080,Allen Crabbe,24-295,G-F,1/29/17,POR,,GSW,L,0,22,4,7,0.571,4,6,0.667,0,1,0,0,0,,0,0,0
11081,Allen Crabbe,24-245,G-F,12/10/16,POR,@,IND,L,0,26,3,4,0.75,1,2,0.5,2,2,1,0,0,,0,5,5
11082,Allen Crabbe,24-329,G-F,3/4/17,POR,,BRK,W,0,19,2,3,0.667,1,1,1,1,2,0.5,3,4,0.75,0,3,3
11083,Jamal Crawford,36-356,G,3/11/17,LAC,,PHI,W,0,31,2,13,0.154,2,9,0.222,0,4,0,4,4,1,0,0,0
11084,Jamal Crawford,36-307,G,1/21/17,LAC,@,DEN,L,0,25,3,13,0.231,3,9,0.333,0,4,0,2,2,1,0,2,2
11085,Jae Crowder,26-247,F,3/10/17,BOS,@,DEN,L,1,33,2,6,0.333,0,1,0,2,5,0.4,2,2,1,0,3,3
11086,Jae Crowder,26-185,F,1/7/17,BOS,,NOP,W,1,31,3,9,0.333,1,4,0.25,2,5,0.4,0,0,,1,5,6
11087,Dante Cunningham,29-199,F,11/7/16,NOP,@,GSW,L,0,26,3,5,0.6,1,2,0.5,2,3,0.667,0,0,,1,0,1
11088,Dante Cunningham,29-252,F,12/30/16,NOP,,NYK,W,1,35,3,7,0.429,1,3,0.333,2,4,0.5,0,0,,0,3,3
11089,Dante Cunningham,29-315,F,3/3/17,NOP,,SAS,L,0,21,3,6,0.5,2,4,0.5,1,2,0.5,1,2,0.5,0,1,1
11090,Seth Curry,26-073,G,11/4/16,DAL,,POR,L,0,26,3,8,0.375,1,3,0.333,2,5,0.4,0,0,,1,2,3
11091,Seth Curry,26-174,G,2/13/17,DAL,,BOS,L,1,33,3,9,0.333,1,4,0.25,2,5,0.4,0,0,,0,5,5
11092,Seth Curry,26-066,G,10/28/16,DAL,,HOU,L,0,20,3,6,0.5,2,2,1,1,4,0.25,1,1,1,0,0,0
11093,Seth Curry,26-139,G,1/9/17,DAL,@,MIN,L,0,30,3,6,0.5,1,3,0.333,2,3,0.667,0,0,,1,1,2
11094,Seth Curry,26-208,G,3/19/17,DAL,@,BRK,W,1,31,3,9,0.333,3,4,0.75,0,5,0,2,2,1,0,1,1
11095,Stephen Curry,28-276,G,12/15/16,GSW,,NYK,W,1,34,3,14,0.214,1,6,0.167,2,8,0.25,0,0,,1,9,10
11096,Troy Daniels,25-165,G,12/27/16,MEM,@,BOS,L,0,20,3,10,0.3,1,2,0.5,2,8,0.25,0,0,,0,0,0
11097,Anthony Davis,23-320,F-C,1/25/17,NOP,,OKC,L,1,16,2,8,0.25,2,8,0.25,0,0,,4,6,0.667,0,5,5
11098,Ed Davis,27-219,F,1/10/17,POR,@,LAL,W,0,21,3,6,0.5,3,6,0.5,0,0,,2,2,1,3,5,8
11099,Dewayne Dedmon,27-209,C,3/9/17,SAS,@,OKC,L,1,19,3,6,0.5,3,6,0.5,0,0,,2,2,1,3,5,8
11100,Sam Dekker,22-250,F,1/11/17,HOU,@,MIN,L,0,22,3,9,0.333,1,4,0.25,2,5,0.4,0,0,,1,1,2
11101,Sam Dekker,22-295,F,2/25/17,HOU,,MIN,W,0,16,3,4,0.75,2,2,1,1,2,0.5,1,2,0.5,2,0,2
11102,Sam Dekker,22-313,F,3/15/17,HOU,,LAL,W,0,19,4,7,0.571,4,5,0.8,0,2,0,0,2,0,2,7,9
11103,Sam Dekker,22-256,F,1/17/17,HOU,@,MIA,L,0,25,3,8,0.375,2,5,0.4,1,3,0.333,1,2,0.5,5,2,7
11104,Sam Dekker,22-293,F,2/23/17,HOU,@,NOP,W,0,20,3,5,0.6,1,2,0.5,2,3,0.667,0,0,,1,3,4
11105,Sam Dekker,22-254,F,1/15/17,HOU,@,BRK,W,0,17,4,5,0.8,4,4,1,0,1,0,0,1,0,0,1,1
11106,Sam Dekker,22-268,F,1/29/17,HOU,@,IND,L,0,26,4,6,0.667,4,4,1,0,2,0,0,0,,1,2,3
11107,Sam Dekker,22-238,F,12/30/16,HOU,,LAC,W,0,19,4,8,0.5,4,4,1,0,4,0,0,0,,1,1,2
11108,Sam Dekker,22-250,F,1/11/17,HOU,@,MIN,L,0,22,3,9,0.333,1,4,0.25,2,5,0.4,0,0,,1,1,2
11109,Malcolm Delaney,28-007,G,3/18/17,ATL,,POR,L,0,26,3,7,0.429,3,4,0.75,0,3,0,2,2,1,0,2,2
11110,Malcolm Delaney,27-277,G,12/13/16,ATL,,ORL,L,0,14,2,4,0.5,2,3,0.667,0,1,0,4,4,1,0,1,1
11111,Malcolm Delaney,27-238,G,11/4/16,ATL,@,WAS,L,0,15,2,5,0.4,0,2,0,2,3,0.667,2,2,1,0,0,0
11112,Malcolm Delaney,27-266,G,12/2/16,ATL,,DET,L,0,19,2,4,0.5,2,4,0.5,0,0,,4,5,0.8,0,1,1
11113,Malcolm Delaney,27-315,G,1/20/17,ATL,,CHI,W,0,18,2,5,0.4,1,3,0.333,1,2,0.5,3,4,0.75,1,1,2
11114,Malcolm Delaney,27-232,G,10/29/16,ATL,@,PHI,W,0,20,3,6,0.5,2,5,0.4,1,1,1,1,2,0.5,0,2,2
11115,Matthew Dellavedova,26-080,G,11/27/16,MIL,@,ORL,W,1,31,3,13,0.231,1,6,0.167,2,7,0.286,0,0,,0,1,1
11116,Matthew Dellavedova,26-109,G,12/26/16,MIL,@,WAS,L,1,30,1,9,0.111,1,4,0.25,0,5,0,6,8,0.75,1,2,3
11117,Matthew Dellavedova,26-130,G,1/16/17,MIL,,PHI,L,0,21,3,6,0.5,3,6,0.5,0,0,,2,2,1,0,1,1
11118,Matthew Dellavedova,26-183,G,3/10/17,MIL,,IND,W,1,24,2,7,0.286,1,5,0.2,1,2,0.5,3,3,1,0,0,0
11119,Matthew Dellavedova,26-088,G,12/5/16,MIL,,SAS,L,1,32,3,8,0.375,2,5,0.4,1,3,0.333,1,1,1,0,0,0
11120,Matthew Dellavedova,26-069,G,11/16/16,MIL,@,ATL,L,1,27,3,9,0.333,1,4,0.25,2,5,0.4,0,0,,0,1,1
11121,Matthew Dellavedova,26-103,G,12/20/16,MIL,,CLE,L,1,39,3,10,0.3,1,3,0.333,2,7,0.286,0,0,,1,2,3
11122,Luol Deng,31-213,F,11/15/16,LAL,,BRK,W,1,21,2,6,0.333,2,5,0.4,0,1,0,4,6,0.667,3,2,5
11123,Luol Deng,31-221,F,11/23/16,LAL,@,GSW,L,1,26,3,9,0.333,3,8,0.375,0,1,0,2,2,1,2,5,7
11124,Luol Deng,31-220,F,11/22/16,LAL,,OKC,W,1,19,4,9,0.444,4,8,0.5,0,1,0,0,2,0,0,3,3
11125,Boris Diaw,34-236,F-C,12/8/16,UTA,,GSW,L,1,26,4,7,0.571,4,5,0.8,0,2,0,0,0,,3,1,4
11126,Gorgui Dieng,26-292,C,11/5/16,MIN,@,OKC,L,1,27,4,8,0.5,4,8,0.5,0,0,,0,0,,2,6,8
11127,Gorgui Dieng,27-056,C,3/15/17,MIN,@,BOS,L,1,31,3,7,0.429,3,6,0.5,0,1,0,2,2,1,4,5,9
11128,Gorgui Dieng,26-317,C,11/30/16,MIN,,NYK,L,1,33,2,6,0.333,2,6,0.333,0,0,,4,6,0.667,4,4,8
11129,Gorgui Dieng,27-008,C,1/26/17,MIN,,IND,L,1,34,3,6,0.5,3,6,0.5,0,0,,2,3,0.667,1,8,9
11130,Gorgui Dieng,27-023,C,2/10/17,MIN,,NOP,L,1,34,3,8,0.375,2,7,0.286,1,1,1,1,2,0.5,3,5,8
11131,Gorgui Dieng,26-295,C,11/8/16,MIN,@,BRK,L,1,19,3,4,0.75,3,4,0.75,0,0,,2,4,0.5,0,2,2
11132,Spencer Dinwiddie,23-324,G,2/24/17,BRK,@,DEN,L,0,23,3,7,0.429,3,6,0.5,0,1,0,2,3,0.667,0,4,4
11133,Toney Douglas,30-336,G,2/15/17,MEM,,NOP,L,0,23,4,9,0.444,4,6,0.667,0,3,0,0,1,0,1,7,8
11134,Andre Drummond,23-216,C,3/14/17,DET,@,CLE,L,1,27,4,12,0.333,4,11,0.364,0,1,0,0,0,,5,9,14
11135,Andre Drummond,23-100,C,11/18/16,DET,@,CLE,L,1,27,4,12,0.333,4,12,0.333,0,0,,0,0,,3,7,10
11136,Andre Drummond,23-219,C,3/17/17,DET,,TOR,L,1,36,4,10,0.4,4,10,0.4,0,0,,0,4,0,6,16,22
11137,Jared Dudley,31-160,F-G,12/17/16,PHO,@,OKC,L,0,17,3,4,0.75,2,2,1,1,2,0.5,1,1,1,0,3,3
11138,Jared Dudley,31-152,F-G,12/9/16,PHO,@,LAL,W,0,30,3,8,0.375,1,4,0.25,2,4,0.5,0,0,,0,3,3
11139,Jared Dudley,31-254,F-G,3/21/17,PHO,@,MIA,L,0,19,3,6,0.5,2,2,1,1,4,0.25,1,3,0.333,0,8,8
11140,Jared Dudley,31-150,F-G,12/7/16,PHO,,IND,L,0,25,3,11,0.273,1,4,0.25,2,7,0.286,0,0,,1,7,8
11141,Mike Dunleavy,36-162,F-G,2/24/17,ATL,,MIA,L,0,16,2,2,1,1,1,1,1,1,1,3,4,0.75,0,2,2
11142,Mike Dunleavy,36-148,F-G,2/10/17,ATL,@,SAC,L,0,12,3,5,0.6,1,2,0.5,2,3,0.667,0,0,,0,1,1
11143,Kris Dunn,22-260,G,12/3/16,MIN,@,CHO,W,0,16,3,5,0.6,2,4,0.5,1,1,1,1,2,0.5,1,1,2
11144,Kris Dunn,22-355,G,3/8/17,MIN,,LAC,W,0,15,3,5,0.6,1,3,0.333,2,2,1,0,0,,0,1,1
11145,Kris Dunn,22-276,G,12/19/16,MIN,,PHO,W,0,11,3,6,0.5,2,5,0.4,1,1,1,1,1,1,0,3,3
11146,Kris Dunn,22-222,G,10/26/16,MIN,@,MEM,L,0,15,4,6,0.667,4,5,0.8,0,1,0,0,0,,1,3,4
11147,Kris Dunn,22-266,G,12/9/16,MIN,,DET,L,0,20,4,10,0.4,4,6,0.667,0,4,0,0,0,,1,4,5
11148,Wayne Ellington,29-046,G,12/14/16,MIA,,IND,W,1,21,3,10,0.3,1,2,0.5,2,8,0.25,0,0,,0,3,3
11149,Monta Ellis,31-122,G,2/25/17,IND,@,MIA,L,0,27,3,12,0.25,3,10,0.3,0,2,0,2,2,1,0,3,3
11150,Monta Ellis,31-093,G,1/27/17,IND,,SAC,W,0,16,3,3,1,2,2,1,1,1,1,1,1,1,0,0,0
11151,Monta Ellis,31-107,G,2/10/17,IND,@,WAS,L,0,28,4,9,0.444,4,6,0.667,0,3,0,0,0,,0,1,1
11152,James Ennis,26-201,F,1/18/17,MEM,@,WAS,L,0,28,3,10,0.3,3,6,0.5,0,4,0,2,2,1,4,2,6
11153,James Ennis,26-211,F,1/28/17,MEM,@,UTA,W,1,23,3,4,0.75,2,2,1,1,2,0.5,1,2,0.5,0,4,4
11154,James Ennis,26-121,F,10/30/16,MEM,,WAS,W,1,34,3,10,0.3,2,5,0.4,1,5,0.2,1,3,0.333,4,8,12
11155,James Ennis,26-191,F,1/8/17,MEM,,UTA,W,0,27,2,3,0.667,1,1,1,1,2,0.5,3,3,1,0,5,5
11156,James Ennis,26-187,F,1/4/17,MEM,@,LAC,L,1,32,3,7,0.429,3,7,0.429,0,0,,2,2,1,2,4,6
11157,James Ennis,26-220,F,2/6/17,MEM,,SAS,W,0,19,3,5,0.6,3,4,0.75,0,1,0,2,2,1,3,2,5
11158,Tyler Ennis,22-200,G,3/12/17,LAL,,PHI,L,0,16,3,5,0.6,2,3,0.667,1,2,0.5,1,1,1,0,0,0
11159,Tyler Ennis,22-195,G,3/7/17,LAL,@,DAL,L,0,17,4,8,0.5,4,6,0.667,0,2,0,0,0,,1,1,2
11160,Tyler Ennis,22-082,G,11/14/16,HOU,,PHI,W,0,15,3,6,0.5,1,4,0.25,2,2,1,0,0,,0,0,0
11161,Tyreke Evans,27-123,G-F,1/20/17,NOP,,BRK,L,0,13,2,10,0.2,2,6,0.333,0,4,0,4,6,0.667,3,1,4
11162,Dante Exum,21-243,G,3/13/17,UTA,,LAC,W,0,14,2,3,0.667,0,1,0,2,2,1,2,2,1,0,3,3
11163,Dante Exum,21-236,G,3/6/17,UTA,,NOP,W,1,25,3,11,0.273,2,6,0.333,1,5,0.2,1,2,0.5,1,3,4
11164,Dante Exum,21-154,G,12/14/16,UTA,,OKC,W,1,17,3,5,0.6,2,4,0.5,1,1,1,1,2,0.5,0,1,1
11165,Dante Exum,21-194,G,1/23/17,UTA,,OKC,L,0,14,3,6,0.5,2,2,1,1,4,0.25,1,1,1,0,1,1
11166,Dante Exum,21-233,G,3/3/17,UTA,,BRK,W,0,16,2,5,0.4,1,2,0.5,1,3,0.333,3,3,1,0,2,2
11167,Kenneth Faried,26-350,F,11/3/16,DEN,@,MIN,W,0,19,4,4,1,4,4,1,0,0,,0,0,,1,4,5
11168,Kenneth Faried,26-359,F,11/12/16,DEN,,DET,L,1,21,4,9,0.444,4,8,0.5,0,1,0,0,2,0,5,3,8
11169,Kenneth Faried,26-357,F,11/10/16,DEN,,GSW,L,0,30,4,9,0.444,4,9,0.444,0,0,,0,0,,6,5,11
11170,Kenneth Faried,27-004,F,11/23/16,DEN,@,UTA,L,1,22,3,7,0.429,3,7,0.429,0,0,,2,2,1,5,5,10
11171,Kenneth Faried,27-037,F,12/26/16,DEN,@,LAC,W,0,19,3,7,0.429,3,7,0.429,0,0,,2,2,1,5,5,10
11172,Derrick Favors,25-190,F-C,1/21/17,UTA,,IND,W,1,24,3,7,0.429,3,7,0.429,0,0,,2,4,0.5,2,5,7
11173,Derrick Favors,25-110,F-C,11/2/16,UTA,,DAL,W,1,23,3,8,0.375,3,8,0.375,0,0,,2,4,0.5,0,1,1
11174,Derrick Favors,25-228,F-C,2/28/17,UTA,@,OKC,L,1,27,4,9,0.444,4,9,0.444,0,0,,0,2,0,2,3,5
11175,Derrick Favors,25-195,F-C,1/26/17,UTA,,LAL,W,1,22,3,9,0.333,3,9,0.333,0,0,,2,2,1,2,4,6
11176,Derrick Favors,25-165,F-C,12/27/16,UTA,@,LAL,W,1,22,2,5,0.4,2,5,0.4,0,0,,4,4,1,4,2,6
11177,Cristiano Felicio,24-171,F-C,12/25/16,CHI,@,SAS,L,0,18,2,4,0.5,2,4,0.5,0,0,,4,5,0.8,2,1,3
11178,Cristiano Felicio,24-194,F-C,1/17/17,CHI,,DAL,L,0,12,3,3,1,3,3,1,0,0,,2,2,1,1,0,1
11179,Raymond Felton,32-177,G,12/20/16,LAC,,DEN,W,0,19,4,7,0.571,4,5,0.8,0,2,0,0,0,,1,2,3
11180,Raymond Felton,32-199,G,1/11/17,LAC,,ORL,W,0,17,4,6,0.667,4,5,0.8,0,1,0,0,0,,0,3,3
11181,Raymond Felton,32-182,G,12/25/16,LAC,@,LAL,L,1,38,4,10,0.4,4,9,0.444,0,1,0,0,0,,4,6,10
11182,Raymond Felton,32-131,G,11/4/16,LAC,@,MEM,W,0,18,3,6,0.5,1,3,0.333,2,3,0.667,0,0,,1,1,2
11183,Raymond Felton,32-180,G,12/23/16,LAC,,DAL,L,1,34,3,11,0.273,2,8,0.25,1,3,0.333,1,1,1,0,4,4
11184,Yogi Ferrell,23-314,G,3/19/17,DAL,@,BRK,W,1,22,2,5,0.4,2,4,0.5,0,1,0,4,4,1,0,2,2
11185,Dorian Finney-Smith,23-313,F,3/13/17,DAL,@,TOR,L,0,18,3,4,0.75,1,2,0.5,2,2,1,0,0,,0,0,0
11186,Dorian Finney-Smith,23-224,F,12/14/16,DAL,,DET,L,1,29,3,6,0.5,1,2,0.5,2,4,0.5,0,0,,2,3,5
11187,Dorian Finney-Smith,23-205,F,11/25/16,DAL,@,CLE,L,0,22,3,9,0.333,1,4,0.25,2,5,0.4,0,0,,0,0,0
11188,Dorian Finney-Smith,23-203,F,11/23/16,DAL,,LAC,L,0,25,3,7,0.429,1,3,0.333,2,4,0.5,0,0,,1,1,2
11189,Dorian Finney-Smith,23-266,F,1/25/17,DAL,,NYK,W,1,31,3,5,0.6,1,2,0.5,2,3,0.667,0,0,,0,5,5
11190,Dorian Finney-Smith,23-217,F,12/7/16,DAL,,SAC,L,1,23,3,5,0.6,1,2,0.5,2,3,0.667,0,0,,0,3,3
11191,Bryn Forbes,23-185,G,1/24/17,SAS,@,TOR,W,0,12,3,4,0.75,1,1,1,2,3,0.667,0,0,,0,1,1
11192,Bryn Forbes,23-231,G,3/11/17,SAS,,GSW,W,0,25,3,7,0.429,1,2,0.5,2,5,0.4,0,0,,0,1,1
11193,Evan Fournier,24-074,G-F,1/11/17,ORL,@,LAC,L,1,25,3,8,0.375,3,6,0.5,0,2,0,2,3,0.667,0,2,2
11194,Evan Fournier,23-365,G-F,10/28/16,ORL,@,DET,L,1,27,4,12,0.333,4,8,0.5,0,4,0,0,1,0,0,2,2
11195,Evan Fournier,24-076,G-F,1/13/17,ORL,@,POR,W,1,30,3,10,0.3,2,7,0.286,1,3,0.333,1,2,0.5,1,0,1
11196,Randy Foye,33-160,G,3/3/17,BRK,@,UTA,L,1,13,3,5,0.6,1,1,1,2,4,0.5,0,0,,1,1,2
11197,Randy Foye,33-136,G,2/7/17,BRK,@,CHO,L,1,21,2,4,0.5,1,2,0.5,1,2,0.5,3,3,1,0,5,5
11198,Randy Foye,33-158,G,3/1/17,BRK,@,SAC,W,1,14,2,2,1,0,0,,2,2,1,2,2,1,0,1,1
11199,Randy Foye,33-072,G,12/5/16,BRK,,WAS,L,0,15,3,7,0.429,1,3,0.333,2,4,0.5,0,0,,0,4,4
11200,Randy Foye,33-049,G,11/12/16,BRK,@,PHO,W,0,16,3,9,0.333,1,3,0.333,2,6,0.333,0,0,,0,3,3
11201,Tim Frazier,26-031,G,12/2/16,NOP,,LAC,L,1,31,2,6,0.333,2,5,0.4,0,1,0,4,8,0.5,0,3,3
11202,Tim Frazier,26-026,G,11/27/16,NOP,@,DAL,L,1,31,3,9,0.333,3,7,0.429,0,2,0,2,2,1,1,1,2
11203,Tim Frazier,26-101,G,2/10/17,NOP,@,MIN,W,0,20,2,6,0.333,2,6,0.333,0,0,,4,7,0.571,0,1,1
11204,Tim Frazier,26-034,G,12/5/16,NOP,,MEM,L,1,39,3,10,0.3,3,7,0.429,0,3,0,2,2,1,1,3,4
11205,Channing Frye,33-253,C-F,1/25/17,CLE,,SAC,L,0,19,3,6,0.5,1,1,1,2,5,0.4,0,0,,0,2,2
11206,Channing Frye,33-249,C-F,1/21/17,CLE,,SAS,L,0,17,2,8,0.25,2,6,0.333,0,2,0,4,5,0.8,1,3,4
11207,Channing Frye,33-299,C-F,3/12/17,CLE,@,HOU,L,0,14,3,4,0.75,1,1,1,2,3,0.667,0,0,,0,4,4
11208,Channing Frye,33-214,C-F,12/17/16,CLE,,LAL,W,0,14,3,3,1,1,1,1,2,2,1,0,0,,0,0,0
11209,Channing Frye,33-183,C-F,11/16/16,CLE,@,IND,L,0,27,3,9,0.333,1,1,1,2,8,0.25,0,0,,0,5,5
11210,Channing Frye,33-210,C-F,12/13/16,CLE,,MEM,W,0,15,2,6,0.333,1,2,0.5,1,4,0.25,3,3,1,0,1,1
11211,Channing Frye,33-270,C-F,2/11/17,CLE,,DEN,W,0,11,3,4,0.75,1,1,1,2,3,0.667,0,0,,0,1,1
11212,Channing Frye,33-178,C-F,11/11/16,CLE,@,WAS,W,0,14,3,8,0.375,1,4,0.25,2,4,0.5,0,0,,0,0,0
11213,Langston Galloway,25-100,G,3/19/17,SAC,@,SAS,L,0,23,4,8,0.5,4,7,0.571,0,1,0,0,0,,1,0,1
11214,Langston Galloway,25-099,G,3/18/17,SAC,@,OKC,L,0,20,3,7,0.429,3,6,0.5,0,1,0,2,2,1,0,1,1
11215,Langston Galloway,25-096,G,3/15/17,SAC,@,PHO,W,0,26,3,5,0.6,1,1,1,2,4,0.5,0,0,,0,2,2
11216,Langston Galloway,25-042,G,1/20/17,NOP,,BRK,L,0,24,3,12,0.25,1,5,0.2,2,7,0.286,0,0,,2,2,4
11217,Langston Galloway,24-356,G,11/29/16,NOP,,LAL,W,0,17,3,9,0.333,1,3,0.333,2,6,0.333,0,0,,0,1,1
11218,Marc Gasol,32-041,C,3/11/17,MEM,,ATL,L,1,27,3,11,0.273,2,8,0.25,1,3,0.333,1,2,0.5,0,6,6
11219,Marc Gasol,31-278,C,11/2/16,MEM,,NOP,W,1,38,3,18,0.167,2,13,0.154,1,5,0.2,1,2,0.5,1,10,11
11220,Marc Gasol,31-324,C,12/18/16,MEM,,UTA,L,1,36,4,22,0.182,4,17,0.235,0,5,0,0,0,,2,5,7
11221,Pau Gasol,36-121,F-C,11/4/16,SAS,@,UTA,W,1,23,4,9,0.444,4,9,0.444,0,0,,0,0,,1,5,6
11222,Pau Gasol,36-118,F-C,11/1/16,SAS,,UTA,L,1,27,4,8,0.5,4,7,0.571,0,1,0,0,0,,1,7,8
11223,Pau Gasol,36-243,F-C,3/6/17,SAS,,HOU,W,0,17,3,12,0.25,2,10,0.2,1,2,0.5,1,2,0.5,0,6,6
11224,Pau Gasol,36-255,F-C,3/18/17,SAS,@,MEM,L,0,24,3,5,0.6,3,4,0.75,0,1,0,2,2,1,3,6,9
11225,Pau Gasol,36-143,F-C,11/26/16,SAS,@,WAS,W,1,29,4,7,0.571,4,6,0.667,0,1,0,0,0,,2,8,10
11226,Paul George,26-275,F,2/1/17,IND,@,ORL,W,1,33,3,14,0.214,2,8,0.25,1,6,0.167,1,1,1,1,6,7
11227,Jonathan Gibson,29-017,G,11/25/16,DAL,@,CLE,L,0,14,2,3,0.667,0,0,,2,3,0.667,2,2,1,0,1,1
11228,Taj Gibson,31-197,F,1/7/17,CHI,,TOR,W,1,20,3,7,0.429,3,7,0.429,0,0,,2,2,1,2,4,6
11229,Taj Gibson,31-133,F,11/4/16,CHI,,NYK,L,1,31,4,7,0.571,4,7,0.571,0,0,,0,2,0,4,2,6
11230,Taj Gibson,31-131,F,11/2/16,CHI,@,BOS,L,1,26,3,12,0.25,3,12,0.25,0,0,,2,3,0.667,5,4,9
11231,Taj Gibson,31-146,F,11/17/16,CHI,@,UTA,W,1,27,3,7,0.429,3,7,0.429,0,0,,2,2,1,4,5,9
11232,Taj Gibson,31-164,F,12/5/16,CHI,,POR,L,1,27,4,6,0.667,4,6,0.667,0,0,,0,1,0,1,5,6
11233,Taj Gibson,31-175,F,12/16/16,CHI,,MIL,L,1,20,4,10,0.4,4,10,0.4,0,0,,0,0,,3,1,4
11234,Taj Gibson,31-139,F,11/10/16,CHI,@,MIA,W,1,23,4,7,0.571,4,7,0.571,0,0,,0,0,,1,2,3
11235,Taj Gibson,31-187,F,12/28/16,CHI,,BRK,W,1,29,4,7,0.571,4,7,0.571,0,0,,0,0,,1,2,3
11236,Taj Gibson,31-222,F,2/1/17,CHI,@,OKC,W,1,22,3,5,0.6,2,4,0.5,1,1,1,1,1,1,0,8,8
11237,Manu Ginobili,39-187,G,1/31/17,SAS,,OKC,W,0,21,3,6,0.5,2,3,0.667,1,3,0.333,1,3,0.333,0,2,2
11238,Manu Ginobili,39-104,G,11/9/16,SAS,,HOU,L,0,21,1,7,0.143,1,5,0.2,0,2,0,6,6,1,0,1,1
11239,Manu Ginobili,39-180,G,1/24/17,SAS,@,TOR,W,0,22,3,11,0.273,2,7,0.286,1,4,0.25,1,3,0.333,0,0,0
11240,Manu Ginobili,39-116,G,11/21/16,SAS,,DAL,W,0,25,2,6,0.333,0,1,0,2,5,0.4,2,2,1,1,3,4
11241,Manu Ginobili,39-177,G,1/21/17,SAS,@,CLE,W,0,20,3,9,0.333,1,3,0.333,2,6,0.333,0,0,,1,1,2
11242,Manu Ginobili,39-096,G,11/1/16,SAS,,UTA,L,0,23,1,5,0.2,0,2,0,1,3,0.333,5,5,1,0,1,1
11243,Manu Ginobili,39-091,G,10/27/16,SAS,@,SAC,W,0,19,3,9,0.333,1,3,0.333,2,6,0.333,0,0,,0,3,3
11244,Rudy Gobert,24-191,C,1/3/17,UTA,@,BOS,L,1,34,3,8,0.375,3,8,0.375,0,0,,2,2,1,5,8,13
11245,Rudy Gobert,24-126,C,10/30/16,UTA,@,LAC,L,1,26,3,4,0.75,3,4,0.75,0,0,,2,2,1,2,7,9
11246,Rudy Gobert,24-223,C,2/4/17,UTA,,CHO,W,1,38,2,5,0.4,2,5,0.4,0,0,,4,8,0.5,6,9,15
11247,Rudy Gobert,24-134,C,11/7/16,UTA,@,PHI,W,1,20,3,4,0.75,3,4,0.75,0,0,,2,5,0.4,0,6,6
11248,Archie Goodwin,22-089,G,11/14/16,NOP,,BOS,W,0,15,1,4,0.25,1,3,0.333,0,1,0,6,6,1,0,0,0
11249,Aaron Gordon,21-119,F,1/13/17,ORL,@,POR,W,1,36,2,5,0.4,2,5,0.4,0,0,,4,6,0.667,1,6,7
11250,Aaron Gordon,21-150,F,2/13/17,ORL,@,MIA,W,1,29,3,6,0.5,3,5,0.6,0,1,0,2,4,0.5,1,5,6
11251,Aaron Gordon,21-128,F,1/22/17,ORL,,GSW,L,1,34,4,14,0.286,4,8,0.5,0,6,0,0,0,,1,2,3
11252,Aaron Gordon,21-043,F,10/29/16,ORL,@,CLE,L,1,26,3,7,0.429,2,4,0.5,1,3,0.333,1,2,0.5,0,3,3
11253,Aaron Gordon,21-076,F,12/1/16,ORL,@,MEM,L,1,21,3,6,0.5,3,3,1,0,3,0,2,4,0.5,0,3,3
11254,Eric Gordon,28-075,G,3/10/17,HOU,@,CHI,W,0,23,3,14,0.214,1,4,0.25,2,10,0.2,0,0,,0,1,1
11255,Marcin Gortat,33-028,C-F,3/17/17,WAS,,CHI,W,1,22,4,9,0.444,4,9,0.444,0,0,,0,0,,1,7,8
11256,Marcin Gortat,32-341,C-F,1/23/17,WAS,@,CHO,W,1,29,4,5,0.8,4,5,0.8,0,0,,0,0,,2,5,7
11257,Marcin Gortat,33-026,C-F,3/15/17,WAS,,DAL,L,1,25,4,10,0.4,4,10,0.4,0,0,,0,2,0,3,7,10
11258,Marcin Gortat,32-262,C-F,11/5/16,WAS,@,ORL,L,1,37,3,10,0.3,3,10,0.3,0,0,,2,4,0.5,4,10,14
11259,Marcin Gortat,32-310,C-F,12/23/16,WAS,@,MIL,L,1,26,4,8,0.5,4,8,0.5,0,0,,0,0,,1,5,6
11260,Jerami Grant,22-336,F,2/11/17,OKC,,GSW,L,0,23,2,6,0.333,2,4,0.5,0,2,0,4,4,1,1,4,5
11261,Jerami Grant,22-267,F,12/4/16,OKC,,NOP,W,0,14,3,6,0.5,2,4,0.5,1,2,0.5,1,1,1,0,2,2
11262,Jerami Grant,22-331,F,2/6/17,OKC,@,IND,L,0,28,3,7,0.429,2,4,0.5,1,3,0.333,1,2,0.5,3,1,4
11263,Jerami Grant,22-353,F,2/28/17,OKC,,UTA,W,0,19,3,4,0.75,2,2,1,1,2,0.5,1,4,0.25,0,3,3
11264,Jerami Grant,22-249,F,11/16/16,OKC,,HOU,W,0,19,3,6,0.5,1,3,0.333,2,3,0.667,0,0,,0,3,3
11265,Jerami Grant,22-280,F,12/17/16,OKC,,PHO,W,0,29,3,8,0.375,2,6,0.333,1,2,0.5,1,2,0.5,1,4,5
11266,Jerami Grant,22-323,F,1/29/17,OKC,@,CLE,L,0,25,3,8,0.375,1,3,0.333,2,5,0.4,0,0,,1,3,4
11267,Jerami Grant,22-338,F,2/13/17,OKC,@,WAS,L,0,25,3,12,0.25,2,8,0.25,1,4,0.25,1,4,0.25,2,5,7
11268,Jerian Grant,24-065,G,12/13/16,CHI,,MIN,L,1,19,3,6,0.5,1,4,0.25,2,2,1,0,0,,0,3,3
11269,Jerian Grant,24-090,G,1/7/17,CHI,,TOR,W,0,22,2,3,0.667,2,2,1,0,1,0,4,4,1,1,2,3
11270,Jerian Grant,24-126,G,2/12/17,CHI,@,MIN,L,1,20,3,5,0.6,1,2,0.5,2,3,0.667,0,0,,0,1,1
11271,Jerian Grant,24-027,G,11/5/16,CHI,@,IND,L,0,12,2,7,0.286,1,4,0.25,1,3,0.333,3,3,1,0,2,2
11272,Danny Green,29-140,G-F,11/9/16,SAS,,HOU,L,1,26,3,9,0.333,1,1,1,2,8,0.25,0,0,,0,3,3
11273,Danny Green,29-219,G-F,1/27/17,SAS,@,NOP,L,1,29,2,5,0.4,0,0,,2,5,0.4,2,2,1,0,3,3
11274,Draymond Green,26-238,F,10/28/16,GSW,@,NOP,W,1,34,3,10,0.3,2,8,0.25,1,2,0.5,1,2,0.5,4,7,11
11275,Draymond Green,27-014,F,3/18/17,GSW,,MIL,W,1,30,2,6,0.333,2,6,0.333,0,0,,4,4,1,2,6,8
11276,Draymond Green,26-334,F,2/1/17,GSW,,CHO,W,1,31,3,10,0.3,1,3,0.333,2,7,0.286,0,0,,0,10,10
11277,Gerald Green,30-338,G-F,12/29/16,BOS,@,CLE,L,0,16,3,6,0.5,1,2,0.5,2,4,0.5,0,0,,0,0,0
11278,Gerald Green,30-285,G-F,11/6/16,BOS,,DEN,L,0,10,3,4,0.75,1,1,1,2,3,0.667,0,0,,0,2,2
11279,Gerald Green,30-334,G-F,12/25/16,BOS,@,NYK,W,0,12,3,6,0.5,1,3,0.333,2,3,0.667,0,0,,2,2,4
11280,JaMychal Green,26-206,F,1/13/17,MEM,@,HOU,W,1,29,3,4,0.75,2,2,1,1,2,0.5,1,2,0.5,1,3,4
11281,JaMychal Green,26-225,F,2/1/17,MEM,@,DEN,W,1,26,4,9,0.444,4,8,0.5,0,1,0,0,0,,3,5,8
11282,JaMychal Green,26-248,F,2/24/17,MEM,@,IND,L,1,32,3,7,0.429,2,5,0.4,1,2,0.5,1,2,0.5,3,4,7
11283,JaMychal Green,26-201,F,1/8/17,MEM,,UTA,W,1,32,3,5,0.6,2,3,0.667,1,2,0.5,1,2,0.5,1,5,6
11284,JaMychal Green,26-230,F,2/6/17,MEM,,SAS,W,1,25,3,5,0.6,3,4,0.75,0,1,0,2,2,1,3,4,7
11285,JaMychal Green,26-163,F,12/1/16,MEM,,ORL,W,1,27,3,4,0.75,2,3,0.667,1,1,1,1,2,0.5,0,7,7
11286,JaMychal Green,26-146,F,11/14/16,MEM,@,UTA,W,1,27,2,6,0.333,2,6,0.333,0,0,,4,4,1,4,2,6
11287,JaMychal Green,26-189,F,12/27/16,MEM,@,BOS,L,1,22,3,5,0.6,3,5,0.6,0,0,,2,2,1,1,5,6
11288,Jeff Green,30-179,F,2/23/17,ORL,,POR,L,0,18,1,3,0.333,1,1,1,0,2,0,6,8,0.75,0,4,4
11289,Jeff Green,30-073,F,11/9/16,ORL,,MIN,L,0,21,2,6,0.333,1,3,0.333,1,3,0.333,3,3,1,1,2,3
11290,Jeff Green,30-083,F,11/19/16,ORL,,DAL,W,1,22,4,7,0.571,4,6,0.667,0,1,0,0,0,,0,3,3
11291,Blake Griffin,27-362,F,3/13/17,LAC,@,UTA,L,1,37,3,8,0.375,2,6,0.333,1,2,0.5,1,2,0.5,1,8,9
11292,Justin Hamilton,26-310,C,2/5/17,BRK,,TOR,L,0,19,4,7,0.571,4,4,1,0,3,0,0,0,,2,4,6
11293,Justin Hamilton,26-210,C,10/28/16,BRK,,IND,W,0,28,3,8,0.375,2,2,1,1,6,0.167,1,1,1,2,5,7
11294,Justin Hamilton,26-329,C,2/24/17,BRK,@,DEN,L,0,21,3,6,0.5,2,3,0.667,1,3,0.333,1,2,0.5,2,5,7
11295,Justin Hamilton,26-266,C,12/23/16,BRK,@,CLE,L,1,19,3,8,0.375,3,5,0.6,0,3,0,2,2,1,1,5,6
11296,Tim Hardaway,24-360,G,3/11/17,ATL,@,MEM,W,0,21,3,5,0.6,1,2,0.5,2,3,0.667,0,0,,1,2,3
11297,Tim Hardaway,24-237,G,11/8/16,ATL,@,CLE,W,0,29,3,11,0.273,2,4,0.5,1,7,0.143,1,2,0.5,1,1,2
11298,Maurice Harkless,23-184,F-G,11/11/16,POR,,SAC,W,1,36,3,9,0.333,1,5,0.2,2,4,0.5,0,0,,3,5,8
11299,Maurice Harkless,23-182,F-G,11/9/16,POR,@,LAC,L,1,22,3,5,0.6,1,1,1,2,4,0.5,0,0,,0,4,4
11300,Maurice Harkless,23-272,F-G,2/7/17,POR,@,DAL,W,0,22,2,9,0.222,1,7,0.143,1,2,0.5,3,6,0.5,5,2,7
11301,Maurice Harkless,23-184,F-G,11/11/16,POR,,SAC,W,1,36,3,9,0.333,1,5,0.2,2,4,0.5,0,0,,3,5,8
11302,Maurice Harkless,23-272,F-G,2/7/17,POR,@,DAL,W,0,22,2,9,0.222,1,7,0.143,1,2,0.5,3,6,0.5,5,2,7
11303,Maurice Harkless,23-182,F-G,11/9/16,POR,@,LAC,L,1,22,3,5,0.6,1,1,1,2,4,0.5,0,0,,0,4,4
11304,Maurice Harkless,23-293,F-G,2/28/17,POR,@,DET,L,1,37,4,8,0.5,4,7,0.571,0,1,0,0,2,0,3,7,10
11305,Maurice Harkless,23-226,F-G,12/23/16,POR,,SAS,L,1,34,4,8,0.5,4,6,0.667,0,2,0,0,4,0,1,1,2
11306,Montrezl Harrell,22-360,F-C,1/20/17,HOU,,GSW,L,1,27,4,7,0.571,4,7,0.571,0,0,,0,0,,1,2,3
11307,Montrezl Harrell,23-016,F-C,2/11/17,HOU,,PHO,W,0,18,2,6,0.333,2,6,0.333,0,0,,4,5,0.8,2,3,5
11308,Montrezl Harrell,22-316,F-C,12/7/16,HOU,,LAL,W,0,9,4,6,0.667,4,6,0.667,0,0,,0,0,,1,0,1
11309,Montrezl Harrell,22-345,F-C,1/5/17,HOU,,OKC,W,0,29,4,7,0.571,4,7,0.571,0,0,,0,3,0,2,6,8
11310,Montrezl Harrell,23-008,F-C,2/3/17,HOU,,CHI,W,0,21,3,7,0.429,3,7,0.429,0,0,,2,2,1,3,2,5
11311,Montrezl Harrell,22-311,F-C,12/2/16,HOU,@,DEN,W,0,20,4,6,0.667,4,6,0.667,0,0,,0,0,,0,3,3
11312,Devin Harris,34-022,G,3/21/17,DAL,,GSW,L,0,15,3,6,0.5,1,1,1,2,5,0.4,0,0,,0,1,1
11313,Devin Harris,33-325,G,1/17/17,DAL,@,CHI,W,0,18,1,7,0.143,1,5,0.2,0,2,0,6,6,1,2,0,2
11314,Devin Harris,33-364,G,2/25/17,DAL,,NOP,W,0,22,3,9,0.333,3,6,0.5,0,3,0,2,5,0.4,0,5,5
11315,Devin Harris,33-363,G,2/24/17,DAL,@,MIN,L,0,17,3,5,0.6,1,2,0.5,2,3,0.667,0,0,,0,0,0
11316,Gary Harris,22-143,G,2/4/17,DEN,@,SAS,L,1,25,4,9,0.444,4,8,0.5,0,1,0,0,0,,1,3,4
11317,Gary Harris,22-113,G,1/5/17,DEN,,SAS,L,1,26,3,11,0.273,2,7,0.286,1,4,0.25,1,2,0.5,1,0,1
11318,Gary Harris,22-134,G,1/26/17,DEN,,PHO,W,1,28,2,9,0.222,0,5,0,2,4,0.5,2,2,1,1,0,1
11319,Joe Harris,25-089,G,12/5/16,BRK,,WAS,L,0,28,2,5,0.4,1,3,0.333,1,2,0.5,3,4,0.75,0,5,5
11320,Joe Harris,25-171,G,2/25/17,BRK,@,GSW,L,1,27,3,7,0.429,1,3,0.333,2,4,0.5,0,0,,0,1,1
11321,Joe Harris,25-068,G,11/14/16,BRK,@,LAC,L,0,25,3,6,0.5,2,3,0.667,1,3,0.333,1,2,0.5,1,1,2
11322,Joe Harris,25-081,G,11/27/16,BRK,,SAC,L,0,19,3,8,0.375,1,3,0.333,2,5,0.4,0,0,,0,0,0
11323,Joe Harris,25-135,G,1/20/17,BRK,@,NOP,W,1,13,3,5,0.6,1,3,0.333,2,2,1,0,0,,0,2,2
11324,Joe Harris,25-063,G,11/9/16,BRK,@,NYK,L,0,29,3,7,0.429,2,3,0.667,1,4,0.25,1,2,0.5,1,6,7
11325,Joe Harris,25-074,G,11/20/16,BRK,,POR,L,0,27,2,7,0.286,2,4,0.5,0,3,0,4,4,1,0,4,4
11326,Joe Harris,25-154,G,2/8/17,BRK,,WAS,L,0,19,3,5,0.6,1,2,0.5,2,3,0.667,0,0,,0,2,2
11327,Tobias Harris,24-204,F,2/4/17,DET,@,IND,L,0,23,2,9,0.222,2,7,0.286,0,2,0,4,4,1,0,4,4
11328,Tobias Harris,24-226,F,2/26/17,DET,,BOS,L,0,33,2,8,0.25,1,3,0.333,1,5,0.2,3,6,0.5,1,1,2
11329,Tobias Harris,24-149,F,12/11/16,DET,,PHI,L,1,35,3,9,0.333,3,6,0.5,0,3,0,2,2,1,0,6,6
11330,Tobias Harris,24-247,F,3/19/17,DET,,PHO,W,1,34,2,10,0.2,1,7,0.143,1,3,0.333,3,4,0.75,0,4,4
11331,Andrew Harrison,22-059,G,12/26/16,MEM,@,ORL,L,0,24,1,4,0.25,1,4,0.25,0,0,,6,8,0.75,0,4,4
11332,Andrew Harrison,22-096,G,2/1/17,MEM,@,DEN,W,0,21,2,6,0.333,0,3,0,2,3,0.667,2,4,0.5,0,0,0
11333,Spencer Hawes,28-188,C-F,11/2/16,CHO,,PHI,W,0,15,3,3,1,3,3,1,0,0,,2,2,1,0,0,0
11334,Spencer Hawes,28-205,C-F,11/19/16,CHO,@,NOP,L,0,21,4,6,0.667,4,4,1,0,2,0,0,0,,0,6,6
11335,Spencer Hawes,28-251,C-F,1/4/17,CHO,,OKC,W,0,24,2,6,0.333,0,3,0,2,3,0.667,2,2,1,0,4,4
11336,Spencer Hawes,28-278,C-F,1/31/17,CHO,@,POR,L,0,16,4,9,0.444,4,7,0.571,0,2,0,0,0,,1,3,4
11337,Spencer Hawes,28-215,C-F,11/29/16,CHO,,DET,L,0,17,3,5,0.6,1,3,0.333,2,2,1,0,0,,0,2,2
11338,Gordon Hayward,26-239,F-G,11/17/16,UTA,,CHI,L,1,41,3,15,0.2,3,12,0.25,0,3,0,2,3,0.667,1,11,12
11339,Gerald Henderson,29-062,G,2/9/17,PHI,@,ORL,W,1,21,4,9,0.444,4,7,0.571,0,2,0,0,0,,0,1,1
11340,Gerald Henderson,29-059,G,2/6/17,PHI,@,DET,L,0,18,3,7,0.429,3,5,0.6,0,2,0,2,2,1,0,1,1
11341,John Henson,25-364,C-F,12/26/16,MIL,@,WAS,L,1,25,4,7,0.571,4,7,0.571,0,0,,0,0,,0,3,3
11342,John Henson,26-031,C-F,1/28/17,MIL,,BOS,L,0,7,1,2,0.5,1,2,0.5,0,0,,6,8,0.75,1,0,1
11343,John Henson,26-072,C-F,3/10/17,MIL,,IND,W,0,21,4,5,0.8,4,5,0.8,0,0,,0,0,,3,4,7
11344,John Henson,25-343,C-F,12/5/16,MIL,,SAS,L,1,26,1,3,0.333,1,3,0.333,0,0,,6,8,0.75,0,5,5
11345,John Henson,26-023,C-F,1/20/17,MIL,@,ORL,L,1,16,3,4,0.75,3,4,0.75,0,0,,2,2,1,1,4,5
11346,John Henson,25-320,C-F,11/12/16,MIL,,MEM,W,1,18,3,5,0.6,3,5,0.6,0,0,,2,2,1,0,7,7
11347,John Henson,26-019,C-F,1/16/17,MIL,,PHI,L,1,26,3,8,0.375,3,8,0.375,0,0,,2,2,1,2,3,5
11348,John Henson,26-079,C-F,3/17/17,MIL,@,LAL,W,0,19,3,6,0.5,3,6,0.5,0,0,,2,4,0.5,5,4,9
11349,Juan Hernangomez,21-113,F,1/19/17,DEN,@,SAS,L,1,38,3,9,0.333,2,5,0.4,1,4,0.25,1,2,0.5,2,4,6
11350,Juan Hernangomez,21-135,F,2/10/17,DEN,@,NYK,W,0,16,3,6,0.5,1,2,0.5,2,4,0.5,0,0,,0,1,1
11351,Juan Hernangomez,21-154,F,3/1/17,DEN,@,MIL,W,0,14,2,3,0.667,1,1,1,1,2,0.5,3,3,1,1,2,3
11352,Juan Hernangomez,21-126,F,2/1/17,DEN,,MEM,L,0,15,3,5,0.6,2,4,0.5,1,1,1,1,1,1,1,3,4
11353,Juan Hernangomez,21-046,F,11/13/16,DEN,@,POR,L,0,16,2,3,0.667,1,1,1,1,2,0.5,3,4,0.75,1,5,6
11354,Juan Hernangomez,21-125,F,1/31/17,DEN,@,LAL,L,0,12,2,2,1,0,0,,2,2,1,2,2,1,1,1,2
11355,Willy Hernangomez,22-225,C,1/7/17,NYK,@,IND,L,0,18,3,9,0.333,2,6,0.333,1,3,0.333,1,1,1,0,4,4
11356,Willy Hernangomez,22-243,C,1/25/17,NYK,@,DAL,L,0,24,4,9,0.444,4,9,0.444,0,0,,0,0,,6,10,16
11357,Willy Hernangomez,22-185,C,11/28/16,NYK,,OKC,L,0,14,3,5,0.6,3,5,0.6,0,0,,2,2,1,1,1,2
11358,Willy Hernangomez,22-183,C,11/26/16,NYK,@,CHO,L,0,17,4,5,0.8,4,5,0.8,0,0,,0,0,,3,5,8
11359,Willy Hernangomez,22-202,C,12/15/16,NYK,@,GSW,L,0,21,4,8,0.5,4,8,0.5,0,0,,0,2,0,1,9,10
11360,Willy Hernangomez,22-255,C,2/6/17,NYK,,LAL,L,0,24,3,9,0.333,3,9,0.333,0,0,,2,2,1,3,10,13
11361,Willy Hernangomez,22-282,C,3/5/17,NYK,,GSW,L,0,14,4,5,0.8,4,5,0.8,0,0,,0,0,,2,3,5
11362,Willy Hernangomez,22-168,C,11/11/16,NYK,@,BOS,L,0,24,4,13,0.308,4,13,0.308,0,0,,0,0,,6,6,12
11363,Willy Hernangomez,22-276,C,2/27/17,NYK,,TOR,L,1,34,4,6,0.667,4,6,0.667,0,0,,0,0,,4,5,9
11364,Willy Hernangomez,22-297,C,3/20/17,NYK,@,LAC,L,1,17,3,11,0.273,3,11,0.273,0,0,,2,2,1,5,4,9
11365,Willy Hernangomez,22-233,C,1/15/17,NYK,@,TOR,L,0,21,3,7,0.429,3,6,0.5,0,1,0,2,3,0.667,5,9,14
11366,Willy Hernangomez,22-264,C,2/15/17,NYK,@,OKC,L,1,32,3,6,0.5,3,6,0.5,0,0,,2,2,1,3,7,10
11367,Mario Hezonja,21-356,F-G,2/15/17,ORL,,SAS,L,0,25,4,10,0.4,4,9,0.444,0,1,0,0,0,,0,1,1
11368,Mario Hezonja,21-328,F-G,1/18/17,ORL,@,NOP,L,0,18,3,5,0.6,1,3,0.333,2,2,1,0,0,,1,4,5
11369,Mario Hezonja,22-009,F-G,3/6/17,ORL,,NYK,L,0,15,3,6,0.5,3,5,0.6,0,1,0,2,3,0.667,0,3,3
11370,Mario Hezonja,22-006,F-G,3/3/17,ORL,,MIA,W,0,16,2,6,0.333,2,4,0.5,0,2,0,4,4,1,0,3,3
11371,Roy Hibbert,30-025,C,1/5/17,CHO,@,DET,L,1,19,3,3,1,3,3,1,0,0,,2,2,1,2,4,6
11372,Buddy Hield,23-058,G,2/13/17,NOP,@,PHO,W,1,23,2,7,0.286,0,2,0,2,5,0.4,2,3,0.667,0,5,5
11373,Buddy Hield,22-354,G,12/5/16,NOP,,MEM,L,1,24,3,8,0.375,1,3,0.333,2,5,0.4,0,0,,0,3,3
11374,Buddy Hield,23-053,G,2/8/17,NOP,,UTA,L,1,19,3,7,0.429,1,1,1,2,6,0.333,0,0,,0,2,2
11375,Buddy Hield,22-335,G,11/16/16,NOP,@,ORL,L,0,20,3,7,0.429,2,4,0.5,1,3,0.333,1,1,1,0,5,5
11376,Buddy Hield,23-072,G,2/27/17,SAC,,MIN,L,0,27,3,8,0.375,2,3,0.667,1,5,0.2,1,2,0.5,0,5,5
11377,Buddy Hield,22-317,G,10/29/16,NOP,@,SAS,L,0,18,3,10,0.3,3,7,0.429,0,3,0,2,2,1,1,4,5
11378,Nene Hilario,34-045,F-C,10/28/16,HOU,@,DAL,W,0,19,0,2,0,0,2,0,0,0,,8,12,0.667,0,3,3
11379,Nene Hilario,34-117,F-C,1/8/17,HOU,@,TOR,W,1,13,4,5,0.8,4,5,0.8,0,0,,0,1,0,0,2,2
11380,Nene Hilario,34-155,F-C,2/15/17,HOU,,MIA,L,0,20,2,5,0.4,2,4,0.5,0,1,0,4,7,0.571,5,4,9
11381,Nene Hilario,34-178,F-C,3/10/17,HOU,@,CHI,W,0,19,4,8,0.5,4,7,0.571,0,1,0,0,0,,1,5,6
11382,Nene Hilario,34-075,F-C,11/27/16,HOU,@,POR,W,0,15,4,7,0.571,4,7,0.571,0,0,,0,0,,0,3,3
11383,George Hill,30-209,G,11/29/16,UTA,,HOU,W,1,32,2,6,0.333,0,3,0,2,3,0.667,2,2,1,0,1,1
11384,Solomon Hill,25-308,F,1/20/17,NOP,,BRK,L,1,23,4,6,0.667,4,6,0.667,0,0,,0,0,,0,0,0
11385,Solomon Hill,25-237,F,11/10/16,NOP,@,MIL,W,0,31,4,6,0.667,4,4,1,0,2,0,0,0,,1,5,6
11386,Solomon Hill,25-265,F,12/8/16,NOP,,PHI,L,1,38,3,7,0.429,2,4,0.5,1,3,0.333,1,2,0.5,1,3,4
11387,Justin Holiday,27-203,G,10/25/16,NYK,@,CLE,L,0,26,2,7,0.286,0,4,0,2,3,0.667,2,2,1,1,5,6
11388,Justin Holiday,27-252,G,12/13/16,NYK,@,PHO,L,0,25,3,8,0.375,3,6,0.5,0,2,0,2,2,1,0,1,1
11389,Justin Holiday,27-269,G,12/30/16,NYK,@,NOP,L,0,28,3,8,0.375,1,1,1,2,7,0.286,0,0,,1,6,7
11390,Justin Holiday,27-211,G,11/2/16,NYK,,HOU,L,0,18,3,10,0.3,1,6,0.167,2,4,0.5,0,0,,0,2,2
11391,Justin Holiday,27-226,G,11/17/16,NYK,@,WAS,L,0,23,2,3,0.667,1,1,1,1,2,0.5,3,4,0.75,0,4,4
11392,Justin Holiday,27-207,G,10/29/16,NYK,,MEM,W,0,19,4,7,0.571,4,5,0.8,0,2,0,0,0,,0,0,0
11393,Rondae Hollis-Jefferson,21-342,F,12/10/16,BRK,@,SAS,L,0,19,3,9,0.333,3,8,0.375,0,1,0,2,2,1,1,6,7
11394,Rondae Hollis-Jefferson,21-355,F,12/23/16,BRK,@,CLE,L,0,23,3,6,0.5,3,5,0.6,0,1,0,2,2,1,0,3,3
11395,Rondae Hollis-Jefferson,22-024,F,1/27/17,BRK,@,CLE,L,1,25,3,9,0.333,2,6,0.333,1,3,0.333,1,2,0.5,0,3,3
11396,Rondae Hollis-Jefferson,21-316,F,11/14/16,BRK,@,LAC,L,1,21,2,3,0.667,2,3,0.667,0,0,,4,4,1,1,1,2
11397,Rondae Hollis-Jefferson,22-022,F,1/25/17,BRK,,MIA,L,0,24,3,5,0.6,3,4,0.75,0,1,0,2,2,1,0,5,5
11398,Rondae Hollis-Jefferson,21-311,F,11/9/16,BRK,@,NYK,L,1,29,1,4,0.25,1,2,0.5,0,2,0,6,6,1,0,5,5
11399,Rondae Hollis-Jefferson,21-322,F,11/20/16,BRK,,POR,L,1,25,4,11,0.364,4,9,0.444,0,2,0,0,0,,1,2,3
11400,Richaun Holmes,23-133,F-C,2/25/17,PHI,@,NYK,L,0,16,3,4,0.75,2,3,0.667,1,1,1,1,2,0.5,1,1,2
11401,Richaun Holmes,23-032,F-C,11/16/16,PHI,,WAS,W,0,19,3,3,1,1,1,1,2,2,1,0,0,,2,1,3
11402,Richaun Holmes,23-133,F-C,2/25/17,PHI,@,NYK,L,0,16,3,4,0.75,2,3,0.667,1,1,1,1,2,0.5,1,1,2
11403,Richaun Holmes,23-027,F-C,11/11/16,PHI,,IND,W,0,24,4,10,0.4,4,9,0.444,0,1,0,0,0,,4,8,12
11404,Richaun Holmes,23-142,F-C,3/6/17,PHI,,MIL,L,1,22,3,9,0.333,3,8,0.375,0,1,0,2,2,1,5,4,9
11405,Richaun Holmes,23-155,F-C,3/19/17,PHI,,BOS,W,0,29,4,6,0.667,4,5,0.8,0,1,0,0,0,,1,6,7
11406,Rodney Hood,24-047,G-F,12/6/16,UTA,,PHO,W,1,12,3,6,0.5,1,4,0.25,2,2,1,0,0,,0,0,0
11407,Rodney Hood,24-036,G-F,11/25/16,UTA,,ATL,W,1,28,3,9,0.333,1,4,0.25,2,5,0.4,0,0,,1,3,4
11408,Al Horford,30-218,C-F,1/7/17,BOS,,NOP,W,1,35,3,18,0.167,2,12,0.167,1,6,0.167,1,1,1,4,3,7
11409,Al Horford,30-202,C-F,12/22/16,BOS,@,IND,W,1,33,3,12,0.25,3,9,0.333,0,3,0,2,2,1,3,8,11
11410,Al Horford,30-266,C-F,2/24/17,BOS,@,TOR,L,1,30,3,5,0.6,3,5,0.6,0,0,,2,2,1,0,5,5
11411,Dwight Howard,31-088,C,3/6/17,ATL,,GSW,L,1,29,3,4,0.75,3,4,0.75,0,0,,2,6,0.333,5,14,19
11412,Dwight Howard,30-350,C,11/22/16,ATL,,NOP,L,1,19,4,6,0.667,4,6,0.667,0,0,,0,0,,2,4,6
11413,Marcelo Huertas,33-259,G,2/8/17,LAL,@,DET,L,0,12,3,8,0.375,2,5,0.4,1,3,0.333,1,1,1,1,2,3
11414,Kris Humphries,31-361,F-C,2/1/17,ATL,@,MIA,L,0,16,3,4,0.75,2,3,0.667,1,1,1,1,2,0.5,0,3,3
11415,Serge Ibaka,27-146,F-C,2/11/17,ORL,@,DAL,L,1,25,4,10,0.4,4,9,0.444,0,1,0,0,0,,1,3,4
11416,Serge Ibaka,27-080,F-C,12/7/16,ORL,,BOS,L,1,25,3,10,0.3,1,6,0.167,2,4,0.5,0,0,,3,5,8
11417,Serge Ibaka,27-087,F-C,12/14/16,ORL,,LAC,L,1,31,3,10,0.3,2,5,0.4,1,5,0.2,1,2,0.5,2,6,8
11418,Serge Ibaka,27-054,F-C,11/11/16,ORL,,UTA,L,1,31,3,12,0.25,1,8,0.125,2,4,0.5,0,0,,2,6,8
11419,Andre Iguodala,32-350,G-F,1/12/17,GSW,,DET,W,0,21,3,5,0.6,1,2,0.5,2,3,0.667,0,0,,0,0,0
11420,Andre Iguodala,33-026,G-F,2/23/17,GSW,,LAC,W,0,30,2,6,0.333,2,4,0.5,0,2,0,4,4,1,1,5,6
11421,Andre Iguodala,33-041,G-F,3/10/17,GSW,@,MIN,L,0,32,4,6,0.667,4,5,0.8,0,1,0,0,0,,2,0,2
11422,Andre Iguodala,32-329,G-F,12/22/16,GSW,@,BRK,W,0,25,3,6,0.5,1,1,1,2,5,0.4,0,0,,1,5,6
11423,Andre Iguodala,32-346,G-F,1/8/17,GSW,@,SAC,W,0,29,3,6,0.5,2,5,0.4,1,1,1,1,2,0.5,2,5,7
11424,Andre Iguodala,33-014,G-F,2/11/17,GSW,@,OKC,W,0,28,3,8,0.375,2,4,0.5,1,4,0.25,1,2,0.5,1,4,5
11425,Andre Iguodala,32-295,G-F,11/18/16,GSW,@,BOS,W,0,22,4,7,0.571,4,6,0.667,0,1,0,0,1,0,1,5,6
11426,Ersan Ilyasova,29-302,F,3/13/17,ATL,@,SAS,L,0,23,3,7,0.429,2,5,0.4,1,2,0.5,1,1,1,1,4,5
11427,Joe Ingles,29-036,F-G,11/7/16,UTA,@,PHI,W,0,21,3,8,0.375,3,7,0.429,0,1,0,2,3,0.667,1,2,3
11428,Joe Ingles,29-132,F-G,2/11/17,UTA,,BOS,L,1,30,3,10,0.3,3,5,0.6,0,5,0,2,2,1,0,3,3
11429,Joe Ingles,29-048,F-G,11/19/16,UTA,@,HOU,L,0,15,3,3,1,1,1,1,2,2,1,0,0,,0,1,1
11430,Joe Ingles,29-062,F-G,12/3/16,UTA,,DEN,W,0,27,3,5,0.6,1,2,0.5,2,3,0.667,0,0,,0,3,3
11431,Joe Ingles,29-030,F-G,11/1/16,UTA,@,SAS,W,0,19,3,4,0.75,1,1,1,2,3,0.667,0,0,,0,1,1
11432,Joe Ingles,29-028,F-G,10/30/16,UTA,@,LAC,L,0,20,3,7,0.429,1,4,0.25,2,3,0.667,0,0,,1,6,7
11433,Joe Ingles,29-104,F-G,1/14/17,UTA,,ORL,W,0,11,3,3,1,1,1,1,2,2,1,0,0,,0,1,1
11434,Brandon Ingram,19-084,F,11/25/16,LAL,,GSW,L,1,39,3,18,0.167,3,14,0.214,0,4,0,2,2,1,1,8,9
11435,Brandon Ingram,19-179,F,2/28/17,LAL,,CHO,L,1,42,3,10,0.3,2,5,0.4,1,5,0.2,1,4,0.25,0,5,5
11436,Brandon Ingram,19-074,F,11/15/16,LAL,,BRK,W,0,24,2,5,0.4,2,4,0.5,0,1,0,4,4,1,0,3,3
11437,Brandon Ingram,19-089,F,11/30/16,LAL,@,CHI,W,1,41,1,9,0.111,1,7,0.143,0,2,0,6,8,0.75,0,3,3
11438,Kyrie Irving,24-227,G,11/5/16,CLE,@,PHI,W,1,34,3,17,0.176,3,12,0.25,0,5,0,2,3,0.667,1,6,7
11439,Demetrius Jackson,22-060,G,11/6/16,BOS,,DEN,L,0,11,2,3,0.667,1,2,0.5,1,1,1,3,4,0.75,2,1,3
11440,Reggie Jackson,26-333,G,3/15/17,DET,,UTA,L,1,20,4,11,0.364,4,10,0.4,0,1,0,0,0,,0,2,2
11441,Reggie Jackson,26-319,G,3/1/17,DET,@,NOP,L,1,29,4,16,0.25,4,13,0.308,0,3,0,0,0,,0,2,2
11442,Al Jefferson,32-038,C-F,2/11/17,IND,,MIL,L,0,17,4,6,0.667,4,6,0.667,0,0,,0,0,,0,4,4
11443,Al Jefferson,32-022,C-F,1/26/17,IND,@,MIN,W,0,12,4,6,0.667,4,6,0.667,0,0,,0,0,,1,5,6
11444,Al Jefferson,31-348,C-F,12/17/16,IND,@,DET,W,0,17,3,10,0.3,3,10,0.3,0,0,,2,4,0.5,2,7,9
11445,Al Jefferson,32-063,C-F,3/8/17,IND,,DET,W,0,18,4,10,0.4,4,10,0.4,0,0,,0,0,,1,4,5
11446,Al Jefferson,32-033,C-F,2/6/17,IND,,OKC,W,0,12,4,9,0.444,4,9,0.444,0,0,,0,0,,2,3,5
11447,Al Jefferson,32-025,C-F,1/29/17,IND,,HOU,W,0,10,4,5,0.8,4,5,0.8,0,0,,0,0,,0,0,0
11448,Richard Jefferson,36-206,F,1/13/17,CLE,@,SAC,W,0,21,2,3,0.667,1,1,1,1,2,0.5,3,5,0.6,1,2,3
11449,Richard Jefferson,36-187,F,12/25/16,CLE,,GSW,W,0,29,2,11,0.182,2,6,0.333,0,5,0,4,4,1,0,2,2
11450,Richard Jefferson,36-222,F,1/29/17,CLE,,OKC,W,0,31,4,5,0.8,4,4,1,0,1,0,0,0,,0,4,4
11451,Richard Jefferson,36-220,F,1/27/17,CLE,,BRK,W,0,25,3,6,0.5,2,2,1,1,4,0.25,1,2,0.5,0,1,1
11452,Richard Jefferson,36-182,F,12/20/16,CLE,@,MIL,W,1,35,2,7,0.286,1,2,0.5,1,5,0.2,3,3,1,0,2,2
11453,Richard Jefferson,36-253,F,3/1/17,CLE,@,BOS,L,0,18,3,7,0.429,2,4,0.5,1,3,0.333,1,1,1,1,3,4
11454,Richard Jefferson,36-161,F,11/29/16,CLE,@,MIL,L,0,12,2,4,0.5,0,1,0,2,3,0.667,2,2,1,0,2,2
11455,Jonas Jerebko,29-315,F,1/11/17,BOS,,WAS,W,0,22,3,5,0.6,2,2,1,1,3,0.333,1,2,0.5,2,4,6
11456,Jonas Jerebko,29-282,F,12/9/16,BOS,,TOR,L,0,17,3,5,0.6,1,1,1,2,4,0.5,0,0,,2,1,3
11457,Jonas Jerebko,30-001,F,3/3/17,BOS,@,LAL,W,0,16,3,3,1,1,1,1,2,2,1,0,0,,0,4,4
11458,Jonas Jerebko,29-328,F,1/24/17,BOS,@,WAS,L,0,18,4,5,0.8,4,4,1,0,1,0,0,0,,2,3,5
11459,Amir Johnson,29-215,F,12/2/16,BOS,,SAC,W,1,15,3,3,1,3,3,1,0,0,,2,2,1,2,0,2
11460,Amir Johnson,29-199,F,11/16/16,BOS,,DAL,W,1,29,3,4,0.75,3,4,0.75,0,0,,2,2,1,3,3,6
11461,Amir Johnson,29-318,F,3/15/17,BOS,,MIN,W,1,26,3,3,1,3,3,1,0,0,,2,3,0.667,1,3,4
11462,Amir Johnson,29-243,F,12/30/16,BOS,,MIA,W,1,23,2,3,0.667,2,3,0.667,0,0,,4,6,0.667,2,3,5
11463,Amir Johnson,29-178,F,10/26/16,BOS,,BRK,W,1,20,4,6,0.667,4,6,0.667,0,0,,0,1,0,4,3,7
11464,Amir Johnson,29-311,F,3/8/17,BOS,@,GSW,W,1,20,4,4,1,4,4,1,0,0,,0,0,,0,5,5
11465,James Johnson,30-012,F,3/4/17,MIA,,CLE,W,0,18,3,5,0.6,2,3,0.667,1,2,0.5,1,1,1,1,3,4
11466,James Johnson,29-340,F,1/25/17,MIA,@,BRK,W,0,19,3,6,0.5,2,3,0.667,1,3,0.333,1,2,0.5,0,2,2
11467,James Johnson,30-007,F,2/27/17,MIA,@,DAL,L,0,31,4,12,0.333,4,8,0.5,0,4,0,0,0,,1,4,5
11468,Joe Johnson,35-190,G-F,1/5/17,UTA,@,TOR,L,0,20,3,6,0.5,3,5,0.6,0,1,0,2,2,1,0,3,3
11469,Joe Johnson,35-225,G-F,2/9/17,UTA,@,DAL,L,0,26,3,8,0.375,1,2,0.5,2,6,0.333,0,0,,0,0,0
11470,Joe Johnson,35-125,G-F,11/1/16,UTA,@,SAS,W,1,34,3,8,0.375,1,3,0.333,2,5,0.4,0,0,,0,3,3
11471,Joe Johnson,35-170,G-F,12/16/16,UTA,,DAL,W,0,21,3,7,0.429,3,5,0.6,0,2,0,2,2,1,1,4,5
11472,Joe Johnson,35-262,G-F,3/18/17,UTA,@,CHI,L,1,33,3,12,0.25,3,10,0.3,0,2,0,2,2,1,3,3,6
11473,Joe Johnson,35-164,G-F,12/10/16,UTA,,SAC,W,0,25,4,9,0.444,4,6,0.667,0,3,0,0,0,,1,3,4
11474,Joe Johnson,35-213,G-F,1/28/17,UTA,,MEM,L,0,27,3,7,0.429,1,3,0.333,2,4,0.5,0,0,,0,2,2
11475,Stanley Johnson,20-201,F,12/16/16,DET,@,WAS,L,0,17,4,5,0.8,4,4,1,0,1,0,0,1,0,0,1,1
11476,Stanley Johnson,20-253,F,2/6/17,DET,,PHI,W,0,24,3,9,0.333,3,7,0.429,0,2,0,2,3,0.667,2,6,8
11477,Stanley Johnson,20-178,F,11/23/16,DET,,MIA,W,0,20,3,4,0.75,2,2,1,1,2,0.5,1,1,1,1,3,4
11478,Stanley Johnson,20-228,F,1/12/17,DET,@,GSW,L,0,38,3,5,0.6,1,2,0.5,2,3,0.667,0,0,,0,2,2
11479,Stanley Johnson,20-284,F,3/9/17,DET,,CLE,W,0,18,3,6,0.5,3,3,1,0,3,0,2,3,0.667,0,5,5
11480,Tyler Johnson,24-277,G,2/8/17,MIA,@,MIL,W,0,27,3,11,0.273,3,9,0.333,0,2,0,2,2,1,1,3,4
11481,Tyler Johnson,24-275,G,2/6/17,MIA,@,MIN,W,0,22,3,9,0.333,2,6,0.333,1,3,0.333,1,2,0.5,1,1,2
11482,Tyler Johnson,24-194,G,11/17/16,MIA,,MIL,W,0,23,3,8,0.375,2,5,0.4,1,3,0.333,1,2,0.5,1,7,8
11483,Tyler Johnson,24-208,G,12/1/16,MIA,@,UTA,W,0,30,3,11,0.273,3,7,0.429,0,4,0,2,2,1,1,5,6
11484,Wesley Johnson,29-164,F-G,12/22/16,LAC,,SAS,W,0,27,3,10,0.3,1,3,0.333,2,7,0.286,0,1,0,1,8,9
11485,Wesley Johnson,29-119,F-G,11/7/16,LAC,,DET,W,0,18,3,8,0.375,1,3,0.333,2,5,0.4,0,0,,1,4,5
11486,Nikola Jokic,21-277,C-F,11/22/16,DEN,,CHI,W,0,18,3,5,0.6,3,5,0.6,0,0,,2,2,1,3,5,8
11487,Nikola Jokic,21-258,C-F,11/3/16,DEN,@,MIN,W,1,14,3,3,1,3,3,1,0,0,,2,4,0.5,1,2,3
11488,Nikola Jokic,21-273,C-F,11/18/16,DEN,,TOR,L,0,27,4,8,0.5,4,6,0.667,0,2,0,0,0,,2,10,12
11489,Nikola Jokic,21-308,C-F,12/23/16,DEN,,ATL,L,1,19,3,4,0.75,2,3,0.667,1,1,1,1,2,0.5,1,6,7
11490,Derrick Jones,20-015,F,3/2/17,PHO,,CHO,W,0,22,3,4,0.75,3,4,0.75,0,0,,2,2,1,0,0,0
11491,Derrick Jones,20-013,F,2/28/17,PHO,@,MEM,L,0,10,4,4,1,4,4,1,0,0,,0,0,,0,2,2
11492,Terrence Jones,24-339,F,12/13/16,NOP,,GSW,L,0,21,4,6,0.667,4,5,0.8,0,1,0,0,0,,1,9,10
11493,Tyus Jones,20-186,G,11/12/16,MIN,,LAC,L,0,8,2,3,0.667,0,0,,2,3,0.667,2,2,1,0,2,2
11494,DeAndre Jordan,28-129,C,11/27/16,LAC,@,IND,L,1,32,2,3,0.667,2,3,0.667,0,0,,4,7,0.571,2,12,14
11495,DeAndre Jordan,28-191,C,1/28/17,LAC,@,GSW,L,1,23,4,4,1,4,4,1,0,0,,0,3,0,2,3,5
11496,DeAndre Jordan,28-109,C,11/7/16,LAC,,DET,W,1,27,4,5,0.8,4,5,0.8,0,0,,0,0,,0,10,10
11497,DeAndre Jordan,28-107,C,11/5/16,LAC,@,SAS,W,1,30,4,8,0.5,4,8,0.5,0,0,,0,0,,1,7,8
11498,DeAndre Jordan,28-104,C,11/2/16,LAC,,OKC,L,1,32,4,4,1,4,4,1,0,0,,0,3,0,0,6,6
11499,DeAndre Jordan,28-118,C,11/16/16,LAC,,MEM,L,1,35,4,5,0.8,4,5,0.8,0,0,,0,2,0,4,10,14
11500,Cory Joseph,25-069,G,10/28/16,TOR,,CLE,L,0,21,4,7,0.571,4,7,0.571,0,0,,0,0,,0,1,1
11501,Cory Joseph,25-165,G,2/1/17,TOR,@,BOS,L,0,23,4,10,0.4,4,10,0.4,0,0,,0,1,0,0,1,1
11502,Cory Joseph,25-134,G,1/1/17,TOR,@,LAL,W,0,27,4,6,0.667,4,5,0.8,0,1,0,0,0,,0,1,1
11503,Cory Joseph,25-078,G,11/6/16,TOR,,SAC,L,0,17,2,7,0.286,1,5,0.2,1,2,0.5,3,4,0.75,0,1,1
11504,Cory Joseph,25-176,G,2/12/17,TOR,,DET,L,0,19,3,8,0.375,2,6,0.333,1,2,0.5,1,2,0.5,0,2,2
11505,Cory Joseph,25-069,G,10/28/16,TOR,,CLE,L,0,21,4,7,0.571,4,7,0.571,0,0,,0,0,,0,1,1
11506,Frank Kaminsky,23-294,F-C,1/23/17,CHO,,WAS,L,0,20,3,10,0.3,1,7,0.143,2,3,0.667,0,0,,1,3,4
11507,Frank Kaminsky,23-214,F-C,11/4/16,CHO,@,BRK,W,0,18,3,5,0.6,1,1,1,2,4,0.5,0,0,,0,4,4
11508,Frank Kaminsky,23-299,F-C,1/28/17,CHO,,SAC,L,0,22,3,10,0.3,1,2,0.5,2,8,0.25,0,0,,0,4,4
11509,Frank Kaminsky,23-221,F-C,11/11/16,CHO,,TOR,L,0,18,3,9,0.333,1,5,0.2,2,4,0.5,0,0,,1,1,2
11510,Frank Kaminsky,23-249,F-C,12/9/16,CHO,,ORL,W,0,27,1,7,0.143,0,3,0,1,4,0.25,5,6,0.833,2,7,9
11511,Enes Kanter,24-213,C,12/19/16,OKC,,ATL,L,0,15,4,5,0.8,4,5,0.8,0,0,,0,0,,4,3,7
11512,Enes Kanter,24-180,C,11/16/16,OKC,,HOU,W,0,15,3,6,0.5,3,6,0.5,0,0,,2,2,1,1,6,7
11513,Enes Kanter,24-173,C,11/9/16,OKC,,TOR,L,0,19,3,3,1,3,3,1,0,0,,2,2,1,0,0,0
11514,Michael Kidd-Gilchrist,23-116,F,1/20/17,CHO,,TOR,W,1,31,4,9,0.444,4,9,0.444,0,0,,0,0,,3,8,11
11515,Michael Kidd-Gilchrist,23-166,F,3/11/17,CHO,,NOP,L,1,36,3,5,0.6,3,5,0.6,0,0,,2,2,1,1,5,6
11516,Michael Kidd-Gilchrist,23-128,F,2/1/17,CHO,@,GSW,L,1,23,4,11,0.364,4,11,0.364,0,0,,0,0,,1,8,9
11517,Michael Kidd-Gilchrist,23-138,F,2/11/17,CHO,,LAC,L,1,32,4,8,0.5,4,8,0.5,0,0,,0,0,,1,6,7
11518,Michael Kidd-Gilchrist,23-173,F,3/18/17,CHO,,WAS,W,1,27,4,8,0.5,4,8,0.5,0,0,,0,0,,1,3,4
11519,Michael Kidd-Gilchrist,23-101,F,1/5/17,CHO,@,DET,L,1,27,2,5,0.4,2,5,0.4,0,0,,4,4,1,4,9,13
11520,Michael Kidd-Gilchrist,23-119,F,1/23/17,CHO,,WAS,L,1,27,4,8,0.5,4,8,0.5,0,0,,0,1,0,1,6,7
11521,Michael Kidd-Gilchrist,23-136,F,2/9/17,CHO,,HOU,L,1,35,4,9,0.444,4,9,0.444,0,0,,0,0,,4,5,9
11522,Sean Kilpatrick,27-019,G,1/25/17,BRK,,MIA,L,0,15,3,6,0.5,1,3,0.333,2,3,0.667,0,0,,0,1,1
11523,Sean Kilpatrick,26-349,G,12/20/16,BRK,@,TOR,L,1,23,3,10,0.3,3,6,0.5,0,4,0,2,2,1,0,1,1
11524,Sean Kilpatrick,26-362,G,1/2/17,BRK,,UTA,L,1,28,2,7,0.286,1,4,0.25,1,3,0.333,3,3,1,0,4,4
11525,Sean Kilpatrick,27-065,G,3/12/17,BRK,,NYK,W,0,25,1,9,0.111,1,3,0.333,0,6,0,6,6,1,0,8,8
11526,Sean Kilpatrick,27-024,G,1/30/17,BRK,@,MIA,L,0,17,3,6,0.5,3,4,0.75,0,2,0,2,2,1,0,3,3
11527,Brandon Knight,25-015,G,12/17/16,PHO,@,OKC,L,0,20,3,10,0.3,2,8,0.25,1,2,0.5,1,1,1,0,1,1
11528,Kyle Korver,35-277,G-F,12/19/16,ATL,@,OKC,W,1,35,3,6,0.5,1,2,0.5,2,4,0.5,0,0,,0,2,2
11529,Kyle Korver,35-329,G-F,2/9/17,CLE,@,OKC,L,0,26,3,3,1,1,1,1,2,2,1,0,0,,0,1,1
11530,Kosta Koufos,27-287,C,12/7/16,SAC,@,DAL,W,1,17,4,4,1,4,4,1,0,0,,0,0,,1,3,4
11531,Kosta Koufos,27-331,C,1/20/17,SAC,@,MEM,L,1,24,3,5,0.6,3,5,0.6,0,0,,2,2,1,0,2,2
11532,Kosta Koufos,27-246,C,10/27/16,SAC,,SAS,L,1,24,4,7,0.571,4,7,0.571,0,0,,0,0,,2,5,7
11533,Kosta Koufos,27-365,C,2/23/17,SAC,,DEN,W,1,21,4,7,0.571,4,7,0.571,0,0,,0,0,,1,5,6
11534,Kosta Koufos,28-014,C,3/10/17,SAC,,WAS,L,1,21,4,11,0.364,4,11,0.364,0,0,,0,0,,2,4,6
11535,Kosta Koufos,27-270,C,11/20/16,SAC,,TOR,W,0,26,3,6,0.5,3,6,0.5,0,0,,2,5,0.4,0,6,6
11536,Mindaugas Kuzminskas,27-138,F,3/6/17,NYK,@,ORL,W,0,16,3,5,0.6,2,4,0.5,1,1,1,1,1,1,0,1,1
11537,Mindaugas Kuzminskas,27-108,F,2/4/17,NYK,,CLE,L,0,19,2,6,0.333,1,2,0.5,1,4,0.25,3,4,0.75,1,5,6
11538,Mindaugas Kuzminskas,27-152,F,3/20/17,NYK,@,LAC,L,0,18,2,6,0.333,1,2,0.5,1,4,0.25,3,3,1,2,2,4
11539,Mindaugas Kuzminskas,27-029,F,11/17/16,NYK,@,WAS,L,0,7,3,5,0.6,1,2,0.5,2,3,0.667,0,0,,0,1,1
11540,Skal Labissiere,20-344,F,2/25/17,SAC,,CHO,L,0,23,4,10,0.4,4,9,0.444,0,1,0,0,0,,3,10,13
11541,Skal Labissiere,20-232,F,11/5/16,SAC,@,MIL,L,0,15,3,5,0.6,3,5,0.6,0,0,,2,3,0.667,3,0,3
11542,Skal Labissiere,20-357,F,3/10/17,SAC,,WAS,L,0,14,4,6,0.667,4,6,0.667,0,0,,0,0,,0,5,5
11543,Jeremy Lamb,24-255,G-F,2/9/17,CHO,,HOU,L,0,11,3,8,0.375,2,5,0.4,1,3,0.333,1,1,1,0,3,3
11544,Jeremy Lamb,24-201,G-F,12/17/16,CHO,@,ATL,W,0,16,4,7,0.571,4,6,0.667,0,1,0,0,1,0,1,4,5
11545,Jeremy Lamb,24-289,G-F,3/15/17,CHO,@,IND,L,1,29,3,9,0.333,3,8,0.375,0,1,0,2,2,1,1,6,7
11546,Jeremy Lamb,24-196,G-F,12/12/16,CHO,@,IND,L,0,14,2,6,0.333,2,3,0.667,0,3,0,4,4,1,0,5,5
11547,Jeremy Lamb,24-282,G-F,3/8/17,CHO,@,MIA,L,0,25,4,7,0.571,4,7,0.571,0,0,,0,0,,0,4,4
11548,Joffrey Lauvergne,25-092,C-F,12/31/16,OKC,,LAC,W,0,16,2,4,0.5,2,3,0.667,0,1,0,4,5,0.8,0,3,3
11549,Joffrey Lauvergne,25-036,C-F,11/5/16,OKC,,MIN,W,0,23,4,9,0.444,4,8,0.5,0,1,0,0,0,,2,2,4
11550,Joffrey Lauvergne,25-034,C-F,11/3/16,OKC,@,GSW,L,0,19,3,5,0.6,2,3,0.667,1,2,0.5,1,2,0.5,4,3,7
11551,Joffrey Lauvergne,25-086,C-F,12/25/16,OKC,,MIN,W,0,18,3,4,0.75,1,2,0.5,2,2,1,0,0,,1,3,4
11552,Zach LaVine,21-302,G,1/6/17,MIN,@,WAS,L,1,37,3,14,0.214,1,8,0.125,2,6,0.333,0,0,,0,5,5
11553,Zach LaVine,21-328,G,2/1/17,MIN,@,CLE,L,1,37,4,18,0.222,4,12,0.333,0,6,0,0,0,,0,3,3
11554,Ty Lawson,29-112,G,2/23/17,SAC,,DEN,W,1,31,4,10,0.4,4,9,0.444,0,1,0,0,0,,3,1,4
11555,Ty Lawson,28-363,G,10/31/16,SAC,@,ATL,L,1,23,3,5,0.6,2,4,0.5,1,1,1,1,2,0.5,1,1,2
11556,Ty Lawson,29-029,G,12/2/16,SAC,@,BOS,L,0,21,3,8,0.375,3,6,0.5,0,2,0,2,2,1,3,0,3
11557,Ty Lawson,28-361,G,10/29/16,SAC,,MIN,W,1,34,3,10,0.3,1,5,0.2,2,5,0.4,0,0,,0,1,1
11558,Ty Lawson,29-127,G,3/10/17,SAC,,WAS,L,0,20,2,5,0.4,2,4,0.5,0,1,0,4,4,1,0,0,0
11559,Ty Lawson,29-125,G,3/8/17,SAC,@,SAS,L,0,24,3,7,0.429,3,6,0.5,0,1,0,2,2,1,0,1,1
11560,Ty Lawson,29-041,G,12/14/16,SAC,@,HOU,L,0,24,4,9,0.444,4,8,0.5,0,1,0,0,0,,0,0,0
11561,Ty Lawson,29-079,G,1/21/17,SAC,@,CHI,L,0,23,2,7,0.286,2,7,0.286,0,0,,4,5,0.8,1,2,3
11562,Ty Lawson,29-039,G,12/12/16,SAC,,LAL,W,0,26,3,8,0.375,3,5,0.6,0,3,0,2,2,1,2,4,6
11563,Ty Lawson,29-055,G,12/28/16,SAC,@,POR,L,0,29,2,8,0.25,1,4,0.25,1,4,0.25,3,4,0.75,1,0,1
11564,Ty Lawson,29-020,G,11/23/16,SAC,,OKC,W,0,21,3,4,0.75,3,4,0.75,0,0,,2,2,1,1,3,4
11565,Ty Lawson,29-135,G,3/18/17,SAC,@,OKC,L,0,22,3,6,0.5,3,5,0.6,0,1,0,2,5,0.4,1,0,1
11566,Ty Lawson,29-068,G,1/10/17,SAC,,DET,W,0,24,2,9,0.222,1,7,0.143,1,2,0.5,3,4,0.75,0,1,1
11567,Courtney Lee,31-126,G,2/6/17,NYK,,LAL,L,1,25,3,6,0.5,1,2,0.5,2,4,0.5,0,0,,0,3,3
11568,Courtney Lee,31-067,G,12/9/16,NYK,@,SAC,W,1,33,3,7,0.429,1,4,0.25,2,3,0.667,0,1,0,1,3,4
11569,David Lee,33-229,F,12/14/16,SAS,,BOS,W,1,30,3,5,0.6,3,5,0.6,0,0,,2,3,0.667,2,8,10
11570,David Lee,33-245,F,12/30/16,SAS,,POR,W,0,16,4,4,1,4,4,1,0,0,,0,0,,2,2,4
11571,David Lee,33-225,F,12/10/16,SAS,,BRK,W,0,19,3,5,0.6,3,5,0.6,0,0,,2,2,1,2,6,8
11572,David Lee,33-217,F,12/2/16,SAS,,WAS,W,0,17,3,6,0.5,3,6,0.5,0,0,,2,4,0.5,3,4,7
11573,David Lee,33-184,F,10/30/16,SAS,@,MIA,W,1,25,3,7,0.429,3,7,0.429,0,0,,2,2,1,4,7,11
11574,David Lee,33-249,F,1/3/17,SAS,,TOR,W,0,15,4,6,0.667,4,6,0.667,0,0,,0,0,,2,2,4
11575,David Lee,33-247,F,1/1/17,SAS,@,ATL,L,0,18,4,9,0.444,4,9,0.444,0,0,,0,0,,1,2,3
11576,Alex Len,23-264,C,3/7/17,PHO,,WAS,L,1,22,3,4,0.75,3,4,0.75,0,0,,2,2,1,2,9,11
11577,Alex Len,23-262,C,3/5/17,PHO,,BOS,W,1,13,3,7,0.429,3,7,0.429,0,0,,2,3,0.667,1,1,2
11578,Alex Len,23-190,C,12/23/16,PHO,,PHI,W,0,18,3,4,0.75,3,4,0.75,0,0,,2,2,1,2,5,7
11579,Alex Len,23-184,C,12/17/16,PHO,@,OKC,L,0,14,3,6,0.5,3,6,0.5,0,0,,2,3,0.667,5,2,7
11580,Alex Len,23-132,C,10/26/16,PHO,,SAC,L,0,24,3,6,0.5,3,6,0.5,0,0,,2,2,1,2,5,7
11581,Alex Len,23-266,C,3/9/17,PHO,,LAL,L,1,22,4,7,0.571,4,7,0.571,0,0,,0,0,,3,3,6
11582,Meyers Leonard,24-277,C-F,11/30/16,POR,,IND,W,0,23,3,9,0.333,1,2,0.5,2,7,0.286,0,0,,1,2,3
11583,Meyers Leonard,24-290,C-F,12/13/16,POR,,OKC,W,0,22,3,5,0.6,1,2,0.5,2,3,0.667,0,0,,0,4,4
11584,Meyers Leonard,24-324,C-F,1/16/17,POR,@,WAS,L,0,22,4,7,0.571,4,6,0.667,0,1,0,0,0,,2,2,4
11585,Jon Leuer,27-204,F,12/4/16,DET,,ORL,L,0,26,3,7,0.429,2,3,0.667,1,4,0.25,1,2,0.5,0,6,6
11586,Jon Leuer,27-236,F,1/5/17,DET,,CHO,W,1,22,3,6,0.5,1,3,0.333,2,3,0.667,0,0,,1,5,6
11587,Jon Leuer,27-304,F,3/14/17,DET,@,CLE,L,0,22,3,6,0.5,3,6,0.5,0,0,,2,2,1,2,5,7
11588,Jon Leuer,27-171,F,11/1/16,DET,,NYK,W,0,26,4,9,0.444,4,8,0.5,0,1,0,0,0,,3,3,6
11589,Jon Leuer,27-184,F,11/14/16,DET,,OKC,W,0,29,3,8,0.375,3,7,0.429,0,1,0,2,3,0.667,1,8,9
11590,Jon Leuer,27-196,F,11/26/16,DET,@,OKC,L,0,22,4,7,0.571,4,4,1,0,3,0,0,0,,0,3,3
11591,Jon Leuer,27-259,F,1/28/17,DET,@,MIA,L,1,24,4,5,0.8,4,4,1,0,1,0,0,1,0,1,0,1
11592,Jon Leuer,27-181,F,11/11/16,DET,@,SAS,L,0,28,3,8,0.375,3,3,1,0,5,0,2,2,1,0,3,3
11593,Jon Leuer,27-223,F,12/23/16,DET,,GSW,L,1,33,4,7,0.571,4,6,0.667,0,1,0,0,0,,1,6,7
11594,Caris LeVert,22-143,G-F,1/15/17,BRK,,HOU,L,0,22,2,8,0.25,0,2,0,2,6,0.333,2,2,1,0,2,2
11595,DeAndre Liggins,28-273,G,12/29/16,CLE,,BOS,W,1,20,2,5,0.4,0,1,0,2,4,0.5,2,2,1,0,0,0
11596,DeAndre Liggins,28-314,G,2/8/17,CLE,@,IND,W,1,16,3,4,0.75,2,2,1,1,2,0.5,1,1,1,0,0,0
11597,Damian Lillard,26-117,G,11/9/16,POR,@,LAC,L,1,28,1,10,0.1,1,6,0.167,0,4,0,6,6,1,0,1,1
11598,Shaun Livingston,31-129,G,1/18/17,GSW,,OKC,W,0,20,4,8,0.5,4,8,0.5,0,0,,0,0,,1,0,1
11599,Shaun Livingston,31-146,G,2/4/17,GSW,@,SAC,L,0,17,3,4,0.75,3,4,0.75,0,0,,2,2,1,0,2,2
11600,Shaun Livingston,31-121,G,1/10/17,GSW,,MIA,W,0,18,3,5,0.6,3,5,0.6,0,0,,2,4,0.5,0,0,0
11601,Shaun Livingston,31-139,G,1/28/17,GSW,,LAC,W,0,16,4,6,0.667,4,6,0.667,0,0,,0,0,,0,2,2
11602,Shaun Livingston,31-165,G,2/23/17,GSW,,LAC,W,0,17,4,7,0.571,4,7,0.571,0,0,,0,0,,0,1,1
11603,Shaun Livingston,31-097,G,12/17/16,GSW,,POR,W,0,16,3,5,0.6,3,5,0.6,0,0,,2,2,1,0,2,2
11604,Shawn Long,24-049,F,3/19/17,PHI,,BOS,W,0,7,3,4,0.75,3,4,0.75,0,0,,2,4,0.5,2,1,3
11605,Brook Lopez,28-339,C,3/6/17,BRK,@,MEM,W,1,32,3,6,0.5,3,5,0.6,0,1,0,2,2,1,0,4,4
11606,Robin Lopez,28-269,C,12/26/16,CHI,,IND,W,1,32,4,8,0.5,4,8,0.5,0,0,,0,1,0,5,7,12
11607,Robin Lopez,28-220,C,11/7/16,CHI,,ORL,W,1,24,4,7,0.571,4,7,0.571,0,0,,0,0,,3,4,7
11608,Robin Lopez,28-298,C,1/24/17,CHI,@,ORL,W,1,27,4,5,0.8,4,5,0.8,0,0,,0,0,,1,3,4
11609,Robin Lopez,28-249,C,12/6/16,CHI,@,DET,L,1,33,3,5,0.6,3,5,0.6,0,0,,2,6,0.333,3,5,8
11610,Robin Lopez,28-348,C,3/15/17,CHI,,MEM,L,1,24,4,7,0.571,4,7,0.571,0,0,,0,0,,1,2,3
11611,Robin Lopez,28-215,C,11/2/16,CHI,@,BOS,L,1,14,3,6,0.5,3,6,0.5,0,0,,2,4,0.5,3,2,5
11612,Robin Lopez,28-259,C,12/16/16,CHI,,MIL,L,1,28,3,10,0.3,3,10,0.3,0,0,,2,2,1,6,1,7
11613,Robin Lopez,28-209,C,10/27/16,CHI,,BOS,W,1,27,3,8,0.375,3,8,0.375,0,0,,2,4,0.5,6,2,8
11614,Robin Lopez,28-319,C,2/14/17,CHI,,TOR,W,1,21,4,12,0.333,4,12,0.333,0,0,,0,0,,2,4,6
11615,Timothe Luwawu-Cabarrot,21-301,F,3/6/17,PHI,,MIL,L,0,18,3,7,0.429,3,5,0.6,0,2,0,2,2,1,0,1,1
11616,Trey Lyles,21-006,F,11/11/16,UTA,@,ORL,W,0,21,3,7,0.429,1,2,0.5,2,5,0.4,0,0,,1,3,4
11617,Trey Lyles,21-098,F,2/11/17,UTA,,BOS,L,0,22,3,11,0.273,2,6,0.333,1,5,0.2,1,1,1,3,3,6
11618,Trey Lyles,21-015,F,11/20/16,UTA,@,DEN,L,1,21,3,8,0.375,1,4,0.25,2,4,0.5,0,0,,1,5,6
11619,Trey Lyles,21-095,F,2/8/17,UTA,@,NOP,W,0,14,3,7,0.429,1,3,0.333,2,4,0.5,0,0,,0,1,1
11620,Shelvin Mack,26-253,G,12/31/16,UTA,,PHO,W,0,26,3,8,0.375,1,6,0.167,2,2,1,0,0,,0,2,2
11621,Shelvin Mack,26-199,G,11/7/16,UTA,@,PHI,W,1,29,3,6,0.5,1,4,0.25,2,2,1,0,0,,0,0,0
11622,Shelvin Mack,26-225,G,12/3/16,UTA,,DEN,W,0,26,3,9,0.333,3,8,0.375,0,1,0,2,2,1,0,1,1
11623,Shelvin Mack,26-256,G,1/3/17,UTA,@,BOS,L,1,26,3,10,0.3,3,9,0.333,0,1,0,2,2,1,0,1,1
11624,Thon Maker,19-337,F-C,1/27/17,MIL,@,TOR,L,0,8,3,5,0.6,3,5,0.6,0,0,,2,2,1,2,0,2
11625,Boban Marjanovic,28-148,C,1/10/17,DET,@,SAC,L,0,10,3,7,0.429,3,7,0.429,0,0,,2,2,1,1,3,4
11626,Jarell Martin,22-203,F,12/13/16,MEM,@,CLE,L,0,19,3,4,0.75,3,4,0.75,0,0,,2,2,1,2,8,10
11627,Wesley Matthews,30-124,G,2/15/17,DAL,@,DET,L,1,37,4,13,0.308,4,6,0.667,0,7,0,0,0,,0,2,2
11628,Wesley Matthews,30-031,G,11/14/16,DAL,@,NYK,L,1,34,3,9,0.333,1,4,0.25,2,5,0.4,0,0,,0,5,5
11629,Wesley Matthews,30-158,G,3/21/17,DAL,,GSW,L,1,33,3,8,0.375,1,3,0.333,2,5,0.4,0,0,,1,2,3
11630,Luc Mbah a Moute,30-108,F,12/26/16,LAC,,DEN,L,1,32,3,6,0.5,1,3,0.333,2,3,0.667,0,0,,0,7,7
11631,Luc Mbah a Moute,30-124,F,1/11/17,LAC,,ORL,W,1,23,4,8,0.5,4,7,0.571,0,1,0,0,0,,1,1,2
11632,Luc Mbah a Moute,30-145,F,2/1/17,LAC,@,PHO,W,0,13,4,5,0.8,4,5,0.8,0,0,,0,0,,1,1,2
11633,Luc Mbah a Moute,30-071,F,11/19/16,LAC,,CHI,W,1,26,3,6,0.5,1,3,0.333,2,3,0.667,0,0,,2,0,2
11634,Luc Mbah a Moute,30-155,F,2/11/17,LAC,@,CHO,W,1,22,4,7,0.571,4,6,0.667,0,1,0,0,0,,0,0,0
11635,Luc Mbah a Moute,30-127,F,1/14/17,LAC,,LAL,W,1,21,3,6,0.5,3,6,0.5,0,0,,2,2,1,2,2,4
11636,James Michael McAdoo,24-016,F,1/20/17,GSW,@,HOU,W,0,12,3,3,1,3,3,1,0,0,,2,2,1,0,2,2
11637,James Michael McAdoo,24-021,F,1/25/17,GSW,@,CHO,W,0,20,3,4,0.75,3,4,0.75,0,0,,2,2,1,1,6,7
11638,James Michael McAdoo,24-037,F,2/10/17,GSW,@,MEM,W,0,11,4,4,1,4,4,1,0,0,,0,1,0,1,1,2
11639,Patrick McCaw,21-016,G,11/10/16,GSW,@,DEN,W,0,15,3,6,0.5,3,4,0.75,0,2,0,2,2,1,0,1,1
11640,Patrick McCaw,21-126,G,2/28/17,GSW,@,WAS,L,0,24,2,2,1,1,1,1,1,1,1,3,4,0.75,0,2,2
11641,Patrick McCaw,21-087,G,1/20/17,GSW,@,HOU,W,0,3,3,3,1,1,1,1,2,2,1,0,0,,0,0,0
11642,Patrick McCaw,21-100,G,2/2/17,GSW,@,LAC,W,1,28,3,7,0.429,1,2,0.5,2,5,0.4,0,2,0,0,1,1
11643,Sheldon McClellan,24-018,G,1/8/17,WAS,@,MIL,W,0,12,3,5,0.6,2,3,0.667,1,2,0.5,1,1,1,0,3,3
11644,Sheldon McClellan,24-009,G,12/30/16,WAS,,BRK,W,1,24,2,6,0.333,1,4,0.25,1,2,0.5,3,3,1,0,1,1
11645,C.J. McCollum,25-176,G,3/14/17,POR,@,NOP,L,1,30,4,12,0.333,4,9,0.444,0,3,0,0,0,,0,3,3
11646,C.J. McCollum,25-051,G,11/9/16,POR,@,LAC,L,1,26,4,11,0.364,4,9,0.444,0,2,0,0,0,,1,3,4
11647,T.J. McConnell,24-301,G,1/20/17,PHI,,POR,W,1,31,4,8,0.5,4,8,0.5,0,0,,0,0,,1,3,4
11648,T.J. McConnell,24-313,G,2/1/17,PHI,@,DAL,L,1,29,3,6,0.5,3,6,0.5,0,0,,2,2,1,0,4,4
11649,T.J. McConnell,24-321,G,2/9/17,PHI,@,ORL,W,1,30,4,10,0.4,4,8,0.5,0,2,0,0,0,,1,4,5
11650,T.J. McConnell,24-292,G,1/11/17,PHI,,NYK,W,1,34,4,6,0.667,4,6,0.667,0,0,,0,0,,2,4,6
11651,T.J. McConnell,24-268,G,12/18/16,PHI,,BRK,W,0,25,4,9,0.444,4,8,0.5,0,1,0,0,0,,1,2,3
11652,T.J. McConnell,24-302,G,1/21/17,PHI,@,ATL,L,1,37,3,7,0.429,3,7,0.429,0,0,,2,2,1,1,5,6
11653,K.J. McDaniels,24-038,G-F,3/19/17,BRK,,DAL,L,0,15,3,6,0.5,1,2,0.5,2,4,0.5,0,0,,0,1,1
11654,Doug McDermott,25-011,F,1/14/17,CHI,,NOP,W,0,20,3,9,0.333,1,3,0.333,2,6,0.333,0,0,,2,5,7
11655,Doug McDermott,24-345,F,12/13/16,CHI,,MIN,L,0,27,4,8,0.5,4,7,0.571,0,1,0,0,0,,1,2,3
11656,Doug McDermott,24-342,F,12/10/16,CHI,,MIA,W,0,26,3,9,0.333,3,7,0.429,0,2,0,2,2,1,0,1,1
11657,Doug McDermott,24-340,F,12/8/16,CHI,,SAS,W,0,26,2,6,0.333,1,2,0.5,1,4,0.25,3,3,1,1,3,4
11658,Doug McDermott,24-311,F,11/9/16,CHI,@,ATL,L,0,19,4,6,0.667,4,5,0.8,0,1,0,0,0,,0,1,1
11659,Doug McDermott,25-052,F,2/24/17,OKC,,LAL,W,0,19,3,8,0.375,3,6,0.5,0,2,0,2,2,1,2,2,4
11660,Doug McDermott,24-347,F,12/15/16,CHI,@,MIL,L,0,28,3,6,0.5,1,4,0.25,2,2,1,0,0,,1,4,5
11661,JaVale McGee,29-027,C,2/15/17,GSW,,SAC,W,1,18,4,5,0.8,4,5,0.8,0,0,,0,0,,1,9,10
11662,JaVale McGee,28-309,C,11/23/16,GSW,,LAL,W,0,10,3,4,0.75,3,4,0.75,0,0,,2,4,0.5,0,4,4
11663,JaVale McGee,29-025,C,2/13/17,GSW,@,DEN,L,1,16,4,6,0.667,4,6,0.667,0,0,,0,0,,0,7,7
11664,JaVale McGee,28-336,C,12/20/16,GSW,,UTA,W,0,15,4,14,0.286,4,13,0.308,0,1,0,0,0,,2,5,7
11665,JaVale McGee,29-058,C,3/18/17,GSW,,MIL,W,0,12,4,4,1,4,4,1,0,0,,0,0,,1,3,4
11666,JaVale McGee,28-346,C,12/30/16,GSW,,DAL,W,0,11,4,4,1,4,4,1,0,0,,0,0,,0,1,1
11667,JaVale McGee,28-312,C,11/26/16,GSW,,MIN,W,0,11,4,5,0.8,4,5,0.8,0,0,,0,0,,2,3,5
11668,JaVale McGee,28-359,C,1/12/17,GSW,,DET,W,0,8,4,5,0.8,4,5,0.8,0,0,,0,0,,3,3,6
11669,Rodney McGruder,25-109,G,11/15/16,MIA,,ATL,L,1,37,4,11,0.364,4,8,0.5,0,3,0,0,0,,3,1,4
11670,Rodney McGruder,25-158,G,1/3/17,MIA,@,PHO,L,1,33,3,10,0.3,1,5,0.2,2,5,0.4,0,0,,3,2,5
11671,Rodney McGruder,25-156,G,1/1/17,MIA,,DET,L,1,33,3,8,0.375,2,5,0.4,1,3,0.333,1,1,1,1,3,4
11672,Rodney McGruder,25-217,G,3/3/17,MIA,@,ORL,L,1,17,3,6,0.5,1,3,0.333,2,3,0.667,0,0,,0,1,1
11673,Ben McLemore,23-313,G,12/20/16,SAC,,POR,W,1,21,2,4,0.5,1,1,1,1,3,0.333,3,3,1,0,0,0
11674,Ben McLemore,23-309,G,12/16/16,SAC,@,MEM,W,1,16,3,7,0.429,2,4,0.5,1,3,0.333,1,1,1,0,0,0
11675,Jordan McRae,25-268,G,12/21/16,CLE,,MIL,W,0,18,3,6,0.5,2,5,0.4,1,1,1,1,3,0.333,0,3,3
11676,Josh McRoberts,29-286,F,12/10/16,MIA,@,CHI,L,1,23,3,5,0.6,1,2,0.5,2,3,0.667,0,0,,1,4,5
11677,Josh McRoberts,29-294,F,12/18/16,MIA,,BOS,L,1,16,3,5,0.6,1,2,0.5,2,3,0.667,0,0,,0,0,0
11678,Jodie Meeks,29-136,G,1/4/17,ORL,,ATL,L,1,24,4,8,0.5,4,7,0.571,0,1,0,0,0,,0,2,2
11679,Salah Mejri,30-142,C,11/4/16,DAL,,POR,L,0,13,4,4,1,4,4,1,0,0,,0,0,,0,6,6
11680,Salah Mejri,30-159,C,11/21/16,DAL,@,SAS,L,1,32,4,5,0.8,4,5,0.8,0,0,,0,0,,1,10,11
11681,Jordan Mickey,22-120,F,11/6/16,BOS,,DEN,L,0,19,4,4,1,4,4,1,0,0,,0,1,0,0,2,2
11682,Khris Middleton,25-198,F-G,2/26/17,MIL,,PHO,W,1,28,3,8,0.375,2,5,0.4,1,3,0.333,1,1,1,0,7,7
11683,C.J. Miles,29-191,G-F,10/26/16,IND,,DAL,W,0,13,3,6,0.5,1,3,0.333,2,3,0.667,0,0,,0,0,0
11684,C.J. Miles,29-262,G-F,1/5/17,IND,,BRK,W,0,18,3,6,0.5,1,2,0.5,2,4,0.5,0,0,,0,2,2
11685,C.J. Miles,29-335,G-F,3/19/17,IND,@,TOR,L,1,23,3,9,0.333,1,3,0.333,2,6,0.333,0,0,,0,1,1
11686,C.J. Miles,29-258,G-F,1/1/17,IND,,ORL,W,0,16,4,8,0.5,4,4,1,0,4,0,0,0,,0,0,0
11687,C.J. Miles,29-294,G-F,2/6/17,IND,,OKC,W,1,20,3,10,0.3,2,3,0.667,1,7,0.143,1,1,1,0,3,3
11688,C.J. Miles,29-313,G-F,2/25/17,IND,@,MIA,L,1,27,3,4,0.75,1,1,1,2,3,0.667,0,0,,0,5,5
11689,C.J. Miles,29-256,G-F,12/30/16,IND,,CHI,W,0,22,3,7,0.429,2,5,0.4,1,2,0.5,1,1,1,0,3,3
11690,C.J. Miles,29-328,G-F,3/12/17,IND,,MIA,W,1,30,3,8,0.375,2,3,0.667,1,5,0.2,1,1,1,0,5,5
11691,C.J. Miles,29-303,G-F,2/15/17,IND,@,CLE,L,0,19,2,3,0.667,1,1,1,1,2,0.5,3,3,1,0,2,2
11692,C.J. Miles,29-208,G-F,11/12/16,IND,,BOS,L,1,32,3,10,0.3,1,3,0.333,2,7,0.286,0,0,,0,3,3
11693,Patty Mills,28-090,G,11/9/16,SAS,,HOU,L,1,34,3,8,0.375,3,4,0.75,0,4,0,2,2,1,2,1,3
11694,Patty Mills,28-173,G,1/31/17,SAS,,OKC,W,0,16,2,4,0.5,0,2,0,2,2,1,2,2,1,0,0,0
11695,Patty Mills,28-104,G,11/23/16,SAS,@,CHO,W,0,19,2,4,0.5,1,1,1,1,3,0.333,3,3,1,1,1,2
11696,Patty Mills,28-185,G,2/12/17,SAS,@,NYK,L,0,20,3,8,0.375,1,3,0.333,2,5,0.4,0,0,,1,0,1
11697,Patty Mills,28-082,G,11/1/16,SAS,,UTA,L,0,15,4,8,0.5,4,4,1,0,4,0,0,0,,1,0,1
11698,Patty Mills,28-222,G,3/21/17,SAS,@,MIN,W,0,21,3,5,0.6,1,1,1,2,4,0.5,0,0,,1,1,2
11699,Patty Mills,28-093,G,11/12/16,SAS,@,HOU,W,0,21,3,8,0.375,1,2,0.5,2,6,0.333,0,0,,0,4,4
11700,Paul Millsap,32-005,F,2/15/17,ATL,@,LAC,L,1,30,3,12,0.25,2,8,0.25,1,4,0.25,1,2,0.5,1,1,2
11701,Nikola Mirotic,25-323,F,12/30/16,CHI,@,IND,L,0,27,3,14,0.214,1,3,0.333,2,11,0.182,0,0,,0,6,6
11702,Nikola Mirotic,26-021,F,3/4/17,CHI,,LAC,L,0,27,4,9,0.444,4,5,0.8,0,4,0,0,0,,1,6,7
11703,Nikola Mirotic,26-038,F,3/21/17,CHI,@,TOR,L,1,26,3,9,0.333,1,2,0.5,2,7,0.286,0,2,0,0,2,2
11704,Nikola Mirotic,25-278,F,11/15/16,CHI,@,POR,W,0,19,3,6,0.5,1,1,1,2,5,0.4,0,0,,0,8,8
11705,Nikola Mirotic,25-261,F,10/29/16,CHI,,IND,W,0,26,3,9,0.333,2,5,0.4,1,4,0.25,1,1,1,1,2,3
11706,Greg Monroe,26-209,C-F,12/30/16,MIL,@,MIN,L,0,14,4,10,0.4,4,10,0.4,0,0,,0,0,,0,1,1
11707,Greg Monroe,26-174,C-F,11/25/16,MIL,,TOR,L,0,19,4,8,0.5,4,8,0.5,0,0,,0,0,,4,6,10
11708,Greg Monroe,26-251,C-F,2/10/17,MIL,,LAL,L,0,19,3,6,0.5,3,6,0.5,0,0,,2,2,1,0,1,1
11709,Greg Monroe,26-200,C-F,12/21/16,MIL,@,CLE,L,0,18,3,7,0.429,3,6,0.5,0,1,0,2,4,0.5,1,6,7
11710,Greg Monroe,26-244,C-F,2/3/17,MIL,@,DEN,L,0,13,3,6,0.5,3,6,0.5,0,0,,2,4,0.5,1,1,2
11711,Greg Monroe,26-159,C-F,11/10/16,MIL,,NOP,L,0,20,3,5,0.6,3,5,0.6,0,0,,2,2,1,1,2,3
11712,E'Twaun Moore,27-312,G,1/5/17,NOP,,ATL,L,0,27,3,11,0.273,1,5,0.2,2,6,0.333,0,0,,1,1,2
11713,E'Twaun Moore,27-292,G,12/16/16,NOP,@,HOU,L,1,25,3,8,0.375,1,5,0.2,2,3,0.667,0,0,,0,3,3
11714,E'Twaun Moore,27-316,G,1/9/17,NOP,@,NYK,W,0,24,4,7,0.571,4,6,0.667,0,1,0,0,0,,1,0,1
11715,Marcus Morris,27-194,F,3/15/17,DET,,UTA,L,1,33,3,15,0.2,3,10,0.3,0,5,0,2,2,1,0,1,1
11716,Markieff Morris,27-087,F,11/28/16,WAS,,SAC,W,1,44,2,12,0.167,2,10,0.2,0,2,0,4,4,1,2,3,5
11717,Markieff Morris,27-184,F,3/5/17,WAS,,ORL,W,1,31,3,9,0.333,3,8,0.375,0,1,0,2,2,1,1,1,2
11718,Markieff Morris,27-076,F,11/17/16,WAS,,NYK,W,1,35,4,11,0.364,4,9,0.444,0,2,0,0,0,,1,7,8
11719,Markieff Morris,27-110,F,12/21/16,WAS,@,CHI,W,1,39,4,12,0.333,4,12,0.333,0,0,,0,0,,2,10,12
11720,Anthony Morrow,31-057,G,11/23/16,OKC,@,SAC,L,0,19,2,8,0.25,1,6,0.167,1,2,0.5,3,3,1,0,0,0
11721,Timofey Mozgov,30-182,C,1/14/17,LAL,@,LAC,L,1,21,4,6,0.667,4,6,0.667,0,0,,0,1,0,2,3,5
11722,Timofey Mozgov,30-106,C,10/30/16,LAL,@,OKC,L,1,24,4,5,0.8,4,5,0.8,0,0,,0,0,,3,2,5
11723,Timofey Mozgov,30-149,C,12/12/16,LAL,@,SAC,L,1,23,4,7,0.571,4,7,0.571,0,0,,0,0,,5,1,6
11724,Timofey Mozgov,30-104,C,10/28/16,LAL,@,UTA,L,1,23,1,4,0.25,1,4,0.25,0,0,,6,7,0.857,1,5,6
11725,Timofey Mozgov,30-119,C,11/12/16,LAL,@,NOP,W,1,21,4,4,1,4,4,1,0,0,,0,0,,1,4,5
11726,Timofey Mozgov,30-178,C,1/10/17,LAL,,POR,L,1,20,4,8,0.5,4,8,0.5,0,0,,0,0,,1,1,2
11727,Timofey Mozgov,30-132,C,11/25/16,LAL,,GSW,L,1,20,3,6,0.5,3,6,0.5,0,0,,2,4,0.5,1,3,4
11728,Timofey Mozgov,30-232,C,3/5/17,LAL,,NOP,L,0,15,3,3,1,3,3,1,0,0,,2,2,1,2,3,5
11729,Timofey Mozgov,30-127,C,11/20/16,LAL,,CHI,L,1,21,4,7,0.571,4,7,0.571,0,0,,0,0,,1,1,2
11730,Timofey Mozgov,30-183,C,1/15/17,LAL,,DET,L,1,22,4,7,0.571,4,7,0.571,0,0,,0,0,,0,3,3
11731,Emmanuel Mudiay,20-306,G,1/5/17,DEN,,SAS,L,1,28,4,10,0.4,4,7,0.571,0,3,0,0,0,,0,1,1
11732,Emmanuel Mudiay,20-253,G,11/13/16,DEN,@,POR,L,1,30,3,16,0.188,2,10,0.2,1,6,0.167,1,2,0.5,0,2,2
11733,Emmanuel Mudiay,20-303,G,1/2/17,DEN,@,GSW,L,1,31,4,11,0.364,4,8,0.5,0,3,0,0,0,,0,2,2
11734,Emmanuel Mudiay,21-015,G,3/20/17,DEN,@,HOU,L,0,10,2,4,0.5,0,1,0,2,3,0.667,2,2,1,0,1,1
11735,Shabazz Muhammad,23-354,F-G,11/1/16,MIN,,MEM,W,0,19,2,6,0.333,2,6,0.333,0,0,,4,4,1,2,2,4
11736,Shabazz Muhammad,24-074,F-G,1/26/17,MIN,,IND,L,0,20,2,5,0.4,2,5,0.4,0,0,,4,4,1,1,1,2
11737,Shabazz Muhammad,24-036,F-G,12/19/16,MIN,,PHO,W,0,21,3,8,0.375,3,7,0.429,0,1,0,2,2,1,1,1,2
11738,Shabazz Muhammad,24-034,F-G,12/17/16,MIN,,HOU,L,0,17,3,7,0.429,3,6,0.5,0,1,0,2,4,0.5,2,4,6
11739,Jamal Murray,19-301,G,12/20/16,DEN,@,LAC,L,0,27,3,9,0.333,1,1,1,2,8,0.25,0,1,0,2,3,5
11740,Jamal Murray,19-317,G,1/5/17,DEN,,SAS,L,0,23,3,8,0.375,2,4,0.5,1,4,0.25,1,1,1,2,0,2
11741,Jamal Murray,19-324,G,1/12/17,DEN,,IND,W,0,11,3,6,0.5,3,3,1,0,3,0,2,2,1,1,0,1
11742,Mike Muscala,25-159,F-C,12/7/16,ATL,,MIA,W,0,24,4,8,0.5,4,7,0.571,0,1,0,0,0,,0,3,3
11743,Mike Muscala,25-187,F-C,1/4/17,ATL,@,ORL,W,0,22,3,3,1,1,1,1,2,2,1,0,0,,0,1,1
11744,Mike Muscala,25-215,F-C,2/1/17,ATL,@,MIA,L,0,14,3,5,0.6,1,2,0.5,2,3,0.667,0,0,,1,0,1
11745,Mike Muscala,25-210,F-C,1/27/17,ATL,,WAS,L,0,14,3,5,0.6,1,3,0.333,2,2,1,0,0,,1,1,2
11746,Larry Nance Jr.,24-065,F,3/7/17,LAL,@,DAL,L,0,21,4,6,0.667,4,5,0.8,0,1,0,0,0,,0,3,3
11747,Larry Nance Jr.,24-061,F,3/3/17,LAL,,BOS,L,0,20,4,6,0.667,4,6,0.667,0,0,,0,0,,1,3,4
11748,Larry Nance Jr.,23-317,F,11/13/16,LAL,@,MIN,L,0,22,4,5,0.8,4,4,1,0,1,0,0,0,,0,4,4
11749,Larry Nance Jr.,23-333,F,11/29/16,LAL,@,NOP,L,0,20,4,7,0.571,4,6,0.667,0,1,0,0,0,,1,4,5
11750,Larry Nance Jr.,24-032,F,2/2/17,LAL,@,WAS,L,0,20,4,8,0.5,4,8,0.5,0,0,,0,0,,3,3,6
11751,Larry Nance Jr.,24-070,F,3/12/17,LAL,,PHI,L,0,22,3,4,0.75,1,1,1,2,3,0.667,0,1,0,0,4,4
11752,Larry Nance Jr.,23-326,F,11/22/16,LAL,,OKC,W,0,27,4,7,0.571,4,7,0.571,0,0,,0,0,,1,3,4
11753,Larry Nance Jr.,24-044,F,2/14/17,LAL,,SAC,L,0,24,4,6,0.667,4,5,0.8,0,1,0,0,2,0,2,4,6
11754,Shabazz Napier,25-156,G,12/17/16,POR,@,GSW,L,0,12,3,6,0.5,2,4,0.5,1,2,0.5,1,1,1,0,1,1
11755,Shabazz Napier,25-216,G,2/15/17,POR,@,UTA,L,0,12,3,5,0.6,2,3,0.667,1,2,0.5,1,2,0.5,0,1,1
11756,Shabazz Napier,25-169,G,12/30/16,POR,@,SAS,L,0,16,4,10,0.4,4,5,0.8,0,5,0,0,0,,0,0,0
11757,Jameer Nelson,34-361,G,2/4/17,DEN,@,SAS,L,1,22,3,8,0.375,1,5,0.2,2,3,0.667,0,0,,1,2,3
11758,Jameer Nelson,35-015,G,2/24/17,DEN,,BRK,W,1,22,3,5,0.6,1,1,1,2,4,0.5,0,0,,0,1,1
11759,Jameer Nelson,35-030,G,3/11/17,DEN,@,SAC,W,1,33,3,8,0.375,2,5,0.4,1,3,0.333,1,2,0.5,0,2,2
11760,Jameer Nelson,35-029,G,3/10/17,DEN,,BOS,W,1,31,4,9,0.444,4,7,0.571,0,2,0,0,1,0,0,5,5
11761,Jameer Nelson,34-318,G,12/23/16,DEN,,ATL,L,0,21,3,6,0.5,2,3,0.667,1,3,0.333,1,2,0.5,1,0,1
11762,Jameer Nelson,35-023,G,3/4/17,DEN,,CHO,L,1,29,3,9,0.333,1,3,0.333,2,6,0.333,0,0,,0,2,2
11763,Raul Neto,24-205,G,12/10/16,UTA,,SAC,W,0,11,3,5,0.6,1,3,0.333,2,2,1,0,0,,1,3,4
11764,Raul Neto,24-226,G,12/31/16,UTA,,PHO,W,0,14,3,6,0.5,3,4,0.75,0,2,0,2,2,1,0,1,1
11765,Andrew Nicholson,26-327,F,10/30/16,WAS,@,MEM,L,0,25,4,9,0.444,4,6,0.667,0,3,0,0,1,0,1,2,3
11766,Joakim Noah,31-304,C,12/25/16,NYK,,BOS,L,1,28,3,4,0.75,3,4,0.75,0,0,,2,3,0.667,5,7,12
11767,Joakim Noah,31-316,C,1/6/17,NYK,@,MIL,W,1,20,4,6,0.667,4,6,0.667,0,0,,0,0,,5,4,9
11768,Joakim Noah,31-314,C,1/4/17,NYK,,MIL,L,1,31,4,7,0.571,4,7,0.571,0,0,,0,2,0,7,9,16
11769,Joakim Noah,31-312,C,1/2/17,NYK,,ORL,L,1,33,3,7,0.429,3,7,0.429,0,0,,2,4,0.5,5,5,10
11770,Joakim Noah,31-292,C,12/13/16,NYK,@,PHO,L,1,22,3,5,0.6,3,5,0.6,0,0,,2,7,0.286,2,6,8
11771,Nerlens Noel,22-297,C-F,2/1/17,PHI,@,DAL,L,0,17,4,8,0.5,4,8,0.5,0,0,,0,0,,1,2,3
11772,Nerlens Noel,22-273,C-F,1/8/17,PHI,@,BRK,W,0,24,3,8,0.375,3,8,0.375,0,0,,2,2,1,2,2,4
11773,Nerlens Noel,22-245,C-F,12/11/16,PHI,@,DET,W,0,10,3,5,0.6,3,5,0.6,0,0,,2,2,1,0,0,0
11774,Nerlens Noel,22-268,C-F,1/3/17,PHI,,MIN,W,0,11,4,5,0.8,4,5,0.8,0,0,,0,0,,1,0,1
11775,Lucas Nogueira,24-183,C,1/25/17,TOR,@,MEM,L,0,24,4,4,1,4,4,1,0,0,,0,2,0,4,4,8
11776,Lucas Nogueira,24-195,C,2/6/17,TOR,,LAC,W,0,26,3,6,0.5,3,6,0.5,0,0,,2,2,1,1,5,6
11777,Lucas Nogueira,24-194,C,2/5/17,TOR,@,BRK,W,0,22,4,6,0.667,4,5,0.8,0,1,0,0,0,,1,4,5
11778,Lucas Nogueira,24-135,C,12/8/16,TOR,,MIN,W,0,19,4,5,0.8,4,5,0.8,0,0,,0,0,,4,5,9
11779,Dirk Nowitzki,38-253,F,2/27/17,DAL,,MIA,W,1,26,2,9,0.222,1,7,0.143,1,2,0.5,3,3,1,1,11,12
11780,Dirk Nowitzki,38-227,F,2/1/17,DAL,,PHI,W,1,28,4,12,0.333,4,10,0.4,0,2,0,0,0,,0,5,5
11781,Dirk Nowitzki,38-250,F,2/24/17,DAL,@,MIN,L,1,29,4,14,0.286,4,10,0.4,0,4,0,0,0,,1,6,7
11782,Dirk Nowitzki,38-225,F,1/30/17,DAL,,CLE,W,1,24,3,4,0.75,1,2,0.5,2,2,1,0,0,,0,6,6
11783,Jusuf Nurkic,22-104,C,12/5/16,DEN,@,PHI,W,1,24,4,8,0.5,4,8,0.5,0,0,,0,2,0,6,4,10
11784,Jusuf Nurkic,22-102,C,12/3/16,DEN,@,UTA,L,1,13,4,6,0.667,4,6,0.667,0,0,,0,0,,3,1,4
11785,Jusuf Nurkic,22-082,C,11/13/16,DEN,@,POR,L,1,19,3,11,0.273,3,11,0.273,0,0,,2,4,0.5,4,5,9
11786,Jusuf Nurkic,22-096,C,11/27/16,DEN,@,PHO,W,1,16,4,7,0.571,4,7,0.571,0,0,,0,0,,1,5,6
11787,Jusuf Nurkic,22-187,C,2/26/17,POR,@,TOR,L,1,21,3,9,0.333,3,9,0.333,0,0,,2,3,0.667,1,3,4
11788,Jusuf Nurkic,22-094,C,11/25/16,DEN,,OKC,L,1,22,3,6,0.5,3,6,0.5,0,0,,2,2,1,1,6,7
11789,Kyle O'Quinn,26-284,F-C,1/4/17,NYK,,MIL,L,0,15,4,8,0.5,4,8,0.5,0,0,,0,0,,2,0,2
11790,Kyle O'Quinn,26-244,F-C,11/25/16,NYK,,CHO,W,0,17,4,7,0.571,4,7,0.571,0,0,,0,0,,0,3,3
11791,Kyle O'Quinn,26-258,F-C,12/9/16,NYK,@,SAC,W,0,20,4,7,0.571,4,7,0.571,0,0,,0,0,,5,6,11
11792,Kyle O'Quinn,26-239,F-C,11/20/16,NYK,,ATL,W,1,17,4,5,0.8,4,5,0.8,0,0,,0,0,,4,4,8
11793,Jahlil Okafor,20-319,C-F,10/29/16,PHI,,ATL,L,0,15,2,7,0.286,2,7,0.286,0,0,,4,4,1,1,3,4
11794,Jahlil Okafor,20-316,C-F,10/26/16,PHI,,OKC,L,0,16,4,10,0.4,4,10,0.4,0,0,,0,0,,1,2,3
11795,Victor Oladipo,24-208,G,11/28/16,OKC,@,NYK,W,1,31,4,11,0.364,4,7,0.571,0,4,0,0,0,,0,4,4
11796,Kelly Olynyk,25-236,C-F,12/11/16,BOS,@,OKC,L,0,22,2,9,0.222,1,2,0.5,1,7,0.143,3,4,0.75,2,6,8
11797,Kelly Olynyk,25-262,C-F,1/6/17,BOS,,PHI,W,0,18,2,7,0.286,1,3,0.333,1,4,0.25,3,4,0.75,1,3,4
11798,Kelly Oubre,20-365,F,12/8/16,WAS,,DEN,W,0,25,4,9,0.444,4,7,0.571,0,2,0,0,0,,2,3,5
11799,Kelly Oubre,20-344,F,11/17/16,WAS,,NYK,W,0,23,3,6,0.5,1,2,0.5,2,4,0.5,0,0,,0,3,3
11800,Kelly Oubre,21-025,F,1/3/17,WAS,@,DAL,L,0,25,3,5,0.6,1,1,1,2,4,0.5,0,0,,0,3,3
11801,Zaza Pachulia,33-015,C,2/25/17,GSW,,BRK,W,1,20,3,5,0.6,3,5,0.6,0,0,,2,3,0.667,1,8,9
11802,Zaza Pachulia,32-267,C,11/3/16,GSW,,OKC,W,1,23,4,4,1,4,4,1,0,0,,0,0,,6,4,10
11803,Zaza Pachulia,32-322,C,12/28/16,GSW,,TOR,W,1,18,3,5,0.6,3,5,0.6,0,0,,2,2,1,2,1,3
11804,Zaza Pachulia,32-280,C,11/16/16,GSW,@,TOR,W,1,16,2,3,0.667,2,3,0.667,0,0,,4,4,1,0,1,1
11805,Zaza Pachulia,32-335,C,1/10/17,GSW,,MIA,W,1,24,3,5,0.6,3,5,0.6,0,0,,2,2,1,1,5,6
11806,Zaza Pachulia,33-036,C,3/18/17,GSW,,MIL,W,1,12,3,5,0.6,3,5,0.6,0,0,,2,4,0.5,0,4,4
11807,Zaza Pachulia,33-020,C,3/2/17,GSW,@,CHI,L,1,14,4,7,0.571,4,7,0.571,0,0,,0,0,,2,3,5
11808,Jabari Parker,21-306,F,1/15/17,MIL,@,ATL,L,1,33,4,9,0.444,4,6,0.667,0,3,0,0,0,,3,7,10
11809,Jabari Parker,21-270,F,12/10/16,MIL,@,WAS,L,1,24,3,8,0.375,2,5,0.4,1,3,0.333,1,2,0.5,0,4,4
11810,Tony Parker,34-205,G,12/8/16,SAS,@,CHI,L,1,24,4,10,0.4,4,9,0.444,0,1,0,0,0,,0,1,1
11811,Tony Parker,34-265,G,2/6/17,SAS,@,MEM,L,1,29,3,7,0.429,3,7,0.429,0,0,,2,2,1,0,2,2
11812,Tony Parker,34-285,G,2/26/17,SAS,@,LAL,W,1,20,4,5,0.8,4,5,0.8,0,0,,0,0,,0,3,3
11813,Tony Parker,34-217,G,12/20/16,SAS,@,HOU,W,1,24,3,7,0.429,2,6,0.333,1,1,1,1,2,0.5,1,1,2
11814,Chandler Parsons,28-106,F,2/8/17,MEM,,PHO,W,1,24,3,7,0.429,1,4,0.25,2,3,0.667,0,2,0,0,3,3
11815,Chandler Parsons,28-094,F,1/27/17,MEM,@,POR,L,1,21,2,6,0.333,0,2,0,2,4,0.5,2,2,1,0,2,2
11816,Patrick Patterson,27-259,F,11/28/16,TOR,,PHI,W,0,20,3,5,0.6,1,1,1,2,4,0.5,0,0,,0,2,2
11817,Patrick Patterson,27-300,F,1/8/17,TOR,,HOU,L,0,22,3,5,0.6,1,3,0.333,2,2,1,0,0,,3,4,7
11818,Patrick Patterson,28-005,F,3/19/17,TOR,,IND,W,0,19,2,3,0.667,0,0,,2,3,0.667,2,2,1,0,1,1
11819,Patrick Patterson,27-354,F,3/3/17,TOR,@,WAS,W,0,28,2,8,0.25,0,3,0,2,5,0.4,2,2,1,2,5,7
11820,Chris Paul,31-255,G,1/16/17,LAC,,OKC,W,1,14,3,5,0.6,1,2,0.5,2,3,0.667,0,0,,0,3,3
11821,Chris Paul,31-203,G,11/25/16,LAC,@,DET,L,1,33,2,9,0.222,1,5,0.2,1,4,0.25,3,3,1,0,3,3
11822,Adreian Payne,25-272,F-C,11/17/16,MIN,,PHI,W,0,13,2,5,0.4,2,3,0.667,0,2,0,4,6,0.667,0,1,1
11823,Cameron Payne,22-161,G,1/16/17,OKC,@,LAC,L,0,21,4,9,0.444,4,5,0.8,0,4,0,0,0,,0,0,0
11824,Cameron Payne,22-174,G,1/29/17,OKC,@,CLE,L,0,20,3,11,0.273,1,8,0.125,2,3,0.667,0,0,,0,4,4
11825,Cameron Payne,22-152,G,1/7/17,OKC,,DEN,W,0,13,3,4,0.75,1,1,1,2,3,0.667,0,0,,0,2,2
11826,Elfrid Payton,23-016,G,3/10/17,ORL,@,CHO,L,1,27,4,8,0.5,4,8,0.5,0,0,,0,0,,0,2,2
11827,Elfrid Payton,22-291,G,12/9/16,ORL,@,CHO,L,0,23,4,13,0.308,4,10,0.4,0,3,0,0,0,,2,2,4
11828,Elfrid Payton,22-355,G,2/11/17,ORL,@,DAL,L,0,20,4,9,0.444,4,7,0.571,0,2,0,0,0,,0,2,2
11829,Elfrid Payton,22-273,G,11/21/16,ORL,@,MIL,L,1,35,4,9,0.444,4,6,0.667,0,3,0,0,2,0,0,8,8
11830,Elfrid Payton,22-286,G,12/4/16,ORL,@,DET,W,0,23,4,9,0.444,4,7,0.571,0,2,0,0,3,0,2,2,4
11831,Elfrid Payton,23-017,G,3/11/17,ORL,,CLE,L,1,34,4,17,0.235,4,17,0.235,0,0,,0,0,,3,7,10
11832,Mason Plumlee,26-251,C-F,11/11/16,POR,,SAC,W,1,35,3,5,0.6,3,5,0.6,0,0,,2,5,0.4,2,5,7
11833,Mason Plumlee,27-006,C-F,3/11/17,DEN,@,SAC,W,0,21,3,3,1,3,3,1,0,0,,2,2,1,2,5,7
11834,Mason Plumlee,26-280,C-F,12/10/16,POR,@,IND,L,1,26,3,4,0.75,3,4,0.75,0,0,,2,2,1,1,8,9
11835,Mason Plumlee,27-005,C-F,3/10/17,DEN,,BOS,W,0,20,4,4,1,4,4,1,0,0,,0,0,,3,2,5
11836,Mason Plumlee,26-309,C-F,1/8/17,POR,,DET,L,1,40,4,12,0.333,4,11,0.364,0,1,0,0,2,0,6,4,10
11837,Mason Plumlee,26-319,C-F,1/18/17,POR,@,CHO,L,1,30,3,6,0.5,3,6,0.5,0,0,,2,2,1,3,7,10
11838,Mason Plumlee,26-300,C-F,12/30/16,POR,@,SAS,L,1,27,1,4,0.25,1,4,0.25,0,0,,6,8,0.75,0,5,5
11839,Miles Plumlee,28-059,C-F,10/30/16,MIL,@,DET,L,1,17,4,6,0.667,4,6,0.667,0,0,,0,0,,2,3,5
11840,Otto Porter,23-213,F,1/2/17,WAS,@,HOU,L,1,33,4,12,0.333,4,7,0.571,0,5,0,0,0,,0,3,3
11841,Otto Porter,23-162,F,11/12/16,WAS,@,CHI,L,1,29,3,12,0.25,2,9,0.222,1,3,0.333,1,3,0.333,1,3,4
11842,Otto Porter,23-290,F,3/20/17,WAS,@,BOS,L,1,21,4,8,0.5,4,5,0.8,0,3,0,0,0,,2,1,3
11843,Otto Porter,23-252,F,2/10/17,WAS,,IND,W,1,25,3,7,0.429,2,3,0.667,1,4,0.25,1,1,1,1,3,4
11844,Otto Porter,23-201,F,12/21/16,WAS,@,CHI,W,1,12,3,5,0.6,1,1,1,2,4,0.5,0,0,,0,2,2
11845,Otto Porter,23-154,F,11/4/16,WAS,,ATL,W,1,38,4,7,0.571,4,4,1,0,3,0,0,0,,0,0,0
11846,Bobby Portis,22-033,F,3/15/17,CHI,,MEM,L,1,20,4,9,0.444,4,7,0.571,0,2,0,0,0,,3,4,7
11847,Bobby Portis,22-028,F,3/10/17,CHI,,HOU,L,1,20,3,9,0.333,3,7,0.429,0,2,0,2,2,1,0,6,6
11848,Bobby Portis,22-026,F,3/8/17,CHI,@,ORL,L,1,19,4,6,0.667,4,5,0.8,0,1,0,0,0,,0,3,3
11849,Kristaps Porzingis,21-135,F-C,12/15/16,NYK,@,GSW,L,1,35,4,13,0.308,4,11,0.364,0,2,0,0,2,0,2,3,5
11850,Kristaps Porzingis,21-205,F-C,2/23/17,NYK,@,CLE,L,1,16,4,10,0.4,4,6,0.667,0,4,0,0,0,,1,4,5
11851,Kristaps Porzingis,21-174,F-C,1/23/17,NYK,@,IND,W,1,25,3,11,0.273,1,5,0.2,2,6,0.333,0,0,,0,4,4
11852,Dwight Powell,25-151,F-C,12/18/16,DAL,,SAC,W,0,20,3,4,0.75,3,4,0.75,0,0,,2,2,1,2,4,6
11853,Dwight Powell,25-167,F-C,1/3/17,DAL,,WAS,W,0,13,2,3,0.667,2,3,0.667,0,0,,4,5,0.8,0,3,3
11854,Dwight Powell,25-145,F-C,12/12/16,DAL,,DEN,W,0,22,4,5,0.8,4,5,0.8,0,0,,0,0,,1,0,1
11855,Dwight Powell,25-143,F-C,12/10/16,DAL,@,HOU,L,0,26,4,4,1,4,4,1,0,0,,0,0,,1,5,6
11856,Dwight Powell,25-126,F-C,11/23/16,DAL,,LAC,L,0,14,3,7,0.429,3,7,0.429,0,0,,2,2,1,1,3,4
11857,Dwight Powell,25-171,F-C,1/7/17,DAL,,ATL,L,0,16,4,5,0.8,4,5,0.8,0,0,,0,0,,2,4,6
11858,Norman Powell,23-277,G,2/26/17,TOR,,POR,W,0,12,3,6,0.5,3,5,0.6,0,1,0,2,2,1,0,4,4
11859,Norman Powell,23-207,G,12/18/16,TOR,@,ORL,W,0,8,4,6,0.667,4,4,1,0,2,0,0,0,,0,1,1
11860,Norman Powell,23-287,G,3/8/17,TOR,@,NOP,W,0,21,3,5,0.6,1,2,0.5,2,3,0.667,0,0,,0,3,3
11861,Chasson Randle,23-365,G,2/4/17,PHI,@,MIA,L,0,12,1,4,0.25,1,1,1,0,3,0,6,6,1,0,0,0
11862,Chasson Randle,23-362,G,2/1/17,PHI,@,DAL,L,0,12,3,5,0.6,2,2,1,1,3,0.333,1,1,1,0,2,2
11863,Julius Randle,22-021,F,12/20/16,LAL,@,CHO,L,1,31,4,12,0.333,4,12,0.333,0,0,,0,0,,1,5,6
11864,Julius Randle,22-057,F,1/25/17,LAL,@,POR,L,1,20,4,9,0.444,4,9,0.444,0,0,,0,1,0,1,4,5
11865,Julius Randle,21-349,F,11/12/16,LAL,@,NOP,W,1,28,4,11,0.364,4,11,0.364,0,0,,0,0,,2,9,11
11866,Julius Randle,22-003,F,12/2/16,LAL,@,TOR,L,1,22,4,8,0.5,4,8,0.5,0,0,,0,0,,2,6,8
11867,Zach Randolph,35-243,F,3/16/17,MEM,@,ATL,W,0,18,4,13,0.308,4,12,0.333,0,1,0,0,0,,2,3,5
11868,Zach Randolph,35-242,F,3/15/17,MEM,@,CHI,W,0,25,4,14,0.286,4,14,0.286,0,0,,0,0,,4,5,9
11869,Zach Randolph,35-231,F,3/4/17,MEM,@,HOU,L,0,24,3,9,0.333,2,7,0.286,1,2,0.5,1,2,0.5,2,4,6
11870,J.J. Redick,32-131,G,11/2/16,LAC,,OKC,L,1,26,3,12,0.25,1,7,0.143,2,5,0.4,0,0,,0,4,4
11871,J.J. Redick,32-125,G,10/27/16,LAC,@,POR,W,1,30,3,8,0.375,2,3,0.667,1,5,0.2,1,2,0.5,0,3,3
11872,J.J. Redick,32-250,G,3/1/17,LAC,,HOU,L,1,31,3,9,0.333,1,4,0.25,2,5,0.4,0,0,,0,3,3
11873,J.J. Redick,32-189,G,12/30/16,LAC,@,HOU,L,1,25,3,9,0.333,1,3,0.333,2,6,0.333,0,0,,1,0,1
11874,Willie Reed,26-208,F-C,12/10/16,MIA,@,CHI,L,0,15,4,5,0.8,4,5,0.8,0,0,,0,2,0,4,3,7
11875,Willie Reed,26-228,F-C,12/30/16,MIA,@,BOS,L,0,14,4,6,0.667,4,6,0.667,0,0,,0,0,,2,2,4
11876,Willie Reed,26-248,F-C,1/19/17,MIA,,DAL,W,0,13,3,3,1,3,3,1,0,0,,2,3,0.667,1,2,3
11877,Willie Reed,26-305,F-C,3/17/17,MIA,,MIN,W,0,15,3,4,0.75,3,3,1,0,1,0,2,4,0.5,2,2,4
11878,Josh Richardson,23-060,G,11/14/16,MIA,@,SAS,L,1,28,4,9,0.444,4,7,0.571,0,2,0,0,0,,1,0,1
11879,Josh Richardson,23-170,G,3/4/17,MIA,,CLE,W,0,25,4,9,0.444,4,7,0.571,0,2,0,0,0,,1,6,7
11880,Josh Richardson,23-181,G,3/15/17,MIA,,NOP,W,0,16,3,4,0.75,1,2,0.5,2,2,1,0,0,,2,0,2
11881,Malachi Richardson,21-026,G,1/31/17,SAC,@,HOU,L,0,19,3,10,0.3,2,6,0.333,1,4,0.25,1,2,0.5,1,2,3
11882,Austin Rivers,24-095,G,11/4/16,LAC,@,MEM,W,0,23,2,9,0.222,1,5,0.2,1,4,0.25,3,5,0.6,0,3,3
11883,Austin Rivers,24-143,G,12/22/16,LAC,,SAS,W,0,25,2,9,0.222,1,6,0.167,1,3,0.333,3,4,0.75,0,0,0
11884,Austin Rivers,24-091,G,10/31/16,LAC,,PHO,W,0,24,4,9,0.444,4,9,0.444,0,0,,0,0,,0,0,0
11885,Austin Rivers,24-214,G,3/3/17,LAC,@,MIL,L,0,27,2,6,0.333,2,5,0.4,0,1,0,4,6,0.667,0,2,2
11886,Austin Rivers,24-087,G,10/27/16,LAC,@,POR,W,0,26,4,8,0.5,4,5,0.8,0,3,0,0,0,,0,4,4
11887,Andre Roberson,25-036,G-F,1/9/17,OKC,@,CHI,W,1,33,3,5,0.6,1,1,1,2,4,0.5,0,0,,0,2,2
11888,Andre Roberson,25-052,G-F,1/25/17,OKC,@,NOP,W,1,28,4,4,1,4,4,1,0,0,,0,0,,1,3,4
11889,Andre Roberson,25-067,G-F,2/9/17,OKC,,CLE,W,1,41,4,8,0.5,4,7,0.571,0,1,0,0,1,0,2,5,7
11890,Andre Roberson,25-089,G-F,3/3/17,OKC,@,PHO,L,1,31,3,5,0.6,2,2,1,1,3,0.333,1,2,0.5,1,2,3
11891,Andre Roberson,25-050,G-F,1/23/17,OKC,@,UTA,W,1,31,4,6,0.667,4,4,1,0,2,0,0,0,,1,10,11
11892,Andre Roberson,24-350,G-F,11/18/16,OKC,,BRK,W,1,26,4,9,0.444,4,7,0.571,0,2,0,0,2,0,3,3,6
11893,Andre Roberson,25-104,G-F,3/18/17,OKC,,SAC,W,1,33,4,6,0.667,4,5,0.8,0,1,0,0,0,,4,2,6
11894,Andre Roberson,24-331,G-F,10/30/16,OKC,,LAL,W,1,30,4,7,0.571,4,4,1,0,3,0,0,2,0,0,5,5
11895,Andre Roberson,25-097,G-F,3/11/17,OKC,,UTA,W,1,32,3,4,0.75,2,2,1,1,2,0.5,1,4,0.25,0,3,3
11896,Andre Roberson,25-040,G-F,1/13/17,OKC,@,MIN,L,1,32,3,6,0.5,3,6,0.5,0,0,,2,2,1,0,2,2
11897,Andre Roberson,24-357,G-F,11/25/16,OKC,@,DEN,W,1,35,4,6,0.667,4,4,1,0,2,0,0,1,0,1,1,2
11898,Andre Roberson,25-038,G-F,1/11/17,OKC,,MEM,W,1,31,3,5,0.6,2,2,1,1,3,0.333,1,2,0.5,1,7,8
11899,Brian Roberts,31-060,G,2/1/17,CHO,@,GSW,L,0,15,2,3,0.667,2,2,1,0,1,0,4,4,1,0,2,2
11900,Brian Roberts,31-059,G,1/31/17,CHO,@,POR,L,0,6,2,3,0.667,0,1,0,2,2,1,2,2,1,0,1,1
11901,Brian Roberts,31-072,G,2/13/17,CHO,,PHI,L,0,10,2,3,0.667,0,1,0,2,2,1,2,2,1,0,0,0
11902,Glenn Robinson,22-304,G-F,11/7/16,IND,@,CHO,L,0,13,3,7,0.429,2,3,0.667,1,4,0.25,1,3,0.333,1,1,2
11903,Glenn Robinson,23-004,G-F,1/12/17,IND,@,DEN,L,1,27,4,10,0.4,4,8,0.5,0,2,0,0,0,,4,0,4
11904,Glenn Robinson,22-318,G-F,11/21/16,IND,,GSW,L,1,37,3,14,0.214,1,9,0.111,2,5,0.4,0,0,,1,4,5
11905,Glenn Robinson,22-365,G-F,1/7/17,IND,,NYK,W,1,27,3,7,0.429,1,3,0.333,2,4,0.5,0,0,,0,6,6
11906,Glenn Robinson,22-363,G-F,1/5/17,IND,,BRK,W,1,25,3,5,0.6,3,3,1,0,2,0,2,3,0.667,2,4,6
11907,Glenn Robinson,22-361,G-F,1/3/17,IND,@,DET,W,1,28,3,5,0.6,1,2,0.5,2,3,0.667,0,0,,0,2,2
11908,Glenn Robinson,22-309,G-F,11/12/16,IND,,BOS,L,0,26,4,11,0.364,4,7,0.571,0,4,0,0,0,,1,5,6
11909,Thomas Robinson,25-280,F,12/22/16,LAL,@,MIA,L,0,18,3,4,0.75,3,4,0.75,0,0,,2,2,1,5,7,12
11910,Thomas Robinson,25-287,F,12/29/16,LAL,,DAL,L,0,19,4,5,0.8,4,5,0.8,0,0,,0,0,,4,6,10
11911,Thomas Robinson,25-299,F,1/10/17,LAL,,POR,L,0,16,4,6,0.667,4,6,0.667,0,0,,0,0,,1,1,2
11912,Sergio Rodriguez,30-173,G,12/2/16,PHI,,ORL,L,1,25,3,9,0.333,2,7,0.286,1,2,0.5,1,1,1,0,3,3
11913,Sergio Rodriguez,30-248,G,2/15/17,PHI,@,BOS,L,0,20,3,7,0.429,1,4,0.25,2,3,0.667,0,0,,0,3,3
11914,Sergio Rodriguez,30-270,G,3/9/17,PHI,@,POR,L,0,22,3,9,0.333,2,5,0.4,1,4,0.25,1,2,0.5,0,1,1
11915,Sergio Rodriguez,30-246,G,2/13/17,PHI,@,CHO,W,0,12,3,5,0.6,1,2,0.5,2,3,0.667,0,0,,0,0,0
11916,Sergio Rodriguez,30-229,G,1/27/17,PHI,,HOU,L,0,20,3,7,0.429,1,2,0.5,2,5,0.4,0,1,0,0,0,0
11917,Sergio Rodriguez,30-160,G,11/19/16,PHI,,PHO,W,1,29,3,10,0.3,1,4,0.25,2,6,0.333,0,0,,0,8,8
11918,Sergio Rodriguez,30-235,G,2/2/17,PHI,@,SAS,L,0,17,3,7,0.429,2,6,0.333,1,1,1,1,2,0.5,0,2,2
11919,Rajon Rondo,30-342,G,1/29/17,CHI,,PHI,W,0,21,2,9,0.222,1,7,0.143,1,2,0.5,3,4,0.75,0,5,5
11920,Rajon Rondo,31-016,G,3/10/17,CHI,,HOU,L,0,17,3,5,0.6,1,1,1,2,4,0.5,0,0,,0,2,2
11921,Rajon Rondo,31-014,G,3/8/17,CHI,@,ORL,L,0,28,3,7,0.429,1,4,0.25,2,3,0.667,0,0,,2,3,5
11922,Rajon Rondo,31-008,G,3/2/17,CHI,,GSW,W,0,13,3,5,0.6,3,4,0.75,0,1,0,2,3,0.667,0,3,3
11923,Terrence Ross,26-036,F-G,3/13/17,ORL,@,SAC,L,1,29,3,7,0.429,1,2,0.5,2,5,0.4,0,0,,0,2,2
11924,Terrence Ross,25-280,F-G,11/11/16,TOR,@,CHO,W,0,20,3,4,0.75,3,3,1,0,1,0,2,2,1,0,0,0
11925,Terrence Ross,25-294,F-G,11/25/16,TOR,@,MIL,W,0,20,3,7,0.429,1,2,0.5,2,5,0.4,0,0,,1,0,1
11926,Terrence Ross,25-275,F-G,11/6/16,TOR,,SAC,L,0,19,3,9,0.333,1,2,0.5,2,7,0.286,0,0,,0,2,2
11927,Terrence Ross,25-290,F-G,11/21/16,TOR,@,LAC,L,0,26,4,6,0.667,4,6,0.667,0,0,,0,0,,0,3,3
11928,Terrence Ross,25-338,F-G,1/8/17,TOR,,HOU,L,0,25,4,12,0.333,4,7,0.571,0,5,0,0,0,,0,2,2
11929,Terrence Ross,25-348,F-G,1/18/17,TOR,@,PHI,L,0,31,3,10,0.3,1,3,0.333,2,7,0.286,0,0,,0,6,6
11930,Terrence Ross,26-039,F-G,3/16/17,ORL,@,GSW,L,1,25,3,6,0.5,2,4,0.5,1,2,0.5,1,2,0.5,0,1,1
11931,Terry Rozier,22-224,G,10/27/16,BOS,@,CHI,L,0,23,3,7,0.429,1,2,0.5,2,5,0.4,0,0,,0,4,4
11932,Terry Rozier,22-363,G,3/15/17,BOS,,MIN,W,0,14,3,7,0.429,1,3,0.333,2,4,0.5,0,0,,0,1,1
11933,Ricky Rubio,26-051,G,12/11/16,MIN,,GSW,L,1,32,3,10,0.3,3,5,0.6,0,5,0,2,2,1,3,2,5
11934,Ricky Rubio,26-059,G,12/19/16,MIN,,PHO,W,1,37,1,5,0.2,1,3,0.333,0,2,0,6,6,1,0,3,3
11935,Ricky Rubio,26-040,G,11/30/16,MIN,,NYK,L,1,38,2,5,0.4,2,3,0.667,0,2,0,4,4,1,0,2,2
11936,Ricky Rubio,26-086,G,1/15/17,MIN,@,DAL,L,1,36,2,9,0.222,2,7,0.286,0,2,0,4,6,0.667,1,4,5
11937,Damjan Rudez,30-221,F,1/24/17,ORL,,CHI,L,0,13,3,5,0.6,1,1,1,2,4,0.5,0,0,,0,1,1
11938,Brandon Rush,31-237,G-F,3/1/17,MIN,@,UTA,W,1,24,3,5,0.6,1,2,0.5,2,3,0.667,0,0,,1,1,2
11939,D'Angelo Russell,20-271,G,11/20/16,LAL,,CHI,L,1,23,3,11,0.273,1,2,0.5,2,9,0.222,0,0,,0,3,3
11940,D'Angelo Russell,20-357,G,2/14/17,LAL,,SAC,L,1,23,3,9,0.333,1,6,0.167,2,3,0.667,0,0,,0,2,2
11941,Domantas Sabonis,20-308,F,3/7/17,OKC,,POR,L,1,21,3,7,0.429,3,6,0.5,0,1,0,2,2,1,1,3,4
11942,Domantas Sabonis,20-267,F,1/25/17,OKC,@,NOP,W,1,28,4,7,0.571,4,5,0.8,0,2,0,0,1,0,1,5,6
11943,Domantas Sabonis,20-282,F,2/9/17,OKC,,CLE,W,1,21,4,9,0.444,4,8,0.5,0,1,0,0,0,,0,2,2
11944,Domantas Sabonis,20-197,F,11/16/16,OKC,,HOU,W,1,28,4,5,0.8,4,4,1,0,1,0,0,0,,1,2,3
11945,Domantas Sabonis,20-317,F,3/16/17,OKC,@,TOR,W,0,19,3,7,0.429,2,6,0.333,1,1,1,1,2,0.5,0,6,6
11946,Domantas Sabonis,20-178,F,10/28/16,OKC,,PHO,W,1,17,4,6,0.667,4,6,0.667,0,0,,0,0,,0,4,4
11947,Dario Saric,22-234,F,11/28/16,PHI,@,TOR,L,0,24,3,13,0.231,2,7,0.286,1,6,0.167,1,4,0.25,1,3,4
11948,Dario Saric,22-273,F,1/6/17,PHI,@,BOS,L,0,23,3,9,0.333,3,6,0.5,0,3,0,2,2,1,1,5,6
11949,Dario Saric,22-270,F,1/3/17,PHI,,MIN,W,0,24,3,8,0.375,3,5,0.6,0,3,0,2,2,1,2,5,7
11950,Dario Saric,22-217,F,11/11/16,PHI,,IND,W,1,29,3,6,0.5,2,4,0.5,1,2,0.5,1,1,1,0,5,5
11951,Dario Saric,22-285,F,1/18/17,PHI,,TOR,W,0,24,3,9,0.333,2,6,0.333,1,3,0.333,1,2,0.5,2,7,9
11952,Dario Saric,22-259,F,12/23/16,PHI,@,PHO,L,0,27,3,10,0.3,1,5,0.2,2,5,0.4,0,0,,2,2,4
11953,Tomas Satoransky,25-020,G,11/19/16,WAS,,MIA,L,0,25,3,5,0.6,3,5,0.6,0,0,,2,3,0.667,0,2,2
11954,Tomas Satoransky,25-012,G,11/11/16,WAS,,CLE,L,0,20,3,7,0.429,3,7,0.429,0,0,,2,2,1,1,1,2
11955,Tomas Satoransky,25-006,G,11/5/16,WAS,@,ORL,L,1,32,4,7,0.571,4,7,0.571,0,0,,0,1,0,0,2,2
11956,Dennis Schroder,23-102,G,12/26/16,ATL,@,MIN,L,1,23,4,10,0.4,4,8,0.5,0,2,0,0,0,,1,1,2
11957,Dennis Schroder,23-184,G,3/18/17,ATL,,POR,L,1,28,2,14,0.143,1,12,0.083,1,2,0.5,3,4,0.75,0,3,3
11958,Luis Scola,36-237,F,12/23/16,BRK,@,CLE,L,0,15,3,5,0.6,2,4,0.5,1,1,1,1,1,1,2,3,5
11959,Luis Scola,36-272,F,1/27/17,BRK,@,CLE,L,0,25,2,5,0.4,0,0,,2,5,0.4,2,2,1,2,5,7
11960,Luis Scola,36-179,F,10/26/16,BRK,@,BOS,L,0,22,3,8,0.375,2,3,0.667,1,5,0.2,1,2,0.5,0,1,1
11961,Thabo Sefolosha,32-313,G-F,3/11/17,ATL,@,MEM,W,1,23,3,5,0.6,1,1,1,2,4,0.5,0,0,,0,4,4
11962,Thabo Sefolosha,32-187,G-F,11/5/16,ATL,,HOU,W,0,24,4,8,0.5,4,7,0.571,0,1,0,0,0,,3,1,4
11963,Thabo Sefolosha,32-221,G-F,12/9/16,ATL,@,MIL,W,1,29,3,9,0.333,3,5,0.6,0,4,0,2,2,1,0,6,6
11964,Thabo Sefolosha,32-215,G-F,12/3/16,ATL,@,TOR,L,0,23,3,7,0.429,1,4,0.25,2,3,0.667,0,0,,1,3,4
11965,Thabo Sefolosha,32-264,G-F,1/21/17,ATL,,PHI,W,1,32,3,6,0.5,3,6,0.5,0,0,,2,3,0.667,1,3,4
11966,Thabo Sefolosha,32-247,G-F,1/4/17,ATL,@,ORL,W,1,28,4,9,0.444,4,8,0.5,0,1,0,0,0,,0,5,5
11967,Kevin Seraphin,27-031,F,1/7/17,IND,,NYK,W,0,19,4,6,0.667,4,6,0.667,0,0,,0,0,,1,4,5
11968,Kevin Seraphin,27-029,F,1/5/17,IND,,BRK,W,0,15,4,8,0.5,4,8,0.5,0,0,,0,0,,2,1,3
11969,Kevin Seraphin,27-084,F,3/1/17,IND,@,SAS,L,0,15,4,4,1,4,4,1,0,0,,0,0,,2,1,3
11970,Kevin Seraphin,26-350,F,11/21/16,IND,,GSW,L,0,22,4,11,0.364,4,11,0.364,0,0,,0,0,,6,8,14
11971,Kevin Seraphin,26-327,F,10/29/16,IND,@,CHI,L,0,12,4,6,0.667,4,6,0.667,0,0,,0,0,,1,3,4
11972,Ramon Sessions,30-234,G,12/1/16,CHO,,DAL,W,0,15,3,3,1,3,3,1,0,0,,2,2,1,0,0,0
11973,Ramon Sessions,30-245,G,12/12/16,CHO,@,IND,L,0,13,2,4,0.5,1,2,0.5,1,2,0.5,3,4,0.75,0,0,0
11974,Ramon Sessions,30-228,G,11/25/16,CHO,@,NYK,L,0,25,4,9,0.444,4,7,0.571,0,2,0,0,1,0,0,3,3
11975,Iman Shumpert,26-128,G,11/1/16,CLE,,HOU,W,0,26,3,4,0.75,1,1,1,2,3,0.667,0,0,,0,2,2
11976,Iman Shumpert,26-256,G,3/9/17,CLE,@,DET,L,1,35,3,8,0.375,1,3,0.333,2,5,0.4,0,0,,0,1,1
11977,Iman Shumpert,26-194,G,1/6/17,CLE,@,BRK,W,0,30,2,3,0.667,2,2,1,0,1,0,4,4,1,0,1,1
11978,Iman Shumpert,26-253,G,3/6/17,CLE,,MIA,L,1,26,3,9,0.333,2,7,0.286,1,2,0.5,1,2,0.5,0,3,3
11979,Iman Shumpert,26-250,G,3/3/17,CLE,@,ATL,W,1,28,2,7,0.286,0,1,0,2,6,0.333,2,2,1,1,2,3
11980,Iman Shumpert,26-174,G,12/17/16,CLE,,LAL,W,0,29,3,9,0.333,2,3,0.667,1,6,0.167,1,1,1,2,2,4
11981,Iman Shumpert,26-218,G,1/30/17,CLE,@,DAL,L,1,30,1,6,0.167,0,3,0,1,3,0.333,5,6,0.833,0,4,4
11982,Pascal Siakam,22-302,F,12/2/16,TOR,,LAL,W,1,24,4,5,0.8,4,4,1,0,1,0,0,0,,2,5,7
11983,Pascal Siakam,22-285,F,11/15/16,TOR,@,CLE,L,1,16,4,5,0.8,4,5,0.8,0,0,,0,0,,2,1,3
11984,Pascal Siakam,22-274,F,11/4/16,TOR,,MIA,W,1,16,4,6,0.667,4,6,0.667,0,0,,0,0,,1,2,3
11985,Pascal Siakam,22-288,F,11/18/16,TOR,@,DEN,W,1,23,4,6,0.667,4,6,0.667,0,0,,0,0,,1,3,4
11986,Jonathon Simmons,27-154,G-F,2/15/17,SAS,@,ORL,W,0,21,2,7,0.286,2,3,0.667,0,4,0,4,4,1,0,5,5
11987,Jonathon Simmons,27-188,G-F,3/21/17,SAS,@,MIN,W,0,16,3,6,0.5,1,3,0.333,2,3,0.667,0,0,,1,3,4
11988,Marcus Smart,22-327,G,1/27/17,BOS,,ORL,W,0,23,3,7,0.429,1,4,0.25,2,3,0.667,0,0,,0,2,2
11989,Marcus Smart,23-013,G,3/19/17,BOS,@,PHI,L,1,35,3,12,0.25,3,9,0.333,0,3,0,2,2,1,2,4,6
11990,Ish Smith,28-239,G,3/1/17,DET,@,NOP,L,0,19,4,8,0.5,4,5,0.8,0,3,0,0,0,,0,1,1
11991,Ish Smith,28-157,G,12/9/16,DET,@,MIN,W,0,15,3,5,0.6,1,3,0.333,2,2,1,0,0,,0,1,1
11992,Ish Smith,28-169,G,12/21/16,DET,,MEM,L,0,22,3,7,0.429,3,6,0.5,0,1,0,2,4,0.5,1,3,4
11993,Ish Smith,28-207,G,1/28/17,DET,@,MIA,L,0,17,4,9,0.444,4,9,0.444,0,0,,0,0,,1,1,2
11994,Ish Smith,28-244,G,3/6/17,DET,,CHI,W,0,18,4,9,0.444,4,8,0.5,0,1,0,0,0,,1,1,2
11995,J.R. Smith,31-096,G-F,12/14/16,CLE,@,MEM,L,1,25,4,15,0.267,4,12,0.333,0,3,0,0,1,0,0,2,2
11996,J.R. Smith,31-049,G-F,10/28/16,CLE,@,TOR,W,1,34,3,8,0.375,1,1,1,2,7,0.286,0,0,,0,0,0
11997,J.R. Smith,31-075,G-F,11/23/16,CLE,,POR,W,1,27,3,3,1,1,1,1,2,2,1,0,0,,1,1,2
11998,J.R. Smith,31-046,G-F,10/25/16,CLE,,NYK,W,1,25,3,13,0.231,1,5,0.2,2,8,0.25,0,0,,0,3,3
11999,Jason Smith,30-364,F-C,3/1/17,WAS,@,TOR,W,0,10,4,4,1,4,4,1,0,0,,0,0,,0,5,5
12000,Jason Smith,30-322,F-C,1/18/17,WAS,,MEM,W,0,20,3,8,0.375,3,6,0.5,0,2,0,2,2,1,1,2,3
12001,Jason Smith,31-016,F-C,3/18/17,WAS,@,CHO,L,1,27,3,8,0.375,2,5,0.4,1,3,0.333,1,2,0.5,1,3,4
12002,Tony Snell,25-109,G-F,2/27/17,MIL,@,CLE,L,1,33,2,6,0.333,0,1,0,2,5,0.4,2,2,1,0,3,3
12003,Tony Snell,25-040,G-F,12/20/16,MIL,,CLE,L,1,41,3,7,0.429,1,2,0.5,2,5,0.4,0,0,,0,6,6
12004,Tony Snell,25-069,G-F,1/18/17,MIL,@,HOU,L,1,32,3,6,0.5,1,3,0.333,2,3,0.667,0,0,,0,4,4
12005,Tony Snell,25-051,G-F,12/31/16,MIL,@,CHI,W,1,24,2,3,0.667,0,1,0,2,2,1,2,2,1,0,0,0
12006,Tony Snell,25-019,G-F,11/29/16,MIL,,CLE,W,1,25,3,8,0.375,2,2,1,1,6,0.167,1,2,0.5,0,3,3
12007,Tony Snell,25-032,G-F,12/12/16,MIL,@,TOR,L,1,29,3,6,0.5,1,1,1,2,5,0.4,0,0,,0,5,5
12008,Tony Snell,25-061,G-F,1/10/17,MIL,@,SAS,W,1,31,3,6,0.5,1,1,1,2,5,0.4,0,0,,0,1,1
12009,Tony Snell,25-114,G-F,3/4/17,MIL,,TOR,W,1,30,3,11,0.273,1,3,0.333,2,8,0.25,0,0,,0,2,2
12010,Marreese Speights,29-224,C-F,3/16/17,LAC,@,DEN,L,1,15,3,6,0.5,1,2,0.5,2,4,0.5,0,0,,1,5,6
12011,Marreese Speights,29-119,C-F,12/1/16,LAC,@,CLE,W,0,16,4,7,0.571,4,6,0.667,0,1,0,0,0,,1,3,4
12012,Marreese Speights,29-134,C-F,12/16/16,LAC,@,MIA,W,0,13,2,6,0.333,2,4,0.5,0,2,0,4,4,1,1,5,6
12013,Marreese Speights,29-088,C-F,10/31/16,LAC,,PHO,W,0,13,2,6,0.333,2,3,0.667,0,3,0,4,4,1,2,3,5
12014,Marreese Speights,29-132,C-F,12/14/16,LAC,@,ORL,W,0,13,3,7,0.429,1,5,0.2,2,2,1,0,0,,2,4,6
12015,Marreese Speights,29-182,C-F,2/2/17,LAC,,GSW,L,0,17,2,7,0.286,1,4,0.25,1,3,0.333,3,3,1,2,4,6
12016,Marreese Speights,29-100,C-F,11/12/16,LAC,@,MIN,W,0,14,3,7,0.429,1,1,1,2,6,0.333,0,0,,1,2,3
12017,Marreese Speights,29-217,C-F,3/9/17,LAC,@,MEM,W,0,19,3,6,0.5,1,1,1,2,5,0.4,0,0,,1,2,3
12018,Marreese Speights,29-203,C-F,2/23/17,LAC,@,GSW,L,0,14,3,7,0.429,2,4,0.5,1,3,0.333,1,1,1,0,5,5
12019,Marreese Speights,29-195,C-F,2/15/17,LAC,,ATL,W,0,12,4,8,0.5,4,4,1,0,4,0,0,0,,0,0,0
12020,Marreese Speights,29-214,C-F,3/6/17,LAC,,BOS,W,0,15,3,6,0.5,2,2,1,1,4,0.25,1,2,0.5,2,6,8
12021,Marreese Speights,29-191,C-F,2/11/17,LAC,@,CHO,W,0,15,3,7,0.429,1,3,0.333,2,4,0.5,0,0,,1,3,4
12022,Nik Stauskas,23-074,G,12/20/16,PHI,,NOP,L,0,23,2,8,0.25,0,3,0,2,5,0.4,2,2,1,0,5,5
12023,Nik Stauskas,23-098,G,1/13/17,PHI,,CHO,W,1,31,3,8,0.375,1,2,0.5,2,6,0.333,0,0,,1,3,4
12024,Nik Stauskas,23-109,G,1/24/17,PHI,,LAC,W,1,24,3,5,0.6,1,2,0.5,2,3,0.667,0,0,,0,1,1
12025,Nik Stauskas,23-120,G,2/4/17,PHI,@,MIA,L,1,40,2,11,0.182,2,7,0.286,0,4,0,4,4,1,0,4,4
12026,Nik Stauskas,23-118,G,2/2/17,PHI,@,SAS,L,1,28,2,10,0.2,0,5,0,2,5,0.4,2,2,1,1,3,4
12027,Nik Stauskas,23-088,G,1/3/17,PHI,,MIN,W,1,32,3,9,0.333,1,4,0.25,2,5,0.4,0,0,,0,3,3
12028,Nik Stauskas,23-117,G,2/1/17,PHI,@,DAL,L,1,35,2,5,0.4,1,1,1,1,4,0.25,3,4,0.75,0,3,3
12029,Nik Stauskas,23-045,G,11/21/16,PHI,,MIA,W,0,21,2,6,0.333,0,2,0,2,4,0.5,2,2,1,0,3,3
12030,Lance Stephenson,26-051,G-F,10/26/16,NOP,,DEN,L,0,26,4,7,0.571,4,7,0.571,0,0,,0,0,,1,2,3
12031,Rodney Stuckey,30-213,G,11/20/16,IND,@,OKC,W,0,17,3,9,0.333,2,7,0.286,1,2,0.5,1,4,0.25,1,1,2
12032,Rodney Stuckey,30-286,G,2/1/17,IND,@,ORL,W,0,14,2,6,0.333,2,6,0.333,0,0,,4,6,0.667,0,1,1
12033,Rodney Stuckey,30-188,G,10/26/16,IND,,DAL,W,0,22,3,6,0.5,2,4,0.5,1,2,0.5,1,3,0.333,0,3,3
12034,Jared Sullinger,24-320,F,1/18/17,TOR,@,PHI,L,0,14,4,10,0.4,4,8,0.5,0,2,0,0,1,0,1,2,3
12035,Jeff Teague,28-278,G,3/15/17,IND,,CHO,W,1,30,3,8,0.375,1,3,0.333,2,5,0.4,0,0,,0,8,8
12036,Mirza Teletovic,31-044,F,11/1/16,MIL,@,NOP,W,0,13,3,7,0.429,1,1,1,2,6,0.333,0,0,,0,0,0
12037,Mirza Teletovic,31-041,F,10/29/16,MIL,,BRK,W,0,16,2,4,0.5,0,1,0,2,3,0.667,2,2,1,0,2,2
12038,Mirza Teletovic,31-184,F,3/21/17,MIL,@,POR,W,0,18,3,8,0.375,1,3,0.333,2,5,0.4,0,0,,0,4,4
12039,Mirza Teletovic,31-103,F,12/30/16,MIL,@,MIN,L,0,19,2,4,0.5,0,0,,2,4,0.5,2,2,1,0,3,3
12040,Garrett Temple,30-258,G,1/21/17,SAC,@,CHI,L,1,30,3,9,0.333,2,5,0.4,1,4,0.25,1,2,0.5,0,3,3
12041,Garrett Temple,30-240,G,1/3/17,SAC,@,DEN,W,0,25,4,9,0.444,4,7,0.571,0,2,0,0,0,,2,3,5
12042,Garrett Temple,30-182,G,11/6/16,SAC,@,TOR,W,0,21,3,6,0.5,2,2,1,1,4,0.25,1,1,1,1,2,3
12043,Garrett Temple,30-252,G,1/15/17,SAC,,OKC,L,1,24,3,6,0.5,3,4,0.75,0,2,0,2,2,1,0,4,4
12044,Garrett Temple,30-311,G,3/15/17,SAC,@,PHO,W,0,27,2,7,0.286,0,4,0,2,3,0.667,2,2,1,0,4,4
12045,Garrett Temple,30-199,G,11/23/16,SAC,,OKC,W,0,27,3,8,0.375,1,3,0.333,2,5,0.4,0,0,,1,2,3
12046,Garrett Temple,30-196,G,11/20/16,SAC,,TOR,W,0,19,2,4,0.5,0,0,,2,4,0.5,2,2,1,0,3,3
12047,Jason Terry,39-165,G,2/27/17,MIL,@,CLE,L,0,22,3,5,0.6,1,2,0.5,2,3,0.667,0,0,,0,2,2
12048,Jason Terry,39-176,G,3/10/17,MIL,,IND,W,0,26,3,5,0.6,2,3,0.667,1,2,0.5,1,2,0.5,0,3,3
12049,Jason Terry,39-130,G,1/23/17,MIL,,HOU,W,0,15,3,5,0.6,1,2,0.5,2,3,0.667,0,0,,1,0,1
12050,Jason Terry,39-111,G,1/4/17,MIL,@,NYK,W,0,28,3,5,0.6,1,1,1,2,4,0.5,0,0,,1,2,3
12051,Jason Terry,39-142,G,2/4/17,MIL,@,PHO,W,0,19,2,3,0.667,0,0,,2,3,0.667,2,2,1,1,0,1
12052,Jason Terry,39-169,G,3/3/17,MIL,,LAC,W,0,25,3,4,0.75,1,1,1,2,3,0.667,0,0,,0,1,1
12053,Hollis Thompson,25-216,G-F,11/5/16,PHI,,CLE,L,0,20,3,6,0.5,1,1,1,2,5,0.4,0,0,,0,2,2
12054,Hollis Thompson,25-332,G-F,3/1/17,NOP,,DET,W,1,40,2,7,0.286,1,3,0.333,1,4,0.25,3,3,1,0,8,8
12055,Klay Thompson,26-306,G,12/10/16,GSW,@,MEM,L,1,31,4,14,0.286,4,11,0.364,0,3,0,0,0,,0,1,1
12056,Tristan Thompson,25-351,F-C,2/27/17,CLE,,MIL,W,1,34,2,4,0.5,2,4,0.5,0,0,,4,6,0.667,1,7,8
12057,Tristan Thompson,25-364,F-C,3/12/17,CLE,@,HOU,L,1,33,4,4,1,4,4,1,0,0,,0,0,,4,4,8
12058,Tristan Thompson,25-261,F-C,11/29/16,CLE,@,MIL,L,1,30,3,6,0.5,3,6,0.5,0,0,,2,4,0.5,2,3,5
12059,Tristan Thompson,25-358,F-C,3/6/17,CLE,,MIA,L,1,36,3,3,1,3,3,1,0,0,,2,4,0.5,4,9,13
12060,Tristan Thompson,25-287,F-C,12/25/16,CLE,,GSW,W,1,28,2,5,0.4,2,5,0.4,0,0,,4,6,0.667,6,2,8
12061,Tristan Thompson,25-301,F-C,1/8/17,CLE,@,PHO,W,1,28,2,4,0.5,2,4,0.5,0,0,,4,4,1,4,6,10
12062,Tristan Thompson,25-250,F-C,11/18/16,CLE,,DET,W,1,30,3,8,0.375,3,7,0.429,0,1,0,2,2,1,1,13,14
12063,Marcus Thornton,29-184,G,12/6/16,WAS,,ORL,L,0,18,4,7,0.571,4,5,0.8,0,2,0,0,0,,2,4,6
12064,Marcus Thornton,29-208,G,12/30/16,WAS,,BRK,W,0,21,3,6,0.5,1,4,0.25,2,2,1,0,0,,1,2,3
12065,Marcus Thornton,29-155,G,11/7/16,WAS,,HOU,L,0,17,2,10,0.2,0,3,0,2,7,0.286,2,2,1,1,4,5
12066,P.J. Tucker,31-256,F,1/16/17,PHO,,UTA,L,0,27,4,6,0.667,4,5,0.8,0,1,0,0,0,,2,11,13
12067,P.J. Tucker,31-307,F,3/8/17,TOR,@,NOP,W,1,38,4,7,0.571,4,5,0.8,0,2,0,0,0,,0,6,6
12068,P.J. Tucker,31-320,F,3/21/17,TOR,,CHI,W,0,33,3,6,0.5,1,2,0.5,2,4,0.5,0,0,,2,10,12
12069,P.J. Tucker,31-316,F,3/17/17,TOR,@,DET,W,0,27,3,6,0.5,1,3,0.333,2,3,0.667,0,0,,1,8,9
12070,P.J. Tucker,31-264,F,1/24/17,PHO,,MIN,L,0,34,1,3,0.333,1,3,0.333,0,0,,6,8,0.75,0,6,6
12071,P.J. Tucker,31-192,F,11/13/16,PHO,@,GSW,L,0,27,3,5,0.6,3,4,0.75,0,1,0,2,6,0.333,2,6,8
12072,P.J. Tucker,31-274,F,2/3/17,PHO,@,SAC,W,0,32,2,8,0.25,0,4,0,2,4,0.5,2,2,1,1,4,5
12073,Evan Turner,28-083,G,1/18/17,POR,@,CHO,L,0,20,4,8,0.5,4,6,0.667,0,2,0,0,0,,2,7,9
12074,Evan Turner,28-101,G,2/5/17,POR,@,OKC,L,1,26,4,11,0.364,4,10,0.4,0,1,0,0,0,,1,2,3
12075,Evan Turner,28-064,G,12/30/16,POR,@,SAS,L,0,28,3,11,0.273,3,10,0.3,0,1,0,2,2,1,0,4,4
12076,Evan Turner,28-092,G,1/27/17,POR,,MEM,W,1,31,3,9,0.333,1,6,0.167,2,3,0.667,0,0,,0,2,2
12077,Evan Turner,28-019,G,11/15/16,POR,,CHI,L,0,20,3,9,0.333,3,7,0.429,0,2,0,2,2,1,0,4,4
12078,Myles Turner,20-349,F-C,3/8/17,IND,,DET,W,1,25,3,6,0.5,3,6,0.5,0,0,,2,2,1,0,5,5
12079,Beno Udrih,34-137,G,11/19/16,DET,,BOS,L,0,15,3,5,0.6,3,5,0.6,0,0,,2,2,1,0,2,2
12080,Tyler Ulis,21-009,G,1/14/17,PHO,,SAS,W,0,14,4,6,0.667,4,6,0.667,0,0,,0,0,,0,0,0
12081,Tyler Ulis,21-056,G,3/2/17,PHO,,CHO,W,0,23,3,7,0.429,3,7,0.429,0,0,,2,2,1,0,1,1
12082,Tyler Ulis,21-065,G,3/11/17,PHO,@,DAL,W,0,28,4,11,0.364,4,9,0.444,0,2,0,0,0,,0,3,3
12083,Jonas Valanciunas,24-237,C,12/29/16,TOR,@,PHO,L,1,19,2,4,0.5,2,4,0.5,0,0,,4,4,1,3,7,10
12084,Jonas Valanciunas,24-266,C,1/27/17,TOR,,MIL,W,1,24,4,10,0.4,4,10,0.4,0,0,,0,0,,1,10,11
12085,Jonas Valanciunas,24-319,C,3/21/17,TOR,,CHI,W,1,25,4,6,0.667,4,6,0.667,0,0,,0,0,,1,4,5
12086,Jonas Valanciunas,24-247,C,1/8/17,TOR,,HOU,L,1,23,4,4,1,4,4,1,0,0,,0,0,,0,5,5
12087,Denzel Valentine,23-114,G,3/10/17,CHI,,HOU,L,0,23,3,8,0.375,1,2,0.5,2,6,0.333,0,0,,0,5,5
12088,Denzel Valentine,23-108,G,3/4/17,CHI,,LAC,L,0,14,3,5,0.6,1,1,1,2,4,0.5,0,0,,0,3,3
12089,Denzel Valentine,23-065,G,1/20/17,CHI,@,ATL,L,0,24,3,10,0.3,1,2,0.5,2,8,0.25,0,0,,1,5,6
12090,Denzel Valentine,23-004,G,11/20/16,CHI,@,LAL,W,0,18,3,7,0.429,1,2,0.5,2,5,0.4,0,0,,0,2,2
12091,Rashad Vaughn,20-157,G,1/20/17,MIL,@,ORL,L,0,10,3,6,0.5,1,3,0.333,2,3,0.667,0,0,,0,2,2
12092,Rashad Vaughn,20-127,G,12/21/16,MIL,@,CLE,L,0,16,3,7,0.429,1,4,0.25,2,3,0.667,0,0,,0,1,1
12093,Noah Vonleh,21-154,F,1/25/17,POR,,LAL,W,1,20,4,6,0.667,4,6,0.667,0,0,,0,0,,4,6,10
12094,Noah Vonleh,21-209,F,3/21/17,POR,,MIL,L,1,28,2,4,0.5,2,4,0.5,0,0,,4,5,0.8,4,4,8
12095,Noah Vonleh,21-150,F,1/21/17,POR,@,BOS,W,1,17,4,8,0.5,4,8,0.5,0,0,,0,0,,4,2,6
12096,Nikola Vucevic,26-103,C,2/4/17,ORL,@,ATL,L,1,24,4,10,0.4,4,10,0.4,0,0,,0,0,,0,7,7
12097,Nikola Vucevic,26-028,C,11/21/16,ORL,@,MIL,L,1,28,4,12,0.333,4,11,0.364,0,1,0,0,0,,3,8,11
12098,Sasha Vujacic,32-307,G,1/9/17,NYK,,NOP,L,0,10,2,5,0.4,1,3,0.333,1,2,0.5,3,3,1,0,0,0
12099,Dwyane Wade,35-057,G,3/15/17,CHI,,MEM,L,1,23,3,11,0.273,2,9,0.222,1,2,0.5,1,2,0.5,0,3,3
12100,Dwyane Wade,34-349,G,12/31/16,CHI,,MIL,L,1,25,3,13,0.231,2,9,0.222,1,4,0.25,1,2,0.5,1,4,5
12101,Dwyane Wade,35-054,G,3/12/17,CHI,@,BOS,L,1,26,4,11,0.364,4,9,0.444,0,2,0,0,0,,1,2,3
12102,Dion Waiters,25-029,G,1/8/17,MIA,@,LAC,L,0,15,2,7,0.286,1,5,0.2,1,2,0.5,3,4,0.75,0,2,2
12103,Dion Waiters,25-084,G,3/4/17,MIA,,CLE,W,1,24,3,10,0.3,1,5,0.2,2,5,0.4,0,0,,0,1,1
12104,Dion Waiters,25-031,G,1/10/17,MIA,@,GSW,L,1,38,4,17,0.235,4,12,0.333,0,5,0,0,0,,0,3,3
12105,Taurean Waller-Prince,22-342,F,2/27/17,ATL,@,BOS,W,0,30,3,9,0.333,3,8,0.375,0,1,0,2,2,1,5,7,12
12106,Taurean Waller-Prince,22-339,F,2/24/17,ATL,,MIA,L,0,16,3,7,0.429,3,7,0.429,0,0,,2,2,1,0,4,4
12107,Taurean Waller-Prince,22-246,F,11/23/16,ATL,@,IND,W,0,16,3,4,0.75,2,2,1,1,2,0.5,1,2,0.5,1,3,4
12108,Taurean Waller-Prince,22-330,F,2/15/17,ATL,@,LAC,L,0,25,3,8,0.375,2,4,0.5,1,4,0.25,1,1,1,1,4,5
12109,Taurean Waller-Prince,22-294,F,1/10/17,ATL,@,BRK,W,0,20,2,6,0.333,0,2,0,2,4,0.5,2,2,1,2,4,6
12110,Taurean Waller-Prince,22-361,F,3/18/17,ATL,,POR,L,0,31,2,9,0.222,2,6,0.333,0,3,0,4,5,0.8,1,5,6
12111,Taurean Waller-Prince,22-239,F,11/16/16,ATL,,MIL,W,0,19,2,5,0.4,2,2,1,0,3,0,4,4,1,0,5,5
12112,T.J. Warren,23-072,F,11/16/16,PHO,@,DEN,L,1,18,2,11,0.182,0,7,0,2,4,0.5,2,2,1,0,1,1
12113,T.J. Warren,23-149,F,2/1/17,PHO,,LAC,L,1,29,3,6,0.5,3,6,0.5,0,0,,2,3,0.667,2,1,3
12114,T.J. Warren,23-129,F,1/12/17,PHO,,DAL,L,1,28,4,11,0.364,4,9,0.444,0,2,0,0,0,,1,1,2
12115,T.J. Warren,23-141,F,1/24/17,PHO,,MIN,L,1,30,4,11,0.364,4,9,0.444,0,2,0,0,1,0,1,1,2
12116,C.J. Watson,32-293,G,2/4/17,ORL,@,ATL,L,0,20,3,4,0.75,1,1,1,2,3,0.667,0,0,,0,2,2
12117,C.J. Watson,32-333,G,3/16/17,ORL,@,GSW,L,0,17,3,6,0.5,1,2,0.5,2,4,0.5,0,0,,0,2,2
12118,Briante Weber,24-081,PG,3/20/17,CHO,,ATL,W,0,19,4,5,0.8,4,5,0.8,0,0,,0,1,0,0,4,4
12119,Briante Weber,24-076,PG,3/15/17,CHO,@,IND,L,0,20,4,7,0.571,4,6,0.667,0,1,0,0,0,,1,4,5
12120,David West,36-070,F,11/7/16,GSW,,NOP,W,0,14,3,5,0.6,3,5,0.6,0,0,,2,2,1,3,1,4
12121,David West,36-194,F,3/11/17,GSW,@,SAS,L,0,15,3,8,0.375,3,8,0.375,0,0,,2,2,1,1,2,3
12122,David West,36-123,F,12/30/16,GSW,,DAL,W,0,15,2,2,1,2,2,1,0,0,,4,4,1,0,2,2
12123,David West,36-142,F,1/18/17,GSW,,OKC,W,0,11,4,5,0.8,4,5,0.8,0,0,,0,0,,0,1,1
12124,Isaiah Whitehead,21-281,G,12/14/16,BRK,,LAL,W,1,24,3,4,0.75,3,4,0.75,0,0,,2,2,1,1,1,2
12125,Isaiah Whitehead,22-008,G,3/16/17,BRK,@,NYK,W,0,21,4,6,0.667,4,4,1,0,2,0,0,0,,0,0,0
12126,Isaiah Whitehead,21-268,G,12/1/16,BRK,,MIL,L,1,31,3,8,0.375,3,6,0.5,0,2,0,2,2,1,0,0,0
12127,Isaiah Whitehead,21-241,G,11/4/16,BRK,,CHO,L,1,23,4,9,0.444,4,6,0.667,0,3,0,0,0,,1,1,2
12128,Hassan Whiteside,27-177,C,12/7/16,MIA,@,ATL,L,1,36,4,12,0.333,4,12,0.333,0,0,,0,0,,3,9,12
12129,Hassan Whiteside,27-199,C,12/29/16,MIA,@,CHO,L,1,35,4,7,0.571,4,7,0.571,0,0,,0,0,,0,10,10
12130,Hassan Whiteside,27-242,C,2/10/17,MIA,@,BRK,W,1,25,3,10,0.3,3,10,0.3,0,0,,2,2,1,3,6,9
12131,Hassan Whiteside,27-179,C,12/9/16,MIA,@,CLE,L,1,28,4,10,0.4,4,10,0.4,0,0,,0,0,,6,6,12
12132,Andrew Wiggins,21-315,F-G,1/3/17,MIN,@,PHI,L,1,37,2,15,0.133,2,12,0.167,0,3,0,4,4,1,0,4,4
12133,Deron Williams,32-259,G,3/12/17,CLE,@,HOU,L,0,23,2,6,0.333,0,2,0,2,4,0.5,2,2,1,0,5,5
12134,Deron Williams,32-186,G,12/29/16,DAL,@,LAL,W,1,33,3,6,0.5,2,3,0.667,1,3,0.333,1,1,1,0,1,1
12135,Derrick Williams,25-276,F,2/25/17,CLE,,CHI,L,0,23,3,7,0.429,3,5,0.6,0,2,0,2,4,0.5,0,4,4
12136,Lou Williams,30-066,G,1/1/17,LAL,,TOR,L,0,17,3,11,0.273,1,7,0.143,2,4,0.5,0,2,0,0,0,0
12137,Marvin Williams,30-213,F,1/18/17,CHO,,POR,W,1,24,3,9,0.333,1,5,0.2,2,4,0.5,0,0,,2,7,9
12138,Marvin Williams,30-152,F,11/18/16,CHO,,ATL,W,1,28,3,9,0.333,1,4,0.25,2,5,0.4,0,0,,2,9,11
12139,Marvin Williams,30-192,F,12/28/16,CHO,@,ORL,W,1,22,3,7,0.429,1,3,0.333,2,4,0.5,0,0,,1,5,6
12140,Marvin Williams,30-208,F,1/13/17,CHO,@,PHI,L,1,28,2,6,0.333,0,2,0,2,4,0.5,2,2,1,1,2,3
12141,Marvin Williams,30-159,F,11/25/16,CHO,@,NYK,L,1,17,3,5,0.6,2,3,0.667,1,2,0.5,1,1,1,1,1,2
12142,Marvin Williams,30-199,F,1/4/17,CHO,,OKC,W,1,27,3,9,0.333,2,6,0.333,1,3,0.333,1,1,1,2,6,8
12143,Marvin Williams,30-216,F,1/21/17,CHO,,BRK,W,1,26,2,6,0.333,0,0,,2,6,0.333,2,2,1,0,6,6
12144,Marvin Williams,30-252,F,2/26/17,CHO,@,LAC,L,1,39,2,6,0.333,1,3,0.333,1,3,0.333,3,4,0.75,0,6,6
12145,Troy Williams,21-342,F,12/6/16,MEM,,PHI,W,1,31,4,6,0.667,4,4,1,0,2,0,0,0,,1,2,3
12146,Justise Winslow,20-267,F,12/18/16,MIA,,BOS,L,0,32,2,3,0.667,2,3,0.667,0,0,,4,8,0.5,1,3,4
12147,Jeff Withey,26-359,C,3/1/17,UTA,,MIN,L,0,10,4,6,0.667,4,6,0.667,0,0,,0,0,,2,1,3
12148,Brandan Wright,29-155,F-C,3/9/17,MEM,,LAC,L,1,15,4,6,0.667,4,6,0.667,0,0,,0,1,0,0,2,2
12149,Nick Young,31-270,G-F,2/26/17,LAL,,SAS,L,1,23,3,8,0.375,2,4,0.5,1,4,0.25,1,1,1,0,0,0
12150,Nick Young,31-153,G-F,11/1/16,LAL,@,IND,L,1,21,3,6,0.5,1,2,0.5,2,4,0.5,0,0,,0,4,4
12151,Nick Young,31-194,G-F,12/12/16,LAL,@,SAC,L,1,26,3,10,0.3,1,3,0.333,2,7,0.286,0,0,,0,2,2
12152,Nick Young,31-225,G-F,1/12/17,LAL,@,SAS,L,1,14,3,6,0.5,1,2,0.5,2,4,0.5,0,0,,0,0,0
12153,Nick Young,31-223,G-F,1/10/17,LAL,,POR,L,1,28,2,9,0.222,0,4,0,2,5,0.4,2,3,0.667,0,0,0
12154,Nick Young,31-147,G-F,10/26/16,LAL,,HOU,W,1,27,3,12,0.25,1,3,0.333,2,9,0.222,0,0,,0,3,3
12155,Nick Young,31-175,G-F,11/23/16,LAL,@,GSW,L,1,19,3,8,0.375,1,5,0.2,2,3,0.667,0,0,,0,1,1
12156,Nick Young,31-228,G-F,1/15/17,LAL,,DET,L,1,26,2,8,0.25,1,1,1,1,7,0.143,3,3,1,2,5,7
12157,Thaddeus Young,28-211,F,1/18/17,IND,@,SAC,W,1,24,4,11,0.364,4,9,0.444,0,2,0,0,0,,1,3,4
12158,Thaddeus Young,28-220,F,1/27/17,IND,,SAC,W,1,29,3,9,0.333,3,5,0.6,0,4,0,2,2,1,1,4,5
12159,Thaddeus Young,28-272,F,3/20/17,IND,,UTA,W,1,32,4,8,0.5,4,8,0.5,0,0,,0,0,,4,4,8
12160,Thaddeus Young,28-251,F,2/27/17,IND,@,HOU,W,1,23,4,10,0.4,4,10,0.4,0,0,,0,2,0,1,4,5
12161,Thaddeus Young,28-196,F,1/3/17,IND,@,DET,W,1,33,4,8,0.5,4,5,0.8,0,3,0,0,0,,1,4,5
12162,Cody Zeller,24-166,F-C,3/20/17,CHO,,ATL,W,1,22,4,6,0.667,4,6,0.667,0,0,,0,2,0,2,3,5
12163,Cody Zeller,24-055,F-C,11/29/16,CHO,,DET,L,1,28,4,6,0.667,4,6,0.667,0,0,,0,0,,2,8,10
12164,Cody Zeller,24-068,F-C,12/12/16,CHO,@,IND,L,1,31,4,9,0.444,4,9,0.444,0,0,,0,0,,1,6,7
12165,Cody Zeller,24-154,F-C,3/8/17,CHO,@,MIA,L,1,42,4,8,0.5,4,8,0.5,0,0,,0,0,,2,2,4
12166,Tyler Zeller,26-347,F-C,12/29/16,BOS,@,CLE,L,0,10,3,4,0.75,3,4,0.75,0,0,,2,2,1,0,0,0
12167,Paul Zipser,23-020,G-F,3/10/17,CHI,,HOU,L,0,20,3,9,0.333,1,3,0.333,2,6,0.333,0,0,,0,2,2
12168,Paul Zipser,23-027,G-F,3/17/17,CHI,@,WAS,L,1,28,4,11,0.364,4,8,0.5,0,3,0,0,0,,2,5,7
12169,Ivica Zubac,19-350,C,3/3/17,LAL,,BOS,L,0,23,4,8,0.5,4,8,0.5,0,0,,0,2,0,0,1,1
12170,Ivica Zubac,19-300,C,1/12/17,LAL,@,SAS,L,0,15,4,7,0.571,4,7,0.571,0,0,,0,0,,2,2,4
12171,Ivica Zubac,19-334,C,2/15/17,LAL,@,PHO,L,0,14,3,6,0.5,3,6,0.5,0,0,,2,4,0.5,2,2,4
12172,Alex Abrines,23-104,G-F,11/13/16,OKC,,ORL,L,0,19,3,7,0.429,2,3,0.667,1,4,0.25,0,0,,0,3,3
12173,Alex Abrines,23-161,G-F,1/9/17,OKC,@,CHI,W,0,19,3,6,0.5,2,3,0.667,1,3,0.333,0,0,,0,2,2
12174,Alex Abrines,23-159,G-F,1/7/17,OKC,,DEN,W,0,20,1,4,0.25,0,1,0,1,3,0.333,4,4,1,0,2,2
12175,Alex Abrines,23-107,G-F,11/16/16,OKC,,HOU,W,0,15,2,4,0.5,0,1,0,2,3,0.667,1,1,1,0,0,0
12176,Quincy Acy,26-111,F,1/25/17,BRK,,MIA,L,0,6,2,3,0.667,1,2,0.5,1,1,1,2,2,1,0,0,0
12177,Quincy Acy,26-166,F,3/21/17,BRK,,DET,W,0,23,2,4,0.5,1,2,0.5,1,2,0.5,2,2,1,1,3,4
12178,Quincy Acy,26-149,F,3/4/17,BRK,@,POR,L,0,17,2,4,0.5,0,0,,2,4,0.5,1,2,0.5,0,1,1
12179,Quincy Acy,26-101,F,1/15/17,BRK,,HOU,L,0,20,2,6,0.333,1,4,0.25,1,2,0.5,2,2,1,3,1,4
12180,Quincy Acy,26-113,F,1/27/17,BRK,@,CLE,L,0,18,3,4,0.75,2,3,0.667,1,1,1,0,0,,0,5,5
12181,Quincy Acy,26-153,F,3/8/17,BRK,@,ATL,L,0,22,2,6,0.333,1,2,0.5,1,4,0.25,2,2,1,0,7,7
12182,Steven Adams,23-193,C,1/29/17,OKC,@,CLE,L,1,27,3,4,0.75,3,4,0.75,0,0,,1,1,1,2,8,10
12183,Steven Adams,23-137,C,12/4/16,OKC,,NOP,W,1,9,3,3,1,3,3,1,0,0,,1,1,1,0,3,3
12184,Steven Adams,23-200,C,2/5/17,OKC,,POR,W,1,38,3,11,0.273,3,11,0.273,0,0,,1,4,0.25,9,4,13
12185,Steven Adams,23-128,C,11/25/16,OKC,@,DEN,W,1,30,3,7,0.429,3,7,0.429,0,0,,1,2,0.5,1,5,6
12186,Arron Afflalo,31-032,G,11/16/16,SAC,,SAS,L,1,22,3,8,0.375,2,5,0.4,1,3,0.333,0,0,,1,1,2
12187,Arron Afflalo,31-012,G,10/27/16,SAC,,SAS,L,1,36,3,9,0.333,2,6,0.333,1,3,0.333,0,0,,0,4,4
12188,Arron Afflalo,31-092,G,1/15/17,SAC,,OKC,L,0,18,2,5,0.4,1,4,0.25,1,1,1,2,2,1,0,3,3
12189,Arron Afflalo,31-021,G,11/5/16,SAC,@,MIL,L,1,23,2,10,0.2,1,7,0.143,1,3,0.333,2,2,1,1,1,2
12190,Alexis Ajinca,28-315,C,3/17/17,NOP,,HOU,W,0,10,3,4,0.75,3,4,0.75,0,0,,1,1,1,2,2,4
12191,Alexis Ajinca,28-219,C,12/11/16,NOP,@,PHO,W,1,12,3,5,0.6,3,5,0.6,0,0,,1,2,0.5,1,4,5
12192,Lavoy Allen,28-034,F-C,3/10/17,IND,@,MIL,L,0,15,3,5,0.6,3,5,0.6,0,0,,1,1,1,2,1,3
12193,Tony Allen,35-051,G-F,3/3/17,MEM,@,DAL,L,1,22,3,6,0.5,2,4,0.5,1,2,0.5,0,0,,0,2,2
12194,Al-Farouq Aminu,26-119,F,1/18/17,POR,@,CHO,L,1,30,2,7,0.286,1,2,0.5,1,5,0.2,2,2,1,1,6,7
12195,Al-Farouq Aminu,26-137,F,2/5/17,POR,@,OKC,L,0,32,1,8,0.125,0,5,0,1,3,0.333,4,4,1,2,5,7
12196,Al-Farouq Aminu,26-132,F,1/31/17,POR,,CHO,W,0,28,3,8,0.375,2,4,0.5,1,4,0.25,0,0,,1,9,10
12197,Al-Farouq Aminu,26-130,F,1/29/17,POR,,GSW,L,0,34,3,10,0.3,2,5,0.4,1,5,0.2,0,0,,1,8,9
12198,Al-Farouq Aminu,26-106,F,1/5/17,POR,,LAL,W,1,35,3,8,0.375,2,5,0.4,1,3,0.333,0,0,,1,10,11
12199,Alan Anderson,34-055,G-F,12/10/16,LAC,,NOP,W,0,19,3,6,0.5,2,4,0.5,1,2,0.5,0,0,,0,1,1
12200,Justin Anderson,22-342,G,10/26/16,DAL,@,IND,L,0,19,3,9,0.333,2,3,0.667,1,6,0.167,0,0,,1,4,5
12201,Justin Anderson,23-074,G,2/1/17,DAL,,PHI,W,0,5,3,4,0.75,2,2,1,1,2,0.5,0,0,,1,3,4
12202,Justin Anderson,23-100,G,2/27/17,PHI,,GSW,L,0,10,3,5,0.6,3,3,1,0,2,0,1,1,1,2,2,4
12203,Kyle Anderson,23-114,F-G,1/12/17,SAS,,LAL,W,0,16,2,3,0.667,1,2,0.5,1,1,1,2,2,1,0,2,2
12204,Kyle Anderson,23-086,F-G,12/15/16,SAS,@,PHO,W,0,16,1,1,1,1,1,1,0,0,,5,6,0.833,0,1,1
12205,Ryan Anderson,28-304,F,3/6/17,HOU,@,SAS,L,1,25,3,6,0.5,2,2,1,1,4,0.25,0,0,,1,1,2
12206,Ryan Anderson,28-228,F,12/20/16,HOU,,SAS,L,1,37,2,8,0.25,1,5,0.2,1,3,0.333,2,2,1,2,4,6
12207,Ryan Anderson,28-192,F,11/14/16,HOU,,PHI,W,1,30,3,11,0.273,2,5,0.4,1,6,0.167,0,0,,3,4,7
12208,Carmelo Anthony,32-216,F,12/31/16,NYK,@,HOU,L,1,19,3,11,0.273,3,9,0.333,0,2,0,1,2,0.5,1,0,1
12209,Trevor Ariza,31-215,F,1/31/17,HOU,,SAC,W,1,27,2,6,0.333,1,2,0.5,1,4,0.25,2,2,1,0,9,9
12210,Trevor Ariza,31-211,F,1/27/17,HOU,@,PHI,W,1,41,1,6,0.167,0,0,,1,6,0.167,4,4,1,0,5,5
12211,Trevor Ariza,31-165,F,12/12/16,HOU,,BRK,W,1,37,3,8,0.375,3,4,0.75,0,4,0,1,3,0.333,0,4,4
12212,Trevor Ariza,31-162,F,12/9/16,HOU,@,OKC,W,1,34,2,7,0.286,1,2,0.5,1,5,0.2,2,2,1,3,5,8
12213,Darrell Arthur,28-255,F,12/5/16,DEN,@,PHI,W,0,23,2,5,0.4,1,2,0.5,1,3,0.333,2,2,1,1,6,7
12214,Darrell Arthur,28-302,F,1/21/17,DEN,,LAC,W,0,13,3,5,0.6,2,2,1,1,3,0.333,0,0,,0,2,2
12215,Darrell Arthur,28-318,F,2/6/17,DEN,,DAL,W,0,22,3,8,0.375,2,3,0.667,1,5,0.2,0,0,,0,3,3
12216,Darrell Arthur,28-346,F,3/6/17,DEN,,SAC,W,0,17,2,8,0.25,1,5,0.2,1,3,0.333,2,2,1,0,4,4
12217,D.J. Augustin,29-021,G,12/1/16,ORL,@,MEM,L,1,19,2,6,0.333,0,3,0,2,3,0.667,1,2,0.5,0,1,1
12218,D.J. Augustin,29-105,G,2/23/17,ORL,,POR,L,0,26,2,7,0.286,1,6,0.167,1,1,1,2,2,1,0,0,0
12219,D.J. Augustin,29-019,G,11/29/16,ORL,@,SAS,W,1,25,2,6,0.333,1,3,0.333,1,3,0.333,2,2,1,1,3,4
12220,D.J. Augustin,29-048,G,12/28/16,ORL,,CHO,L,1,16,2,5,0.4,1,2,0.5,1,3,0.333,2,2,1,0,0,0
12221,D.J. Augustin,28-351,G,10/26/16,ORL,,MIA,L,0,17,2,3,0.667,2,2,1,0,1,0,3,3,1,0,1,1
12222,D.J. Augustin,29-118,G,3/8/17,ORL,,CHI,W,0,12,3,6,0.5,2,2,1,1,4,0.25,0,0,,0,0,0
12223,D.J. Augustin,29-062,G,1/11/17,ORL,@,LAC,L,0,27,2,9,0.222,2,6,0.333,0,3,0,3,3,1,1,1,2
12224,D.J. Augustin,28-361,G,11/5/16,ORL,,WAS,W,0,20,3,8,0.375,2,4,0.5,1,4,0.25,0,0,,0,0,0
12225,D.J. Augustin,29-040,G,12/20/16,ORL,@,MIA,W,1,26,2,9,0.222,1,5,0.2,1,4,0.25,2,3,0.667,0,1,1
12226,Luke Babbitt,27-197,F,1/3/17,MIA,@,PHO,L,1,23,3,11,0.273,2,7,0.286,1,4,0.25,0,2,0,0,5,5
12227,Luke Babbitt,27-195,F,1/1/17,MIA,,DET,L,1,17,3,5,0.6,2,4,0.5,1,1,1,0,0,,0,3,3
12228,Luke Babbitt,27-192,F,12/29/16,MIA,@,CHO,L,1,21,3,5,0.6,2,2,1,1,3,0.333,0,0,,0,3,3
12229,Ron Baker,23-347,G,3/12/17,NYK,@,BRK,L,0,17,2,3,0.667,2,2,1,0,1,0,3,4,0.75,0,2,2
12230,Wade Baldwin,20-211,G,10/26/16,MEM,,MIN,W,0,25,3,8,0.375,2,6,0.333,1,2,0.5,0,0,,2,3,5
12231,Wade Baldwin,20-249,G,12/3/16,MEM,,LAL,W,0,20,2,7,0.286,2,6,0.333,0,1,0,3,4,0.75,0,2,2
12232,Leandro Barbosa,34-104,G,3/12/17,PHO,,POR,L,0,18,3,6,0.5,3,5,0.6,0,1,0,1,1,1,0,0,0
12233,Leandro Barbosa,34-079,G,2/15/17,PHO,,LAL,W,0,10,3,4,0.75,3,4,0.75,0,0,,1,1,1,0,0,0
12234,Leandro Barbosa,33-337,G,10/30/16,PHO,,GSW,L,0,15,3,6,0.5,3,6,0.5,0,0,,1,2,0.5,1,2,3
12235,J.J. Barea,32-195,G,1/7/17,DAL,,ATL,L,0,17,3,8,0.375,2,4,0.5,1,4,0.25,0,0,,0,4,4
12236,Matt Barnes,36-263,F,11/27/16,SAC,@,BRK,W,0,19,3,5,0.6,2,2,1,1,3,0.333,0,0,,1,3,4
12237,Matt Barnes,36-284,F,12/18/16,SAC,@,DAL,L,0,25,3,7,0.429,2,3,0.667,1,4,0.25,0,0,,1,2,3
12238,Matt Barnes,37-011,F,3/20/17,GSW,@,OKC,W,0,19,2,4,0.5,2,2,1,0,2,0,3,4,0.75,0,1,1
12239,Matt Barnes,36-282,F,12/16/16,SAC,@,MEM,W,0,29,2,8,0.25,2,4,0.5,0,4,0,3,6,0.5,2,8,10
12240,Matt Barnes,37-009,F,3/18/17,GSW,,MIL,W,0,24,2,4,0.5,0,0,,2,4,0.5,1,2,0.5,0,9,9
12241,Matt Barnes,36-315,F,1/18/17,SAC,,IND,L,0,20,2,7,0.286,1,3,0.333,1,4,0.25,2,2,1,2,2,4
12242,Matt Barnes,36-312,F,1/15/17,SAC,,OKC,L,0,27,3,6,0.5,2,4,0.5,1,2,0.5,0,0,,4,4,8
12243,Matt Barnes,36-246,F,11/10/16,SAC,,LAL,L,0,29,3,8,0.375,2,4,0.5,1,4,0.25,0,0,,2,3,5
12244,Will Barton,25-365,G,1/5/17,DEN,,SAS,L,0,15,2,6,0.333,2,5,0.4,0,1,0,3,3,1,0,1,1
12245,Will Barton,25-319,G,11/20/16,DEN,,UTA,W,1,19,3,9,0.333,2,6,0.333,1,3,0.333,0,1,0,1,2,3
12246,Will Barton,26-063,G,3/10/17,DEN,,BOS,W,0,20,3,7,0.429,2,4,0.5,1,3,0.333,0,0,,0,3,3
12247,Brandon Bass,31-268,F,1/23/17,LAC,@,ATL,W,0,15,1,2,0.5,1,2,0.5,0,0,,5,5,1,1,3,4
12248,Brandon Bass,31-322,F,3/18/17,LAC,,CLE,W,0,7,3,3,1,3,3,1,0,0,,1,1,1,0,2,2
12249,Brandon Bass,31-242,F,12/28/16,LAC,@,NOP,L,0,13,3,6,0.5,3,6,0.5,0,0,,1,1,1,1,3,4
12250,Brandon Bass,31-278,F,2/2/17,LAC,,GSW,L,0,16,3,5,0.6,3,5,0.6,0,0,,1,1,1,0,2,2
12251,Nicolas Batum,28-003,F-G,12/17/16,CHO,@,ATL,W,1,32,3,13,0.231,3,11,0.273,0,2,0,1,2,0.5,0,3,3
12252,Aron Baynes,29-326,C,10/30/16,DET,,MIL,W,0,11,2,4,0.5,2,4,0.5,0,0,,3,4,0.75,2,5,7
12253,Aron Baynes,30-085,C,3/4/17,DET,@,PHI,W,0,9,2,2,1,2,2,1,0,0,,3,4,0.75,1,1,2
12254,Aron Baynes,29-353,C,11/26/16,DET,@,OKC,L,0,12,1,2,0.5,1,2,0.5,0,0,,5,6,0.833,2,2,4
12255,Kent Bazemore,27-118,G-F,10/27/16,ATL,,WAS,W,1,26,1,7,0.143,0,3,0,1,4,0.25,4,4,1,0,3,3
12256,Kent Bazemore,27-168,G-F,12/16/16,ATL,@,TOR,W,0,22,3,6,0.5,2,4,0.5,1,2,0.5,0,2,0,2,3,5
12257,Kent Bazemore,27-216,G-F,2/2/17,ATL,@,HOU,W,1,31,3,7,0.429,2,4,0.5,1,3,0.333,0,0,,0,3,3
12258,Kent Bazemore,27-252,G-F,3/10/17,ATL,,TOR,W,1,28,3,8,0.375,2,4,0.5,1,4,0.25,0,2,0,1,6,7
12259,Kent Bazemore,27-250,G-F,3/8/17,ATL,,BRK,W,1,23,3,13,0.231,2,11,0.182,1,2,0.5,0,2,0,2,3,5
12260,Kent Bazemore,27-154,G-F,12/2/16,ATL,,DET,L,1,18,3,11,0.273,2,8,0.25,1,3,0.333,0,0,,1,1,2
12261,Malik Beasley,20-067,G,2/1/17,DEN,,MEM,L,0,6,2,2,1,1,1,1,1,1,1,2,2,1,0,0,0
12262,Michael Beasley,27-354,F,12/28/16,MIL,@,DET,W,0,22,3,8,0.375,3,8,0.375,0,0,,1,2,0.5,0,3,3
12263,Michael Beasley,27-302,F,11/6/16,MIL,@,DAL,L,0,10,3,4,0.75,2,3,0.667,1,1,1,0,0,,0,3,3
12264,Michael Beasley,28-033,F,2/11/17,MIL,@,IND,W,1,26,3,8,0.375,2,7,0.286,1,1,1,0,0,,3,3,6
12265,Michael Beasley,27-361,F,1/4/17,MIL,@,NYK,W,0,10,2,3,0.667,1,2,0.5,1,1,1,2,2,1,0,0,0
12266,Michael Beasley,27-295,F,10/30/16,MIL,@,DET,L,0,16,3,5,0.6,3,3,1,0,2,0,1,2,0.5,0,1,1
12267,Michael Beasley,28-007,F,1/16/17,MIL,,PHI,L,0,26,2,5,0.4,2,5,0.4,0,0,,3,4,0.75,2,4,6
12268,Marco Belinelli,30-285,G-F,1/4/17,CHO,,OKC,W,0,15,1,4,0.25,1,3,0.333,0,1,0,5,6,0.833,0,2,2
12269,Marco Belinelli,30-259,G-F,12/9/16,CHO,,ORL,W,0,21,3,6,0.5,3,5,0.6,0,1,0,1,1,1,0,3,3
12270,Marco Belinelli,30-353,G-F,3/13/17,CHO,,CHI,L,0,22,2,7,0.286,2,5,0.4,0,2,0,3,3,1,1,2,3
12271,Marco Belinelli,30-297,G-F,1/16/17,CHO,@,BOS,L,0,18,3,7,0.429,2,3,0.667,1,4,0.25,0,0,,0,1,1
12272,Marco Belinelli,30-309,G-F,1/28/17,CHO,,SAC,L,0,28,3,10,0.3,2,3,0.667,1,7,0.143,0,0,,0,1,1
12273,Marco Belinelli,30-215,G-F,10/26/16,CHO,@,MIL,W,0,26,3,8,0.375,3,6,0.5,0,2,0,1,1,1,0,4,4
12274,Marco Belinelli,30-342,G-F,3/2/17,CHO,@,PHO,L,0,24,2,7,0.286,2,4,0.5,0,3,0,3,3,1,0,0,0
12275,DeAndre' Bembry,22-175,F,12/26/16,ATL,@,MIN,L,0,17,3,4,0.75,3,4,0.75,0,0,,1,3,0.333,0,3,3
12276,Dragan Bender,19-044,F,12/31/16,PHO,@,UTA,L,0,21,2,4,0.5,0,0,,2,4,0.5,1,3,0.333,0,1,1
12277,Anthony Bennett,23-245,F,11/14/16,BRK,@,LAC,L,0,26,2,8,0.25,1,3,0.333,1,5,0.2,2,2,1,1,8,9
12278,Anthony Bennett,23-264,F,12/3/16,BRK,@,MIL,L,1,23,3,6,0.5,3,3,1,0,3,0,1,2,0.5,4,10,14
12279,Anthony Bennett,23-231,F,10/31/16,BRK,,CHI,L,0,12,2,7,0.286,1,2,0.5,1,5,0.2,2,2,1,0,1,1
12280,Davis Bertans,24-084,F,2/4/17,SAS,,DEN,W,0,19,3,4,0.75,2,3,0.667,1,1,1,0,0,,1,2,3
12281,Davis Bertans,24-004,F,11/16/16,SAS,@,SAC,W,0,17,2,5,0.4,0,0,,2,5,0.4,1,2,0.5,1,1,2
12282,Davis Bertans,24-018,F,11/30/16,SAS,@,DAL,W,0,15,2,2,1,1,1,1,1,1,1,2,2,1,0,0,0
12283,Patrick Beverley,28-201,G,1/29/17,HOU,@,IND,L,1,33,2,8,0.25,1,4,0.25,1,4,0.25,2,2,1,1,3,4
12284,Patrick Beverley,28-136,G,11/25/16,HOU,@,SAC,W,1,31,2,5,0.4,0,1,0,2,4,0.5,1,2,0.5,3,4,7
12285,Patrick Beverley,28-199,G,1/27/17,HOU,@,PHI,W,1,33,2,5,0.4,1,2,0.5,1,3,0.333,2,2,1,0,3,3
12286,Patrick Beverley,28-218,G,2/15/17,HOU,,MIA,L,1,13,2,5,0.4,2,5,0.4,0,0,,3,4,0.75,0,0,0
12287,Patrick Beverley,28-193,G,1/21/17,HOU,@,MEM,W,1,30,3,10,0.3,2,5,0.4,1,5,0.2,0,0,,0,7,7
12288,Patrick Beverley,28-248,G,3/17/17,HOU,@,NOP,L,1,31,2,9,0.222,1,5,0.2,1,4,0.25,2,2,1,2,5,7
12289,Bismack Biyombo,24-107,C-F,12/13/16,ORL,@,ATL,W,1,33,3,4,0.75,3,4,0.75,0,0,,1,2,0.5,1,8,9
12290,Bismack Biyombo,24-194,C-F,3/10/17,ORL,@,CHO,L,1,29,3,3,1,3,3,1,0,0,,1,8,0.125,2,8,10
12291,Bismack Biyombo,24-204,C-F,3/20/17,ORL,,PHI,W,0,16,3,5,0.6,3,5,0.6,0,0,,1,1,1,2,4,6
12292,Nemanja Bjelica,28-266,F,1/30/17,MIN,,ORL,W,0,24,3,4,0.75,3,4,0.75,0,0,,1,2,0.5,1,3,4
12293,Nemanja Bjelica,28-239,F,1/3/17,MIN,@,PHI,L,0,23,2,6,0.333,1,2,0.5,1,4,0.25,2,2,1,0,3,3
12294,Nemanja Bjelica,28-271,F,2/4/17,MIN,,MEM,L,0,14,3,4,0.75,2,3,0.667,1,1,1,0,0,,0,4,4
12295,Nemanja Bjelica,28-282,F,2/15/17,MIN,@,DEN,W,0,29,3,5,0.6,2,4,0.5,1,1,1,0,0,,2,3,5
12296,Tarik Black,25-084,C-F,2/14/17,LAL,,SAC,L,1,21,3,5,0.6,2,4,0.5,1,1,1,0,0,,2,1,3
12297,Tarik Black,25-047,C-F,1/8/17,LAL,,ORL,W,0,12,3,5,0.6,3,5,0.6,0,0,,1,1,1,0,3,3
12298,Tarik Black,25-080,C-F,2/10/17,LAL,@,MIL,W,1,20,3,5,0.6,3,5,0.6,0,0,,1,2,0.5,1,3,4
12299,Tarik Black,25-005,C-F,11/27/16,LAL,,ATL,W,0,28,3,7,0.429,3,7,0.429,0,0,,1,1,1,2,6,8
12300,Tarik Black,24-354,C-F,11/10/16,LAL,@,SAC,W,0,11,3,4,0.75,3,4,0.75,0,0,,1,2,0.5,1,3,4
12301,Tarik Black,24-354,C-F,11/10/16,LAL,@,SAC,W,0,11,3,4,0.75,3,4,0.75,0,0,,1,2,0.5,1,3,4
12302,Bojan Bogdanovic,27-208,G-F,11/12/16,BRK,@,PHO,W,1,31,2,6,0.333,1,2,0.5,1,4,0.25,2,3,0.667,0,5,5
12303,Bojan Bogdanovic,27-238,G-F,12/12/16,BRK,@,HOU,L,1,22,3,8,0.375,2,5,0.4,1,3,0.333,0,1,0,0,1,1
12304,Devin Booker,20-000,G,10/30/16,PHO,,GSW,L,1,28,3,12,0.25,2,8,0.25,1,4,0.25,0,0,,0,0,0
12305,Trevor Booker,29-061,F,1/25/17,BRK,,MIA,L,1,24,2,4,0.5,2,4,0.5,0,0,,3,4,0.75,2,4,6
12306,Corey Brewer,30-263,F-G,11/23/16,HOU,,TOR,L,0,10,3,5,0.6,2,2,1,1,3,0.333,0,0,,0,3,3
12307,Corey Brewer,30-261,F-G,11/21/16,HOU,@,DET,W,0,13,2,3,0.667,1,1,1,1,2,0.5,2,4,0.5,0,1,1
12308,Corey Brewer,31-008,F-G,3/13/17,LAL,@,DEN,L,0,17,3,8,0.375,3,8,0.375,0,0,,1,2,0.5,2,2,4
12309,Corey Brewer,30-301,F-G,12/31/16,HOU,,NYK,W,1,29,3,6,0.5,2,3,0.667,1,3,0.333,0,0,,1,3,4
12310,Corey Brewer,30-326,F-G,1/25/17,HOU,@,BOS,L,0,24,3,4,0.75,3,4,0.75,0,0,,1,2,0.5,0,2,2
12311,Malcolm Brogdon,24-005,G,12/16/16,MIL,@,CHI,W,0,27,3,8,0.375,2,4,0.5,1,4,0.25,0,0,,0,2,2
12312,Malcolm Brogdon,24-038,G,1/18/17,MIL,@,HOU,L,1,35,3,12,0.25,2,8,0.25,1,4,0.25,0,0,,6,3,9
12313,Malcolm Brogdon,24-054,G,2/3/17,MIL,@,DEN,L,0,24,3,7,0.429,3,5,0.6,0,2,0,1,1,1,0,1,1
12314,Malcolm Brogdon,23-331,G,11/6/16,MIL,@,DAL,L,0,20,2,7,0.286,2,5,0.4,0,2,0,3,4,0.75,0,1,1
12315,Malcolm Brogdon,24-064,G,2/13/17,MIL,,DET,W,0,21,2,6,0.333,2,6,0.333,0,0,,3,3,1,1,0,1
12316,Aaron Brooks,31-305,G,11/14/16,IND,,ORL,W,0,17,2,9,0.222,1,6,0.167,1,3,0.333,2,2,1,0,0,0
12317,Anthony Brown,24-050,F-G,11/29/16,NOP,,LAL,W,0,22,3,5,0.6,2,3,0.667,1,2,0.5,0,0,,2,4,6
12318,Anthony Brown,24-109,F-G,1/27/17,ORL,@,BOS,L,0,12,3,7,0.429,2,4,0.5,1,3,0.333,0,0,,0,4,4
12319,Bobby Brown,32-118,G,1/20/17,HOU,,GSW,L,0,3,3,4,0.75,2,2,1,1,2,0.5,0,0,,0,0,0
12320,Jaylen Brown,20-046,F,12/9/16,BOS,,TOR,L,0,22,3,6,0.5,2,5,0.4,1,1,1,0,0,,0,3,3
12321,Jaylen Brown,20-042,F,12/5/16,BOS,@,HOU,L,0,19,3,6,0.5,2,4,0.5,1,2,0.5,0,0,,0,1,1
12322,Jaylen Brown,20-005,F,10/29/16,BOS,@,CHO,W,0,13,3,6,0.5,3,6,0.5,0,0,,1,1,1,1,0,1
12323,Jaylen Brown,20-051,F,12/14/16,BOS,@,SAS,L,0,11,2,3,0.667,2,3,0.667,0,0,,3,4,0.75,1,1,2
12324,Reggie Bullock,25-303,G-F,1/13/17,DET,@,UTA,L,0,26,3,6,0.5,3,5,0.6,0,1,0,1,1,1,0,2,2
12325,Reggie Bullock,25-313,G-F,1/23/17,DET,,SAC,L,0,11,3,6,0.5,2,2,1,1,4,0.25,0,0,,0,4,4
12326,Trey Burke,24-070,G,1/21/17,WAS,@,DET,L,0,9,3,5,0.6,2,4,0.5,1,1,1,0,0,,1,1,2
12327,Trey Burke,24-036,G,12/18/16,WAS,,LAC,W,0,17,2,3,0.667,0,1,0,2,2,1,1,2,0.5,0,0,0
12328,Trey Burke,24-090,G,2/10/17,WAS,,IND,W,0,14,3,9,0.333,2,7,0.286,1,2,0.5,0,0,,0,0,0
12329,Trey Burke,24-088,G,2/8/17,WAS,@,BRK,W,0,14,3,6,0.5,2,4,0.5,1,2,0.5,0,0,,0,0,0
12330,Alec Burks,25-184,G,1/20/17,UTA,@,DAL,W,0,12,1,3,0.333,0,0,,1,3,0.333,4,6,0.667,0,2,2
12331,Alec Burks,25-201,G,2/6/17,UTA,@,ATL,W,0,21,3,5,0.6,2,2,1,1,3,0.333,0,0,,0,1,1
12332,Alec Burks,25-208,G,2/13/17,UTA,,LAC,L,0,22,3,8,0.375,2,6,0.333,1,2,0.5,0,0,,0,2,2
12333,Alec Burks,25-228,G,3/5/17,UTA,@,SAC,W,0,15,3,6,0.5,3,4,0.75,0,2,0,1,1,1,1,2,3
12334,Jimmy Butler,27-093,G-F,12/16/16,CHI,,MIL,L,1,30,3,14,0.214,2,9,0.222,1,5,0.2,0,0,,2,5,7
12335,Jose Calderon,35-063,G,11/30/16,LAL,@,CHI,W,1,17,3,4,0.75,3,4,0.75,0,0,,1,1,1,0,0,0
12336,Jose Calderon,35-114,G,1/20/17,LAL,,IND,W,0,19,3,7,0.429,2,3,0.667,1,4,0.25,0,0,,1,0,1
12337,Jose Calderon,35-058,G,11/25/16,LAL,,GSW,L,1,28,3,6,0.5,2,3,0.667,1,3,0.333,0,0,,1,0,1
12338,Jose Calderon,35-056,G,11/23/16,LAL,@,GSW,L,1,20,3,7,0.429,2,4,0.5,1,3,0.333,0,0,,2,2,4
12339,Kentavious Caldwell-Pope,23-322,G,1/5/17,DET,,CHO,W,1,33,3,12,0.25,2,8,0.25,1,4,0.25,0,0,,0,2,2
12340,Kentavious Caldwell-Pope,23-361,G,2/13/17,DET,@,MIL,L,1,33,2,10,0.2,1,6,0.167,1,4,0.25,2,2,1,1,2,3
12341,Kentavious Caldwell-Pope,23-293,G,12/7/16,DET,@,CHO,L,1,37,3,9,0.333,2,5,0.4,1,4,0.25,0,0,,1,3,4
12342,DeMarre Carroll,30-219,F,3/3/17,TOR,@,WAS,W,1,26,3,7,0.429,2,2,1,1,5,0.2,0,0,,1,4,5
12343,DeMarre Carroll,30-098,F,11/2/16,TOR,@,WAS,W,1,22,2,7,0.286,1,2,0.5,1,5,0.2,2,4,0.5,0,1,1
12344,DeMarre Carroll,30-186,F,1/29/17,TOR,,ORL,L,1,17,3,8,0.375,3,3,1,0,5,0,1,2,0.5,0,2,2
12345,DeMarre Carroll,30-184,F,1/27/17,TOR,,MIL,W,1,32,2,9,0.222,1,3,0.333,1,6,0.167,2,3,0.667,0,3,3
12346,Vince Carter,39-365,G-F,1/25/17,MEM,,TOR,W,0,30,2,4,0.5,2,3,0.667,0,1,0,3,4,0.75,0,3,3
12347,Vince Carter,39-304,G-F,11/25/16,MEM,,MIA,L,0,16,2,7,0.286,1,3,0.333,1,4,0.25,2,2,1,1,4,5
12348,Vince Carter,40-011,G-F,2/6/17,MEM,,SAS,W,0,24,3,9,0.333,2,4,0.5,1,5,0.2,0,1,0,1,5,6
12349,Vince Carter,39-302,G-F,11/23/16,MEM,@,PHI,W,0,39,3,11,0.273,2,5,0.4,1,6,0.167,0,1,0,0,2,2
12350,Vince Carter,40-008,G-F,2/3/17,MEM,@,OKC,L,0,19,3,6,0.5,2,2,1,1,4,0.25,0,0,,0,0,0
12351,Vince Carter,40-048,G-F,3/15/17,MEM,@,CHI,W,1,29,3,7,0.429,2,3,0.667,1,4,0.25,0,0,,1,2,3
12352,Michael Carter-Williams,25-162,G,3/21/17,CHI,@,TOR,L,0,13,2,6,0.333,1,4,0.25,1,2,0.5,2,2,1,0,0,0
12353,Michael Carter-Williams,25-019,G,10/29/16,CHI,,IND,W,0,23,2,8,0.25,2,7,0.286,0,1,0,3,4,0.75,0,1,1
12354,Michael Carter-Williams,25-158,G,3/17/17,CHI,@,WAS,L,0,15,2,4,0.5,1,3,0.333,1,1,1,2,4,0.5,0,1,1
12355,Michael Carter-Williams,25-156,G,3/15/17,CHI,,MEM,L,0,13,3,8,0.375,2,7,0.286,1,1,1,0,0,,1,1,2
12356,Omri Casspi,28-156,F,11/25/16,SAC,,HOU,L,0,28,3,7,0.429,3,5,0.6,0,2,0,1,2,0.5,0,4,4
12357,Omri Casspi,28-163,F,12/2/16,SAC,@,BOS,L,0,27,2,9,0.222,1,7,0.143,1,2,0.5,2,3,0.667,3,2,5
12358,Tyson Chandler,34-124,C,2/3/17,PHO,@,SAC,W,1,32,1,1,1,1,1,1,0,0,,5,5,1,0,12,12
12359,Tyson Chandler,34-088,C,12/29/16,PHO,,TOR,W,1,27,3,4,0.75,3,4,0.75,0,0,,1,3,0.333,4,9,13
12360,Marquese Chriss,19-224,F,2/11/17,PHO,@,HOU,L,1,32,3,11,0.273,3,7,0.429,0,4,0,1,1,1,2,4,6
12361,Marquese Chriss,19-142,F,11/21/16,PHO,@,WAS,L,1,16,3,8,0.375,2,6,0.333,1,2,0.5,0,0,,2,1,3
12362,Marquese Chriss,19-160,F,12/9/16,PHO,@,LAL,W,1,8,3,5,0.6,2,2,1,1,3,0.333,0,0,,0,1,1
12363,Marquese Chriss,19-244,F,3/3/17,PHO,,OKC,W,1,26,3,8,0.375,2,4,0.5,1,4,0.25,0,0,,0,2,2
12364,Marquese Chriss,19-172,F,12/21/16,PHO,,HOU,L,1,16,3,7,0.429,2,3,0.667,1,4,0.25,0,0,,1,2,3
12365,Marquese Chriss,19-139,F,11/18/16,PHO,@,IND,W,1,16,3,7,0.429,3,6,0.5,0,1,0,1,2,0.5,0,1,1
12366,Marquese Chriss,19-120,F,10/30/16,PHO,,GSW,L,0,14,3,6,0.5,2,5,0.4,1,1,1,0,0,,1,3,4
12367,Marquese Chriss,19-151,F,11/30/16,PHO,,ATL,W,1,13,2,4,0.5,1,1,1,1,3,0.333,2,2,1,0,2,2
12368,Marquese Chriss,19-118,F,10/28/16,PHO,@,OKC,L,0,11,3,5,0.6,3,3,1,0,2,0,1,2,0.5,1,3,4
12369,Marquese Chriss,19-116,F,10/26/16,PHO,,SAC,L,0,22,3,7,0.429,3,7,0.429,0,0,,1,2,0.5,2,2,4
12370,Marquese Chriss,19-226,F,2/13/17,PHO,,NOP,L,1,16,3,9,0.333,3,6,0.5,0,3,0,1,2,0.5,2,1,3
12371,Marquese Chriss,19-129,F,11/8/16,PHO,@,POR,L,1,20,3,7,0.429,3,6,0.5,0,1,0,1,2,0.5,2,2,4
12372,Rakeem Christmas,25-101,F,3/12/17,IND,,MIA,W,0,18,3,5,0.6,3,5,0.6,0,0,,1,2,0.5,3,2,5
12373,Semaj Christon,24-046,G,12/17/16,OKC,,PHO,W,0,22,3,7,0.429,3,5,0.6,0,2,0,1,1,1,0,5,5
12374,Semaj Christon,24-043,G,12/14/16,OKC,@,UTA,L,0,23,3,9,0.333,2,6,0.333,1,3,0.333,0,0,,1,2,3
12375,Ian Clark,25-298,G,12/30/16,GSW,,DAL,W,0,24,3,8,0.375,3,5,0.6,0,3,0,1,2,0.5,1,1,2
12376,Ian Clark,25-275,G,12/7/16,GSW,@,LAC,W,0,13,3,7,0.429,3,5,0.6,0,2,0,1,1,1,0,3,3
12377,Ian Clark,25-321,G,1/22/17,GSW,@,ORL,W,0,14,3,8,0.375,2,4,0.5,1,4,0.25,0,0,,1,2,3
12378,Jordan Clarkson,24-156,G,11/10/16,LAL,@,SAC,W,0,22,3,7,0.429,2,4,0.5,1,3,0.333,0,0,,0,3,3
12379,Jordan Clarkson,24-183,G,12/7/16,LAL,@,HOU,L,1,35,3,13,0.231,2,8,0.25,1,5,0.2,0,0,,0,2,2
12380,Norris Cole,28-140,G,3/2/17,OKC,@,POR,L,0,11,2,5,0.4,1,4,0.25,1,1,1,2,2,1,0,1,1
12381,Darren Collison,29-113,G,12/14/16,SAC,@,HOU,L,1,29,2,10,0.2,2,8,0.25,0,2,0,3,3,1,0,4,4
12382,Nick Collison,36-052,F,12/17/16,OKC,,PHO,W,0,6,3,3,1,3,3,1,0,0,,1,2,0.5,1,1,2
12383,Pat Connaughton,23-322,G,11/23/16,POR,@,CLE,L,0,4,3,3,1,2,2,1,1,1,1,0,0,,0,1,1
12384,Robert Covington,25-336,F,11/14/16,PHI,@,HOU,L,1,14,1,7,0.143,0,1,0,1,6,0.167,4,4,1,0,1,1
12385,Robert Covington,26-090,F,3/14/17,PHI,@,GSW,L,1,32,1,8,0.125,0,4,0,1,4,0.25,4,4,1,2,7,9
12386,Robert Covington,25-360,F,12/8/16,PHI,@,NOP,W,1,31,3,9,0.333,2,4,0.5,1,5,0.2,0,0,,2,5,7
12387,Robert Covington,26-031,F,1/14/17,PHI,@,WAS,L,1,22,2,6,0.333,1,2,0.5,1,4,0.25,2,2,1,0,4,4
12388,Allen Crabbe,24-279,G-F,1/13/17,POR,,ORL,L,1,33,3,10,0.3,2,5,0.4,1,5,0.2,0,0,,0,3,3
12389,Allen Crabbe,24-261,G-F,12/26/16,POR,,TOR,L,1,35,3,11,0.273,3,8,0.375,0,3,0,1,2,0.5,0,5,5
12390,Allen Crabbe,24-337,G-F,3/12/17,POR,@,PHO,W,0,34,3,8,0.375,2,4,0.5,1,4,0.25,0,0,,0,5,5
12391,Allen Crabbe,24-243,G-F,12/8/16,POR,@,MEM,L,0,31,2,9,0.222,1,5,0.2,1,4,0.25,2,3,0.667,0,5,5
12392,Allen Crabbe,24-227,G-F,11/22/16,POR,@,NYK,L,0,23,1,7,0.143,0,4,0,1,3,0.333,4,5,0.8,1,2,3
12393,Jamal Crawford,36-243,G,11/18/16,LAC,@,SAC,W,0,26,2,8,0.25,0,4,0,2,4,0.5,1,1,1,0,2,2
12394,Jamal Crawford,36-305,G,1/19/17,LAC,,MIN,L,0,25,3,14,0.214,3,10,0.3,0,4,0,1,2,0.5,3,5,8
12395,Jamal Crawford,36-283,G,12/28/16,LAC,@,NOP,L,0,29,3,15,0.2,3,12,0.25,0,3,0,1,1,1,0,0,0
12396,Jamal Crawford,36-353,G,3/8/17,LAC,@,MIN,L,0,24,2,9,0.222,2,6,0.333,0,3,0,3,3,1,1,0,1
12397,Jamal Crawford,36-244,G,11/19/16,LAC,,CHI,W,0,27,3,9,0.333,2,4,0.5,1,5,0.2,0,0,,0,1,1
12398,Jordan Crawford,28-145,G,3/17/17,NOP,,HOU,W,0,19,3,10,0.3,2,6,0.333,1,4,0.25,0,1,0,1,4,5
12399,Jae Crowder,26-252,F,3/15/17,BOS,,MIN,W,1,28,1,8,0.125,0,3,0,1,5,0.2,4,4,1,2,2,4
12400,Jae Crowder,26-225,F,2/16/17,BOS,@,CHI,L,1,33,3,8,0.375,3,4,0.75,0,4,0,1,2,0.5,2,1,3
12401,Jae Crowder,26-252,F,3/15/17,BOS,,MIN,W,1,28,1,8,0.125,0,3,0,1,5,0.2,4,4,1,2,2,4
12402,Dante Cunningham,29-208,F,11/16/16,NOP,@,ORL,L,1,33,3,9,0.333,2,7,0.286,1,2,0.5,0,0,,3,6,9
12403,Dante Cunningham,29-278,F,1/25/17,NOP,,OKC,L,0,25,3,5,0.6,2,3,0.667,1,2,0.5,0,0,,1,5,6
12404,Dante Cunningham,29-200,F,11/8/16,NOP,@,SAC,L,0,23,3,5,0.6,2,3,0.667,1,2,0.5,0,1,0,0,4,4
12405,Dante Cunningham,29-329,F,3/17/17,NOP,,HOU,W,1,39,3,5,0.6,3,3,1,0,2,0,1,2,0.5,3,6,9
12406,Dante Cunningham,29-267,F,1/14/17,NOP,@,CHI,L,0,19,3,7,0.429,2,3,0.667,1,4,0.25,0,0,,1,4,5
12407,Seth Curry,26-145,G,1/15/17,DAL,,MIN,W,1,32,2,9,0.222,1,5,0.2,1,4,0.25,2,2,1,1,2,3
12408,Seth Curry,26-109,G,12/10/16,DAL,@,HOU,L,0,26,3,5,0.6,2,3,0.667,1,2,0.5,0,0,,0,3,3
12409,Seth Curry,26-064,G,10/26/16,DAL,@,IND,L,0,16,3,4,0.75,2,2,1,1,2,0.5,0,0,,0,3,3
12410,Seth Curry,26-206,G,3/17/17,DAL,@,PHI,L,1,17,2,4,0.5,1,2,0.5,1,2,0.5,2,2,1,0,1,1
12411,Seth Curry,26-075,G,11/6/16,DAL,,MIL,W,0,25,3,7,0.429,2,3,0.667,1,4,0.25,0,0,,0,0,0
12412,Seth Curry,26-092,G,11/23/16,DAL,,LAC,L,1,29,3,7,0.429,3,5,0.6,0,2,0,1,1,1,0,1,1
12413,Seth Curry,26-113,G,12/14/16,DAL,,DET,L,0,23,3,8,0.375,2,7,0.286,1,1,1,0,0,,0,0,0
12414,Seth Curry,26-128,G,12/29/16,DAL,@,LAL,W,0,25,3,6,0.5,2,5,0.4,1,1,1,0,0,,0,1,1
12415,Troy Daniels,25-232,G,3/4/17,MEM,@,HOU,L,0,11,3,6,0.5,2,2,1,1,4,0.25,0,0,,0,0,0
12416,Anthony Davis,23-362,F-C,3/8/17,NOP,,TOR,L,1,17,2,4,0.5,2,4,0.5,0,0,,3,5,0.6,0,4,4
12417,Ed Davis,27-175,F,11/27/16,POR,,HOU,L,1,22,3,3,1,3,3,1,0,0,,1,2,0.5,1,2,3
12418,Ed Davis,27-190,F,12/12/16,POR,@,LAC,L,0,14,0,1,0,0,1,0,0,0,,7,8,0.875,2,3,5
12419,Ed Davis,27-255,F,2/15/17,POR,@,UTA,L,1,19,3,5,0.6,3,5,0.6,0,0,,1,2,0.5,3,2,5
12420,Dewayne Dedmon,27-160,C,1/19/17,SAS,,DEN,W,0,19,3,5,0.6,3,5,0.6,0,0,,1,1,1,0,4,4
12421,Dewayne Dedmon,27-176,C,2/4/17,SAS,,DEN,W,1,14,3,3,1,3,3,1,0,0,,1,2,0.5,2,1,3
12422,Dewayne Dedmon,27-165,C,1/24/17,SAS,@,TOR,W,0,19,2,3,0.667,2,3,0.667,0,0,,3,4,0.75,2,2,4
12423,Sam Dekker,22-245,F,1/6/17,HOU,@,ORL,W,0,18,3,5,0.6,2,3,0.667,1,2,0.5,0,0,,4,4,8
12424,Sam Dekker,22-302,F,3/4/17,HOU,,MEM,W,0,18,3,4,0.75,2,3,0.667,1,1,1,0,0,,1,2,3
12425,Sam Dekker,22-217,F,12/9/16,HOU,@,OKC,W,0,15,3,5,0.6,3,3,1,0,2,0,1,4,0.25,0,1,1
12426,Malcolm Delaney,27-287,G,12/23/16,ATL,@,DEN,W,0,30,3,8,0.375,2,5,0.4,1,3,0.333,0,0,,1,1,2
12427,Malcolm Delaney,27-254,G,11/20/16,ATL,@,NYK,L,0,21,1,4,0.25,1,3,0.333,0,1,0,5,5,1,0,4,4
12428,Malcolm Delaney,27-300,G,1/5/17,ATL,@,NOP,W,0,20,2,6,0.333,2,4,0.5,0,2,0,3,3,1,0,3,3
12429,Malcolm Delaney,27-341,G,2/15/17,ATL,@,LAC,L,0,17,2,4,0.5,2,4,0.5,0,0,,3,3,1,0,1,1
12430,Matthew Dellavedova,26-074,G,11/21/16,MIL,,ORL,W,1,27,3,7,0.429,2,2,1,1,5,0.2,0,0,,0,1,1
12431,Matthew Dellavedova,26-063,G,11/10/16,MIL,,NOP,L,1,29,2,7,0.286,2,5,0.4,0,2,0,3,5,0.6,1,4,5
12432,Luol Deng,31-296,F,2/6/17,LAL,@,NYK,W,0,24,1,6,0.167,1,2,0.5,0,4,0,5,5,1,0,3,3
12433,Luol Deng,31-193,F,10/26/16,LAL,,HOU,W,1,28,3,9,0.333,2,5,0.4,1,4,0.25,0,0,,2,3,5
12434,Luol Deng,31-290,F,1/31/17,LAL,,DEN,W,1,31,3,9,0.333,2,6,0.333,1,3,0.333,0,0,,0,4,4
12435,Luol Deng,31-204,F,11/6/16,LAL,,PHO,W,1,21,2,5,0.4,0,1,0,2,4,0.5,1,2,0.5,0,7,7
12436,Luol Deng,31-244,F,12/16/16,LAL,@,PHI,W,1,32,3,8,0.375,2,3,0.667,1,5,0.2,0,0,,1,5,6
12437,Boris Diaw,34-226,F-C,11/28/16,UTA,@,MIN,W,1,29,3,3,1,2,2,1,1,1,1,0,0,,1,1,2
12438,Boris Diaw,34-238,F-C,12/10/16,UTA,,SAC,W,1,17,3,4,0.75,2,3,0.667,1,1,1,0,0,,0,1,1
12439,Boris Diaw,34-333,F-C,3/15/17,UTA,@,DET,W,0,19,3,8,0.375,2,6,0.333,1,2,0.5,0,0,,1,1,2
12440,Gorgui Dieng,27-028,C,2/15/17,MIN,@,DEN,W,1,28,3,9,0.333,2,7,0.286,1,2,0.5,0,0,,1,4,5
12441,Gorgui Dieng,27-052,C,3/11/17,MIN,@,MIL,L,1,24,2,4,0.5,2,4,0.5,0,0,,3,3,1,2,4,6
12442,Gorgui Dieng,27-049,C,3/8/17,MIN,,LAC,W,1,39,3,6,0.5,3,6,0.5,0,0,,1,2,0.5,3,6,9
12443,Gorgui Dieng,27-042,C,3/1/17,MIN,@,UTA,W,1,23,2,6,0.333,2,6,0.333,0,0,,3,4,0.75,0,6,6
12444,Gorgui Dieng,26-320,C,12/3/16,MIN,@,CHO,W,1,31,3,11,0.273,2,9,0.222,1,2,0.5,0,0,,2,6,8
12445,Spencer Dinwiddie,23-307,G,2/7/17,BRK,@,CHO,L,1,23,2,5,0.4,1,2,0.5,1,3,0.333,2,2,1,0,0,0
12446,Spencer Dinwiddie,23-275,G,1/6/17,BRK,,CLE,L,1,18,2,3,0.667,2,3,0.667,0,0,,3,3,1,0,5,5
12447,Spencer Dinwiddie,23-305,G,2/5/17,BRK,,TOR,L,0,21,1,2,0.5,0,1,0,1,1,1,4,4,1,0,0,0
12448,Spencer Dinwiddie,23-271,G,1/2/17,BRK,,UTA,L,0,13,3,6,0.5,3,4,0.75,0,2,0,1,3,0.333,0,1,1
12449,Toney Douglas,30-325,G,2/4/17,MEM,@,MIN,W,0,22,2,4,0.5,2,3,0.667,0,1,0,3,4,0.75,0,7,7
12450,Jared Dudley,31-244,F-G,3/11/17,PHO,@,DAL,W,0,22,2,5,0.4,0,0,,2,5,0.4,1,2,0.5,0,1,1
12451,Jared Dudley,31-132,F-G,11/19/16,PHO,@,PHI,L,0,23,3,7,0.429,2,3,0.667,1,4,0.25,0,0,,2,1,3
12452,Jared Dudley,31-236,F-G,3/3/17,PHO,,OKC,W,0,26,3,4,0.75,2,2,1,1,2,0.5,0,0,,0,5,5
12453,Jared Dudley,31-250,F-G,3/17/17,PHO,,ORL,L,0,26,3,9,0.333,2,3,0.667,1,6,0.167,0,0,,1,5,6
12454,Jared Dudley,31-211,F-G,2/6/17,PHO,@,NOP,L,0,21,3,6,0.5,2,4,0.5,1,2,0.5,0,0,,0,6,6
12455,Jared Dudley,31-233,F-G,2/28/17,PHO,@,MEM,L,0,15,2,4,0.5,1,1,1,1,3,0.333,2,2,1,0,1,1
12456,Mike Dunleavy,36-140,F-G,2/2/17,ATL,@,HOU,W,0,22,2,4,0.5,0,0,,2,4,0.5,1,2,0.5,0,1,1
12457,Mike Dunleavy,36-134,F-G,1/27/17,ATL,,WAS,L,0,21,3,8,0.375,2,3,0.667,1,5,0.2,0,0,,1,2,3
12458,Kris Dunn,22-232,G,11/5/16,MIN,@,OKC,L,1,28,2,8,0.25,2,8,0.25,0,0,,3,6,0.5,2,2,4
12459,Wayne Ellington,29-076,G,1/13/17,MIA,@,MIL,L,0,14,3,7,0.429,2,4,0.5,1,3,0.333,0,0,,2,1,3
12460,Wayne Ellington,29-139,G,3/17/17,MIA,,MIN,W,0,18,3,8,0.375,2,2,1,1,6,0.167,0,0,,0,2,2
12461,Wayne Ellington,29-042,G,12/10/16,MIA,@,CHI,L,1,25,3,7,0.429,2,4,0.5,1,3,0.333,0,0,,1,2,3
12462,Wayne Ellington,29-119,G,2/25/17,MIA,,IND,W,0,21,2,5,0.4,0,0,,2,5,0.4,1,1,1,0,4,4
12463,Wayne Ellington,29-095,G,2/1/17,MIA,,ATL,W,0,26,2,11,0.182,1,5,0.2,1,6,0.167,2,2,1,0,2,2
12464,Monta Ellis,31-012,G,11/7/16,IND,@,CHO,L,1,17,3,4,0.75,2,2,1,1,2,0.5,0,0,,0,0,0
12465,Monta Ellis,31-021,G,11/16/16,IND,,CLE,W,1,35,3,6,0.5,2,3,0.667,1,3,0.333,0,0,,1,5,6
12466,James Ennis,26-258,F,3/16/17,MEM,@,ATL,W,0,20,2,6,0.333,1,3,0.333,1,3,0.333,2,2,1,0,1,1
12467,James Ennis,26-213,F,1/30/17,MEM,@,PHO,W,0,26,2,3,0.667,1,1,1,1,2,0.5,2,2,1,1,2,3
12468,James Ennis,26-189,F,1/6/17,MEM,@,GSW,W,0,20,3,8,0.375,2,5,0.4,1,3,0.333,0,0,,1,4,5
12469,James Ennis,26-222,F,2/8/17,MEM,,PHO,W,0,22,2,3,0.667,1,1,1,1,2,0.5,2,3,0.667,1,3,4
12470,James Ennis,26-128,F,11/6/16,MEM,,POR,L,0,35,3,8,0.375,2,4,0.5,1,4,0.25,0,0,,0,3,3
12471,James Ennis,26-143,F,11/21/16,MEM,@,CHO,W,1,13,3,4,0.75,2,2,1,1,2,0.5,0,0,,0,0,0
12472,Tyler Ennis,22-201,G,3/13/17,LAL,@,DEN,L,0,20,2,6,0.333,2,5,0.4,0,1,0,3,3,1,2,1,3
12473,Tyler Ennis,22-125,G,12/27/16,HOU,@,DAL,W,0,18,3,5,0.6,2,4,0.5,1,1,1,0,0,,0,2,2
12474,Tyler Ennis,22-203,G,3/15/17,LAL,@,HOU,L,0,9,3,4,0.75,3,3,1,0,1,0,1,1,1,1,0,1
12475,Tyreke Evans,27-095,G-F,12/23/16,NOP,,MIA,W,0,15,1,7,0.143,0,5,0,1,2,0.5,4,4,1,0,5,5
12476,Tyreke Evans,27-087,G-F,12/15/16,NOP,,IND,W,0,11,2,3,0.667,1,1,1,1,2,0.5,2,2,1,0,3,3
12477,Tyreke Evans,27-108,G-F,1/5/17,NOP,,ATL,L,0,13,3,6,0.5,2,4,0.5,1,2,0.5,0,0,,0,2,2
12478,Tyreke Evans,27-146,G-F,2/12/17,NOP,@,SAC,L,0,15,2,6,0.333,2,5,0.4,0,1,0,3,4,0.75,0,3,3
12479,Dante Exum,21-248,G,3/18/17,UTA,@,CHI,L,0,16,2,5,0.4,2,4,0.5,0,1,0,3,5,0.6,0,4,4
12480,Dante Exum,21-114,G,11/4/16,UTA,,SAS,L,0,29,3,9,0.333,2,6,0.333,1,3,0.333,0,0,,1,6,7
12481,Dante Exum,21-146,G,12/6/16,UTA,,PHO,W,1,17,3,5,0.6,2,3,0.667,1,2,0.5,0,0,,0,3,3
12482,Dante Exum,21-208,G,2/6/17,UTA,@,ATL,W,0,14,3,5,0.6,3,4,0.75,0,1,0,1,2,0.5,0,2,2
12483,Dante Exum,21-245,G,3/15/17,UTA,@,DET,W,0,23,3,4,0.75,2,3,0.667,1,1,1,0,0,,0,3,3
12484,Kenneth Faried,26-345,F,10/29/16,DEN,,POR,L,0,30,2,4,0.5,2,4,0.5,0,0,,3,4,0.75,3,6,9
12485,Kenneth Faried,26-365,F,11/18/16,DEN,,TOR,L,1,24,3,4,0.75,3,4,0.75,0,0,,1,1,1,1,10,11
12486,Derrick Favors,25-234,F-C,3/6/17,UTA,,NOP,W,1,32,3,10,0.3,3,10,0.3,0,0,,1,2,0.5,1,3,4
12487,Derrick Favors,25-154,F-C,12/16/16,UTA,,DAL,W,0,14,2,3,0.667,2,3,0.667,0,0,,3,4,0.75,1,1,2
12488,Cristiano Felicio,24-220,F-C,2/12/17,CHI,@,MIN,L,0,24,3,7,0.429,3,7,0.429,0,0,,1,2,0.5,1,3,4
12489,Cristiano Felicio,24-240,F-C,3/4/17,CHI,,LAC,L,0,15,3,5,0.6,3,5,0.6,0,0,,1,2,0.5,4,1,5
12490,Cristiano Felicio,24-114,F-C,10/29/16,CHI,,IND,W,0,20,3,5,0.6,3,5,0.6,0,0,,1,2,0.5,3,5,8
12491,Cristiano Felicio,24-161,F-C,12/15/16,CHI,@,MIL,L,0,21,3,4,0.75,3,4,0.75,0,0,,1,2,0.5,2,4,6
12492,Raymond Felton,32-196,G,1/8/17,LAC,,MIA,W,1,37,3,11,0.273,2,5,0.4,1,6,0.167,0,0,,1,6,7
12493,Raymond Felton,32-129,G,11/2/16,LAC,,OKC,L,0,16,3,5,0.6,2,4,0.5,1,1,1,0,0,,0,2,2
12494,Raymond Felton,32-158,G,12/1/16,LAC,@,CLE,W,0,19,3,7,0.429,2,5,0.4,1,2,0.5,0,0,,0,3,3
12495,Raymond Felton,32-156,G,11/29/16,LAC,@,BRK,L,0,14,3,6,0.5,2,3,0.667,1,3,0.333,0,0,,0,2,2
12496,Raymond Felton,32-225,G,2/6/17,LAC,@,TOR,L,1,36,3,9,0.333,2,6,0.333,1,3,0.333,0,0,,0,6,6
12497,Raymond Felton,32-139,G,11/12/16,LAC,@,MIN,W,0,13,3,3,1,2,2,1,1,1,1,0,0,,1,1,2
12498,Yogi Ferrell,23-300,G,3/5/17,DAL,,OKC,W,1,32,3,8,0.375,2,5,0.4,1,3,0.333,0,0,,0,2,2
12499,Yogi Ferrell,23-292,G,2/25/17,DAL,,NOP,W,1,29,3,9,0.333,2,4,0.5,1,5,0.2,0,0,,2,3,5
12500,Dorian Finney-Smith,23-189,F,11/9/16,DAL,@,GSW,L,1,35,2,5,0.4,1,1,1,1,4,0.25,2,4,0.5,1,2,3
12501,Dorian Finney-Smith,23-261,F,1/20/17,DAL,,UTA,L,0,14,3,4,0.75,2,3,0.667,1,1,1,0,0,,1,1,2
12502,Dorian Finney-Smith,23-189,F,11/9/16,DAL,@,GSW,L,1,35,2,5,0.4,1,1,1,1,4,0.25,2,4,0.5,1,2,3
12503,Evan Fournier,24-119,G-F,2/25/17,ORL,,ATL,W,1,34,2,11,0.182,1,4,0.25,1,7,0.143,2,2,1,0,4,4
12504,Randy Foye,33-051,G,11/14/16,BRK,@,LAC,L,0,29,1,4,0.25,0,1,0,1,3,0.333,4,5,0.8,0,4,4
12505,Randy Foye,33-068,G,12/1/16,BRK,,MIL,L,0,23,2,7,0.286,1,3,0.333,1,4,0.25,2,2,1,0,6,6
12506,Tim Frazier,26-125,G,3/6/17,NOP,@,UTA,L,0,29,2,4,0.5,1,2,0.5,1,2,0.5,2,4,0.5,1,3,4
12507,Tim Frazier,26-037,G,12/8/16,NOP,,PHI,L,1,29,3,7,0.429,2,4,0.5,1,3,0.333,0,0,,2,4,6
12508,Tim Frazier,26-080,G,1/20/17,NOP,,BRK,L,0,12,3,6,0.5,3,4,0.75,0,2,0,1,2,0.5,0,0,0
12509,Tim Frazier,26-133,G,3/14/17,NOP,,POR,W,0,24,2,6,0.333,1,4,0.25,1,2,0.5,2,2,1,0,5,5
12510,Channing Frye,33-268,C-F,2/9/17,CLE,@,OKC,L,0,15,2,6,0.333,1,2,0.5,1,4,0.25,2,2,1,0,6,6
12511,Langston Galloway,25-007,G,12/16/16,NOP,@,HOU,L,0,21,3,10,0.3,2,5,0.4,1,5,0.2,0,1,0,1,0,1
12512,Pau Gasol,36-113,F-C,10/27/16,SAS,@,SAC,W,1,21,3,7,0.429,2,6,0.333,1,1,1,0,0,,0,6,6
12513,Pau Gasol,36-165,F-C,12/18/16,SAS,,NOP,W,1,24,3,7,0.429,3,7,0.429,0,0,,1,4,0.25,5,9,14
12514,Pau Gasol,36-245,F-C,3/8/17,SAS,,SAC,W,0,16,2,5,0.4,2,5,0.4,0,0,,3,4,0.75,1,3,4
12515,Rudy Gay,30-117,F,12/12/16,SAC,,LAL,W,1,14,2,6,0.333,2,3,0.667,0,3,0,3,3,1,0,5,5
12516,Alonzo Gee,29-180,G,11/25/16,DEN,,OKC,L,0,27,2,8,0.25,2,5,0.4,0,3,0,3,5,0.6,1,2,3
12517,Jonathan Gibson,29-013,G,11/21/16,DAL,@,SAS,L,0,16,2,6,0.333,2,4,0.5,0,2,0,3,4,0.75,1,0,1
12518,Jonathan Gibson,29-029,G,12/7/16,DAL,,SAC,L,0,28,3,12,0.25,2,7,0.286,1,5,0.2,0,0,,0,2,2
12519,Taj Gibson,31-258,F,3/9/17,OKC,,SAS,W,1,22,3,7,0.429,3,7,0.429,0,0,,1,2,0.5,0,3,3
12520,Taj Gibson,31-214,F,1/24/17,CHI,@,ORL,W,1,29,2,6,0.333,2,5,0.4,0,1,0,3,6,0.5,0,6,6
12521,Taj Gibson,31-211,F,1/21/17,CHI,,SAC,W,1,29,3,9,0.333,3,9,0.333,0,0,,1,2,0.5,0,3,3
12522,Taj Gibson,31-249,F,2/28/17,OKC,,UTA,W,0,26,2,4,0.5,2,4,0.5,0,0,,3,4,0.75,1,2,3
12523,Manu Ginobili,39-230,G,3/15/17,SAS,,POR,L,0,20,2,5,0.4,1,3,0.333,1,2,0.5,2,4,0.5,0,1,1
12524,Manu Ginobili,39-183,G,1/27/17,SAS,@,NOP,L,0,15,3,7,0.429,2,6,0.333,1,1,1,0,0,,0,0,0
12525,Manu Ginobili,39-100,G,11/5/16,SAS,,LAC,L,0,13,2,6,0.333,1,3,0.333,1,3,0.333,2,2,1,0,4,4
12526,Rudy Gobert,24-136,C,11/9/16,UTA,@,CHO,L,1,30,2,4,0.5,2,4,0.5,0,0,,3,4,0.75,5,6,11
12527,Rudy Gobert,24-160,C,12/3/16,UTA,,DEN,W,1,37,3,4,0.75,3,4,0.75,0,0,,1,2,0.5,3,8,11
12528,Archie Goodwin,22-087,G,11/12/16,NOP,,LAL,L,0,10,1,1,1,0,0,,1,1,1,4,4,1,0,0,0
12529,Aaron Gordon,21-144,F,2/7/17,ORL,@,HOU,L,1,19,3,5,0.6,2,2,1,1,3,0.333,0,0,,1,1,2
12530,Aaron Gordon,21-093,F,12/18/16,ORL,,TOR,L,1,20,3,9,0.333,2,5,0.4,1,4,0.25,0,0,,0,1,1
12531,Aaron Gordon,21-046,F,11/1/16,ORL,@,PHI,W,1,32,3,10,0.3,3,6,0.5,0,4,0,1,1,1,1,1,2
12532,Aaron Gordon,21-138,F,2/1/17,ORL,,IND,L,1,32,3,8,0.375,3,4,0.75,0,4,0,1,3,0.333,0,0,0
12533,Aaron Gordon,21-088,F,12/13/16,ORL,@,ATL,W,1,18,3,6,0.5,2,3,0.667,1,3,0.333,0,0,,0,3,3
12534,Aaron Gordon,21-135,F,1/29/17,ORL,@,TOR,W,1,26,3,8,0.375,2,5,0.4,1,3,0.333,0,0,,2,1,3
12535,Aaron Gordon,21-054,F,11/9/16,ORL,,MIN,L,1,31,2,9,0.222,2,6,0.333,0,3,0,3,4,0.75,1,3,4
12536,Eric Gordon,28-023,G,1/17/17,HOU,@,MIA,L,0,30,3,17,0.176,2,7,0.286,1,10,0.1,0,0,,0,1,1
12537,Marcin Gortat,32-299,C-F,12/12/16,WAS,@,MIA,L,1,32,3,5,0.6,3,5,0.6,0,0,,1,2,0.5,5,6,11
12538,Marcin Gortat,33-016,C-F,3/5/17,WAS,,ORL,W,1,22,1,3,0.333,1,3,0.333,0,0,,5,6,0.833,4,7,11
12539,Marcin Gortat,32-326,C-F,1/8/17,WAS,@,MIL,W,1,37,2,5,0.4,2,5,0.4,0,0,,3,4,0.75,2,10,12
12540,Marcin Gortat,33-024,C-F,3/13/17,WAS,@,MIN,L,1,23,3,5,0.6,3,5,0.6,0,0,,1,1,1,1,3,4
12541,Marcin Gortat,32-336,C-F,1/18/17,WAS,,MEM,W,1,36,3,5,0.6,3,5,0.6,0,0,,1,2,0.5,3,8,11
12542,Jerami Grant,22-351,F,2/26/17,OKC,,NOP,W,0,21,2,3,0.667,2,2,1,0,1,0,3,3,1,0,3,3
12543,Jerami Grant,22-349,F,2/24/17,OKC,,LAL,W,0,20,3,3,1,3,3,1,0,0,,1,1,1,0,2,2
12544,Jerami Grant,22-277,F,12/14/16,OKC,@,UTA,L,1,22,2,6,0.333,1,5,0.2,1,1,1,2,2,1,0,2,2
12545,Jerami Grant,22-242,F,11/9/16,OKC,,TOR,L,0,12,2,3,0.667,1,1,1,1,2,0.5,2,2,1,0,2,2
12546,Jerami Grant,22-303,F,1/9/17,OKC,@,CHI,W,0,16,3,6,0.5,2,3,0.667,1,3,0.333,0,0,,0,2,2
12547,Jerami Grant,23-008,F,3/20/17,OKC,,GSW,L,0,15,3,4,0.75,3,4,0.75,0,0,,1,4,0.25,0,1,1
12548,Jerami Grant,22-263,F,11/30/16,OKC,,WAS,W,0,24,1,3,0.333,0,0,,1,3,0.333,4,8,0.5,2,2,4
12549,Jerami Grant,22-312,F,1/18/17,OKC,@,GSW,L,1,29,2,8,0.25,2,6,0.333,0,2,0,3,4,0.75,1,0,1
12550,Jerian Grant,24-148,G,3/6/17,CHI,@,DET,L,1,23,3,8,0.375,2,4,0.5,1,4,0.25,0,0,,0,3,3
12551,Jerian Grant,24-107,G,1/24/17,CHI,@,ORL,W,1,20,1,4,0.25,0,0,,1,4,0.25,4,5,0.8,0,3,3
12552,Jerian Grant,24-142,G,2/28/17,CHI,,DEN,L,1,12,2,2,1,1,1,1,1,1,1,2,2,1,0,0,0
12553,Jerian Grant,24-117,G,2/3/17,CHI,@,HOU,L,1,17,2,4,0.5,1,1,1,1,3,0.333,2,2,1,0,0,0
12554,Jerian Grant,24-138,G,2/24/17,CHI,,PHO,W,0,13,2,3,0.667,1,1,1,1,2,0.5,2,5,0.4,1,2,3
12555,Danny Green,29-152,G-F,11/21/16,SAS,,DAL,W,1,29,1,4,0.25,1,1,1,0,3,0,5,6,0.833,0,3,3
12556,Danny Green,29-221,G-F,1/29/17,SAS,,DAL,L,1,31,3,6,0.5,2,2,1,1,4,0.25,0,0,,0,4,4
12557,Draymond Green,26-281,F,12/10/16,GSW,@,MEM,L,1,26,3,7,0.429,3,6,0.5,0,1,0,1,3,0.333,4,3,7
12558,Draymond Green,26-356,F,2/23/17,GSW,,LAC,W,1,23,2,4,0.5,1,3,0.333,1,1,1,2,2,1,0,6,6
12559,Draymond Green,26-325,F,1/23/17,GSW,@,MIA,L,1,39,3,8,0.375,3,5,0.6,0,3,0,1,4,0.25,1,2,3
12560,Draymond Green,27-017,F,3/21/17,GSW,@,DAL,W,1,28,2,6,0.333,1,2,0.5,1,4,0.25,2,2,1,0,7,7
12561,Gerald Green,30-365,G-F,1/25/17,BOS,,HOU,W,0,16,3,5,0.6,2,2,1,1,3,0.333,0,0,,0,4,4
12562,Gerald Green,31-013,G-F,2/8/17,BOS,@,SAC,L,0,13,2,7,0.286,1,5,0.2,1,2,0.5,2,4,0.5,1,1,2
12563,JaMychal Green,26-214,F,1/21/17,MEM,,HOU,L,1,30,3,6,0.5,2,5,0.4,1,1,1,0,0,,6,3,9
12564,JaMychal Green,26-131,F,10/30/16,MEM,,WAS,W,1,39,3,6,0.5,2,3,0.667,1,3,0.333,0,0,,2,4,6
12565,JaMychal Green,26-185,F,12/23/16,MEM,,HOU,W,1,27,1,3,0.333,0,2,0,1,1,1,4,4,1,3,2,5
12566,JaMychal Green,26-223,F,1/30/17,MEM,@,PHO,W,1,28,2,7,0.286,0,3,0,2,4,0.5,1,2,0.5,3,5,8
12567,JaMychal Green,26-182,F,12/20/16,MEM,,BOS,L,1,31,2,5,0.4,2,4,0.5,0,1,0,3,4,0.75,4,8,12
12568,Jeff Green,30-089,F,11/25/16,ORL,,WAS,L,1,25,3,9,0.333,2,6,0.333,1,3,0.333,0,0,,0,3,3
12569,Jeff Green,30-167,F,2/11/17,ORL,@,DAL,L,0,15,3,8,0.375,3,6,0.5,0,2,0,1,1,1,1,2,3
12570,Jeff Green,30-131,F,1/6/17,ORL,,HOU,L,0,20,3,8,0.375,2,5,0.4,1,3,0.333,0,0,,0,1,1
12571,Jeff Green,30-181,F,2/25/17,ORL,,ATL,W,0,22,1,4,0.25,0,1,0,1,3,0.333,4,4,1,1,3,4
12572,Jeff Green,30-197,F,3/13/17,ORL,@,SAC,L,0,19,2,6,0.333,2,4,0.5,0,2,0,3,3,1,0,5,5
12573,Jeff Green,30-195,F,3/11/17,ORL,,CLE,L,0,18,3,7,0.429,3,6,0.5,0,1,0,1,1,1,0,3,3
12574,Jeff Green,30-059,F,10/26/16,ORL,,MIA,L,0,25,2,7,0.286,2,5,0.4,0,2,0,3,4,0.75,1,2,3
12575,Justin Hamilton,26-349,C,3/16/17,BRK,@,NYK,W,0,18,2,4,0.5,1,1,1,1,3,0.333,2,2,1,3,3,6
12576,Justin Hamilton,26-225,C,11/12/16,BRK,@,PHO,W,0,26,2,2,1,1,1,1,1,1,1,2,3,0.667,0,3,3
12577,Justin Hamilton,26-242,C,11/29/16,BRK,,LAC,W,0,25,2,6,0.333,1,3,0.333,1,3,0.333,2,4,0.5,0,4,4
12578,Tim Hardaway,24-256,G,11/27/16,ATL,@,LAL,L,0,13,3,6,0.5,2,3,0.667,1,3,0.333,0,1,0,1,0,1
12579,Tim Hardaway,24-266,G,12/7/16,ATL,,MIA,W,1,22,3,9,0.333,2,6,0.333,1,3,0.333,0,0,,0,0,0
12580,Tim Hardaway,24-278,G,12/19/16,ATL,@,OKC,W,0,22,3,7,0.429,2,4,0.5,1,3,0.333,0,0,,0,2,2
12581,Tim Hardaway,24-227,G,10/29/16,ATL,@,PHI,W,0,19,3,11,0.273,2,5,0.4,1,6,0.167,0,1,0,0,3,3
12582,Maurice Harkless,23-171,F-G,10/29/16,POR,@,DEN,W,1,32,2,6,0.333,0,3,0,2,3,0.667,1,2,0.5,0,3,3
12583,Maurice Harkless,23-213,F-G,12/10/16,POR,@,IND,L,1,31,3,7,0.429,2,3,0.667,1,4,0.25,0,0,,1,0,1
12584,Montrezl Harrell,22-336,F-C,12/27/16,HOU,@,DAL,W,0,26,3,7,0.429,3,7,0.429,0,0,,1,2,0.5,2,0,2
12585,Montrezl Harrell,22-318,F-C,12/9/16,HOU,@,OKC,W,0,13,3,4,0.75,3,4,0.75,0,0,,1,3,0.333,1,1,2
12586,Montrezl Harrell,22-314,F-C,12/5/16,HOU,,BOS,W,0,19,3,5,0.6,3,5,0.6,0,0,,1,1,1,1,1,2
12587,Montrezl Harrell,23-005,F-C,1/31/17,HOU,,SAC,W,0,15,3,3,1,3,3,1,0,0,,1,2,0.5,1,2,3
12588,Devin Harris,33-337,G,1/29/17,DAL,@,SAS,W,0,19,2,6,0.333,1,3,0.333,1,3,0.333,2,2,1,0,1,1
12589,Devin Harris,34-008,G,3/7/17,DAL,,LAL,W,0,13,2,4,0.5,1,2,0.5,1,2,0.5,2,2,1,0,0,0
12590,Devin Harris,33-333,G,1/25/17,DAL,,NYK,W,0,22,2,8,0.25,1,5,0.2,1,3,0.333,2,4,0.5,0,4,4
12591,Devin Harris,34-006,G,3/5/17,DAL,,OKC,W,0,18,2,5,0.4,1,3,0.333,1,2,0.5,2,2,1,0,2,2
12592,Devin Harris,33-282,G,12/5/16,DAL,,CHO,L,0,18,2,4,0.5,1,1,1,1,3,0.333,2,2,1,0,3,3
12593,Joe Harris,25-072,G,11/18/16,BRK,@,OKC,L,0,20,2,3,0.667,1,2,0.5,1,1,1,2,4,0.5,0,1,1
12594,Joe Harris,25-069,G,11/15/16,BRK,@,LAL,L,0,29,3,9,0.333,2,2,1,1,7,0.143,0,0,,0,3,3
12595,Joe Harris,25-170,G,2/24/17,BRK,@,DEN,L,0,24,2,7,0.286,0,2,0,2,5,0.4,1,2,0.5,1,4,5
12596,Joe Harris,25-117,G,1/2/17,BRK,,UTA,L,0,22,3,5,0.6,2,2,1,1,3,0.333,0,0,,1,0,1
12597,Tobias Harris,24-159,F,12/21/16,DET,,MEM,L,1,27,3,7,0.429,2,5,0.4,1,2,0.5,0,0,,0,6,6
12598,Andrew Harrison,22-026,G,11/23/16,MEM,@,PHI,W,0,42,2,6,0.333,1,2,0.5,1,4,0.25,2,2,1,0,4,4
12599,Andrew Harrison,22-068,G,1/4/17,MEM,@,LAC,L,0,20,2,2,1,1,1,1,1,1,1,2,4,0.5,0,5,5
12600,Andrew Harrison,22-085,G,1/21/17,MEM,,HOU,L,0,15,2,5,0.4,1,1,1,1,4,0.25,2,2,1,0,0,0
12601,Andrew Harrison,22-132,G,3/9/17,MEM,,LAC,L,1,14,2,5,0.4,1,2,0.5,1,3,0.333,2,2,1,0,0,0
12602,Udonis Haslem,36-209,F-C,1/4/17,MIA,@,SAC,W,0,18,2,3,0.667,2,3,0.667,0,0,,3,4,0.75,1,2,3
12603,Spencer Hawes,28-217,C-F,12/1/16,CHO,,DAL,W,0,13,3,3,1,3,3,1,0,0,,1,1,1,0,3,3
12604,Gordon Hayward,26-327,F-G,2/13/17,UTA,,LAC,L,1,29,2,12,0.167,1,6,0.167,1,6,0.167,2,2,1,0,5,5
12605,Gerald Henderson,29-030,G,1/8/17,PHI,@,BRK,W,0,21,3,7,0.429,3,7,0.429,0,0,,1,1,1,0,1,1
12606,Gerald Henderson,28-334,G,11/7/16,PHI,,UTA,L,1,24,3,8,0.375,2,6,0.333,1,2,0.5,0,0,,0,3,3
12607,John Henson,25-337,C-F,11/29/16,MIL,,CLE,W,1,21,3,7,0.429,3,7,0.429,0,0,,1,1,1,4,5,9
12608,John Henson,25-350,C-F,12/12/16,MIL,@,TOR,L,1,14,3,5,0.6,3,5,0.6,0,0,,1,1,1,0,2,2
12609,John Henson,26-000,C-F,12/28/16,MIL,@,DET,W,1,19,2,4,0.5,2,4,0.5,0,0,,3,4,0.75,0,2,2
12610,John Henson,25-327,C-F,11/19/16,MIL,,GSW,L,1,18,3,3,1,3,3,1,0,0,,1,2,0.5,0,6,6
12611,John Henson,25-306,C-F,10/29/16,MIL,,BRK,W,0,21,3,6,0.5,3,6,0.5,0,0,,1,2,0.5,2,10,12
12612,John Henson,25-345,C-F,12/7/16,MIL,,POR,W,1,25,2,4,0.5,2,4,0.5,0,0,,3,6,0.5,2,4,6
12613,John Henson,25-324,C-F,11/16/16,MIL,@,ATL,L,1,20,2,5,0.4,2,5,0.4,0,0,,3,4,0.75,3,4,7
12614,Juan Hernangomez,21-131,F,2/6/17,DEN,,DAL,W,0,18,3,5,0.6,3,4,0.75,0,1,0,1,1,1,3,6,9
12615,Juan Hernangomez,21-149,F,2/24/17,DEN,,BRK,W,0,8,3,5,0.6,2,3,0.667,1,2,0.5,0,0,,1,3,4
12616,Juan Hernangomez,21-161,F,3/8/17,DEN,,WAS,L,1,29,3,4,0.75,3,4,0.75,0,0,,1,3,0.333,1,9,10
12617,Juan Hernangomez,21-045,F,11/12/16,DEN,,DET,L,0,20,3,5,0.6,2,3,0.667,1,2,0.5,0,0,,1,3,4
12618,Willy Hernangomez,22-177,C,11/20/16,NYK,,ATL,W,0,29,3,4,0.75,3,4,0.75,0,0,,1,3,0.333,2,6,8
12619,Mario Hezonja,21-348,F-G,2/7/17,ORL,@,HOU,L,0,15,3,6,0.5,2,4,0.5,1,2,0.5,0,0,,0,2,2
12620,Mario Hezonja,21-337,F-G,1/27/17,ORL,@,BOS,L,0,23,3,8,0.375,2,4,0.5,1,4,0.25,0,0,,0,3,3
12621,Mario Hezonja,22-014,F-G,3/11/17,ORL,,CLE,L,0,15,2,5,0.4,1,2,0.5,1,3,0.333,2,2,1,0,2,2
12622,Mario Hezonja,21-332,F-G,1/22/17,ORL,,GSW,L,0,21,3,11,0.273,2,4,0.5,1,7,0.143,0,1,0,1,4,5
12623,Mario Hezonja,21-352,F-G,2/11/17,ORL,@,DAL,L,1,35,3,11,0.273,2,5,0.4,1,6,0.167,0,0,,0,6,6
12624,Buddy Hield,23-088,G,3/15/17,SAC,@,PHO,W,1,21,3,7,0.429,2,4,0.5,1,3,0.333,0,0,,0,2,2
12625,Buddy Hield,22-362,G,12/13/16,NOP,,GSW,L,1,18,3,7,0.429,2,4,0.5,1,3,0.333,0,0,,0,3,3
12626,Nene Hilario,34-043,F-C,10/26/16,HOU,@,LAL,L,0,22,3,5,0.6,3,5,0.6,0,0,,1,4,0.25,2,1,3
12627,George Hill,30-273,G,2/1/17,UTA,,MIL,W,1,34,3,9,0.333,2,6,0.333,1,3,0.333,0,0,,0,2,2
12628,Solomon Hill,25-317,F,1/29/17,NOP,,WAS,L,1,39,2,9,0.222,0,2,0,2,7,0.286,1,2,0.5,1,2,3
12629,Solomon Hill,25-231,F,11/4/16,NOP,,PHO,L,1,30,2,5,0.4,1,3,0.333,1,2,0.5,2,4,0.5,1,4,5
12630,Solomon Hill,25-329,F,2/10/17,NOP,@,MIN,W,1,37,2,8,0.25,1,2,0.5,1,6,0.167,2,2,1,1,5,6
12631,Solomon Hill,25-345,F,2/26/17,NOP,@,OKC,L,1,31,1,3,0.333,0,0,,1,3,0.333,4,4,1,1,3,4
12632,Solomon Hill,25-323,F,2/4/17,NOP,@,WAS,L,1,27,3,6,0.5,2,3,0.667,1,3,0.333,0,0,,1,4,5
12633,Darrun Hilliard,23-219,G,11/18/16,DET,@,CLE,L,0,20,1,6,0.167,0,4,0,1,2,0.5,4,6,0.667,0,1,1
12634,Jrue Holiday,26-197,G,12/26/16,NOP,,DAL,W,1,36,2,11,0.182,2,10,0.2,0,1,0,3,4,0.75,0,3,3
12635,Jrue Holiday,26-269,G,3/8/17,NOP,,TOR,L,1,32,3,9,0.333,2,5,0.4,1,4,0.25,0,0,,0,0,0
12636,Jrue Holiday,26-164,G,11/23/16,NOP,,MIN,W,0,22,2,8,0.25,2,6,0.333,0,2,0,3,4,0.75,0,1,1
12637,Justin Holiday,27-248,G,12/9/16,NYK,@,SAC,W,0,15,3,6,0.5,2,4,0.5,1,2,0.5,0,0,,1,2,3
12638,Justin Holiday,27-231,G,11/22/16,NYK,,POR,W,0,19,3,4,0.75,2,3,0.667,1,1,1,0,0,,0,5,5
12639,Justin Holiday,27-264,G,12/25/16,NYK,,BOS,L,0,14,1,3,0.333,0,1,0,1,2,0.5,4,4,1,0,1,1
12640,Justin Holiday,27-343,G,3/14/17,NYK,,IND,W,0,20,3,5,0.6,2,3,0.667,1,2,0.5,0,0,,1,1,2
12641,Justin Holiday,27-259,G,12/20/16,NYK,,IND,W,0,21,3,5,0.6,2,3,0.667,1,2,0.5,0,0,,0,4,4
12642,Justin Holiday,27-274,G,1/4/17,NYK,,MIL,L,0,10,3,6,0.5,2,4,0.5,1,2,0.5,0,0,,1,2,3
12643,Justin Holiday,27-302,G,2/1/17,NYK,@,BRK,W,0,28,2,4,0.5,1,1,1,1,3,0.333,2,2,1,0,4,4
12644,Rondae Hollis-Jefferson,21-360,F,12/28/16,BRK,@,CHI,L,0,18,2,7,0.286,2,7,0.286,0,0,,3,5,0.6,0,1,1
12645,Rondae Hollis-Jefferson,22-005,F,1/8/17,BRK,,PHI,L,0,23,3,5,0.6,3,5,0.6,0,0,,1,2,0.5,0,4,4
12646,Rondae Hollis-Jefferson,22-018,F,1/21/17,BRK,@,CHO,L,0,21,3,6,0.5,3,3,1,0,3,0,1,3,0.333,0,4,4
12647,Rondae Hollis-Jefferson,22-057,F,3/1/17,BRK,@,SAC,W,1,19,1,5,0.2,0,3,0,1,2,0.5,4,6,0.667,0,2,2
12648,Rondae Hollis-Jefferson,21-333,F,12/1/16,BRK,,MIL,L,0,17,3,7,0.429,3,6,0.5,0,1,0,1,2,0.5,0,2,2
12649,Rondae Hollis-Jefferson,21-350,F,12/18/16,BRK,@,PHI,L,0,19,3,5,0.6,3,4,0.75,0,1,0,1,4,0.25,1,4,5
12650,Richaun Holmes,23-028,F-C,11/12/16,PHI,@,ATL,L,0,20,2,8,0.25,2,7,0.286,0,1,0,3,4,0.75,2,3,5
12651,Richaun Holmes,23-025,F-C,11/9/16,PHI,@,IND,L,0,28,3,4,0.75,2,2,1,1,2,0.5,0,4,0,0,6,6
12652,Rodney Hood,24-077,G-F,1/5/17,UTA,@,TOR,L,1,35,3,10,0.3,2,5,0.4,1,5,0.2,0,0,,0,2,2
12653,Al Horford,30-258,C-F,2/16/17,BOS,@,CHI,L,1,27,3,10,0.3,2,5,0.4,1,5,0.2,0,0,,0,2,2
12654,Dwight Howard,30-336,C,11/8/16,ATL,@,CLE,W,1,27,3,5,0.6,3,5,0.6,0,0,,1,4,0.25,2,15,17
12655,Dwight Howard,31-095,C,3/13/17,ATL,@,SAS,L,1,30,2,5,0.4,2,5,0.4,0,0,,3,10,0.3,2,11,13
12656,Josh Huestis,25-044,F,2/1/17,OKC,,CHI,L,0,7,3,4,0.75,2,2,1,1,2,0.5,0,0,,2,2,4
12657,Kris Humphries,31-350,F-C,1/21/17,ATL,,PHI,W,0,16,2,4,0.5,2,4,0.5,0,0,,3,4,0.75,1,8,9
12658,Kris Humphries,31-349,F-C,1/20/17,ATL,,CHI,W,0,20,3,6,0.5,2,4,0.5,1,2,0.5,0,0,,3,6,9
12659,Kris Humphries,32-002,F-C,2/8/17,ATL,,DEN,W,0,13,3,4,0.75,2,2,1,1,2,0.5,0,0,,0,4,4
12660,Serge Ibaka,27-050,F-C,11/7/16,ORL,@,CHI,L,1,26,3,6,0.5,2,4,0.5,1,2,0.5,0,0,,0,7,7
12661,Andre Iguodala,33-045,G-F,3/14/17,GSW,,PHI,W,0,33,3,8,0.375,2,7,0.286,1,1,1,0,0,,0,1,1
12662,Ersan Ilyasova,29-201,F,12/2/16,PHI,,ORL,L,1,17,2,9,0.222,1,4,0.25,1,5,0.2,2,4,0.5,1,1,2
12663,Ersan Ilyasova,29-288,F,2/27/17,ATL,@,BOS,W,0,17,2,8,0.25,1,3,0.333,1,5,0.2,2,2,1,1,3,4
12664,Joe Ingles,29-134,F-G,2/13/17,UTA,,LAC,L,1,22,2,4,0.5,1,2,0.5,1,2,0.5,2,2,1,0,4,4
12665,Joe Ingles,29-116,F-G,1/26/17,UTA,,LAL,W,0,26,2,4,0.5,1,1,1,1,3,0.333,2,2,1,1,3,4
12666,Joe Ingles,29-065,F-G,12/6/16,UTA,,PHO,W,0,21,2,4,0.5,1,1,1,1,3,0.333,2,2,1,0,3,3
12667,Joe Ingles,29-033,F-G,11/4/16,UTA,,SAS,L,0,21,2,5,0.4,1,1,1,1,4,0.25,2,4,0.5,0,1,1
12668,Joe Ingles,29-064,F-G,12/5/16,UTA,@,LAL,W,0,12,2,3,0.667,1,2,0.5,1,1,1,2,3,0.667,0,2,2
12669,Joe Ingles,29-093,F-G,1/3/17,UTA,@,BOS,L,0,26,2,6,0.333,1,2,0.5,1,4,0.25,2,2,1,1,4,5
12670,Brandon Ingram,19-079,F,11/20/16,LAL,,CHI,L,0,20,3,6,0.5,3,6,0.5,0,0,,1,2,0.5,1,3,4
12671,Brandon Ingram,19-086,F,11/27/16,LAL,,ATL,W,0,29,3,10,0.3,2,8,0.25,1,2,0.5,0,0,,0,8,8
12672,Pierre Jackson,25-120,G,12/27/16,DAL,,HOU,L,0,11,2,5,0.4,1,3,0.333,1,2,0.5,2,2,1,0,1,1
12673,Reggie Jackson,26-294,G,2/4/17,DET,@,IND,L,1,27,3,11,0.273,2,8,0.25,1,3,0.333,0,0,,1,2,3
12674,Reggie Jackson,26-272,G,1/13/17,DET,@,UTA,L,1,27,3,11,0.273,2,10,0.2,1,1,1,0,1,0,0,1,1
12675,Reggie Jackson,26-339,G,3/21/17,DET,@,BRK,L,1,20,3,9,0.333,2,7,0.286,1,2,0.5,0,0,,1,1,2
12676,Reggie Jackson,26-234,G,12/6/16,DET,,CHI,W,1,18,2,9,0.222,1,8,0.125,1,1,1,2,3,0.667,0,3,3
12677,Reggie Jackson,26-247,G,12/19/16,DET,@,CHI,L,1,24,2,5,0.4,2,4,0.5,0,1,0,3,4,0.75,0,1,1
12678,Al Jefferson,32-017,C-F,1/21/17,IND,@,UTA,L,0,14,3,4,0.75,3,4,0.75,0,0,,1,1,1,0,4,4
12679,Al Jefferson,31-296,C-F,10/26/16,IND,,DAL,W,0,11,3,6,0.5,3,6,0.5,0,0,,1,1,1,1,5,6
12680,Richard Jefferson,36-271,F,3/19/17,CLE,@,LAL,W,0,29,3,4,0.75,3,3,1,0,1,0,1,2,0.5,0,5,5
12681,Richard Jefferson,36-197,F,1/4/17,CLE,,CHI,L,0,29,2,7,0.286,0,2,0,2,5,0.4,1,2,0.5,1,0,1
12682,Richard Jefferson,36-232,F,2/8/17,CLE,@,IND,W,0,22,1,3,0.333,0,0,,1,3,0.333,4,4,1,1,1,2
12683,Brandon Jennings,27-032,G,10/25/16,NYK,@,CLE,L,0,21,1,7,0.143,1,3,0.333,0,4,0,5,6,0.833,1,2,3
12684,Brandon Jennings,27-153,G,2/23/17,NYK,@,CLE,L,0,14,2,9,0.222,1,5,0.2,1,4,0.25,2,2,1,1,1,2
12685,Jonas Jerebko,29-271,F,11/28/16,BOS,@,MIA,W,0,21,3,3,1,2,2,1,1,1,1,0,0,,1,3,4
12686,Jonas Jerebko,29-268,F,11/25/16,BOS,,SAS,L,0,11,3,4,0.75,2,3,0.667,1,1,1,0,0,,0,3,3
12687,Jonas Jerebko,29-249,F,11/6/16,BOS,,DEN,L,0,18,3,6,0.5,2,4,0.5,1,2,0.5,0,0,,3,0,3
12688,Jonas Jerebko,29-314,F,1/10/17,BOS,@,TOR,L,0,17,2,3,0.667,1,2,0.5,1,1,1,2,2,1,0,2,2
12689,Jonas Jerebko,29-331,F,1/27/17,BOS,,ORL,W,1,27,2,6,0.333,1,3,0.333,1,3,0.333,2,2,1,1,7,8
12690,Jonas Jerebko,29-329,F,1/25/17,BOS,,HOU,W,1,23,3,3,1,2,2,1,1,1,1,0,0,,3,4,7
12691,Jonas Jerebko,29-362,F,2/27/17,BOS,,ATL,L,0,19,2,2,1,1,1,1,1,1,1,2,2,1,0,3,3
12692,Amir Johnson,29-288,F,2/13/17,BOS,@,DAL,W,1,21,3,4,0.75,2,3,0.667,1,1,1,0,0,,2,5,7
12693,James Johnson,29-268,F,11/14/16,MIA,@,SAS,L,0,18,2,4,0.5,1,2,0.5,1,2,0.5,2,2,1,2,3,5
12694,James Johnson,29-302,F,12/18/16,MIA,,BOS,L,0,19,3,4,0.75,2,3,0.667,1,1,1,0,0,,0,2,2
12695,James Johnson,29-336,F,1/21/17,MIA,,MIL,W,0,34,3,12,0.25,3,8,0.375,0,4,0,1,1,1,1,2,3
12696,Joe Johnson,35-123,G-F,10/30/16,UTA,@,LAC,L,1,25,3,9,0.333,2,7,0.286,1,2,0.5,0,0,,0,1,1
12697,Joe Johnson,35-187,G-F,1/2/17,UTA,@,BRK,W,0,21,3,6,0.5,2,3,0.667,1,3,0.333,0,0,,0,4,4
12698,Joe Johnson,35-168,G-F,12/14/16,UTA,,OKC,W,0,21,3,7,0.429,2,5,0.4,1,2,0.5,0,0,,0,4,4
12699,Joe Johnson,35-177,G-F,12/23/16,UTA,,TOR,L,0,16,3,7,0.429,2,5,0.4,1,2,0.5,0,0,,0,0,0
12700,Joe Johnson,35-211,G-F,1/26/17,UTA,,LAL,W,0,16,3,4,0.75,3,3,1,0,1,0,1,1,1,0,2,2
12701,Joe Johnson,35-168,G-F,12/14/16,UTA,,OKC,W,0,21,3,7,0.429,2,5,0.4,1,2,0.5,0,0,,0,4,4
12702,Stanley Johnson,20-244,F,1/28/17,DET,@,MIA,L,0,16,3,4,0.75,2,3,0.667,1,1,1,0,1,0,0,1,1
12703,Stanley Johnson,20-204,F,12/19/16,DET,@,CHI,L,0,24,3,9,0.333,2,5,0.4,1,4,0.25,0,0,,2,2,4
12704,Stanley Johnson,20-255,F,2/8/17,DET,,LAL,W,0,18,2,3,0.667,2,2,1,0,1,0,3,3,1,0,2,2
12705,Stanley Johnson,20-234,F,1/18/17,DET,,ATL,W,0,32,3,5,0.6,2,4,0.5,1,1,1,0,0,,2,2,4
12706,Stanley Johnson,20-273,F,2/26/17,DET,,BOS,L,0,12,2,2,1,1,1,1,1,1,1,2,2,1,0,2,2
12707,Stanley Johnson,20-199,F,12/14/16,DET,@,DAL,W,0,15,1,4,0.25,0,2,0,1,2,0.5,4,4,1,1,1,2
12708,Stanley Johnson,20-270,F,2/23/17,DET,,CHO,W,0,16,3,5,0.6,2,2,1,1,3,0.333,0,0,,0,2,2
12709,Wesley Johnson,29-209,F-G,2/5/17,LAC,@,BOS,L,0,11,3,4,0.75,2,2,1,1,2,0.5,0,0,,0,2,2
12710,Wesley Johnson,29-168,F-G,12/26/16,LAC,,DEN,L,1,20,2,5,0.4,1,1,1,1,4,0.25,2,4,0.5,0,2,2
12711,Wesley Johnson,29-149,F-G,12/7/16,LAC,,GSW,L,0,15,1,4,0.25,0,2,0,1,2,0.5,4,4,1,2,2,4
12712,Nikola Jokic,21-280,C-F,11/25/16,DEN,,OKC,L,0,29,3,7,0.429,2,5,0.4,1,2,0.5,0,0,,3,3,6
12713,Terrence Jones,25-009,F,1/18/17,NOP,,ORL,W,0,18,3,6,0.5,2,4,0.5,1,2,0.5,0,0,,0,5,5
12714,Terrence Jones,24-304,F,11/8/16,NOP,@,SAC,L,0,26,3,6,0.5,3,6,0.5,0,0,,1,2,0.5,1,4,5
12715,Terrence Jones,24-315,F,11/19/16,NOP,,CHO,W,0,20,2,8,0.25,2,6,0.333,0,2,0,3,4,0.75,0,4,4
12716,Terrence Jones,24-298,F,11/2/16,NOP,@,MEM,L,0,28,3,8,0.375,2,5,0.4,1,3,0.333,0,0,,2,8,10
12717,Terrence Jones,24-293,F,10/28/16,NOP,,GSW,L,0,13,3,5,0.6,3,4,0.75,0,1,0,1,2,0.5,1,1,2
12718,Tyus Jones,20-302,G,3/8/17,MIN,,LAC,W,0,18,3,4,0.75,2,2,1,1,2,0.5,0,0,,0,2,2
12719,Tyus Jones,20-244,G,1/9/17,MIN,,DAL,W,0,11,3,3,1,2,2,1,1,1,1,0,0,,1,0,1
12720,DeAndre Jordan,28-116,C,11/14/16,LAC,,BRK,W,1,25,3,6,0.5,3,6,0.5,0,0,,1,2,0.5,5,9,14
12721,DeAndre Jordan,28-101,C,10/30/16,LAC,,UTA,W,1,28,3,10,0.3,3,10,0.3,0,0,,1,2,0.5,6,10,16
12722,DeAndre Jordan,28-209,C,2/15/17,LAC,,ATL,W,1,29,3,4,0.75,3,4,0.75,0,0,,1,2,0.5,3,13,16
12723,DeAndre Jordan,28-157,C,12/25/16,LAC,@,LAL,L,1,28,3,4,0.75,3,4,0.75,0,0,,1,4,0.25,1,9,10
12724,DeAndre Jordan,28-171,C,1/8/17,LAC,,MIA,W,1,34,2,4,0.5,2,4,0.5,0,0,,3,8,0.375,2,16,18
12725,DeAndre Jordan,28-155,C,12/23/16,LAC,,DAL,L,1,34,3,7,0.429,3,7,0.429,0,0,,1,4,0.25,3,14,17
12726,DeAndre Jordan,28-186,C,1/23/17,LAC,@,ATL,W,1,35,1,1,1,1,1,1,0,0,,5,8,0.625,3,9,12
12727,Cory Joseph,25-143,G,1/10/17,TOR,,BOS,W,0,24,2,5,0.4,1,3,0.333,1,2,0.5,2,2,1,0,1,1
12728,Cory Joseph,25-107,G,12/5/16,TOR,,CLE,L,0,13,3,4,0.75,2,3,0.667,1,1,1,0,0,,0,0,0
12729,Frank Kaminsky,23-256,F-C,12/16/16,CHO,@,BOS,L,0,20,3,10,0.3,2,5,0.4,1,5,0.2,0,0,,2,3,5
12730,Frank Kaminsky,23-287,F-C,1/16/17,CHO,@,BOS,L,0,19,3,6,0.5,2,4,0.5,1,2,0.5,0,0,,0,1,1
12731,Frank Kaminsky,23-276,F-C,1/5/17,CHO,@,DET,L,0,20,3,6,0.5,2,4,0.5,1,2,0.5,0,0,,0,4,4
12732,Michael Kidd-Gilchrist,23-157,F,3/2/17,CHO,@,PHO,L,1,29,3,7,0.429,3,7,0.429,0,0,,1,2,0.5,5,3,8
12733,Michael Kidd-Gilchrist,23-033,F,10/29/16,CHO,,BOS,L,1,25,2,5,0.4,2,5,0.4,0,0,,3,4,0.75,1,3,4
12734,Michael Kidd-Gilchrist,23-131,F,2/4/17,CHO,@,UTA,L,1,29,3,6,0.5,3,6,0.5,0,0,,1,2,0.5,0,6,6
12735,Michael Kidd-Gilchrist,23-053,F,11/18/16,CHO,,ATL,W,1,35,3,10,0.3,3,10,0.3,0,0,,1,1,1,2,3,5
12736,Sean Kilpatrick,26-347,G,12/18/16,BRK,@,PHI,L,1,26,2,5,0.4,2,3,0.667,0,2,0,3,4,0.75,0,4,4
12737,Sean Kilpatrick,27-011,G,1/17/17,BRK,,TOR,L,0,26,1,7,0.143,0,4,0,1,3,0.333,4,4,1,0,1,1
12738,Sean Kilpatrick,26-359,G,12/30/16,BRK,@,WAS,L,1,23,2,6,0.333,2,5,0.4,0,1,0,3,3,1,0,2,2
12739,Sean Kilpatrick,26-308,G,11/9/16,BRK,@,NYK,L,1,28,2,9,0.222,1,5,0.2,1,4,0.25,2,4,0.5,0,4,4
12740,Sean Kilpatrick,27-040,G,2/15/17,BRK,,MIL,L,0,19,3,9,0.333,2,4,0.5,1,5,0.2,0,0,,0,1,1
12741,Brandon Knight,24-329,G,10/26/16,PHO,,SAC,L,0,26,1,8,0.125,1,5,0.2,0,3,0,5,6,0.833,0,1,1
12742,Brandon Knight,25-027,G,12/29/16,PHO,,TOR,W,0,9,3,5,0.6,2,4,0.5,1,1,1,0,0,,0,2,2
12743,Brandon Knight,25-009,G,12/11/16,PHO,,NOP,L,0,16,3,6,0.5,3,5,0.6,0,1,0,1,2,0.5,0,2,2
12744,Kyle Korver,35-260,G-F,12/2/16,ATL,,DET,L,1,34,2,8,0.25,2,5,0.4,0,3,0,3,4,0.75,0,2,2
12745,Kyle Korver,35-275,G-F,12/17/16,ATL,,CHO,L,0,20,3,8,0.375,2,3,0.667,1,5,0.2,0,0,,0,4,4
12746,Kyle Korver,35-267,G-F,12/9/16,ATL,@,MIL,W,0,33,2,6,0.333,1,1,1,1,5,0.2,2,2,1,0,3,3
12747,Kosta Koufos,27-317,C,1/6/17,SAC,,LAC,L,0,12,3,4,0.75,3,4,0.75,0,0,,1,2,0.5,1,2,3
12748,Kosta Koufos,27-332,C,1/21/17,SAC,@,CHI,L,1,25,3,4,0.75,3,4,0.75,0,0,,1,1,1,1,5,6
12749,Mindaugas Kuzminskas,27-100,F,1/27/17,NYK,,CHO,W,0,18,3,7,0.429,3,6,0.5,0,1,0,1,1,1,2,2,4
12750,Mindaugas Kuzminskas,27-006,F,10/25/16,NYK,@,CLE,L,0,9,3,5,0.6,2,2,1,1,3,0.333,0,0,,0,1,1
12751,Mindaugas Kuzminskas,27-079,F,1/6/17,NYK,@,MIL,W,0,13,3,5,0.6,2,2,1,1,3,0.333,0,0,,0,1,1
12752,Mindaugas Kuzminskas,27-094,F,1/21/17,NYK,,PHO,L,0,18,3,7,0.429,2,4,0.5,1,3,0.333,0,0,,0,1,1
12753,Skal Labissiere,20-358,F,3/11/17,SAC,,DEN,L,0,20,3,7,0.429,3,7,0.429,0,0,,1,5,0.2,2,3,5
12754,Jeremy Lamb,24-215,G-F,12/31/16,CHO,,CLE,L,0,18,3,5,0.6,2,2,1,1,3,0.333,0,0,,0,2,2
12755,Jeremy Lamb,24-247,G-F,2/1/17,CHO,@,GSW,L,0,24,3,11,0.273,3,8,0.375,0,3,0,1,2,0.5,0,7,7
12756,Jeremy Lamb,24-271,G-F,2/25/17,CHO,@,SAC,W,0,18,3,8,0.375,2,4,0.5,1,4,0.25,0,0,,0,4,4
12757,Jeremy Lamb,24-207,G-F,12/23/16,CHO,,CHI,W,0,17,2,6,0.333,2,4,0.5,0,2,0,3,3,1,0,3,3
12758,Nicolas Laprovittola,26-306,G,12/2/16,SAS,,WAS,W,1,20,2,5,0.4,1,2,0.5,1,3,0.333,2,2,1,0,1,1
12759,Nicolas Laprovittola,26-304,G,11/30/16,SAS,@,DAL,W,1,19,3,6,0.5,2,3,0.667,1,3,0.333,0,0,,0,1,1
12760,Nicolas Laprovittola,26-272,G,10/29/16,SAS,,NOP,W,0,22,2,5,0.4,2,2,1,0,3,0,3,3,1,0,4,4
12761,Joffrey Lauvergne,25-129,C-F,2/6/17,OKC,@,IND,L,0,20,3,5,0.6,3,4,0.75,0,1,0,1,2,0.5,2,4,6
12762,Joffrey Lauvergne,25-128,C-F,2/5/17,OKC,,POR,W,0,17,3,6,0.5,2,4,0.5,1,2,0.5,0,0,,4,5,9
12763,Joffrey Lauvergne,25-159,C-F,3/8/17,CHI,@,ORL,L,0,29,2,6,0.333,1,3,0.333,1,3,0.333,2,4,0.5,2,6,8
12764,Joffrey Lauvergne,25-072,C-F,12/11/16,OKC,,BOS,W,0,21,3,10,0.3,3,7,0.429,0,3,0,1,4,0.25,2,5,7
12765,Joffrey Lauvergne,25-051,C-F,11/20/16,OKC,,IND,L,0,26,3,5,0.6,2,2,1,1,3,0.333,0,1,0,2,5,7
12766,Ty Lawson,29-093,G,2/4/17,SAC,,GSW,W,0,20,3,7,0.429,2,4,0.5,1,3,0.333,0,0,,0,1,1
12767,Ty Lawson,29-136,G,3/19/17,SAC,@,SAS,L,0,21,3,8,0.375,3,7,0.429,0,1,0,1,1,1,0,2,2
12768,Ty Lawson,28-359,G,10/27/16,SAC,,SAS,L,1,36,3,7,0.429,3,5,0.6,0,2,0,1,2,0.5,1,3,4
12769,Jake Layman,22-255,F,11/17/16,POR,@,HOU,L,0,17,1,4,0.25,0,1,0,1,3,0.333,4,5,0.8,0,2,2
12770,Courtney Lee,31-121,G,2/1/17,NYK,@,BRK,W,1,28,3,7,0.429,3,5,0.6,0,2,0,1,2,0.5,2,2,4
12771,Courtney Lee,31-105,G,1/16/17,NYK,,ATL,L,0,21,3,7,0.429,2,3,0.667,1,4,0.25,0,0,,0,2,2
12772,Courtney Lee,31-029,G,11/1/16,NYK,@,DET,L,1,29,3,7,0.429,2,4,0.5,1,3,0.333,0,0,,0,2,2
12773,Courtney Lee,31-042,G,11/14/16,NYK,,DAL,W,1,32,3,7,0.429,2,4,0.5,1,3,0.333,0,0,,0,2,2
12774,Courtney Lee,31-058,G,11/30/16,NYK,@,MIN,W,1,8,3,3,1,2,2,1,1,1,1,0,0,,0,1,1
12775,Courtney Lee,31-078,G,12/20/16,NYK,,IND,W,1,37,2,7,0.286,1,4,0.25,1,3,0.333,2,2,1,1,3,4
12776,Courtney Lee,31-100,G,1/11/17,NYK,@,PHI,L,1,27,3,7,0.429,3,4,0.75,0,3,0,1,1,1,1,1,2
12777,David Lee,33-215,F,11/30/16,SAS,@,DAL,W,0,22,3,6,0.5,3,6,0.5,0,0,,1,2,0.5,0,5,5
12778,David Lee,33-230,F,12/15/16,SAS,@,PHO,W,0,19,3,7,0.429,3,7,0.429,0,0,,1,1,1,1,7,8
12779,David Lee,33-277,F,1/31/17,SAS,,OKC,W,0,26,3,7,0.429,3,7,0.429,0,0,,1,2,0.5,2,5,7
12780,Alex Len,23-210,C,1/12/17,PHO,,DAL,L,0,10,3,4,0.75,3,4,0.75,0,0,,1,2,0.5,0,3,3
12781,Alex Len,23-153,C,11/16/16,PHO,@,DEN,L,0,21,2,4,0.5,2,4,0.5,0,0,,3,4,0.75,0,4,4
12782,Meyers Leonard,24-269,C-F,11/22/16,POR,@,NYK,L,0,19,2,9,0.222,1,2,0.5,1,7,0.143,2,2,1,0,1,1
12783,Meyers Leonard,24-294,C-F,12/17/16,POR,@,GSW,L,0,17,2,6,0.333,1,3,0.333,1,3,0.333,2,2,1,0,1,1
12784,Meyers Leonard,25-001,C-F,2/28/17,POR,@,DET,L,0,18,3,6,0.5,2,3,0.667,1,3,0.333,0,0,,0,4,4
12785,Meyers Leonard,24-312,C-F,1/4/17,POR,@,GSW,L,0,11,1,2,0.5,1,2,0.5,0,0,,5,6,0.833,0,1,1
12786,Jon Leuer,27-167,F,10/28/16,DET,,ORL,W,0,28,3,7,0.429,2,5,0.4,1,2,0.5,0,0,,2,7,9
12787,Jon Leuer,27-305,F,3/15/17,DET,,UTA,L,1,30,3,8,0.375,2,7,0.286,1,1,1,0,0,,1,4,5
12788,Caris LeVert,22-195,G-F,3/8/17,BRK,@,ATL,L,1,24,3,6,0.5,2,2,1,1,4,0.25,0,0,,0,3,3
12789,Caris LeVert,22-191,G-F,3/4/17,BRK,@,POR,L,1,24,3,7,0.429,3,5,0.6,0,2,0,1,2,0.5,0,2,2
12790,Caris LeVert,22-109,G-F,12/12/16,BRK,@,HOU,L,0,15,2,5,0.4,0,1,0,2,4,0.5,1,2,0.5,1,1,2
12791,DeAndre Liggins,28-283,G,1/8/17,CLE,@,PHO,W,1,25,3,4,0.75,2,3,0.667,1,1,1,0,0,,0,1,1
12792,Jeremy Lin,28-185,G,2/24/17,BRK,@,DEN,L,1,15,2,3,0.667,1,2,0.5,1,1,1,2,2,1,0,2,2
12793,Jeremy Lin,28-192,G,3/3/17,BRK,@,UTA,L,1,16,3,7,0.429,2,5,0.4,1,2,0.5,0,0,,0,3,3
12794,Shaun Livingston,31-117,G,1/6/17,GSW,,MEM,L,0,16,3,4,0.75,3,4,0.75,0,0,,1,2,0.5,0,2,2
12795,Brook Lopez,28-208,C,10/26/16,BRK,@,BOS,L,1,21,1,7,0.143,0,5,0,1,2,0.5,4,4,1,2,3,5
12796,Robin Lopez,28-308,C,2/3/17,CHI,@,HOU,L,1,41,3,8,0.375,3,8,0.375,0,0,,1,2,0.5,4,7,11
12797,Robin Lopez,28-301,C,1/27/17,CHI,,MIA,L,1,18,3,6,0.5,3,6,0.5,0,0,,1,1,1,1,1,2
12798,Robin Lopez,28-248,C,12/5/16,CHI,,POR,L,1,33,2,6,0.333,2,6,0.333,0,0,,3,4,0.75,7,7,14
12799,Timothe Luwawu-Cabarrot,21-211,F,12/6/16,PHI,@,MEM,L,0,16,3,6,0.5,2,4,0.5,1,2,0.5,0,2,0,0,2,2
12800,Timothe Luwawu-Cabarrot,21-296,F,3/1/17,PHI,@,MIA,L,0,24,1,5,0.2,1,4,0.25,0,1,0,5,6,0.833,0,4,4
12801,Timothe Luwawu-Cabarrot,21-260,F,1/24/17,PHI,,LAC,W,0,13,2,2,1,1,1,1,1,1,1,2,2,1,0,1,1
12802,Timothe Luwawu-Cabarrot,21-268,F,2/1/17,PHI,@,DAL,L,1,23,3,5,0.6,2,3,0.667,1,2,0.5,0,0,,0,4,4
12803,Trey Lyles,21-082,F,1/26/17,UTA,,LAL,W,0,19,2,7,0.286,1,4,0.25,1,3,0.333,2,2,1,0,3,3
12804,Trey Lyles,21-002,F,11/7/16,UTA,@,PHI,W,0,31,2,9,0.222,1,6,0.167,1,3,0.333,2,2,1,0,1,1
12805,Trey Lyles,21-046,F,12/21/16,UTA,,SAC,L,0,16,3,8,0.375,2,4,0.5,1,4,0.25,0,0,,1,2,3
12806,Trey Lyles,21-093,F,2/6/17,UTA,@,ATL,W,0,11,3,7,0.429,2,4,0.5,1,3,0.333,0,0,,0,4,4
12807,Trey Lyles,20-360,F,10/30/16,UTA,@,LAC,L,0,19,3,8,0.375,2,4,0.5,1,4,0.25,0,0,,2,3,5
12808,Trey Lyles,21-088,F,2/1/17,UTA,,MIL,W,0,15,3,6,0.5,2,4,0.5,1,2,0.5,0,0,,0,3,3
12809,Shelvin Mack,26-196,G,11/4/16,UTA,,SAS,L,0,21,2,8,0.25,1,6,0.167,1,2,0.5,2,2,1,0,1,1
12810,Shelvin Mack,26-220,G,11/28/16,UTA,@,MIN,W,0,14,3,4,0.75,2,3,0.667,1,1,1,0,0,,0,1,1
12811,Ian Mahinmi,30-133,C,3/18/17,WAS,@,CHO,L,0,21,2,5,0.4,2,5,0.4,0,0,,3,4,0.75,2,5,7
12812,Ian Mahinmi,30-113,C,2/26/17,WAS,,UTA,L,0,16,2,3,0.667,2,3,0.667,0,0,,3,3,1,2,0,2
12813,Ian Mahinmi,30-123,C,3/8/17,WAS,@,DEN,W,0,15,3,3,1,3,3,1,0,0,,1,2,0.5,1,3,4
12814,Thon Maker,20-009,F-C,3/6/17,MIL,@,PHI,W,1,15,2,7,0.286,1,3,0.333,1,4,0.25,2,2,1,1,2,3
12815,Thon Maker,19-351,F-C,2/10/17,MIL,,LAL,L,1,17,3,6,0.5,2,2,1,1,4,0.25,0,0,,1,5,6
12816,Boban Marjanovic,28-084,C,11/7/16,DET,@,LAC,L,0,8,1,4,0.25,1,4,0.25,0,0,,5,5,1,2,0,2
12817,Jarell Martin,22-193,F,12/3/16,MEM,,LAL,W,0,20,1,3,0.333,0,1,0,1,2,0.5,4,4,1,0,2,2
12818,Jarell Martin,22-208,F,12/18/16,MEM,,UTA,L,0,13,3,7,0.429,3,6,0.5,0,1,0,1,1,1,2,1,3
12819,Jarell Martin,22-161,F,11/1/16,MEM,@,MIN,L,1,26,3,7,0.429,3,5,0.6,0,2,0,1,3,0.333,0,3,3
12820,Wesley Matthews,30-133,G,2/24/17,DAL,@,MIN,L,1,37,2,9,0.222,1,4,0.25,1,5,0.2,2,2,1,1,4,5
12821,Wesley Matthews,30-021,G,11/4/16,DAL,,POR,L,1,29,1,6,0.167,0,4,0,1,2,0.5,4,5,0.8,0,0,0
12822,Wesley Matthews,30-148,G,3/11/17,DAL,,PHO,L,1,35,1,6,0.167,0,2,0,1,4,0.25,4,4,1,3,4,7
12823,Luc Mbah a Moute,30-086,F,12/4/16,LAC,,IND,L,1,27,3,5,0.6,2,3,0.667,1,2,0.5,0,0,,3,1,4
12824,Luc Mbah a Moute,30-070,F,11/18/16,LAC,@,SAC,W,1,26,3,4,0.75,3,3,1,0,1,0,1,4,0.25,0,1,1
12825,Luc Mbah a Moute,30-104,F,12/22/16,LAC,,SAS,W,1,15,3,5,0.6,2,4,0.5,1,1,1,0,0,,0,1,1
12826,Luc Mbah a Moute,30-188,F,3/16/17,LAC,@,DEN,L,1,20,3,9,0.333,2,8,0.25,1,1,1,0,0,,2,4,6
12827,Luc Mbah a Moute,30-170,F,2/26/17,LAC,,CHO,W,1,35,3,6,0.5,2,5,0.4,1,1,1,0,0,,0,0,0
12828,Luc Mbah a Moute,30-063,F,11/11/16,LAC,@,OKC,W,1,31,3,6,0.5,2,4,0.5,1,2,0.5,0,0,,2,4,6
12829,James Michael McAdoo,24-042,F,2/15/17,GSW,,SAC,W,0,14,3,6,0.5,3,6,0.5,0,0,,1,2,0.5,0,2,2
12830,Sheldon McClellan,23-311,G,10/27/16,WAS,@,ATL,L,0,4,3,4,0.75,2,2,1,1,2,0.5,0,0,,0,0,0
12831,Sheldon McClellan,24-000,G,12/21/16,WAS,@,CHI,W,0,19,2,3,0.667,2,3,0.667,0,0,,3,4,0.75,0,2,2
12832,T.J. McConnell,24-306,G,1/25/17,PHI,@,MIL,W,1,30,3,5,0.6,2,4,0.5,1,1,1,0,0,,0,3,3
12833,T.J. McConnell,24-354,G,3/14/17,PHI,@,GSW,L,1,31,3,7,0.429,3,7,0.429,0,0,,1,2,0.5,0,7,7
12834,T.J. McConnell,24-337,G,2/25/17,PHI,@,NYK,L,1,33,3,4,0.75,2,3,0.667,1,1,1,0,0,,1,3,4
12835,Chris McCullough,21-294,F,11/25/16,BRK,@,IND,L,0,7,3,4,0.75,3,4,0.75,0,0,,1,1,1,1,2,3
12836,K.J. McDaniels,23-341,G-F,1/15/17,HOU,@,BRK,W,0,6,2,2,1,1,1,1,1,1,1,2,2,1,0,1,1
12837,Doug McDermott,24-360,F,12/28/16,CHI,,BRK,W,0,30,2,6,0.333,2,4,0.5,0,2,0,3,3,1,1,3,4
12838,Doug McDermott,25-006,F,1/9/17,CHI,,OKC,L,0,25,2,6,0.333,1,4,0.25,1,2,0.5,2,2,1,0,2,2
12839,Doug McDermott,25-014,F,1/17/17,CHI,,DAL,L,0,22,3,10,0.3,2,6,0.333,1,4,0.25,0,0,,0,6,6
12840,JaVale McGee,28-307,C,11/21/16,GSW,@,IND,W,0,14,3,4,0.75,3,4,0.75,0,0,,1,4,0.25,1,4,5
12841,JaVale McGee,29-037,C,2/25/17,GSW,,BRK,W,0,12,3,10,0.3,3,10,0.3,0,0,,1,3,0.333,6,3,9
12842,JaVale McGee,29-010,C,1/29/17,GSW,@,POR,W,0,9,3,3,1,3,3,1,0,0,,1,3,0.333,1,2,3
12843,Rodney McGruder,25-136,G,12/12/16,MIA,,WAS,W,1,30,3,5,0.6,2,3,0.667,1,2,0.5,0,0,,1,2,3
12844,Rodney McGruder,25-225,G,3/11/17,MIA,,TOR,W,1,26,3,5,0.6,2,2,1,1,3,0.333,0,2,0,0,1,1
12845,Rodney McGruder,25-168,G,1/13/17,MIA,@,MIL,L,1,20,3,5,0.6,2,2,1,1,3,0.333,0,0,,0,0,0
12846,Rodney McGruder,25-151,G,12/27/16,MIA,,OKC,L,1,36,3,5,0.6,2,3,0.667,1,2,0.5,0,0,,1,0,1
12847,Rodney McGruder,25-127,G,12/3/16,MIA,@,POR,L,1,39,3,9,0.333,2,5,0.4,1,4,0.25,0,0,,1,3,4
12848,Rodney McGruder,25-142,G,12/18/16,MIA,,BOS,L,1,30,2,3,0.667,1,2,0.5,1,1,1,2,2,1,1,4,5
12849,Rodney McGruder,25-218,G,3/4/17,MIA,,CLE,W,1,20,2,4,0.5,1,1,1,1,3,0.333,2,3,0.667,1,1,2
12850,Rodney McGruder,25-180,G,1/25/17,MIA,@,BRK,W,1,23,3,6,0.5,2,4,0.5,1,2,0.5,0,0,,1,4,5
12851,Rodney McGruder,25-231,G,3/17/17,MIA,,MIN,W,1,20,3,8,0.375,2,3,0.667,1,5,0.2,0,0,,2,1,3
12852,Ben McLemore,23-316,G,12/23/16,SAC,@,MIN,W,1,16,2,4,0.5,1,1,1,1,3,0.333,2,3,0.667,0,3,3
12853,Jordan McRae,25-273,G,12/26/16,CLE,@,DET,L,0,6,1,2,0.5,0,1,0,1,1,1,4,4,1,0,2,2
12854,Jordan McRae,25-242,G,11/25/16,CLE,,DAL,W,0,14,3,7,0.429,3,5,0.6,0,2,0,1,1,1,0,2,2
12855,Jordan McRae,25-235,G,11/18/16,CLE,,DET,W,0,15,2,7,0.286,1,6,0.167,1,1,1,2,2,1,0,2,2
12856,Josh McRoberts,29-282,F,12/6/16,MIA,,NYK,L,1,29,2,6,0.333,1,4,0.25,1,2,0.5,2,2,1,3,5,8
12857,Josh McRoberts,29-288,F,12/12/16,MIA,,WAS,W,1,18,3,8,0.375,2,5,0.4,1,3,0.333,0,0,,3,5,8
12858,Jodie Meeks,29-105,G,12/4/16,ORL,@,DET,W,0,16,3,8,0.375,3,5,0.6,0,3,0,1,1,1,1,0,1
12859,Salah Mejri,30-184,C,12/16/16,DAL,@,UTA,L,1,21,3,3,1,3,3,1,0,0,,1,1,1,2,3,5
12860,Salah Mejri,30-180,C,12/12/16,DAL,,DEN,W,1,22,3,3,1,3,3,1,0,0,,1,2,0.5,4,4,8
12861,C.J. Miles,29-326,G-F,3/10/17,IND,@,MIL,L,1,26,3,7,0.429,2,2,1,1,5,0.2,0,0,,0,2,2
12862,Patty Mills,28-110,G,11/29/16,SAS,,ORL,L,0,19,2,5,0.4,1,2,0.5,1,3,0.333,2,2,1,0,2,2
12863,Paul Millsap,31-320,F,12/26/16,ATL,@,MIN,L,1,25,2,13,0.154,2,10,0.2,0,3,0,3,4,0.75,2,3,5
12864,Nikola Mirotic,25-321,F,12/28/16,CHI,,BRK,W,0,25,1,7,0.143,0,3,0,1,4,0.25,4,4,1,1,3,4
12865,Nikola Mirotic,25-280,F,11/17/16,CHI,@,UTA,W,0,21,3,6,0.5,2,3,0.667,1,3,0.333,0,0,,0,3,3
12866,Greg Monroe,26-194,C-F,12/15/16,MIL,,CHI,W,0,22,3,7,0.429,3,7,0.429,0,0,,1,1,1,0,5,5
12867,Greg Monroe,26-161,C-F,11/12/16,MIL,,MEM,W,0,21,2,3,0.667,2,3,0.667,0,0,,3,4,0.75,1,6,7
12868,Greg Monroe,26-230,C-F,1/20/17,MIL,@,ORL,L,0,14,2,7,0.286,2,7,0.286,0,0,,3,6,0.5,4,1,5
12869,E'Twaun Moore,27-258,G,11/12/16,NOP,,LAL,L,1,24,3,10,0.3,2,8,0.25,1,2,0.5,0,0,,2,1,3
12870,E'Twaun Moore,27-314,G,1/7/17,NOP,@,BOS,L,0,29,3,8,0.375,3,4,0.75,0,4,0,1,1,1,2,0,2
12871,E'Twaun Moore,28-021,G,3/21/17,NOP,,MEM,W,0,25,3,7,0.429,2,4,0.5,1,3,0.333,0,0,,0,0,0
12872,Marcus Morris,27-096,F,12/7/16,DET,@,CHO,L,1,34,3,10,0.3,2,7,0.286,1,3,0.333,0,0,,2,8,10
12873,Marcus Morris,27-152,F,2/1/17,DET,,NOP,W,1,34,3,9,0.333,2,5,0.4,1,4,0.25,0,0,,1,3,4
12874,Marcus Morris,27-082,F,11/23/16,DET,,MIA,W,1,26,2,8,0.25,2,7,0.286,0,1,0,3,4,0.75,0,1,1
12875,Marcus Morris,27-077,F,11/18/16,DET,@,CLE,L,1,31,3,11,0.273,2,7,0.286,1,4,0.25,0,0,,1,2,3
12876,Marcus Morris,27-075,F,11/16/16,DET,@,NYK,L,1,37,3,9,0.333,2,6,0.333,1,3,0.333,0,0,,0,3,3
12877,Marcus Morris,27-073,F,11/14/16,DET,,OKC,W,1,30,3,12,0.25,2,9,0.222,1,3,0.333,0,0,,1,5,6
12878,Marcus Morris,27-190,F,3/11/17,DET,,NYK,W,1,34,3,10,0.3,2,6,0.333,1,4,0.25,0,0,,1,4,5
12879,Markieff Morris,27-177,F,2/26/17,WAS,,UTA,L,1,29,3,11,0.273,3,9,0.333,0,2,0,1,1,1,0,4,4
12880,Markieff Morris,27-066,F,11/7/16,WAS,,HOU,L,1,33,3,14,0.214,2,12,0.167,1,2,0.5,0,0,,4,5,9
12881,Anthony Morrow,31-127,G,2/1/17,OKC,,CHI,L,0,24,3,11,0.273,2,5,0.4,1,6,0.167,0,0,,1,0,1
12882,Anthony Morrow,31-135,G,2/9/17,OKC,,CLE,W,0,8,3,7,0.429,2,2,1,1,5,0.2,0,0,,0,2,2
12883,Anthony Morrow,31-131,G,2/5/17,OKC,,POR,W,0,19,3,7,0.429,2,5,0.4,1,2,0.5,0,0,,0,0,0
12884,Donatas Motiejunas,26-145,F-C,2/12/17,NOP,@,SAC,L,0,22,2,6,0.333,2,3,0.667,0,3,0,3,4,0.75,1,7,8
12885,Timofey Mozgov,30-173,C,1/5/17,LAL,@,POR,L,1,11,3,5,0.6,3,5,0.6,0,0,,1,1,1,0,5,5
12886,Emmanuel Mudiay,20-270,G,11/30/16,DEN,,MIA,L,1,36,3,11,0.273,3,9,0.333,0,2,0,1,3,0.333,2,6,8
12887,Shabazz Muhammad,24-093,F-G,2/14/17,MIN,,CLE,L,0,15,2,5,0.4,2,3,0.667,0,2,0,3,5,0.6,0,1,1
12888,Shabazz Muhammad,24-061,F-G,1/13/17,MIN,,OKC,W,0,23,3,6,0.5,2,4,0.5,1,2,0.5,0,0,,0,1,1
12889,Shabazz Muhammad,24-038,F-G,12/21/16,MIN,@,ATL,W,0,19,3,10,0.3,2,7,0.286,1,3,0.333,0,0,,3,2,5
12890,Shabazz Muhammad,24-067,F-G,1/19/17,MIN,@,LAC,W,0,18,2,5,0.4,1,4,0.25,1,1,1,2,4,0.5,1,3,4
12891,Shabazz Muhammad,23-361,F-G,11/8/16,MIN,@,BRK,L,0,24,3,12,0.25,2,8,0.25,1,4,0.25,0,0,,2,2,4
12892,Jamal Murray,19-349,G,2/6/17,DEN,,DAL,W,0,19,3,9,0.333,2,7,0.286,1,2,0.5,0,0,,0,3,3
12893,Jamal Murray,19-263,G,11/12/16,DEN,,DET,L,0,20,3,6,0.5,2,3,0.667,1,3,0.333,0,0,,0,1,1
12894,Jamal Murray,19-309,G,12/28/16,DEN,,MIN,W,0,13,3,5,0.6,2,2,1,1,3,0.333,0,0,,0,1,1
12895,Mike Muscala,25-155,F-C,12/3/16,ATL,@,TOR,L,1,24,3,7,0.429,2,4,0.5,1,3,0.333,0,0,,2,2,4
12896,Mike Muscala,25-124,F-C,11/2/16,ATL,,LAL,L,0,15,3,3,1,2,2,1,1,1,1,0,0,,3,2,5
12897,Mike Muscala,25-229,F-C,2/15/17,ATL,@,LAC,L,0,11,3,4,0.75,3,4,0.75,0,0,,1,1,1,0,2,2
12898,Maurice Ndour,24-227,F,1/31/17,NYK,@,WAS,L,0,8,3,5,0.6,2,3,0.667,1,2,0.5,0,0,,1,1,2
12899,Jameer Nelson,34-300,G,12/5/16,DEN,@,PHI,W,0,30,3,8,0.375,3,5,0.6,0,3,0,1,2,0.5,1,4,5
12900,Jameer Nelson,34-278,G,11/13/16,DEN,@,POR,L,0,33,3,8,0.375,2,4,0.5,1,4,0.25,0,0,,1,3,4
12901,Raul Neto,24-296,G,3/11/17,UTA,@,OKC,L,0,13,3,4,0.75,3,4,0.75,0,0,,1,1,1,0,0,0
12902,Joakim Noah,31-326,C,1/16/17,NYK,,ATL,L,1,33,2,3,0.667,2,3,0.667,0,0,,3,5,0.6,7,10,17
12903,Joakim Noah,31-321,C,1/11/17,NYK,@,PHI,L,1,20,3,6,0.5,3,6,0.5,0,0,,1,1,1,3,3,6
12904,Joakim Noah,31-265,C,11/16/16,NYK,,DET,W,1,25,3,7,0.429,3,7,0.429,0,0,,1,6,0.167,7,8,15
12905,Nerlens Noel,22-300,C-F,2/4/17,PHI,@,MIA,L,1,20,2,6,0.333,2,6,0.333,0,0,,3,4,0.75,1,6,7
12906,Lucas Nogueira,24-103,C,11/6/16,TOR,,SAC,L,0,21,3,3,1,3,3,1,0,0,,1,2,0.5,3,2,5
12907,Lucas Nogueira,24-189,C,1/31/17,TOR,,NOP,W,0,22,3,4,0.75,3,4,0.75,0,0,,1,2,0.5,4,4,8
12908,Lucas Nogueira,24-203,C,2/14/17,TOR,@,CHI,L,0,25,3,4,0.75,3,4,0.75,0,0,,1,3,0.333,0,3,3
12909,Lucas Nogueira,24-168,C,1/10/17,TOR,,BOS,W,0,21,3,4,0.75,3,3,1,0,1,0,1,2,0.5,2,1,3
12910,Dirk Nowitzki,38-191,F,12/27/16,DAL,,HOU,L,1,15,2,8,0.25,2,8,0.25,0,0,,3,4,0.75,1,2,3
12911,Jusuf Nurkic,22-135,C,1/5/17,DEN,,SAS,L,0,21,3,4,0.75,3,4,0.75,0,0,,1,2,0.5,1,5,6
12912,Jusuf Nurkic,22-200,C,3/11/17,POR,,WAS,L,1,28,2,8,0.25,2,8,0.25,0,0,,3,4,0.75,2,5,7
12913,David Nwaba,24-048,PG,3/3/17,LAL,,BOS,L,0,20,2,2,1,2,2,1,0,0,,3,4,0.75,0,2,2
12914,David Nwaba,24-064,PG,3/19/17,LAL,,CLE,L,0,22,3,5,0.6,3,5,0.6,0,0,,1,2,0.5,1,4,5
12915,Kyle O'Quinn,26-223,F-C,11/4/16,NYK,@,CHI,W,0,13,3,7,0.429,3,7,0.429,0,0,,1,2,0.5,2,1,3
12916,Kyle O'Quinn,26-342,F-C,3/3/17,NYK,@,PHI,L,0,17,2,4,0.5,2,4,0.5,0,0,,3,4,0.75,2,2,4
12917,Kyle O'Quinn,26-315,F-C,2/4/17,NYK,,CLE,L,0,13,3,6,0.5,3,6,0.5,0,0,,1,2,0.5,2,2,4
12918,Jahlil Okafor,21-056,C-F,2/9/17,PHI,@,ORL,W,1,22,3,8,0.375,3,8,0.375,0,0,,1,2,0.5,0,2,2
12919,Jahlil Okafor,20-338,C-F,11/17/16,PHI,@,MIN,L,0,22,2,5,0.4,2,5,0.4,0,0,,3,4,0.75,0,2,2
12920,Victor Oladipo,24-275,G,2/3/17,OKC,,MEM,W,1,35,3,14,0.214,2,9,0.222,1,5,0.2,0,0,,0,3,3
12921,Kelly Olynyk,25-318,C-F,3/3/17,BOS,@,LAL,W,0,14,3,9,0.333,3,5,0.6,0,4,0,1,1,1,1,1,2
12922,Kelly Olynyk,25-230,C-F,12/5/16,BOS,@,HOU,L,0,15,3,6,0.5,2,4,0.5,1,2,0.5,0,0,,1,4,5
12923,Kelly Olynyk,25-241,C-F,12/16/16,BOS,,CHO,W,0,18,2,5,0.4,0,2,0,2,3,0.667,1,2,0.5,0,3,3
12924,Kelly Olynyk,25-239,C-F,12/14/16,BOS,@,SAS,L,0,19,2,4,0.5,1,3,0.333,1,1,1,2,2,1,0,3,3
12925,Kelly Olynyk,25-290,C-F,2/3/17,BOS,,LAL,W,0,16,3,8,0.375,3,5,0.6,0,3,0,1,2,0.5,2,7,9
12926,Kelly Oubre,21-082,F,3/1/17,WAS,@,TOR,W,0,24,2,7,0.286,1,3,0.333,1,4,0.25,2,2,1,0,3,3
12927,Kelly Oubre,21-007,F,12/16/16,WAS,,DET,W,0,34,1,6,0.167,1,3,0.333,0,3,0,5,6,0.833,0,6,6
12928,Zaza Pachulia,32-297,C,12/3/16,GSW,,PHO,W,1,15,3,5,0.6,3,5,0.6,0,0,,1,3,0.333,0,3,3
12929,Zaza Pachulia,32-337,C,1/12/17,GSW,,DET,W,1,24,3,6,0.5,3,6,0.5,0,0,,1,2,0.5,0,5,5
12930,Zaza Pachulia,32-317,C,12/23/16,GSW,@,DET,W,1,19,2,2,1,2,2,1,0,0,,3,3,1,3,5,8
12931,Tony Parker,34-178,G,11/11/16,SAS,,DET,W,1,21,3,11,0.273,3,9,0.333,0,2,0,1,2,0.5,0,2,2
12932,Tony Parker,34-192,G,11/25/16,SAS,@,BOS,W,1,24,3,7,0.429,3,7,0.429,0,0,,1,1,1,0,2,2
12933,Tony Parker,34-255,G,1/27/17,SAS,@,NOP,L,1,22,2,7,0.286,2,6,0.333,0,1,0,3,4,0.75,0,1,1
12934,Chandler Parsons,28-067,F,12/31/16,MEM,@,SAC,W,1,16,3,7,0.429,2,3,0.667,1,4,0.25,0,0,,0,1,1
12935,Chandler Parsons,28-082,F,1/15/17,MEM,,CHI,L,1,19,2,6,0.333,1,3,0.333,1,3,0.333,2,2,1,0,1,1
12936,Chandler Parsons,28-129,F,3/3/17,MEM,@,DAL,L,1,24,3,11,0.273,2,7,0.286,1,4,0.25,0,0,,0,4,4
12937,Patrick Patterson,27-269,F,12/8/16,TOR,,MIN,W,0,30,2,10,0.2,0,2,0,2,8,0.25,1,4,0.25,1,4,5
12938,Patrick Patterson,27-321,F,1/29/17,TOR,,ORL,L,1,29,2,4,0.5,1,2,0.5,1,2,0.5,2,3,0.667,3,7,10
12939,Chris Paul,31-306,G,3/8/17,LAC,@,MIN,L,1,32,3,9,0.333,2,5,0.4,1,4,0.25,0,1,0,1,2,3
12940,Adreian Payne,25-270,F-C,11/15/16,MIN,,CHO,L,0,11,2,6,0.333,2,5,0.4,0,1,0,3,3,1,3,0,3
12941,Cameron Payne,22-177,G,2/1/17,OKC,,CHI,L,0,19,3,10,0.3,2,8,0.25,1,2,0.5,0,0,,0,0,0
12942,Cameron Payne,22-216,G,3/12/17,CHI,@,BOS,L,0,20,3,7,0.429,2,3,0.667,1,4,0.25,0,0,,0,2,2
12943,Elfrid Payton,22-359,G,2/15/17,ORL,,SAS,L,0,30,3,8,0.375,2,6,0.333,1,2,0.5,0,0,,1,2,3
12944,Elfrid Payton,22-292,G,12/10/16,ORL,,DEN,L,0,27,3,10,0.3,3,7,0.429,0,3,0,1,3,0.333,0,4,4
12945,Paul Pierce,39-068,F-G,12/20/16,LAC,,DEN,W,1,18,2,6,0.333,0,1,0,2,5,0.4,1,2,0.5,0,1,1
12946,Paul Pierce,39-156,F-G,3/18/17,LAC,,CLE,W,0,14,3,3,1,2,2,1,1,1,1,0,0,,1,5,6
12947,Mason Plumlee,26-314,C-F,1/13/17,POR,,ORL,L,1,28,2,7,0.286,2,7,0.286,0,0,,3,4,0.75,2,5,7
12948,Mason Plumlee,26-332,C-F,1/31/17,POR,,CHO,W,1,23,2,3,0.667,2,3,0.667,0,0,,3,6,0.5,3,8,11
12949,Mason Plumlee,26-246,C-F,11/6/16,POR,@,MEM,W,1,24,2,3,0.667,2,3,0.667,0,0,,3,6,0.5,1,5,6
12950,Mason Plumlee,26-260,C-F,11/20/16,POR,@,BRK,W,1,24,3,6,0.5,3,6,0.5,0,0,,1,3,0.333,2,6,8
12951,Mason Plumlee,26-317,C-F,1/16/17,POR,@,WAS,L,1,21,2,7,0.286,2,7,0.286,0,0,,3,3,1,2,3,5
12952,Miles Plumlee,28-141,C-F,1/20/17,MIL,@,ORL,L,0,16,2,5,0.4,2,5,0.4,0,0,,3,7,0.429,0,0,0
12953,Jakob Poeltl,21-013,C,10/28/16,TOR,,CLE,L,0,11,3,5,0.6,3,5,0.6,0,0,,1,1,1,4,3,7
12954,Otto Porter,23-266,F,2/24/17,WAS,@,PHI,L,1,36,3,9,0.333,2,4,0.5,1,5,0.2,0,0,,2,2,4
12955,Otto Porter,23-186,F,12/6/16,WAS,,ORL,L,1,27,3,4,0.75,2,2,1,1,2,0.5,0,0,,1,2,3
12956,Bobby Portis,22-015,F,2/25/17,CHI,@,CLE,W,1,19,2,6,0.333,1,3,0.333,1,3,0.333,2,2,1,1,2,3
12957,Bobby Portis,21-334,F,1/9/17,CHI,,OKC,L,0,10,3,7,0.429,2,4,0.5,1,3,0.333,0,0,,2,0,2
12958,Kristaps Porzingis,21-162,F-C,1/11/17,NYK,@,PHI,L,1,28,3,10,0.3,2,4,0.5,1,6,0.167,0,0,,0,2,2
12959,Dwight Powell,25-102,F-C,10/30/16,DAL,@,HOU,L,0,12,3,7,0.429,2,5,0.4,1,2,0.5,0,0,,0,2,2
12960,Dwight Powell,25-244,F-C,3/21/17,DAL,,GSW,L,0,8,3,5,0.6,3,3,1,0,2,0,1,2,0.5,1,0,1
12961,Dwight Powell,25-233,F-C,3/10/17,DAL,,BRK,W,0,20,1,2,0.5,1,2,0.5,0,0,,5,6,0.833,1,7,8
12962,Dwight Powell,25-107,F-C,11/4/16,DAL,,POR,L,0,23,2,3,0.667,2,3,0.667,0,0,,3,4,0.75,2,6,8
12963,Dwight Powell,25-186,F-C,1/22/17,DAL,,LAL,W,0,19,2,4,0.5,1,2,0.5,1,2,0.5,2,2,1,3,4,7
12964,Norman Powell,23-201,G,12/12/16,TOR,,MIL,W,0,8,3,4,0.75,2,3,0.667,1,1,1,0,0,,0,0,0
12965,Norman Powell,23-218,G,12/29/16,TOR,@,PHO,L,0,22,2,7,0.286,1,5,0.2,1,2,0.5,2,2,1,0,5,5
12966,Chasson Randle,24-029,G,3/6/17,NYK,@,ORL,W,0,26,2,7,0.286,2,6,0.333,0,1,0,3,3,1,1,4,5
12967,Chasson Randle,24-043,G,3/20/17,NYK,@,LAC,L,0,11,2,3,0.667,2,3,0.667,0,0,,3,4,0.75,1,0,1
12968,Julius Randle,22-104,F,3/13/17,LAL,@,DEN,L,1,24,3,8,0.375,2,6,0.333,1,2,0.5,0,0,,2,6,8
12969,Julius Randle,21-334,F,10/28/16,LAL,@,UTA,L,1,27,3,7,0.429,2,6,0.333,1,1,1,0,0,,1,3,4
12970,Julius Randle,22-049,F,1/17/17,LAL,,DEN,L,1,25,2,8,0.25,2,8,0.25,0,0,,3,3,1,3,4,7
12971,Zach Randolph,35-212,F,2/13/17,MEM,@,BRK,W,0,19,2,8,0.25,2,7,0.286,0,1,0,3,4,0.75,1,2,3
12972,Zach Randolph,35-145,F,12/8/16,MEM,,POR,W,0,17,2,10,0.2,2,9,0.222,0,1,0,3,6,0.5,4,5,9
12973,Willie Reed,26-261,F-C,2/1/17,MIA,,ATL,W,0,18,3,5,0.6,3,5,0.6,0,0,,1,2,0.5,1,3,4
12974,Willie Reed,26-296,F-C,3/8/17,MIA,,CHO,W,0,13,3,5,0.6,3,5,0.6,0,0,,1,4,0.25,2,4,6
12975,Willie Reed,26-165,F-C,10/28/16,MIA,,CHO,L,0,21,2,3,0.667,2,3,0.667,0,0,,3,4,0.75,2,1,3
12976,Josh Richardson,23-099,G,12/23/16,MIA,@,NOP,L,1,33,2,10,0.2,1,5,0.2,1,5,0.2,2,2,1,0,1,1
12977,Josh Richardson,23-053,G,11/7/16,MIA,@,OKC,L,0,25,3,8,0.375,2,4,0.5,1,4,0.25,0,0,,2,2,4
12978,Josh Richardson,23-169,G,3/3/17,MIA,@,ORL,L,0,24,1,3,0.333,0,1,0,1,2,0.5,4,4,1,1,3,4
12979,Josh Richardson,23-167,G,3/1/17,MIA,,PHI,W,0,24,3,8,0.375,2,5,0.4,1,3,0.333,0,0,,0,6,6
12980,Malachi Richardson,20-344,G,12/14/16,SAC,@,HOU,L,0,12,2,5,0.4,1,2,0.5,1,3,0.333,2,2,1,0,3,3
12981,Malachi Richardson,21-032,G,2/6/17,SAC,,CHI,L,0,8,2,5,0.4,2,3,0.667,0,2,0,3,3,1,0,0,0
12982,Malachi Richardson,20-361,G,12/31/16,SAC,,MEM,L,0,10,2,4,0.5,1,1,1,1,3,0.333,2,2,1,0,1,1
12983,Austin Rivers,24-217,G,3/6/17,LAC,,BOS,W,0,32,2,4,0.5,1,3,0.333,1,1,1,2,2,1,0,3,3
12984,Austin Rivers,24-191,G,2/8/17,LAC,@,NYK,W,1,36,3,10,0.3,2,7,0.286,1,3,0.333,0,1,0,0,4,4
12985,Austin Rivers,24-118,G,11/27/16,LAC,@,IND,L,0,25,2,5,0.4,1,3,0.333,1,2,0.5,2,3,0.667,0,1,1
12986,Austin Rivers,24-137,G,12/16/16,LAC,@,MIA,W,1,34,2,6,0.333,0,2,0,2,4,0.5,1,2,0.5,0,1,1
12987,Austin Rivers,24-102,G,11/11/16,LAC,@,OKC,W,0,18,2,5,0.4,2,3,0.667,0,2,0,3,7,0.429,1,0,1
12988,Austin Rivers,24-146,G,12/25/16,LAC,@,LAL,L,0,25,3,10,0.3,2,7,0.286,1,3,0.333,0,0,,1,1,2
12989,Andre Roberson,25-100,G-F,3/14/17,OKC,@,BRK,W,1,20,2,4,0.5,1,1,1,1,3,0.333,2,4,0.5,2,1,3
12990,Andre Roberson,25-095,G-F,3/9/17,OKC,,SAS,W,1,27,3,4,0.75,3,3,1,0,1,0,1,2,0.5,2,3,5
12991,Andre Roberson,25-009,G-F,12/13/16,OKC,@,POR,L,1,31,3,7,0.429,2,4,0.5,1,3,0.333,0,0,,1,3,4
12992,Andre Roberson,24-341,G-F,11/9/16,OKC,,TOR,L,1,23,3,7,0.429,2,5,0.4,1,2,0.5,0,0,,0,1,1
12993,Thomas Robinson,25-281,F,12/23/16,LAL,@,ORL,L,0,19,3,5,0.6,3,5,0.6,0,0,,1,2,0.5,5,6,11
12994,Thomas Robinson,25-295,F,1/6/17,LAL,,MIA,W,0,17,3,5,0.6,3,5,0.6,0,0,,1,6,0.167,3,6,9
12995,Sergio Rodriguez,30-157,G,11/16/16,PHI,,WAS,W,1,28,2,4,0.5,2,3,0.667,0,1,0,3,4,0.75,0,4,4
12996,Sergio Rodriguez,30-152,G,11/11/16,PHI,,IND,W,1,34,3,7,0.429,2,3,0.667,1,4,0.25,0,0,,1,1,2
12997,Sergio Rodriguez,30-164,G,11/23/16,PHI,,MEM,L,1,21,3,9,0.333,2,6,0.333,1,3,0.333,0,0,,0,0,0
12998,Sergio Rodriguez,30-146,G,11/5/16,PHI,,CLE,L,1,31,3,9,0.333,2,4,0.5,1,5,0.2,0,0,,0,6,6
12999,Rajon Rondo,30-305,G,12/23/16,CHI,@,CHO,L,1,33,3,10,0.3,2,7,0.286,1,3,0.333,0,0,,2,7,9
13000,Rajon Rondo,30-298,G,12/16/16,CHI,,MIL,L,1,26,3,9,0.333,2,6,0.333,1,3,0.333,0,2,0,1,3,4
13001,Terrence Ross,26-007,F-G,2/12/17,TOR,,DET,L,0,18,3,6,0.5,2,4,0.5,1,2,0.5,0,0,,0,3,3
13002,Terrence Ross,25-337,F-G,1/7/17,TOR,@,CHI,L,0,25,3,10,0.3,2,3,0.667,1,7,0.143,0,0,,0,3,3
13003,Terrence Ross,25-352,F-G,1/22/17,TOR,,PHO,L,0,25,2,9,0.222,1,3,0.333,1,6,0.167,2,2,1,1,1,2
13004,Terrence Ross,25-269,F-G,10/31/16,TOR,,DEN,W,0,15,2,5,0.4,1,2,0.5,1,3,0.333,2,2,1,0,2,2
13005,Terrence Ross,25-328,F-G,12/29/16,TOR,@,PHO,L,0,30,3,11,0.273,2,4,0.5,1,7,0.143,0,0,,0,4,4
13006,Terry Rozier,22-242,G,11/14/16,BOS,@,NOP,L,0,13,3,7,0.429,2,3,0.667,1,4,0.25,0,0,,1,1,2
13007,Terry Rozier,22-231,G,11/3/16,BOS,@,CLE,L,0,16,3,5,0.6,2,3,0.667,1,2,0.5,0,0,,0,3,3
13008,Terry Rozier,22-230,G,11/2/16,BOS,,CHI,W,0,13,3,6,0.5,2,4,0.5,1,2,0.5,0,1,0,0,2,2
13009,Terry Rozier,22-302,G,1/13/17,BOS,@,ATL,W,0,23,3,5,0.6,3,4,0.75,0,1,0,1,2,0.5,1,3,4
13010,Ricky Rubio,26-048,G,12/8/16,MIN,@,TOR,L,1,29,2,7,0.286,0,1,0,2,6,0.333,1,1,1,1,2,3
13011,Ricky Rubio,26-031,G,11/21/16,MIN,,BOS,L,1,38,1,7,0.143,0,3,0,1,4,0.25,4,4,1,4,4,8
13012,Ricky Rubio,26-057,G,12/17/16,MIN,,HOU,L,1,41,2,7,0.286,1,5,0.2,1,2,0.5,2,2,1,2,6,8
13013,Ricky Rubio,26-022,G,11/12/16,MIN,,LAC,L,1,24,2,5,0.4,1,3,0.333,1,2,0.5,2,4,0.5,5,1,6
13014,Brandon Rush,31-223,G-F,2/15/17,MIN,@,DEN,W,1,24,3,6,0.5,2,4,0.5,1,2,0.5,0,0,,0,2,2
13015,Brandon Rush,31-240,G-F,3/4/17,MIN,@,SAS,L,1,32,3,5,0.6,2,3,0.667,1,2,0.5,0,0,,0,6,6
13016,D'Angelo Russell,20-264,G,11/13/16,LAL,@,MIN,L,1,26,3,10,0.3,2,5,0.4,1,5,0.2,0,1,0,0,4,4
13017,Domantas Sabonis,20-201,F,11/20/16,OKC,,IND,L,1,20,3,10,0.3,2,5,0.4,1,5,0.2,0,0,,3,3,6
13018,Domantas Sabonis,20-225,F,12/14/16,OKC,@,UTA,L,1,16,3,6,0.5,2,4,0.5,1,2,0.5,0,0,,0,4,4
13019,Domantas Sabonis,20-257,F,1/15/17,OKC,@,SAC,W,1,28,3,8,0.375,3,4,0.75,0,4,0,1,2,0.5,0,3,3
13020,Domantas Sabonis,20-255,F,1/13/17,OKC,@,MIN,L,1,21,3,11,0.273,3,8,0.375,0,3,0,1,3,0.333,1,5,6
13021,Domantas Sabonis,20-190,F,11/9/16,OKC,,TOR,L,1,28,3,6,0.5,2,3,0.667,1,3,0.333,0,0,,0,1,1
13022,Dario Saric,22-254,F,12/18/16,PHI,,BRK,W,0,25,3,10,0.3,2,5,0.4,1,5,0.2,0,0,,2,6,8
13023,Dario Saric,22-252,F,12/16/16,PHI,,LAL,L,0,20,2,8,0.25,1,4,0.25,1,4,0.25,2,2,1,2,1,3
13024,Tomas Satoransky,25-017,G,11/16/16,WAS,@,PHI,L,0,23,3,4,0.75,3,3,1,0,1,0,1,4,0.25,1,0,1
13025,Luis Scola,36-217,F,12/3/16,BRK,@,MIL,L,0,11,3,4,0.75,3,3,1,0,1,0,1,1,1,2,1,3
13026,Luis Scola,36-260,F,1/15/17,BRK,,HOU,L,0,8,2,3,0.667,1,1,1,1,2,0.5,2,2,1,0,4,4
13027,Luis Scola,36-250,F,1/5/17,BRK,@,IND,L,0,25,3,7,0.429,2,4,0.5,1,3,0.333,0,0,,1,2,3
13028,Thabo Sefolosha,32-194,G-F,11/12/16,ATL,,PHI,W,0,18,3,7,0.429,2,4,0.5,1,3,0.333,0,0,,0,2,2
13029,Thabo Sefolosha,32-248,G-F,1/5/17,ATL,@,NOP,W,1,32,3,6,0.5,2,4,0.5,1,2,0.5,0,0,,1,5,6
13030,Ramon Sessions,30-201,G,10/29/16,CHO,,BOS,L,0,18,2,4,0.5,1,3,0.333,1,1,1,2,2,1,0,3,3
13031,Ramon Sessions,30-232,G,11/29/16,CHO,,DET,L,0,13,2,4,0.5,2,4,0.5,0,0,,3,4,0.75,0,1,1
13032,Ramon Sessions,30-243,G,12/10/16,CHO,@,CLE,L,0,18,2,6,0.333,1,4,0.25,1,2,0.5,2,4,0.5,0,2,2
13033,Ramon Sessions,30-226,G,11/23/16,CHO,,SAS,L,0,16,3,4,0.75,2,3,0.667,1,1,1,0,0,,0,0,0
13034,Ramon Sessions,30-238,G,12/5/16,CHO,@,DAL,W,0,13,0,1,0,0,1,0,0,0,,7,7,1,0,1,1
13035,Iman Shumpert,26-132,G,11/5/16,CLE,@,PHI,W,0,26,3,4,0.75,2,2,1,1,2,0.5,0,0,,1,2,3
13036,Iman Shumpert,26-259,G,3/12/17,CLE,@,HOU,L,1,30,2,9,0.222,1,3,0.333,1,6,0.167,2,2,1,0,5,5
13037,Iman Shumpert,26-182,G,12/25/16,CLE,,GSW,W,0,29,1,9,0.111,0,4,0,1,5,0.2,4,4,1,3,2,5
13038,Iman Shumpert,26-180,G,12/23/16,CLE,,BRK,W,0,18,3,9,0.333,2,4,0.5,1,5,0.2,0,0,,0,3,3
13039,Pascal Siakam,23-040,F,3/16/17,TOR,,OKC,L,0,6,3,3,1,2,2,1,1,1,1,0,0,,0,0,0
13040,Jonathon Simmons,27-139,G-F,1/31/17,SAS,,OKC,W,0,19,3,9,0.333,3,9,0.333,0,0,,1,4,0.25,2,4,6
13041,Jonathon Simmons,27-127,G-F,1/19/17,SAS,,DEN,W,0,14,3,9,0.333,3,8,0.375,0,1,0,1,2,0.5,0,4,4
13042,Jonathon Simmons,27-125,G-F,1/17/17,SAS,,MIN,W,0,12,1,1,1,1,1,1,0,0,,5,6,0.833,0,0,0
13043,Jonathon Simmons,27-083,G-F,12/6/16,SAS,@,MIN,W,0,18,3,8,0.375,2,7,0.286,1,1,1,0,0,,0,2,2
13044,Marcus Smart,22-362,G,3/3/17,BOS,@,LAL,W,0,28,1,7,0.143,1,4,0.25,0,3,0,5,5,1,0,5,5
13045,Marcus Smart,22-292,G,12/23/16,BOS,,OKC,L,0,24,3,10,0.3,2,8,0.25,1,2,0.5,0,0,,1,2,3
13046,Marcus Smart,22-325,G,1/25/17,BOS,,HOU,W,0,31,2,5,0.4,1,4,0.25,1,1,1,2,2,1,2,2,4
13047,Marcus Smart,22-241,G,11/2/16,BOS,,CHI,W,0,34,2,8,0.25,1,2,0.5,1,6,0.167,2,4,0.5,0,5,5
13048,Marcus Smart,22-272,G,12/3/16,BOS,@,PHI,W,0,32,2,6,0.333,2,2,1,0,4,0,3,4,0.75,0,3,3
13049,Ish Smith,28-178,G,12/30/16,DET,@,ATL,L,0,25,3,7,0.429,2,3,0.667,1,4,0.25,0,0,,1,3,4
13050,Ish Smith,28-154,G,12/6/16,DET,,CHI,W,0,30,2,11,0.182,2,9,0.222,0,2,0,3,4,0.75,1,4,5
13051,Jason Smith,30-301,F-C,12/28/16,WAS,,IND,W,0,18,3,4,0.75,2,3,0.667,1,1,1,0,2,0,3,4,7
13052,Jason Smith,30-318,F-C,1/14/17,WAS,,PHI,W,0,13,3,6,0.5,2,5,0.4,1,1,1,0,0,,2,2,4
13053,Jason Smith,30-279,F-C,12/6/16,WAS,,ORL,L,0,10,3,5,0.6,2,4,0.5,1,1,1,0,0,,0,2,2
13054,Jason Smith,30-314,F-C,1/10/17,WAS,,CHI,W,0,23,3,7,0.429,2,5,0.4,1,2,0.5,0,0,,3,3,6
13055,Tony Snell,25-072,G-F,1/21/17,MIL,@,MIA,L,1,25,2,2,1,1,1,1,1,1,1,2,2,1,0,2,2
13056,Tony Snell,25-111,G-F,3/1/17,MIL,,DEN,L,1,31,3,8,0.375,2,3,0.667,1,5,0.2,0,0,,0,1,1
13057,Tony Snell,25-125,G-F,3/15/17,MIL,@,LAC,W,1,31,3,9,0.333,2,2,1,1,7,0.143,0,0,,0,3,3
13058,Tony Snell,25-000,G-F,11/10/16,MIL,,NOP,L,1,33,2,6,0.333,1,2,0.5,1,4,0.25,2,2,1,1,3,4
13059,Tony Snell,25-017,G-F,11/27/16,MIL,@,ORL,W,1,35,3,7,0.429,3,3,1,0,4,0,1,2,0.5,0,8,8
13060,Tony Snell,25-011,G-F,11/21/16,MIL,,ORL,W,1,25,3,7,0.429,2,3,0.667,1,4,0.25,0,0,,0,2,2
13061,Tony Snell,25-059,G-F,1/8/17,MIL,,WAS,L,1,34,3,6,0.5,2,3,0.667,1,3,0.333,0,0,,0,2,2
13062,Marreese Speights,29-120,C-F,12/2/16,LAC,@,NOP,W,0,14,3,5,0.6,3,5,0.6,0,0,,1,2,0.5,3,2,5
13063,Marreese Speights,29-155,C-F,1/6/17,LAC,@,SAC,W,0,11,2,11,0.182,1,6,0.167,1,5,0.2,2,2,1,4,7,11
13064,Marreese Speights,29-193,C-F,2/13/17,LAC,@,UTA,W,0,15,2,7,0.286,1,3,0.333,1,4,0.25,2,2,1,0,7,7
13065,Marreese Speights,29-095,C-F,11/7/16,LAC,,DET,W,0,19,1,6,0.167,1,3,0.333,0,3,0,5,5,1,0,4,4
13066,Marreese Speights,29-226,C-F,3/18/17,LAC,,CLE,W,0,15,3,4,0.75,2,3,0.667,1,1,1,0,0,,0,8,8
13067,Nik Stauskas,23-026,G,11/2/16,PHI,@,CHO,L,0,31,2,6,0.333,1,3,0.333,1,3,0.333,2,2,1,0,4,4
13068,Nik Stauskas,23-158,G,3/14/17,PHI,@,GSW,L,0,26,2,6,0.333,1,2,0.5,1,4,0.25,2,2,1,1,2,3
13069,Nik Stauskas,23-106,G,1/21/17,PHI,@,ATL,L,1,35,3,11,0.273,2,7,0.286,1,4,0.25,0,0,,0,6,6
13070,Rodney Stuckey,30-228,G,12/5/16,IND,@,GSW,L,0,20,1,3,0.333,0,2,0,1,1,1,4,4,1,1,2,3
13071,Jeff Teague,28-170,G,11/27/16,IND,,LAC,W,1,24,3,8,0.375,2,5,0.4,1,3,0.333,0,0,,0,2,2
13072,Jeff Teague,28-203,G,12/30/16,IND,,CHI,W,1,35,2,13,0.154,2,11,0.182,0,2,0,3,4,0.75,0,5,5
13073,Jeff Teague,28-264,G,3/1/17,IND,@,SAS,L,1,31,2,6,0.333,1,4,0.25,1,2,0.5,2,3,0.667,1,4,5
13074,Jeff Teague,28-227,G,1/23/17,IND,,NYK,L,1,36,3,9,0.333,2,6,0.333,1,3,0.333,0,2,0,0,4,4
13075,Mirza Teletovic,31-064,F,11/21/16,MIL,,ORL,W,0,13,2,6,0.333,1,1,1,1,5,0.2,2,4,0.5,0,5,5
13076,Mirza Teletovic,31-076,F,12/3/16,MIL,,BRK,W,0,15,2,6,0.333,0,0,,2,6,0.333,1,2,0.5,0,3,3
13077,Garrett Temple,30-267,G,1/30/17,SAC,@,PHI,L,1,35,3,6,0.5,2,3,0.667,1,3,0.333,0,1,0,1,0,1
13078,Garrett Temple,30-314,G,3/18/17,SAC,@,OKC,L,1,28,2,8,0.25,1,2,0.5,1,6,0.167,2,2,1,1,2,3
13079,Garrett Temple,30-265,G,1/28/17,SAC,@,CHO,W,1,24,2,7,0.286,1,4,0.25,1,3,0.333,2,4,0.5,0,1,1
13080,Garrett Temple,30-306,G,3/10/17,SAC,,WAS,L,0,30,2,6,0.333,0,4,0,2,2,1,1,2,0.5,0,0,0
13081,Garrett Temple,30-192,G,11/16/16,SAC,,SAS,L,0,18,3,4,0.75,2,3,0.667,1,1,1,0,0,,0,4,4
13082,Jason Terry,39-049,G,11/3/16,MIL,,IND,W,0,18,2,3,0.667,1,1,1,1,2,0.5,2,2,1,0,0,0
13083,Jason Terry,39-162,G,2/24/17,MIL,,UTA,L,0,20,2,4,0.5,0,0,,2,4,0.5,1,2,0.5,0,0,0
13084,Lance Thomas,28-255,F,1/4/17,NYK,,MIL,L,1,38,3,8,0.375,2,6,0.333,1,2,0.5,0,0,,1,3,4
13085,Lance Thomas,28-201,F,11/11/16,NYK,@,BOS,L,0,20,3,7,0.429,2,4,0.5,1,3,0.333,0,0,,1,4,5
13086,Hollis Thompson,25-247,G-F,12/6/16,PHI,@,MEM,L,0,23,2,6,0.333,0,2,0,2,4,0.5,1,2,0.5,0,1,1
13087,Hollis Thompson,25-270,G-F,12/29/16,PHI,@,UTA,L,0,21,3,6,0.5,2,4,0.5,1,2,0.5,0,0,,0,1,1
13088,Hollis Thompson,25-228,G-F,11/17/16,PHI,@,MIN,L,0,20,2,6,0.333,1,3,0.333,1,3,0.333,2,2,1,1,2,3
13089,Hollis Thompson,25-329,G-F,2/26/17,NOP,@,OKC,L,1,31,2,4,0.5,0,1,0,2,3,0.667,1,2,0.5,0,3,3
13090,Hollis Thompson,25-252,G-F,12/11/16,PHI,@,DET,W,0,15,3,5,0.6,2,2,1,1,3,0.333,0,0,,1,1,2
13091,Tristan Thompson,25-276,F-C,12/14/16,CLE,@,MEM,L,1,28,2,5,0.4,2,5,0.4,0,0,,3,6,0.5,4,7,11
13092,Tristan Thompson,25-288,F-C,12/26/16,CLE,@,DET,L,1,26,2,4,0.5,2,4,0.5,0,0,,3,4,0.75,4,6,10
13093,Tristan Thompson,25-237,F-C,11/5/16,CLE,@,PHI,W,1,30,3,6,0.5,3,6,0.5,0,0,,1,2,0.5,6,7,13
13094,Marcus Thornton,29-186,G,12/8/16,WAS,,DEN,W,0,11,3,6,0.5,2,4,0.5,1,2,0.5,0,0,,0,3,3
13095,Marcus Thornton,29-196,G,12/18/16,WAS,,LAC,W,0,14,3,4,0.75,2,3,0.667,1,1,1,0,0,,1,3,4
13096,Marcus Thornton,29-211,G,1/2/17,WAS,@,HOU,L,0,18,3,8,0.375,2,5,0.4,1,3,0.333,0,0,,0,3,3
13097,Marcus Thornton,29-206,G,12/28/16,WAS,,IND,W,0,20,3,6,0.5,2,4,0.5,1,2,0.5,0,2,0,1,4,5
13098,Anthony Tolliver,31-277,F-C,3/5/17,SAC,,UTA,L,0,27,3,4,0.75,2,2,1,1,2,0.5,0,0,,0,3,3
13099,Anthony Tolliver,31-200,F-C,12/18/16,SAC,@,DAL,L,0,23,2,6,0.333,1,2,0.5,1,4,0.25,2,2,1,1,6,7
13100,Anthony Tolliver,31-216,F-C,1/3/17,SAC,@,DEN,W,0,25,2,4,0.5,1,1,1,1,3,0.333,2,2,1,0,3,3
13101,Anthony Tolliver,31-247,F-C,2/3/17,SAC,,PHO,L,0,26,2,9,0.222,1,4,0.25,1,5,0.2,2,4,0.5,1,5,6
13102,Anthony Tolliver,31-216,F-C,1/3/17,SAC,@,DEN,W,0,25,2,4,0.5,1,1,1,1,3,0.333,2,2,1,0,3,3
13103,Anthony Tolliver,31-243,F-C,1/30/17,SAC,@,PHI,L,0,21,2,4,0.5,0,1,0,2,3,0.667,1,2,0.5,1,3,4
13104,P.J. Tucker,31-254,F,1/14/17,PHO,,SAS,W,0,30,2,7,0.286,1,2,0.5,1,5,0.2,2,2,1,0,5,5
13105,P.J. Tucker,31-198,F,11/19/16,PHO,@,PHI,L,1,31,1,3,0.333,0,1,0,1,2,0.5,4,4,1,1,6,7
13106,P.J. Tucker,31-216,F,12/7/16,PHO,,IND,L,1,34,3,12,0.25,2,7,0.286,1,5,0.2,0,0,,2,2,4
13107,P.J. Tucker,31-281,F,2/10/17,PHO,,CHI,W,0,34,2,5,0.4,1,2,0.5,1,3,0.333,2,2,1,1,6,7
13108,P.J. Tucker,31-197,F,11/18/16,PHO,@,IND,W,0,39,3,12,0.25,3,8,0.375,0,4,0,1,2,0.5,5,5,10
13109,P.J. Tucker,31-243,F,1/3/17,PHO,,MIA,W,0,32,3,5,0.6,3,3,1,0,2,0,1,1,1,2,4,6
13110,P.J. Tucker,31-179,F,10/31/16,PHO,@,LAC,L,0,27,3,6,0.5,2,4,0.5,1,2,0.5,0,0,,1,5,6
13111,Evan Turner,28-029,G,11/25/16,POR,,NOP,W,0,25,3,11,0.273,2,6,0.333,1,5,0.2,0,0,,1,3,4
13112,Evan Turner,28-013,G,11/9/16,POR,@,LAC,L,0,20,3,8,0.375,3,6,0.5,0,2,0,1,1,1,3,3,6
13113,Myles Turner,20-244,F-C,11/23/16,IND,,ATL,L,1,35,2,5,0.4,1,4,0.25,1,1,1,2,2,1,1,8,9
13114,Beno Udrih,34-123,G,11/5/16,DET,,DEN,W,0,20,3,6,0.5,2,4,0.5,1,2,0.5,0,0,,0,3,3
13115,Beno Udrih,34-134,G,11/16/16,DET,@,NYK,L,0,13,3,7,0.429,3,5,0.6,0,2,0,1,1,1,0,0,0
13116,Beno Udrih,34-147,G,11/29/16,DET,@,CHO,W,0,20,3,5,0.6,2,4,0.5,1,1,1,0,0,,0,1,1
13117,Tyler Ulis,21-061,G,3/7/17,PHO,,WAS,L,0,22,3,8,0.375,3,7,0.429,0,1,0,1,2,0.5,0,2,2
13118,Jonas Valanciunas,24-256,C,1/17/17,TOR,@,BRK,W,1,29,3,7,0.429,3,7,0.429,0,0,,1,2,0.5,1,9,10
13119,Jonas Valanciunas,24-236,C,12/28/16,TOR,@,GSW,L,1,21,2,5,0.4,2,5,0.4,0,0,,3,3,1,2,3,5
13120,Jonas Valanciunas,24-299,C,3/1/17,TOR,,WAS,L,1,21,3,12,0.25,3,12,0.25,0,0,,1,1,1,7,4,11
13121,Jonas Valanciunas,24-314,C,3/16/17,TOR,,OKC,L,1,17,3,7,0.429,3,7,0.429,0,0,,1,1,1,2,3,5
13122,Jonas Valanciunas,24-294,C,2/24/17,TOR,,BOS,W,1,18,3,4,0.75,3,4,0.75,0,0,,1,3,0.333,3,3,6
13123,Denzel Valentine,23-104,G,2/28/17,CHI,,DEN,L,0,27,3,7,0.429,2,2,1,1,5,0.2,0,0,,0,7,7
13124,Noah Vonleh,21-183,F,2/23/17,POR,@,ORL,W,1,16,3,3,1,3,3,1,0,0,,1,2,0.5,1,3,4
13125,Noah Vonleh,21-200,F,3/12/17,POR,@,PHO,W,1,23,2,5,0.4,2,5,0.4,0,0,,3,5,0.6,4,3,7
13126,Nikola Vucevic,26-004,C,10/28/16,ORL,@,DET,L,1,26,3,12,0.25,3,12,0.25,0,0,,1,2,0.5,4,10,14
13127,Nikola Vucevic,26-046,C,12/9/16,ORL,@,CHO,L,0,23,3,10,0.3,3,10,0.3,0,0,,1,2,0.5,0,5,5
13128,Sasha Vujacic,32-313,G,1/15/17,NYK,@,TOR,L,0,7,2,3,0.667,0,0,,2,3,0.667,1,2,0.5,0,1,1
13129,Kemba Walker,26-311,G,3/15/17,CHO,@,IND,L,1,30,3,11,0.273,3,8,0.375,0,3,0,1,1,1,0,1,1
13130,Kemba Walker,26-269,G,2/1/17,CHO,@,GSW,L,1,25,1,5,0.2,1,2,0.5,0,3,0,5,5,1,0,1,1
13131,C.J. Watson,32-282,G,1/24/17,ORL,,CHI,L,0,23,3,6,0.5,3,5,0.6,0,1,0,1,2,0.5,1,2,3
13132,C.J. Watson,32-327,G,3/10/17,ORL,@,CHO,L,0,23,3,8,0.375,2,4,0.5,1,4,0.25,0,0,,1,2,3
13133,C.J. Watson,32-226,G,11/29/16,ORL,@,SAS,W,0,17,3,3,1,2,2,1,1,1,1,0,0,,0,1,1
13134,C.J. Watson,32-304,G,2/15/17,ORL,,SAS,L,1,12,3,4,0.75,2,3,0.667,1,1,1,0,0,,0,0,0
13135,David West,36-188,F,3/5/17,GSW,@,NYK,W,0,11,3,4,0.75,3,4,0.75,0,0,,1,2,0.5,1,0,1
13136,David West,36-084,F,11/21/16,GSW,@,IND,W,0,15,2,5,0.4,2,5,0.4,0,0,,3,3,1,0,4,4
13137,David West,36-183,F,2/28/17,GSW,@,WAS,L,0,13,3,5,0.6,3,5,0.6,0,0,,1,2,0.5,0,3,3
13138,David West,36-082,F,11/19/16,GSW,@,MIL,W,0,12,3,4,0.75,3,4,0.75,0,0,,1,2,0.5,4,3,7
13139,Okaro White,24-170,F,1/30/17,MIA,,BRK,W,0,14,2,4,0.5,1,1,1,1,3,0.333,2,2,1,1,1,2
13140,Okaro White,24-168,F,1/28/17,MIA,,DET,W,0,19,2,3,0.667,1,1,1,1,2,0.5,2,2,1,0,2,2
13141,Okaro White,24-179,F,2/8/17,MIA,@,MIL,W,0,17,2,3,0.667,1,1,1,1,2,0.5,2,2,1,1,4,5
13142,Isaiah Whitehead,21-337,G,2/8/17,BRK,,WAS,L,0,21,2,6,0.333,1,4,0.25,1,2,0.5,2,2,1,0,2,2
13143,Isaiah Whitehead,21-360,G,3/3/17,BRK,@,UTA,L,0,25,3,12,0.25,2,8,0.25,1,4,0.25,0,0,,1,3,4
13144,Isaiah Whitehead,21-303,G,1/5/17,BRK,@,IND,L,1,13,3,7,0.429,2,5,0.4,1,2,0.5,0,0,,0,2,2
13145,Isaiah Whitehead,21-318,G,1/20/17,BRK,@,NOP,W,0,29,3,8,0.375,3,6,0.5,0,2,0,1,2,0.5,1,2,3
13146,Isaiah Whitehead,21-277,G,12/10/16,BRK,@,SAS,L,1,23,3,9,0.333,2,5,0.4,1,4,0.25,0,0,,0,0,0
13147,Isaiah Whitehead,21-344,G,2/15/17,BRK,,MIL,L,0,18,3,5,0.6,3,4,0.75,0,1,0,1,1,1,1,1,2
13148,Isaiah Whitehead,21-342,G,2/13/17,BRK,,MEM,L,0,17,3,5,0.6,2,3,0.667,1,2,0.5,0,0,,0,0,0
13149,Isaiah Whitehead,22-013,G,3/21/17,BRK,,DET,W,0,28,2,9,0.222,2,9,0.222,0,0,,3,4,0.75,2,2,4
13150,Isaiah Whitehead,21-308,G,1/10/17,BRK,,ATL,L,1,26,3,8,0.375,2,7,0.286,1,1,1,0,0,,1,1,2
13151,Hassan Whiteside,27-226,C,1/25/17,MIA,@,BRK,W,1,21,3,10,0.3,3,10,0.3,0,0,,1,2,0.5,0,1,1
13152,Andrew Wiggins,21-256,F-G,11/5/16,MIN,@,OKC,L,1,27,3,13,0.231,3,12,0.25,0,1,0,1,2,0.5,1,2,3
13153,Andrew Wiggins,21-270,F-G,11/19/16,MIN,@,MEM,L,1,32,2,11,0.182,2,8,0.25,0,3,0,3,4,0.75,0,4,4
13154,Deron Williams,32-230,G,2/11/17,DAL,,ORL,W,1,16,3,6,0.5,2,3,0.667,1,3,0.333,0,0,,0,0,0
13155,Deron Williams,32-213,G,1/25/17,DAL,,NYK,W,1,16,3,6,0.5,2,4,0.5,1,2,0.5,0,0,,0,0,0
13156,Deron Williams,32-195,G,1/7/17,DAL,,ATL,L,1,28,3,12,0.25,3,7,0.429,0,5,0,1,1,1,2,5,7
13157,Derrick Williams,25-266,F,2/15/17,CLE,,IND,W,0,27,2,7,0.286,0,2,0,2,5,0.4,1,2,0.5,0,5,5
13158,Derrick Williams,25-262,F,2/11/17,CLE,,DEN,W,0,21,2,3,0.667,1,1,1,1,2,0.5,2,2,1,0,1,1
13159,Derrick Williams,25-180,F,11/21/16,MIA,@,PHI,L,1,19,2,6,0.333,1,4,0.25,1,2,0.5,2,4,0.5,1,0,1
13160,Lou Williams,30-003,G,10/30/16,LAL,@,OKC,L,0,20,2,7,0.286,2,5,0.4,0,2,0,3,4,0.75,0,1,1
13161,Lou Williams,30-144,G,3/20/17,HOU,,DEN,W,0,17,2,6,0.333,2,4,0.5,0,2,0,3,4,0.75,0,3,3
13162,Marvin Williams,30-131,F,10/28/16,CHO,@,MIA,W,1,34,3,6,0.5,2,4,0.5,1,2,0.5,0,0,,0,11,11
13163,Troy Williams,21-339,F,12/3/16,MEM,,LAL,W,1,35,3,8,0.375,2,5,0.4,1,3,0.333,0,0,,1,5,6
13164,Kyle Wiltjer,24-055,F,12/14/16,HOU,,SAC,W,0,6,2,2,1,0,0,,2,2,1,1,2,0.5,2,0,2
13165,Justise Winslow,20-233,F,11/14/16,MIA,@,SAS,L,1,35,3,11,0.273,3,10,0.3,0,1,0,1,2,0.5,2,1,3
13166,Justise Winslow,20-276,F,12/27/16,MIA,,OKC,L,1,35,2,10,0.2,2,8,0.25,0,2,0,3,3,1,0,3,3
13167,Brandan Wright,29-167,F-C,3/21/17,MEM,@,NOP,L,0,20,3,3,1,3,3,1,0,0,,1,2,0.5,0,2,2
13168,Nick Young,31-246,G-F,2/2/17,LAL,@,WAS,L,1,24,3,10,0.3,2,2,1,1,8,0.125,0,0,,0,1,1
13169,Thaddeus Young,28-177,F,12/15/16,IND,@,NOP,L,1,36,3,8,0.375,3,7,0.429,0,1,0,1,2,0.5,1,8,9
13170,Cody Zeller,24-024,F-C,10/29/16,CHO,,BOS,L,1,21,2,4,0.5,2,4,0.5,0,0,,3,6,0.5,1,8,9
13171,Cody Zeller,24-161,F-C,3/15/17,CHO,@,IND,L,1,27,3,8,0.375,3,8,0.375,0,0,,1,1,1,0,4,4
13172,Tyler Zeller,26-300,F-C,11/12/16,BOS,@,IND,W,0,16,3,6,0.5,3,6,0.5,0,0,,1,2,0.5,4,2,6
13173,Paul Zipser,22-349,G-F,2/1/17,CHI,@,OKC,W,0,24,2,5,0.4,1,2,0.5,1,3,0.333,2,3,0.667,0,5,5
13174,Paul Zipser,22-329,G-F,1/12/17,CHI,@,NYK,L,1,34,2,6,0.333,1,3,0.333,1,3,0.333,2,2,1,0,5,5
13175,Alex Abrines,23-189,G-F,2/6/17,OKC,@,IND,L,0,8,2,4,0.5,0,0,,2,4,0.5,0,0,,1,0,1
13176,Alex Abrines,23-213,G-F,3/2/17,OKC,@,POR,L,1,10,2,3,0.667,0,1,0,2,2,1,0,0,,0,0,0
13177,Alex Abrines,23-163,G-F,1/11/17,OKC,,MEM,W,0,17,2,3,0.667,0,0,,2,3,0.667,0,0,,0,0,0
13178,Alex Abrines,23-156,G-F,1/4/17,OKC,@,CHO,L,0,21,2,6,0.333,0,1,0,2,5,0.4,0,0,,0,1,1
13179,Alex Abrines,23-154,G-F,1/2/17,OKC,@,MIL,L,0,14,2,6,0.333,0,2,0,2,4,0.5,0,0,,1,1,2
13180,Alex Abrines,23-093,G-F,11/2/16,OKC,@,LAC,W,0,8,2,2,1,0,0,,2,2,1,0,0,,0,0,0
13181,Quincy Acy,26-034,F,11/9/16,DAL,@,GSW,L,0,24,2,6,0.333,2,4,0.5,0,2,0,2,2,1,1,2,3
13182,Steven Adams,23-114,C,11/11/16,OKC,,LAC,L,1,32,2,5,0.4,2,5,0.4,0,0,,2,2,1,1,4,5
13183,Steven Adams,23-162,C,12/29/16,OKC,@,MEM,L,1,27,1,9,0.111,1,9,0.111,0,0,,4,8,0.5,8,6,14
13184,Steven Adams,23-110,C,11/7/16,OKC,,MIA,W,1,29,3,5,0.6,3,5,0.6,0,0,,0,0,,0,6,6
13185,Steven Adams,23-119,C,11/16/16,OKC,,HOU,W,1,33,3,7,0.429,3,7,0.429,0,0,,0,0,,0,6,6
13186,Steven Adams,23-152,C,12/19/16,OKC,,ATL,L,1,31,2,4,0.5,2,4,0.5,0,0,,2,5,0.4,4,5,9
13187,Steven Adams,23-179,C,1/15/17,OKC,@,SAC,W,1,20,3,6,0.5,3,6,0.5,0,0,,0,0,,1,3,4
13188,Arron Afflalo,31-100,G,1/23/17,SAC,@,DET,W,1,29,2,9,0.222,0,2,0,2,7,0.286,0,0,,0,2,2
13189,Arron Afflalo,31-034,G,11/18/16,SAC,,LAC,L,1,24,1,3,0.333,1,1,1,0,2,0,4,4,1,0,1,1
13190,Alexis Ajinca,28-190,C,11/12/16,NOP,,LAL,L,0,24,3,4,0.75,3,4,0.75,0,0,,0,0,,3,4,7
13191,Alexis Ajinca,28-218,C,12/10/16,NOP,@,LAC,L,1,19,3,7,0.429,3,6,0.5,0,1,0,0,0,,2,4,6
13192,Alexis Ajinca,28-194,C,11/16/16,NOP,@,ORL,L,0,25,2,8,0.25,2,8,0.25,0,0,,2,2,1,1,5,6
13193,Cole Aldrich,28-038,C,12/8/16,MIN,@,TOR,L,0,15,3,3,1,3,3,1,0,0,,0,0,,2,6,8
13194,LaMarcus Aldridge,31-225,F-C,3/1/17,SAS,,IND,W,1,32,3,9,0.333,3,9,0.333,0,0,,0,0,,1,4,5
13195,LaMarcus Aldridge,31-140,F-C,12/6/16,SAS,@,MIN,W,1,30,3,8,0.375,3,7,0.429,0,1,0,0,0,,0,2,2
13196,Lavoy Allen,27-363,F-C,2/1/17,IND,@,ORL,W,0,19,1,2,0.5,1,2,0.5,0,0,,4,4,1,0,1,1
13197,Lavoy Allen,28-004,F-C,2/8/17,IND,,CLE,L,1,23,3,6,0.5,3,6,0.5,0,0,,0,0,,3,2,5
13198,Lavoy Allen,27-275,F-C,11/5/16,IND,,CHI,W,0,20,3,4,0.75,3,4,0.75,0,0,,0,0,,0,0,0
13199,Tony Allen,34-345,G-F,12/21/16,MEM,@,DET,W,1,28,3,8,0.375,3,8,0.375,0,0,,0,0,,1,1,2
13200,Tony Allen,35-007,G-F,1/18/17,MEM,@,WAS,L,1,30,2,7,0.286,2,7,0.286,0,0,,2,4,0.5,5,2,7
13201,Tony Allen,35-017,G-F,1/28/17,MEM,@,UTA,W,1,26,3,8,0.375,3,7,0.429,0,1,0,0,0,,1,3,4
13202,Al-Farouq Aminu,26-100,F,12/30/16,POR,@,SAS,L,1,28,2,9,0.222,2,6,0.333,0,3,0,2,3,0.667,1,5,6
13203,Al-Farouq Aminu,26-093,F,12/23/16,POR,,SAS,L,1,29,2,6,0.333,0,1,0,2,5,0.4,0,0,,2,0,2
13204,Al-Farouq Aminu,26-041,F,11/1/16,POR,,GSW,L,1,30,3,11,0.273,3,5,0.6,0,6,0,0,2,0,1,9,10
13205,Chris Andersen,38-114,F-C,10/29/16,CLE,,ORL,W,0,9,2,2,1,2,2,1,0,0,,2,4,0.5,1,1,2
13206,Alan Anderson,34-118,G-F,2/11/17,LAC,@,CHO,W,0,13,2,3,0.667,2,2,1,0,1,0,2,2,1,0,1,1
13207,Alan Anderson,34-073,G-F,12/28/16,LAC,@,NOP,L,0,5,2,3,0.667,0,1,0,2,2,1,0,0,,0,1,1
13208,Alan Anderson,34-104,G-F,1/28/17,LAC,@,GSW,L,0,11,2,4,0.5,0,1,0,2,3,0.667,0,0,,0,0,0
13209,Justin Anderson,22-365,G,11/18/16,DAL,,MEM,L,0,32,2,9,0.222,2,5,0.4,0,4,0,2,2,1,0,6,6
13210,Justin Anderson,23-041,G,12/30/16,DAL,@,GSW,L,0,15,3,11,0.273,3,7,0.429,0,4,0,0,0,,2,2,4
13211,Justin Anderson,23-102,G,3/1/17,PHI,@,MIA,L,0,26,3,4,0.75,3,3,1,0,1,0,0,0,,2,2,4
13212,Justin Anderson,23-021,G,12/10/16,DAL,@,HOU,L,0,12,2,7,0.286,0,1,0,2,6,0.333,0,0,,0,3,3
13213,Justin Anderson,22-351,G,11/4/16,DAL,,POR,L,0,18,3,5,0.6,3,4,0.75,0,1,0,0,0,,1,1,2
13214,Kyle Anderson,23-107,F-G,1/5/17,SAS,@,DEN,W,0,8,3,4,0.75,3,4,0.75,0,0,,0,0,,0,1,1
13215,Ryan Anderson,28-277,F,2/7/17,HOU,,ORL,W,1,28,2,7,0.286,1,5,0.2,1,2,0.5,1,1,1,3,1,4
13216,Ryan Anderson,28-238,F,12/30/16,HOU,,LAC,W,1,23,2,10,0.2,1,2,0.5,1,8,0.125,1,1,1,0,3,3
13217,Ryan Anderson,28-190,F,11/12/16,HOU,,SAS,L,1,37,1,13,0.077,0,6,0,1,7,0.143,3,4,0.75,4,4,8
13218,Trevor Ariza,31-122,F,10/30/16,HOU,,DAL,W,1,33,2,4,0.5,0,0,,2,4,0.5,0,0,,2,5,7
13219,Trevor Ariza,31-152,F,11/29/16,HOU,@,UTA,L,1,26,3,8,0.375,3,4,0.75,0,4,0,0,0,,1,2,3
13220,Trevor Ariza,31-247,F,3/4/17,HOU,,MEM,W,1,29,2,8,0.25,1,2,0.5,1,6,0.167,1,2,0.5,1,8,9
13221,Trevor Ariza,31-176,F,12/23/16,HOU,@,MEM,L,1,36,2,5,0.4,0,1,0,2,4,0.5,0,0,,0,4,4
13222,Trevor Ariza,31-242,F,2/27/17,HOU,,IND,L,1,36,2,10,0.2,2,3,0.667,0,7,0,2,2,1,1,4,5
13223,Trevor Ariza,31-142,F,11/19/16,HOU,,UTA,W,1,31,2,6,0.333,1,2,0.5,1,4,0.25,1,2,0.5,1,3,4
13224,Darrell Arthur,28-348,F,3/8/17,DEN,,WAS,L,0,28,2,4,0.5,0,1,0,2,3,0.667,0,1,0,0,5,5
13225,Darrell Arthur,28-258,F,12/8/16,DEN,@,WAS,L,1,20,2,3,0.667,0,0,,2,3,0.667,0,0,,0,3,3
13226,Omer Asik,30-144,C,11/25/16,NOP,@,POR,L,1,18,2,2,1,2,2,1,0,0,,2,2,1,0,4,4
13227,Omer Asik,30-142,C,11/23/16,NOP,,MIN,W,1,28,2,3,0.667,2,3,0.667,0,0,,2,4,0.5,1,8,9
13228,Omer Asik,30-141,C,11/22/16,NOP,@,ATL,W,1,22,2,3,0.667,2,3,0.667,0,0,,2,2,1,1,5,6
13229,D.J. Augustin,29-055,G,1/4/17,ORL,,ATL,L,0,13,2,4,0.5,0,0,,2,4,0.5,0,0,,0,2,2
13230,D.J. Augustin,29-053,G,1/2/17,ORL,@,NYK,W,1,14,2,4,0.5,0,0,,2,4,0.5,0,0,,0,0,0
13231,D.J. Augustin,29-004,G,11/14/16,ORL,@,IND,L,0,16,2,5,0.4,1,2,0.5,1,3,0.333,1,2,0.5,0,0,0
13232,D.J. Augustin,29-097,G,2/15/17,ORL,,SAS,L,0,20,2,4,0.5,1,1,1,1,3,0.333,1,3,0.333,0,1,1
13233,D.J. Augustin,28-363,G,11/7/16,ORL,@,CHI,L,0,23,2,10,0.2,0,3,0,2,7,0.286,0,0,,0,0,0
13234,D.J. Augustin,29-059,G,1/8/17,ORL,@,LAL,L,0,28,1,6,0.167,0,1,0,1,5,0.2,3,4,0.75,0,5,5
13235,D.J. Augustin,29-078,G,1/27/17,ORL,@,BOS,L,0,18,2,6,0.333,2,4,0.5,0,2,0,2,6,0.333,0,1,1
13236,Luke Babbitt,27-256,F,3/3/17,MIA,@,ORL,L,1,14,2,3,0.667,0,0,,2,3,0.667,0,0,,0,0,0
13237,Luke Babbitt,27-132,F,10/30/16,MIA,,SAS,L,1,25,2,6,0.333,0,1,0,2,5,0.4,0,0,,0,5,5
13238,Luke Babbitt,27-130,F,10/28/16,MIA,,CHO,L,1,20,2,5,0.4,0,1,0,2,4,0.5,0,0,,0,3,3
13239,Luke Babbitt,27-264,F,3/11/17,MIA,,TOR,W,1,20,2,4,0.5,0,0,,2,4,0.5,0,0,,0,1,1
13240,Ron Baker,23-351,G,3/16/17,NYK,,BRK,L,0,25,2,10,0.2,2,8,0.25,0,2,0,2,2,1,0,1,1
13241,Ron Baker,23-252,G,12/7/16,NYK,,CLE,L,0,10,2,7,0.286,1,3,0.333,1,4,0.25,1,2,0.5,0,1,1
13242,Ron Baker,23-285,G,1/9/17,NYK,,NOP,L,0,25,3,5,0.6,3,5,0.6,0,0,,0,0,,0,7,7
13243,Ron Baker,23-322,G,2/15/17,NYK,@,OKC,L,0,18,2,4,0.5,1,2,0.5,1,2,0.5,1,2,0.5,0,1,1
13244,Ron Baker,23-282,G,1/6/17,NYK,@,MIL,W,0,12,1,3,0.333,1,1,1,0,2,0,4,4,1,0,2,2
13245,Wade Baldwin,20-244,G,11/28/16,MEM,,CHO,L,0,15,3,5,0.6,3,3,1,0,2,0,0,2,0,1,2,3
13246,Wade Baldwin,20-259,G,12/13/16,MEM,@,CLE,L,0,4,1,1,1,1,1,1,0,0,,4,4,1,0,0,0
13247,Leandro Barbosa,34-015,G,12/13/16,PHO,,NYK,W,0,18,3,5,0.6,3,3,1,0,2,0,0,0,,0,3,3
13248,Leandro Barbosa,34-090,G,2/26/17,PHO,@,MIL,L,0,19,3,7,0.429,3,6,0.5,0,1,0,0,0,,0,1,1
13249,J.J. Barea,32-262,G,3/15/17,DAL,@,WAS,W,0,20,3,8,0.375,3,4,0.75,0,4,0,0,0,,0,2,2
13250,Harrison Barnes,24-237,F,1/22/17,DAL,,LAL,W,1,27,3,12,0.25,3,10,0.3,0,2,0,0,0,,2,3,5
13251,Matt Barnes,37-012,F,3/21/17,GSW,@,DAL,W,0,23,2,4,0.5,0,2,0,2,2,1,0,0,,0,5,5
13252,Matt Barnes,36-331,F,2/3/17,SAC,,PHO,L,1,39,3,9,0.333,3,5,0.6,0,4,0,0,0,,0,10,10
13253,Matt Barnes,36-241,F,11/5/16,SAC,@,MIL,L,0,14,2,7,0.286,2,6,0.333,0,1,0,2,2,1,0,2,2
13254,Matt Barnes,36-322,F,1/25/17,SAC,@,CLE,W,0,16,2,7,0.286,0,2,0,2,5,0.4,0,0,,2,4,6
13255,Will Barton,26-051,G,2/26/17,DEN,,MEM,L,0,25,2,5,0.4,1,2,0.5,1,3,0.333,1,2,0.5,0,2,2
13256,Will Barton,25-357,G,12/28/16,DEN,,MIN,W,0,19,3,6,0.5,3,5,0.6,0,1,0,0,0,,0,0,0
13257,Will Barton,26-029,G,2/4/17,DEN,@,SAS,L,0,25,3,9,0.333,3,7,0.429,0,2,0,0,0,,1,2,3
13258,Will Barton,26-022,G,1/28/17,DEN,@,PHO,W,0,20,2,5,0.4,2,3,0.667,0,2,0,2,3,0.667,1,4,5
13259,Brandon Bass,31-200,F,11/16/16,LAC,,MEM,L,0,9,2,2,1,2,2,1,0,0,,2,2,1,0,0,0
13260,Brandon Bass,31-269,F,1/24/17,LAC,@,PHI,L,0,12,0,1,0,0,1,0,0,0,,6,6,1,1,1,2
13261,Brandon Bass,31-191,F,11/7/16,LAC,,DET,W,0,9,3,5,0.6,3,5,0.6,0,0,,0,0,,0,1,1
13262,Brandon Bass,31-213,F,11/29/16,LAC,@,BRK,L,0,12,3,4,0.75,3,4,0.75,0,0,,0,0,,0,2,2
13263,Nicolas Batum,27-350,F-G,11/28/16,CHO,@,MEM,W,1,23,1,5,0.2,1,3,0.333,0,2,0,4,4,1,0,2,2
13264,Aron Baynes,30-019,C,12/28/16,DET,,MIL,L,0,18,3,3,1,3,3,1,0,0,,0,0,,0,4,4
13265,Aron Baynes,30-037,C,1/15/17,DET,@,LAL,W,0,16,3,4,0.75,3,4,0.75,0,0,,0,0,,1,3,4
13266,Aron Baynes,30-014,C,12/23/16,DET,,GSW,L,0,17,3,4,0.75,3,4,0.75,0,0,,0,0,,2,0,2
13267,Kent Bazemore,27-193,G-F,1/10/17,ATL,@,BRK,W,1,22,1,7,0.143,1,4,0.25,0,3,0,4,6,0.667,1,2,3
13268,Kent Bazemore,27-190,G-F,1/7/17,ATL,@,DAL,W,1,28,2,6,0.333,0,2,0,2,4,0.5,0,0,,2,2,4
13269,Michael Beasley,28-026,F,2/4/17,MIL,@,PHO,W,0,7,3,4,0.75,3,4,0.75,0,0,,0,0,,0,1,1
13270,Marco Belinelli,30-301,G-F,1/20/17,CHO,,TOR,W,0,22,2,7,0.286,2,3,0.667,0,4,0,2,2,1,0,1,1
13271,Marco Belinelli,30-312,G-F,1/31/17,CHO,@,POR,L,0,24,3,6,0.5,3,6,0.5,0,0,,0,0,,0,1,1
13272,Marco Belinelli,30-294,G-F,1/13/17,CHO,@,PHI,L,0,22,1,6,0.167,1,4,0.25,0,2,0,4,5,0.8,0,4,4
13273,Marco Belinelli,30-238,G-F,11/18/16,CHO,,ATL,W,0,27,2,7,0.286,1,3,0.333,1,4,0.25,1,2,0.5,0,1,1
13274,Marco Belinelli,30-360,G-F,3/20/17,CHO,,ATL,W,0,21,1,5,0.2,0,1,0,1,4,0.25,3,4,0.75,1,2,3
13275,Marco Belinelli,30-248,G-F,11/28/16,CHO,@,MEM,W,0,21,2,9,0.222,2,6,0.333,0,3,0,2,2,1,0,3,3
13276,Marco Belinelli,30-231,G-F,11/11/16,CHO,,TOR,L,0,27,2,9,0.222,1,4,0.25,1,5,0.2,1,1,1,0,4,4
13277,DeAndre' Bembry,22-217,F,2/6/17,ATL,,UTA,L,0,18,3,7,0.429,3,7,0.429,0,0,,0,0,,0,0,0
13278,DeAndre' Bembry,22-185,F,1/5/17,ATL,@,NOP,W,0,15,3,4,0.75,3,3,1,0,1,0,0,0,,0,1,1
13279,Dragan Bender,19-058,F,1/14/17,PHO,,SAS,W,0,21,2,4,0.5,0,1,0,2,3,0.667,0,0,,0,6,6
13280,Anthony Bennett,23-273,F,12/12/16,BRK,@,HOU,L,0,18,2,3,0.667,2,2,1,0,1,0,2,2,1,2,2,4
13281,Anthony Bennett,23-266,F,12/5/16,BRK,,WAS,L,0,13,2,2,1,0,0,,2,2,1,0,0,,1,1,2
13282,Davis Bertans,24-078,F,1/29/17,SAS,,DAL,L,1,17,2,5,0.4,1,2,0.5,1,3,0.333,1,1,1,0,3,3
13283,Davis Bertans,23-353,F,10/30/16,SAS,@,MIA,W,0,17,2,3,0.667,0,0,,2,3,0.667,0,0,,1,0,1
13284,Patrick Beverley,28-185,G,1/13/17,HOU,,MEM,L,1,33,3,7,0.429,3,4,0.75,0,3,0,0,0,,0,2,2
13285,Patrick Beverley,28-180,G,1/8/17,HOU,@,TOR,W,1,32,2,6,0.333,2,3,0.667,0,3,0,2,2,1,0,2,2
13286,Patrick Beverley,28-158,G,12/17/16,HOU,@,MIN,W,1,43,2,6,0.333,2,6,0.333,0,0,,2,2,1,2,8,10
13287,Patrick Beverley,28-140,G,11/29/16,HOU,@,UTA,L,1,22,2,5,0.4,2,4,0.5,0,1,0,2,2,1,1,5,6
13288,Bismack Biyombo,24-110,C-F,12/16/16,ORL,,BRK,W,1,25,0,2,0,0,2,0,0,0,,6,8,0.75,3,4,7
13289,Bismack Biyombo,24-159,C-F,2/3/17,ORL,,TOR,W,0,18,2,4,0.5,2,4,0.5,0,0,,2,4,0.5,2,5,7
13290,Bismack Biyombo,24-195,C-F,3/11/17,ORL,,CLE,L,0,16,2,4,0.5,2,4,0.5,0,0,,2,2,1,2,6,8
13291,Bismack Biyombo,24-192,C-F,3/8/17,ORL,,CHI,W,1,35,3,11,0.273,3,11,0.273,0,0,,0,0,,2,4,6
13292,Bismack Biyombo,24-114,C-F,12/20/16,ORL,@,MIA,W,1,31,3,4,0.75,3,4,0.75,0,0,,0,4,0,2,7,9
13293,Nemanja Bjelica,28-190,F,11/15/16,MIN,,CHO,L,0,21,2,4,0.5,0,0,,2,4,0.5,0,0,,0,2,2
13294,Nemanja Bjelica,28-253,F,1/17/17,MIN,@,SAS,L,0,25,1,4,0.25,1,3,0.333,0,1,0,4,5,0.8,0,4,4
13295,Tarik Black,25-010,C-F,12/2/16,LAL,@,TOR,L,0,20,2,8,0.25,2,8,0.25,0,0,,2,3,0.667,6,0,6
13296,Tarik Black,24-345,C-F,11/1/16,LAL,@,IND,L,0,19,1,2,0.5,1,2,0.5,0,0,,4,4,1,2,6,8
13297,Tarik Black,25-008,C-F,11/30/16,LAL,@,CHI,W,0,12,2,2,1,2,2,1,0,0,,2,4,0.5,1,0,1
13298,Tarik Black,24-356,C-F,11/12/16,LAL,@,NOP,W,0,18,3,5,0.6,3,5,0.6,0,0,,0,0,,2,3,5
13299,Tarik Black,25-042,C-F,1/3/17,LAL,,MEM,W,0,10,1,4,0.25,1,4,0.25,0,0,,4,6,0.667,1,2,3
13300,Tarik Black,25-054,C-F,1/15/17,LAL,,DET,L,0,11,2,2,1,2,2,1,0,0,,2,3,0.667,0,2,2
13301,Tarik Black,25-054,C-F,1/15/17,LAL,,DET,L,0,11,2,2,1,2,2,1,0,0,,2,3,0.667,0,2,2
13302,Tarik Black,25-070,C-F,1/31/17,LAL,,DEN,W,1,18,3,5,0.6,3,5,0.6,0,0,,0,1,0,4,4,8
13303,Eric Bledsoe,26-345,G,11/18/16,PHO,@,IND,W,1,13,3,10,0.3,3,9,0.333,0,1,0,0,0,,0,3,3
13304,Bojan Bogdanovic,27-205,G-F,11/9/16,BRK,@,NYK,L,1,29,2,9,0.222,2,6,0.333,0,3,0,2,2,1,0,2,2
13305,Bojan Bogdanovic,27-319,G-F,3/3/17,WAS,,TOR,L,0,20,1,5,0.2,1,3,0.333,0,2,0,4,4,1,0,1,1
13306,Andrew Bogut,31-337,C,10/30/16,DAL,@,HOU,L,1,28,3,7,0.429,3,7,0.429,0,0,,0,2,0,5,10,15
13307,Andrew Bogut,31-333,C,10/26/16,DAL,@,IND,L,1,20,3,5,0.6,3,5,0.6,0,0,,0,2,0,2,4,6
13308,Andrew Bogut,32-059,C,1/26/17,DAL,@,OKC,L,1,17,3,5,0.6,3,5,0.6,0,0,,0,0,,1,2,3
13309,Andrew Bogut,31-354,C,11/16/16,DAL,@,BOS,L,1,25,3,7,0.429,3,7,0.429,0,0,,0,0,,1,6,7
13310,Trevor Booker,29-064,F,1/28/17,BRK,@,MIN,L,1,16,3,4,0.75,3,4,0.75,0,0,,0,0,,1,4,5
13311,Trevor Booker,29-099,F,3/4/17,BRK,@,POR,L,0,20,3,6,0.5,3,5,0.6,0,1,0,0,0,,1,5,6
13312,Trevor Booker,29-096,F,3/1/17,BRK,@,SAC,W,0,24,3,7,0.429,3,7,0.429,0,0,,0,0,,3,5,8
13313,Trevor Booker,29-033,F,12/28/16,BRK,@,CHI,L,1,26,3,7,0.429,3,7,0.429,0,0,,0,0,,5,8,13
13314,Trevor Booker,29-049,F,1/13/17,BRK,@,TOR,L,1,27,3,8,0.375,3,8,0.375,0,0,,0,0,,1,6,7
13315,Avery Bradley,26-093,G,2/27/17,BOS,,ATL,L,1,15,2,4,0.5,0,1,0,2,3,0.667,0,0,,0,0,0
13316,Corey Brewer,30-363,F-G,3/3/17,LAL,,BOS,L,0,12,3,4,0.75,3,4,0.75,0,0,,0,0,,0,3,3
13317,Corey Brewer,30-259,F-G,11/19/16,HOU,,UTA,W,0,15,2,3,0.667,2,2,1,0,1,0,2,2,1,2,3,5
13318,Corey Brewer,30-314,F-G,1/13/17,HOU,,MEM,L,0,17,2,7,0.286,1,3,0.333,1,4,0.25,1,2,0.5,1,3,4
13319,Corey Brewer,30-322,F-G,1/21/17,HOU,@,MEM,W,0,24,2,3,0.667,1,1,1,1,2,0.5,1,1,1,0,5,5
13320,Malcolm Brogdon,24-015,G,12/26/16,MIL,@,WAS,L,0,23,3,3,1,3,3,1,0,0,,0,0,,0,1,1
13321,Malcolm Brogdon,24-043,G,1/23/17,MIL,,HOU,W,0,30,2,8,0.25,2,6,0.333,0,2,0,2,4,0.5,0,2,2
13322,Malcolm Brogdon,24-059,G,2/8/17,MIL,,MIA,L,0,33,2,7,0.286,2,6,0.333,0,1,0,2,4,0.5,1,1,2
13323,Malcolm Brogdon,23-324,G,10/30/16,MIL,@,DET,L,0,17,3,7,0.429,3,6,0.5,0,1,0,0,1,0,0,2,2
13324,Malcolm Brogdon,24-096,G,3/17/17,MIL,@,LAL,W,1,32,2,7,0.286,2,3,0.667,0,4,0,2,2,1,0,5,5
13325,Malcolm Brogdon,24-009,G,12/20/16,MIL,,CLE,L,0,19,3,6,0.5,3,4,0.75,0,2,0,0,0,,0,1,1
13326,Aaron Brooks,31-338,G,12/17/16,IND,@,DET,W,0,18,3,7,0.429,3,6,0.5,0,1,0,0,0,,0,0,0
13327,Aaron Brooks,31-318,G,11/27/16,IND,,LAC,W,0,16,3,6,0.5,3,5,0.6,0,1,0,0,0,,2,2,4
13328,Anthony Brown,24-044,F-G,11/23/16,NOP,,MIN,W,0,3,2,2,1,0,0,,2,2,1,0,0,,0,0,0
13329,Bobby Brown,32-127,G,1/29/17,HOU,@,IND,L,0,3,2,3,0.667,0,1,0,2,2,1,0,0,,0,0,0
13330,Jaylen Brown,20-107,F,2/8/17,BOS,@,SAC,L,1,26,2,5,0.4,2,4,0.5,0,1,0,2,2,1,0,3,3
13331,Jaylen Brown,20-147,F,3/20/17,BOS,,WAS,W,0,20,3,6,0.5,3,4,0.75,0,2,0,0,0,,1,2,3
13332,Jaylen Brown,20-067,F,12/30/16,BOS,,MIA,W,0,16,3,4,0.75,3,3,1,0,1,0,0,0,,0,0,0
13333,Jaylen Brown,20-066,F,12/29/16,BOS,@,CLE,L,0,12,3,4,0.75,3,4,0.75,0,0,,0,0,,1,2,3
13334,Reggie Bullock,25-325,G-F,2/4/17,DET,@,IND,L,0,9,2,3,0.667,0,0,,2,3,0.667,0,0,,0,2,2
13335,Reggie Bullock,25-363,G-F,3/14/17,DET,@,CLE,L,0,21,2,6,0.333,1,2,0.5,1,4,0.25,1,1,1,0,2,2
13336,Reggie Bullock,25-250,G-F,11/21/16,DET,,HOU,L,0,10,3,5,0.6,3,4,0.75,0,1,0,0,0,,2,0,2
13337,Trey Burke,24-032,G,12/14/16,WAS,,CHO,W,0,18,3,4,0.75,3,3,1,0,1,0,0,0,,0,0,0
13338,Trey Burke,24-026,G,12/8/16,WAS,,DEN,W,0,12,3,6,0.5,3,6,0.5,0,0,,0,0,,1,0,1
13339,Trey Burke,24-041,G,12/23/16,WAS,@,MIL,L,0,16,2,5,0.4,2,4,0.5,0,1,0,2,2,1,0,0,0
13340,Trey Burke,24-059,G,1/10/17,WAS,,CHI,W,0,13,2,4,0.5,0,2,0,2,2,1,0,0,,0,1,1
13341,Trey Burke,24-073,G,1/24/17,WAS,,BOS,W,0,10,3,5,0.6,3,4,0.75,0,1,0,0,0,,1,1,2
13342,Trey Burke,24-000,G,11/12/16,WAS,@,CHI,L,0,17,3,7,0.429,3,7,0.429,0,0,,0,0,,0,0,0
13343,Trey Burke,24-039,G,12/21/16,WAS,@,CHI,W,0,12,3,5,0.6,3,5,0.6,0,0,,0,1,0,0,1,1
13344,Trey Burke,24-072,G,1/23/17,WAS,@,CHO,W,0,12,3,3,1,3,3,1,0,0,,0,0,,0,1,1
13345,Alec Burks,25-196,G,2/1/17,UTA,,MIL,W,0,25,2,7,0.286,1,3,0.333,1,4,0.25,1,2,0.5,0,4,4
13346,Kentavious Caldwell-Pope,24-016,G,3/6/17,DET,,CHI,W,1,36,2,9,0.222,0,3,0,2,6,0.333,0,0,,2,3,5
13347,Kentavious Caldwell-Pope,23-314,G,12/28/16,DET,,MIL,L,1,30,3,7,0.429,3,7,0.429,0,0,,0,0,,0,2,2
13348,Kentavious Caldwell-Pope,23-305,G,12/19/16,DET,@,CHI,L,1,24,3,6,0.5,3,5,0.6,0,1,0,0,0,,0,1,1
13349,Isaiah Canaan,25-206,G,12/13/16,CHI,,MIN,L,0,27,3,9,0.333,3,6,0.5,0,3,0,0,0,,0,3,3
13350,Isaiah Canaan,25-263,G,2/8/17,CHI,@,GSW,L,0,23,2,4,0.5,2,3,0.667,0,1,0,2,2,1,0,2,2
13351,Clint Capela,22-303,F-C,3/17/17,HOU,@,NOP,L,1,19,3,9,0.333,3,9,0.333,0,0,,0,2,0,2,2,4
13352,DeMarre Carroll,30-189,F,2/1/17,TOR,@,BOS,L,1,38,2,8,0.25,0,2,0,2,6,0.333,0,0,,1,5,6
13353,DeMarre Carroll,30-212,F,2/24/17,TOR,,BOS,W,1,28,2,4,0.5,1,1,1,1,3,0.333,1,2,0.5,1,3,4
13354,DeMarre Carroll,30-152,F,12/26/16,TOR,@,POR,W,1,27,2,7,0.286,0,2,0,2,5,0.4,0,0,,1,1,2
13355,Vince Carter,39-327,G-F,12/18/16,MEM,,UTA,L,0,18,2,6,0.333,1,4,0.25,1,2,0.5,1,1,1,1,1,2
13356,Vince Carter,40-031,G-F,2/26/17,MEM,@,DEN,W,0,26,2,6,0.333,2,3,0.667,0,3,0,2,2,1,0,2,2
13357,Vince Carter,39-323,G-F,12/14/16,MEM,,CLE,W,0,19,2,4,0.5,0,1,0,2,3,0.667,0,0,,1,4,5
13358,Vince Carter,39-305,G-F,11/26/16,MEM,@,MIA,W,0,16,2,8,0.25,2,3,0.667,0,5,0,2,2,1,0,4,4
13359,Vince Carter,39-329,G-F,12/20/16,MEM,,BOS,L,0,15,2,5,0.4,0,1,0,2,4,0.5,0,0,,0,2,2
13360,Omri Casspi,28-136,F,11/5/16,SAC,@,MIL,L,1,24,3,8,0.375,3,5,0.6,0,3,0,0,0,,3,3,6
13361,Omri Casspi,28-165,F,12/4/16,SAC,@,NYK,L,0,20,2,4,0.5,2,3,0.667,0,1,0,2,2,1,0,3,3
13362,Omri Casspi,28-189,F,12/28/16,SAC,@,POR,L,0,14,2,3,0.667,1,2,0.5,1,1,1,1,2,0.5,0,5,5
13363,Willie Cauley-Stein,23-106,F-C,12/2/16,SAC,@,BOS,L,0,12,3,5,0.6,3,5,0.6,0,0,,0,0,,0,1,1
13364,Willie Cauley-Stein,23-079,F-C,11/5/16,SAC,@,MIL,L,0,17,2,2,1,2,2,1,0,0,,2,2,1,0,3,3
13365,Willie Cauley-Stein,23-155,F-C,1/20/17,SAC,@,MEM,L,0,12,2,3,0.667,2,3,0.667,0,0,,2,2,1,0,2,2
13366,Willie Cauley-Stein,23-111,F-C,12/7/16,SAC,@,DAL,W,0,15,3,5,0.6,3,5,0.6,0,0,,0,2,0,1,2,3
13367,Willie Cauley-Stein,23-069,F-C,10/26/16,SAC,@,PHO,W,0,19,3,6,0.5,3,6,0.5,0,0,,0,0,,1,1,2
13368,Willie Cauley-Stein,23-084,F-C,11/10/16,SAC,,LAL,L,0,12,3,4,0.75,3,4,0.75,0,0,,0,0,,2,2,4
13369,Willie Cauley-Stein,23-124,F-C,12/20/16,SAC,,POR,W,0,7,3,3,1,3,3,1,0,0,,0,0,,0,0,0
13370,Tyson Chandler,34-085,C,12/26/16,PHO,@,HOU,L,1,20,3,6,0.5,3,6,0.5,0,0,,0,0,,5,3,8
13371,Tyson Chandler,34-031,C,11/2/16,PHO,,POR,W,1,28,2,4,0.5,2,4,0.5,0,0,,2,2,1,2,16,18
13372,Tyson Chandler,34-131,C,2/10/17,PHO,,CHI,W,1,12,3,4,0.75,3,4,0.75,0,0,,0,0,,1,4,5
13373,Tyson Chandler,34-059,C,11/30/16,PHO,,ATL,W,1,25,3,5,0.6,3,5,0.6,0,0,,0,0,,3,6,9
13374,Tyson Chandler,34-054,C,11/25/16,PHO,,MIN,L,0,11,3,3,1,3,3,1,0,0,,0,0,,3,4,7
13375,Wilson Chandler,29-298,F,3/4/17,DEN,,CHO,L,1,22,1,8,0.125,0,3,0,1,5,0.2,3,4,0.75,0,4,4
13376,Wilson Chandler,29-186,F,11/12/16,DEN,,DET,L,0,30,3,12,0.25,3,9,0.333,0,3,0,0,0,,2,8,10
13377,Wilson Chandler,29-305,F,3/11/17,DEN,@,SAC,W,1,29,3,13,0.231,3,8,0.375,0,5,0,0,0,,1,3,4
13378,Wilson Chandler,29-263,F,1/28/17,DEN,@,PHO,W,0,23,2,10,0.2,2,8,0.25,0,2,0,2,2,1,1,2,3
13379,Marquese Chriss,19-157,F,12/6/16,PHO,@,UTA,L,1,17,3,7,0.429,3,5,0.6,0,2,0,0,0,,2,2,4
13380,Marquese Chriss,19-219,F,2/6/17,PHO,@,NOP,L,1,17,3,7,0.429,3,5,0.6,0,2,0,0,1,0,0,3,3
13381,Marquese Chriss,19-170,F,12/19/16,PHO,@,MIN,L,1,17,2,6,0.333,1,4,0.25,1,2,0.5,1,2,0.5,3,1,4
13382,Marquese Chriss,19-201,F,1/19/17,PHO,@,CLE,L,1,22,3,7,0.429,3,7,0.429,0,0,,0,0,,2,2,4
13383,Marquese Chriss,19-140,F,11/19/16,PHO,@,PHI,L,1,20,2,7,0.286,0,2,0,2,5,0.4,0,2,0,0,2,2
13384,Rakeem Christmas,25-108,F,3/19/17,IND,@,TOR,L,0,16,2,4,0.5,2,4,0.5,0,0,,2,2,1,2,3,5
13385,Semaj Christon,24-050,G,12/21/16,OKC,@,NOP,W,0,14,3,7,0.429,3,5,0.6,0,2,0,0,0,,0,0,0
13386,Semaj Christon,24-001,G,11/2/16,OKC,@,LAC,W,0,15,3,7,0.429,3,7,0.429,0,0,,0,0,,1,1,2
13387,Ian Clark,25-276,G,12/8/16,GSW,@,UTA,W,0,20,2,5,0.4,0,2,0,2,3,0.667,0,0,,0,0,0
13388,Ian Clark,25-291,G,12/23/16,GSW,@,DET,W,0,15,2,2,1,2,2,1,0,0,,2,2,1,0,2,2
13389,Ian Clark,25-288,G,12/20/16,GSW,,UTA,W,0,10,2,5,0.4,1,3,0.333,1,2,0.5,1,2,0.5,0,1,1
13390,Ian Clark,25-281,G,12/13/16,GSW,@,NOP,W,0,13,2,6,0.333,0,2,0,2,4,0.5,0,0,,0,2,2
13391,Jordan Clarkson,24-238,G,1/31/17,LAL,,DEN,W,0,21,3,7,0.429,3,6,0.5,0,1,0,0,0,,0,3,3
13392,Darren Collison,29-079,G,11/10/16,SAC,,LAL,L,0,23,2,11,0.182,2,11,0.182,0,0,,2,2,1,0,2,2
13393,Darren Collison,29-097,G,11/28/16,SAC,@,WAS,L,1,32,2,6,0.333,2,5,0.4,0,1,0,2,2,1,2,1,3
13394,Darren Collison,29-127,G,12/28/16,SAC,@,POR,L,1,20,2,7,0.286,2,6,0.333,0,1,0,2,2,1,0,1,1
13395,Quinn Cook,23-343,G,3/1/17,DAL,@,ATL,L,0,14,2,5,0.4,0,1,0,2,4,0.5,0,0,,0,0,0
13396,Robert Covington,25-324,F,11/2/16,PHI,@,CHO,L,1,26,2,9,0.222,0,1,0,2,8,0.25,0,0,,1,2,3
13397,Allen Crabbe,24-310,G-F,2/13/17,POR,,ATL,L,0,31,2,5,0.4,1,3,0.333,1,2,0.5,1,2,0.5,0,3,3
13398,Allen Crabbe,24-211,G-F,11/6/16,POR,@,MEM,W,0,27,2,4,0.5,0,2,0,2,2,1,0,0,,0,3,3
13399,Allen Crabbe,24-287,G-F,1/21/17,POR,@,BOS,W,0,24,3,10,0.3,3,8,0.375,0,2,0,0,0,,0,2,2
13400,Allen Crabbe,24-232,G-F,11/27/16,POR,,HOU,L,0,29,2,5,0.4,0,2,0,2,3,0.667,0,0,,0,5,5
13401,Jamal Crawford,36-273,G,12/18/16,LAC,@,WAS,L,0,29,2,6,0.333,1,3,0.333,1,3,0.333,1,1,1,0,2,2
13402,Jamal Crawford,36-227,G,11/2/16,LAC,,OKC,L,0,26,3,11,0.273,3,7,0.429,0,4,0,0,0,,0,0,0
13403,Jae Crowder,26-236,F,2/27/17,BOS,,ATL,L,1,31,2,9,0.222,1,4,0.25,1,5,0.2,1,3,0.333,1,3,4
13404,Dante Cunningham,29-211,F,11/19/16,NOP,,CHO,W,1,43,2,8,0.25,0,5,0,2,3,0.667,0,0,,4,4,8
13405,Dante Cunningham,29-250,F,12/28/16,NOP,,LAC,W,1,32,2,6,0.333,0,1,0,2,5,0.4,0,0,,1,8,9
13406,Dante Cunningham,29-326,F,3/14/17,NOP,,POR,W,0,25,3,4,0.75,3,3,1,0,1,0,0,0,,0,10,10
13407,Dante Cunningham,29-320,F,3/8/17,NOP,,TOR,L,0,26,3,7,0.429,3,5,0.6,0,2,0,0,0,,1,4,5
13408,Dante Cunningham,29-317,F,3/5/17,NOP,@,LAL,W,0,24,2,6,0.333,1,2,0.5,1,4,0.25,1,2,0.5,2,2,4
13409,Dante Cunningham,29-240,F,12/18/16,NOP,@,SAS,L,0,17,2,5,0.4,1,2,0.5,1,3,0.333,1,2,0.5,0,1,1
13410,Dante Cunningham,29-290,F,2/6/17,NOP,,PHO,W,0,20,3,5,0.6,3,5,0.6,0,0,,0,0,,1,4,5
13411,Dante Cunningham,29-255,F,1/2/17,NOP,@,CLE,L,1,33,3,5,0.6,3,4,0.75,0,1,0,0,0,,0,6,6
13412,Seth Curry,26-071,G,11/2/16,DAL,@,UTA,L,0,15,3,4,0.75,3,3,1,0,1,0,0,0,,0,1,1
13413,Seth Curry,26-085,G,11/16/16,DAL,@,BOS,L,0,32,3,7,0.429,3,6,0.5,0,1,0,0,0,,0,4,4
13414,Troy Daniels,25-244,G,3/16/17,MEM,@,ATL,W,0,19,2,7,0.286,0,2,0,2,5,0.4,0,0,,1,3,4
13415,Troy Daniels,25-226,G,2/26/17,MEM,@,DEN,W,0,18,2,5,0.4,0,0,,2,5,0.4,0,0,,0,2,2
13416,Troy Daniels,25-243,G,3/15/17,MEM,@,CHI,W,0,19,2,8,0.25,0,1,0,2,7,0.286,0,0,,1,2,3
13417,Troy Daniels,25-131,G,11/23/16,MEM,@,PHI,W,1,23,2,7,0.286,0,2,0,2,5,0.4,0,0,,0,4,4
13418,Troy Daniels,25-177,G,1/8/17,MEM,,UTA,W,0,13,2,4,0.5,0,2,0,2,2,1,0,0,,0,2,2
13419,Troy Daniels,25-241,G,3/13/17,MEM,,MIL,W,0,15,2,8,0.25,0,2,0,2,6,0.333,0,0,,1,3,4
13420,Troy Daniels,25-159,G,12/21/16,MEM,@,DET,W,0,17,2,9,0.222,0,1,0,2,8,0.25,0,0,,0,1,1
13421,Troy Daniels,25-201,G,2/1/17,MEM,@,DEN,W,0,6,2,3,0.667,0,0,,2,3,0.667,0,0,,0,0,0
13422,Troy Daniels,25-197,G,1/28/17,MEM,@,UTA,W,0,19,2,4,0.5,0,1,0,2,3,0.667,0,0,,0,0,0
13423,Troy Daniels,25-213,G,2/13/17,MEM,@,BRK,W,0,16,2,5,0.4,0,1,0,2,4,0.5,0,0,,0,1,1
13424,Troy Daniels,25-210,G,2/10/17,MEM,,GSW,L,0,15,2,7,0.286,1,3,0.333,1,4,0.25,1,2,0.5,2,1,3
13425,Deyonta Davis,20-011,F-C,12/13/16,MEM,@,CLE,L,0,11,3,3,1,3,3,1,0,0,,0,1,0,1,3,4
13426,Ed Davis,27-191,F,12/13/16,POR,,OKC,W,0,11,2,3,0.667,2,3,0.667,0,0,,2,2,1,1,2,3
13427,Ed Davis,27-247,F,2/7/17,POR,@,DAL,W,0,18,3,5,0.6,3,5,0.6,0,0,,0,0,,3,2,5
13428,Ed Davis,27-142,F,10/25/16,POR,,UTA,W,0,24,2,3,0.667,2,3,0.667,0,0,,2,2,1,3,4,7
13429,Ed Davis,27-188,F,12/10/16,POR,@,IND,L,1,34,3,6,0.5,3,6,0.5,0,0,,0,0,,4,6,10
13430,Ed Davis,27-199,F,12/21/16,POR,,DAL,L,0,19,1,1,1,1,1,1,0,0,,4,6,0.667,5,5,10
13431,Dewayne Dedmon,27-133,C,12/23/16,SAS,@,POR,W,1,27,2,4,0.5,2,4,0.5,0,0,,2,2,1,2,5,7
13432,Dewayne Dedmon,27-204,C,3/4/17,SAS,,MIN,W,1,18,3,3,1,3,3,1,0,0,,0,0,,2,2,4
13433,Dewayne Dedmon,27-219,C,3/19/17,SAS,,SAC,W,0,12,3,3,1,3,3,1,0,0,,0,0,,1,3,4
13434,Dewayne Dedmon,27-084,C,11/4/16,SAS,@,UTA,W,0,12,3,5,0.6,3,5,0.6,0,0,,0,0,,1,7,8
13435,Dewayne Dedmon,27-110,C,11/30/16,SAS,@,DAL,W,1,26,2,5,0.4,2,5,0.4,0,0,,2,2,1,1,9,10
13436,Dewayne Dedmon,27-128,C,12/18/16,SAS,,NOP,W,0,17,3,7,0.429,3,7,0.429,0,0,,0,0,,0,2,2
13437,Dewayne Dedmon,27-109,C,11/29/16,SAS,,ORL,L,0,17,3,4,0.75,3,4,0.75,0,0,,0,1,0,1,7,8
13438,Dewayne Dedmon,27-172,C,1/31/17,SAS,,OKC,W,1,17,2,3,0.667,2,3,0.667,0,0,,2,2,1,2,6,8
13439,Dewayne Dedmon,27-153,C,1/12/17,SAS,,LAL,W,0,21,2,3,0.667,2,3,0.667,0,0,,2,2,1,3,9,12
13440,Dewayne Dedmon,27-185,C,2/13/17,SAS,@,IND,W,1,28,3,5,0.6,3,5,0.6,0,0,,0,0,,5,7,12
13441,Sam Dekker,22-179,F,11/1/16,HOU,@,CLE,L,0,14,3,8,0.375,3,5,0.6,0,3,0,0,0,,1,2,3
13442,Sam Dekker,22-195,F,11/17/16,HOU,,POR,W,0,17,2,3,0.667,2,2,1,0,1,0,2,2,1,1,1,2
13443,Sam Dekker,22-285,F,2/15/17,HOU,,MIA,L,0,21,3,6,0.5,3,3,1,0,3,0,0,0,,2,1,3
13444,Malcolm Delaney,27-239,G,11/5/16,ATL,,HOU,W,0,16,3,7,0.429,3,5,0.6,0,2,0,0,0,,0,1,1
13445,Malcolm Delaney,27-269,G,12/5/16,ATL,,OKC,L,0,14,2,5,0.4,2,5,0.4,0,0,,2,2,1,0,0,0
13446,Malcolm Delaney,27-234,G,10/31/16,ATL,,SAC,W,0,16,2,6,0.333,0,2,0,2,4,0.5,0,0,,0,2,2
13447,Matthew Dellavedova,26-093,G,12/10/16,MIL,@,WAS,L,1,31,2,8,0.25,0,3,0,2,5,0.4,0,0,,1,1,2
13448,Matthew Dellavedova,26-194,G,3/21/17,MIL,@,POR,W,0,25,2,7,0.286,2,6,0.333,0,1,0,2,2,1,0,2,2
13449,Matthew Dellavedova,26-177,G,3/4/17,MIL,,TOR,W,0,26,2,11,0.182,2,9,0.222,0,2,0,2,2,1,0,3,3
13450,Luol Deng,31-218,F,11/20/16,LAL,,CHI,L,1,23,2,5,0.4,0,1,0,2,4,0.5,0,0,,0,4,4
13451,Luol Deng,31-285,F,1/26/17,LAL,@,UTA,L,1,21,3,6,0.5,3,6,0.5,0,0,,0,0,,1,3,4
13452,Luol Deng,31-237,F,12/9/16,LAL,,PHO,L,1,37,3,6,0.5,3,5,0.6,0,1,0,0,0,,0,11,11
13453,Luol Deng,31-314,F,2/24/17,LAL,@,OKC,L,0,18,3,9,0.333,3,8,0.375,0,1,0,0,0,,2,0,2
13454,Cheick Diallo,20-096,F,12/18/16,NOP,@,SAS,L,0,10,3,4,0.75,3,4,0.75,0,0,,0,0,,1,3,4
13455,Boris Diaw,34-261,F-C,1/2/17,UTA,@,BRK,W,0,13,3,7,0.429,3,6,0.5,0,1,0,0,0,,1,1,2
13456,Boris Diaw,34-273,F-C,1/14/17,UTA,,ORL,W,0,14,2,8,0.25,2,5,0.4,0,3,0,2,3,0.667,1,0,1
13457,Boris Diaw,34-272,F-C,1/13/17,UTA,,DET,W,0,18,2,3,0.667,2,3,0.667,0,0,,2,2,1,0,1,1
13458,Boris Diaw,34-285,F-C,1/26/17,UTA,,LAL,W,0,18,2,8,0.25,2,6,0.333,0,2,0,2,2,1,1,0,1
13459,Boris Diaw,34-301,F-C,2/11/17,UTA,,BOS,L,0,6,1,2,0.5,1,1,1,0,1,0,4,4,1,0,1,1
13460,Boris Diaw,34-282,F-C,1/23/17,UTA,,OKC,L,0,16,3,3,1,3,3,1,0,0,,0,0,,0,2,2
13461,Boris Diaw,34-321,F-C,3/3/17,UTA,,BRK,W,0,13,2,8,0.25,2,7,0.286,0,1,0,2,4,0.5,2,4,6
13462,Boris Diaw,34-280,F-C,1/21/17,UTA,,IND,W,0,19,3,7,0.429,3,7,0.429,0,0,,0,0,,1,2,3
13463,Boris Diaw,34-212,F-C,11/14/16,UTA,,MEM,L,0,21,3,4,0.75,3,4,0.75,0,0,,0,0,,1,0,1
13464,Gorgui Dieng,26-340,C,12/23/16,MIN,,SAC,L,1,43,3,5,0.6,3,5,0.6,0,0,,0,0,,3,7,10
13465,Gorgui Dieng,27-016,C,2/3/17,MIN,@,DET,L,1,32,3,9,0.333,3,8,0.375,0,1,0,0,0,,1,11,12
13466,Gorgui Dieng,26-347,C,12/30/16,MIN,,MIL,W,1,34,3,6,0.5,3,6,0.5,0,0,,0,0,,1,3,4
13467,Gorgui Dieng,26-299,C,11/12/16,MIN,,LAC,L,1,30,3,6,0.5,3,5,0.6,0,1,0,0,0,,3,2,5
13468,Gorgui Dieng,26-342,C,12/25/16,MIN,@,OKC,L,1,29,3,7,0.429,3,7,0.429,0,0,,0,0,,3,3,6
13469,Spencer Dinwiddie,23-329,G,3/1/17,BRK,@,SAC,W,0,27,1,5,0.2,1,5,0.2,0,0,,4,4,1,1,3,4
13470,Spencer Dinwiddie,23-344,G,3/16/17,BRK,@,NYK,W,0,21,1,2,0.5,0,1,0,1,1,1,3,6,0.5,0,3,3
13471,Toney Douglas,30-345,G,2/24/17,MEM,@,IND,L,0,18,3,7,0.429,3,3,1,0,4,0,0,0,,0,1,1
13472,Toney Douglas,30-355,G,3/6/17,MEM,,BRK,L,0,23,3,7,0.429,3,4,0.75,0,3,0,0,0,,0,0,0
13473,Goran Dragic,30-188,G,11/10/16,MIA,,CHI,L,1,22,3,9,0.333,3,7,0.429,0,2,0,0,0,,0,0,0
13474,Goran Dragic,30-201,G,11/23/16,MIA,@,DET,L,1,22,1,7,0.143,0,3,0,1,4,0.25,3,5,0.6,1,1,2
13475,Andre Drummond,23-084,C,11/2/16,DET,@,BRK,L,1,25,3,9,0.333,3,9,0.333,0,0,,0,0,,0,6,6
13476,Andre Drummond,23-217,C,3/15/17,DET,,UTA,L,1,20,3,4,0.75,3,4,0.75,0,0,,0,0,,0,5,5
13477,Jared Dudley,31-129,F-G,11/16/16,PHO,@,DEN,L,0,23,2,4,0.5,1,1,1,1,3,0.333,1,2,0.5,0,2,2
13478,Jared Dudley,31-231,F-G,2/26/17,PHO,@,MIL,L,0,25,2,5,0.4,0,1,0,2,4,0.5,0,0,,0,2,2
13479,Jared Dudley,31-110,F-G,10/28/16,PHO,@,OKC,L,1,25,1,2,0.5,0,0,,1,2,0.5,3,5,0.6,0,2,2
13480,Jared Dudley,31-156,F-G,12/13/16,PHO,,NYK,W,0,22,2,4,0.5,0,1,0,2,3,0.667,0,0,,0,6,6
13481,Jared Dudley,31-134,F-G,11/21/16,PHO,@,WAS,L,0,27,3,9,0.333,3,6,0.5,0,3,0,0,0,,1,4,5
13482,Jared Dudley,31-215,F-G,2/10/17,PHO,,CHI,W,0,14,2,4,0.5,0,1,0,2,3,0.667,0,0,,1,1,2
13483,Jared Dudley,31-115,F-G,11/2/16,PHO,,POR,W,1,21,2,5,0.4,0,2,0,2,3,0.667,0,0,,0,5,5
13484,Mike Dunleavy,36-051,F-G,11/5/16,CLE,@,PHI,W,0,13,2,5,0.4,0,1,0,2,4,0.5,0,0,,1,0,1
13485,Mike Dunleavy,36-102,F-G,12/26/16,CLE,@,DET,L,0,28,2,4,0.5,1,3,0.333,1,1,1,1,2,0.5,0,4,4
13486,Mike Dunleavy,36-127,F-G,1/20/17,ATL,,CHI,W,0,15,2,5,0.4,0,1,0,2,4,0.5,0,0,,0,0,0
13487,Mike Dunleavy,36-044,F-G,10/29/16,CLE,,ORL,W,0,20,2,8,0.25,0,2,0,2,6,0.333,0,0,,0,2,2
13488,Mike Dunleavy,36-120,F-G,1/13/17,ATL,,BOS,L,0,15,2,3,0.667,0,0,,2,3,0.667,0,0,,0,5,5
13489,Kris Dunn,22-278,G,12/21/16,MIN,@,ATL,W,0,15,2,5,0.4,1,2,0.5,1,3,0.333,1,1,1,0,1,1
13490,Kris Dunn,22-259,G,12/2/16,MIN,@,NYK,L,0,18,2,3,0.667,2,3,0.667,0,0,,2,2,1,0,1,1
13491,Kris Dunn,22-299,G,1/11/17,MIN,,HOU,W,0,13,3,7,0.429,3,7,0.429,0,0,,0,0,,1,2,3
13492,Kris Dunn,22-344,G,2/25/17,MIN,@,HOU,L,0,18,2,4,0.5,1,3,0.333,1,1,1,1,1,1,2,3,5
13493,Kris Dunn,22-250,G,11/23/16,MIN,@,NOP,L,0,26,2,4,0.5,2,4,0.5,0,0,,2,2,1,0,4,4
13494,Henry Ellenson,19-339,F,12/17/16,DET,,IND,L,0,5,2,2,1,0,0,,2,2,1,0,0,,0,0,0
13495,Wayne Ellington,29-107,G,2/13/17,MIA,,ORL,L,0,21,2,7,0.286,0,1,0,2,6,0.333,0,0,,0,0,0
13496,Wayne Ellington,29-100,G,2/6/17,MIA,@,MIN,W,0,15,2,4,0.5,0,2,0,2,2,1,0,0,,0,2,2
13497,Wayne Ellington,29-121,G,2/27/17,MIA,@,DAL,L,0,17,2,6,0.333,0,0,,2,6,0.333,0,1,0,0,2,2
13498,Monta Ellis,31-089,G,1/23/17,IND,,NYK,L,0,24,1,6,0.167,1,5,0.2,0,1,0,4,4,1,0,3,3
13499,Monta Ellis,31-137,G,3/12/17,IND,,MIA,W,0,19,2,6,0.333,1,5,0.2,1,1,1,1,2,0.5,0,1,1
13500,Monta Ellis,31-008,G,11/3/16,IND,@,MIL,L,1,34,2,4,0.5,2,2,1,0,2,0,2,2,1,0,3,3
13501,James Ennis,26-208,F,1/25/17,MEM,,TOR,W,1,37,2,6,0.333,0,3,0,2,3,0.667,0,0,,2,4,6
13502,Tyler Ennis,22-193,G,3/5/17,LAL,,NOP,L,0,7,2,3,0.667,0,1,0,2,2,1,0,0,,0,2,2
13503,Tyler Ennis,22-080,G,11/12/16,HOU,,SAS,L,0,9,3,6,0.5,3,5,0.6,0,1,0,0,0,,1,1,2
13504,Tyreke Evans,27-093,G-F,12/21/16,NOP,,OKC,L,0,15,2,6,0.333,1,4,0.25,1,2,0.5,1,1,1,0,1,1
13505,Dante Exum,21-160,G,12/20/16,UTA,@,GSW,L,1,26,2,2,1,0,0,,2,2,1,0,0,,0,1,1
13506,Dante Exum,21-119,G,11/9/16,UTA,@,CHO,L,0,24,2,4,0.5,1,1,1,1,3,0.333,1,2,0.5,0,1,1
13507,Kenneth Faried,26-347,F,10/31/16,DEN,@,TOR,L,0,15,1,3,0.333,1,3,0.333,0,0,,4,4,1,1,4,5
13508,Kenneth Faried,27-041,F,12/30/16,DEN,,PHI,L,0,12,1,3,0.333,1,3,0.333,0,0,,4,4,1,2,4,6
13509,Kenneth Faried,27-039,F,12/28/16,DEN,,MIN,W,0,16,3,4,0.75,3,4,0.75,0,0,,0,2,0,2,3,5
13510,Derrick Favors,25-211,F-C,2/11/17,UTA,,BOS,L,1,26,3,5,0.6,3,5,0.6,0,0,,0,0,,3,3,6
13511,Derrick Favors,25-209,F-C,2/9/17,UTA,@,DAL,L,1,33,2,9,0.222,2,9,0.222,0,0,,2,3,0.667,5,5,10
13512,Derrick Favors,25-112,F-C,11/4/16,UTA,,SAS,L,1,27,3,13,0.231,3,13,0.231,0,0,,0,0,,2,5,7
13513,Derrick Favors,25-171,F-C,1/2/17,UTA,@,BRK,W,1,18,3,7,0.429,3,7,0.429,0,0,,0,0,,1,2,3
13514,Derrick Favors,25-109,F-C,11/1/16,UTA,@,SAS,W,1,16,3,6,0.5,3,6,0.5,0,0,,0,0,,0,3,3
13515,Derrick Favors,25-122,F-C,11/14/16,UTA,,MEM,L,1,21,2,6,0.333,2,6,0.333,0,0,,2,2,1,0,2,2
13516,Derrick Favors,25-120,F-C,11/12/16,UTA,@,MIA,W,1,6,3,3,1,3,3,1,0,0,,0,0,,0,1,1
13517,Derrick Favors,25-161,F-C,12/23/16,UTA,,TOR,L,0,15,2,8,0.25,2,8,0.25,0,0,,2,2,1,2,5,7
13518,Kay Felder,21-255,G,12/9/16,CLE,,MIA,W,0,4,3,4,0.75,3,4,0.75,0,0,,0,0,,0,0,0
13519,Cristiano Felicio,24-204,F-C,1/27/17,CHI,,MIA,L,0,23,3,5,0.6,3,5,0.6,0,0,,0,2,0,2,2,4
13520,Cristiano Felicio,24-156,F-C,12/10/16,CHI,,MIA,W,0,17,2,3,0.667,2,3,0.667,0,0,,2,2,1,4,3,7
13521,Cristiano Felicio,24-216,F-C,2/8/17,CHI,@,GSW,L,0,15,3,4,0.75,3,4,0.75,0,0,,0,0,,2,2,4
13522,Cristiano Felicio,24-167,F-C,12/21/16,CHI,,WAS,L,0,7,3,3,1,3,3,1,0,0,,0,0,,1,2,3
13523,Cristiano Felicio,24-165,F-C,12/19/16,CHI,,DET,W,0,22,3,5,0.6,3,5,0.6,0,0,,0,0,,3,4,7
13524,Raymond Felton,32-173,G,12/16/16,LAC,@,MIA,W,0,17,1,3,0.333,1,3,0.333,0,0,,4,4,1,1,2,3
13525,Raymond Felton,32-171,G,12/14/16,LAC,@,ORL,W,0,17,2,6,0.333,2,5,0.4,0,1,0,2,2,1,0,1,1
13526,Raymond Felton,32-258,G,3/11/17,LAC,,PHI,W,0,22,3,6,0.5,3,5,0.6,0,1,0,0,0,,0,1,1
13527,Yogi Ferrell,23-193,G,11/18/16,BRK,@,OKC,L,0,19,1,5,0.2,1,2,0.5,0,3,0,4,4,1,3,1,4
13528,Yogi Ferrell,23-294,G,2/27/17,DAL,,MIA,W,1,29,2,9,0.222,1,7,0.143,1,2,0.5,1,2,0.5,2,3,5
13529,Dorian Finney-Smith,23-311,F,3/11/17,DAL,,PHO,L,0,14,2,3,0.667,0,1,0,2,2,1,0,0,,1,4,5
13530,Dorian Finney-Smith,23-201,F,11/21/16,DAL,@,SAS,L,1,27,2,5,0.4,2,2,1,0,3,0,2,2,1,0,1,1
13531,Dorian Finney-Smith,23-319,F,3/19/17,DAL,@,BRK,W,0,12,2,3,0.667,0,0,,2,3,0.667,0,0,,0,1,1
13532,Tim Frazier,26-028,G,11/29/16,NOP,,LAL,W,1,32,3,7,0.429,3,5,0.6,0,2,0,0,0,,0,1,1
13533,Channing Frye,33-161,C-F,10/25/16,CLE,,NYK,W,0,14,2,6,0.333,0,1,0,2,5,0.4,0,0,,2,2,4
13534,Channing Frye,33-204,C-F,12/7/16,CLE,@,NYK,W,0,13,2,4,0.5,0,1,0,2,3,0.667,0,0,,0,0,0
13535,Channing Frye,33-301,C-F,3/14/17,CLE,,DET,W,0,20,2,4,0.5,0,1,0,2,3,0.667,0,0,,0,3,3
13536,Langston Galloway,25-027,G,1/5/17,NOP,,ATL,L,0,18,2,7,0.286,0,1,0,2,6,0.333,0,0,,1,1,2
13537,Langston Galloway,25-094,G,3/13/17,SAC,,ORL,W,0,22,2,4,0.5,0,2,0,2,2,1,0,0,,0,0,0
13538,Langston Galloway,24-325,G,10/29/16,NOP,@,SAS,L,0,23,3,10,0.3,3,6,0.5,0,4,0,0,0,,0,4,4
13539,Langston Galloway,25-021,G,12/30/16,NOP,,NYK,W,0,21,2,8,0.25,0,1,0,2,7,0.286,0,0,,0,2,2
13540,Langston Galloway,25-051,G,1/29/17,NOP,,WAS,L,0,11,2,4,0.5,0,0,,2,4,0.5,0,0,,0,2,2
13541,Marc Gasol,31-295,C,11/19/16,MEM,,MIN,W,1,35,2,12,0.167,2,11,0.182,0,1,0,2,2,1,0,7,7
13542,Pau Gasol,36-146,F-C,11/29/16,SAS,,ORL,L,1,22,2,6,0.333,2,5,0.4,0,1,0,2,2,1,2,4,6
13543,Pau Gasol,36-188,F-C,1/10/17,SAS,,MIL,L,1,28,3,9,0.333,3,8,0.375,0,1,0,0,0,,3,8,11
13544,Taj Gibson,31-247,F,2/26/17,OKC,,NOP,W,0,21,2,9,0.222,2,9,0.222,0,0,,2,2,1,1,4,5
13545,Taj Gibson,31-215,F,1/25/17,CHI,,ATL,L,1,28,3,10,0.3,3,9,0.333,0,1,0,0,2,0,5,5,10
13546,Taj Gibson,31-254,F,3/5/17,OKC,@,DAL,L,0,23,2,5,0.4,2,5,0.4,0,0,,2,3,0.667,0,2,2
13547,Taj Gibson,31-192,F,1/2/17,CHI,,CHO,W,1,27,3,8,0.375,3,8,0.375,0,0,,0,0,,5,3,8
13548,Taj Gibson,31-210,F,1/20/17,CHI,@,ATL,L,1,18,3,5,0.6,3,4,0.75,0,1,0,0,0,,3,0,3
13549,Manu Ginobili,39-213,G,2/26/17,SAS,@,LAL,W,0,20,2,4,0.5,0,0,,2,4,0.5,0,0,,0,0,0
13550,Manu Ginobili,39-211,G,2/24/17,SAS,@,LAC,W,0,22,2,5,0.4,1,1,1,1,4,0.25,1,1,1,2,0,2
13551,Manu Ginobili,39-109,G,11/14/16,SAS,,MIA,W,0,17,2,5,0.4,0,3,0,2,2,1,0,0,,0,3,3
13552,Manu Ginobili,39-130,G,12/5/16,SAS,@,MIL,W,0,21,2,7,0.286,1,4,0.25,1,3,0.333,1,2,0.5,0,2,2
13553,Manu Ginobili,39-226,G,3/11/17,SAS,,GSW,W,0,19,2,6,0.333,2,4,0.5,0,2,0,2,3,0.667,2,3,5
13554,Rudy Gobert,24-201,C,1/13/17,UTA,,DET,W,1,31,3,4,0.75,3,4,0.75,0,0,,0,0,,3,7,10
13555,Rudy Gobert,24-147,C,11/20/16,UTA,@,DEN,L,1,26,3,6,0.5,3,6,0.5,0,0,,0,0,,3,4,7
13556,Rudy Gobert,24-128,C,11/1/16,UTA,@,SAS,W,1,33,1,4,0.25,1,4,0.25,0,0,,4,6,0.667,2,10,12
13557,Rudy Gobert,24-141,C,11/14/16,UTA,,MEM,L,1,22,2,3,0.667,2,3,0.667,0,0,,2,2,1,0,5,5
13558,Rudy Gobert,24-158,C,12/1/16,UTA,,MIA,L,1,35,3,4,0.75,3,4,0.75,0,0,,0,0,,3,7,10
13559,Aaron Gordon,21-181,F,3/16/17,ORL,@,GSW,L,1,21,2,7,0.286,2,5,0.4,0,2,0,2,4,0.5,2,1,3
13560,Aaron Gordon,21-097,F,12/22/16,ORL,@,NYK,L,1,19,3,8,0.375,3,5,0.6,0,3,0,0,0,,0,2,2
13561,Eric Gordon,28-026,G,1/20/17,HOU,,GSW,L,0,33,2,14,0.143,2,7,0.286,0,7,0,2,2,1,1,3,4
13562,Marcin Gortat,32-334,C-F,1/16/17,WAS,,POR,W,1,27,3,9,0.333,3,9,0.333,0,0,,0,0,,2,4,6
13563,Marcin Gortat,33-018,C-F,3/7/17,WAS,@,PHO,W,1,19,3,8,0.375,3,8,0.375,0,0,,0,0,,0,3,3
13564,Marcin Gortat,33-029,C-F,3/18/17,WAS,@,CHO,L,1,27,2,7,0.286,2,7,0.286,0,0,,2,2,1,2,14,16
13565,Marcin Gortat,33-014,C-F,3/3/17,WAS,,TOR,L,1,31,2,7,0.286,2,6,0.333,0,1,0,2,2,1,0,6,6
13566,Marcin Gortat,32-293,C-F,12/6/16,WAS,,ORL,L,1,38,3,11,0.273,3,11,0.273,0,0,,0,1,0,2,9,11
13567,Marcin Gortat,33-009,C-F,2/26/17,WAS,,UTA,L,1,28,3,9,0.333,3,9,0.333,0,0,,0,0,,2,6,8
13568,Treveon Graham,23-030,G,11/28/16,CHO,@,MEM,W,0,4,2,2,1,0,0,,2,2,1,0,0,,0,0,0
13569,Jerami Grant,22-231,F,10/29/16,PHI,,ATL,L,0,19,2,7,0.286,2,6,0.333,0,1,0,2,4,0.5,0,3,3
13570,Jerami Grant,22-258,F,11/25/16,OKC,@,DEN,W,0,29,1,6,0.167,1,3,0.333,0,3,0,4,6,0.667,0,5,5
13571,Jerami Grant,22-256,F,11/23/16,OKC,@,SAC,L,0,32,2,5,0.4,2,3,0.667,0,2,0,2,4,0.5,0,3,3
13572,Jerami Grant,22-268,F,12/5/16,OKC,@,ATL,W,0,25,3,6,0.5,3,5,0.6,0,1,0,0,0,,0,2,2
13573,Jerami Grant,22-236,F,11/3/16,OKC,@,GSW,L,0,25,3,9,0.333,3,9,0.333,0,0,,0,2,0,1,3,4
13574,Jerami Grant,22-235,F,11/2/16,OKC,@,LAC,W,0,18,2,6,0.333,2,6,0.333,0,0,,2,4,0.5,0,2,2
13575,Jerian Grant,24-110,G,1/27/17,CHI,,MIA,L,1,14,2,5,0.4,2,3,0.667,0,2,0,2,3,0.667,1,0,1
13576,Jerian Grant,24-055,G,12/3/16,CHI,@,DAL,L,0,25,3,6,0.5,3,6,0.5,0,0,,0,0,,0,1,1
13577,Jerian Grant,24-071,G,12/19/16,CHI,,DET,W,0,15,3,5,0.6,3,5,0.6,0,0,,0,0,,0,0,0
13578,Jerian Grant,24-024,G,11/2/16,CHI,@,BOS,L,0,13,3,3,1,3,3,1,0,0,,0,0,,0,2,2
13579,Jerian Grant,24-139,G,2/25/17,CHI,@,CLE,W,1,16,2,4,0.5,0,1,0,2,3,0.667,0,0,,0,3,3
13580,Jerian Grant,24-039,G,11/17/16,CHI,@,UTA,W,1,29,2,10,0.2,2,8,0.25,0,2,0,2,2,1,0,5,5
13581,Danny Green,29-235,G-F,2/12/17,SAS,@,NYK,L,1,34,2,13,0.154,0,3,0,2,10,0.2,0,0,,2,1,3
13582,Danny Green,29-255,G-F,3/4/17,SAS,,MIN,W,1,38,2,8,0.25,1,3,0.333,1,5,0.2,1,2,0.5,4,0,4
13583,Danny Green,29-166,G-F,12/5/16,SAS,@,MIL,W,1,19,2,6,0.333,0,1,0,2,5,0.4,0,0,,0,1,1
13584,Danny Green,29-199,G-F,1/7/17,SAS,,CHO,W,1,21,2,6,0.333,0,2,0,2,4,0.5,0,0,,1,3,4
13585,Danny Green,29-254,G-F,3/3/17,SAS,@,NOP,W,1,36,3,10,0.3,3,7,0.429,0,3,0,0,0,,0,7,7
13586,Danny Green,29-197,G-F,1/5/17,SAS,@,DEN,W,1,25,2,7,0.286,0,1,0,2,6,0.333,0,0,,1,4,5
13587,Danny Green,29-213,G-F,1/21/17,SAS,@,CLE,W,1,32,2,5,0.4,0,0,,2,5,0.4,0,0,,0,2,2
13588,Danny Green,29-195,G-F,1/3/17,SAS,,TOR,W,1,22,2,5,0.4,0,2,0,2,3,0.667,0,0,,0,3,3
13589,Danny Green,29-176,G-F,12/15/16,SAS,@,PHO,W,1,16,2,2,1,0,0,,2,2,1,0,0,,0,1,1
13590,Danny Green,29-157,G-F,11/26/16,SAS,@,WAS,W,1,27,2,4,0.5,0,0,,2,4,0.5,0,0,,0,5,5
13591,Danny Green,29-223,G-F,1/31/17,SAS,,OKC,W,1,24,2,6,0.333,0,1,0,2,5,0.4,0,0,,0,1,1
13592,Danny Green,29-206,G-F,1/14/17,SAS,@,PHO,L,1,28,3,7,0.429,3,3,1,0,4,0,0,0,,0,2,2
13593,Danny Green,29-186,G-F,12/25/16,SAS,,CHI,W,1,24,2,4,0.5,0,0,,2,4,0.5,0,0,,0,3,3
13594,Draymond Green,26-242,F,11/1/16,GSW,@,POR,W,1,30,2,3,0.667,1,1,1,1,2,0.5,1,2,0.5,0,8,8
13595,Draymond Green,26-344,F,2/11/17,GSW,@,OKC,W,1,34,2,7,0.286,2,6,0.333,0,1,0,2,2,1,0,8,8
13596,Draymond Green,26-324,F,1/22/17,GSW,@,ORL,W,1,33,1,7,0.143,1,3,0.333,0,4,0,4,4,1,4,6,10
13597,Gerald Green,30-282,G-F,11/3/16,BOS,@,CLE,L,0,9,2,6,0.333,0,2,0,2,4,0.5,0,0,,0,0,0
13598,Gerald Green,31-021,G-F,2/16/17,BOS,@,CHI,L,0,12,2,5,0.4,0,1,0,2,4,0.5,0,0,,1,2,3
13599,Gerald Green,30-297,G-F,11/18/16,BOS,,GSW,L,0,17,2,11,0.182,0,6,0,2,5,0.4,0,0,,0,6,6
13600,Gerald Green,31-043,G-F,3/10/17,BOS,@,DEN,L,0,15,1,2,0.5,0,0,,1,2,0.5,3,4,0.75,0,3,3
13601,JaMychal Green,26-239,F,2/15/17,MEM,,NOP,L,1,22,3,8,0.375,3,6,0.5,0,2,0,0,1,0,2,4,6
13602,JaMychal Green,26-140,F,11/8/16,MEM,,DEN,W,1,26,3,7,0.429,3,6,0.5,0,1,0,0,0,,1,3,4
13603,JaMychal Green,26-170,F,12/8/16,MEM,,POR,W,1,34,2,8,0.25,2,6,0.333,0,2,0,2,2,1,3,15,18
13604,JaMychal Green,26-178,F,12/16/16,MEM,,SAC,L,1,21,2,5,0.4,2,3,0.667,0,2,0,2,2,1,1,7,8
13605,JaMychal Green,26-133,F,11/1/16,MEM,@,MIN,L,1,27,2,8,0.25,1,5,0.2,1,3,0.333,1,2,0.5,0,2,2
13606,JaMychal Green,26-150,F,11/18/16,MEM,@,DAL,W,1,32,2,6,0.333,1,3,0.333,1,3,0.333,1,2,0.5,0,12,12
13607,Jeff Green,30-110,F,12/16/16,ORL,,BRK,W,0,27,2,8,0.25,2,4,0.5,0,4,0,2,2,1,0,0,0
13608,Jeff Green,30-159,F,2/3/17,ORL,,TOR,W,0,13,3,9,0.333,3,8,0.375,0,1,0,0,0,,1,0,1
13609,Jeff Green,30-157,F,2/1/17,ORL,,IND,L,0,16,2,7,0.286,2,5,0.4,0,2,0,2,2,1,0,1,1
13610,Jeff Green,30-093,F,11/29/16,ORL,@,SAS,W,0,25,3,10,0.3,3,8,0.375,0,2,0,0,0,,1,2,3
13611,Jeff Green,30-117,F,12/23/16,ORL,,LAL,W,0,20,2,3,0.667,1,1,1,1,2,0.5,1,2,0.5,0,0,0
13612,Jeff Green,30-133,F,1/8/17,ORL,@,LAL,L,0,24,2,5,0.4,2,4,0.5,0,1,0,2,2,1,0,1,1
13613,Justin Hamilton,26-211,C,10/29/16,BRK,@,MIL,L,1,30,2,6,0.333,0,2,0,2,4,0.5,0,0,,1,2,3
13614,Justin Hamilton,26-286,C,1/12/17,BRK,,NOP,L,0,16,3,9,0.333,3,5,0.6,0,4,0,0,0,,1,3,4
13615,Justin Hamilton,26-240,C,11/27/16,BRK,,SAC,L,0,24,3,7,0.429,3,5,0.6,0,2,0,0,0,,4,6,10
13616,Justin Hamilton,26-315,C,2/10/17,BRK,,MIA,L,0,18,2,6,0.333,1,4,0.25,1,2,0.5,1,1,1,2,1,3
13617,Justin Hamilton,26-215,C,11/2/16,BRK,,DET,W,0,23,3,4,0.75,3,4,0.75,0,0,,0,0,,1,2,3
13618,Justin Hamilton,26-294,C,1/20/17,BRK,@,NOP,W,1,24,3,6,0.5,3,4,0.75,0,2,0,0,0,,1,4,5
13619,Tim Hardaway,24-305,G,1/15/17,ATL,,MIL,W,0,24,3,7,0.429,3,4,0.75,0,3,0,0,0,,0,2,2
13620,Maurice Harkless,23-300,F-G,3/7/17,POR,@,OKC,W,1,29,3,5,0.6,3,4,0.75,0,1,0,0,2,0,3,1,4
13621,Maurice Harkless,23-314,F-G,3/21/17,POR,,MIL,L,1,30,2,6,0.333,2,4,0.5,0,2,0,2,2,1,2,3,5
13622,Maurice Harkless,23-215,F-G,12/12/16,POR,@,LAC,L,1,32,3,7,0.429,3,6,0.5,0,1,0,0,0,,3,3,6
13623,Maurice Harkless,23-270,F-G,2/5/17,POR,@,OKC,L,0,22,3,6,0.5,3,5,0.6,0,1,0,0,0,,1,2,3
13624,Maurice Harkless,23-174,F-G,11/1/16,POR,,GSW,L,1,26,3,11,0.273,3,8,0.375,0,3,0,0,0,,1,1,2
13625,Montrezl Harrell,22-325,F-C,12/16/16,HOU,,NOP,W,0,16,3,4,0.75,3,3,1,0,1,0,0,0,,1,7,8
13626,Montrezl Harrell,22-302,F-C,11/23/16,HOU,,TOR,L,0,12,3,3,1,3,3,1,0,0,,0,0,,0,3,3
13627,Montrezl Harrell,22-361,F-C,1/21/17,HOU,@,MEM,W,1,16,3,6,0.5,3,5,0.6,0,1,0,0,0,,2,0,2
13628,Devin Harris,34-014,G,3/13/17,DAL,@,TOR,L,0,13,3,6,0.5,3,6,0.5,0,0,,0,1,0,0,2,2
13629,Devin Harris,33-354,G,2/15/17,DAL,@,DET,L,0,18,1,7,0.143,1,5,0.2,0,2,0,4,4,1,0,3,3
13630,Devin Harris,34-004,G,3/3/17,DAL,,MEM,W,0,15,3,7,0.429,3,4,0.75,0,3,0,0,2,0,0,1,1
13631,Joe Harris,25-175,G,3/1/17,BRK,@,SAC,W,0,21,2,6,0.333,0,0,,2,6,0.333,0,0,,0,3,3
13632,Joe Harris,25-051,G,10/28/16,BRK,,IND,W,0,18,2,7,0.286,0,1,0,2,6,0.333,0,0,,0,3,3
13633,Tobias Harris,24-213,F,2/13/17,DET,@,MIL,L,0,20,3,11,0.273,3,9,0.333,0,2,0,0,0,,2,1,3
13634,Andrew Harrison,22-021,G,11/18/16,MEM,@,DAL,W,0,26,2,8,0.25,1,4,0.25,1,4,0.25,1,2,0.5,0,4,4
13635,Andrew Harrison,22-075,G,1/11/17,MEM,@,OKC,L,0,11,2,5,0.4,2,4,0.5,0,1,0,2,2,1,0,0,0
13636,Andrew Harrison,22-029,G,11/26/16,MEM,@,MIA,W,0,24,0,2,0,0,1,0,0,1,0,6,8,0.75,0,2,2
13637,Andrew Harrison,22-094,G,1/30/17,MEM,@,PHO,W,0,10,1,1,1,0,0,,1,1,1,3,4,0.75,0,0,0
13638,Andrew Harrison,22-041,G,12/8/16,MEM,,POR,W,1,26,2,12,0.167,2,8,0.25,0,4,0,2,4,0.5,1,0,1
13639,Andrew Harrison,22-036,G,12/3/16,MEM,,LAL,W,1,30,2,7,0.286,1,2,0.5,1,5,0.2,1,2,0.5,1,3,4
13640,Udonis Haslem,36-206,F-C,1/1/17,MIA,,DET,L,0,21,2,4,0.5,2,4,0.5,0,0,,2,2,1,1,5,6
13641,Spencer Hawes,28-199,C-F,11/13/16,CHO,@,CLE,L,0,20,3,7,0.429,3,7,0.429,0,0,,0,0,,2,3,5
13642,Spencer Hawes,28-274,C-F,1/27/17,CHO,@,NYK,L,0,25,1,4,0.25,1,2,0.5,0,2,0,4,4,1,2,3,5
13643,Spencer Hawes,28-244,C-F,12/28/16,CHO,@,ORL,W,0,8,3,4,0.75,3,3,1,0,1,0,0,0,,0,3,3
13644,Spencer Hawes,28-263,C-F,1/16/17,CHO,@,BOS,L,0,17,3,5,0.6,3,4,0.75,0,1,0,0,0,,0,3,3
13645,Spencer Hawes,28-184,C-F,10/29/16,CHO,,BOS,L,0,20,3,9,0.333,3,9,0.333,0,0,,0,0,,3,2,5
13646,Gordon Hayward,26-272,F-G,12/20/16,UTA,@,GSW,L,1,27,2,10,0.2,2,4,0.5,0,6,0,2,3,0.667,1,2,3
13647,Gerald Henderson,29-017,G,12/26/16,PHI,@,SAC,L,1,25,3,9,0.333,3,6,0.5,0,3,0,0,0,,0,2,2
13648,Gerald Henderson,28-339,G,11/12/16,PHI,@,ATL,L,1,21,3,6,0.5,3,5,0.6,0,1,0,0,2,0,1,2,3
13649,Gerald Henderson,29-061,G,2/8/17,PHI,,SAS,L,1,23,1,6,0.167,0,3,0,1,3,0.333,3,4,0.75,0,3,3
13650,John Henson,26-063,C-F,3/1/17,MIL,,DEN,L,0,18,3,6,0.5,3,6,0.5,0,0,,0,0,,1,3,4
13651,John Henson,26-083,C-F,3/21/17,MIL,@,POR,W,0,20,3,6,0.5,3,6,0.5,0,0,,0,0,,5,3,8
13652,John Henson,26-013,C-F,1/10/17,MIL,@,SAS,W,1,17,3,6,0.5,3,6,0.5,0,0,,0,0,,2,4,6
13653,John Henson,25-347,C-F,12/9/16,MIL,,ATL,L,1,25,3,6,0.5,3,6,0.5,0,0,,0,0,,2,4,6
13654,Juan Hernangomez,21-164,F,3/11/17,DEN,@,SAC,W,0,5,2,3,0.667,0,0,,2,3,0.667,0,0,,0,1,1
13655,Juan Hernangomez,21-083,F,12/20/16,DEN,@,LAC,L,0,6,2,4,0.5,2,3,0.667,0,1,0,2,2,1,1,1,2
13656,Juan Hernangomez,21-133,F,2/8/17,DEN,@,ATL,L,0,14,2,4,0.5,1,1,1,1,3,0.333,1,2,0.5,1,5,6
13657,Willy Hernangomez,22-182,C,11/25/16,NYK,,CHO,W,0,20,3,5,0.6,3,5,0.6,0,0,,0,0,,2,7,9
13658,Willy Hernangomez,22-198,C,12/11/16,NYK,@,LAL,W,0,20,3,8,0.375,3,7,0.429,0,1,0,0,0,,4,8,12
13659,Willy Hernangomez,22-289,C,3/12/17,NYK,@,BRK,L,1,17,3,8,0.375,3,7,0.429,0,1,0,0,0,,1,9,10
13660,Willy Hernangomez,22-227,C,1/9/17,NYK,,NOP,L,0,13,3,4,0.75,3,4,0.75,0,0,,0,0,,2,2,4
13661,Willy Hernangomez,22-189,C,12/2/16,NYK,,MIN,W,0,17,3,6,0.5,3,6,0.5,0,0,,0,0,,1,3,4
13662,Willy Hernangomez,22-187,C,11/30/16,NYK,@,MIN,W,0,8,2,2,1,2,2,1,0,0,,2,2,1,1,1,2
13663,Willy Hernangomez,22-239,C,1/21/17,NYK,,PHO,L,0,14,2,4,0.5,2,4,0.5,0,0,,2,2,1,0,8,8
13664,Mario Hezonja,22-019,F-G,3/16/17,ORL,@,GSW,L,0,24,3,10,0.3,3,8,0.375,0,2,0,0,1,0,0,4,4
13665,Roy Hibbert,30-048,C,1/28/17,CHO,,SAC,L,1,12,2,2,1,2,2,1,0,0,,2,2,1,1,1,2
13666,Roy Hibbert,29-360,C,12/5/16,CHO,@,DAL,W,0,22,2,3,0.667,2,3,0.667,0,0,,2,2,1,2,3,5
13667,Roy Hibbert,29-358,C,12/3/16,CHO,,MIN,L,0,18,2,8,0.25,2,8,0.25,0,0,,2,2,1,2,1,3
13668,Roy Hibbert,30-009,C,12/20/16,CHO,,LAL,W,0,9,2,3,0.667,2,3,0.667,0,0,,2,2,1,0,2,2
13669,Roy Hibbert,30-045,C,1/25/17,CHO,,GSW,L,1,17,2,3,0.667,2,3,0.667,0,0,,2,2,1,2,2,4
13670,Roy Hibbert,30-022,C,1/2/17,CHO,@,CHI,L,1,22,2,4,0.5,2,4,0.5,0,0,,2,2,1,0,1,1
13671,Roy Hibbert,30-001,C,12/12/16,CHO,@,IND,L,0,17,2,3,0.667,2,3,0.667,0,0,,2,2,1,1,2,3
13672,Roy Hibbert,29-338,C,11/13/16,CHO,@,CLE,L,0,13,3,5,0.6,3,5,0.6,0,0,,0,0,,2,1,3
13673,Roy Hibbert,29-351,C,11/26/16,CHO,,NYK,W,0,14,1,2,0.5,1,2,0.5,0,0,,4,4,1,1,2,3
13674,Buddy Hield,23-049,G,2/4/17,NOP,@,WAS,L,1,23,3,10,0.3,3,7,0.429,0,3,0,0,0,,1,2,3
13675,Buddy Hield,22-344,G,11/25/16,NOP,@,POR,L,0,12,2,4,0.5,1,2,0.5,1,2,0.5,1,1,1,0,1,1
13676,Buddy Hield,22-357,G,12/8/16,NOP,,PHI,L,1,34,2,12,0.167,0,6,0,2,6,0.333,0,0,,0,4,4
13677,Nene Hilario,34-188,F-C,3/20/17,HOU,,DEN,W,0,21,3,6,0.5,3,6,0.5,0,0,,0,0,,1,2,3
13678,George Hill,30-285,G,2/13/17,UTA,,LAC,L,1,26,2,11,0.182,1,5,0.2,1,6,0.167,1,2,0.5,0,1,1
13679,Solomon Hill,25-290,F,1/2/17,NOP,@,CLE,L,1,27,2,8,0.25,0,1,0,2,7,0.286,0,0,,0,2,2
13680,Solomon Hill,25-259,F,12/2/16,NOP,,LAC,L,1,25,2,3,0.667,0,0,,2,3,0.667,0,0,,0,2,2
13681,Darrun Hilliard,23-274,G,1/12/17,DET,@,GSW,L,0,26,2,12,0.167,2,8,0.25,0,4,0,2,4,0.5,0,1,1
13682,Jrue Holiday,26-259,G,2/26/17,NOP,@,OKC,L,1,33,3,9,0.333,3,7,0.429,0,2,0,0,0,,0,3,3
13683,Jrue Holiday,26-256,G,2/23/17,NOP,,HOU,L,1,35,3,12,0.25,3,6,0.5,0,6,0,0,0,,1,3,4
13684,Justin Holiday,27-229,G,11/20/16,NYK,,ATL,W,0,19,2,8,0.25,0,3,0,2,5,0.4,0,0,,0,2,2
13685,Justin Holiday,27-328,G,2/27/17,NYK,,TOR,L,0,15,2,5,0.4,1,3,0.333,1,2,0.5,1,1,1,0,1,1
13686,Justin Holiday,27-313,G,2/12/17,NYK,,SAS,W,0,13,2,3,0.667,0,1,0,2,2,1,0,0,,0,0,0
13687,Justin Holiday,27-282,G,1/12/17,NYK,,CHI,W,0,17,2,5,0.4,0,1,0,2,4,0.5,0,0,,0,0,0
13688,Rondae Hollis-Jefferson,22-033,F,2/5/17,BRK,,TOR,L,1,20,2,4,0.5,2,3,0.667,0,1,0,2,2,1,1,5,6
13689,Rondae Hollis-Jefferson,22-070,F,3/14/17,BRK,,OKC,L,1,26,1,2,0.5,1,2,0.5,0,0,,4,4,1,2,2,4
13690,Rondae Hollis-Jefferson,21-346,F,12/14/16,BRK,,LAL,W,0,19,2,4,0.5,2,3,0.667,0,1,0,2,2,1,3,4,7
13691,Rondae Hollis-Jefferson,22-064,F,3/8/17,BRK,@,ATL,L,1,18,1,3,0.333,1,2,0.5,0,1,0,4,6,0.667,1,1,2
13692,Rondae Hollis-Jefferson,22-075,F,3/19/17,BRK,,DAL,L,1,30,2,6,0.333,2,6,0.333,0,0,,2,2,1,1,8,9
13693,Rondae Hollis-Jefferson,22-020,F,1/23/17,BRK,,SAS,L,0,17,1,4,0.25,1,4,0.25,0,0,,4,4,1,1,4,5
13694,Richaun Holmes,23-060,F-C,12/14/16,PHI,,TOR,L,0,7,3,5,0.6,3,5,0.6,0,0,,0,0,,1,0,1
13695,Richaun Holmes,23-017,F-C,11/1/16,PHI,,ORL,L,0,23,3,6,0.5,3,6,0.5,0,0,,0,0,,1,6,7
13696,Richaun Holmes,23-011,F-C,10/26/16,PHI,,OKC,L,0,12,2,2,1,2,2,1,0,0,,2,2,1,1,2,3
13697,Richaun Holmes,23-119,F-C,2/11/17,PHI,,MIA,W,0,16,2,2,1,2,2,1,0,0,,2,3,0.667,4,0,4
13698,Rodney Hood,24-144,G-F,3/13/17,UTA,,LAC,W,1,20,2,7,0.286,2,7,0.286,0,0,,2,2,1,0,0,0
13699,Al Horford,30-269,C-F,2/27/17,BOS,,ATL,L,1,28,3,9,0.333,3,5,0.6,0,4,0,0,0,,1,5,6
13700,Al Horford,30-209,C-F,12/29/16,BOS,@,CLE,L,1,29,3,9,0.333,3,7,0.429,0,2,0,0,0,,0,1,1
13701,Dwight Howard,31-024,C,1/1/17,ATL,,SAS,W,1,34,2,4,0.5,2,4,0.5,0,0,,2,4,0.5,4,4,8
13702,Dwight Howard,30-363,C,12/5/16,ATL,,OKC,L,1,19,2,6,0.333,2,6,0.333,0,0,,2,4,0.5,3,3,6
13703,Dwight Howard,31-055,C,2/1/17,ATL,@,MIA,L,1,25,2,6,0.333,2,6,0.333,0,0,,2,2,1,3,8,11
13704,Dwight Howard,31-064,C,2/10/17,ATL,@,SAC,L,1,32,3,5,0.6,3,5,0.6,0,0,,0,0,,1,10,11
13705,Kris Humphries,31-326,F-C,12/28/16,ATL,,NYK,W,0,12,2,7,0.286,2,6,0.333,0,1,0,2,2,1,2,4,6
13706,Kris Humphries,31-284,F-C,11/16/16,ATL,,MIL,W,0,15,2,4,0.5,2,3,0.667,0,1,0,2,2,1,1,1,2
13707,Kris Humphries,31-333,F-C,1/4/17,ATL,@,ORL,W,0,14,2,5,0.4,2,4,0.5,0,1,0,2,2,1,0,0,0
13708,Kris Humphries,31-364,F-C,2/4/17,ATL,,ORL,W,0,12,2,4,0.5,2,4,0.5,0,0,,2,2,1,1,2,3
13709,Serge Ibaka,27-057,F-C,11/14/16,ORL,@,IND,L,1,28,3,13,0.231,3,9,0.333,0,4,0,0,0,,3,10,13
13710,Andre Iguodala,32-302,G-F,11/25/16,GSW,@,LAL,W,0,24,3,5,0.6,3,4,0.75,0,1,0,0,0,,0,4,4
13711,Andre Iguodala,32-318,G-F,12/11/16,GSW,@,MIN,W,0,29,1,6,0.167,0,3,0,1,3,0.333,3,4,0.75,1,3,4
13712,Andre Iguodala,33-004,G-F,2/1/17,GSW,,CHO,W,0,25,3,4,0.75,3,3,1,0,1,0,0,0,,0,5,5
13713,Andre Iguodala,33-036,G-F,3/5/17,GSW,@,NYK,W,0,31,2,5,0.4,0,0,,2,5,0.4,0,0,,1,2,3
13714,Andre Iguodala,32-342,G-F,1/4/17,GSW,,POR,W,0,30,2,3,0.667,1,2,0.5,1,1,1,1,2,0.5,2,3,5
13715,Andre Iguodala,33-051,G-F,3/20/17,GSW,@,OKC,W,0,22,1,4,0.25,1,3,0.333,0,1,0,4,4,1,0,4,4
13716,Andre Iguodala,32-320,G-F,12/13/16,GSW,@,NOP,W,0,31,2,6,0.333,0,1,0,2,5,0.4,0,0,,2,6,8
13717,Andre Iguodala,32-356,G-F,1/18/17,GSW,,OKC,W,0,25,3,4,0.75,3,4,0.75,0,0,,0,0,,1,1,2
13718,Ersan Ilyasova,29-305,F,3/16/17,ATL,,MEM,L,0,14,2,5,0.4,1,4,0.25,1,1,1,1,2,0.5,3,2,5
13719,Ersan Ilyasova,29-178,F,11/9/16,PHI,@,IND,L,0,21,2,6,0.333,1,4,0.25,1,2,0.5,1,2,0.5,0,2,2
13720,Joe Ingles,29-154,F-G,3/5/17,UTA,@,SAC,W,0,28,2,7,0.286,0,0,,2,7,0.286,0,0,,1,0,1
13721,Joe Ingles,29-113,F-G,1/23/17,UTA,,OKC,L,1,22,3,5,0.6,3,5,0.6,0,0,,0,0,,0,2,2
13722,Joe Ingles,29-095,F-G,1/5/17,UTA,@,TOR,L,0,26,3,6,0.5,3,3,1,0,3,0,0,0,,0,6,6
13723,Joe Ingles,29-127,F-G,2/6/17,UTA,@,ATL,W,1,24,2,2,1,0,0,,2,2,1,0,0,,1,3,4
13724,Joe Ingles,29-145,F-G,2/24/17,UTA,@,MIL,W,0,26,2,8,0.25,0,4,0,2,4,0.5,0,0,,1,6,7
13725,Joe Ingles,29-157,F-G,3/8/17,UTA,@,HOU,W,0,28,2,6,0.333,0,0,,2,6,0.333,0,0,,1,4,5
13726,Brandon Ingram,19-142,F,1/22/17,LAL,@,DAL,L,1,36,2,12,0.167,2,9,0.222,0,3,0,2,3,0.667,0,1,1
13727,Brandon Ingram,19-123,F,1/3/17,LAL,,MEM,W,0,25,2,4,0.5,2,4,0.5,0,0,,2,6,0.333,0,3,3
13728,Brandon Ingram,19-121,F,1/1/17,LAL,,TOR,L,0,26,2,7,0.286,2,4,0.5,0,3,0,2,2,1,1,2,3
13729,Brandon Ingram,19-165,F,2/14/17,LAL,,SAC,L,1,27,2,7,0.286,1,5,0.2,1,2,0.5,1,4,0.25,2,3,5
13730,Jarrett Jack,33-120,G,2/25/17,NOP,@,DAL,L,0,25,2,3,0.667,2,2,1,0,1,0,2,2,1,0,0,0
13731,Reggie Jackson,26-291,G,2/1/17,DET,,NOP,W,1,21,2,7,0.286,2,4,0.5,0,3,0,2,2,1,0,0,0
13732,Reggie Jackson,26-326,G,3/8/17,DET,@,IND,L,1,23,1,8,0.125,1,4,0.25,0,4,0,4,4,1,0,2,2
13733,Reggie Jackson,26-302,G,2/12/17,DET,@,TOR,W,1,17,1,5,0.2,1,3,0.333,0,2,0,4,4,1,0,0,0
13734,Reggie Jackson,26-332,G,3/14/17,DET,@,CLE,L,1,20,3,13,0.231,3,12,0.25,0,1,0,0,0,,0,1,1
13735,Al Jefferson,31-335,C-F,12/4/16,IND,@,LAC,W,0,18,2,4,0.5,2,4,0.5,0,0,,2,3,0.667,0,4,4
13736,Al Jefferson,31-365,C-F,1/3/17,IND,@,DET,W,0,12,2,7,0.286,2,7,0.286,0,0,,2,2,1,0,2,2
13737,Al Jefferson,31-299,C-F,10/29/16,IND,@,CHI,L,0,15,3,5,0.6,3,5,0.6,0,0,,0,0,,1,2,3
13738,Al Jefferson,31-361,C-F,12/30/16,IND,,CHI,W,0,17,2,6,0.333,2,6,0.333,0,0,,2,2,1,2,5,7
13739,Al Jefferson,31-343,C-F,12/12/16,IND,,CHO,W,0,12,3,7,0.429,3,7,0.429,0,0,,0,0,,1,2,3
13740,Al Jefferson,32-042,C-F,2/15/17,IND,@,CLE,L,0,13,3,7,0.429,3,7,0.429,0,0,,0,0,,2,4,6
13741,Al Jefferson,32-037,C-F,2/10/17,IND,@,WAS,L,0,17,3,6,0.5,3,6,0.5,0,0,,0,0,,1,7,8
13742,Al Jefferson,32-065,C-F,3/10/17,IND,@,MIL,L,0,13,2,7,0.286,2,7,0.286,0,0,,2,2,1,0,1,1
13743,Al Jefferson,31-319,C-F,11/18/16,IND,,PHO,L,0,6,3,4,0.75,3,4,0.75,0,0,,0,0,,1,1,2
13744,Richard Jefferson,36-155,F,11/23/16,CLE,,POR,W,0,25,3,4,0.75,3,3,1,0,1,0,0,0,,0,2,2
13745,Richard Jefferson,36-130,F,10/29/16,CLE,,ORL,W,0,23,3,6,0.5,3,4,0.75,0,2,0,0,0,,0,3,3
13746,Richard Jefferson,36-230,F,2/6/17,CLE,@,WAS,W,0,21,2,4,0.5,2,3,0.667,0,1,0,2,2,1,1,2,3
13747,Richard Jefferson,36-137,F,11/5/16,CLE,@,PHI,W,0,14,2,4,0.5,1,2,0.5,1,2,0.5,1,1,1,0,3,3
13748,Brandon Jennings,27-042,G,11/4/16,NYK,@,CHI,W,0,23,2,4,0.5,1,1,1,1,3,0.333,1,2,0.5,0,5,5
13749,Brandon Jennings,27-074,G,12/6/16,NYK,@,MIA,W,0,24,2,8,0.25,1,4,0.25,1,4,0.25,1,2,0.5,0,1,1
13750,Brandon Jennings,27-131,G,2/1/17,NYK,@,BRK,W,1,43,1,11,0.091,1,7,0.143,0,4,0,4,6,0.667,0,3,3
13751,Brandon Jennings,27-036,G,10/29/16,NYK,,MEM,W,0,16,2,4,0.5,0,0,,2,4,0.5,0,0,,0,2,2
13752,Brandon Jennings,27-050,G,11/12/16,NYK,@,TOR,L,0,16,2,6,0.333,2,6,0.333,0,0,,2,2,1,1,1,2
13753,Brandon Jennings,27-049,G,11/11/16,NYK,@,BOS,L,0,27,1,7,0.143,0,3,0,1,4,0.25,3,4,0.75,2,4,6
13754,Brandon Jennings,27-140,G,2/10/17,NYK,,DEN,L,1,39,2,10,0.2,0,4,0,2,6,0.333,0,0,,1,1,2
13755,Jonas Jerebko,29-336,F,2/1/17,BOS,,TOR,W,0,19,2,7,0.286,0,2,0,2,5,0.4,0,0,,0,3,3
13756,Jonas Jerebko,29-278,F,12/5/16,BOS,@,HOU,L,1,21,2,5,0.4,0,2,0,2,3,0.667,0,0,,3,2,5
13757,Jonas Jerebko,29-245,F,11/2/16,BOS,,CHI,W,0,22,2,5,0.4,2,5,0.4,0,0,,2,2,1,1,5,6
13758,Jonas Jerebko,29-303,F,12/30/16,BOS,,MIA,W,0,23,2,4,0.5,0,1,0,2,3,0.667,0,1,0,1,2,3
13759,Jonas Jerebko,29-287,F,12/14/16,BOS,@,SAS,L,0,15,2,6,0.333,2,3,0.667,0,3,0,2,2,1,0,0,0
13760,Amir Johnson,29-201,F,11/18/16,BOS,,GSW,L,1,16,3,5,0.6,3,5,0.6,0,0,,0,0,,1,1,2
13761,Amir Johnson,29-216,F,12/3/16,BOS,@,PHI,W,1,15,3,4,0.75,3,3,1,0,1,0,0,0,,0,2,2
13762,Amir Johnson,29-269,F,1/25/17,BOS,,HOU,W,0,10,2,2,1,2,2,1,0,0,,2,2,1,0,5,5
13763,Amir Johnson,29-247,F,1/3/17,BOS,,UTA,W,1,28,3,7,0.429,3,7,0.429,0,0,,0,0,,1,4,5
13764,Amir Johnson,29-224,F,12/11/16,BOS,@,OKC,L,1,29,3,8,0.375,3,7,0.429,0,1,0,0,0,,4,4,8
13765,Amir Johnson,29-309,F,3/6/17,BOS,@,LAC,L,1,24,2,5,0.4,2,5,0.4,0,0,,2,4,0.5,2,3,5
13766,Amir Johnson,29-251,F,1/7/17,BOS,,NOP,W,1,24,2,6,0.333,2,5,0.4,0,1,0,2,4,0.5,4,2,6
13767,James Johnson,29-361,F,2/15/17,MIA,@,HOU,W,0,31,3,10,0.3,3,8,0.375,0,2,0,0,0,,0,6,6
13768,James Johnson,29-342,F,1/27/17,MIA,@,CHI,W,0,31,3,15,0.2,3,13,0.231,0,2,0,0,1,0,4,5,9
13769,James Johnson,29-313,F,12/29/16,MIA,@,CHO,L,0,18,2,7,0.286,2,6,0.333,0,1,0,2,7,0.286,1,3,4
13770,Joe Johnson,35-183,G-F,12/29/16,UTA,,PHI,W,0,17,2,6,0.333,0,2,0,2,4,0.5,0,0,,0,0,0
13771,Joe Johnson,35-193,G-F,1/8/17,UTA,@,MEM,L,0,17,3,8,0.375,3,7,0.429,0,1,0,0,0,,0,3,3
13772,Joe Johnson,35-175,G-F,12/21/16,UTA,,SAC,L,0,22,2,7,0.286,0,2,0,2,5,0.4,0,0,,0,1,1
13773,Joe Johnson,35-245,G-F,3/1/17,UTA,,MIN,L,0,22,3,8,0.375,3,6,0.5,0,2,0,0,0,,1,3,4
13774,Stanley Johnson,20-275,F,2/28/17,DET,,POR,W,0,28,2,6,0.333,0,3,0,2,3,0.667,0,0,,2,5,7
13775,Stanley Johnson,20-164,F,11/9/16,DET,@,PHO,L,0,6,2,3,0.667,2,3,0.667,0,0,,2,2,1,0,0,0
13776,Stanley Johnson,20-196,F,12/11/16,DET,,PHI,L,0,26,2,8,0.25,1,5,0.2,1,3,0.333,1,2,0.5,1,1,2
13777,Stanley Johnson,20-166,F,11/11/16,DET,@,SAS,L,0,15,1,6,0.167,0,2,0,1,4,0.25,3,4,0.75,0,2,2
13778,Tyler Johnson,24-305,G,3/8/17,MIA,,CHO,W,0,22,2,6,0.333,0,2,0,2,4,0.5,0,0,,0,1,1
13779,Nikola Jokic,21-260,C-F,11/5/16,DEN,@,DET,L,1,23,3,9,0.333,3,9,0.333,0,0,,0,0,,2,4,6
13780,Nikola Jokic,21-267,C-F,11/12/16,DEN,,DET,L,0,20,2,7,0.286,2,7,0.286,0,0,,2,2,1,2,1,3
13781,Derrick Jones,20-009,F,2/24/17,PHO,@,CHI,L,0,14,2,4,0.5,2,4,0.5,0,0,,2,2,1,1,1,2
13782,Derrick Jones,20-000,F,2/15/17,PHO,,LAL,W,0,4,3,3,1,3,3,1,0,0,,0,0,,1,1,2
13783,Derrick Jones,20-020,F,3/7/17,PHO,,WAS,L,0,22,3,3,1,3,3,1,0,0,,0,0,,0,2,2
13784,Derrick Jones,20-034,F,3/21/17,PHO,@,MIA,L,0,18,2,4,0.5,2,4,0.5,0,0,,2,2,1,0,1,1
13785,Derrick Jones,20-016,F,3/3/17,PHO,,OKC,W,0,15,3,3,1,3,3,1,0,0,,0,0,,1,0,1
13786,Derrick Jones,20-030,F,3/17/17,PHO,,ORL,L,0,17,3,6,0.5,3,6,0.5,0,0,,0,0,,2,0,2
13787,James Jones,36-054,F-G,11/27/16,CLE,@,PHI,W,0,11,2,2,1,0,0,,2,2,1,0,0,,0,0,0
13788,Terrence Jones,24-325,F,11/29/16,NOP,,LAL,W,0,26,2,7,0.286,2,4,0.5,0,3,0,2,2,1,1,7,8
13789,Terrence Jones,24-359,F,1/2/17,NOP,@,CLE,L,0,18,2,5,0.4,2,5,0.4,0,0,,2,2,1,0,3,3
13790,Terrence Jones,24-308,F,11/12/16,NOP,,LAL,L,0,21,2,7,0.286,2,5,0.4,0,2,0,2,3,0.667,1,3,4
13791,Terrence Jones,24-291,F,10/26/16,NOP,,DEN,L,0,18,2,6,0.333,2,5,0.4,0,1,0,2,2,1,1,2,3
13792,Terrence Jones,24-337,F,12/11/16,NOP,@,PHO,W,0,25,2,9,0.222,1,6,0.167,1,3,0.333,1,2,0.5,2,4,6
13793,Terrence Jones,24-334,F,12/8/16,NOP,,PHI,L,0,19,2,4,0.5,2,2,1,0,2,0,2,4,0.5,0,3,3
13794,Tyus Jones,20-293,G,2/27/17,MIN,@,SAC,W,0,27,2,8,0.25,1,3,0.333,1,5,0.2,1,1,1,0,1,1
13795,Tyus Jones,20-311,G,3/17/17,MIN,@,MIA,L,0,14,3,6,0.5,3,4,0.75,0,2,0,0,0,,0,0,0
13796,Tyus Jones,20-291,G,2/25/17,MIN,@,HOU,L,0,21,2,8,0.25,1,3,0.333,1,5,0.2,1,2,0.5,0,4,4
13797,Tyus Jones,20-199,G,11/25/16,MIN,@,PHO,W,0,19,3,6,0.5,3,6,0.5,0,0,,0,0,,0,2,2
13798,Tyus Jones,20-179,G,11/5/16,MIN,@,OKC,L,0,16,0,4,0,0,2,0,0,2,0,6,6,1,1,1,2
13799,DeAndre Jordan,28-121,C,11/19/16,LAC,,CHI,W,1,27,3,6,0.5,3,6,0.5,0,0,,0,0,,1,8,9
13800,DeAndre Jordan,28-226,C,3/4/17,LAC,@,CHI,W,1,31,3,5,0.6,3,5,0.6,0,0,,0,0,,4,10,14
13801,DeAndre Jordan,28-121,C,11/19/16,LAC,,CHI,W,1,27,3,6,0.5,3,6,0.5,0,0,,0,0,,1,8,9
13802,DeAndre Jordan,28-226,C,3/4/17,LAC,@,CHI,W,1,31,3,5,0.6,3,5,0.6,0,0,,0,0,,4,10,14
13803,DeAndre Jordan,28-134,C,12/2/16,LAC,@,NOP,W,1,34,2,2,1,2,2,1,0,0,,2,2,1,3,10,13
13804,DeAndre Jordan,28-106,C,11/4/16,LAC,@,MEM,W,1,36,3,8,0.375,3,8,0.375,0,0,,0,0,,6,15,21
13805,DeAndre Jordan,28-199,C,2/5/17,LAC,@,BOS,L,1,31,2,6,0.333,2,6,0.333,0,0,,2,4,0.5,4,12,16
13806,Cory Joseph,25-191,G,2/27/17,TOR,@,NYK,W,1,34,3,7,0.429,3,4,0.75,0,3,0,0,0,,1,2,3
13807,Cory Joseph,25-067,G,10/26/16,TOR,,DET,W,0,22,3,6,0.5,3,6,0.5,0,0,,0,0,,2,2,4
13808,Cory Joseph,25-203,G,3/11/17,TOR,@,MIA,L,1,22,3,8,0.375,3,8,0.375,0,0,,0,0,,0,3,3
13809,Cory Joseph,25-114,G,12/12/16,TOR,,MIL,W,0,27,3,8,0.375,3,7,0.429,0,1,0,0,0,,1,3,4
13810,Cory Joseph,25-179,G,2/15/17,TOR,,CHO,W,0,25,2,6,0.333,0,4,0,2,2,1,0,0,,1,1,2
13811,Cory Joseph,25-081,G,11/9/16,TOR,@,OKC,W,0,19,2,4,0.5,1,3,0.333,1,1,1,1,2,0.5,0,0,0
13812,Cory Joseph,25-111,G,12/9/16,TOR,@,BOS,W,0,24,1,7,0.143,0,5,0,1,2,0.5,3,4,0.75,0,1,1
13813,Cory Joseph,25-160,G,1/27/17,TOR,,MIL,W,0,29,3,6,0.5,3,6,0.5,0,0,,0,0,,0,2,2
13814,Cory Joseph,25-128,G,12/26/16,TOR,@,POR,W,0,23,2,11,0.182,2,10,0.2,0,1,0,2,2,1,0,2,2
13815,Cory Joseph,25-072,G,10/31/16,TOR,,DEN,W,0,24,3,8,0.375,3,7,0.429,0,1,0,0,0,,1,2,3
13816,Frank Kaminsky,23-245,F-C,12/5/16,CHO,@,DAL,W,1,23,3,7,0.429,3,6,0.5,0,1,0,0,0,,0,3,3
13817,Frank Kaminsky,23-273,F-C,1/2/17,CHO,@,CHI,L,0,20,2,5,0.4,2,4,0.5,0,1,0,2,2,1,1,2,3
13818,Frank Kaminsky,23-252,F-C,12/12/16,CHO,@,IND,L,0,20,1,8,0.125,0,6,0,1,2,0.5,3,4,0.75,0,4,4
13819,Frank Kaminsky,23-250,F-C,12/10/16,CHO,@,CLE,L,0,29,2,13,0.154,1,8,0.125,1,5,0.2,1,2,0.5,4,2,6
13820,Enes Kanter,24-166,C,11/2/16,OKC,@,LAC,W,0,24,3,11,0.273,3,10,0.3,0,1,0,0,0,,3,9,12
13821,Enes Kanter,24-207,C,12/13/16,OKC,@,POR,L,0,19,1,7,0.143,1,6,0.167,0,1,0,4,7,0.571,5,2,7
13822,Michael Kidd-Gilchrist,23-037,F,11/2/16,CHO,,PHI,W,1,32,2,4,0.5,2,4,0.5,0,0,,2,4,0.5,2,11,13
13823,Michael Kidd-Gilchrist,23-085,F,12/20/16,CHO,,LAL,W,1,30,3,11,0.273,3,11,0.273,0,0,,0,0,,5,6,11
13824,Michael Kidd-Gilchrist,23-098,F,1/2/17,CHO,@,CHI,L,1,27,3,10,0.3,3,10,0.3,0,0,,0,0,,2,1,3
13825,Michael Kidd-Gilchrist,23-152,F,2/25/17,CHO,@,SAC,W,1,27,1,6,0.167,1,5,0.2,0,1,0,4,4,1,6,6,12
13826,Michael Kidd-Gilchrist,23-050,F,11/15/16,CHO,@,MIN,W,1,33,2,5,0.4,2,5,0.4,0,0,,2,4,0.5,0,6,6
13827,Michael Kidd-Gilchrist,23-077,F,12/12/16,CHO,@,IND,L,1,20,1,9,0.111,1,8,0.125,0,1,0,4,4,1,5,5,10
13828,Michael Kidd-Gilchrist,23-112,F,1/16/17,CHO,@,BOS,L,1,35,3,11,0.273,3,10,0.3,0,1,0,0,0,,2,7,9
13829,Michael Kidd-Gilchrist,23-142,F,2/15/17,CHO,@,TOR,L,1,36,2,7,0.286,2,7,0.286,0,0,,2,2,1,1,13,14
13830,Michael Kidd-Gilchrist,23-140,F,2/13/17,CHO,,PHI,L,1,32,2,2,1,2,2,1,0,0,,2,2,1,2,5,7
13831,Michael Kidd-Gilchrist,23-039,F,11/4/16,CHO,@,BRK,W,1,34,3,5,0.6,3,5,0.6,0,0,,0,0,,1,8,9
13832,Michael Kidd-Gilchrist,23-159,F,3/4/17,CHO,@,DEN,W,1,22,3,9,0.333,3,9,0.333,0,0,,0,0,,1,2,3
13833,Sean Kilpatrick,27-007,G,1/13/17,BRK,@,TOR,L,0,22,2,5,0.4,2,3,0.667,0,2,0,2,2,1,0,2,2
13834,Sean Kilpatrick,26-339,G,12/10/16,BRK,@,SAS,L,1,24,2,7,0.286,2,5,0.4,0,2,0,2,2,1,1,0,1
13835,Sean Kilpatrick,26-314,G,11/15/16,BRK,@,LAL,L,1,19,3,7,0.429,3,5,0.6,0,2,0,0,1,0,1,3,4
13836,Brandon Knight,25-070,G,2/10/17,PHO,,CHI,W,0,15,3,6,0.5,3,4,0.75,0,2,0,0,0,,1,2,3
13837,Brandon Knight,24-346,G,11/12/16,PHO,,BRK,L,0,22,2,13,0.154,2,9,0.222,0,4,0,2,2,1,2,7,9
13838,Kyle Korver,35-310,G-F,1/21/17,CLE,,SAS,L,0,22,2,3,0.667,0,0,,2,3,0.667,0,0,,1,1,2
13839,Kyle Korver,35-284,G-F,12/26/16,ATL,@,MIN,L,0,23,2,7,0.286,0,1,0,2,6,0.333,0,0,,0,3,3
13840,Kyle Korver,35-261,G-F,12/3/16,ATL,@,TOR,L,1,25,3,7,0.429,3,4,0.75,0,3,0,0,0,,0,0,0
13841,Kyle Korver,35-334,G-F,2/14/17,CLE,@,MIN,W,0,27,2,5,0.4,0,0,,2,5,0.4,0,0,,0,5,5
13842,Kosta Koufos,27-350,C,2/8/17,SAC,,BOS,W,1,27,3,8,0.375,3,8,0.375,0,0,,0,0,,3,8,11
13843,Kosta Koufos,27-251,C,11/1/16,SAC,@,MIA,L,0,25,3,4,0.75,3,3,1,0,1,0,0,0,,2,7,9
13844,Kosta Koufos,27-334,C,1/23/17,SAC,@,DET,W,1,12,3,5,0.6,3,5,0.6,0,0,,0,0,,0,3,3
13845,Kosta Koufos,27-298,C,12/18/16,SAC,@,DAL,L,1,23,3,3,1,3,3,1,0,0,,0,0,,2,7,9
13846,Kosta Koufos,27-315,C,1/4/17,SAC,,MIA,L,1,15,2,2,1,2,2,1,0,0,,2,2,1,1,3,4
13847,Kosta Koufos,28-001,C,2/25/17,SAC,,CHO,L,1,19,3,7,0.429,3,7,0.429,0,0,,0,0,,4,3,7
13848,Kosta Koufos,27-277,C,11/27/16,SAC,@,BRK,W,1,26,3,5,0.6,3,5,0.6,0,0,,0,0,,1,1,2
13849,Kosta Koufos,27-258,C,11/8/16,SAC,,NOP,W,1,23,3,7,0.429,3,7,0.429,0,0,,0,0,,2,5,7
13850,Kosta Koufos,27-308,C,12/28/16,SAC,@,POR,L,1,23,3,3,1,3,3,1,0,0,,0,0,,3,7,10
13851,Kosta Koufos,27-326,C,1/15/17,SAC,,OKC,L,0,16,3,6,0.5,3,6,0.5,0,0,,0,0,,1,0,1
13852,Kosta Koufos,27-341,C,1/30/17,SAC,@,PHI,L,1,17,3,4,0.75,3,4,0.75,0,0,,0,0,,0,0,0
13853,Kosta Koufos,27-306,C,12/26/16,SAC,,PHI,W,1,15,3,3,1,3,3,1,0,0,,0,2,0,0,3,3
13854,Mindaugas Kuzminskas,27-143,F,3/11/17,NYK,@,DET,L,0,7,2,4,0.5,2,4,0.5,0,0,,2,2,1,0,1,1
13855,Mindaugas Kuzminskas,27-064,F,12/22/16,NYK,,ORL,W,0,18,2,3,0.667,1,1,1,1,2,0.5,1,2,0.5,0,2,2
13856,Mindaugas Kuzminskas,27-092,F,1/19/17,NYK,,WAS,L,1,18,1,5,0.2,0,0,,1,5,0.2,3,4,0.75,0,1,1
13857,Mindaugas Kuzminskas,27-014,F,11/2/16,NYK,,HOU,L,0,6,1,3,0.333,0,2,0,1,1,1,3,4,0.75,1,0,1
13858,Jeremy Lamb,24-187,G-F,12/3/16,CHO,,MIN,L,0,12,2,5,0.4,0,2,0,2,3,0.667,0,0,,0,5,5
13859,Jeremy Lamb,24-269,G-F,2/23/17,CHO,@,DET,L,0,17,3,8,0.375,3,5,0.6,0,3,0,0,0,,0,4,4
13860,Jeremy Lamb,24-261,G-F,2/15/17,CHO,@,TOR,L,0,11,3,5,0.6,3,4,0.75,0,1,0,0,0,,0,2,2
13861,Joffrey Lauvergne,25-103,C-F,1/11/17,OKC,,MEM,W,0,11,1,2,0.5,1,1,1,0,1,0,4,4,1,1,2,3
13862,Joffrey Lauvergne,25-059,C-F,11/28/16,OKC,@,NYK,W,0,20,3,8,0.375,3,5,0.6,0,3,0,0,0,,0,5,5
13863,Joffrey Lauvergne,25-101,C-F,1/9/17,OKC,@,CHI,W,0,14,2,3,0.667,1,1,1,1,2,0.5,1,2,0.5,0,0,0
13864,Joffrey Lauvergne,25-057,C-F,11/26/16,OKC,,DET,W,0,12,1,4,0.25,1,3,0.333,0,1,0,4,8,0.5,1,3,4
13865,Ty Lawson,29-034,G,12/7/16,SAC,@,DAL,W,0,21,3,9,0.333,3,8,0.375,0,1,0,0,0,,0,2,2
13866,Ty Lawson,29-128,G,3/11/17,SAC,,DEN,L,0,24,3,8,0.375,3,6,0.5,0,2,0,0,0,,1,3,4
13867,Ty Lawson,29-097,G,2/8/17,SAC,,BOS,W,1,14,3,6,0.5,3,6,0.5,0,0,,0,0,,0,2,2
13868,Ty Lawson,29-043,G,12/16/16,SAC,@,MEM,W,0,22,2,5,0.4,1,3,0.333,1,2,0.5,1,2,0.5,0,3,3
13869,Courtney Lee,31-101,G,1/12/17,NYK,,CHI,W,1,31,3,8,0.375,3,4,0.75,0,4,0,0,0,,0,2,2
13870,David Lee,33-197,F,11/12/16,SAS,@,HOU,W,0,21,2,3,0.667,2,3,0.667,0,0,,2,3,0.667,0,6,6
13871,David Lee,33-179,F,10/25/16,SAS,@,GSW,W,0,11,2,4,0.5,2,4,0.5,0,0,,2,2,1,3,3,6
13872,David Lee,33-303,F,2/26/17,SAS,@,LAL,W,0,25,3,4,0.75,3,4,0.75,0,0,,0,0,,2,6,8
13873,David Lee,33-208,F,11/23/16,SAS,@,CHO,W,0,18,2,4,0.5,2,4,0.5,0,0,,2,2,1,0,3,3
13874,David Lee,33-292,F,2/15/17,SAS,@,ORL,W,0,18,3,3,1,3,3,1,0,0,,0,1,0,0,4,4
13875,David Lee,33-237,F,12/22/16,SAS,@,LAC,L,0,16,3,3,1,3,3,1,0,0,,0,0,,2,3,5
13876,David Lee,33-311,F,3/6/17,SAS,,HOU,W,0,23,3,6,0.5,3,6,0.5,0,0,,0,0,,5,3,8
13877,David Lee,33-235,F,12/20/16,SAS,@,HOU,W,0,17,3,5,0.6,3,5,0.6,0,0,,0,0,,0,4,4
13878,David Lee,33-183,F,10/29/16,SAS,,NOP,W,0,15,3,6,0.5,3,6,0.5,0,0,,0,0,,1,4,5
13879,Alex Len,23-195,C,12/28/16,PHO,@,SAS,L,0,20,2,4,0.5,2,4,0.5,0,0,,2,2,1,1,4,5
13880,Alex Len,23-228,C,1/30/17,PHO,,MEM,L,0,21,3,6,0.5,3,6,0.5,0,0,,0,1,0,3,4,7
13881,Alex Len,23-193,C,12/26/16,PHO,@,HOU,L,0,20,2,2,1,2,2,1,0,0,,2,2,1,1,5,6
13882,Alex Len,23-136,C,10/30/16,PHO,,GSW,L,0,18,2,7,0.286,2,7,0.286,0,0,,2,2,1,1,7,8
13883,Alex Len,23-260,C,3/3/17,PHO,,OKC,W,1,13,2,4,0.5,2,3,0.667,0,1,0,2,2,1,1,1,2
13884,Alex Len,23-167,C,11/30/16,PHO,,ATL,W,0,23,3,4,0.75,3,4,0.75,0,0,,0,0,,5,5,10
13885,Alex Len,23-233,C,2/4/17,PHO,,MIL,L,0,11,3,5,0.6,3,5,0.6,0,0,,0,0,,1,0,1
13886,Alex Len,23-162,C,11/25/16,PHO,,MIN,L,1,29,3,6,0.5,3,5,0.6,0,1,0,0,0,,2,9,11
13887,Alex Len,23-255,C,2/26/17,PHO,@,MIL,L,1,14,2,7,0.286,2,7,0.286,0,0,,2,2,1,4,5,9
13888,Alex Len,23-178,C,12/11/16,PHO,,NOP,L,0,15,1,5,0.2,1,5,0.2,0,0,,4,6,0.667,1,3,4
13889,Alex Len,23-272,C,3/15/17,PHO,,SAC,L,1,17,3,4,0.75,3,4,0.75,0,0,,0,0,,2,6,8
13890,Alex Len,23-214,C,1/16/17,PHO,,UTA,L,1,21,3,4,0.75,3,4,0.75,0,0,,0,1,0,0,5,5
13891,Meyers Leonard,25-003,C-F,3/2/17,POR,,OKC,W,0,10,2,3,0.667,1,1,1,1,2,0.5,1,2,0.5,1,0,1
13892,Meyers Leonard,24-316,C-F,1/8/17,POR,,DET,L,0,18,2,8,0.25,0,4,0,2,4,0.5,0,0,,0,4,4
13893,Meyers Leonard,24-264,C-F,11/17/16,POR,@,HOU,L,0,6,2,2,1,0,0,,2,2,1,0,0,,1,0,1
13894,Meyers Leonard,25-013,C-F,3/12/17,POR,@,PHO,W,0,14,3,5,0.6,3,3,1,0,2,0,0,0,,0,2,2
13895,Meyers Leonard,25-012,C-F,3/11/17,POR,,WAS,L,0,25,3,4,0.75,3,4,0.75,0,0,,0,0,,0,6,6
13896,Meyers Leonard,24-256,C-F,11/9/16,POR,@,LAC,L,0,22,3,8,0.375,3,6,0.5,0,2,0,0,0,,2,8,10
13897,Jon Leuer,27-169,F,10/30/16,DET,,MIL,W,0,27,3,5,0.6,3,4,0.75,0,1,0,0,0,,0,3,3
13898,Jon Leuer,27-261,F,1/30/17,DET,@,BOS,L,1,26,1,5,0.2,1,3,0.333,0,2,0,4,4,1,2,4,6
13899,Jon Leuer,27-207,F,12/7/16,DET,@,CHO,L,0,23,3,11,0.273,3,7,0.429,0,4,0,0,0,,0,4,4
13900,Jon Leuer,27-294,F,3/4/17,DET,@,PHI,W,1,19,3,7,0.429,3,6,0.5,0,1,0,0,0,,0,2,2
13901,Caris LeVert,22-136,G-F,1/8/17,BRK,,PHI,L,0,21,3,5,0.6,3,4,0.75,0,1,0,0,1,0,0,3,3
13902,Caris LeVert,22-133,G-F,1/5/17,BRK,@,IND,L,0,21,2,3,0.667,0,0,,2,3,0.667,0,0,,1,1,2
13903,DeAndre Liggins,28-285,G,1/10/17,CLE,@,UTA,L,1,19,2,4,0.5,0,1,0,2,3,0.667,0,0,,1,1,2
13904,DeAndre Liggins,28-251,G,12/7/16,CLE,@,NYK,W,1,21,2,2,1,0,0,,2,2,1,0,0,,1,1,2
13905,Shaun Livingston,31-140,G,1/29/17,GSW,@,POR,W,1,23,3,6,0.5,3,6,0.5,0,0,,0,0,,0,1,1
13906,Shaun Livingston,31-167,G,2/25/17,GSW,,BRK,W,0,17,3,6,0.5,3,6,0.5,0,0,,0,0,,0,2,2
13907,Shaun Livingston,31-053,G,11/3/16,GSW,,OKC,W,0,17,3,4,0.75,3,4,0.75,0,0,,0,0,,1,1,2
13908,Shaun Livingston,31-119,G,1/8/17,GSW,@,SAC,W,0,19,3,4,0.75,3,4,0.75,0,0,,0,0,,0,2,2
13909,Shaun Livingston,31-051,G,11/1/16,GSW,@,POR,W,0,18,2,3,0.667,2,3,0.667,0,0,,2,2,1,0,1,1
13910,Shaun Livingston,31-153,G,2/11/17,GSW,@,OKC,W,0,16,3,3,1,3,3,1,0,0,,0,1,0,0,2,2
13911,Shaun Livingston,31-063,G,11/13/16,GSW,,PHO,W,0,20,3,5,0.6,3,5,0.6,0,0,,0,2,0,3,1,4
13912,Shaun Livingston,31-078,G,11/28/16,GSW,,ATL,W,0,16,3,5,0.6,3,5,0.6,0,0,,0,0,,0,2,2
13913,Shaun Livingston,31-113,G,1/2/17,GSW,,DEN,W,0,18,3,6,0.5,3,6,0.5,0,0,,0,1,0,2,1,3
13914,Shaun Livingston,31-060,G,11/10/16,GSW,@,DEN,W,0,18,3,4,0.75,3,4,0.75,0,0,,0,0,,0,2,2
13915,Shaun Livingston,31-191,G,3/21/17,GSW,@,DAL,W,0,20,3,4,0.75,3,4,0.75,0,0,,0,0,,1,1,2
13916,Shaun Livingston,31-110,G,12/30/16,GSW,,DAL,W,0,18,3,5,0.6,3,5,0.6,0,0,,0,0,,0,2,2
13917,Shaun Livingston,31-073,G,11/23/16,GSW,,LAL,W,0,17,3,4,0.75,3,4,0.75,0,0,,0,0,,0,2,2
13918,Shaun Livingston,31-090,G,12/10/16,GSW,@,MEM,L,0,18,3,4,0.75,3,4,0.75,0,0,,0,1,0,0,0,0
13919,Shawn Long,24-042,F,3/12/17,PHI,@,LAL,W,0,12,2,3,0.667,2,3,0.667,0,0,,2,2,1,0,5,5
13920,Kevon Looney,20-293,F-C,11/25/16,GSW,@,LAL,W,0,13,3,3,1,3,3,1,0,0,,0,0,,0,1,1
13921,Kevon Looney,20-294,F-C,11/26/16,GSW,,MIN,W,1,18,2,3,0.667,2,3,0.667,0,0,,2,2,1,1,2,3
13922,Robin Lopez,28-346,C,3/13/17,CHI,@,CHO,W,1,30,3,7,0.429,3,7,0.429,0,0,,0,0,,0,3,3
13923,Robin Lopez,28-258,C,12/15/16,CHI,@,MIL,L,1,25,3,6,0.5,3,6,0.5,0,0,,0,0,,1,5,6
13924,Robin Lopez,28-288,C,1/14/17,CHI,,NOP,W,1,27,3,12,0.25,3,12,0.25,0,0,,0,0,,9,2,11
13925,Robin Lopez,28-222,C,11/9/16,CHI,@,ATL,L,1,30,3,4,0.75,3,4,0.75,0,0,,0,0,,1,4,5
13926,Robin Lopez,28-266,C,12/23/16,CHI,@,CHO,L,1,33,3,8,0.375,3,8,0.375,0,0,,0,0,,4,5,9
13927,Robin Lopez,28-281,C,1/7/17,CHI,,TOR,W,1,27,3,7,0.429,3,7,0.429,0,0,,0,0,,1,4,5
13928,Robin Lopez,28-264,C,12/21/16,CHI,,WAS,L,1,33,3,5,0.6,3,5,0.6,0,0,,0,0,,1,3,4
13929,Robin Lopez,28-278,C,1/4/17,CHI,@,CLE,W,1,23,3,5,0.6,3,5,0.6,0,0,,0,0,,3,2,5
13930,Kyle Lowry,30-284,G,1/3/17,TOR,@,SAS,L,1,29,2,9,0.222,2,2,1,0,7,0,2,2,1,0,4,4
13931,Timothe Luwawu-Cabarrot,21-294,F,2/27/17,PHI,,GSW,L,0,17,1,3,0.333,1,2,0.5,0,1,0,4,4,1,1,1,2
13932,Timothe Luwawu-Cabarrot,21-200,F,11/25/16,PHI,,CHI,L,0,10,1,4,0.25,1,2,0.5,0,2,0,4,4,1,0,3,3
13933,Timothe Luwawu-Cabarrot,21-299,F,3/4/17,PHI,,DET,L,0,21,3,9,0.333,3,6,0.5,0,3,0,0,0,,1,2,3
13934,Timothe Luwawu-Cabarrot,21-276,F,2/9/17,PHI,@,ORL,W,0,8,2,4,0.5,1,3,0.333,1,1,1,1,2,0.5,1,0,1
13935,Trey Lyles,20-365,F,11/4/16,UTA,,SAS,L,0,29,1,8,0.125,0,4,0,1,4,0.25,3,4,0.75,2,5,7
13936,Trey Lyles,20-358,F,10/28/16,UTA,,LAL,W,0,18,2,8,0.25,1,4,0.25,1,4,0.25,1,1,1,0,2,2
13937,Trey Lyles,21-080,F,1/24/17,UTA,@,DEN,L,0,21,2,4,0.5,1,2,0.5,1,2,0.5,1,3,0.333,1,4,5
13938,Shelvin Mack,26-242,G,12/20/16,UTA,@,GSW,L,0,22,3,7,0.429,3,5,0.6,0,2,0,0,2,0,0,1,1
13939,Shelvin Mack,26-201,G,11/9/16,UTA,@,CHO,L,1,24,3,11,0.273,3,8,0.375,0,3,0,0,0,,1,2,3
13940,Shelvin Mack,26-232,G,12/10/16,UTA,,SAC,W,0,28,3,8,0.375,3,5,0.6,0,3,0,0,0,,3,1,4
13941,Ian Mahinmi,30-115,C,2/28/17,WAS,,GSW,W,0,16,2,4,0.5,2,4,0.5,0,0,,2,4,0.5,4,2,6
13942,Ian Mahinmi,30-118,C,3/3/17,WAS,,TOR,L,0,16,3,4,0.75,3,4,0.75,0,0,,0,0,,2,1,3
13943,Ian Mahinmi,30-130,C,3/15/17,WAS,,DAL,L,0,19,3,6,0.5,3,6,0.5,0,0,,0,0,,0,5,5
13944,Thon Maker,19-331,F-C,1/21/17,MIL,@,MIA,L,1,18,1,3,0.333,0,1,0,1,2,0.5,3,4,0.75,1,0,1
13945,Thon Maker,19-252,F-C,11/3/16,MIL,,IND,W,0,1,2,2,1,0,0,,2,2,1,0,0,,0,0,0
13946,Thon Maker,19-344,F-C,2/3/17,MIL,@,DEN,L,0,4,2,2,1,0,0,,2,2,1,0,0,,0,0,0
13947,Thon Maker,20-002,F-C,2/27/17,MIL,@,CLE,L,1,9,2,4,0.5,0,1,0,2,3,0.667,0,0,,0,0,0
13948,Thon Maker,19-354,F-C,2/13/17,MIL,,DET,W,1,17,3,10,0.3,3,6,0.5,0,4,0,0,0,,2,3,5
13949,Boban Marjanovic,28-126,C,12/19/16,DET,@,CHI,L,0,7,3,6,0.5,3,6,0.5,0,0,,0,0,,0,2,2
13950,Boban Marjanovic,28-151,C,1/13/17,DET,@,UTA,L,0,15,3,5,0.6,3,5,0.6,0,0,,0,0,,1,3,4
13951,Boban Marjanovic,28-205,C,3/8/17,DET,@,IND,L,0,11,1,2,0.5,1,2,0.5,0,0,,4,5,0.8,0,5,5
13952,Jarell Martin,22-191,F,12/1/16,MEM,,ORL,W,0,28,2,11,0.182,2,10,0.2,0,1,0,2,2,1,2,8,10
13953,Jarell Martin,22-204,F,12/14/16,MEM,,CLE,W,0,23,2,2,1,2,2,1,0,0,,2,2,1,1,5,6
13954,Jarell Martin,22-186,F,11/26/16,MEM,@,MIA,W,0,17,3,5,0.6,3,5,0.6,0,0,,0,0,,0,3,3
13955,Jarell Martin,22-185,F,11/25/16,MEM,,MIA,L,0,18,2,4,0.5,2,4,0.5,0,0,,2,2,1,1,11,12
13956,Jarell Martin,22-162,F,11/2/16,MEM,,NOP,W,0,17,2,6,0.333,2,5,0.4,0,1,0,2,2,1,1,3,4
13957,Wesley Matthews,30-042,G,11/25/16,DAL,@,CLE,L,1,29,2,8,0.25,0,1,0,2,7,0.286,0,0,,0,2,2
13958,Luc Mbah a Moute,30-175,F,3/3/17,LAC,@,MIL,L,1,30,3,5,0.6,3,3,1,0,2,0,0,0,,2,1,3
13959,Luc Mbah a Moute,30-100,F,12/18/16,LAC,@,WAS,L,1,17,2,4,0.5,2,3,0.667,0,1,0,2,2,1,1,0,1
13960,Luc Mbah a Moute,30-185,F,3/13/17,LAC,@,UTA,L,1,21,2,2,1,1,1,1,1,1,1,1,1,1,0,1,1
13961,Luc Mbah a Moute,30-110,F,12/28/16,LAC,@,NOP,L,1,32,2,6,0.333,0,2,0,2,4,0.5,0,0,,1,3,4
13962,Luc Mbah a Moute,30-107,F,12/25/16,LAC,@,LAL,L,1,16,3,9,0.333,3,6,0.5,0,3,0,0,0,,1,1,2
13963,Luc Mbah a Moute,30-121,F,1/8/17,LAC,,MIA,W,1,28,3,8,0.375,3,6,0.5,0,2,0,0,0,,0,1,1
13964,Luc Mbah a Moute,30-119,F,1/6/17,LAC,@,SAC,W,1,23,3,8,0.375,3,8,0.375,0,0,,0,0,,1,1,2
13965,Luc Mbah a Moute,30-083,F,12/1/16,LAC,@,CLE,W,1,30,3,7,0.429,3,5,0.6,0,2,0,0,0,,0,3,3
13966,James Michael McAdoo,24-052,F,2/25/17,GSW,,BRK,W,0,15,3,3,1,3,3,1,0,0,,0,2,0,1,0,1
13967,James Michael McAdoo,24-071,F,3/16/17,GSW,,ORL,W,0,8,3,3,1,3,3,1,0,0,,0,4,0,0,1,1
13968,Patrick McCaw,21-136,G,3/10/17,GSW,@,MIN,L,1,25,3,7,0.429,3,6,0.5,0,1,0,0,0,,1,3,4
13969,Patrick McCaw,21-134,G,3/8/17,GSW,,BOS,L,1,32,3,7,0.429,3,4,0.75,0,3,0,0,0,,1,3,4
13970,Patrick McCaw,21-019,G,11/13/16,GSW,,PHO,W,0,18,2,4,0.5,0,1,0,2,3,0.667,0,0,,1,1,2
13971,Sheldon McClellan,23-331,G,11/16/16,WAS,@,PHI,L,1,20,2,7,0.286,2,4,0.5,0,3,0,2,2,1,1,1,2
13972,Sheldon McClellan,24-002,G,12/23/16,WAS,@,MIL,L,0,23,1,5,0.2,1,2,0.5,0,3,0,4,4,1,0,2,2
13973,T.J. McConnell,24-237,G,11/17/16,PHI,@,MIN,L,0,24,3,4,0.75,3,4,0.75,0,0,,0,0,,1,5,6
13974,T.J. McConnell,24-359,G,3/19/17,PHI,,BOS,W,1,28,3,6,0.5,3,5,0.6,0,1,0,0,0,,0,3,3
13975,T.J. McConnell,24-320,G,2/8/17,PHI,,SAS,L,1,31,3,10,0.3,3,10,0.3,0,0,,0,0,,0,1,1
13976,T.J. McConnell,24-357,G,3/17/17,PHI,,DAL,W,1,22,3,5,0.6,3,5,0.6,0,0,,0,0,,0,2,2
13977,T.J. McConnell,24-218,G,10/29/16,PHI,,ATL,L,0,19,2,5,0.4,2,4,0.5,0,1,0,2,3,0.667,1,2,3
13978,T.J. McConnell,24-248,G,11/28/16,PHI,@,TOR,L,0,20,2,3,0.667,2,3,0.667,0,0,,2,2,1,0,2,2
13979,T.J. McConnell,24-266,G,12/16/16,PHI,,LAL,L,0,23,2,5,0.4,2,5,0.4,0,0,,2,2,1,0,1,1
13980,T.J. McConnell,24-352,G,3/12/17,PHI,@,LAL,W,1,30,1,2,0.5,1,2,0.5,0,0,,4,4,1,1,4,5
13981,T.J. McConnell,24-284,G,1/3/17,PHI,,MIN,W,1,35,3,9,0.333,3,6,0.5,0,3,0,0,0,,0,7,7
13982,T.J. McConnell,24-231,G,11/11/16,PHI,,IND,W,0,19,1,2,0.5,0,1,0,1,1,1,3,4,0.75,0,4,4
13983,T.J. McConnell,24-279,G,12/29/16,PHI,@,UTA,L,0,27,3,5,0.6,3,5,0.6,0,0,,0,0,,0,0,0
13984,T.J. McConnell,24-225,G,11/5/16,PHI,,CLE,L,0,17,3,5,0.6,3,5,0.6,0,0,,0,0,,1,2,3
13985,K.J. McDaniels,24-036,G-F,3/17/17,BRK,,BOS,L,0,19,3,7,0.429,3,5,0.6,0,2,0,0,0,,1,3,4
13986,Doug McDermott,25-072,F,3/16/17,OKC,@,TOR,W,0,16,2,5,0.4,0,1,0,2,4,0.5,0,0,,0,2,2
13987,Doug McDermott,24-306,F,11/4/16,CHI,,NYK,L,0,26,3,5,0.6,3,4,0.75,0,1,0,0,0,,1,1,2
13988,Doug McDermott,25-061,F,3/5/17,OKC,@,DAL,L,0,35,3,9,0.333,3,7,0.429,0,2,0,0,0,,0,4,4
13989,Doug McDermott,25-059,F,3/3/17,OKC,@,PHO,L,0,35,2,8,0.25,2,4,0.5,0,4,0,2,2,1,0,1,1
13990,JaVale McGee,28-326,C,12/10/16,GSW,@,MEM,L,0,9,3,7,0.429,3,7,0.429,0,0,,0,2,0,1,3,4
13991,JaVale McGee,28-324,C,12/8/16,GSW,@,UTA,W,0,8,3,4,0.75,3,4,0.75,0,0,,0,0,,1,2,3
13992,Rodney McGruder,25-113,G,11/19/16,MIA,@,WAS,W,0,19,2,5,0.4,2,4,0.5,0,1,0,2,3,0.667,1,3,4
13993,Rodney McGruder,25-233,G,3/19/17,MIA,,POR,L,1,19,2,4,0.5,1,1,1,1,3,0.333,1,2,0.5,2,2,4
13994,Rodney McGruder,25-089,G,10/26/16,MIA,@,ORL,W,0,24,1,3,0.333,1,2,0.5,0,1,0,4,5,0.8,1,2,3
13995,Rodney McGruder,25-176,G,1/21/17,MIA,,MIL,W,1,18,2,5,0.4,1,3,0.333,1,2,0.5,1,2,0.5,0,0,0
13996,Rodney McGruder,25-211,G,2/25/17,MIA,,IND,W,1,18,2,4,0.5,0,1,0,2,3,0.667,0,0,,0,1,1
13997,Rodney McGruder,25-133,G,12/9/16,MIA,@,CLE,L,1,37,3,10,0.3,3,6,0.5,0,4,0,0,0,,4,4,8
13998,Rodney McGruder,25-172,G,1/17/17,MIA,,HOU,W,1,16,3,4,0.75,3,4,0.75,0,0,,0,2,0,0,0,0
13999,Ben McLemore,23-258,G,10/26/16,SAC,@,PHO,W,0,17,3,7,0.429,3,5,0.6,0,2,0,0,1,0,0,0,0
14000,Ben McLemore,23-314,G,12/21/16,SAC,@,UTA,W,1,17,3,6,0.5,3,5,0.6,0,1,0,0,0,,1,1,2
14001,Ben McLemore,23-314,G,12/21/16,SAC,@,UTA,W,1,17,3,6,0.5,3,5,0.6,0,1,0,0,0,,1,1,2
14002,Ben McLemore,24-018,G,3/1/17,SAC,,BRK,L,1,14,2,7,0.286,2,7,0.286,0,0,,2,2,1,0,1,1
14003,Jordan McRae,25-294,G,1/16/17,CLE,@,GSW,L,0,7,3,4,0.75,3,3,1,0,1,0,0,0,,0,0,0
14004,Jordan McRae,25-318,G,2/9/17,CLE,@,OKC,L,1,27,2,9,0.222,1,5,0.2,1,4,0.25,1,1,1,2,0,2
14005,Jordan McRae,25-317,G,2/8/17,CLE,@,IND,W,0,14,2,5,0.4,0,1,0,2,4,0.5,0,0,,0,0,0
14006,Josh McRoberts,29-285,F,12/9/16,MIA,@,CLE,L,1,19,3,13,0.231,3,11,0.273,0,2,0,0,0,,3,1,4
14007,Jodie Meeks,29-117,G,12/16/16,ORL,,BRK,W,0,18,1,3,0.333,1,2,0.5,0,1,0,4,5,0.8,0,2,2
14008,Salah Mejri,30-239,C,2/9/17,DAL,,UTA,W,0,15,3,4,0.75,3,4,0.75,0,0,,0,0,,1,1,2
14009,Salah Mejri,30-237,C,2/7/17,DAL,,POR,L,0,15,2,2,1,2,2,1,0,0,,2,2,1,1,4,5
14010,Salah Mejri,30-137,C,10/30/16,DAL,@,HOU,L,0,17,3,3,1,3,3,1,0,0,,0,0,,5,2,7
14011,Salah Mejri,30-177,C,12/9/16,DAL,,IND,W,1,27,3,4,0.75,3,4,0.75,0,0,,0,0,,1,4,5
14012,Khris Middleton,25-182,F-G,2/10/17,MIL,,LAL,L,0,21,2,7,0.286,1,5,0.2,1,2,0.5,1,2,0.5,0,1,1
14013,C.J. Miles,29-330,G-F,3/14/17,IND,@,NYK,L,1,25,2,9,0.222,0,1,0,2,8,0.25,0,0,,0,4,4
14014,C.J. Miles,29-278,G-F,1/21/17,IND,@,UTA,L,0,28,2,8,0.25,1,3,0.333,1,5,0.2,1,2,0.5,0,2,2
14015,C.J. Miles,29-277,G-F,1/20/17,IND,@,LAL,L,0,14,2,5,0.4,0,2,0,2,3,0.667,0,1,0,0,1,1
14016,C.J. Miles,29-304,G-F,2/16/17,IND,,WAS,L,0,26,3,7,0.429,3,6,0.5,0,1,0,0,0,,0,1,1
14017,Mike Miller,36-360,F-G,2/13/17,DEN,,GSW,W,0,11,2,2,1,0,0,,2,2,1,0,0,,0,2,2
14018,Patty Mills,28-154,G,1/12/17,SAS,,LAL,W,0,17,2,5,0.4,1,2,0.5,1,3,0.333,1,2,0.5,0,1,1
14019,Patty Mills,28-171,G,1/29/17,SAS,,DAL,L,0,21,3,10,0.3,3,6,0.5,0,4,0,0,0,,1,7,8
14020,Patty Mills,28-219,G,3/18/17,SAS,@,MEM,L,0,22,2,8,0.25,0,0,,2,8,0.25,0,0,,0,2,2
14021,Patty Mills,28-145,G,1/3/17,SAS,,TOR,W,0,18,2,4,0.5,0,0,,2,4,0.5,0,0,,0,3,3
14022,Patty Mills,28-077,G,10/27/16,SAS,@,SAC,W,0,23,2,7,0.286,0,3,0,2,4,0.5,0,0,,0,1,1
14023,Patty Mills,28-141,G,12/30/16,SAS,,POR,W,0,22,3,4,0.75,3,4,0.75,0,0,,0,0,,0,1,1
14024,Patty Mills,28-139,G,12/28/16,SAS,,PHO,W,0,16,2,5,0.4,2,3,0.667,0,2,0,2,2,1,1,2,3
14025,Paul Millsap,31-276,F,11/12/16,ATL,,PHI,W,1,27,3,10,0.3,3,8,0.375,0,2,0,0,0,,0,4,4
14026,Nikola Mirotic,25-293,F,11/30/16,CHI,,LAL,L,0,22,3,9,0.333,3,5,0.6,0,4,0,0,0,,1,5,6
14027,Nikola Mirotic,25-288,F,11/25/16,CHI,@,PHI,W,0,25,2,5,0.4,1,2,0.5,1,3,0.333,1,3,0.333,1,2,3
14028,Nikola Mirotic,25-270,F,11/7/16,CHI,,ORL,W,0,21,2,9,0.222,1,3,0.333,1,6,0.167,1,2,0.5,1,3,4
14029,Nikola Mirotic,26-023,F,3/6/17,CHI,@,DET,L,0,18,2,7,0.286,1,2,0.5,1,5,0.2,1,2,0.5,0,0,0
14030,Nikola Mirotic,25-341,F,1/17/17,CHI,,DAL,L,0,22,2,4,0.5,0,1,0,2,3,0.667,0,0,,2,3,5
14031,Nikola Mirotic,25-356,F,2/1/17,CHI,@,OKC,W,0,20,2,5,0.4,2,3,0.667,0,2,0,2,2,1,1,3,4
14032,Nikola Mirotic,26-017,F,2/28/17,CHI,,DEN,L,0,20,2,4,0.5,1,1,1,1,3,0.333,1,1,1,0,1,1
14033,Greg Monroe,26-265,C-F,2/24/17,MIL,,UTA,L,0,21,2,8,0.25,2,8,0.25,0,0,,2,2,1,5,3,8
14034,Greg Monroe,26-154,C-F,11/5/16,MIL,,SAC,W,0,14,2,4,0.5,2,4,0.5,0,0,,2,2,1,0,3,3
14035,Greg Monroe,26-237,C-F,1/27/17,MIL,@,TOR,L,0,17,3,5,0.6,3,5,0.6,0,0,,0,0,,1,1,2
14036,Greg Monroe,26-189,C-F,12/10/16,MIL,@,WAS,L,0,23,2,5,0.4,2,5,0.4,0,0,,2,2,1,0,6,6
14037,Greg Monroe,26-150,C-F,11/1/16,MIL,@,NOP,W,0,18,2,6,0.333,2,6,0.333,0,0,,2,2,1,4,8,12
14038,Greg Monroe,26-249,C-F,2/8/17,MIL,,MIA,L,0,22,2,5,0.4,2,5,0.4,0,0,,2,3,0.667,2,5,7
14039,Greg Monroe,26-199,C-F,12/20/16,MIL,,CLE,L,0,18,3,5,0.6,3,5,0.6,0,0,,0,1,0,1,3,4
14040,E'Twaun Moore,27-309,G,1/2/17,NOP,@,CLE,L,0,20,2,5,0.4,0,2,0,2,3,0.667,0,0,,1,3,4
14041,E'Twaun Moore,28-003,G,3/3/17,NOP,,SAS,L,0,37,2,8,0.25,1,6,0.167,1,2,0.5,1,1,1,0,4,4
14042,E'Twaun Moore,27-289,G,12/13/16,NOP,,GSW,L,0,25,2,6,0.333,2,3,0.667,0,3,0,2,2,1,1,1,2
14043,E'Twaun Moore,27-361,G,2/23/17,NOP,,HOU,L,1,23,2,6,0.333,2,5,0.4,0,1,0,2,2,1,0,3,3
14044,E'Twaun Moore,27-297,G,12/21/16,NOP,,OKC,L,0,15,2,7,0.286,0,3,0,2,4,0.5,0,0,,1,0,1
14045,Marcus Morris,27-166,F,2/15/17,DET,,DAL,W,1,36,3,11,0.273,3,8,0.375,0,3,0,0,0,,0,13,13
14046,Marcus Morris,27-108,F,12/19/16,DET,@,CHI,L,1,24,2,9,0.222,2,5,0.4,0,4,0,2,2,1,1,0,1
14047,Markieff Morris,27-108,F,12/19/16,WAS,@,IND,L,1,27,2,9,0.222,2,6,0.333,0,3,0,2,2,1,0,6,6
14048,Markieff Morris,27-186,F,3/7/17,WAS,@,PHO,W,1,25,1,5,0.2,1,5,0.2,0,0,,4,4,1,0,2,2
14049,Markieff Morris,27-078,F,11/19/16,WAS,,MIA,L,1,9,3,4,0.75,3,3,1,0,1,0,0,0,,0,0,0
14050,Markieff Morris,27-061,F,11/2/16,WAS,,TOR,L,1,36,2,7,0.286,1,5,0.2,1,2,0.5,1,2,0.5,0,3,3
14051,Anthony Morrow,31-033,G,10/30/16,OKC,,LAL,W,0,6,3,5,0.6,3,4,0.75,0,1,0,0,0,,0,0,0
14052,Anthony Morrow,31-064,G,11/30/16,OKC,,WAS,W,0,31,2,9,0.222,0,2,0,2,7,0.286,0,0,,0,1,1
14053,Anthony Morrow,31-048,G,11/14/16,OKC,@,DET,L,0,9,3,5,0.6,3,4,0.75,0,1,0,0,0,,2,0,2
14054,Donatas Motiejunas,26-122,F-C,1/20/17,NOP,,BRK,L,0,12,2,5,0.4,0,0,,2,5,0.4,0,0,,0,2,2
14055,Donatas Motiejunas,26-159,F-C,2/26/17,NOP,@,OKC,L,0,23,2,6,0.333,2,4,0.5,0,2,0,2,6,0.333,1,3,4
14056,Donatas Motiejunas,26-156,F-C,2/23/17,NOP,,HOU,L,0,10,2,3,0.667,1,1,1,1,2,0.5,1,1,1,0,2,2
14057,Donatas Motiejunas,26-148,F-C,2/15/17,NOP,@,MEM,W,0,22,2,3,0.667,2,3,0.667,0,0,,2,4,0.5,0,1,1
14058,Timofey Mozgov,30-169,C,1/1/17,LAL,,TOR,L,1,21,2,6,0.333,2,6,0.333,0,0,,2,2,1,0,3,3
14059,Timofey Mozgov,30-108,C,11/1/16,LAL,@,IND,L,1,19,3,7,0.429,3,6,0.5,0,1,0,0,0,,3,2,5
14060,Emmanuel Mudiay,20-277,G,12/7/16,DEN,@,BRK,L,1,18,2,10,0.2,2,7,0.286,0,3,0,2,4,0.5,1,1,2
14061,Emmanuel Mudiay,20-245,G,11/5/16,DEN,@,DET,L,1,24,0,7,0,0,5,0,0,2,0,6,7,0.857,0,2,2
14062,Emmanuel Mudiay,20-336,G,2/4/17,DEN,@,SAS,L,0,20,2,10,0.2,2,7,0.286,0,3,0,2,2,1,1,3,4
14063,Shabazz Muhammad,24-028,F-G,12/11/16,MIN,,GSW,L,0,15,1,5,0.2,0,2,0,1,3,0.333,3,4,0.75,2,3,5
14064,Shabazz Muhammad,24-040,F-G,12/23/16,MIN,,SAC,L,0,17,1,1,1,0,0,,1,1,1,3,4,0.75,0,1,1
14065,Dejounte Murray,20-163,G,3/1/17,SAS,,IND,W,1,21,2,6,0.333,1,3,0.333,1,3,0.333,1,2,0.5,0,1,1
14066,Dejounte Murray,20-100,G,12/28/16,SAS,,PHO,W,0,3,2,2,1,2,2,1,0,0,,2,2,1,0,0,0
14067,Dejounte Murray,20-047,G,11/5/16,SAS,,LAC,L,0,9,2,4,0.5,0,2,0,2,2,1,0,0,,0,0,0
14068,Jamal Murray,19-298,G,12/17/16,DEN,,NYK,W,0,13,2,5,0.4,0,1,0,2,4,0.5,0,0,,2,1,3
14069,Jamal Murray,19-289,G,12/8/16,DEN,@,WAS,L,0,17,2,5,0.4,0,1,0,2,4,0.5,0,0,,1,1,2
14070,Mike Muscala,25-238,F-C,2/24/17,ATL,,MIA,L,0,19,1,5,0.2,1,2,0.5,0,3,0,4,6,0.667,2,7,9
14071,Mike Muscala,25-168,F-C,12/16/16,ATL,@,TOR,W,0,18,3,7,0.429,3,6,0.5,0,1,0,0,2,0,2,2,4
14072,Mike Muscala,25-165,F-C,12/13/16,ATL,,ORL,L,0,24,3,8,0.375,3,7,0.429,0,1,0,0,0,,1,4,5
14073,Larry Nance Jr.,23-336,F,12/2/16,LAL,@,TOR,L,0,23,3,6,0.5,3,6,0.5,0,0,,0,0,,2,4,6
14074,Larry Nance Jr.,24-038,F,2/8/17,LAL,@,DET,L,0,19,3,5,0.6,3,5,0.6,0,0,,0,0,,1,6,7
14075,Larry Nance Jr.,23-316,F,11/12/16,LAL,@,NOP,W,0,22,3,5,0.6,3,5,0.6,0,0,,0,0,,1,7,8
14076,Larry Nance Jr.,23-348,F,12/14/16,LAL,@,BRK,L,0,22,3,3,1,3,3,1,0,0,,0,0,,1,3,4
14077,Larry Nance Jr.,23-345,F,12/11/16,LAL,,NYK,L,0,20,3,5,0.6,3,5,0.6,0,0,,0,0,,2,0,2
14078,Shabazz Napier,25-174,G,1/4/17,POR,@,GSW,L,0,12,2,4,0.5,1,2,0.5,1,2,0.5,1,2,0.5,0,0,0
14079,Shabazz Napier,25-117,G,11/8/16,POR,,PHO,W,0,11,2,3,0.667,0,0,,2,3,0.667,0,2,0,0,0,0
14080,Shabazz Napier,25-167,G,12/28/16,POR,,SAC,W,0,13,2,5,0.4,0,1,0,2,4,0.5,0,0,,0,2,2
14081,Maurice Ndour,24-180,F,12/15/16,NYK,@,GSW,L,0,6,2,4,0.5,2,4,0.5,0,0,,2,2,1,1,0,1
14082,Jameer Nelson,34-365,G,2/8/17,DEN,@,ATL,L,1,31,2,8,0.25,0,3,0,2,5,0.4,0,0,,1,0,1
14083,Jameer Nelson,34-329,G,1/3/17,DEN,,SAC,L,0,19,2,7,0.286,0,2,0,2,5,0.4,0,0,,0,1,1
14084,Jameer Nelson,34-347,G,1/21/17,DEN,,LAC,W,0,29,3,8,0.375,3,6,0.5,0,2,0,0,0,,0,2,2
14085,Jameer Nelson,34-263,G,10/29/16,DEN,,POR,L,0,15,2,5,0.4,0,1,0,2,4,0.5,0,0,,0,0,0
14086,Jameer Nelson,34-360,G,2/3/17,DEN,,MIL,W,1,30,2,6,0.333,1,3,0.333,1,3,0.333,1,2,0.5,0,3,3
14087,Jameer Nelson,35-025,G,3/6/17,DEN,,SAC,W,1,30,3,5,0.6,3,4,0.75,0,1,0,0,0,,1,0,1
14088,Raul Neto,24-185,G,11/20/16,UTA,@,DEN,L,0,3,2,3,0.667,1,2,0.5,1,1,1,1,1,1,0,0,0
14089,Raul Neto,24-215,G,12/20/16,UTA,@,GSW,L,0,13,3,7,0.429,3,4,0.75,0,3,0,0,0,,0,1,1
14090,Andrew Nicholson,27-011,F,12/19/16,WAS,@,IND,L,0,7,2,2,1,0,0,,2,2,1,0,0,,0,2,2
14091,Andrew Nicholson,26-353,F,11/25/16,WAS,@,ORL,W,0,16,3,7,0.429,3,6,0.5,0,1,0,0,0,,0,1,1
14092,Joakim Noah,31-274,C,11/25/16,NYK,,CHO,W,1,18,3,5,0.6,3,5,0.6,0,0,,0,0,,4,5,9
14093,Joakim Noah,31-339,C,1/29/17,NYK,@,ATL,L,1,41,2,5,0.4,2,5,0.4,0,0,,2,2,1,7,7,14
14094,Joakim Noah,31-247,C,10/29/16,NYK,,MEM,W,1,22,2,2,1,2,2,1,0,0,,2,6,0.333,1,9,10
14095,Joakim Noah,31-301,C,12/22/16,NYK,,ORL,W,1,22,2,5,0.4,2,5,0.4,0,0,,2,2,1,4,3,7
14096,Joakim Noah,31-294,C,12/15/16,NYK,@,GSW,L,1,15,3,10,0.3,3,10,0.3,0,0,,0,0,,6,4,10
14097,Nerlens Noel,22-323,C-F,2/27/17,DAL,,MIA,W,0,25,3,3,1,3,3,1,0,0,,0,0,,2,4,6
14098,Nerlens Noel,22-279,C-F,1/14/17,PHI,@,WAS,L,0,13,3,7,0.429,3,7,0.429,0,0,,0,0,,5,7,12
14099,Nerlens Noel,22-278,C-F,1/13/17,PHI,,CHO,W,0,20,3,3,1,3,3,1,0,0,,0,0,,1,1,2
14100,Nerlens Noel,22-325,C-F,3/1/17,DAL,@,ATL,L,0,16,3,5,0.6,3,5,0.6,0,0,,0,0,,1,1,2
14101,Lucas Nogueira,24-201,C,2/12/17,TOR,,DET,L,0,32,1,1,1,1,1,1,0,0,,4,4,1,1,1,2
14102,Lucas Nogueira,24-147,C,12/20/16,TOR,,BRK,W,0,22,2,3,0.667,2,3,0.667,0,0,,2,2,1,3,3,6
14103,Lucas Nogueira,24-109,C,11/12/16,TOR,,NYK,W,0,26,3,3,1,3,3,1,0,0,,0,0,,4,6,10
14104,Lucas Nogueira,24-145,C,12/18/16,TOR,@,ORL,W,0,17,3,4,0.75,3,4,0.75,0,0,,0,0,,0,5,5
14105,Lucas Nogueira,24-182,C,1/24/17,TOR,,SAS,L,0,26,3,6,0.5,3,6,0.5,0,0,,0,0,,4,6,10
14106,Lucas Nogueira,24-125,C,11/28/16,TOR,,PHI,W,0,22,1,2,0.5,1,2,0.5,0,0,,4,6,0.667,2,2,4
14107,Lucas Nogueira,24-132,C,12/5/16,TOR,,CLE,L,0,15,2,2,1,2,2,1,0,0,,2,3,0.667,1,2,3
14108,David Nwaba,24-057,PG,3/12/17,LAL,,PHI,L,1,16,1,3,0.333,1,2,0.5,0,1,0,4,4,1,0,1,1
14109,Johnny O'Bryant,23-255,F-C,2/11/17,DEN,@,CLE,L,0,11,3,5,0.6,3,5,0.6,0,0,,0,0,,1,1,2
14110,Kyle O'Quinn,26-296,F-C,1/16/17,NYK,,ATL,L,0,16,3,10,0.3,3,10,0.3,0,0,,0,0,,2,6,8
14111,Kyle O'Quinn,26-277,F-C,12/28/16,NYK,@,ATL,L,0,13,3,5,0.6,3,5,0.6,0,0,,0,0,,0,4,4
14112,Kyle O'Quinn,26-274,F-C,12/25/16,NYK,,BOS,L,0,13,3,4,0.75,3,4,0.75,0,0,,0,0,,1,3,4
14113,Kyle O'Quinn,26-235,F-C,11/16/16,NYK,,DET,W,0,15,2,3,0.667,2,3,0.667,0,0,,2,2,1,2,3,5
14114,Kyle O'Quinn,26-269,F-C,12/20/16,NYK,,IND,W,0,17,3,6,0.5,3,6,0.5,0,0,,0,0,,1,5,6
14115,Daniel Ochefu,23-008,C,12/23/16,WAS,@,MIL,L,0,11,3,4,0.75,3,4,0.75,0,0,,0,2,0,0,2,2
14116,Jahlil Okafor,21-011,C-F,12/26/16,PHI,@,SAC,L,1,20,3,5,0.6,3,5,0.6,0,0,,0,0,,1,1,2
14117,Jahlil Okafor,21-076,C-F,3/1/17,PHI,@,MIA,L,1,22,3,11,0.273,3,11,0.273,0,0,,0,0,,2,5,7
14118,Jahlil Okafor,21-008,C-F,12/23/16,PHI,@,PHO,L,1,20,3,4,0.75,3,4,0.75,0,0,,0,0,,1,3,4
14119,Jahlil Okafor,20-340,C-F,11/19/16,PHI,,PHO,W,0,19,3,4,0.75,3,4,0.75,0,0,,0,0,,1,0,1
14120,Victor Oladipo,24-257,G,1/16/17,OKC,@,LAC,L,1,24,3,11,0.273,3,9,0.333,0,2,0,0,0,,0,3,3
14121,Victor Oladipo,24-285,G,2/13/17,OKC,@,WAS,L,1,18,2,6,0.333,2,3,0.667,0,3,0,2,2,1,1,0,1
14122,Kelly Olynyk,25-267,C-F,1/11/17,BOS,,WAS,W,0,23,2,5,0.4,0,2,0,2,3,0.667,0,0,,0,6,6
14123,Kelly Olynyk,25-228,C-F,12/3/16,BOS,@,PHI,W,0,11,2,2,1,1,1,1,1,1,1,1,2,0.5,0,0,0
14124,Kelly Olynyk,25-280,C-F,1/24/17,BOS,@,WAS,L,0,22,3,8,0.375,3,4,0.75,0,4,0,0,0,,1,2,3
14125,Chinanu Onuaku,20-055,F-C,12/26/16,HOU,,PHO,W,0,8,2,2,1,2,2,1,0,0,,2,2,1,1,2,3
14126,Kelly Oubre,21-003,F,12/12/16,WAS,@,MIA,L,0,24,2,5,0.4,2,3,0.667,0,2,0,2,2,1,1,4,5
14127,Kelly Oubre,21-036,F,1/14/17,WAS,,PHI,W,0,27,3,6,0.5,3,4,0.75,0,2,0,0,0,,0,2,2
14128,Kelly Oubre,21-028,F,1/6/17,WAS,,MIN,W,0,14,2,4,0.5,0,1,0,2,3,0.667,0,0,,0,1,1
14129,Zaza Pachulia,33-039,C,3/21/17,GSW,@,DAL,W,1,14,3,3,1,3,3,1,0,0,,0,0,,1,5,6
14130,Zaza Pachulia,33-024,C,3/6/17,GSW,@,ATL,W,1,15,3,6,0.5,3,6,0.5,0,0,,0,0,,1,4,5
14131,Zaza Pachulia,32-290,C,11/26/16,GSW,,MIN,W,1,25,2,6,0.333,2,6,0.333,0,0,,2,2,1,1,3,4
14132,Zaza Pachulia,32-348,C,1/23/17,GSW,@,MIA,L,1,27,2,6,0.333,2,6,0.333,0,0,,2,4,0.5,4,6,10
14133,Zaza Pachulia,32-287,C,11/23/16,GSW,,LAL,W,1,18,2,3,0.667,2,3,0.667,0,0,,2,2,1,0,3,3
14134,Zaza Pachulia,32-285,C,11/21/16,GSW,@,IND,W,1,14,2,4,0.5,2,4,0.5,0,0,,2,2,1,2,5,7
14135,Zaza Pachulia,33-013,C,2/23/17,GSW,,LAC,W,1,18,3,3,1,3,3,1,0,0,,0,0,,1,3,4
14136,Georgios Papagiannis,19-259,C,3/19/17,SAC,@,SAS,L,0,24,2,7,0.286,2,7,0.286,0,0,,2,2,1,4,6,10
14137,Tony Parker,34-202,G,12/5/16,SAS,@,MIL,W,1,18,3,8,0.375,3,7,0.429,0,1,0,0,0,,1,0,1
14138,Tony Parker,34-168,G,11/1/16,SAS,,UTA,L,1,33,3,5,0.6,3,5,0.6,0,0,,0,1,0,0,3,3
14139,Chandler Parsons,28-099,F,2/1/17,MEM,@,DEN,W,1,22,2,7,0.286,2,5,0.4,0,2,0,2,2,1,0,6,6
14140,Chandler Parsons,28-085,F,1/18/17,MEM,@,WAS,L,1,19,1,6,0.167,0,3,0,1,3,0.333,3,4,0.75,1,1,2
14141,Patrick Patterson,27-237,F,11/6/16,TOR,,SAC,L,0,31,1,6,0.167,1,4,0.25,0,2,0,4,5,0.8,2,7,9
14142,Patrick Patterson,28-007,F,3/21/17,TOR,,CHI,W,0,23,3,4,0.75,3,4,0.75,0,0,,0,0,,2,5,7
14143,Patrick Patterson,28-003,F,3/17/17,TOR,@,DET,W,0,14,2,5,0.4,0,2,0,2,3,0.667,0,0,,0,2,2
14144,Patrick Patterson,27-349,F,2/26/17,TOR,,POR,W,0,19,2,5,0.4,0,0,,2,5,0.4,0,0,,0,1,1
14145,Patrick Patterson,27-242,F,11/11/16,TOR,@,CHO,W,0,33,2,10,0.2,0,3,0,2,7,0.286,0,0,,2,5,7
14146,Chris Paul,31-313,G,3/15/17,LAC,,MIL,L,1,36,2,10,0.2,1,6,0.167,1,4,0.25,1,1,1,1,4,5
14147,Adreian Payne,25-274,F-C,11/19/16,MIN,@,MEM,L,0,15,2,4,0.5,2,3,0.667,0,1,0,2,2,1,1,2,3
14148,Adreian Payne,25-260,F-C,11/5/16,MIN,@,OKC,L,0,6,2,3,0.667,2,2,1,0,1,0,2,2,1,0,1,1
14149,Adreian Payne,25-278,F-C,11/23/16,MIN,@,NOP,L,0,10,3,4,0.75,3,4,0.75,0,0,,0,0,,0,3,3
14150,Cameron Payne,22-171,G,1/26/17,OKC,,DAL,W,0,13,2,4,0.5,0,2,0,2,2,1,0,0,,0,0,0
14151,Cameron Payne,22-204,G,2/28/17,CHI,,DEN,L,0,17,2,10,0.2,0,5,0,2,5,0.4,0,0,,1,1,2
14152,Cameron Payne,22-201,G,2/25/17,CHI,@,CLE,W,0,12,2,3,0.667,0,0,,2,3,0.667,0,0,,0,1,1
14153,Elfrid Payton,22-255,G,11/3/16,ORL,,SAC,W,1,34,3,13,0.231,3,8,0.375,0,5,0,0,1,0,0,3,3
14154,Elfrid Payton,22-324,G,1/11/17,ORL,@,LAC,L,1,23,3,9,0.333,3,9,0.333,0,0,,0,2,0,0,2,2
14155,Elfrid Payton,22-257,G,11/5/16,ORL,,WAS,W,1,29,2,8,0.25,1,5,0.2,1,3,0.333,1,2,0.5,1,0,1
14156,Paul Pierce,39-036,F-G,11/18/16,LAC,@,SAC,W,0,9,2,2,1,0,0,,2,2,1,0,0,,0,0,0
14157,Mason Plumlee,26-241,C-F,11/1/16,POR,,GSW,L,1,22,3,5,0.6,3,5,0.6,0,0,,0,0,,1,4,5
14158,Mason Plumlee,26-361,C-F,3/1/17,DEN,@,MIL,W,0,18,3,6,0.5,3,6,0.5,0,0,,0,0,,1,3,4
14159,Mason Plumlee,26-360,C-F,2/28/17,DEN,@,CHI,W,0,23,3,5,0.6,3,5,0.6,0,0,,0,0,,0,6,6
14160,Miles Plumlee,28-065,C-F,11/5/16,MIL,,SAC,W,1,15,2,2,1,2,2,1,0,0,,2,2,1,1,2,3
14161,Jakob Poeltl,21-147,C,3/11/17,TOR,@,MIA,L,0,19,3,8,0.375,3,8,0.375,0,0,,0,2,0,6,3,9
14162,Jakob Poeltl,21-022,C,11/6/16,TOR,,SAC,L,1,18,3,4,0.75,3,4,0.75,0,0,,0,0,,2,2,4
14163,Jakob Poeltl,21-152,C,3/16/17,TOR,,OKC,L,0,17,2,3,0.667,2,3,0.667,0,0,,2,2,1,1,1,2
14164,Jakob Poeltl,21-034,C,11/18/16,TOR,@,DEN,W,0,16,2,2,1,2,2,1,0,0,,2,3,0.667,2,4,6
14165,Otto Porter,23-169,F,11/19/16,WAS,,MIA,L,1,37,2,9,0.222,0,3,0,2,6,0.333,0,0,,1,6,7
14166,Otto Porter,23-268,F,2/26/17,WAS,,UTA,L,1,40,3,9,0.333,3,7,0.429,0,2,0,0,0,,1,6,7
14167,Otto Porter,23-235,F,1/24/17,WAS,,BOS,W,1,31,2,4,0.5,0,2,0,2,2,1,0,0,,0,4,4
14168,Bobby Portis,22-004,F,2/14/17,CHI,,TOR,W,0,11,1,5,0.2,0,3,0,1,2,0.5,3,4,0.75,0,4,4
14169,Bobby Portis,21-284,F,11/20/16,CHI,@,LAL,W,0,11,3,5,0.6,3,4,0.75,0,1,0,0,0,,1,1,2
14170,Bobby Portis,21-309,F,12/15/16,CHI,@,MIL,L,0,23,2,6,0.333,2,3,0.667,0,3,0,2,3,0.667,0,6,6
14171,Bobby Portis,21-279,F,11/15/16,CHI,@,POR,W,0,14,2,5,0.4,1,4,0.25,1,1,1,1,2,0.5,3,3,6
14172,Bobby Portis,21-264,F,10/31/16,CHI,@,BRK,W,0,4,3,4,0.75,3,4,0.75,0,0,,0,0,,2,0,2
14173,Bobby Portis,21-289,F,11/25/16,CHI,@,PHI,W,0,19,3,6,0.5,3,5,0.6,0,1,0,0,0,,2,3,5
14174,Dwight Powell,25-140,F-C,12/7/16,DAL,,SAC,L,0,25,3,7,0.429,3,7,0.429,0,0,,0,0,,2,3,5
14175,Dwight Powell,25-134,F-C,12/1/16,DAL,@,CHO,L,0,24,2,4,0.5,2,4,0.5,0,0,,2,2,1,2,6,8
14176,Dwight Powell,25-117,F-C,11/14/16,DAL,@,NYK,L,0,18,2,8,0.25,2,8,0.25,0,0,,2,2,1,1,3,4
14177,Dwight Powell,25-181,F-C,1/17/17,DAL,@,CHI,W,0,12,3,4,0.75,3,3,1,0,1,0,0,0,,0,1,1
14178,Dwight Powell,25-196,F-C,2/1/17,DAL,,PHI,W,0,10,2,5,0.4,1,4,0.25,1,1,1,1,2,0.5,1,2,3
14179,Dwight Powell,25-159,F-C,12/26/16,DAL,@,NOP,L,0,21,2,3,0.667,2,2,1,0,1,0,2,4,0.5,0,5,5
14180,Norman Powell,23-203,G,12/14/16,TOR,@,PHI,W,0,21,2,5,0.4,2,3,0.667,0,2,0,2,3,0.667,0,0,0
14181,Norman Powell,23-163,G,11/4/16,TOR,,MIA,W,0,14,2,2,1,1,1,1,1,1,1,1,2,0.5,0,2,2
14182,Julius Randle,22-042,F,1/10/17,LAL,,POR,L,1,26,2,9,0.222,2,9,0.222,0,0,,2,4,0.5,2,8,10
14183,Julius Randle,22-089,F,2/26/17,LAL,,SAS,L,1,28,2,9,0.222,2,7,0.286,0,2,0,2,6,0.333,2,10,12
14184,Julius Randle,22-004,F,12/3/16,LAL,@,MEM,L,1,29,3,8,0.375,3,7,0.429,0,1,0,0,3,0,2,4,6
14185,Julius Randle,22-015,F,12/14/16,LAL,@,BRK,L,1,31,2,8,0.25,2,8,0.25,0,0,,2,5,0.4,1,9,10
14186,Zach Randolph,35-158,F,12/21/16,MEM,@,DET,W,0,19,3,13,0.231,3,11,0.273,0,2,0,0,0,,1,3,4
14187,Zach Randolph,35-186,F,1/18/17,MEM,@,WAS,L,0,20,3,14,0.214,3,13,0.231,0,1,0,0,0,,3,6,9
14188,Zach Randolph,35-151,F,12/14/16,MEM,,CLE,W,0,19,2,11,0.182,2,10,0.2,0,1,0,2,2,1,3,4,7
14189,J.J. Redick,32-226,G,2/5/17,LAC,@,BOS,L,1,33,2,9,0.222,2,6,0.333,0,3,0,2,2,1,1,3,4
14190,J.J. Redick,32-245,G,2/24/17,LAC,,SAS,L,1,32,2,9,0.222,0,1,0,2,8,0.25,0,0,,0,2,2
14191,Willie Reed,26-252,F-C,1/23/17,MIA,,GSW,W,0,11,3,5,0.6,3,5,0.6,0,0,,0,0,,1,6,7
14192,Willie Reed,26-199,F-C,12/1/16,MIA,@,UTA,W,0,12,3,5,0.6,3,5,0.6,0,0,,0,0,,2,2,4
14193,Willie Reed,26-185,F-C,11/17/16,MIA,,MIL,W,0,19,3,4,0.75,3,4,0.75,0,0,,0,2,0,1,2,3
14194,Willie Reed,26-225,F-C,12/27/16,MIA,,OKC,L,0,12,3,7,0.429,3,6,0.5,0,1,0,0,0,,2,4,6
14195,Willie Reed,26-259,F-C,1/30/17,MIA,,BRK,W,0,17,3,3,1,3,3,1,0,0,,0,0,,1,5,6
14196,Willie Reed,26-204,F-C,12/6/16,MIA,,NYK,L,0,10,2,5,0.4,2,5,0.4,0,0,,2,4,0.5,3,1,4
14197,Willie Reed,26-233,F-C,1/4/17,MIA,@,SAC,W,1,23,3,6,0.5,3,6,0.5,0,0,,0,0,,0,4,4
14198,Josh Richardson,23-113,G,1/6/17,MIA,@,LAL,L,1,30,2,6,0.333,1,2,0.5,1,4,0.25,1,2,0.5,0,1,1
14199,Josh Richardson,23-174,G,3/8/17,MIA,,CHO,W,0,25,2,8,0.25,2,7,0.286,0,1,0,2,2,1,2,1,3
14200,Josh Richardson,23-094,G,12/18/16,MIA,,BOS,L,1,35,3,11,0.273,3,4,0.75,0,7,0,0,0,,0,3,3
14201,Austin Rivers,24-222,G,3/11/17,LAC,,PHI,W,0,19,2,8,0.25,2,5,0.4,0,3,0,2,4,0.5,0,2,2
14202,Austin Rivers,24-096,G,11/5/16,LAC,@,SAS,W,0,22,3,10,0.3,3,7,0.429,0,3,0,0,0,,0,1,1
14203,Andre Roberson,25-061,G-F,2/3/17,OKC,,MEM,W,1,20,3,5,0.6,3,3,1,0,2,0,0,0,,1,3,4
14204,Andre Roberson,25-069,G-F,2/11/17,OKC,,GSW,L,1,34,3,9,0.333,3,6,0.5,0,3,0,0,0,,5,6,11
14205,Andre Roberson,24-352,G-F,11/20/16,OKC,,IND,L,1,36,2,5,0.4,0,1,0,2,4,0.5,0,0,,1,5,6
14206,Brian Roberts,31-093,G,3/6/17,CHO,,IND,W,0,13,2,3,0.667,0,0,,2,3,0.667,0,0,,0,2,2
14207,Brian Roberts,31-068,G,2/9/17,CHO,,HOU,L,0,12,2,4,0.5,0,1,0,2,3,0.667,0,0,,0,0,0
14208,Glenn Robinson,22-336,G-F,12/9/16,IND,@,DAL,L,0,8,2,3,0.667,0,0,,2,3,0.667,0,0,,0,1,1
14209,Glenn Robinson,23-018,G-F,1/26/17,IND,@,MIN,W,0,17,2,2,1,2,2,1,0,0,,2,2,1,0,0,0
14210,Glenn Robinson,23-052,G-F,3/1/17,IND,@,SAS,L,0,16,3,4,0.75,3,3,1,0,1,0,0,1,0,0,2,2
14211,Glenn Robinson,22-332,G-F,12/5/16,IND,@,GSW,L,0,16,2,7,0.286,2,6,0.333,0,1,0,2,2,1,0,0,0
14212,Glenn Robinson,23-015,G-F,1/23/17,IND,,NYK,L,0,18,3,3,1,3,3,1,0,0,,0,0,,1,2,3
14213,Glenn Robinson,22-341,G-F,12/14/16,IND,@,MIA,L,1,25,2,5,0.4,2,5,0.4,0,0,,2,3,0.667,2,3,5
14214,Thomas Robinson,25-253,F,11/25/16,LAL,,GSW,L,0,16,3,8,0.375,3,8,0.375,0,0,,0,2,0,3,7,10
14215,Thomas Robinson,25-363,F,3/15/17,LAL,@,HOU,L,0,5,2,3,0.667,2,3,0.667,0,0,,2,2,1,0,1,1
14216,Thomas Robinson,25-294,F,1/5/17,LAL,@,POR,L,0,15,3,5,0.6,3,5,0.6,0,0,,0,0,,3,2,5
14217,Thomas Robinson,25-257,F,11/29/16,LAL,@,NOP,L,0,10,1,2,0.5,1,2,0.5,0,0,,4,4,1,1,1,2
14218,Sergio Rodriguez,30-148,G,11/7/16,PHI,,UTA,L,1,28,3,9,0.333,3,5,0.6,0,4,0,0,0,,1,3,4
14219,Rajon Rondo,30-327,G,1/14/17,CHI,,NOP,W,0,19,2,7,0.286,0,4,0,2,3,0.667,0,0,,0,2,2
14220,Rajon Rondo,30-261,G,11/9/16,CHI,@,ATL,L,1,34,2,10,0.2,1,6,0.167,1,4,0.25,1,2,0.5,1,4,5
14221,Rajon Rondo,30-277,G,11/25/16,CHI,@,PHI,W,1,26,2,5,0.4,2,5,0.4,0,0,,2,3,0.667,0,8,8
14222,Rajon Rondo,31-023,G,3/17/17,CHI,@,WAS,L,1,33,3,6,0.5,3,4,0.75,0,2,0,0,0,,1,3,4
14223,Rajon Rondo,30-307,G,12/25/16,CHI,@,SAS,L,1,30,3,7,0.429,3,6,0.5,0,1,0,0,0,,2,4,6
14224,Rajon Rondo,30-250,G,10/29/16,CHI,,IND,W,1,25,2,5,0.4,2,3,0.667,0,2,0,2,2,1,1,2,3
14225,Rajon Rondo,31-002,G,2/24/17,CHI,,PHO,W,0,29,3,5,0.6,3,4,0.75,0,1,0,0,0,,1,3,4
14226,Terrence Ross,25-355,F-G,1/25/17,TOR,@,MEM,L,0,21,2,9,0.222,0,2,0,2,7,0.286,0,0,,0,1,1
14227,Terrence Ross,25-301,F-G,12/2/16,TOR,,LAL,W,0,20,2,6,0.333,0,1,0,2,5,0.4,0,0,,0,1,1
14228,Terrence Ross,25-362,F-G,2/1/17,TOR,@,BOS,L,0,23,3,10,0.3,3,6,0.5,0,4,0,0,2,0,0,6,6
14229,Terrence Ross,26-024,F-G,3/1/17,ORL,,NYK,L,1,37,3,10,0.3,3,5,0.6,0,5,0,0,0,,0,5,5
14230,Terrence Ross,25-361,F-G,1/31/17,TOR,,NOP,W,0,22,2,9,0.222,0,2,0,2,7,0.286,0,0,,0,5,5
14231,Terry Rozier,22-316,G,1/27/17,BOS,,ORL,W,0,20,2,5,0.4,2,2,1,0,3,0,2,2,1,1,1,2
14232,Terry Rozier,22-269,G,12/11/16,BOS,@,OKC,L,0,29,3,12,0.25,3,10,0.3,0,2,0,0,0,,2,3,5
14233,Terry Rozier,22-251,G,11/23/16,BOS,@,BRK,W,0,23,3,4,0.75,3,3,1,0,1,0,0,0,,1,5,6
14234,Terry Rozier,22-360,G,3/12/17,BOS,,CHI,W,0,16,2,5,0.4,2,3,0.667,0,2,0,2,2,1,0,1,1
14235,Ricky Rubio,26-117,G,2/15/17,MIN,@,DEN,W,1,34,1,5,0.2,1,1,1,0,4,0,4,4,1,1,2,3
14236,Ricky Rubio,26-036,G,11/26/16,MIN,@,GSW,L,1,29,2,5,0.4,2,3,0.667,0,2,0,2,2,1,1,1,2
14237,Damjan Rudez,30-194,F,12/28/16,ORL,,CHO,L,0,12,2,7,0.286,0,1,0,2,6,0.333,0,0,,0,0,0
14238,Brandon Rush,31-222,G-F,2/14/17,MIN,,CLE,L,1,37,2,6,0.333,0,2,0,2,4,0.5,0,0,,0,4,4
14239,Brandon Rush,31-255,G-F,3/19/17,MIN,@,NOP,L,1,39,2,6,0.333,0,1,0,2,5,0.4,0,0,,0,3,3
14240,Domantas Sabonis,20-186,F,11/5/16,OKC,,MIN,W,1,24,3,9,0.333,3,6,0.5,0,3,0,0,0,,1,4,5
14241,Domantas Sabonis,20-199,F,11/18/16,OKC,,BRK,W,1,26,3,9,0.333,3,6,0.5,0,3,0,0,0,,0,3,3
14242,Domantas Sabonis,20-319,F,3/18/17,OKC,,SAC,W,0,26,2,8,0.25,1,4,0.25,1,4,0.25,1,2,0.5,1,3,4
14243,Domantas Sabonis,20-247,F,1/5/17,OKC,@,HOU,L,1,22,3,5,0.6,3,5,0.6,0,0,,0,0,,0,3,3
14244,Domantas Sabonis,20-183,F,11/2/16,OKC,@,LAC,W,1,17,2,3,0.667,0,0,,2,3,0.667,0,0,,0,2,2
14245,Domantas Sabonis,20-288,F,2/15/17,OKC,,NYK,W,1,24,3,8,0.375,3,7,0.429,0,1,0,0,0,,2,3,5
14246,Domantas Sabonis,20-310,F,3/9/17,OKC,,SAS,W,0,20,3,8,0.375,3,7,0.429,0,1,0,0,0,,0,2,2
14247,Domantas Sabonis,20-286,F,2/13/17,OKC,@,WAS,L,1,23,3,11,0.273,3,6,0.5,0,5,0,0,0,,3,4,7
14248,Domantas Sabonis,20-238,F,12/27/16,OKC,@,MIA,W,1,26,3,6,0.5,3,4,0.75,0,2,0,0,0,,2,3,5
14249,Dario Saric,22-296,F,1/29/17,PHI,@,CHI,L,0,16,2,6,0.333,2,3,0.667,0,3,0,2,2,1,1,2,3
14250,Tomas Satoransky,25-022,G,11/21/16,WAS,,PHO,W,0,16,1,1,1,0,0,,1,1,1,3,4,0.75,0,4,4
14251,Dennis Schroder,23-122,G,1/15/17,ATL,,MIL,W,1,24,3,8,0.375,3,8,0.375,0,0,,0,0,,0,2,2
14252,Luis Scola,36-211,F,11/27/16,BRK,,SAC,L,0,12,2,6,0.333,2,5,0.4,0,1,0,2,2,1,1,0,1
14253,Luis Scola,36-204,F,11/20/16,BRK,,POR,L,0,14,1,4,0.25,1,2,0.5,0,2,0,4,5,0.8,1,1,2
14254,Thabo Sefolosha,32-204,G-F,11/22/16,ATL,,NOP,L,0,23,3,7,0.429,3,6,0.5,0,1,0,0,0,,0,3,3
14255,Thabo Sefolosha,32-217,G-F,12/5/16,ATL,,OKC,L,1,33,3,6,0.5,3,5,0.6,0,1,0,0,2,0,0,3,3
14256,Thabo Sefolosha,32-212,G-F,11/30/16,ATL,@,PHO,L,0,31,3,6,0.5,3,6,0.5,0,0,,0,0,,1,7,8
14257,Thabo Sefolosha,32-229,G-F,12/17/16,ATL,,CHO,L,1,30,2,4,0.5,0,1,0,2,3,0.667,0,0,,0,2,2
14258,Kevin Seraphin,26-347,F,11/18/16,IND,,PHO,L,0,11,2,4,0.5,2,4,0.5,0,0,,2,2,1,2,0,2
14259,Kevin Seraphin,27-025,F,1/1/17,IND,,ORL,W,0,16,3,3,1,3,3,1,0,0,,0,0,,1,5,6
14260,Kevin Seraphin,27-098,F,3/15/17,IND,,CHO,W,0,11,3,4,0.75,3,4,0.75,0,0,,0,0,,0,1,1
14261,Kevin Seraphin,26-343,F,11/14/16,IND,,ORL,W,0,19,3,8,0.375,3,8,0.375,0,0,,0,0,,5,5,10
14262,Kevin Seraphin,27-066,F,2/11/17,IND,,MIL,L,0,8,3,5,0.6,3,5,0.6,0,0,,0,0,,0,0,0
14263,Ramon Sessions,30-222,G,11/19/16,CHO,@,NOP,L,0,21,3,7,0.429,3,4,0.75,0,3,0,0,2,0,0,0,0
14264,Ramon Sessions,30-250,G,12/17/16,CHO,@,ATL,W,0,14,2,4,0.5,2,3,0.667,0,1,0,2,2,1,0,3,3
14265,Ramon Sessions,30-221,G,11/18/16,CHO,,ATL,W,0,15,2,5,0.4,1,4,0.25,1,1,1,1,2,0.5,0,0,0
14266,Ramon Sessions,30-266,G,1/2/17,CHO,@,CHI,L,0,16,2,3,0.667,2,3,0.667,0,0,,2,3,0.667,0,1,1
14267,Ramon Sessions,30-295,G,1/31/17,CHO,@,POR,L,0,13,0,2,0,0,2,0,0,0,,6,6,1,0,1,1
14268,Ramon Sessions,30-216,G,11/13/16,CHO,@,CLE,L,0,17,3,7,0.429,3,7,0.429,0,0,,0,0,,0,0,0
14269,Ramon Sessions,30-280,G,1/16/17,CHO,@,BOS,L,0,16,3,4,0.75,3,4,0.75,0,0,,0,1,0,0,1,1
14270,Ramon Sessions,30-207,G,11/4/16,CHO,@,BRK,W,0,21,1,7,0.143,1,5,0.2,0,2,0,4,6,0.667,0,2,2
14271,Ramon Sessions,30-269,G,1/5/17,CHO,@,DET,L,0,22,3,8,0.375,3,6,0.5,0,2,0,0,0,,0,1,1
14272,Iman Shumpert,26-124,G,10/28/16,CLE,@,TOR,W,0,20,1,4,0.25,0,3,0,1,1,1,3,4,0.75,0,4,4
14273,Iman Shumpert,26-266,G,3/19/17,CLE,@,LAL,W,1,28,3,8,0.375,3,6,0.5,0,2,0,0,0,,0,1,1
14274,Iman Shumpert,26-177,G,12/20/16,CLE,@,MIL,W,0,33,2,8,0.25,1,4,0.25,1,4,0.25,1,2,0.5,0,4,4
14275,Iman Shumpert,26-138,G,11/11/16,CLE,@,WAS,W,0,27,2,4,0.5,2,2,1,0,2,0,2,2,1,2,2,4
14276,Iman Shumpert,26-186,G,12/29/16,CLE,,BOS,W,0,30,2,6,0.333,1,2,0.5,1,4,0.25,1,2,0.5,2,0,2
14277,Iman Shumpert,26-150,G,11/23/16,CLE,,POR,W,0,17,2,4,0.5,0,1,0,2,3,0.667,0,0,,1,1,2
14278,Iman Shumpert,26-199,G,1/11/17,CLE,@,POR,L,0,26,3,5,0.6,3,4,0.75,0,1,0,0,2,0,0,2,2
14279,Iman Shumpert,26-215,G,1/27/17,CLE,,BRK,W,1,24,2,8,0.25,2,3,0.667,0,5,0,2,3,0.667,0,1,1
14280,Iman Shumpert,26-234,G,2/15/17,CLE,,IND,W,1,26,2,5,0.4,0,1,0,2,4,0.5,0,0,,0,1,1
14281,Pascal Siakam,22-295,F,11/25/16,TOR,@,MIL,W,1,23,2,3,0.667,2,3,0.667,0,0,,2,4,0.5,3,4,7
14282,Pascal Siakam,22-308,F,12/8/16,TOR,,MIN,W,1,11,1,1,1,1,1,1,0,0,,4,4,1,0,1,1
14283,Pascal Siakam,23-001,F,2/5/17,TOR,@,BRK,W,1,29,2,4,0.5,2,4,0.5,0,0,,2,2,1,1,6,7
14284,Pascal Siakam,22-305,F,12/5/16,TOR,,CLE,L,1,18,3,6,0.5,3,6,0.5,0,0,,0,0,,1,1,2
14285,Pascal Siakam,22-318,F,12/18/16,TOR,@,ORL,W,1,28,2,4,0.5,2,3,0.667,0,1,0,2,2,1,3,4,7
14286,Jonathon Simmons,27-163,G-F,2/24/17,SAS,@,LAC,W,0,10,2,5,0.4,2,3,0.667,0,2,0,2,2,1,0,0,0
14287,Jonathon Simmons,27-178,G-F,3/11/17,SAS,,GSW,W,0,27,3,6,0.5,3,6,0.5,0,0,,0,0,,0,3,3
14288,Jonathon Simmons,27-082,G-F,12/5/16,SAS,@,MIL,W,0,24,3,5,0.6,3,5,0.6,0,0,,0,0,,0,4,4
14289,Jonathon Simmons,27-099,G-F,12/22/16,SAS,@,LAC,L,0,22,2,10,0.2,1,8,0.125,1,2,0.5,1,2,0.5,1,3,4
14290,Jonathon Simmons,27-046,G-F,10/30/16,SAS,@,MIA,W,0,25,2,8,0.25,2,7,0.286,0,1,0,2,2,1,0,2,2
14291,Jonathon Simmons,27-176,G-F,3/9/17,SAS,@,OKC,L,0,18,1,5,0.2,1,5,0.2,0,0,,4,6,0.667,0,0,0
14292,Jonathon Simmons,27-111,G-F,1/3/17,SAS,,TOR,W,0,20,3,9,0.333,3,6,0.5,0,3,0,0,0,,0,4,4
14293,Jonathon Simmons,27-173,G-F,3/6/17,SAS,,HOU,W,0,14,3,4,0.75,3,3,1,0,1,0,0,0,,1,1,2
14294,Jonathon Simmons,27-059,G-F,11/12/16,SAS,@,HOU,W,0,16,3,4,0.75,3,3,1,0,1,0,0,0,,0,2,2
14295,Jonathon Simmons,27-076,G-F,11/29/16,SAS,,ORL,L,0,18,3,8,0.375,3,6,0.5,0,2,0,0,0,,0,3,3
14296,Jonathon Simmons,27-122,G-F,1/14/17,SAS,@,PHO,L,0,16,2,4,0.5,1,3,0.333,1,1,1,1,2,0.5,0,3,3
14297,Jonathon Simmons,27-052,G-F,11/5/16,SAS,,LAC,L,0,19,3,6,0.5,3,5,0.6,0,1,0,0,0,,1,3,4
14298,Jonathon Simmons,27-165,G-F,2/26/17,SAS,@,LAL,W,0,17,2,8,0.25,2,7,0.286,0,1,0,2,2,1,0,0,0
14299,Kyle Singler,28-285,F,2/13/17,OKC,@,WAS,L,0,17,2,3,0.667,2,3,0.667,0,0,,2,3,0.667,1,2,3
14300,Kyle Singler,28-183,F,11/3/16,OKC,@,GSW,L,0,17,2,5,0.4,1,3,0.333,1,2,0.5,1,2,0.5,0,2,2
14301,Marcus Smart,22-299,G,12/30/16,BOS,,MIA,W,1,34,1,7,0.143,1,6,0.167,0,1,0,4,4,1,1,3,4
14302,Marcus Smart,22-287,G,12/18/16,BOS,@,MIA,W,0,27,2,8,0.25,2,7,0.286,0,1,0,2,2,1,1,5,6
14303,Ish Smith,28-197,G,1/18/17,DET,,ATL,W,0,18,3,5,0.6,3,3,1,0,2,0,0,0,,0,3,3
14304,Ish Smith,28-194,G,1/15/17,DET,@,LAL,W,0,20,3,7,0.429,3,5,0.6,0,2,0,0,0,,0,1,1
14305,Ish Smith,28-113,G,10/26/16,DET,@,TOR,L,1,33,3,10,0.3,3,6,0.5,0,4,0,0,0,,0,1,1
14306,Ish Smith,28-141,G,11/23/16,DET,,MIA,W,1,18,2,6,0.333,2,6,0.333,0,0,,2,2,1,0,3,3
14307,Ish Smith,28-189,G,1/10/17,DET,@,SAC,L,0,17,2,5,0.4,2,4,0.5,0,1,0,2,2,1,0,1,1
14308,Ish Smith,28-257,G,3/19/17,DET,,PHO,W,0,23,2,9,0.222,1,8,0.125,1,1,1,1,2,0.5,0,3,3
14309,Ish Smith,28-164,G,12/16/16,DET,@,WAS,L,0,18,3,6,0.5,3,4,0.75,0,2,0,0,0,,0,2,2
14310,J.R. Smith,31-081,G-F,11/29/16,CLE,@,MIL,L,1,30,2,7,0.286,0,0,,2,7,0.286,0,0,,0,0,0
14311,J.R. Smith,31-102,G-F,12/20/16,CLE,@,MIL,W,1,17,2,6,0.333,0,2,0,2,4,0.5,0,0,,0,1,1
14312,J.R. Smith,31-092,G-F,12/10/16,CLE,,CHO,W,1,32,2,6,0.333,0,0,,2,6,0.333,0,0,,0,2,2
14313,J.R. Smith,31-060,G-F,11/8/16,CLE,,ATL,L,1,32,2,13,0.154,0,3,0,2,10,0.2,0,0,,1,1,2
14314,Jason Smith,30-345,F-C,2/10/17,WAS,,IND,W,0,17,3,5,0.6,3,5,0.6,0,0,,0,0,,1,1,2
14315,Jason Smith,30-327,F-C,1/23/17,WAS,@,CHO,W,0,19,3,4,0.75,3,4,0.75,0,0,,0,0,,0,6,6
14316,Jason Smith,30-260,F-C,11/17/16,WAS,,NYK,W,0,11,2,2,1,2,2,1,0,0,,2,2,1,2,1,3
14317,Jason Smith,30-294,F-C,12/21/16,WAS,@,CHI,W,0,12,2,4,0.5,2,4,0.5,0,0,,2,3,0.667,1,2,3
14318,Jason Smith,30-275,F-C,12/2/16,WAS,@,SAS,L,0,14,3,6,0.5,3,6,0.5,0,0,,0,0,,1,2,3
14319,Tony Snell,25-090,G-F,2/8/17,MIL,,MIA,L,1,34,2,6,0.333,0,2,0,2,4,0.5,0,0,,0,2,2
14320,Tony Snell,25-086,G-F,2/4/17,MIL,@,PHO,W,1,26,2,7,0.286,1,4,0.25,1,3,0.333,1,2,0.5,0,1,1
14321,Tony Snell,24-354,G-F,10/29/16,MIL,,BRK,W,1,21,3,7,0.429,3,4,0.75,0,3,0,0,0,,1,1,2
14322,Tony Snell,25-083,G-F,2/1/17,MIL,@,UTA,L,1,22,2,3,0.667,0,0,,2,3,0.667,0,0,,0,7,7
14323,Tony Snell,25-066,G-F,1/15/17,MIL,@,ATL,L,1,22,2,5,0.4,0,0,,2,5,0.4,0,0,,0,0,0
14324,Tony Snell,25-078,G-F,1/27/17,MIL,@,TOR,L,1,27,2,4,0.5,0,0,,2,4,0.5,0,0,,0,2,2
14325,Tony Snell,25-092,G-F,2/10/17,MIL,,LAL,L,1,23,2,4,0.5,1,2,0.5,1,2,0.5,1,1,1,0,3,3
14326,Marreese Speights,29-168,C-F,1/19/17,LAC,,MIN,L,0,18,2,9,0.222,1,4,0.25,1,5,0.2,1,2,0.5,1,3,4
14327,Marreese Speights,29-117,C-F,11/29/16,LAC,@,BRK,L,0,15,1,4,0.25,1,2,0.5,0,2,0,4,4,1,1,4,5
14328,Marreese Speights,29-109,C-F,11/21/16,LAC,,TOR,W,0,14,2,5,0.4,2,2,1,0,3,0,2,2,1,0,6,6
14329,Marreese Speights,29-122,C-F,12/4/16,LAC,,IND,L,0,12,2,7,0.286,0,2,0,2,5,0.4,0,0,,2,1,3
14330,Nik Stauskas,23-101,G,1/16/17,PHI,@,MIL,W,1,20,2,5,0.4,0,2,0,2,3,0.667,0,0,,1,2,3
14331,Nik Stauskas,23-150,G,3/6/17,PHI,,MIL,L,0,27,3,6,0.5,3,4,0.75,0,2,0,0,0,,0,0,0
14332,Nik Stauskas,23-022,G,10/29/16,PHI,,ATL,L,0,29,2,7,0.286,0,4,0,2,3,0.667,0,0,,0,5,5
14333,Nik Stauskas,23-156,G,3/12/17,PHI,@,LAL,W,0,23,3,6,0.5,3,4,0.75,0,2,0,0,0,,0,0,0
14334,Lance Stephenson,26-160,G-F,2/12/17,MIN,,CHI,W,0,14,3,5,0.6,3,5,0.6,0,0,,0,0,,0,0,0
14335,Lance Stephenson,26-156,G-F,2/8/17,MIN,,TOR,W,0,20,3,7,0.429,3,7,0.429,0,0,,0,0,,0,4,4
14336,Diamond Stone,19-278,C,11/14/16,LAC,,BRK,W,0,8,2,6,0.333,2,6,0.333,0,0,,2,2,1,1,1,2
14337,Rodney Stuckey,30-327,G,3/14/17,IND,@,NYK,L,0,16,1,6,0.167,0,3,0,1,3,0.333,3,6,0.5,0,1,1
14338,Rodney Stuckey,30-321,G,3/8/17,IND,,DET,W,0,24,2,7,0.286,1,4,0.25,1,3,0.333,1,1,1,0,2,2
14339,Rodney Stuckey,30-233,G,12/10/16,IND,,POR,W,0,27,1,5,0.2,1,3,0.333,0,2,0,4,4,1,0,3,3
14340,Rodney Stuckey,30-296,G,2/11/17,IND,,MIL,L,0,16,1,4,0.25,0,2,0,1,2,0.5,3,3,1,0,1,1
14341,Jeff Teague,28-251,G,2/16/17,IND,,WAS,L,1,27,3,7,0.429,3,4,0.75,0,3,0,0,0,,0,6,6
14342,Jeff Teague,28-199,G,12/26/16,IND,@,CHI,L,1,24,2,8,0.25,1,5,0.2,1,3,0.333,1,2,0.5,1,1,2
14343,Mirza Teletovic,31-169,F,3/6/17,MIL,@,PHI,W,0,21,2,8,0.25,0,2,0,2,6,0.333,0,0,,0,5,5
14344,Mirza Teletovic,31-104,F,12/31/16,MIL,@,CHI,W,0,23,2,6,0.333,0,2,0,2,4,0.5,0,0,,0,3,3
14345,Mirza Teletovic,31-038,F,10/26/16,MIL,,CHO,L,1,27,3,12,0.25,3,7,0.429,0,5,0,0,0,,0,2,2
14346,Mirza Teletovic,31-136,F,2/1/17,MIL,@,UTA,L,0,8,3,4,0.75,3,3,1,0,1,0,0,1,0,0,2,2
14347,Mirza Teletovic,31-070,F,11/27/16,MIL,@,ORL,W,0,15,2,5,0.4,0,0,,2,5,0.4,0,0,,1,2,3
14348,Mirza Teletovic,31-068,F,11/25/16,MIL,,TOR,L,0,13,2,4,0.5,0,0,,2,4,0.5,0,0,,0,0,0
14349,Garrett Temple,30-304,G,3/8/17,SAC,@,SAS,L,0,25,2,7,0.286,2,3,0.667,0,4,0,2,3,0.667,0,7,7
14350,Jason Terry,39-120,G,1/13/17,MIL,,MIA,W,0,23,2,5,0.4,0,1,0,2,4,0.5,0,0,,0,1,1
14351,Jason Terry,39-099,G,12/23/16,MIL,,WAS,W,0,18,2,2,1,0,0,,2,2,1,0,0,,0,1,1
14352,Jason Terry,39-151,G,2/13/17,MIL,,DET,W,0,17,2,3,0.667,0,0,,2,3,0.667,0,0,,0,0,0
14353,Jason Terry,39-092,G,12/16/16,MIL,@,CHI,W,0,19,2,5,0.4,0,1,0,2,4,0.5,0,0,,0,1,1
14354,Lance Thomas,28-188,F,10/29/16,NYK,,MEM,W,0,19,3,5,0.6,3,4,0.75,0,1,0,0,0,,1,2,3
14355,Lance Thomas,28-233,F,12/13/16,NYK,@,PHO,L,0,23,1,4,0.25,0,2,0,1,2,0.5,3,3,1,1,1,2
14356,Lance Thomas,28-199,F,11/9/16,NYK,,BRK,W,0,10,3,5,0.6,3,4,0.75,0,1,0,0,0,,0,1,1
14357,Lance Thomas,28-229,F,12/9/16,NYK,@,SAC,W,0,18,2,5,0.4,0,2,0,2,3,0.667,0,0,,1,1,2
14358,Hollis Thompson,25-234,G-F,11/23/16,PHI,,MEM,L,1,27,3,10,0.3,3,7,0.429,0,3,0,0,0,,0,3,3
14359,Tristan Thompson,25-279,F-C,12/17/16,CLE,,LAL,W,1,27,3,7,0.429,3,7,0.429,0,0,,0,0,,3,3,6
14360,Tristan Thompson,25-309,F-C,1/16/17,CLE,@,GSW,L,1,30,2,3,0.667,2,3,0.667,0,0,,2,2,1,2,3,5
14361,Tristan Thompson,25-275,F-C,12/13/16,CLE,,MEM,W,1,30,3,6,0.5,3,6,0.5,0,0,,0,0,,2,5,7
14362,Tristan Thompson,25-255,F-C,11/23/16,CLE,,POR,W,1,27,2,3,0.667,2,3,0.667,0,0,,2,6,0.333,1,5,6
14363,Tristan Thompson,25-318,F-C,1/25/17,CLE,,SAC,L,1,32,2,3,0.667,2,3,0.667,0,0,,2,6,0.333,3,5,8
14364,Tristan Thompson,25-332,F-C,2/8/17,CLE,@,IND,W,1,35,3,3,1,3,3,1,0,0,,0,0,,3,7,10
14365,Tristan Thompson,25-267,F-C,12/5/16,CLE,@,TOR,W,1,29,3,5,0.6,3,5,0.6,0,0,,0,2,0,4,10,14
14366,Anthony Tolliver,31-147,F-C,10/26/16,SAC,@,PHO,W,0,15,3,6,0.5,3,3,1,0,3,0,0,0,,2,3,5
14367,Anthony Tolliver,31-203,F-C,12/21/16,SAC,@,UTA,W,0,30,2,3,0.667,0,0,,2,3,0.667,0,0,,2,5,7
14368,Anthony Tolliver,31-236,F-C,1/23/17,SAC,@,DET,W,0,24,2,4,0.5,1,2,0.5,1,2,0.5,1,2,0.5,1,1,2
14369,Anthony Tolliver,31-250,F-C,2/6/17,SAC,,CHI,L,0,30,3,4,0.75,3,3,1,0,1,0,0,0,,5,1,6
14370,Anthony Tolliver,31-234,F-C,1/21/17,SAC,@,CHI,L,0,25,2,7,0.286,0,1,0,2,6,0.333,0,0,,0,1,1
14371,Anthony Tolliver,31-233,F-C,1/20/17,SAC,@,MEM,L,0,26,2,9,0.222,1,3,0.333,1,6,0.167,1,2,0.5,3,1,4
14372,P.J. Tucker,31-302,F,3/3/17,TOR,@,WAS,W,0,24,3,5,0.6,3,5,0.6,0,0,,0,0,,1,2,3
14373,P.J. Tucker,31-279,F,2/8/17,PHO,@,MEM,L,0,30,2,9,0.222,2,7,0.286,0,2,0,2,2,1,7,3,10
14374,P.J. Tucker,31-277,F,2/6/17,PHO,@,NOP,L,0,31,3,7,0.429,3,4,0.75,0,3,0,0,0,,1,4,5
14375,P.J. Tucker,31-315,F,3/16/17,TOR,,OKC,L,0,18,2,6,0.333,1,3,0.333,1,3,0.333,1,2,0.5,0,3,3
14376,P.J. Tucker,31-242,F,1/2/17,PHO,@,LAC,L,0,36,3,8,0.375,3,8,0.375,0,0,,0,0,,4,9,13
14377,P.J. Tucker,31-240,F,12/31/16,PHO,@,UTA,L,0,35,2,4,0.5,0,2,0,2,2,1,0,0,,1,5,6
14378,Evan Turner,28-041,G,12/7/16,POR,@,MIL,L,0,23,2,8,0.25,2,6,0.333,0,2,0,2,2,1,0,4,4
14379,Evan Turner,28-075,G,1/10/17,POR,@,LAL,W,0,26,3,9,0.333,3,7,0.429,0,2,0,0,0,,0,3,3
14380,Evan Turner,28-143,G,3/19/17,POR,@,MIA,W,0,20,3,8,0.375,3,6,0.5,0,2,0,0,0,,0,3,3
14381,Myles Turner,20-256,F-C,12/5/16,IND,@,GSW,L,1,24,3,8,0.375,3,7,0.429,0,1,0,0,0,,1,4,5
14382,Myles Turner,20-356,F-C,3/15/17,IND,,CHO,W,1,37,3,7,0.429,3,7,0.429,0,0,,0,0,,0,11,11
14383,Myles Turner,20-351,F-C,3/10/17,IND,@,MIL,L,1,33,3,9,0.333,3,8,0.375,0,1,0,0,0,,1,3,4
14384,Beno Udrih,34-136,G,11/18/16,DET,@,CLE,L,0,17,2,7,0.286,2,6,0.333,0,1,0,2,2,1,0,2,2
14385,Beno Udrih,34-119,G,11/1/16,DET,,NYK,W,0,16,3,9,0.333,3,9,0.333,0,0,,0,0,,0,1,1
14386,Beno Udrih,34-117,G,10/30/16,DET,,MIL,W,0,17,3,5,0.6,3,5,0.6,0,0,,0,0,,0,3,3
14387,Beno Udrih,34-144,G,11/26/16,DET,@,OKC,L,0,17,3,3,1,3,3,1,0,0,,0,0,,1,1,2
14388,Tyler Ulis,20-361,G,12/31/16,PHO,@,UTA,L,0,10,3,7,0.429,3,7,0.429,0,0,,0,0,,0,0,0
14389,Tyler Ulis,21-050,G,2/24/17,PHO,@,CHI,L,0,13,3,4,0.75,3,4,0.75,0,0,,0,0,,0,2,2
14390,Jonas Valanciunas,24-217,C,12/9/16,TOR,@,BOS,W,1,24,3,7,0.429,3,7,0.429,0,0,,0,0,,2,8,10
14391,Jonas Valanciunas,24-264,C,1/25/17,TOR,@,MEM,L,1,26,2,3,0.667,2,3,0.667,0,0,,2,2,1,2,10,12
14392,Jonas Valanciunas,24-210,C,12/2/16,TOR,,LAL,W,1,24,2,4,0.5,2,4,0.5,0,0,,2,2,1,1,6,7
14393,Jonas Valanciunas,24-208,C,11/30/16,TOR,,MEM,W,1,23,3,6,0.5,3,6,0.5,0,0,,0,0,,1,3,4
14394,Denzel Valentine,23-090,G,2/14/17,CHI,,TOR,W,0,15,2,3,0.667,0,0,,2,3,0.667,0,0,,0,2,2
14395,Denzel Valentine,23-112,G,3/8/17,CHI,@,ORL,L,0,23,2,8,0.25,0,0,,2,8,0.25,0,0,,0,5,5
14396,Denzel Valentine,23-030,G,12/16/16,CHI,,MIL,L,0,22,2,7,0.286,2,5,0.4,0,2,0,2,2,1,0,4,4
14397,Fred VanVleet,23-007,G,3/4/17,TOR,@,MIL,L,0,8,2,3,0.667,2,3,0.667,0,0,,2,2,1,0,2,2
14398,Fred VanVleet,23-024,G,3/21/17,TOR,,CHI,W,0,20,2,3,0.667,2,2,1,0,1,0,2,2,1,0,3,3
14399,Anderson Varejao,34-056,F-C,11/23/16,GSW,,LAL,W,0,9,1,1,1,1,1,1,0,0,,4,4,1,2,1,3
14400,Rashad Vaughn,20-214,G,3/18/17,MIL,@,GSW,L,0,12,2,5,0.4,0,1,0,2,4,0.5,0,0,,0,4,4
14401,Rashad Vaughn,20-086,G,11/10/16,MIL,,NOP,L,0,15,3,5,0.6,3,4,0.75,0,1,0,0,0,,0,2,2
14402,Noah Vonleh,21-064,F,10/27/16,POR,,LAC,L,0,10,1,3,0.333,1,2,0.5,0,1,0,4,5,0.8,0,0,0
14403,Noah Vonleh,21-115,F,12/17/16,POR,@,GSW,L,1,24,3,7,0.429,3,7,0.429,0,0,,0,2,0,3,5,8
14404,Noah Vonleh,21-113,F,12/15/16,POR,@,DEN,L,1,18,3,8,0.375,3,8,0.375,0,0,,0,0,,3,4,7
14405,Noah Vonleh,21-069,F,11/1/16,POR,,GSW,L,0,12,2,7,0.286,0,2,0,2,5,0.4,0,0,,0,1,1
14406,Noah Vonleh,21-108,F,12/10/16,POR,@,IND,L,0,7,2,2,1,2,2,1,0,0,,2,2,1,1,1,2
14407,Nikola Vucevic,26-012,C,11/5/16,ORL,,WAS,W,1,26,3,6,0.5,3,6,0.5,0,0,,0,2,0,2,7,9
14408,Sasha Vujacic,32-269,G,12/2/16,NYK,,MIN,W,0,11,2,3,0.667,0,0,,2,3,0.667,0,0,,0,0,0
14409,Dion Waiters,25-097,G,3/17/17,MIA,,MIN,W,1,12,3,3,1,3,3,1,0,0,,0,0,,0,2,2
14410,T.J. Warren,23-147,F,1/30/17,PHO,,MEM,L,1,21,1,4,0.25,1,4,0.25,0,0,,4,4,1,2,3,5
14411,T.J. Warren,23-145,F,1/28/17,PHO,,DEN,L,1,20,3,10,0.3,3,9,0.333,0,1,0,0,0,,4,1,5
14412,David West,36-116,F,12/23/16,GSW,@,DET,W,0,14,3,4,0.75,3,4,0.75,0,0,,0,0,,0,1,1
14413,David West,36-199,F,3/16/17,GSW,,ORL,W,0,12,3,4,0.75,3,4,0.75,0,0,,0,0,,0,4,4
14414,David West,36-079,F,11/16/16,GSW,@,TOR,W,0,16,3,4,0.75,3,4,0.75,0,0,,0,0,,0,2,2
14415,David West,36-140,F,1/16/17,GSW,,CLE,W,0,15,3,4,0.75,3,4,0.75,0,0,,0,0,,0,2,2
14416,David West,36-204,F,3/21/17,GSW,@,DAL,W,0,15,2,3,0.667,2,3,0.667,0,0,,2,2,1,0,5,5
14417,Okaro White,24-203,F,3/4/17,MIA,,CLE,W,0,25,2,5,0.4,2,5,0.4,0,0,,2,2,1,3,4,7
14418,Isaiah Whitehead,21-237,G,10/31/16,BRK,,CHI,L,0,21,3,11,0.273,3,9,0.333,0,2,0,0,0,,2,2,4
14419,Isaiah Whitehead,21-297,G,12/30/16,BRK,@,WAS,L,1,25,2,8,0.25,1,4,0.25,1,4,0.25,1,2,0.5,0,1,1
14420,Isaiah Whitehead,21-272,G,12/5/16,BRK,,WAS,L,1,24,3,8,0.375,3,8,0.375,0,0,,0,0,,0,4,4
14421,Isaiah Whitehead,21-313,G,1/15/17,BRK,,HOU,L,0,15,2,6,0.333,1,3,0.333,1,3,0.333,1,2,0.5,0,3,3
14422,Isaiah Whitehead,22-000,G,3/8/17,BRK,@,ATL,L,0,24,3,6,0.5,3,4,0.75,0,2,0,0,0,,0,3,3
14423,Isaiah Whitehead,21-270,G,12/3/16,BRK,@,MIL,L,1,24,3,6,0.5,3,4,0.75,0,2,0,0,0,,0,3,3
14424,Isaiah Whitehead,21-339,G,2/10/17,BRK,,MIA,L,0,16,3,9,0.333,3,7,0.429,0,2,0,0,0,,2,0,2
14425,Isaiah Whitehead,21-245,G,11/8/16,BRK,,MIN,W,1,26,2,5,0.4,2,4,0.5,0,1,0,2,2,1,2,5,7
14426,Isaiah Whitehead,21-361,G,3/4/17,BRK,@,POR,L,0,23,3,5,0.6,3,4,0.75,0,1,0,0,0,,0,0,0
14427,Isaiah Whitehead,21-266,G,11/29/16,BRK,,LAC,W,1,46,2,8,0.25,1,5,0.2,1,3,0.333,1,3,0.333,0,3,3
14428,Hassan Whiteside,27-163,C,11/23/16,MIA,@,DET,L,1,25,3,8,0.375,3,8,0.375,0,0,,0,0,,1,7,8
14429,Alan Williams,24-002,F-C,1/30/17,PHO,,MEM,L,0,5,2,3,0.667,2,3,0.667,0,0,,2,3,0.667,1,2,3
14430,Deron Williams,32-253,G,3/6/17,CLE,,MIA,L,0,17,2,3,0.667,2,2,1,0,1,0,2,2,1,0,1,1
14431,Deron Williams,32-207,G,1/19/17,DAL,@,MIA,L,1,32,2,8,0.25,1,3,0.333,1,5,0.2,1,2,0.5,0,3,3
14432,Deron Williams,32-184,G,12/27/16,DAL,,HOU,L,1,23,2,11,0.182,0,6,0,2,5,0.4,0,1,0,2,1,3
14433,Derrick Williams,25-174,F,11/15/16,MIA,,ATL,L,1,18,3,8,0.375,3,6,0.5,0,2,0,0,0,,0,1,1
14434,Derrick Williams,25-226,F,1/6/17,MIA,@,LAL,L,0,15,1,7,0.143,1,4,0.25,0,3,0,4,6,0.667,1,5,6
14435,Lou Williams,30-019,G,11/15/16,LAL,,BRK,W,0,17,2,11,0.182,2,9,0.222,0,2,0,2,2,1,0,2,2
14436,Marvin Williams,30-149,F,11/15/16,CHO,@,MIN,W,1,23,1,9,0.111,1,4,0.25,0,5,0,4,4,1,0,1,1
14437,Marvin Williams,30-260,F,3/6/17,CHO,,IND,W,1,40,1,7,0.143,1,2,0.5,0,5,0,4,4,1,1,4,5
14438,Marvin Williams,30-138,F,11/4/16,CHO,@,BRK,W,1,30,2,13,0.154,0,5,0,2,8,0.25,0,0,,2,2,4
14439,Justise Winslow,20-226,F,11/7/16,MIA,@,OKC,L,1,32,2,13,0.154,2,11,0.182,0,2,0,2,2,1,1,2,3
14440,Jeff Withey,26-269,C,12/1/16,UTA,,MIA,L,0,13,2,2,1,2,2,1,0,0,,2,3,0.667,0,2,2
14441,Jeff Withey,26-331,C,2/1/17,UTA,,MIL,W,0,14,2,5,0.4,2,5,0.4,0,0,,2,2,1,2,2,4
14442,Jeff Withey,26-258,C,11/20/16,UTA,@,DEN,L,0,18,2,3,0.667,2,3,0.667,0,0,,2,2,1,3,2,5
14443,Metta World Peace,37-010,F,11/23/16,LAL,@,GSW,L,0,14,2,4,0.5,0,0,,2,4,0.5,0,0,,0,1,1
14444,Brandan Wright,29-117,F-C,1/30/17,MEM,@,PHO,W,0,5,3,5,0.6,3,5,0.6,0,0,,0,0,,1,1,2
14445,Brandan Wright,29-133,F-C,2/15/17,MEM,,NOP,L,0,12,3,3,1,3,3,1,0,0,,0,0,,0,1,1
14446,Brandan Wright,29-128,F-C,2/10/17,MEM,,GSW,L,0,12,3,7,0.429,3,7,0.429,0,0,,0,0,,0,0,0
14447,Delon Wright,24-309,G,3/1/17,TOR,,WAS,L,0,20,1,2,0.5,1,2,0.5,0,0,,4,4,1,0,1,1
14448,Joe Young,24-123,G,10/28/16,IND,@,BRK,L,0,13,2,6,0.333,1,5,0.2,1,1,1,1,2,0.5,0,2,2
14449,Nick Young,31-281,G-F,3/9/17,LAL,@,PHO,W,1,14,2,6,0.333,0,3,0,2,3,0.667,0,0,,0,1,1
14450,Thaddeus Young,28-176,F,12/14/16,IND,@,MIA,L,1,39,3,6,0.5,3,5,0.6,0,1,0,0,0,,0,7,7
14451,Cody Zeller,24-105,F-C,1/18/17,CHO,,POR,W,1,25,3,7,0.429,3,7,0.429,0,0,,0,0,,3,7,10
14452,Cody Zeller,24-059,F-C,12/3/16,CHO,,MIN,L,1,35,3,7,0.429,3,7,0.429,0,0,,0,0,,3,6,9
14453,Cody Zeller,24-148,F-C,3/2/17,CHO,@,PHO,L,0,24,3,5,0.6,3,5,0.6,0,0,,0,0,,3,5,8
14454,Cody Zeller,24-057,F-C,12/1/16,CHO,,DAL,W,1,31,3,5,0.6,3,5,0.6,0,0,,0,0,,1,6,7
14455,Cody Zeller,24-146,F-C,2/28/17,CHO,@,LAL,W,0,18,3,6,0.5,3,6,0.5,0,0,,0,4,0,3,2,5
14456,Cody Zeller,24-087,F-C,12/31/16,CHO,,CLE,L,1,19,3,3,1,3,3,1,0,0,,0,0,,0,1,1
14457,Cody Zeller,24-157,F-C,3/11/17,CHO,,NOP,L,1,40,3,7,0.429,3,7,0.429,0,0,,0,2,0,3,6,9
14458,Cody Zeller,24-156,F-C,3/10/17,CHO,,ORL,W,1,31,3,4,0.75,3,4,0.75,0,0,,0,0,,0,7,7
14459,Tyler Zeller,26-297,F-C,11/9/16,BOS,@,WAS,L,1,14,3,4,0.75,3,4,0.75,0,0,,0,0,,1,1,2
14460,Tyler Zeller,26-294,F-C,11/6/16,BOS,,DEN,L,1,26,3,7,0.429,3,7,0.429,0,0,,0,0,,0,5,5
14461,Tyler Zeller,26-284,F-C,10/27/16,BOS,@,CHI,L,0,20,3,9,0.333,3,9,0.333,0,0,,0,1,0,1,4,5
14462,Stephen Zimmerman,20-182,C,3/10/17,ORL,@,CHO,L,0,18,2,5,0.4,2,5,0.4,0,0,,2,2,1,1,2,3
14463,Stephen Zimmerman,20-110,C,12/28/16,ORL,,CHO,L,0,6,3,3,1,3,3,1,0,0,,0,0,,1,3,4
14464,Ivica Zubac,19-229,C,11/2/16,LAL,@,ATL,W,1,19,3,4,0.75,3,4,0.75,0,0,,0,0,,2,2,4
14465,Ivica Zubac,19-280,C,12/23/16,LAL,@,ORL,L,0,17,2,7,0.286,2,7,0.286,0,0,,2,2,1,1,1,2
14466,Alex Abrines,23-178,G-F,1/26/17,OKC,,DAL,W,0,16,1,3,0.333,0,0,,1,3,0.333,2,2,1,0,0,0
14467,Alex Abrines,23-222,G-F,3/11/17,OKC,,UTA,W,0,15,2,3,0.667,1,2,0.5,1,1,1,0,0,,0,0,0
14468,Alex Abrines,23-198,G-F,2/15/17,OKC,,NYK,W,0,16,2,5,0.4,1,3,0.333,1,2,0.5,0,0,,0,1,1
14469,Alex Abrines,23-098,G-F,11/7/16,OKC,,MIA,W,0,17,2,9,0.222,1,2,0.5,1,7,0.143,0,0,,1,1,2
14470,Alex Abrines,23-218,G-F,3/7/17,OKC,,POR,L,0,13,2,5,0.4,1,2,0.5,1,3,0.333,0,0,,0,1,1
14471,Alex Abrines,23-094,G-F,11/3/16,OKC,@,GSW,L,0,19,1,6,0.167,0,0,,1,6,0.167,2,2,1,1,2,3
14472,Alex Abrines,23-134,G-F,12/13/16,OKC,@,POR,L,0,13,2,7,0.286,1,2,0.5,1,5,0.2,0,0,,0,2,2
14473,Alex Abrines,23-090,G-F,10/30/16,OKC,,LAL,W,0,2,1,1,1,1,1,1,0,0,,3,3,1,0,0,0
14474,Alex Abrines,23-105,G-F,11/14/16,OKC,@,DET,L,0,17,1,7,0.143,0,2,0,1,5,0.2,2,2,1,0,1,1
14475,Quincy Acy,26-151,F,3/6/17,BRK,@,MEM,W,0,15,2,5,0.4,1,1,1,1,4,0.25,0,0,,0,2,2
14476,Quincy Acy,26-103,F,1/17/17,BRK,,TOR,L,0,3,2,4,0.5,2,4,0.5,0,0,,1,1,1,1,0,1
14477,Quincy Acy,26-114,F,1/28/17,BRK,@,MIN,L,0,17,2,6,0.333,1,4,0.25,1,2,0.5,0,0,,2,0,2
14478,Arron Afflalo,31-114,G,2/6/17,SAC,,CHI,L,1,17,2,5,0.4,1,2,0.5,1,3,0.333,0,0,,0,1,1
14479,Arron Afflalo,31-048,G,12/2/16,SAC,@,BOS,L,1,17,2,4,0.5,2,4,0.5,0,0,,1,2,0.5,1,2,3
14480,Arron Afflalo,31-097,G,1/20/17,SAC,@,MEM,L,1,25,2,5,0.4,2,2,1,0,3,0,1,1,1,0,2,2
14481,Arron Afflalo,31-014,G,10/29/16,SAC,,MIN,W,1,30,2,6,0.333,1,2,0.5,1,4,0.25,0,0,,0,0,0
14482,Arron Afflalo,31-090,G,1/13/17,SAC,,CLE,L,0,17,2,3,0.667,1,2,0.5,1,1,1,0,0,,0,0,0
14483,Arron Afflalo,31-085,G,1/8/17,SAC,,GSW,L,0,14,2,4,0.5,1,1,1,1,3,0.333,0,0,,0,1,1
14484,Alexis Ajinca,28-231,C,12/23/16,NOP,,MIA,W,1,21,2,5,0.4,2,5,0.4,0,0,,1,2,0.5,2,2,4
14485,Alexis Ajinca,28-185,C,11/7/16,NOP,@,GSW,L,0,6,2,2,1,2,2,1,0,0,,1,2,0.5,0,2,2
14486,Alexis Ajinca,28-283,C,2/13/17,NOP,@,PHO,W,1,19,2,5,0.4,2,5,0.4,0,0,,1,2,0.5,2,1,3
14487,LaMarcus Aldridge,31-134,F-C,11/30/16,SAS,@,DAL,W,1,32,2,9,0.222,2,9,0.222,0,0,,1,2,0.5,2,6,8
14488,Lavoy Allen,28-025,F-C,3/1/17,IND,@,SAS,L,0,20,2,3,0.667,2,3,0.667,0,0,,1,2,0.5,3,3,6
14489,Tony Allen,35-054,G-F,3/6/17,MEM,,BRK,L,0,17,2,4,0.5,2,3,0.667,0,1,0,1,2,0.5,2,1,3
14490,Al-Farouq Aminu,26-078,F,12/8/16,POR,@,MEM,L,0,24,2,9,0.222,2,3,0.667,0,6,0,1,2,0.5,1,10,11
14491,Al-Farouq Aminu,26-038,F,10/29/16,POR,@,DEN,W,1,32,1,6,0.167,0,0,,1,6,0.167,2,4,0.5,1,11,12
14492,Al-Farouq Aminu,26-091,F,12/21/16,POR,,DAL,L,1,30,1,4,0.25,0,2,0,1,2,0.5,2,2,1,0,6,6
14493,Alan Anderson,34-097,G-F,1/21/17,LAC,@,DEN,L,0,11,1,6,0.167,0,2,0,1,4,0.25,2,2,1,0,0,0
14494,Alan Anderson,34-092,G-F,1/16/17,LAC,,OKC,W,0,19,2,5,0.4,2,5,0.4,0,0,,1,1,1,0,1,1
14495,Alan Anderson,34-076,G-F,12/31/16,LAC,@,OKC,L,0,18,2,7,0.286,1,2,0.5,1,5,0.2,0,0,,0,3,3
14496,Justin Anderson,23-030,G,12/19/16,DAL,@,DEN,L,0,14,1,1,1,0,0,,1,1,1,2,2,1,0,2,2
14497,Justin Anderson,23-071,G,1/29/17,DAL,@,SAS,W,0,7,2,4,0.5,1,1,1,1,3,0.333,0,0,,0,1,1
14498,Justin Anderson,23-014,G,12/3/16,DAL,,CHI,W,0,10,1,3,0.333,0,2,0,1,1,1,2,4,0.5,1,2,3
14499,Justin Anderson,23-105,G,3/4/17,PHI,,DET,L,0,30,1,6,0.167,0,3,0,1,3,0.333,2,2,1,0,8,8
14500,Justin Anderson,23-002,G,11/21/16,DAL,@,SAS,L,0,15,2,7,0.286,2,4,0.5,0,3,0,1,2,0.5,2,2,4
14501,Justin Anderson,23-014,G,12/3/16,DAL,,CHI,W,0,10,1,3,0.333,0,2,0,1,1,1,2,4,0.5,1,2,3
14502,Justin Anderson,23-030,G,12/19/16,DAL,@,DEN,L,0,14,1,1,1,0,0,,1,1,1,2,2,1,0,2,2
14503,Justin Anderson,23-071,G,1/29/17,DAL,@,SAS,W,0,7,2,4,0.5,1,1,1,1,3,0.333,0,0,,0,1,1
14504,Kyle Anderson,23-039,F-G,10/29/16,SAS,,NOP,W,1,26,2,7,0.286,1,5,0.2,1,2,0.5,0,0,,0,7,7
14505,Kyle Anderson,23-145,F-G,2/12/17,SAS,@,NYK,L,0,7,1,3,0.333,1,3,0.333,0,0,,3,3,1,0,1,1
14506,Kyle Anderson,23-040,F-G,10/30/16,SAS,@,MIA,W,1,20,2,3,0.667,1,2,0.5,1,1,1,0,0,,0,1,1
14507,Ryan Anderson,28-197,F,11/19/16,HOU,,UTA,W,1,32,2,9,0.222,1,4,0.25,1,5,0.2,0,0,,1,2,3
14508,Ryan Anderson,28-175,F,10/28/16,HOU,@,DAL,W,1,25,2,5,0.4,1,4,0.25,1,1,1,0,0,,1,3,4
14509,Trevor Ariza,31-230,F,2/15/17,HOU,,MIA,L,1,36,2,7,0.286,1,2,0.5,1,5,0.2,0,0,,0,4,4
14510,Trevor Ariza,31-118,F,10/26/16,HOU,@,LAL,L,1,33,2,8,0.25,1,4,0.25,1,4,0.25,0,0,,0,6,6
14511,Trevor Ariza,31-202,F,1/18/17,HOU,,MIL,W,1,39,2,8,0.25,1,1,1,1,7,0.143,0,0,,1,5,6
14512,Darrell Arthur,28-273,F,12/23/16,DEN,,ATL,L,0,11,2,4,0.5,1,2,0.5,1,2,0.5,0,0,,0,1,1
14513,Darrell Arthur,28-245,F,11/25/16,DEN,,OKC,L,0,20,2,5,0.4,1,1,1,1,4,0.25,0,0,,0,2,2
14514,Darrell Arthur,28-260,F,12/10/16,DEN,@,ORL,W,1,23,2,5,0.4,1,3,0.333,1,2,0.5,0,0,,0,0,0
14515,Omer Asik,30-127,C,11/8/16,NOP,@,SAC,L,1,26,1,4,0.25,1,4,0.25,0,0,,3,4,0.75,4,5,9
14516,Omer Asik,30-120,C,11/1/16,NOP,,MIL,L,0,13,1,3,0.333,1,3,0.333,0,0,,3,6,0.5,2,5,7
14517,D.J. Augustin,29-052,G,1/1/17,ORL,@,IND,L,1,15,2,6,0.333,1,2,0.5,1,4,0.25,0,0,,0,0,0
14518,D.J. Augustin,29-121,G,3/11/17,ORL,,CLE,L,0,12,2,6,0.333,2,3,0.667,0,3,0,1,1,1,0,1,1
14519,D.J. Augustin,29-081,G,1/30/17,ORL,@,MIN,L,0,23,2,9,0.222,1,4,0.25,1,5,0.2,0,0,,0,1,1
14520,D.J. Augustin,29-130,G,3/20/17,ORL,,PHI,W,0,18,1,5,0.2,0,4,0,1,1,1,2,2,1,1,2,3
14521,Luke Babbitt,27-156,F,11/23/16,MIA,@,DET,L,0,18,2,5,0.4,1,3,0.333,1,2,0.5,0,0,,1,1,2
14522,Luke Babbitt,27-215,F,1/21/17,MIA,,MIL,W,1,18,2,4,0.5,1,2,0.5,1,2,0.5,0,0,,1,3,4
14523,Luke Babbitt,27-193,F,12/30/16,MIA,@,BOS,L,1,16,2,4,0.5,1,1,1,1,3,0.333,0,0,,0,2,2
14524,Luke Babbitt,27-186,F,12/23/16,MIA,@,NOP,L,0,13,2,4,0.5,1,3,0.333,1,1,1,0,0,,1,0,1
14525,Luke Babbitt,27-158,F,11/25/16,MIA,@,MEM,W,0,20,2,4,0.5,1,1,1,1,3,0.333,0,0,,0,1,1
14526,Ron Baker,23-291,G,1/15/17,NYK,@,TOR,L,0,16,2,3,0.667,1,1,1,1,2,0.5,0,0,,0,3,3
14527,Ron Baker,23-307,G,1/31/17,NYK,@,WAS,L,0,28,2,6,0.333,2,5,0.4,0,1,0,1,3,0.333,1,1,2
14528,Ron Baker,23-334,G,2/27/17,NYK,,TOR,L,0,19,2,4,0.5,1,2,0.5,1,2,0.5,0,0,,0,5,5
14529,Ron Baker,23-343,G,3/8/17,NYK,@,MIL,L,0,9,2,5,0.4,1,2,0.5,1,3,0.333,0,0,,1,0,1
14530,Ron Baker,23-209,G,10/25/16,NYK,@,CLE,L,0,7,2,3,0.667,1,2,0.5,1,1,1,0,0,,0,1,1
14531,Wade Baldwin,20-214,G,10/29/16,MEM,@,NYK,L,0,22,2,4,0.5,1,3,0.333,1,1,1,0,0,,0,2,2
14532,Wade Baldwin,20-241,G,11/25/16,MEM,,MIA,L,0,13,2,5,0.4,2,5,0.4,0,0,,1,2,0.5,1,0,1
14533,Leandro Barbosa,33-347,G,11/9/16,PHO,,DET,W,0,8,2,3,0.667,1,2,0.5,1,1,1,0,0,,1,1,2
14534,Leandro Barbosa,34-030,G,12/28/16,PHO,@,SAS,L,0,13,2,4,0.5,1,3,0.333,1,1,1,0,0,,0,1,1
14535,Leandro Barbosa,33-359,G,11/21/16,PHO,@,WAS,L,0,14,2,4,0.5,1,2,0.5,1,2,0.5,0,0,,0,1,1
14536,Leandro Barbosa,34-101,G,3/9/17,PHO,,LAL,L,0,16,2,7,0.286,1,4,0.25,1,3,0.333,0,0,,1,0,1
14537,Leandro Barbosa,34-038,G,1/5/17,PHO,@,DAL,W,0,14,1,7,0.143,0,5,0,1,2,0.5,2,2,1,0,1,1
14538,J.J. Barea,32-258,G,3/11/17,DAL,,PHO,L,0,16,2,9,0.222,1,5,0.2,1,4,0.25,0,0,,1,1,2
14539,Harrison Barnes,24-295,F,3/21/17,DAL,,GSW,L,1,34,2,10,0.2,2,9,0.222,0,1,0,1,2,0.5,1,3,4
14540,Matt Barnes,36-300,F,1/3/17,SAC,@,DEN,W,1,28,2,6,0.333,1,2,0.5,1,4,0.25,0,0,,0,3,3
14541,Matt Barnes,36-328,F,1/31/17,SAC,@,HOU,L,0,30,2,8,0.25,1,3,0.333,1,5,0.2,0,0,,1,10,11
14542,Matt Barnes,37-007,F,3/16/17,GSW,,ORL,W,0,20,2,7,0.286,1,4,0.25,1,3,0.333,0,0,,3,2,5
14543,Matt Barnes,36-342,F,2/14/17,SAC,@,LAL,W,0,27,2,7,0.286,1,2,0.5,1,5,0.2,0,0,,2,4,6
14544,Matt Barnes,36-338,F,2/10/17,SAC,,ATL,W,0,25,2,5,0.4,1,2,0.5,1,3,0.333,0,0,,1,3,4
14545,Matt Barnes,37-001,F,3/10/17,GSW,@,MIN,L,0,10,2,2,1,1,1,1,1,1,1,0,0,,0,2,2
14546,Matt Barnes,36-247,F,11/11/16,SAC,@,POR,L,0,19,1,4,0.25,0,0,,1,4,0.25,2,2,1,1,3,4
14547,Matt Barnes,36-362,F,3/6/17,GSW,@,ATL,W,0,18,1,5,0.2,0,1,0,1,4,0.25,2,2,1,2,5,7
14548,Matt Barnes,36-244,F,11/8/16,SAC,,NOP,W,0,27,2,5,0.4,1,1,1,1,4,0.25,0,0,,0,8,8
14549,Will Barton,25-341,G,12/12/16,DEN,@,DAL,L,1,33,2,12,0.167,1,9,0.111,1,3,0.333,0,0,,2,1,3
14550,Will Barton,26-018,G,1/24/17,DEN,,UTA,W,0,22,1,7,0.143,0,3,0,1,4,0.25,2,3,0.667,1,3,4
14551,Brandon Bass,31-300,F,2/24/17,LAC,,SAS,L,0,10,2,5,0.4,2,5,0.4,0,0,,1,2,0.5,3,3,6
14552,Brandon Bass,31-186,F,11/2/16,LAC,,OKC,L,0,13,2,5,0.4,1,4,0.25,1,1,1,0,0,,3,1,4
14553,Nicolas Batum,28-076,F-G,2/28/17,CHO,@,LAL,W,1,36,2,13,0.154,1,4,0.25,1,9,0.111,0,0,,1,4,5
14554,Kent Bazemore,27-165,G-F,12/13/16,ATL,,ORL,L,0,15,2,8,0.25,2,6,0.333,0,2,0,1,2,0.5,0,3,3
14555,Kent Bazemore,27-175,G-F,12/23/16,ATL,@,DEN,W,1,31,2,9,0.222,2,7,0.286,0,2,0,1,2,0.5,0,2,2
14556,Malik Beasley,20-006,G,12/2/16,DEN,,HOU,L,0,4,2,3,0.667,1,1,1,1,2,0.5,0,0,,0,0,0
14557,Malik Beasley,19-363,G,11/23/16,DEN,@,UTA,L,0,12,1,5,0.2,1,3,0.333,0,2,0,3,4,0.75,0,1,1
14558,Malik Beasley,20-070,G,2/4/17,DEN,@,SAS,L,0,9,2,3,0.667,1,2,0.5,1,1,1,0,0,,0,0,0
14559,Michael Beasley,28-012,F,1/21/17,MIL,@,MIA,L,0,10,2,4,0.5,2,4,0.5,0,0,,1,2,0.5,0,2,2
14560,Michael Beasley,27-329,F,12/3/16,MIL,,BRK,W,0,18,2,5,0.4,2,5,0.4,0,0,,1,2,0.5,0,3,3
14561,Michael Beasley,27-327,F,12/1/16,MIL,@,BRK,W,0,17,1,4,0.25,1,4,0.25,0,0,,3,4,0.75,2,5,7
14562,Marco Belinelli,30-338,G-F,2/26/17,CHO,@,LAC,L,0,14,2,4,0.5,1,1,1,1,3,0.333,0,0,,0,2,2
14563,Marco Belinelli,30-218,G-F,10/29/16,CHO,,BOS,L,0,23,1,6,0.167,1,3,0.333,0,3,0,3,3,1,0,1,1
14564,Marco Belinelli,30-288,G-F,1/7/17,CHO,@,SAS,L,0,27,2,10,0.2,1,6,0.167,1,4,0.25,0,0,,1,3,4
14565,Marco Belinelli,30-246,G-F,11/26/16,CHO,,NYK,W,0,20,2,5,0.4,1,2,0.5,1,3,0.333,0,0,,0,2,2
14566,Marco Belinelli,30-286,G-F,1/5/17,CHO,@,DET,L,0,21,0,6,0,0,6,0,0,0,,5,6,0.833,0,2,2
14567,Dragan Bender,19-076,F,2/1/17,PHO,,LAC,L,0,13,2,6,0.333,1,3,0.333,1,3,0.333,0,0,,3,2,5
14568,Dragan Bender,19-060,F,1/16/17,PHO,,UTA,L,0,25,2,4,0.5,1,1,1,1,3,0.333,0,0,,1,3,4
14569,Dragan Bender,19-056,F,1/12/17,PHO,,DAL,L,0,8,1,3,0.333,0,1,0,1,2,0.5,2,2,1,1,0,1
14570,Dragan Bender,18-362,F,11/13/16,PHO,@,GSW,L,0,14,2,2,1,1,1,1,1,1,1,0,0,,1,1,2
14571,Dragan Bender,19-052,F,1/8/17,PHO,,CLE,L,0,12,2,5,0.4,1,2,0.5,1,3,0.333,0,0,,3,0,3
14572,Dragan Bender,18-361,F,11/12/16,PHO,,BRK,L,0,8,2,3,0.667,1,1,1,1,2,0.5,0,0,,0,1,1
14573,Anthony Bennett,23-251,F,11/20/16,BRK,,POR,L,0,6,1,2,0.5,1,1,1,0,1,0,3,7,0.429,3,1,4
14574,Anthony Bennett,23-297,F,1/5/17,BRK,@,IND,L,0,3,2,2,1,1,1,1,1,1,1,0,0,,0,1,1
14575,Anthony Bennett,23-240,F,11/9/16,BRK,@,NYK,L,0,4,2,3,0.667,1,1,1,1,2,0.5,0,0,,1,1,2
14576,Davis Bertans,24-090,F,2/10/17,SAS,@,DET,W,0,11,2,4,0.5,1,2,0.5,1,2,0.5,0,0,,0,1,1
14577,Davis Bertans,24-052,F,1/3/17,SAS,,TOR,W,0,8,2,3,0.667,1,1,1,1,2,0.5,0,0,,0,2,2
14578,Davis Bertans,24-028,F,12/10/16,SAS,,BRK,W,0,21,1,4,0.25,1,1,1,0,3,0,3,3,1,0,6,6
14579,Davis Bertans,23-348,F,10/25/16,SAS,@,GSW,W,0,4,2,2,1,1,1,1,1,1,1,0,0,,0,1,1
14580,Davis Bertans,24-061,F,1/12/17,SAS,,LAL,W,0,11,2,5,0.4,1,1,1,1,4,0.25,0,0,,0,3,3
14581,Davis Bertans,24-095,F,2/15/17,SAS,@,ORL,W,0,16,1,7,0.143,0,1,0,1,6,0.167,2,2,1,0,0,0
14582,Patrick Beverley,28-130,G,11/19/16,HOU,,UTA,W,1,27,2,6,0.333,1,4,0.25,1,2,0.5,0,0,,0,1,1
14583,Patrick Beverley,28-203,G,1/31/17,HOU,,SAC,W,1,32,2,11,0.182,1,5,0.2,1,6,0.167,0,0,,1,4,5
14584,Bismack Biyombo,24-080,C-F,11/16/16,ORL,,NOP,W,0,25,2,4,0.5,2,4,0.5,0,0,,1,2,0.5,5,3,8
14585,Bismack Biyombo,24-077,C-F,11/13/16,ORL,@,OKC,W,0,29,2,4,0.5,2,4,0.5,0,0,,1,2,0.5,1,7,8
14586,Bismack Biyombo,24-122,C-F,12/28/16,ORL,,CHO,L,1,22,2,3,0.667,2,3,0.667,0,0,,1,1,1,0,4,4
14587,Bismack Biyombo,24-098,C-F,12/4/16,ORL,@,DET,W,1,30,2,3,0.667,2,3,0.667,0,0,,1,2,0.5,0,7,7
14588,Nemanja Bjelica,28-211,F,12/6/16,MIN,,SAS,L,0,11,2,4,0.5,1,2,0.5,1,2,0.5,0,0,,0,0,0
14589,Nemanja Bjelica,28-176,F,11/1/16,MIN,,MEM,W,0,18,2,4,0.5,1,2,0.5,1,2,0.5,0,0,,1,7,8
14590,Nemanja Bjelica,28-242,F,1/6/17,MIN,@,WAS,L,0,11,2,5,0.4,1,1,1,1,4,0.25,0,0,,0,1,1
14591,Nemanja Bjelica,28-201,F,11/26/16,MIN,@,GSW,L,0,13,2,5,0.4,1,2,0.5,1,3,0.333,0,0,,0,1,1
14592,Nemanja Bjelica,28-237,F,1/1/17,MIN,,POR,L,0,15,2,3,0.667,1,1,1,1,2,0.5,0,0,,0,2,2
14593,Nemanja Bjelica,28-281,F,2/14/17,MIN,,CLE,L,0,15,2,4,0.5,1,3,0.333,1,1,1,0,0,,2,4,6
14594,Nemanja Bjelica,28-183,F,11/8/16,MIN,@,BRK,L,0,12,2,5,0.4,1,2,0.5,1,3,0.333,0,1,0,1,4,5
14595,Tarik Black,25-103,C-F,3/5/17,LAL,,NOP,L,1,17,2,8,0.25,2,8,0.25,0,0,,1,1,1,5,1,6
14596,Tarik Black,25-101,C-F,3/3/17,LAL,,BOS,L,1,18,1,4,0.25,1,4,0.25,0,0,,3,4,0.75,1,3,4
14597,Tarik Black,25-051,C-F,1/12/17,LAL,@,SAS,L,0,18,2,3,0.667,2,3,0.667,0,0,,1,2,0.5,2,1,3
14598,Tarik Black,25-111,C-F,3/13/17,LAL,@,DEN,L,0,14,2,5,0.4,2,5,0.4,0,0,,1,1,1,2,1,3
14599,Tarik Black,25-000,C-F,11/22/16,LAL,,OKC,W,0,16,2,3,0.667,2,3,0.667,0,0,,1,1,1,2,4,6
14600,Tarik Black,24-362,C-F,11/18/16,LAL,,SAS,L,0,12,2,4,0.5,2,4,0.5,0,0,,1,2,0.5,3,3,6
14601,Bojan Bogdanovic,27-280,G-F,1/23/17,BRK,,SAS,L,1,23,2,8,0.25,1,5,0.2,1,3,0.333,0,0,,0,3,3
14602,Bojan Bogdanovic,27-246,G-F,12/20/16,BRK,@,TOR,L,1,19,1,6,0.167,0,2,0,1,4,0.25,2,2,1,0,0,0
14603,Andrew Bogut,31-365,C,11/27/16,DAL,,NOP,W,1,29,1,3,0.333,1,3,0.333,0,0,,3,4,0.75,5,9,14
14604,Trevor Booker,28-341,F,10/31/16,BRK,,CHI,L,1,19,2,7,0.286,2,5,0.4,0,2,0,1,2,0.5,2,6,8
14605,Trevor Booker,29-023,F,12/18/16,BRK,@,PHI,L,1,31,2,7,0.286,2,6,0.333,0,1,0,1,2,0.5,1,5,6
14606,Trevor Booker,28-350,F,11/9/16,BRK,@,NYK,L,1,29,1,6,0.167,1,6,0.167,0,0,,3,4,0.75,1,5,6
14607,Avery Bradley,26-051,G,1/16/17,BOS,,CHO,W,1,33,2,9,0.222,1,3,0.333,1,6,0.167,0,0,,0,3,3
14608,Corey Brewer,30-341,F-G,2/9/17,HOU,@,CHO,W,0,25,1,4,0.25,0,0,,1,4,0.25,2,2,1,0,4,4
14609,Corey Brewer,30-332,F-G,1/31/17,HOU,,SAC,W,0,17,2,3,0.667,1,2,0.5,1,1,1,0,0,,0,2,2
14610,Corey Brewer,30-358,F-G,2/26/17,LAL,,SAS,L,0,13,1,3,0.333,0,2,0,1,1,1,2,2,1,1,1,2
14611,Corey Brewer,30-237,F-G,10/28/16,HOU,@,DAL,W,0,11,2,5,0.4,1,3,0.333,1,2,0.5,0,0,,0,2,2
14612,Malcolm Brogdon,24-004,G,12/15/16,MIL,,CHI,W,0,21,2,4,0.5,2,3,0.667,0,1,0,1,2,0.5,2,0,2
14613,Malcolm Brogdon,23-346,G,11/21/16,MIL,,ORL,W,0,21,1,6,0.167,1,3,0.333,0,3,0,3,3,1,1,1,2
14614,Malcolm Brogdon,23-344,G,11/19/16,MIL,,GSW,L,0,14,2,6,0.333,1,4,0.25,1,2,0.5,0,0,,0,4,4
14615,Malcolm Brogdon,23-358,G,12/3/16,MIL,,BRK,W,0,21,2,8,0.25,2,6,0.333,0,2,0,1,1,1,0,2,2
14616,Aaron Brooks,32-021,G,2/4/17,IND,,DET,W,0,17,2,5,0.4,1,2,0.5,1,3,0.333,0,0,,0,1,1
14617,Aaron Brooks,31-330,G,12/9/16,IND,@,DAL,L,0,15,1,3,0.333,0,1,0,1,2,0.5,2,2,1,1,2,3
14618,Aaron Brooks,32-020,G,2/3/17,IND,@,BRK,W,0,14,2,6,0.333,1,4,0.25,1,2,0.5,0,0,,0,0,0
14619,Aaron Brooks,32-064,G,3/19/17,IND,@,TOR,L,0,10,2,5,0.4,1,4,0.25,1,1,1,0,0,,0,1,1
14620,Aaron Brooks,31-316,G,11/25/16,IND,,BRK,W,0,21,2,7,0.286,1,2,0.5,1,5,0.2,0,0,,0,1,1
14621,Aaron Brooks,31-333,G,12/12/16,IND,,CHO,W,0,13,2,5,0.4,1,1,1,1,4,0.25,0,0,,1,2,3
14622,Jaylen Brown,20-060,F,12/23/16,BOS,,OKC,L,0,13,2,5,0.4,2,5,0.4,0,0,,1,1,1,2,1,3
14623,Jaylen Brown,20-026,F,11/19/16,BOS,@,DET,W,0,8,1,2,0.5,0,1,0,1,1,1,2,2,1,0,0,0
14624,Jaylen Brown,20-142,F,3/15/17,BOS,,MIN,W,0,17,2,5,0.4,1,3,0.333,1,2,0.5,0,0,,0,5,5
14625,Nicolas Brussino,23-341,G-F,2/6/17,DAL,@,DEN,L,0,3,2,2,1,1,1,1,1,1,1,0,2,0,0,0,0
14626,Nicolas Brussino,23-262,G-F,11/19/16,DAL,@,ORL,L,0,5,2,3,0.667,1,2,0.5,1,1,1,0,0,,0,1,1
14627,Nicolas Brussino,23-261,G-F,11/18/16,DAL,,MEM,L,0,14,1,3,0.333,0,0,,1,3,0.333,2,2,1,1,3,4
14628,Nicolas Brussino,23-257,G-F,11/14/16,DAL,@,NYK,L,0,8,2,3,0.667,1,1,1,1,2,0.5,0,0,,0,2,2
14629,Reggie Bullock,25-248,G-F,11/19/16,DET,,BOS,L,0,20,2,5,0.4,1,3,0.333,1,2,0.5,0,0,,1,2,3
14630,Reggie Bullock,25-247,G-F,11/18/16,DET,@,CLE,L,0,8,2,4,0.5,1,1,1,1,3,0.333,0,0,,0,0,0
14631,Trey Burke,24-067,G,1/18/17,WAS,,MEM,W,0,8,2,3,0.667,2,3,0.667,0,0,,1,1,1,0,2,2
14632,Trey Burke,24-082,G,2/2/17,WAS,,LAL,W,0,12,2,8,0.25,2,7,0.286,0,1,0,1,2,0.5,0,1,1
14633,Trey Burke,24-104,G,2/24/17,WAS,@,PHI,L,0,10,1,4,0.25,0,2,0,1,2,0.5,2,2,1,0,0,0
14634,Trey Burke,24-078,G,1/29/17,WAS,@,NOP,W,0,11,2,5,0.4,1,3,0.333,1,2,0.5,0,0,,0,0,0
14635,Trey Burke,24-028,G,12/10/16,WAS,,MIL,W,0,9,2,5,0.4,1,3,0.333,1,2,0.5,0,0,,0,0,0
14636,Alec Burks,25-238,G,3/15/17,UTA,@,DET,W,0,13,2,8,0.25,2,5,0.4,0,3,0,1,1,1,0,3,3
14637,Alec Burks,25-210,G,2/15/17,UTA,,POR,W,0,16,2,6,0.333,1,5,0.2,1,1,1,0,0,,0,2,2
14638,Jimmy Butler,27-179,G-F,3/12/17,CHI,@,BOS,L,1,32,2,11,0.182,1,9,0.111,1,2,0.5,0,0,,2,5,7
14639,Jose Calderon,35-065,G,12/2/16,LAL,@,TOR,L,1,18,2,7,0.286,1,5,0.2,1,2,0.5,0,0,,1,4,5
14640,Jose Calderon,35-108,G,1/14/17,LAL,@,LAC,L,0,7,2,3,0.667,1,1,1,1,2,0.5,0,0,,0,0,0
14641,Jose Calderon,35-051,G,11/18/16,LAL,,SAS,L,1,13,2,5,0.4,1,3,0.333,1,2,0.5,0,0,,1,0,1
14642,Kentavious Caldwell-Pope,23-345,G,1/28/17,DET,@,MIA,L,1,34,2,11,0.182,1,7,0.143,1,4,0.25,0,0,,0,0,0
14643,Kentavious Caldwell-Pope,23-253,G,10/28/16,DET,,ORL,W,1,24,2,5,0.4,2,2,1,0,3,0,1,1,1,0,1,1
14644,Kentavious Caldwell-Pope,24-011,G,3/1/17,DET,@,NOP,L,1,33,2,11,0.182,1,5,0.2,1,6,0.167,0,0,,2,1,3
14645,Isaiah Canaan,25-233,G,1/9/17,CHI,,OKC,L,0,8,1,3,0.333,0,2,0,1,1,1,2,2,1,1,0,1
14646,Isaiah Canaan,25-193,G,11/30/16,CHI,,LAL,L,0,26,2,9,0.222,1,4,0.25,1,5,0.2,0,0,,1,0,1
14647,Isaiah Canaan,25-267,G,2/12/17,CHI,@,MIN,L,0,19,1,6,0.167,0,3,0,1,3,0.333,2,2,1,0,0,0
14648,Clint Capela,22-248,F-C,1/21/17,HOU,@,MEM,W,0,16,2,4,0.5,2,4,0.5,0,0,,1,2,0.5,2,2,4
14649,Clint Capela,22-245,F-C,1/18/17,HOU,,MIL,W,0,11,2,3,0.667,2,3,0.667,0,0,,1,2,0.5,1,2,3
14650,DeMarre Carroll,30-214,F,2/26/17,TOR,,POR,W,1,32,1,5,0.2,0,2,0,1,3,0.333,2,4,0.5,0,4,4
14651,DeMarre Carroll,30-158,F,1/1/17,TOR,@,LAL,W,1,17,1,2,0.5,0,0,,1,2,0.5,2,2,1,0,0,0
14652,Vince Carter,39-330,G-F,12/21/16,MEM,@,DET,W,0,16,2,4,0.5,1,1,1,1,3,0.333,0,0,,0,0,0
14653,Vince Carter,39-283,G-F,11/4/16,MEM,,LAC,L,0,23,2,7,0.286,1,4,0.25,1,3,0.333,0,0,,1,6,7
14654,Vince Carter,39-280,G-F,11/1/16,MEM,@,MIN,L,0,14,2,7,0.286,1,2,0.5,1,5,0.2,0,0,,0,4,4
14655,Vince Carter,39-336,G-F,12/27/16,MEM,@,BOS,L,0,23,2,10,0.2,1,4,0.25,1,6,0.167,0,2,0,0,3,3
14656,Vince Carter,40-004,G-F,1/30/17,MEM,@,PHO,W,0,28,1,6,0.167,0,4,0,1,2,0.5,2,2,1,1,4,5
14657,Vince Carter,40-020,G-F,2/15/17,MEM,,NOP,L,0,25,1,7,0.143,0,2,0,1,5,0.2,2,4,0.5,0,3,3
14658,Vince Carter,39-277,G-F,10/29/16,MEM,@,NYK,L,0,25,2,4,0.5,1,1,1,1,3,0.333,0,0,,1,2,3
14659,Michael Carter-Williams,25-089,G,1/7/17,CHI,,TOR,W,1,16,2,4,0.5,1,2,0.5,1,2,0.5,0,0,,1,4,5
14660,Michael Carter-Williams,25-017,G,10/27/16,CHI,,BOS,W,0,17,2,6,0.333,1,5,0.2,1,1,1,0,0,,3,3,6
14661,Omri Casspi,28-272,F,3/21/17,MIN,,SAS,L,0,22,2,2,1,1,1,1,1,1,1,0,0,,0,1,1
14662,Willie Cauley-Stein,23-125,F-C,12/21/16,SAC,@,UTA,W,0,19,2,4,0.5,2,4,0.5,0,0,,1,2,0.5,0,5,5
14663,Willie Cauley-Stein,23-156,F-C,1/21/17,SAC,@,CHI,L,0,13,2,3,0.667,2,3,0.667,0,0,,1,2,0.5,2,2,4
14664,Tyson Chandler,34-125,C,2/4/17,PHO,,MIL,L,1,25,1,1,1,1,1,1,0,0,,3,4,0.75,3,11,14
14665,Tyson Chandler,34-026,C,10/28/16,PHO,@,OKC,L,1,38,2,3,0.667,2,3,0.667,0,0,,1,1,1,2,8,10
14666,Tyson Chandler,34-045,C,11/16/16,PHO,@,DEN,L,1,21,2,2,1,2,2,1,0,0,,1,2,0.5,0,5,5
14667,Tyson Chandler,34-129,C,2/8/17,PHO,@,MEM,L,1,20,1,4,0.25,1,4,0.25,0,0,,3,4,0.75,5,5,10
14668,Tyson Chandler,34-093,C,1/3/17,PHO,,MIA,W,1,32,2,4,0.5,2,4,0.5,0,0,,1,2,0.5,6,14,20
14669,Wilson Chandler,29-212,F,12/8/16,DEN,@,WAS,L,0,32,2,16,0.125,1,8,0.125,1,8,0.125,0,0,,2,6,8
14670,Marquese Chriss,19-208,F,1/26/17,PHO,@,DEN,L,1,8,2,3,0.667,1,1,1,1,2,0.5,0,0,,0,0,0
14671,Marquese Chriss,19-223,F,2/10/17,PHO,,CHI,W,1,22,2,3,0.667,1,2,0.5,1,1,1,0,0,,0,2,2
14672,Marquese Chriss,19-206,F,1/24/17,PHO,,MIN,L,1,12,2,5,0.4,1,3,0.333,1,2,0.5,0,0,,0,2,2
14673,Marquese Chriss,19-123,F,11/2/16,PHO,,POR,W,0,16,2,5,0.4,2,4,0.5,0,1,0,1,3,0.333,0,4,4
14674,Marquese Chriss,19-252,F,3/11/17,PHO,@,DAL,W,1,24,2,4,0.5,1,2,0.5,1,2,0.5,0,0,,0,8,8
14675,Marquese Chriss,19-198,F,1/16/17,PHO,,UTA,L,1,22,2,9,0.222,2,6,0.333,0,3,0,1,1,1,1,2,3
14676,Marquese Chriss,19-196,F,1/14/17,PHO,,SAS,W,1,15,2,6,0.333,1,2,0.5,1,4,0.25,0,0,,2,3,5
14677,Marquese Chriss,19-162,F,12/11/16,PHO,,NOP,L,1,17,1,5,0.2,1,2,0.5,0,3,0,3,6,0.5,0,5,5
14678,Rakeem Christmas,25-059,F,1/29/17,IND,,HOU,W,0,3,1,1,1,1,1,1,0,0,,3,4,0.75,1,1,2
14679,Semaj Christon,24-015,G,11/16/16,OKC,,HOU,W,0,14,2,4,0.5,1,3,0.333,1,1,1,0,0,,0,0,0
14680,Semaj Christon,23-364,G,10/30/16,OKC,,LAL,W,0,20,2,6,0.333,1,5,0.2,1,1,1,0,1,0,0,0,0
14681,Semaj Christon,24-092,G,2/1/17,OKC,,CHI,L,0,13,2,5,0.4,1,3,0.333,1,2,0.5,0,0,,1,2,3
14682,Ian Clark,25-338,G,2/8/17,GSW,,CHI,W,0,16,2,5,0.4,1,1,1,1,4,0.25,0,0,,0,1,1
14683,Ian Clark,25-357,G,2/27/17,GSW,@,PHI,W,0,8,2,2,1,1,1,1,1,1,1,0,0,,0,0,0
14684,Ian Clark,25-327,G,1/28/17,GSW,,LAC,W,0,12,2,5,0.4,1,2,0.5,1,3,0.333,0,0,,0,1,1
14685,Ian Clark,25-232,G,10/25/16,GSW,,SAS,L,0,13,2,8,0.25,2,4,0.5,0,4,0,1,2,0.5,0,0,0
14686,Ian Clark,26-013,G,3/20/17,GSW,@,OKC,W,0,18,2,4,0.5,2,3,0.667,0,1,0,1,2,0.5,0,0,0
14687,Ian Clark,25-303,G,1/4/17,GSW,,POR,W,0,12,2,5,0.4,1,2,0.5,1,3,0.333,0,0,,0,0,0
14688,Jordan Clarkson,24-166,G,11/20/16,LAL,,CHI,L,0,25,1,12,0.083,0,9,0,1,3,0.333,2,3,0.667,1,1,2
14689,Jordan Clarkson,24-201,G,12/25/16,LAL,,LAC,W,0,20,2,9,0.222,2,5,0.4,0,4,0,1,2,0.5,1,0,1
14690,Jordan Clarkson,24-287,G,3/21/17,LAL,,LAC,L,1,36,1,9,0.111,1,5,0.2,0,4,0,3,3,1,0,3,3
14691,Darren Collison,29-161,G,1/31/17,SAC,@,HOU,L,1,26,2,10,0.2,1,8,0.125,1,2,0.5,0,0,,1,1,2
14692,Darren Collison,29-197,G,3/8/17,SAC,@,SAS,L,1,24,2,9,0.222,2,7,0.286,0,2,0,1,1,1,1,4,5
14693,Nick Collison,36-064,F,12/29/16,OKC,@,MEM,L,0,8,2,3,0.667,2,3,0.667,0,0,,1,1,1,0,0,0
14694,Pat Connaughton,24-034,G,2/9/17,POR,,BOS,L,0,15,2,3,0.667,1,1,1,1,2,0.5,0,0,,1,0,1
14695,Pat Connaughton,24-025,G,1/31/17,POR,,CHO,W,0,4,2,2,1,1,1,1,1,1,1,0,0,,0,0,0
14696,Pat Connaughton,24-067,G,3/14/17,POR,@,NOP,L,0,12,2,4,0.5,1,3,0.333,1,1,1,0,0,,0,3,3
14697,Pat Connaughton,24-019,G,1/25/17,POR,,LAL,W,0,15,2,4,0.5,1,3,0.333,1,1,1,0,0,,0,1,1
14698,Pat Connaughton,23-346,G,12/17/16,POR,@,GSW,L,0,18,2,2,1,2,2,1,0,0,,1,1,1,1,3,4
14699,Quinn Cook,23-345,G,3/3/17,DAL,,MEM,W,0,15,2,5,0.4,1,1,1,1,4,0.25,0,0,,0,0,0
14700,Robert Covington,26-012,F,12/26/16,PHI,@,SAC,L,1,37,2,6,0.333,2,4,0.5,0,2,0,1,2,0.5,1,5,6
14701,Allen Crabbe,24-282,G-F,1/16/17,POR,@,WAS,L,0,25,2,6,0.333,1,3,0.333,1,3,0.333,0,1,0,1,2,3
14702,Allen Crabbe,24-300,G-F,2/3/17,POR,,DAL,L,0,23,1,4,0.25,0,3,0,1,1,1,2,2,1,0,0,0
14703,Allen Crabbe,24-312,G-F,2/15/17,POR,@,UTA,L,0,26,2,8,0.25,1,5,0.2,1,3,0.333,0,0,,0,1,1
14704,Allen Crabbe,24-213,G-F,11/8/16,POR,,PHO,W,0,32,2,6,0.333,1,3,0.333,1,3,0.333,0,1,0,0,1,1
14705,Allen Crabbe,24-222,G-F,11/17/16,POR,@,HOU,L,1,20,1,5,0.2,0,2,0,1,3,0.333,2,2,1,0,1,1
14706,Allen Crabbe,24-344,G-F,3/19/17,POR,@,MIA,W,0,30,2,9,0.222,1,5,0.2,1,4,0.25,0,0,,1,4,5
14707,Allen Crabbe,24-284,G-F,1/18/17,POR,@,CHO,L,0,18,2,7,0.286,1,4,0.25,1,3,0.333,0,0,,0,0,0
14708,Jamal Crawford,36-275,G,12/20/16,LAC,,DEN,W,0,19,2,4,0.5,1,2,0.5,1,2,0.5,0,0,,0,1,1
14709,Jamal Crawford,36-285,G,12/30/16,LAC,@,HOU,L,0,30,2,10,0.2,1,6,0.167,1,4,0.25,0,0,,0,1,1
14710,Jamal Crawford,36-314,G,1/28/17,LAC,@,GSW,L,0,30,2,7,0.286,1,4,0.25,1,3,0.333,0,0,,0,1,1
14711,Jamal Crawford,36-332,G,2/15/17,LAC,,ATL,W,0,27,1,7,0.143,0,1,0,1,6,0.167,2,2,1,0,2,2
14712,Jae Crowder,26-249,F,3/12/17,BOS,,CHI,W,1,25,2,9,0.222,1,4,0.25,1,5,0.2,0,0,,0,10,10
14713,Dante Cunningham,29-202,F,11/10/16,NOP,@,MIL,W,1,19,2,8,0.25,1,3,0.333,1,5,0.2,0,0,,0,4,4
14714,Dante Cunningham,29-258,F,1/5/17,NOP,,ATL,L,1,27,2,4,0.5,1,1,1,1,3,0.333,0,0,,0,5,5
14715,Dante Cunningham,29-288,F,2/4/17,NOP,@,WAS,L,0,19,2,3,0.667,2,3,0.667,0,0,,1,1,1,1,2,3
14716,Dante Cunningham,29-245,F,12/23/16,NOP,,MIA,W,1,34,2,8,0.25,1,5,0.2,1,3,0.333,0,0,,0,6,6
14717,Dante Cunningham,29-282,F,1/29/17,NOP,,WAS,L,1,21,2,4,0.5,1,1,1,1,3,0.333,0,0,,2,2,4
14718,Dante Cunningham,29-307,F,2/23/17,NOP,,HOU,L,0,25,2,3,0.667,1,1,1,1,2,0.5,0,0,,1,3,4
14719,Dante Cunningham,29-206,F,11/14/16,NOP,,BOS,W,1,23,2,4,0.5,1,1,1,1,3,0.333,0,0,,0,1,1
14720,Seth Curry,26-202,G,3/13/17,DAL,@,TOR,L,1,32,2,8,0.25,1,4,0.25,1,4,0.25,0,0,,0,3,3
14721,Troy Daniels,25-151,G,12/13/16,MEM,@,CLE,L,0,20,1,6,0.167,0,1,0,1,5,0.2,2,2,1,0,2,2
14722,Troy Daniels,25-148,G,12/10/16,MEM,,GSW,W,0,22,2,9,0.222,1,3,0.333,1,6,0.167,0,1,0,2,1,3
14723,Troy Daniels,25-161,G,12/23/16,MEM,,HOU,W,0,10,1,1,1,0,0,,1,1,1,2,3,0.667,0,1,1
14724,Troy Daniels,25-146,G,12/8/16,MEM,,POR,W,0,32,2,12,0.167,1,8,0.125,1,4,0.25,0,0,,0,2,2
14725,Troy Daniels,25-215,G,2/15/17,MEM,,NOP,L,0,10,1,3,0.333,0,0,,1,3,0.333,2,2,1,2,1,3
14726,Ed Davis,27-263,F,2/23/17,POR,@,ORL,W,0,13,1,3,0.333,1,3,0.333,0,0,,3,6,0.5,2,3,5
14727,Ed Davis,27-183,F,12/5/16,POR,@,CHI,W,1,30,2,3,0.667,2,3,0.667,0,0,,1,2,0.5,2,5,7
14728,Ed Davis,27-214,F,1/5/17,POR,,LAL,W,0,16,1,3,0.333,1,3,0.333,0,0,,3,4,0.75,3,5,8
14729,Ed Davis,27-243,F,2/3/17,POR,,DAL,L,0,16,2,2,1,2,2,1,0,0,,1,2,0.5,1,1,2
14730,Ed Davis,27-159,F,11/11/16,POR,,SAC,W,0,11,1,3,0.333,1,3,0.333,0,0,,3,4,0.75,1,1,2
14731,Dewayne Dedmon,27-158,C,1/17/17,SAS,,MIN,W,0,19,2,4,0.5,2,4,0.5,0,0,,1,2,0.5,2,6,8
14732,Dewayne Dedmon,27-078,C,10/29/16,SAS,,NOP,W,0,16,2,4,0.5,2,4,0.5,0,0,,1,2,0.5,1,5,6
14733,Dewayne Dedmon,27-120,C,12/10/16,SAS,,BRK,W,0,8,2,2,1,2,2,1,0,0,,1,1,1,0,6,6
14734,Dewayne Dedmon,27-138,C,12/28/16,SAS,,PHO,W,0,15,2,4,0.5,2,4,0.5,0,0,,1,2,0.5,1,3,4
14735,Dewayne Dedmon,27-151,C,1/10/17,SAS,,MIL,L,0,20,2,6,0.333,2,6,0.333,0,0,,1,2,0.5,4,3,7
14736,Dewayne Dedmon,27-116,C,12/6/16,SAS,@,MIN,W,0,24,2,2,1,2,2,1,0,0,,1,2,0.5,1,7,8
14737,Sam Dekker,22-224,F,12/16/16,HOU,,NOP,W,0,23,1,8,0.125,0,3,0,1,5,0.2,2,2,1,0,4,4
14738,Sam Dekker,22-220,F,12/12/16,HOU,,BRK,W,0,15,2,5,0.4,1,2,0.5,1,3,0.333,0,0,,0,3,3
14739,Sam Dekker,22-190,F,11/12/16,HOU,,SAS,L,0,11,2,3,0.667,1,1,1,1,2,0.5,0,0,,0,1,1
14740,Sam Dekker,22-249,F,1/10/17,HOU,,CHO,W,0,21,2,5,0.4,1,3,0.333,1,2,0.5,0,0,,0,1,1
14741,Sam Dekker,22-231,F,12/23/16,HOU,@,MEM,L,0,17,2,6,0.333,1,3,0.333,1,3,0.333,0,0,,1,0,1
14742,Sam Dekker,22-185,F,11/7/16,HOU,@,WAS,W,0,14,2,3,0.667,1,1,1,1,2,0.5,0,0,,1,3,4
14743,Sam Dekker,22-318,F,3/20/17,HOU,,DEN,W,0,5,2,3,0.667,2,3,0.667,0,0,,1,2,0.5,0,0,0
14744,Sam Dekker,22-213,F,12/5/16,HOU,,BOS,W,0,18,2,5,0.4,1,3,0.333,1,2,0.5,0,0,,1,3,4
14745,Sam Dekker,22-257,F,1/18/17,HOU,,MIL,W,0,25,2,9,0.222,2,7,0.286,0,2,0,1,2,0.5,3,2,5
14746,Sam Dekker,22-180,F,11/2/16,HOU,@,NYK,W,0,19,2,5,0.4,2,4,0.5,0,1,0,1,2,0.5,2,5,7
14747,Malcolm Delaney,27-353,G,2/27/17,ATL,@,BOS,W,0,18,2,4,0.5,2,4,0.5,0,0,,1,1,1,0,1,1
14748,Malcolm Delaney,27-350,G,2/24/17,ATL,,MIA,L,1,23,2,10,0.2,2,8,0.25,0,2,0,1,2,0.5,2,1,3
14749,Malcolm Delaney,27-311,G,1/16/17,ATL,@,NYK,W,0,19,2,4,0.5,1,3,0.333,1,1,1,0,0,,0,1,1
14750,Malcolm Delaney,27-318,G,1/23/17,ATL,,LAC,L,0,19,2,5,0.4,1,3,0.333,1,2,0.5,0,0,,0,2,2
14751,Matthew Dellavedova,26-191,G,3/18/17,MIL,@,GSW,L,0,26,2,7,0.286,1,4,0.25,1,3,0.333,0,0,,0,0,0
14752,Matthew Dellavedova,26-155,G,2/10/17,MIL,,LAL,L,1,18,2,5,0.4,2,3,0.667,0,2,0,1,1,1,0,1,1
14753,Matthew Dellavedova,26-190,G,3/17/17,MIL,@,LAL,W,0,25,1,7,0.143,1,4,0.25,0,3,0,3,3,1,1,1,2
14754,Matthew Dellavedova,26-153,G,2/8/17,MIL,,MIA,L,1,15,2,6,0.333,1,4,0.25,1,2,0.5,0,0,,0,1,1
14755,Matthew Dellavedova,26-056,G,11/3/16,MIL,,IND,W,1,24,2,6,0.333,2,3,0.667,0,3,0,1,1,1,0,2,2
14756,Matthew Dellavedova,26-106,G,12/23/16,MIL,,WAS,W,1,22,2,6,0.333,1,2,0.5,1,4,0.25,0,0,,0,0,0
14757,Matthew Dellavedova,26-132,G,1/18/17,MIL,@,HOU,L,0,17,2,6,0.333,1,2,0.5,1,4,0.25,0,0,,0,0,0
14758,Matthew Dellavedova,26-146,G,2/1/17,MIL,@,UTA,L,1,26,2,6,0.333,1,3,0.333,1,3,0.333,0,0,,0,1,1
14759,Luol Deng,31-233,F,12/5/16,LAL,,UTA,L,1,27,2,7,0.286,2,6,0.333,0,1,0,1,1,1,2,0,2
14760,Luol Deng,31-227,F,11/29/16,LAL,@,NOP,L,1,22,2,6,0.333,1,2,0.5,1,4,0.25,0,0,,0,2,2
14761,Boris Diaw,34-331,F-C,3/13/17,UTA,,LAC,W,1,21,2,3,0.667,1,2,0.5,1,1,1,0,0,,1,2,3
14762,Boris Diaw,34-316,F-C,2/26/17,UTA,@,WAS,W,0,13,2,4,0.5,2,4,0.5,0,0,,1,1,1,0,0,0
14763,Gorgui Dieng,27-012,C,1/30/17,MIN,,ORL,W,1,33,2,7,0.286,1,5,0.2,1,2,0.5,0,0,,4,10,14
14764,Spencer Dinwiddie,23-286,G,1/17/17,BRK,,TOR,L,1,24,1,3,0.333,1,3,0.333,0,0,,3,4,0.75,0,1,1
14765,Spencer Dinwiddie,23-331,G,3/3/17,BRK,@,UTA,L,0,21,2,5,0.4,2,4,0.5,0,1,0,1,2,0.5,0,3,3
14766,Goran Dragic,30-237,G,12/29/16,MIA,@,CHO,L,1,32,2,11,0.182,2,7,0.286,0,4,0,1,2,0.5,0,3,3
14767,Jared Dudley,31-218,F-G,2/13/17,PHO,,NOP,L,0,12,2,4,0.5,1,2,0.5,1,2,0.5,0,0,,0,0,0
14768,Jared Dudley,31-117,F-G,11/4/16,PHO,@,NOP,W,1,20,2,4,0.5,1,1,1,1,3,0.333,0,0,,0,2,2
14769,Jared Dudley,31-213,F-G,2/8/17,PHO,@,MEM,L,0,17,2,5,0.4,2,3,0.667,0,2,0,1,2,0.5,2,4,6
14770,Jared Dudley,31-235,F-G,3/2/17,PHO,,CHO,W,0,27,2,7,0.286,1,2,0.5,1,5,0.2,0,0,,0,1,1
14771,Jared Dudley,31-113,F-G,10/31/16,PHO,@,LAC,L,1,19,2,6,0.333,1,3,0.333,1,3,0.333,0,0,,1,4,5
14772,Jared Dudley,31-136,F-G,11/23/16,PHO,@,ORL,W,0,26,1,4,0.25,0,0,,1,4,0.25,2,2,1,0,4,4
14773,Mike Dunleavy,36-085,F-G,12/9/16,CLE,,MIA,W,0,22,1,3,0.333,0,1,0,1,2,0.5,2,2,1,0,2,2
14774,Mike Dunleavy,36-075,F-G,11/29/16,CLE,@,MIL,L,0,12,2,4,0.5,1,1,1,1,3,0.333,0,0,,0,1,1
14775,Mike Dunleavy,36-130,F-G,1/23/17,ATL,,LAC,L,0,17,2,2,1,1,1,1,1,1,1,0,0,,0,1,1
14776,Mike Dunleavy,36-142,F-G,2/4/17,ATL,,ORL,W,0,16,2,6,0.333,1,2,0.5,1,4,0.25,0,0,,0,3,3
14777,Mike Dunleavy,36-071,F-G,11/25/16,CLE,,DAL,W,0,14,1,3,0.333,0,0,,1,3,0.333,2,2,1,0,0,0
14778,Mike Dunleavy,36-097,F-G,12/21/16,CLE,,MIL,W,0,13,2,4,0.5,1,2,0.5,1,2,0.5,0,0,,1,1,2
14779,Mike Dunleavy,36-064,F-G,11/18/16,CLE,,DET,W,0,19,2,3,0.667,1,1,1,1,2,0.5,0,0,,0,5,5
14780,Mike Dunleavy,36-061,F-G,11/15/16,CLE,,TOR,W,0,19,2,3,0.667,1,1,1,1,2,0.5,0,0,,0,2,2
14781,Kris Dunn,22-307,G,1/19/17,MIN,@,LAC,W,0,25,2,4,0.5,2,3,0.667,0,1,0,1,2,0.5,1,3,4
14782,Kris Dunn,23-003,G,3/21/17,MIN,,SAS,L,0,24,2,3,0.667,1,1,1,1,2,0.5,0,0,,0,2,2
14783,Kris Dunn,22-240,G,11/13/16,MIN,,LAL,W,0,14,1,2,0.5,1,2,0.5,0,0,,3,5,0.6,0,2,2
14784,Kris Dunn,22-268,G,12/11/16,MIN,,GSW,L,0,16,2,4,0.5,2,4,0.5,0,0,,1,2,0.5,0,2,2
14785,Wayne Ellington,29-109,G,2/15/17,MIA,@,HOU,W,0,15,2,5,0.4,1,2,0.5,1,3,0.333,0,0,,1,0,1
14786,Monta Ellis,31-026,G,11/21/16,IND,,GSW,L,1,23,2,8,0.25,1,5,0.2,1,3,0.333,0,0,,0,2,2
14787,Monta Ellis,31-042,G,12/7/16,IND,@,PHO,W,1,22,1,4,0.25,0,2,0,1,2,0.5,2,2,1,0,4,4
14788,Monta Ellis,31-032,G,11/27/16,IND,,LAC,W,1,35,2,12,0.167,1,8,0.125,1,4,0.25,0,0,,0,6,6
14789,James Ennis,26-253,F,3/11/17,MEM,,ATL,L,1,18,2,7,0.286,2,4,0.5,0,3,0,1,2,0.5,0,3,3
14790,James Ennis,26-173,F,12/21/16,MEM,@,DET,W,0,18,2,4,0.5,1,3,0.333,1,1,1,0,0,,0,5,5
14791,James Ennis,26-172,F,12/20/16,MEM,,BOS,L,1,18,2,4,0.5,2,4,0.5,0,0,,1,1,1,2,0,2
14792,James Ennis,26-170,F,12/18/16,MEM,,UTA,L,0,16,1,3,0.333,1,3,0.333,0,0,,3,4,0.75,1,3,4
14793,James Ennis,26-217,F,2/3/17,MEM,@,OKC,L,0,23,2,5,0.4,1,3,0.333,1,2,0.5,0,0,,2,1,3
14794,James Ennis,26-181,F,12/29/16,MEM,,OKC,W,0,24,1,2,0.5,0,1,0,1,1,1,2,2,1,0,1,1
14795,James Ennis,26-257,F,3/15/17,MEM,@,CHI,W,0,24,1,3,0.333,1,1,1,0,2,0,3,4,0.75,1,3,4
14796,James Ennis,26-123,F,11/1/16,MEM,@,MIN,L,1,21,2,5,0.4,1,3,0.333,1,2,0.5,0,0,,0,4,4
14797,James Ennis,26-140,F,11/18/16,MEM,@,DAL,W,1,30,2,5,0.4,1,3,0.333,1,2,0.5,0,0,,1,5,6
14798,James Ennis,26-227,F,2/13/17,MEM,@,BRK,W,1,28,2,2,1,1,1,1,1,1,1,0,0,,0,3,3
14799,Tyler Ennis,22-209,G,3/21/17,LAL,,LAC,L,0,8,1,5,0.2,1,3,0.333,0,2,0,3,3,1,0,1,1
14800,Tyler Ennis,22-186,G,2/26/17,LAL,,SAS,L,0,8,2,3,0.667,1,1,1,1,2,0.5,0,0,,1,0,1
14801,Dante Exum,21-211,G,2/9/17,UTA,@,DAL,L,1,18,2,3,0.667,1,1,1,1,2,0.5,0,0,,0,0,0
14802,Dante Exum,21-141,G,12/1/16,UTA,,MIA,L,1,18,1,6,0.167,0,2,0,1,4,0.25,2,2,1,1,1,2
14803,Dante Exum,21-238,G,3/8/17,UTA,@,HOU,W,1,9,1,2,0.5,1,1,1,0,1,0,3,3,1,0,1,1
14804,Dante Exum,21-104,G,10/25/16,UTA,@,POR,L,0,8,2,4,0.5,2,3,0.667,0,1,0,1,1,1,1,1,2
14805,Dante Exum,21-150,G,12/10/16,UTA,,SAC,W,1,22,2,5,0.4,1,4,0.25,1,1,1,0,0,,0,2,2
14806,Kenneth Faried,26-355,F,11/8/16,DEN,@,MEM,L,0,28,2,4,0.5,2,3,0.667,0,1,0,1,2,0.5,2,9,11
14807,Kenneth Faried,27-003,F,11/22/16,DEN,,CHI,W,1,15,2,4,0.5,2,4,0.5,0,0,,1,2,0.5,1,3,4
14808,Kenneth Faried,27-061,F,1/19/17,DEN,@,SAS,L,1,25,2,7,0.286,2,7,0.286,0,0,,1,2,0.5,3,6,9
14809,Kenneth Faried,27-001,F,11/20/16,DEN,,UTA,W,1,25,2,6,0.333,2,6,0.333,0,0,,1,3,0.333,2,4,6
14810,Kenneth Faried,27-121,F,3/20/17,DEN,@,HOU,L,0,10,2,6,0.333,2,6,0.333,0,0,,1,1,1,3,0,3
14811,Derrick Favors,25-156,F-C,12/18/16,UTA,@,MEM,W,0,14,2,4,0.5,2,4,0.5,0,0,,1,2,0.5,0,1,1
14812,Derrick Favors,25-189,F-C,1/20/17,UTA,@,DAL,W,1,26,2,5,0.4,2,5,0.4,0,0,,1,2,0.5,1,3,4
14813,Derrick Favors,25-107,F-C,10/30/16,UTA,@,LAC,L,0,23,1,8,0.125,1,8,0.125,0,0,,3,4,0.75,1,10,11
14814,Kay Felder,21-241,G,11/25/16,CLE,,DAL,W,0,14,2,4,0.5,2,4,0.5,0,0,,1,2,0.5,0,1,1
14815,Cristiano Felicio,24-177,F-C,12/31/16,CHI,,MIL,L,0,17,2,3,0.667,2,3,0.667,0,0,,1,2,0.5,1,3,4
14816,Cristiano Felicio,24-232,F-C,2/24/17,CHI,,PHO,W,0,17,2,4,0.5,2,4,0.5,0,0,,1,2,0.5,2,4,6
14817,Cristiano Felicio,24-257,F-C,3/21/17,CHI,@,TOR,L,0,16,2,3,0.667,2,3,0.667,0,0,,1,2,0.5,2,0,2
14818,Cristiano Felicio,24-184,F-C,1/7/17,CHI,,TOR,W,0,26,2,5,0.4,2,5,0.4,0,0,,1,1,1,5,3,8
14819,Raymond Felton,32-132,G,11/5/16,LAC,@,SAS,W,0,19,2,3,0.667,1,2,0.5,1,1,1,0,0,,0,1,1
14820,Raymond Felton,32-194,G,1/6/17,LAC,@,SAC,W,0,21,2,6,0.333,1,5,0.2,1,1,1,0,0,,0,3,3
14821,Yogi Ferrell,23-308,G,3/13/17,DAL,@,TOR,L,1,31,1,7,0.143,1,3,0.333,0,4,0,3,4,0.75,0,3,3
14822,Yogi Ferrell,23-291,G,2/24/17,DAL,@,MIN,L,1,30,2,9,0.222,1,3,0.333,1,6,0.167,0,1,0,0,3,3
14823,Yogi Ferrell,23-282,G,2/15/17,DAL,@,DET,L,0,20,2,8,0.25,1,5,0.2,1,3,0.333,0,0,,1,4,5
14824,Yogi Ferrell,23-184,G,11/9/16,BRK,@,NYK,L,0,14,2,3,0.667,1,2,0.5,1,1,1,0,0,,0,1,1
14825,Yogi Ferrell,23-202,G,11/27/16,BRK,,SAC,L,0,17,2,6,0.333,1,2,0.5,1,4,0.25,0,0,,1,0,1
14826,Dorian Finney-Smith,23-270,F,1/29/17,DAL,@,SAS,W,0,17,2,5,0.4,2,3,0.667,0,2,0,1,1,1,0,2,2
14827,Dorian Finney-Smith,23-188,F,11/8/16,DAL,@,LAL,W,1,20,2,2,1,1,1,1,1,1,1,0,0,,0,3,3
14828,Dorian Finney-Smith,23-186,F,11/6/16,DAL,,MIL,W,0,32,1,6,0.167,0,1,0,1,5,0.2,2,2,1,2,1,3
14829,Dorian Finney-Smith,23-305,F,3/5/17,DAL,,OKC,W,0,16,2,3,0.667,1,1,1,1,2,0.5,0,0,,0,4,4
14830,Dorian Finney-Smith,23-303,F,3/3/17,DAL,,MEM,W,0,28,2,6,0.333,2,3,0.667,0,3,0,1,2,0.5,2,3,5
14831,Dorian Finney-Smith,23-279,F,2/7/17,DAL,,POR,L,0,17,1,3,0.333,0,0,,1,3,0.333,2,2,1,0,2,2
14832,Dorian Finney-Smith,23-301,F,3/1/17,DAL,@,ATL,L,1,24,2,8,0.25,1,3,0.333,1,5,0.2,0,0,,1,1,2
14833,Dorian Finney-Smith,23-229,F,12/19/16,DAL,@,DEN,L,1,26,2,4,0.5,1,2,0.5,1,2,0.5,0,0,,0,4,4
14834,Dorian Finney-Smith,23-198,F,11/18/16,DAL,,MEM,L,1,22,2,6,0.333,2,3,0.667,0,3,0,1,1,1,0,3,3
14835,Dorian Finney-Smith,23-196,F,11/16/16,DAL,@,BOS,L,1,16,2,5,0.4,1,3,0.333,1,2,0.5,0,0,,2,1,3
14836,Dorian Finney-Smith,23-273,F,2/1/17,DAL,,PHI,W,0,18,1,1,1,1,1,1,0,0,,3,4,0.75,0,1,1
14837,Dorian Finney-Smith,23-207,F,11/27/16,DAL,,NOP,W,1,25,2,7,0.286,1,2,0.5,1,5,0.2,0,0,,2,2,4
14838,Bryn Forbes,23-233,G,3/13/17,SAS,,ATL,W,0,11,2,3,0.667,1,1,1,1,2,0.5,0,0,,0,1,1
14839,Bryn Forbes,23-105,G,11/5/16,SAS,,LAC,L,0,14,2,4,0.5,2,2,1,0,2,0,1,1,1,0,1,1
14840,Evan Fournier,24-036,G-F,12/4/16,ORL,@,DET,W,1,32,1,7,0.143,0,4,0,1,3,0.333,2,2,1,0,1,1
14841,Randy Foye,33-153,G,2/24/17,BRK,@,DEN,L,1,19,2,4,0.5,1,1,1,1,3,0.333,0,0,,0,2,2
14842,Randy Foye,33-128,G,1/30/17,BRK,@,MIA,L,1,21,2,7,0.286,1,2,0.5,1,5,0.2,0,0,,2,2,4
14843,Randy Foye,33-142,G,2/13/17,BRK,,MEM,L,1,16,2,4,0.5,1,2,0.5,1,2,0.5,0,0,,0,1,1
14844,Randy Foye,33-046,G,11/9/16,BRK,@,NYK,L,0,15,2,6,0.333,1,2,0.5,1,4,0.25,0,0,,0,0,0
14845,Randy Foye,33-126,G,1/28/17,BRK,@,MIN,L,1,17,2,6,0.333,1,3,0.333,1,3,0.333,0,0,,0,2,2
14846,Randy Foye,33-087,G,12/20/16,BRK,@,TOR,L,0,7,1,1,1,0,0,,1,1,1,2,2,1,0,1,1
14847,Randy Foye,33-057,G,11/20/16,BRK,,POR,L,0,13,1,6,0.167,0,2,0,1,4,0.25,2,2,1,0,3,3
14848,Randy Foye,33-052,G,11/15/16,BRK,@,LAL,L,0,19,2,6,0.333,1,2,0.5,1,4,0.25,0,0,,0,2,2
14849,Randy Foye,33-070,G,12/3/16,BRK,@,MIL,L,0,20,2,5,0.4,1,1,1,1,4,0.25,0,0,,0,2,2
14850,Tim Frazier,25-363,G,10/29/16,NOP,@,SAS,L,1,25,2,8,0.25,1,6,0.167,1,2,0.5,0,0,,0,4,4
14851,Tim Frazier,26-007,G,11/8/16,NOP,@,SAC,L,1,32,2,8,0.25,1,7,0.143,1,1,1,0,0,,1,4,5
14852,Tim Frazier,26-120,G,3/1/17,NOP,,DET,W,0,13,2,3,0.667,2,3,0.667,0,0,,1,2,0.5,1,2,3
14853,Tim Frazier,26-134,G,3/15/17,NOP,@,MIA,L,0,17,2,3,0.667,1,1,1,1,2,0.5,0,0,,1,0,1
14854,Channing Frye,33-267,C-F,2/8/17,CLE,@,IND,W,0,12,2,7,0.286,1,4,0.25,1,3,0.333,0,0,,0,5,5
14855,Channing Frye,33-198,C-F,12/1/16,CLE,,LAC,L,0,15,0,2,0,0,1,0,0,1,0,5,6,0.833,0,5,5
14856,Channing Frye,33-234,C-F,1/6/17,CLE,@,BRK,W,0,25,2,6,0.333,1,2,0.5,1,4,0.25,0,0,,0,5,5
14857,Channing Frye,33-265,C-F,2/6/17,CLE,@,WAS,W,0,12,2,4,0.5,1,1,1,1,3,0.333,0,0,,0,4,4
14858,Channing Frye,33-228,C-F,12/31/16,CLE,@,CHO,W,0,17,1,3,0.333,0,1,0,1,2,0.5,2,2,1,0,3,3
14859,Channing Frye,33-293,C-F,3/6/17,CLE,,MIA,L,0,14,1,3,0.333,0,1,0,1,2,0.5,2,4,0.5,0,3,3
14860,Channing Frye,33-255,C-F,1/27/17,CLE,,BRK,W,0,18,2,7,0.286,1,2,0.5,1,5,0.2,0,0,,3,5,8
14861,Channing Frye,33-238,C-F,1/10/17,CLE,@,UTA,L,0,19,1,6,0.167,1,3,0.333,0,3,0,3,3,1,1,2,3
14862,Danilo Gallinari,28-121,F,12/7/16,DEN,@,BRK,L,1,23,2,7,0.286,1,6,0.167,1,1,1,0,0,,0,3,3
14863,Langston Galloway,24-349,G,11/22/16,NOP,@,ATL,W,0,19,2,5,0.4,1,2,0.5,1,3,0.333,0,0,,0,3,3
14864,Langston Galloway,25-031,G,1/9/17,NOP,@,NYK,W,0,19,2,8,0.25,1,4,0.25,1,4,0.25,0,0,,0,0,0
14865,Langston Galloway,24-345,G,11/18/16,NOP,,POR,W,0,20,2,8,0.25,1,5,0.2,1,3,0.333,0,0,,0,1,1
14866,Langston Galloway,25-006,G,12/15/16,NOP,,IND,W,0,20,2,10,0.2,1,3,0.333,1,7,0.143,0,0,,0,1,1
14867,Langston Galloway,24-322,G,10/26/16,NOP,,DEN,L,0,11,2,5,0.4,2,4,0.5,0,1,0,1,1,1,0,2,2
14868,Langston Galloway,24-337,G,11/10/16,NOP,@,MIL,W,0,14,2,7,0.286,1,5,0.2,1,2,0.5,0,0,,0,5,5
14869,Pau Gasol,36-185,F-C,1/7/17,SAS,,CHO,W,1,20,2,7,0.286,1,5,0.2,1,2,0.5,0,0,,1,4,5
14870,Pau Gasol,36-181,F-C,1/3/17,SAS,,TOR,W,1,19,1,6,0.167,1,6,0.167,0,0,,3,4,0.75,0,4,4
14871,Manu Ginobili,39-118,G,11/23/16,SAS,@,CHO,W,0,16,1,6,0.167,0,3,0,1,3,0.333,2,2,1,0,3,3
14872,Manu Ginobili,39-218,G,3/3/17,SAS,@,NOP,W,0,21,2,5,0.4,2,2,1,0,3,0,1,1,1,0,3,3
14873,Manu Ginobili,39-233,G,3/18/17,SAS,@,MEM,L,0,16,2,5,0.4,1,2,0.5,1,3,0.333,0,0,,0,0,0
14874,Rudy Gobert,24-196,C,1/8/17,UTA,@,MEM,L,1,36,1,3,0.333,1,3,0.333,0,0,,3,6,0.5,7,5,12
14875,Rudy Gobert,24-131,C,11/4/16,UTA,,SAS,L,1,29,2,2,1,2,2,1,0,0,,1,4,0.25,2,6,8
14876,Aaron Gordon,21-082,F,12/7/16,ORL,,BOS,L,1,26,2,9,0.222,1,6,0.167,1,3,0.333,0,2,0,0,3,3
14877,Aaron Gordon,21-066,F,11/21/16,ORL,@,MIL,L,0,21,1,5,0.2,1,2,0.5,0,3,0,3,6,0.5,0,4,4
14878,Aaron Gordon,21-064,F,11/19/16,ORL,,DAL,W,0,25,2,5,0.4,1,3,0.333,1,2,0.5,0,0,,1,3,4
14879,Treveon Graham,23-095,G,2/1/17,CHO,@,GSW,L,0,6,1,3,0.333,0,2,0,1,1,1,2,2,1,0,1,1
14880,Jerami Grant,23-004,F,3/16/17,OKC,@,TOR,W,0,7,2,2,1,1,1,1,1,1,1,0,0,,0,0,0
14881,Jerami Grant,22-294,F,12/31/16,OKC,,LAC,W,0,17,2,2,1,1,1,1,1,1,1,0,0,,0,1,1
14882,Jerami Grant,22-244,F,11/11/16,OKC,,LAC,L,0,13,2,3,0.667,1,2,0.5,1,1,1,0,0,,0,2,2
14883,Jerian Grant,24-057,G,12/5/16,CHI,,POR,L,1,23,1,7,0.143,0,3,0,1,4,0.25,2,2,1,0,3,3
14884,Jerian Grant,24-077,G,12/25/16,CHI,@,SAS,L,0,18,2,6,0.333,1,3,0.333,1,3,0.333,0,0,,0,1,1
14885,Jerian Grant,24-112,G,1/29/17,CHI,,PHI,W,1,17,2,4,0.5,1,3,0.333,1,1,1,0,0,,0,0,0
14886,Jerian Grant,24-073,G,12/21/16,CHI,,WAS,L,0,14,2,4,0.5,2,2,1,0,2,0,1,1,1,2,0,2
14887,Jerian Grant,24-087,G,1/4/17,CHI,@,CLE,W,0,20,1,5,0.2,0,1,0,1,4,0.25,2,2,1,0,2,2
14888,Jerian Grant,24-108,G,1/25/17,CHI,,ATL,L,1,19,2,6,0.333,1,2,0.5,1,4,0.25,0,0,,0,2,2
14889,Jerian Grant,24-144,G,3/2/17,CHI,,GSW,W,1,13,2,2,1,1,1,1,1,1,1,0,0,,0,1,1
14890,Jerian Grant,24-083,G,12/31/16,CHI,,MIL,L,0,18,1,5,0.2,0,1,0,1,4,0.25,2,2,1,0,0,0
14891,Danny Green,29-262,G-F,3/11/17,SAS,,GSW,W,1,21,2,7,0.286,1,2,0.5,1,5,0.2,0,0,,0,3,3
14892,Danny Green,29-175,G-F,12/14/16,SAS,,BOS,W,1,23,2,4,0.5,1,2,0.5,1,2,0.5,0,0,,0,0,0
14893,Danny Green,29-209,G-F,1/17/17,SAS,,MIN,W,1,27,1,8,0.125,0,3,0,1,5,0.2,2,2,1,0,4,4
14894,Danny Green,29-171,G-F,12/10/16,SAS,,BRK,W,1,23,2,4,0.5,2,3,0.667,0,1,0,1,2,0.5,0,3,3
14895,Danny Green,29-257,G-F,3/6/17,SAS,,HOU,W,1,33,2,8,0.25,1,2,0.5,1,6,0.167,0,0,,0,4,4
14896,Danny Green,29-167,G-F,12/6/16,SAS,@,MIN,W,1,20,2,4,0.5,1,1,1,1,3,0.333,0,0,,0,3,3
14897,Danny Green,29-184,G-F,12/23/16,SAS,@,POR,W,1,30,2,7,0.286,1,4,0.25,1,3,0.333,0,0,,0,0,0
14898,Danny Green,29-270,G-F,3/19/17,SAS,,SAC,W,1,20,2,5,0.4,1,3,0.333,1,2,0.5,0,0,,2,3,5
14899,Danny Green,29-227,G-F,2/4/17,SAS,,DEN,W,1,20,2,5,0.4,1,1,1,1,4,0.25,0,0,,0,4,4
14900,Danny Green,29-249,G-F,2/26/17,SAS,@,LAL,W,1,20,2,6,0.333,1,5,0.2,1,1,1,0,0,,0,1,1
14901,Danny Green,29-184,G-F,12/23/16,SAS,@,POR,W,1,30,2,7,0.286,1,4,0.25,1,3,0.333,0,0,,0,0,0
14902,Danny Green,29-270,G-F,3/19/17,SAS,,SAC,W,1,20,2,5,0.4,1,3,0.333,1,2,0.5,0,0,,2,3,5
14903,Draymond Green,26-331,F,1/29/17,GSW,@,POR,W,1,34,2,8,0.25,1,2,0.5,1,6,0.167,0,0,,1,5,6
14904,Draymond Green,27-006,F,3/10/17,GSW,@,MIN,L,1,38,1,8,0.125,1,5,0.2,0,3,0,3,4,0.75,3,4,7
14905,Draymond Green,26-330,F,1/28/17,GSW,,LAC,W,1,26,1,4,0.25,1,3,0.333,0,1,0,3,4,0.75,0,5,5
14906,Draymond Green,26-294,F,12/23/16,GSW,@,DET,W,1,38,1,7,0.143,1,2,0.5,0,5,0,3,4,0.75,0,9,9
14907,Draymond Green,26-346,F,2/13/17,GSW,@,DEN,L,1,24,1,5,0.2,1,3,0.333,0,2,0,3,4,0.75,0,2,2
14908,Draymond Green,26-240,F,10/30/16,GSW,@,PHO,W,1,38,2,9,0.222,2,5,0.4,0,4,0,1,2,0.5,1,12,13
14909,Draymond Green,26-286,F,12/15/16,GSW,,NYK,W,1,32,2,12,0.167,1,7,0.143,1,5,0.2,0,0,,5,6,11
14910,Draymond Green,26-358,F,2/25/17,GSW,,BRK,W,1,23,1,10,0.1,0,6,0,1,4,0.25,2,2,1,1,7,8
14911,Draymond Green,26-264,F,11/23/16,GSW,,LAL,W,1,28,1,6,0.167,1,3,0.333,0,3,0,3,6,0.5,1,8,9
14912,Gerald Green,31-002,G-F,1/28/17,BOS,@,MIL,W,0,13,2,7,0.286,1,4,0.25,1,3,0.333,0,0,,0,1,1
14913,Gerald Green,31-052,G-F,3/19/17,BOS,@,PHI,L,0,14,2,5,0.4,1,2,0.5,1,3,0.333,0,0,,0,2,2
14914,Gerald Green,30-329,G-F,12/20/16,BOS,@,MEM,W,0,7,2,6,0.333,1,3,0.333,1,3,0.333,0,0,,1,2,3
14915,Gerald Green,30-351,G-F,1/11/17,BOS,,WAS,W,0,14,2,6,0.333,1,2,0.5,1,4,0.25,0,1,0,1,2,3
14916,JaMychal Green,26-144,F,11/12/16,MEM,@,MIL,L,1,23,2,6,0.333,2,6,0.333,0,0,,1,1,1,1,2,3
14917,JaMychal Green,26-138,F,11/6/16,MEM,,POR,L,1,33,2,6,0.333,2,3,0.667,0,3,0,1,2,0.5,4,4,8
14918,JaMychal Green,26-234,F,2/10/17,MEM,,GSW,L,1,22,2,4,0.5,2,3,0.667,0,1,0,1,1,1,2,5,7
14919,JaMychal Green,26-167,F,12/5/16,MEM,@,NOP,W,1,43,2,9,0.222,2,6,0.333,0,3,0,1,3,0.333,3,14,17
14920,JaMychal Green,26-255,F,3/3/17,MEM,@,DAL,L,1,26,2,4,0.5,1,3,0.333,1,1,1,0,0,,0,7,7
14921,Jeff Green,30-122,F,12/28/16,ORL,,CHO,L,0,15,1,4,0.25,1,1,1,0,3,0,3,3,1,0,0,0
14922,Jeff Green,30-138,F,1/13/17,ORL,@,POR,W,0,20,2,4,0.5,1,3,0.333,1,1,1,0,0,,0,5,5
14923,Jeff Green,30-071,F,11/7/16,ORL,@,CHI,L,0,15,2,6,0.333,1,3,0.333,1,3,0.333,0,0,,2,2,4
14924,Justin Hamilton,26-263,C,12/20/16,BRK,@,TOR,L,0,23,2,6,0.333,2,3,0.667,0,3,0,1,2,0.5,2,9,11
14925,Justin Hamilton,26-276,C,1/2/17,BRK,,UTA,L,0,16,2,4,0.5,1,2,0.5,1,2,0.5,0,0,,1,5,6
14926,Justin Hamilton,26-244,C,12/1/16,BRK,,MIL,L,0,17,2,9,0.222,1,4,0.25,1,5,0.2,0,0,,1,1,2
14927,Justin Hamilton,26-271,C,12/28/16,BRK,@,CHI,L,0,18,2,7,0.286,1,2,0.5,1,5,0.2,0,0,,3,2,5
14928,A.J. Hammons,24-114,C,12/19/16,DAL,@,DEN,L,0,5,2,3,0.667,1,1,1,1,2,0.5,0,0,,1,0,1
14929,Tim Hardaway,24-229,G,10/31/16,ATL,,SAC,W,0,13,2,6,0.333,2,3,0.667,0,3,0,1,3,0.333,1,1,2
14930,Maurice Harkless,23-188,F-G,11/15/16,POR,,CHI,L,1,29,2,9,0.222,1,5,0.2,1,4,0.25,0,0,,3,5,8
14931,Maurice Harkless,23-242,F-G,1/8/17,POR,,DET,L,1,26,1,4,0.25,0,1,0,1,3,0.333,2,4,0.5,0,2,2
14932,Devin Harris,33-350,G,2/11/17,DAL,,ORL,W,0,12,1,5,0.2,0,2,0,1,3,0.333,2,2,1,1,2,3
14933,Devin Harris,34-000,G,2/27/17,DAL,,MIA,W,0,13,2,5,0.4,1,4,0.25,1,1,1,0,0,,0,0,0
14934,Devin Harris,33-291,G,12/14/16,DAL,,DET,L,0,14,2,5,0.4,1,2,0.5,1,3,0.333,0,0,,0,1,1
14935,Devin Harris,34-011,G,3/10/17,DAL,,BRK,W,0,15,2,3,0.667,2,2,1,0,1,0,1,2,0.5,0,1,1
14936,Devin Harris,33-303,G,12/26/16,DAL,@,NOP,L,0,18,2,4,0.5,1,1,1,1,3,0.333,0,0,,0,3,3
14937,Devin Harris,33-286,G,12/9/16,DAL,,IND,W,0,17,2,5,0.4,1,2,0.5,1,3,0.333,0,0,,0,0,0
14938,Joe Harris,25-100,G,12/16/16,BRK,@,ORL,L,0,19,1,4,0.25,1,3,0.333,0,1,0,3,3,1,0,6,6
14939,Joe Harris,25-156,G,2/10/17,BRK,,MIA,L,0,20,1,4,0.25,0,3,0,1,1,1,2,4,0.5,1,1,2
14940,Joe Harris,25-052,G,10/29/16,BRK,@,MIL,L,0,18,2,7,0.286,1,3,0.333,1,4,0.25,0,0,,0,2,2
14941,Joe Harris,25-104,G,12/20/16,BRK,@,TOR,L,0,22,2,6,0.333,1,3,0.333,1,3,0.333,0,0,,0,6,6
14942,Manny Harris,27-177,G,3/17/17,DAL,@,PHI,L,0,16,2,9,0.222,2,8,0.25,0,1,0,1,2,0.5,1,5,6
14943,Andrew Harrison,22-024,G,11/21/16,MEM,@,CHO,W,0,24,2,6,0.333,1,4,0.25,1,2,0.5,0,0,,0,2,2
14944,Andrew Harrison,22-084,G,1/20/17,MEM,,SAC,W,0,14,1,4,0.25,0,2,0,1,2,0.5,2,2,1,1,2,3
14945,Andrew Harrison,22-019,G,11/16/16,MEM,@,LAC,W,0,26,2,4,0.5,1,2,0.5,1,2,0.5,0,0,,0,3,3
14946,Andrew Harrison,22-129,G,3/6/17,MEM,,BRK,L,1,22,1,4,0.25,0,1,0,1,3,0.333,2,2,1,0,2,2
14947,Andrew Harrison,22-017,G,11/14/16,MEM,@,UTA,W,0,26,1,4,0.25,0,2,0,1,2,0.5,2,2,1,0,2,2
14948,Andrew Harrison,22-141,G,3/18/17,MEM,,SAS,W,0,12,0,2,0,0,1,0,0,1,0,5,5,1,0,0,0
14949,Andrew Harrison,22-056,G,12/23/16,MEM,,HOU,W,0,20,1,6,0.167,1,3,0.333,0,3,0,3,4,0.75,0,2,2
14950,Andrew Harrison,22-119,G,2/24/17,MEM,@,IND,L,0,3,1,1,1,0,0,,1,1,1,2,2,1,0,0,0
14951,Andrew Harrison,22-009,G,11/6/16,MEM,,POR,L,0,17,1,6,0.167,1,4,0.25,0,2,0,3,5,0.6,0,2,2
14952,Andrew Harrison,22-139,G,3/16/17,MEM,@,ATL,W,0,15,2,4,0.5,1,2,0.5,1,2,0.5,0,0,,0,3,3
14953,Udonis Haslem,36-211,F-C,1/6/17,MIA,@,LAL,L,0,7,2,2,1,2,2,1,0,0,,1,2,0.5,1,3,4
14954,Spencer Hawes,28-219,C-F,12/3/16,CHO,,MIN,L,0,22,2,6,0.333,1,4,0.25,1,2,0.5,0,0,,1,5,6
14955,Spencer Hawes,28-212,C-F,11/26/16,CHO,,NYK,W,0,14,2,7,0.286,1,3,0.333,1,4,0.25,0,0,,1,2,3
14956,Gerald Henderson,29-087,G,3/6/17,PHI,,MIL,L,1,17,2,4,0.5,1,3,0.333,1,1,1,0,0,,1,2,3
14957,Gerald Henderson,28-352,G,11/25/16,PHI,,CHI,L,1,19,2,7,0.286,1,4,0.25,1,3,0.333,0,0,,0,1,1
14958,Gerald Henderson,28-363,G,12/6/16,PHI,@,MEM,L,1,16,2,4,0.5,1,3,0.333,1,1,1,0,1,0,0,3,3
14959,Gerald Henderson,29-042,G,1/20/17,PHI,,POR,W,0,26,2,10,0.2,1,7,0.143,1,3,0.333,0,0,,2,5,7
14960,John Henson,25-361,C-F,12/23/16,MIL,,WAS,W,1,19,1,4,0.25,1,4,0.25,0,0,,3,4,0.75,2,1,3
14961,John Henson,26-042,C-F,2/8/17,MIL,,MIA,L,1,26,1,3,0.333,1,3,0.333,0,0,,3,5,0.6,0,5,5
14962,John Henson,26-077,C-F,3/15/17,MIL,@,LAC,W,0,13,2,4,0.5,2,4,0.5,0,0,,1,2,0.5,3,4,7
14963,Juan Hernangomez,21-038,F,11/5/16,DEN,@,DET,L,0,11,1,2,0.5,0,0,,1,2,0.5,2,2,1,0,1,1
14964,Juan Hernangomez,21-129,F,2/4/17,DEN,@,SAS,L,0,22,2,7,0.286,1,4,0.25,1,3,0.333,0,0,,2,5,7
14965,Juan Hernangomez,21-163,F,3/10/17,DEN,,BOS,W,0,13,1,1,1,0,0,,1,1,1,2,2,1,0,3,3
14966,Willy Hernangomez,22-257,C,2/8/17,NYK,,LAC,L,0,20,0,3,0,0,3,0,0,0,,5,6,0.833,2,7,9
14967,Willy Hernangomez,22-174,C,11/17/16,NYK,@,WAS,L,0,10,2,2,1,2,2,1,0,0,,1,2,0.5,0,1,1
14968,Mario Hezonja,21-297,F-G,12/18/16,ORL,,TOR,L,0,7,2,3,0.667,2,3,0.667,0,0,,1,1,1,0,1,1
14969,Mario Hezonja,21-311,F-G,1/1/17,ORL,@,IND,L,0,4,1,2,0.5,0,1,0,1,1,1,2,2,1,0,0,0
14970,Roy Hibbert,29-353,C,11/28/16,CHO,@,MEM,W,0,17,2,4,0.5,2,4,0.5,0,0,,1,3,0.333,3,3,6
14971,Roy Hibbert,30-043,C,1/23/17,CHO,,WAS,L,0,12,2,2,1,2,2,1,0,0,,1,1,1,1,1,2
14972,Buddy Hield,23-039,G,1/25/17,NOP,,OKC,L,1,23,2,10,0.2,1,7,0.143,1,3,0.333,0,0,,0,3,3
14973,Buddy Hield,22-337,G,11/18/16,NOP,,POR,W,0,7,2,2,1,1,1,1,1,1,1,0,0,,0,1,1
14974,Buddy Hield,22-333,G,11/14/16,NOP,,BOS,W,1,21,2,7,0.286,1,3,0.333,1,4,0.25,0,0,,0,2,2
14975,Buddy Hield,23-046,G,2/1/17,NOP,@,DET,L,1,21,2,8,0.25,1,2,0.5,1,6,0.167,0,0,,0,6,6
14976,Buddy Hield,22-346,G,11/27/16,NOP,@,DAL,L,0,16,1,5,0.2,0,2,0,1,3,0.333,2,2,1,0,4,4
14977,Buddy Hield,23-060,G,2/15/17,NOP,@,MEM,W,1,18,2,4,0.5,1,2,0.5,1,2,0.5,0,0,,0,2,2
14978,Buddy Hield,23-026,G,1/12/17,NOP,@,BRK,W,1,24,2,9,0.222,1,3,0.333,1,6,0.167,0,0,,3,2,5
14979,Buddy Hield,23-041,G,1/27/17,NOP,,SAS,W,1,13,2,7,0.286,1,4,0.25,1,3,0.333,0,0,,1,1,2
14980,Buddy Hield,23-057,G,2/12/17,NOP,@,SAC,L,1,14,2,5,0.4,1,2,0.5,1,3,0.333,0,0,,0,0,0
14981,Nene Hilario,34-127,F-C,1/18/17,HOU,,MIL,W,0,10,2,3,0.667,2,3,0.667,0,0,,1,2,0.5,0,0,0
14982,Nene Hilario,34-092,F-C,12/14/16,HOU,,SAC,W,0,14,2,4,0.5,2,4,0.5,0,0,,1,3,0.333,0,2,2
14983,Nene Hilario,34-108,F-C,12/30/16,HOU,,LAC,W,1,16,0,1,0,0,0,,0,1,0,5,8,0.625,2,3,5
14984,Nene Hilario,34-104,F-C,12/26/16,HOU,,PHO,W,0,14,2,3,0.667,2,3,0.667,0,0,,1,2,0.5,1,2,3
14985,Solomon Hill,25-225,F,10/29/16,NOP,@,SAS,L,1,27,2,7,0.286,1,4,0.25,1,3,0.333,0,0,,1,3,4
14986,Solomon Hill,25-272,F,12/15/16,NOP,,IND,W,1,31,1,3,0.333,0,0,,1,3,0.333,2,2,1,1,1,2
14987,Solomon Hill,25-306,F,1/18/17,NOP,,ORL,W,1,32,2,7,0.286,1,4,0.25,1,3,0.333,0,0,,0,5,5
14988,Solomon Hill,25-252,F,11/25/16,NOP,@,POR,L,1,27,2,4,0.5,1,3,0.333,1,1,1,0,0,,2,4,6
14989,Solomon Hill,25-268,F,12/11/16,NOP,@,PHO,W,1,18,2,6,0.333,1,2,0.5,1,4,0.25,0,0,,0,2,2
14990,Solomon Hill,25-235,F,11/8/16,NOP,@,SAC,L,1,26,1,4,0.25,0,2,0,1,2,0.5,2,2,1,0,5,5
14991,Solomon Hill,25-285,F,12/28/16,NOP,,LAC,W,1,24,1,4,0.25,0,1,0,1,3,0.333,2,2,1,1,3,4
14992,Solomon Hill,25-352,F,3/5/17,NOP,@,LAL,W,1,34,2,8,0.25,1,2,0.5,1,6,0.167,0,0,,3,3,6
14993,Solomon Hill,26-003,F,3/21/17,NOP,,MEM,W,1,34,1,7,0.143,1,4,0.25,0,3,0,3,4,0.75,1,4,5
14994,Solomon Hill,25-261,F,12/4/16,NOP,@,OKC,L,1,33,1,7,0.143,0,1,0,1,6,0.167,2,2,1,0,3,3
14995,Solomon Hill,25-278,F,12/21/16,NOP,,OKC,L,1,26,1,2,0.5,0,1,0,1,1,1,2,2,1,1,2,3
14996,Darrun Hilliard,23-230,G,11/29/16,DET,@,CHO,W,0,9,2,4,0.5,1,2,0.5,1,2,0.5,0,1,0,0,0,0
14997,Darrun Hilliard,23-242,G,12/11/16,DET,,PHI,L,1,20,2,7,0.286,2,5,0.4,0,2,0,1,1,1,0,1,1
14998,Darrun Hilliard,23-240,G,12/9/16,DET,@,MIN,W,0,17,2,3,0.667,1,1,1,1,2,0.5,0,0,,0,0,0
14999,Darrun Hilliard,23-238,G,12/7/16,DET,@,CHO,L,0,11,2,4,0.5,2,3,0.667,0,1,0,1,1,1,0,3,3
15000,Darrun Hilliard,23-250,G,12/19/16,DET,@,CHI,L,0,18,2,6,0.333,1,2,0.5,1,4,0.25,0,0,,1,3,4
15001,Jrue Holiday,26-189,G,12/18/16,NOP,@,SAS,L,1,24,2,8,0.25,1,6,0.167,1,2,0.5,0,0,,0,2,2
15002,Justin Holiday,27-243,G,12/4/16,NYK,,SAC,W,1,23,2,7,0.286,1,3,0.333,1,4,0.25,0,0,,3,5,8
15003,Justin Holiday,27-301,G,1/31/17,NYK,@,WAS,L,0,20,1,9,0.111,1,5,0.2,0,4,0,3,4,0.75,0,2,2
15004,Justin Holiday,27-272,G,1/2/17,NYK,,ORL,L,0,14,2,3,0.667,1,1,1,1,2,0.5,0,0,,0,4,4
15005,Justin Holiday,27-235,G,11/26/16,NYK,@,CHO,L,0,18,2,7,0.286,1,4,0.25,1,3,0.333,0,0,,0,4,4
15006,Justin Holiday,27-309,G,2/8/17,NYK,,LAC,L,0,24,2,6,0.333,1,1,1,1,5,0.2,0,0,,0,3,3
15007,Justin Holiday,27-245,G,12/6/16,NYK,@,MIA,W,0,18,2,3,0.667,1,1,1,1,2,0.5,0,0,,0,3,3
15008,Justin Holiday,27-261,G,12/22/16,NYK,,ORL,W,0,20,2,8,0.25,1,6,0.167,1,2,0.5,0,0,,0,0,0
15009,Rondae Hollis-Jefferson,22-010,F,1/13/17,BRK,@,TOR,L,0,16,2,3,0.667,2,3,0.667,0,0,,1,2,0.5,0,1,1
15010,Rondae Hollis-Jefferson,22-038,F,2/10/17,BRK,,MIA,L,1,23,1,3,0.333,1,3,0.333,0,0,,3,4,0.75,2,4,6
15011,Rondae Hollis-Jefferson,21-297,F,10/26/16,BRK,@,BOS,L,1,24,1,3,0.333,1,2,0.5,0,1,0,3,4,0.75,0,2,2
15012,Rondae Hollis-Jefferson,21-337,F,12/5/16,BRK,,WAS,L,0,23,2,5,0.4,2,5,0.4,0,0,,1,2,0.5,1,4,5
15013,Rondae Hollis-Jefferson,22-035,F,2/7/17,BRK,@,CHO,L,1,22,2,4,0.5,2,4,0.5,0,0,,1,2,0.5,0,7,7
15014,Rondae Hollis-Jefferson,22-059,F,3/3/17,BRK,@,UTA,L,1,17,2,4,0.5,2,4,0.5,0,0,,1,2,0.5,1,1,2
15015,Rondae Hollis-Jefferson,21-335,F,12/3/16,BRK,@,MIL,L,0,24,2,5,0.4,1,2,0.5,1,3,0.333,0,3,0,1,8,9
15016,Rodney Hood,24-098,G-F,1/26/17,UTA,,LAL,W,1,22,2,6,0.333,1,2,0.5,1,4,0.25,0,0,,0,4,4
15017,Rodney Hood,24-010,G-F,10/30/16,UTA,@,LAC,L,1,28,2,10,0.2,1,8,0.125,1,2,0.5,0,1,0,0,3,3
15018,Al Horford,30-229,C-F,1/18/17,BOS,,NYK,L,1,34,2,14,0.143,1,6,0.167,1,8,0.125,0,0,,2,5,7
15019,Kris Humphries,32-004,F-C,2/10/17,ATL,@,SAC,L,0,12,2,2,1,1,1,1,1,1,1,0,2,0,0,4,4
15020,Kris Humphries,31-268,F-C,10/31/16,ATL,,SAC,W,0,13,1,1,1,0,0,,1,1,1,2,2,1,0,1,1
15021,Kris Humphries,31-328,F-C,12/30/16,ATL,,DET,W,0,10,2,3,0.667,1,2,0.5,1,1,1,0,0,,1,1,2
15022,Kris Humphries,31-298,F-C,11/30/16,ATL,@,PHO,L,0,15,2,4,0.5,2,3,0.667,0,1,0,1,2,0.5,1,2,3
15023,Serge Ibaka,27-066,F-C,11/23/16,ORL,,PHO,L,1,32,2,9,0.222,1,6,0.167,1,3,0.333,0,0,,2,2,4
15024,Serge Ibaka,27-139,F-C,2/4/17,ORL,@,ATL,L,1,24,2,9,0.222,1,5,0.2,1,4,0.25,0,0,,2,0,2
15025,Andre Iguodala,32-360,G-F,1/22/17,GSW,@,ORL,W,0,29,1,5,0.2,0,1,0,1,4,0.25,2,2,1,0,6,6
15026,Andre Iguodala,32-322,G-F,12/15/16,GSW,,NYK,W,0,21,2,3,0.667,2,2,1,0,1,0,1,2,0.5,1,3,4
15027,Andre Iguodala,32-358,G-F,1/20/17,GSW,@,HOU,W,0,27,2,5,0.4,1,3,0.333,1,2,0.5,0,0,,1,8,9
15028,Andre Iguodala,33-028,G-F,2/25/17,GSW,,BRK,W,0,26,2,4,0.5,1,2,0.5,1,2,0.5,0,0,,0,2,2
15029,Andre Iguodala,33-018,G-F,2/15/17,GSW,,SAC,W,0,22,2,4,0.5,1,2,0.5,1,2,0.5,0,0,,1,5,6
15030,Andre Iguodala,32-310,G-F,12/3/16,GSW,,PHO,W,0,23,2,4,0.5,1,3,0.333,1,1,1,0,0,,1,5,6
15031,Ersan Ilyasova,29-276,F,2/15/17,PHI,@,BOS,L,1,15,2,9,0.222,2,6,0.333,0,3,0,1,1,1,3,0,3
15032,Ersan Ilyasova,29-274,F,2/13/17,PHI,@,CHO,W,1,20,2,7,0.286,1,3,0.333,1,4,0.25,0,0,,1,9,10
15033,Ersan Ilyasova,29-294,F,3/5/17,ATL,,IND,L,0,21,2,4,0.5,1,1,1,1,3,0.333,0,0,,1,3,4
15034,Ersan Ilyasova,29-286,F,2/25/17,ATL,@,ORL,L,0,25,2,10,0.2,2,9,0.222,0,1,0,1,2,0.5,3,7,10
15035,Ersan Ilyasova,29-166,F,10/28/16,OKC,,PHO,W,0,16,2,3,0.667,1,1,1,1,2,0.5,0,0,,0,5,5
15036,Joe Ingles,29-118,F-G,1/28/17,UTA,,MEM,L,0,15,1,1,1,0,0,,1,1,1,2,2,1,0,1,1
15037,Joe Ingles,29-100,F-G,1/10/17,UTA,,CLE,W,0,27,2,5,0.4,1,1,1,1,4,0.25,0,0,,0,2,2
15038,Joe Ingles,29-049,F-G,11/20/16,UTA,@,DEN,L,0,21,1,4,0.25,0,0,,1,4,0.25,2,2,1,0,2,2
15039,Joe Ingles,29-150,F-G,3/1/17,UTA,,MIN,L,1,26,2,8,0.25,1,3,0.333,1,5,0.2,0,0,,0,3,3
15040,Joe Ingles,29-075,F-G,12/16/16,UTA,,DAL,W,0,21,2,3,0.667,1,1,1,1,2,0.5,0,0,,0,2,2
15041,Joe Ingles,29-092,F-G,1/2/17,UTA,@,BRK,W,0,28,2,6,0.333,1,2,0.5,1,4,0.25,0,0,,1,8,9
15042,Brandon Ingram,19-101,F,12/12/16,LAL,@,SAC,L,0,26,2,7,0.286,2,6,0.333,0,1,0,1,2,0.5,1,4,5
15043,Brandon Ingram,19-116,F,12/27/16,LAL,,UTA,L,0,31,2,5,0.4,2,5,0.4,0,0,,1,2,0.5,0,2,2
15044,Brandon Ingram,19-067,F,11/8/16,LAL,,DAL,L,0,26,2,5,0.4,1,3,0.333,1,2,0.5,0,0,,0,4,4
15045,Brandon Ingram,19-135,F,1/15/17,LAL,,DET,L,0,28,1,7,0.143,1,6,0.167,0,1,0,3,6,0.5,2,2,4
15046,Brandon Ingram,19-153,F,2/2/17,LAL,@,WAS,L,0,21,1,3,0.333,1,3,0.333,0,0,,3,4,0.75,1,5,6
15047,Al Jefferson,31-304,C-F,11/3/16,IND,@,MIL,L,0,19,1,8,0.125,1,7,0.143,0,1,0,3,4,0.75,3,4,7
15048,Al Jefferson,32-035,C-F,2/8/17,IND,,CLE,L,0,3,2,2,1,2,2,1,0,0,,1,2,0.5,1,2,3
15049,Al Jefferson,31-345,C-F,12/14/16,IND,@,MIA,L,0,11,2,5,0.4,2,5,0.4,0,0,,1,2,0.5,1,1,2
15050,Al Jefferson,31-359,C-F,12/28/16,IND,@,WAS,L,0,14,2,3,0.667,2,3,0.667,0,0,,1,3,0.333,1,6,7
15051,Richard Jefferson,36-228,F,2/4/17,CLE,@,NYK,W,0,19,2,5,0.4,1,1,1,1,4,0.25,0,0,,1,2,3
15052,Richard Jefferson,36-157,F,11/25/16,CLE,,DAL,W,0,9,1,2,0.5,0,0,,1,2,0.5,2,2,1,0,2,2
15053,Richard Jefferson,36-169,F,12/7/16,CLE,@,NYK,W,0,18,2,5,0.4,1,3,0.333,1,2,0.5,0,0,,0,3,3
15054,Richard Jefferson,36-185,F,12/23/16,CLE,,BRK,W,0,9,2,4,0.5,2,3,0.667,0,1,0,1,1,1,0,0,0
15055,Richard Jefferson,36-148,F,11/16/16,CLE,@,IND,L,1,20,2,6,0.333,1,4,0.25,1,2,0.5,0,0,,0,3,3
15056,Richard Jefferson,36-167,F,12/5/16,CLE,@,TOR,W,0,16,2,3,0.667,1,2,0.5,1,1,1,0,0,,0,0,0
15057,Richard Jefferson,36-216,F,1/23/17,CLE,@,NOP,L,0,22,2,5,0.4,1,2,0.5,1,3,0.333,0,2,0,0,2,2
15058,Richard Jefferson,36-147,F,11/15/16,CLE,,TOR,W,1,26,2,5,0.4,1,3,0.333,1,2,0.5,0,0,,0,0,0
15059,Brandon Jennings,27-098,G,12/30/16,NYK,@,NOP,L,0,28,2,8,0.25,1,5,0.2,1,3,0.333,0,0,,0,3,3
15060,Brandon Jennings,27-111,G,1/12/17,NYK,,CHI,W,0,14,1,4,0.25,0,0,,1,4,0.25,2,3,0.667,0,0,0
15061,Brandon Jennings,27-044,G,11/6/16,NYK,,UTA,L,0,16,2,4,0.5,1,2,0.5,1,2,0.5,0,0,,0,1,1
15062,Brandon Jennings,27-058,G,11/20/16,NYK,,ATL,W,0,28,2,6,0.333,1,3,0.333,1,3,0.333,0,0,,0,4,4
15063,Brandon Jennings,27-088,G,12/20/16,NYK,,IND,W,0,22,2,3,0.667,2,3,0.667,0,0,,1,2,0.5,0,3,3
15064,Brandon Jennings,27-052,G,11/14/16,NYK,,DAL,W,0,23,2,4,0.5,1,1,1,1,3,0.333,0,0,,1,2,3
15065,Jonas Jerebko,29-259,F,11/16/16,BOS,,DAL,W,0,24,2,3,0.667,1,1,1,1,2,0.5,0,0,,1,6,7
15066,Jonas Jerebko,29-275,F,12/2/16,BOS,,SAC,W,0,17,2,5,0.4,1,4,0.25,1,1,1,0,0,,1,8,9
15067,Jonas Jerebko,29-254,F,11/11/16,BOS,,NYK,W,0,21,2,4,0.5,2,3,0.667,0,1,0,1,2,0.5,3,2,5
15068,Jonas Jerebko,30-006,F,3/8/17,BOS,@,GSW,W,0,12,2,3,0.667,1,2,0.5,1,1,1,0,0,,1,4,5
15069,Jonas Jerebko,29-264,F,11/21/16,BOS,@,MIN,W,0,19,2,3,0.667,1,1,1,1,2,0.5,0,0,,0,3,3
15070,Jonas Jerebko,29-295,F,12/22/16,BOS,@,IND,W,0,15,2,4,0.5,1,1,1,1,3,0.333,0,0,,1,3,4
15071,Jonas Jerebko,29-276,F,12/3/16,BOS,@,PHI,W,0,16,2,4,0.5,1,2,0.5,1,2,0.5,0,0,,1,5,6
15072,Amir Johnson,29-222,F,12/9/16,BOS,,TOR,L,1,13,2,4,0.5,1,2,0.5,1,2,0.5,0,0,,0,3,3
15073,Amir Johnson,29-286,F,2/11/17,BOS,@,UTA,W,1,14,2,2,1,2,2,1,0,0,,1,2,0.5,0,3,3
15074,Amir Johnson,29-233,F,12/20/16,BOS,@,MEM,W,1,24,2,4,0.5,2,3,0.667,0,1,0,1,2,0.5,1,2,3
15075,Amir Johnson,29-284,F,2/9/17,BOS,@,POR,W,1,15,2,5,0.4,2,4,0.5,0,1,0,1,2,0.5,4,1,5
15076,Amir Johnson,29-304,F,3/1/17,BOS,,CLE,W,1,11,2,3,0.667,1,1,1,1,2,0.5,0,0,,2,0,2
15077,Amir Johnson,29-302,F,2/27/17,BOS,,ATL,L,1,17,2,3,0.667,2,2,1,0,1,0,1,2,0.5,0,2,2
15078,Amir Johnson,29-179,F,10/27/16,BOS,@,CHI,L,1,16,2,4,0.5,2,4,0.5,0,0,,1,2,0.5,0,1,1
15079,Amir Johnson,29-278,F,2/3/17,BOS,,LAL,W,1,15,2,2,1,2,2,1,0,0,,1,2,0.5,1,1,2
15080,Amir Johnson,29-276,F,2/1/17,BOS,,TOR,W,1,15,2,2,1,1,1,1,1,1,1,0,0,,1,1,2
15081,James Johnson,29-264,F,11/10/16,MIA,,CHI,L,0,21,2,5,0.4,1,2,0.5,1,3,0.333,0,0,,0,4,4
15082,James Johnson,29-334,F,1/19/17,MIA,,DAL,W,0,32,1,6,0.167,1,3,0.333,0,3,0,3,4,0.75,0,7,7
15083,James Johnson,29-282,F,11/28/16,MIA,,BOS,L,0,21,2,9,0.222,1,4,0.25,1,5,0.2,0,0,,0,3,3
15084,Joe Johnson,35-255,G-F,3/11/17,UTA,@,OKC,L,1,19,2,6,0.333,1,4,0.25,1,2,0.5,0,0,,1,1,2
15085,Joe Johnson,35-208,G-F,1/23/17,UTA,,OKC,L,0,16,2,6,0.333,2,5,0.4,0,1,0,1,1,1,1,2,3
15086,Stanley Johnson,20-224,F,1/8/17,DET,@,POR,W,0,25,2,3,0.667,1,1,1,1,2,0.5,0,0,,0,5,5
15087,Stanley Johnson,20-167,F,11/12/16,DET,@,DEN,W,0,14,2,5,0.4,2,4,0.5,0,1,0,1,2,0.5,1,3,4
15088,Stanley Johnson,20-251,F,2/4/17,DET,@,IND,L,0,19,2,5,0.4,2,5,0.4,0,0,,1,1,1,0,4,4
15089,Stanley Johnson,20-289,F,3/14/17,DET,@,CLE,L,0,24,1,10,0.1,0,6,0,1,4,0.25,2,2,1,0,1,1
15090,Stanley Johnson,20-173,F,11/18/16,DET,@,CLE,L,0,16,2,3,0.667,2,2,1,0,1,0,1,2,0.5,0,3,3
15091,Stanley Johnson,20-208,F,12/23/16,DET,,GSW,L,0,18,1,4,0.25,0,2,0,1,2,0.5,2,4,0.5,1,2,3
15092,Stanley Johnson,20-246,F,1/30/17,DET,@,BOS,L,0,18,2,7,0.286,2,3,0.667,0,4,0,1,2,0.5,1,5,6
15093,Tyler Johnson,24-189,G,11/12/16,MIA,,UTA,L,0,29,2,7,0.286,2,5,0.4,0,2,0,1,1,1,1,2,3
15094,Tyler Johnson,24-196,G,11/19/16,MIA,@,WAS,W,0,25,1,9,0.111,0,5,0,1,4,0.25,2,2,1,1,2,3
15095,Tyler Johnson,24-294,G,2/25/17,MIA,,IND,W,0,31,0,5,0,0,2,0,0,3,0,5,6,0.833,0,1,1
15096,Tyler Johnson,24-225,G,12/18/16,MIA,,BOS,L,0,30,2,7,0.286,2,2,1,0,5,0,1,2,0.5,2,4,6
15097,Wesley Johnson,29-184,F-G,1/11/17,LAC,,ORL,W,0,18,2,4,0.5,1,2,0.5,1,2,0.5,0,0,,0,3,3
15098,Wesley Johnson,29-121,F-G,11/9/16,LAC,,POR,W,0,19,2,6,0.333,1,2,0.5,1,4,0.25,0,0,,2,5,7
15099,Wesley Johnson,29-141,F-G,11/29/16,LAC,@,BRK,L,0,12,2,4,0.5,1,1,1,1,3,0.333,0,0,,0,1,1
15100,Wesley Johnson,29-248,F-G,3/16/17,LAC,@,DEN,L,0,14,2,6,0.333,1,2,0.5,1,4,0.25,0,0,,0,2,2
15101,Nikola Jokic,21-250,C-F,10/26/16,DEN,@,NOP,W,1,21,2,5,0.4,1,3,0.333,1,2,0.5,0,0,,1,6,7
15102,Derrick Jones,20-022,F,3/9/17,PHO,,LAL,L,0,10,2,2,1,2,2,1,0,0,,1,2,0.5,1,1,2
15103,James Jones,36-021,F-G,10/25/16,CLE,,NYK,W,0,6,1,2,0.5,0,1,0,1,1,1,2,2,1,0,0,0
15104,James Jones,36-099,F-G,1/11/17,CLE,@,POR,L,0,7,1,2,0.5,0,0,,1,2,0.5,2,2,1,0,2,2
15105,Terrence Jones,24-356,F,12/30/16,NOP,,NYK,W,0,18,2,6,0.333,2,6,0.333,0,0,,1,1,1,0,4,4
15106,Terrence Jones,24-352,F,12/26/16,NOP,,DAL,W,0,12,1,3,0.333,1,2,0.5,0,1,0,3,4,0.75,0,3,3
15107,Terrence Jones,25-028,F,2/6/17,NOP,,PHO,W,1,24,2,8,0.25,2,7,0.286,0,1,0,1,2,0.5,0,9,9
15108,Tyus Jones,20-200,G,11/26/16,MIN,@,GSW,L,0,13,2,2,1,1,1,1,1,1,1,0,0,,0,2,2
15109,Tyus Jones,20-274,G,2/8/17,MIN,,TOR,W,0,27,2,6,0.333,1,2,0.5,1,4,0.25,0,0,,0,0,0
15110,Tyus Jones,20-213,G,12/9/16,MIN,,DET,L,0,5,2,3,0.667,1,2,0.5,1,1,1,0,0,,0,0,0
15111,Tyus Jones,20-272,G,2/6/17,MIN,,MIA,L,0,31,2,5,0.4,2,4,0.5,0,1,0,1,2,0.5,0,1,1
15112,Tyus Jones,20-295,G,3/1/17,MIN,@,UTA,W,0,17,2,4,0.5,1,2,0.5,1,2,0.5,0,0,,0,1,1
15113,DeAndre Jordan,28-231,C,3/9/17,LAC,@,MEM,W,1,35,1,2,0.5,1,2,0.5,0,0,,3,5,0.6,1,10,11
15114,Cory Joseph,25-151,G,1/18/17,TOR,@,PHI,L,0,26,2,5,0.4,2,4,0.5,0,1,0,1,2,0.5,1,2,3
15115,Frank Kaminsky,23-284,F-C,1/13/17,CHO,@,PHI,L,0,22,2,10,0.2,1,6,0.167,1,4,0.25,0,0,,2,0,2
15116,Frank Kaminsky,23-298,F-C,1/27/17,CHO,@,NYK,L,0,22,2,6,0.333,1,3,0.333,1,3,0.333,0,0,,1,3,4
15117,Frank Kaminsky,23-247,F-C,12/7/16,CHO,,DET,W,0,22,2,7,0.286,2,5,0.4,0,2,0,1,4,0.25,1,4,5
15118,Michael Kidd-Gilchrist,23-127,F,1/31/17,CHO,@,POR,L,1,24,1,5,0.2,1,5,0.2,0,0,,3,4,0.75,0,5,5
15119,Sean Kilpatrick,27-049,G,2/24/17,BRK,@,DEN,L,0,18,1,7,0.143,1,5,0.2,0,2,0,3,7,0.429,0,0,0
15120,Sean Kilpatrick,27-009,G,1/15/17,BRK,,HOU,L,0,23,2,11,0.182,1,4,0.25,1,7,0.143,0,0,,0,3,3
15121,Sean Kilpatrick,27-035,G,2/10/17,BRK,,MIA,L,0,16,1,4,0.25,0,1,0,1,3,0.333,2,2,1,1,3,4
15122,Brandon Knight,25-041,G,1/12/17,PHO,,DAL,L,0,19,2,9,0.222,2,8,0.25,0,1,0,1,1,1,0,1,1
15123,Brandon Knight,25-031,G,1/2/17,PHO,@,LAC,L,0,7,2,4,0.5,2,4,0.5,0,0,,1,1,1,0,0,0
15124,Kyle Korver,35-246,G-F,11/18/16,ATL,@,CHO,L,1,29,2,6,0.333,1,3,0.333,1,3,0.333,0,0,,0,0,0
15125,Kyle Korver,35-224,G-F,10/27/16,ATL,,WAS,W,1,22,2,4,0.5,1,1,1,1,3,0.333,0,0,,0,3,3
15126,Kyle Korver,35-312,G-F,1/23/17,CLE,@,NOP,L,0,26,2,4,0.5,1,2,0.5,1,2,0.5,0,0,,0,4,4
15127,Kosta Koufos,28-023,C,3/19/17,SAC,@,SAS,L,1,15,2,5,0.4,2,5,0.4,0,0,,1,1,1,1,4,5
15128,Mindaugas Kuzminskas,27-023,F,11/11/16,NYK,@,BOS,L,0,16,2,5,0.4,2,4,0.5,0,1,0,1,2,0.5,1,1,2
15129,Mindaugas Kuzminskas,27-051,F,12/9/16,NYK,@,SAC,W,0,7,2,4,0.5,1,2,0.5,1,2,0.5,0,0,,1,1,2
15130,Mindaugas Kuzminskas,27-021,F,11/9/16,NYK,,BRK,W,0,17,2,4,0.5,1,1,1,1,3,0.333,0,0,,1,1,2
15131,Mindaugas Kuzminskas,27-049,F,12/7/16,NYK,,CLE,L,0,17,1,5,0.2,0,2,0,1,3,0.333,2,2,1,0,0,0
15132,Mindaugas Kuzminskas,27-018,F,11/6/16,NYK,,UTA,L,0,8,2,5,0.4,1,3,0.333,1,2,0.5,0,0,,2,0,2
15133,Mindaugas Kuzminskas,27-057,F,12/15/16,NYK,@,GSW,L,0,14,2,5,0.4,1,2,0.5,1,3,0.333,0,0,,1,0,1
15134,Jeremy Lamb,24-152,G-F,10/29/16,CHO,,BOS,L,0,9,2,7,0.286,2,3,0.667,0,4,0,1,2,0.5,0,3,3
15135,Nicolas Laprovittola,26-283,G,11/9/16,SAS,,HOU,L,0,14,2,5,0.4,1,3,0.333,1,2,0.5,0,0,,0,0,0
15136,Joffrey Lauvergne,25-061,C-F,11/30/16,OKC,,WAS,W,0,12,2,3,0.667,1,2,0.5,1,1,1,0,0,,0,4,4
15137,Joffrey Lauvergne,25-038,C-F,11/7/16,OKC,,MIA,W,0,16,2,9,0.222,1,5,0.2,1,4,0.25,0,0,,1,1,2
15138,Zach LaVine,21-305,G,1/9/17,MIN,,DAL,W,1,29,2,7,0.286,1,3,0.333,1,4,0.25,0,0,,0,6,6
15139,Ty Lawson,29-003,G,11/6/16,SAC,@,TOR,W,1,36,0,6,0,0,5,0,0,1,0,5,6,0.833,0,2,2
15140,Ty Lawson,29-037,G,12/10/16,SAC,@,UTA,L,0,17,2,6,0.333,2,5,0.4,0,1,0,1,1,1,1,0,1
15141,Ty Lawson,29-017,G,11/20/16,SAC,,TOR,W,1,27,2,7,0.286,1,3,0.333,1,4,0.25,0,0,,0,1,1
15142,Ty Lawson,29-086,G,1/28/17,SAC,@,CHO,W,0,32,2,6,0.333,2,5,0.4,0,1,0,1,2,0.5,0,0,0
15143,Ty Lawson,29-083,G,1/25/17,SAC,@,CLE,W,0,17,2,6,0.333,2,4,0.5,0,2,0,1,1,1,0,1,1
15144,Jake Layman,22-309,F,1/10/17,POR,@,LAL,W,0,3,2,3,0.667,1,2,0.5,1,1,1,0,0,,0,0,0
15145,Jake Layman,22-249,F,11/11/16,POR,,SAC,W,0,14,2,3,0.667,1,1,1,1,2,0.5,0,0,,0,2,2
15146,Courtney Lee,31-162,G,3/14/17,NYK,,IND,W,1,29,2,9,0.222,1,4,0.25,1,5,0.2,0,0,,0,7,7
15147,Courtney Lee,31-108,G,1/19/17,NYK,,WAS,L,0,29,2,6,0.333,1,3,0.333,1,3,0.333,0,0,,0,4,4
15148,Courtney Lee,31-145,G,2/25/17,NYK,,PHI,W,1,24,2,7,0.286,1,3,0.333,1,4,0.25,0,0,,0,4,4
15149,Courtney Lee,31-050,G,11/22/16,NYK,,POR,W,1,27,2,8,0.25,2,4,0.5,0,4,0,1,1,1,1,3,4
15150,Courtney Lee,31-120,G,1/31/17,NYK,@,WAS,L,1,27,2,10,0.2,1,5,0.2,1,5,0.2,0,0,,2,3,5
15151,Courtney Lee,31-104,G,1/15/17,NYK,@,TOR,L,1,25,2,9,0.222,1,5,0.2,1,4,0.25,0,0,,0,1,1
15152,Courtney Lee,31-044,G,11/16/16,NYK,,DET,W,1,29,2,12,0.167,1,9,0.111,1,3,0.333,0,0,,2,2,4
15153,Courtney Lee,31-153,G,3/5/17,NYK,,GSW,L,1,29,2,5,0.4,1,3,0.333,1,2,0.5,0,0,,0,0,0
15154,Courtney Lee,31-098,G,1/9/17,NYK,,NOP,L,1,28,2,8,0.25,1,5,0.2,1,3,0.333,0,0,,2,0,2
15155,Courtney Lee,31-149,G,3/1/17,NYK,@,ORL,W,1,35,2,5,0.4,1,2,0.5,1,3,0.333,0,0,,1,3,4
15156,David Lee,33-186,F,11/1/16,SAS,,UTA,L,0,14,2,3,0.667,2,3,0.667,0,0,,1,1,1,1,1,2
15157,David Lee,33-199,F,11/14/16,SAS,,MIA,W,0,17,2,4,0.5,2,4,0.5,0,0,,1,2,0.5,2,5,7
15158,David Lee,33-263,F,1/17/17,SAS,,MIN,W,0,15,1,4,0.25,1,4,0.25,0,0,,3,4,0.75,1,3,4
15159,David Lee,33-190,F,11/5/16,SAS,,LAC,L,0,14,1,4,0.25,1,4,0.25,0,0,,3,4,0.75,1,3,4
15160,Alex Len,23-164,C,11/27/16,PHO,,DEN,L,0,29,1,5,0.2,1,5,0.2,0,0,,3,3,1,3,7,10
15161,Alex Len,23-259,C,3/2/17,PHO,,CHO,W,1,16,2,3,0.667,2,3,0.667,0,0,,1,1,1,0,5,5
15162,Alex Len,23-196,C,12/29/16,PHO,,TOR,W,0,21,2,5,0.4,2,5,0.4,0,0,,1,2,0.5,2,4,6
15163,Alex Len,23-143,C,11/6/16,PHO,@,LAL,L,0,18,2,4,0.5,2,4,0.5,0,0,,1,2,0.5,2,9,11
15164,Alex Len,23-170,C,12/3/16,PHO,@,GSW,L,0,17,1,3,0.333,1,3,0.333,0,0,,3,4,0.75,0,1,1
15165,Meyers Leonard,24-270,C-F,11/23/16,POR,@,CLE,L,0,8,2,4,0.5,1,3,0.333,1,1,1,0,0,,1,2,3
15166,Meyers Leonard,24-326,C-F,1/18/17,POR,@,CHO,L,0,18,2,8,0.25,1,5,0.2,1,3,0.333,0,0,,1,3,4
15167,Meyers Leonard,24-348,C-F,2/9/17,POR,,BOS,L,0,18,2,3,0.667,1,1,1,1,2,0.5,0,0,,0,2,2
15168,Meyers Leonard,24-321,C-F,1/13/17,POR,,ORL,L,0,20,1,8,0.125,0,4,0,1,4,0.25,2,2,1,1,5,6
15169,Meyers Leonard,24-265,C-F,11/18/16,POR,@,NOP,L,0,8,1,3,0.333,0,1,0,1,2,0.5,2,2,1,0,1,1
15170,Meyers Leonard,24-280,C-F,12/3/16,POR,,MIA,W,0,19,2,6,0.333,1,4,0.25,1,2,0.5,0,0,,1,5,6
15171,Meyers Leonard,24-365,C-F,2/26/17,POR,@,TOR,L,0,21,1,5,0.2,1,3,0.333,0,2,0,3,4,0.75,0,5,5
15172,Caris LeVert,22-123,G-F,12/26/16,BRK,,CHO,W,0,15,2,3,0.667,1,1,1,1,2,0.5,0,0,,0,1,1
15173,Caris LeVert,22-119,G-F,12/22/16,BRK,,GSW,L,0,13,2,6,0.333,2,5,0.4,0,1,0,1,2,0.5,0,1,1
15174,Caris LeVert,22-113,G-F,12/16/16,BRK,@,ORL,L,0,11,2,3,0.667,1,1,1,1,2,0.5,0,0,,0,4,4
15175,Caris LeVert,22-206,G-F,3/19/17,BRK,,DAL,L,1,25,2,6,0.333,1,3,0.333,1,3,0.333,0,0,,0,5,5
15176,Caris LeVert,22-204,G-F,3/17/17,BRK,,BOS,L,1,25,1,6,0.167,0,2,0,1,4,0.25,2,2,1,1,3,4
15177,DeAndre Liggins,28-253,G,12/9/16,CLE,,MIA,W,1,26,2,3,0.667,2,3,0.667,0,0,,1,2,0.5,0,2,2
15178,DeAndre Liggins,28-249,G,12/5/16,CLE,@,TOR,W,0,21,1,2,0.5,0,1,0,1,1,1,2,4,0.5,2,3,5
15179,DeAndre Liggins,28-265,G,12/21/16,CLE,,MIL,W,1,26,2,5,0.4,1,4,0.25,1,1,1,0,0,,0,4,4
15180,DeAndre Liggins,28-281,G,1/6/17,CLE,@,BRK,W,1,18,2,4,0.5,1,1,1,1,3,0.333,0,0,,0,3,3
15181,DeAndre Liggins,28-296,G,1/21/17,CLE,,SAS,L,0,12,2,4,0.5,2,4,0.5,0,0,,1,2,0.5,0,1,1
15182,DeAndre Liggins,28-294,G,1/19/17,CLE,,PHO,W,0,17,1,3,0.333,0,1,0,1,2,0.5,2,2,1,0,0,0
15183,DeAndre Liggins,28-310,G,2/4/17,CLE,@,NYK,W,1,17,2,4,0.5,2,3,0.667,0,1,0,1,2,0.5,0,3,3
15184,Shaun Livingston,31-087,G,12/7/16,GSW,@,LAC,W,0,17,2,2,1,2,2,1,0,0,,1,2,0.5,0,1,1
15185,Kevon Looney,20-291,F-C,11/23/16,GSW,,LAL,W,0,7,2,2,1,1,1,1,1,1,1,0,0,,1,4,5
15186,Kevon Looney,21-009,F-C,2/15/17,GSW,,SAC,W,0,16,2,4,0.5,2,3,0.667,0,1,0,1,2,0.5,0,2,2
15187,Kevon Looney,20-277,F-C,11/9/16,GSW,,DAL,W,0,11,1,1,1,1,1,1,0,0,,3,5,0.6,0,0,0
15188,Kevon Looney,20-313,F-C,12/15/16,GSW,,NYK,W,0,15,2,2,1,2,2,1,0,0,,1,2,0.5,2,2,4
15189,Robin Lopez,28-276,C,1/2/17,CHI,,CHO,W,1,23,2,6,0.333,2,6,0.333,0,0,,1,2,0.5,1,4,5
15190,Robin Lopez,28-217,C,11/4/16,CHI,,NYK,L,1,29,2,6,0.333,2,6,0.333,0,0,,1,2,0.5,4,2,6
15191,Timothe Luwawu-Cabarrot,21-247,F,1/11/17,PHI,,NYK,W,0,12,2,4,0.5,2,3,0.667,0,1,0,1,2,0.5,1,1,2
15192,Timothe Luwawu-Cabarrot,21-235,F,12/30/16,PHI,@,DEN,W,0,11,1,3,0.333,0,2,0,1,1,1,2,2,1,0,1,1
15193,Timothe Luwawu-Cabarrot,21-304,F,3/9/17,PHI,@,POR,L,0,18,1,3,0.333,0,1,0,1,2,0.5,2,2,1,0,0,0
15194,Timothe Luwawu-Cabarrot,21-280,F,2/13/17,PHI,@,CHO,W,0,11,2,4,0.5,1,3,0.333,1,1,1,0,0,,0,0,0
15195,Timothe Luwawu-Cabarrot,21-192,F,11/17/16,PHI,@,MIN,L,0,9,1,5,0.2,0,3,0,1,2,0.5,2,2,1,1,0,1
15196,Trey Lyles,20-355,F,10/25/16,UTA,@,POR,L,0,18,2,6,0.333,1,4,0.25,1,2,0.5,0,0,,0,2,2
15197,Trey Lyles,21-018,F,11/23/16,UTA,,DEN,W,1,15,2,4,0.5,2,2,1,0,2,0,1,1,1,1,6,7
15198,Trey Lyles,21-001,F,11/6/16,UTA,@,NYK,W,0,21,2,6,0.333,1,2,0.5,1,4,0.25,0,0,,0,2,2
15199,Ian Mahinmi,30-128,C,3/13/17,WAS,@,MIN,L,0,22,2,2,1,2,2,1,0,0,,1,1,1,2,5,7
15200,Ian Mahinmi,30-103,C,2/16/17,WAS,@,IND,W,0,13,2,2,1,2,2,1,0,0,,1,4,0.25,0,4,4
15201,Thon Maker,19-302,F-C,12/23/16,MIL,,WAS,W,0,8,2,2,1,1,1,1,1,1,1,0,0,,0,2,2
15202,Thon Maker,19-320,F-C,1/10/17,MIL,@,SAS,W,0,13,2,2,1,1,1,1,1,1,1,0,0,,0,0,0
15203,Boban Marjanovic,28-201,C,3/4/17,DET,@,PHI,W,0,3,2,3,0.667,2,3,0.667,0,0,,1,2,0.5,0,0,0
15204,Jarell Martin,22-190,F,11/30/16,MEM,@,TOR,L,0,24,1,5,0.2,0,3,0,1,2,0.5,2,2,1,0,4,4
15205,Jarell Martin,22-225,F,1/4/17,MEM,@,LAC,L,1,12,1,3,0.333,0,2,0,1,1,1,2,2,1,2,1,3
15206,Luc Mbah a Moute,30-079,F,11/27/16,LAC,@,IND,L,1,12,1,2,0.5,1,1,1,0,1,0,3,4,0.75,0,0,0
15207,Luc Mbah a Moute,30-113,F,12/31/16,LAC,@,OKC,L,1,12,2,6,0.333,2,4,0.5,0,2,0,1,1,1,2,1,3
15208,Luc Mbah a Moute,30-112,F,12/30/16,LAC,@,HOU,L,1,26,2,6,0.333,1,3,0.333,1,3,0.333,0,0,,1,0,1
15209,Luc Mbah a Moute,30-141,F,1/28/17,LAC,@,GSW,L,1,12,1,4,0.25,0,3,0,1,1,1,2,2,1,0,1,1
15210,Luc Mbah a Moute,30-159,F,2/15/17,LAC,,ATL,W,1,15,2,3,0.667,1,1,1,1,2,0.5,0,0,,0,1,1
15211,Luc Mbah a Moute,30-105,F,12/23/16,LAC,,DAL,L,1,37,2,5,0.4,2,3,0.667,0,2,0,1,1,1,1,5,6
15212,Luc Mbah a Moute,30-157,F,2/13/17,LAC,@,UTA,W,1,38,2,5,0.4,1,3,0.333,1,2,0.5,0,0,,1,4,5
15213,James Michael McAdoo,23-302,F,11/1/16,GSW,@,POR,W,0,9,2,3,0.667,2,3,0.667,0,0,,1,2,0.5,0,1,1
15214,Patrick McCaw,21-146,G,3/20/17,GSW,@,OKC,W,1,20,2,2,1,1,1,1,1,1,1,0,0,,2,3,5
15215,Patrick McCaw,21-015,G,11/9/16,GSW,,DAL,W,0,20,2,4,0.5,1,3,0.333,1,1,1,0,0,,0,2,2
15216,Patrick McCaw,21-144,G,3/18/17,GSW,,MIL,W,1,15,2,2,1,2,2,1,0,0,,1,1,1,0,1,1
15217,Patrick McCaw,21-027,G,11/21/16,GSW,@,IND,W,0,12,2,8,0.25,1,4,0.25,1,4,0.25,0,0,,0,0,0
15218,Patrick McCaw,21-099,G,2/1/17,GSW,,CHO,W,0,18,1,5,0.2,0,1,0,1,4,0.25,2,4,0.5,0,1,1
15219,Patrick McCaw,21-022,G,11/16/16,GSW,@,TOR,W,0,21,2,3,0.667,1,1,1,1,2,0.5,0,0,,0,2,2
15220,Patrick McCaw,21-095,G,1/28/17,GSW,,LAC,W,0,18,2,5,0.4,1,1,1,1,4,0.25,0,0,,0,2,2
15221,Sheldon McClellan,24-021,G,1/11/17,WAS,@,BOS,L,0,16,2,3,0.667,1,1,1,1,2,0.5,0,0,,0,4,4
15222,T.J. McConnell,24-239,G,11/19/16,PHI,,PHO,W,0,19,2,6,0.333,2,6,0.333,0,0,,1,2,0.5,1,1,2
15223,T.J. McConnell,24-273,G,12/23/16,PHI,@,PHO,L,0,22,1,6,0.167,0,5,0,1,1,1,2,2,1,1,1,2
15224,T.J. McConnell,24-256,G,12/6/16,PHI,@,MEM,L,0,25,2,5,0.4,1,4,0.25,1,1,1,0,0,,1,1,2
15225,K.J. McDaniels,23-272,G-F,11/7/16,HOU,@,WAS,W,0,14,2,4,0.5,1,2,0.5,1,2,0.5,0,0,,0,1,1
15226,K.J. McDaniels,24-002,G-F,2/11/17,HOU,,PHO,W,0,5,2,4,0.5,1,2,0.5,1,2,0.5,0,0,,2,0,2
15227,K.J. McDaniels,23-267,G-F,11/2/16,HOU,@,NYK,W,0,19,1,3,0.333,0,1,0,1,2,0.5,2,2,1,0,3,3
15228,Doug McDermott,24-298,F,10/27/16,CHI,,BOS,W,0,22,2,5,0.4,2,4,0.5,0,1,0,1,2,0.5,0,1,1
15229,Doug McDermott,24-314,F,11/12/16,CHI,,WAS,W,0,18,2,6,0.333,2,5,0.4,0,1,0,1,1,1,0,1,1
15230,Doug McDermott,25-070,F,3/14/17,OKC,@,BRK,W,0,14,1,4,0.25,0,2,0,1,2,0.5,2,2,1,0,1,1
15231,Doug McDermott,24-348,F,12/16/16,CHI,,MIL,L,0,24,2,8,0.25,2,5,0.4,0,3,0,1,1,1,1,2,3
15232,Doug McDermott,24-357,F,12/25/16,CHI,@,SAS,L,0,27,2,5,0.4,1,3,0.333,1,2,0.5,0,0,,0,2,2
15233,JaVale McGee,29-045,C,3/5/17,GSW,@,NYK,W,0,8,2,3,0.667,2,3,0.667,0,0,,1,2,0.5,1,3,4
15234,JaVale McGee,28-305,C,11/19/16,GSW,@,MIL,W,0,5,2,2,1,2,2,1,0,0,,1,2,0.5,1,2,3
15235,Rodney McGruder,25-154,G,12/30/16,MIA,@,BOS,L,1,29,2,4,0.5,1,1,1,1,3,0.333,0,0,,1,1,2
15236,Rodney McGruder,25-130,G,12/6/16,MIA,,NYK,L,1,35,2,11,0.182,1,7,0.143,1,4,0.25,0,0,,3,3,6
15237,Rodney McGruder,25-115,G,11/21/16,MIA,@,PHI,L,0,18,2,5,0.4,1,1,1,1,4,0.25,0,2,0,4,3,7
15238,Rodney McGruder,25-163,G,1/8/17,MIA,@,LAC,L,1,34,1,7,0.143,0,1,0,1,6,0.167,2,2,1,2,1,3
15239,Rodney McGruder,25-213,G,2/27/17,MIA,@,DAL,L,1,25,2,5,0.4,1,2,0.5,1,3,0.333,0,0,,1,1,2
15240,Ben McLemore,23-321,G,12/28/16,SAC,@,POR,L,1,19,2,9,0.222,2,7,0.286,0,2,0,1,1,1,0,0,0
15241,Ben McLemore,23-271,G,11/8/16,SAC,,NOP,W,0,16,2,3,0.667,1,1,1,1,2,0.5,0,0,,1,3,4
15242,Ben McLemore,23-268,G,11/5/16,SAC,@,MIL,L,0,23,2,8,0.25,2,6,0.333,0,2,0,1,2,0.5,0,1,1
15243,Ben McLemore,23-311,G,12/18/16,SAC,@,DAL,L,1,27,2,5,0.4,1,3,0.333,1,2,0.5,0,0,,0,3,3
15244,Jordan McRae,25-270,G,12/23/16,CLE,,BRK,W,0,16,1,5,0.2,1,4,0.25,0,1,0,3,4,0.75,0,0,0
15245,Jordan McRae,25-289,G,1/11/17,CLE,@,POR,L,0,7,2,2,1,1,1,1,1,1,1,0,0,,0,1,1
15246,Josh McRoberts,29-296,F,12/20/16,MIA,,ORL,L,1,16,2,4,0.5,2,4,0.5,0,0,,1,2,0.5,1,0,1
15247,Josh McRoberts,29-290,F,12/14/16,MIA,,IND,W,1,18,2,2,1,1,1,1,1,1,1,0,0,,1,3,4
15248,Josh McRoberts,29-271,F,11/25/16,MIA,@,MEM,W,0,12,2,7,0.286,2,7,0.286,0,0,,1,2,0.5,1,4,5
15249,Jodie Meeks,29-150,G,1/18/17,ORL,@,NOP,L,1,16,2,6,0.333,2,4,0.5,0,2,0,1,1,1,0,4,4
15250,Salah Mejri,30-147,C,11/9/16,DAL,@,GSW,L,0,14,2,2,1,2,2,1,0,0,,1,1,1,0,5,5
15251,Salah Mejri,30-254,C,2/24/17,DAL,@,MIN,L,0,19,2,4,0.5,2,4,0.5,0,0,,1,2,0.5,1,6,7
15252,Salah Mejri,30-191,C,12/23/16,DAL,@,LAC,W,0,21,1,1,1,1,1,1,0,0,,3,5,0.6,5,3,8
15253,Khris Middleton,25-180,F-G,2/8/17,MIL,,MIA,L,0,15,2,5,0.4,2,4,0.5,0,1,0,1,2,0.5,0,2,2
15254,C.J. Miles,29-241,G-F,12/15/16,IND,@,NOP,L,0,30,1,9,0.111,0,3,0,1,6,0.167,2,2,1,0,5,5
15255,C.J. Miles,29-301,G-F,2/13/17,IND,,SAS,L,0,22,2,7,0.286,1,2,0.5,1,5,0.2,0,0,,1,3,4
15256,Patty Mills,28-207,G,3/6/17,SAS,,HOU,W,0,19,2,7,0.286,1,3,0.333,1,4,0.25,0,0,,0,2,2
15257,Patty Mills,28-097,G,11/16/16,SAS,@,SAC,W,0,19,2,4,0.5,1,1,1,1,3,0.333,0,0,,0,2,2
15258,Patty Mills,28-147,G,1/5/17,SAS,@,DEN,W,0,18,2,6,0.333,1,3,0.333,1,3,0.333,0,0,,0,1,1
15259,Patty Mills,28-181,G,2/8/17,SAS,@,PHI,W,0,18,2,5,0.4,1,2,0.5,1,3,0.333,0,0,,0,3,3
15260,Patty Mills,28-126,G,12/15/16,SAS,@,PHO,W,0,18,2,9,0.222,1,3,0.333,1,6,0.167,0,0,,0,1,1
15261,Patty Mills,28-143,G,1/1/17,SAS,@,ATL,L,0,21,2,8,0.25,1,4,0.25,1,4,0.25,0,0,,0,0,0
15262,Patty Mills,28-210,G,3/9/17,SAS,@,OKC,L,0,22,2,7,0.286,1,3,0.333,1,4,0.25,0,0,,0,0,0
15263,Nikola Mirotic,25-306,F,12/13/16,CHI,,MIN,L,0,20,1,5,0.2,1,1,1,0,4,0,3,4,0.75,1,4,5
15264,Nikola Mirotic,25-365,F,2/10/17,CHI,@,PHO,L,0,14,2,6,0.333,1,2,0.5,1,4,0.25,0,0,,0,4,4
15265,Nikola Mirotic,25-344,F,1/20/17,CHI,@,ATL,L,0,17,1,6,0.167,1,1,1,0,5,0,3,4,0.75,1,3,4
15266,Nikola Mirotic,25-299,F,12/6/16,CHI,@,DET,L,0,23,2,7,0.286,1,3,0.333,1,4,0.25,0,0,,0,6,6
15267,Nikola Mirotic,26-019,F,3/2/17,CHI,,GSW,W,0,16,2,7,0.286,1,3,0.333,1,4,0.25,0,0,,0,2,2
15268,Nikola Mirotic,26-035,F,3/18/17,CHI,,UTA,W,1,17,2,7,0.286,1,2,0.5,1,5,0.2,0,0,,0,4,4
15269,E'Twaun Moore,27-248,G,11/2/16,NOP,@,MEM,L,1,27,2,6,0.333,2,3,0.667,0,3,0,1,2,0.5,0,3,3
15270,E'Twaun Moore,27-299,G,12/23/16,NOP,,MIA,W,0,26,2,6,0.333,1,4,0.25,1,2,0.5,0,1,0,0,3,3
15271,E'Twaun Moore,27-319,G,1/12/17,NOP,@,BRK,W,0,19,2,5,0.4,1,3,0.333,1,2,0.5,0,0,,0,1,1
15272,E'Twaun Moore,27-294,G,12/18/16,NOP,@,SAS,L,1,24,2,5,0.4,1,4,0.25,1,1,1,0,0,,0,1,1
15273,E'Twaun Moore,27-330,G,1/23/17,NOP,,CLE,W,0,24,2,8,0.25,2,5,0.4,0,3,0,1,2,0.5,1,3,4
15274,Markieff Morris,27-068,F,11/9/16,WAS,,BOS,W,1,17,2,6,0.333,1,5,0.2,1,1,1,0,0,,0,6,6
15275,Markieff Morris,27-080,F,11/21/16,WAS,,PHO,W,1,26,2,8,0.25,2,6,0.333,0,2,0,1,4,0.25,4,1,5
15276,Markieff Morris,27-194,F,3/15/17,WAS,,DAL,L,1,32,2,6,0.333,2,4,0.5,0,2,0,1,2,0.5,1,6,7
15277,Anthony Morrow,31-054,G,11/20/16,OKC,,IND,L,0,7,2,5,0.4,2,2,1,0,3,0,1,2,0.5,0,1,1
15278,Anthony Morrow,31-139,G,2/13/17,OKC,@,WAS,L,0,16,2,8,0.25,1,2,0.5,1,6,0.167,0,0,,0,1,1
15279,Anthony Morrow,31-111,G,1/16/17,OKC,@,LAC,L,0,5,1,1,1,0,0,,1,1,1,2,2,1,0,0,0
15280,Anthony Morrow,31-137,G,2/11/17,OKC,,GSW,L,0,17,1,5,0.2,0,3,0,1,2,0.5,2,2,1,1,0,1
15281,Anthony Morrow,31-099,G,1/4/17,OKC,@,CHO,L,0,4,2,4,0.5,1,2,0.5,1,2,0.5,0,0,,0,0,0
15282,Timofey Mozgov,30-134,C,11/27/16,LAL,,ATL,W,1,20,2,5,0.4,2,5,0.4,0,0,,1,2,0.5,2,3,5
15283,Timofey Mozgov,30-174,C,1/6/17,LAL,,MIA,W,1,16,2,4,0.5,2,4,0.5,0,0,,1,2,0.5,0,2,2
15284,Emmanuel Mudiay,20-304,G,1/3/17,DEN,,SAC,L,1,28,2,8,0.25,1,3,0.333,1,5,0.2,0,0,,1,1,2
15285,Emmanuel Mudiay,20-262,G,11/22/16,DEN,,CHI,W,1,27,1,7,0.143,0,4,0,1,3,0.333,2,2,1,0,1,1
15286,Shabazz Muhammad,24-089,F-G,2/10/17,MIN,,NOP,L,0,22,2,8,0.25,2,5,0.4,0,3,0,1,2,0.5,1,1,2
15287,Shabazz Muhammad,24-055,F-G,1/7/17,MIN,,UTA,L,0,18,2,3,0.667,1,1,1,1,2,0.5,0,0,,0,3,3
15288,Shabazz Muhammad,24-103,F-G,2/24/17,MIN,,DAL,W,0,16,2,6,0.333,2,4,0.5,0,2,0,1,1,1,0,2,2
15289,Shabazz Muhammad,24-030,F-G,12/13/16,MIN,@,CHI,W,0,13,2,5,0.4,2,5,0.4,0,0,,1,2,0.5,1,0,1
15290,Shabazz Muhammad,24-045,F-G,12/28/16,MIN,@,DEN,L,0,19,2,4,0.5,1,3,0.333,1,1,1,0,0,,1,1,2
15291,Shabazz Muhammad,23-356,F-G,11/3/16,MIN,,DEN,L,0,13,2,5,0.4,1,4,0.25,1,1,1,0,0,,1,0,1
15292,Jamal Murray,19-269,G,11/18/16,DEN,,TOR,L,0,19,2,8,0.25,2,5,0.4,0,3,0,1,2,0.5,1,1,2
15293,Jamal Murray,19-336,G,1/24/17,DEN,,UTA,W,0,17,1,3,0.333,1,2,0.5,0,1,0,3,4,0.75,0,2,2
15294,Jamal Murray,19-314,G,1/2/17,DEN,@,GSW,L,0,19,2,7,0.286,1,2,0.5,1,5,0.2,0,0,,1,3,4
15295,Jamal Murray,19-333,G,1/21/17,DEN,,LAC,W,0,19,2,7,0.286,1,4,0.25,1,3,0.333,0,0,,0,1,1
15296,Jamal Murray,19-329,G,1/17/17,DEN,@,LAL,W,0,13,2,5,0.4,1,2,0.5,1,3,0.333,0,0,,0,1,1
15297,Mike Muscala,25-127,F-C,11/5/16,ATL,,HOU,W,0,21,2,3,0.667,1,2,0.5,1,1,1,0,0,,1,2,3
15298,Mike Muscala,25-144,F-C,11/22/16,ATL,,NOP,L,0,15,1,4,0.25,1,3,0.333,0,1,0,3,4,0.75,2,4,6
15299,Mike Muscala,25-218,F-C,2/4/17,ATL,,ORL,W,0,20,1,2,0.5,0,0,,1,2,0.5,2,2,1,1,3,4
15300,Mike Muscala,25-262,F-C,3/20/17,ATL,@,CHO,L,0,6,2,3,0.667,1,1,1,1,2,0.5,0,0,,1,0,1
15301,Mike Muscala,25-182,F-C,12/30/16,ATL,,DET,W,0,18,2,5,0.4,1,2,0.5,1,3,0.333,0,0,,2,3,5
15302,Larry Nance Jr.,24-077,F,3/19/17,LAL,,CLE,L,0,14,2,5,0.4,1,4,0.25,1,1,1,0,0,,1,1,2
15303,Larry Nance Jr.,23-301,F,10/28/16,LAL,@,UTA,L,0,16,2,4,0.5,1,2,0.5,1,2,0.5,0,1,0,0,3,3
15304,Larry Nance Jr.,23-299,F,10/26/16,LAL,,HOU,W,0,23,2,5,0.4,2,4,0.5,0,1,0,1,2,0.5,3,2,5
15305,Shabazz Napier,25-129,G,11/20/16,POR,@,BRK,W,0,5,1,2,0.5,0,0,,1,2,0.5,2,2,1,0,0,0
15306,Shabazz Napier,25-159,G,12/20/16,POR,@,SAC,L,0,17,2,8,0.25,1,3,0.333,1,5,0.2,0,0,,0,1,1
15307,Shabazz Napier,25-244,G,3/15/17,POR,@,SAS,W,0,15,2,5,0.4,1,2,0.5,1,3,0.333,0,0,,0,5,5
15308,Jameer Nelson,35-039,G,3/20/17,DEN,@,HOU,L,1,31,2,9,0.222,1,5,0.2,1,4,0.25,0,0,,0,6,6
15309,Jameer Nelson,34-283,G,11/18/16,DEN,,TOR,L,1,37,2,6,0.333,1,3,0.333,1,3,0.333,0,0,,0,3,3
15310,Jameer Nelson,34-297,G,12/2/16,DEN,,HOU,L,0,19,2,5,0.4,1,2,0.5,1,3,0.333,0,0,,0,1,1
15311,Jameer Nelson,35-032,G,3/13/17,DEN,,LAL,W,1,29,2,5,0.4,1,1,1,1,4,0.25,0,0,,0,4,4
15312,Jameer Nelson,34-328,G,1/2/17,DEN,@,GSW,L,0,17,2,4,0.5,2,2,1,0,2,0,1,1,1,0,0,0
15313,Jameer Nelson,34-345,G,1/19/17,DEN,@,SAS,L,0,27,2,7,0.286,1,3,0.333,1,4,0.25,0,0,,0,2,2
15314,Jameer Nelson,35-027,G,3/8/17,DEN,,WAS,L,1,24,2,6,0.333,2,4,0.5,0,2,0,1,2,0.5,1,2,3
15315,Jameer Nelson,34-321,G,12/26/16,DEN,@,LAC,W,0,30,2,10,0.2,1,4,0.25,1,6,0.167,0,0,,0,1,1
15316,Raul Neto,24-229,G,1/3/17,UTA,@,BOS,L,0,14,2,4,0.5,1,2,0.5,1,2,0.5,0,0,,0,2,2
15317,Raul Neto,24-203,G,12/8/16,UTA,,GSW,L,0,14,2,5,0.4,1,3,0.333,1,2,0.5,0,0,,0,2,2
15318,Raul Neto,24-293,G,3/8/17,UTA,@,HOU,W,0,21,2,6,0.333,1,3,0.333,1,3,0.333,0,0,,1,0,1
15319,Georges Niang,23-161,F,11/25/16,IND,,BRK,W,0,6,2,6,0.333,1,3,0.333,1,3,0.333,0,0,,0,0,0
15320,Joakim Noah,31-286,C,12/7/16,NYK,,CLE,L,1,15,2,3,0.667,2,3,0.667,0,0,,1,2,0.5,2,4,6
15321,Nerlens Noel,22-285,C-F,1/20/17,PHI,,POR,W,0,21,1,4,0.25,1,4,0.25,0,0,,3,4,0.75,2,7,9
15322,Nerlens Noel,22-283,C-F,1/18/17,PHI,,TOR,W,0,21,2,5,0.4,2,5,0.4,0,0,,1,2,0.5,0,2,2
15323,Nerlens Noel,22-292,C-F,1/27/17,PHI,,HOU,L,0,20,2,3,0.667,2,3,0.667,0,0,,1,2,0.5,1,3,4
15324,Nerlens Noel,22-302,C-F,2/6/17,PHI,@,DET,L,0,16,2,4,0.5,2,4,0.5,0,0,,1,2,0.5,2,3,5
15325,Lucas Nogueira,24-139,C,12/12/16,TOR,,MIL,W,0,20,2,3,0.667,2,3,0.667,0,0,,1,2,0.5,3,2,5
15326,Dirk Nowitzki,38-138,F,11/4/16,DAL,,POR,L,1,16,2,6,0.333,2,6,0.333,0,0,,1,1,1,0,7,7
15327,Jusuf Nurkic,22-149,C,1/19/17,DEN,@,SAS,L,0,14,2,5,0.4,2,5,0.4,0,0,,1,5,0.2,0,1,1
15328,Jusuf Nurkic,22-116,C,12/17/16,DEN,,NYK,W,0,8,2,5,0.4,2,5,0.4,0,0,,1,2,0.5,1,0,1
15329,Jusuf Nurkic,22-158,C,1/28/17,DEN,@,PHO,W,1,15,2,4,0.5,2,4,0.5,0,0,,1,1,1,0,4,4
15330,Johnny O'Bryant,23-257,F-C,2/13/17,DEN,,GSW,W,0,12,1,1,1,0,0,,1,1,1,2,2,1,2,1,3
15331,Johnny O'Bryant,23-248,F-C,2/4/17,DEN,@,SAS,L,0,9,2,3,0.667,1,2,0.5,1,1,1,0,0,,0,2,2
15332,Kyle O'Quinn,26-287,F-C,1/7/17,NYK,@,IND,L,0,11,2,2,1,2,2,1,0,0,,1,1,1,0,1,1
15333,Kyle O'Quinn,26-264,F-C,12/15/16,NYK,@,GSW,L,0,15,2,4,0.5,2,4,0.5,0,0,,1,3,0.333,2,5,7
15334,Kelly Olynyk,25-259,C-F,1/3/17,BOS,,UTA,W,0,21,2,6,0.333,2,2,1,0,4,0,1,2,0.5,1,6,7
15335,Kelly Olynyk,25-313,C-F,2/26/17,BOS,@,DET,W,0,19,2,8,0.25,1,5,0.2,1,3,0.333,0,0,,0,6,6
15336,Kelly Olynyk,25-209,C-F,11/14/16,BOS,@,NOP,L,1,35,1,8,0.125,0,1,0,1,7,0.143,2,2,1,0,8,8
15337,Kelly Olynyk,25-255,C-F,12/30/16,BOS,,MIA,W,0,19,2,7,0.286,2,5,0.4,0,2,0,1,2,0.5,0,2,2
15338,Kelly Olynyk,25-286,C-F,1/30/17,BOS,,DET,W,0,20,2,3,0.667,2,2,1,0,1,0,1,2,0.5,0,4,4
15339,Kelly Olynyk,25-252,C-F,12/27/16,BOS,,MEM,W,0,18,2,4,0.5,1,1,1,1,3,0.333,0,0,,1,6,7
15340,Kelly Olynyk,25-234,C-F,12/9/16,BOS,,TOR,L,0,23,2,6,0.333,2,4,0.5,0,2,0,1,2,0.5,1,8,9
15341,Kelly Olynyk,25-281,C-F,1/25/17,BOS,,HOU,W,0,17,2,4,0.5,2,3,0.667,0,1,0,1,2,0.5,2,2,4
15342,Kelly Olynyk,25-214,C-F,11/19/16,BOS,@,DET,W,0,14,2,3,0.667,1,1,1,1,2,0.5,0,0,,0,1,1
15343,Kelly Oubre,21-081,F,2/28/17,WAS,,GSW,W,0,17,2,4,0.5,1,1,1,1,3,0.333,0,0,,0,2,2
15344,Kelly Oubre,20-332,F,11/5/16,WAS,@,ORL,L,0,17,2,5,0.4,1,4,0.25,1,1,1,0,0,,0,0,0
15345,Kelly Oubre,20-348,F,11/21/16,WAS,,PHO,W,0,25,2,5,0.4,2,3,0.667,0,2,0,1,4,0.25,0,4,4
15346,Kelly Oubre,21-017,F,12/26/16,WAS,,MIL,W,0,17,2,6,0.333,1,2,0.5,1,4,0.25,0,0,,1,1,2
15347,Kelly Oubre,21-014,F,12/23/16,WAS,@,MIL,L,0,14,2,4,0.5,1,1,1,1,3,0.333,0,0,,0,3,3
15348,Kelly Oubre,20-326,F,10/30/16,WAS,@,MEM,L,0,15,2,4,0.5,2,2,1,0,2,0,1,1,1,1,1,2
15349,Kelly Oubre,21-099,F,3/18/17,WAS,@,CHO,L,0,20,2,3,0.667,1,2,0.5,1,1,1,0,0,,0,1,1
15350,Kelly Oubre,20-323,F,10/27/16,WAS,@,ATL,L,0,22,1,6,0.167,0,2,0,1,4,0.25,2,4,0.5,0,1,1
15351,Kelly Oubre,21-010,F,12/19/16,WAS,@,IND,L,0,19,2,8,0.25,2,6,0.333,0,2,0,1,2,0.5,4,3,7
15352,Zaza Pachulia,32-265,C,11/1/16,GSW,@,POR,W,1,19,2,3,0.667,2,3,0.667,0,0,,1,2,0.5,1,5,6
15353,Zaza Pachulia,32-263,C,10/30/16,GSW,@,PHO,W,1,22,1,5,0.2,1,5,0.2,0,0,,3,3,1,4,6,10
15354,Zaza Pachulia,32-343,C,1/18/17,GSW,,OKC,W,1,19,1,5,0.2,1,5,0.2,0,0,,3,5,0.6,3,3,6
15355,Tony Parker,34-274,G,2/15/17,SAS,@,ORL,W,1,23,2,10,0.2,2,7,0.286,0,3,0,1,2,0.5,0,0,0
15356,Chandler Parsons,28-080,F,1/13/17,MEM,@,HOU,W,1,19,1,7,0.143,0,2,0,1,5,0.2,2,2,1,0,2,2
15357,Chandler Parsons,28-137,F,3/11/17,MEM,,ATL,L,1,23,2,7,0.286,1,5,0.2,1,2,0.5,0,0,,1,1,2
15358,Patrick Patterson,27-362,F,3/11/17,TOR,@,MIA,L,0,18,1,2,0.5,0,1,0,1,1,1,2,2,1,0,2,2
15359,Patrick Patterson,27-273,F,12/12/16,TOR,,MIL,W,0,25,2,2,1,1,1,1,1,1,1,0,0,,1,3,4
15360,Patrick Patterson,27-254,F,11/23/16,TOR,@,HOU,W,0,27,1,3,0.333,0,1,0,1,2,0.5,2,2,1,1,4,5
15361,Patrick Patterson,27-270,F,12/9/16,TOR,@,BOS,W,0,30,2,7,0.286,1,3,0.333,1,4,0.25,0,0,,2,8,10
15362,Patrick Patterson,27-355,F,3/4/17,TOR,@,MIL,L,0,19,2,4,0.5,1,2,0.5,1,2,0.5,0,0,,0,2,2
15363,Patrick Patterson,27-289,F,12/28/16,TOR,@,GSW,L,0,33,2,9,0.222,1,4,0.25,1,5,0.2,0,0,,1,4,5
15364,Patrick Patterson,27-247,F,11/16/16,TOR,,GSW,L,0,25,2,7,0.286,1,4,0.25,1,3,0.333,0,0,,1,3,4
15365,Patrick Patterson,27-263,F,12/2/16,TOR,,LAL,W,0,24,2,4,0.5,1,1,1,1,3,0.333,0,0,,1,6,7
15366,Patrick Patterson,27-228,F,10/28/16,TOR,,CLE,L,0,34,2,6,0.333,1,1,1,1,5,0.2,0,0,,1,5,6
15367,Chris Paul,31-316,G,3/18/17,LAC,,CLE,W,1,27,0,8,0,0,3,0,0,5,0,5,5,1,0,4,4
15368,Cameron Payne,22-170,G,1/25/17,OKC,@,NOP,W,0,12,2,6,0.333,1,3,0.333,1,3,0.333,0,0,,0,0,0
15369,Cameron Payne,22-168,G,1/23/17,OKC,@,UTA,W,0,14,2,6,0.333,1,3,0.333,1,3,0.333,0,0,,0,1,1
15370,Elfrid Payton,22-268,G,11/16/16,ORL,,NOP,W,1,30,2,9,0.222,2,6,0.333,0,3,0,1,2,0.5,1,3,4
15371,Paul Pierce,39-154,F-G,3/16/17,LAC,@,DEN,L,0,16,2,7,0.286,1,2,0.5,1,5,0.2,0,0,,0,4,4
15372,Paul Pierce,39-050,F-G,12/2/16,LAC,@,NOP,W,0,9,1,2,0.5,0,0,,1,2,0.5,2,2,1,0,0,0
15373,Paul Pierce,39-079,F-G,12/31/16,LAC,@,OKC,L,1,16,2,5,0.4,2,4,0.5,0,1,0,1,2,0.5,0,3,3
15374,Paul Pierce,39-047,F-G,11/29/16,LAC,@,BRK,L,1,29,1,7,0.143,0,2,0,1,5,0.2,2,2,1,0,3,3
15375,Paul Pierce,39-073,F-G,12/25/16,LAC,@,LAL,L,1,12,2,4,0.5,1,2,0.5,1,2,0.5,0,0,,0,3,3
15376,Paul Pierce,39-037,F-G,11/19/16,LAC,,CHI,W,0,9,2,4,0.5,1,1,1,1,3,0.333,0,0,,0,0,0
15377,Marshall Plumlee,24-188,C,1/18/17,NYK,@,BOS,W,0,20,2,2,1,2,2,1,0,0,,1,3,0.333,3,4,7
15378,Mason Plumlee,26-364,C-F,3/4/17,DEN,,CHO,L,0,15,2,4,0.5,2,4,0.5,0,0,,1,1,1,3,3,6
15379,Miles Plumlee,28-085,C-F,11/25/16,MIL,,TOR,L,1,20,2,2,1,2,2,1,0,0,,1,2,0.5,1,2,3
15380,Miles Plumlee,28-111,C-F,12/21/16,MIL,@,CLE,L,0,11,2,4,0.5,2,4,0.5,0,0,,1,2,0.5,0,0,0
15381,Jakob Poeltl,21-120,C,2/12/17,TOR,,DET,L,1,20,2,3,0.667,2,3,0.667,0,0,,1,2,0.5,2,2,4
15382,Bobby Portis,21-281,F,11/17/16,CHI,@,UTA,W,0,10,1,3,0.333,0,1,0,1,2,0.5,2,2,1,0,0,0
15383,Bobby Portis,22-031,F,3/13/17,CHI,@,CHO,W,1,20,2,7,0.286,1,4,0.25,1,3,0.333,0,0,,0,7,7
15384,Norman Powell,23-187,G,11/28/16,TOR,,PHI,W,0,11,1,3,0.333,1,3,0.333,0,0,,3,3,1,0,0,0
15385,Norman Powell,23-233,G,1/13/17,TOR,,BRK,W,0,13,2,5,0.4,1,3,0.333,1,2,0.5,0,0,,0,0,0
15386,Norman Powell,23-161,G,11/2/16,TOR,@,WAS,W,0,15,2,3,0.667,1,1,1,1,2,0.5,0,0,,0,3,3
15387,Norman Powell,23-257,G,2/6/17,TOR,,LAC,W,0,12,2,4,0.5,1,1,1,1,3,0.333,0,0,,0,1,1
15388,Norman Powell,23-238,G,1/18/17,TOR,@,PHI,L,0,18,2,6,0.333,1,4,0.25,1,2,0.5,0,0,,1,2,3
15389,Tim Quarterman,22-034,G,11/30/16,POR,,IND,W,0,2,2,2,1,1,1,1,1,1,1,0,0,,0,0,0
15390,Chasson Randle,24-001,G,2/6/17,PHI,@,DET,L,0,5,1,1,1,1,1,1,0,0,,3,3,1,0,0,0
15391,Chasson Randle,23-363,G,2/2/17,PHI,@,SAS,L,0,15,2,6,0.333,1,4,0.25,1,2,0.5,0,0,,0,1,1
15392,Julius Randle,22-096,F,3/5/17,LAL,,NOP,L,1,33,2,7,0.286,2,7,0.286,0,0,,1,2,0.5,2,10,12
15393,J.J. Redick,32-156,G,11/27/16,LAC,@,IND,L,1,22,1,7,0.143,0,2,0,1,5,0.2,2,2,1,0,2,2
15394,J.J. Redick,32-190,G,12/31/16,LAC,@,OKC,L,1,20,2,9,0.222,1,3,0.333,1,6,0.167,0,1,0,0,1,1
15395,Willie Reed,26-268,F-C,2/8/17,MIA,@,MIL,W,0,14,2,5,0.4,1,4,0.25,1,1,1,0,0,,1,4,5
15396,Willie Reed,26-266,F-C,2/6/17,MIA,@,MIN,W,0,12,2,6,0.333,2,6,0.333,0,0,,1,1,1,4,2,6
15397,Willie Reed,26-227,F-C,12/29/16,MIA,@,CHO,L,0,13,2,3,0.667,2,3,0.667,0,0,,1,1,1,1,6,7
15398,Josh Richardson,23-183,G,3/17/17,MIA,,MIN,W,0,32,1,5,0.2,1,5,0.2,0,0,,3,4,0.75,1,3,4
15399,Josh Richardson,23-172,G,3/6/17,MIA,@,CLE,W,0,32,1,4,0.25,1,2,0.5,0,2,0,3,4,0.75,0,2,2
15400,Malachi Richardson,21-018,G,1/23/17,SAC,@,DET,W,0,14,2,4,0.5,2,4,0.5,0,0,,1,2,0.5,0,0,0
15401,Austin Rivers,24-209,G,2/26/17,LAC,,CHO,W,0,20,2,8,0.25,2,3,0.667,0,5,0,1,1,1,1,0,1
15402,Austin Rivers,24-188,G,2/5/17,LAC,@,BOS,L,1,34,1,8,0.125,1,4,0.25,0,4,0,3,4,0.75,1,2,3
15403,Austin Rivers,24-125,G,12/4/16,LAC,,IND,L,0,15,2,4,0.5,2,3,0.667,0,1,0,1,2,0.5,1,2,3
15404,Andre Roberson,25-043,G-F,1/16/17,OKC,@,LAC,L,1,26,2,5,0.4,1,1,1,1,4,0.25,0,0,,1,4,5
15405,Andre Roberson,25-059,G-F,2/1/17,OKC,,CHI,L,1,30,2,5,0.4,1,1,1,1,4,0.25,0,0,,0,6,6
15406,Andre Roberson,24-339,G-F,11/7/16,OKC,,MIA,W,1,30,2,4,0.5,2,4,0.5,0,0,,1,2,0.5,1,4,5
15407,Andre Roberson,24-354,G-F,11/22/16,OKC,@,LAL,L,1,27,2,5,0.4,1,2,0.5,1,3,0.333,0,2,0,1,2,3
15408,Andre Roberson,25-019,G-F,12/23/16,OKC,@,BOS,W,1,38,2,4,0.5,2,3,0.667,0,1,0,1,6,0.167,0,5,5
15409,Brian Roberts,31-013,G,12/16/16,CHO,@,BOS,L,0,16,1,5,0.2,1,5,0.2,0,0,,3,4,0.75,1,0,1
15410,Glenn Robinson,22-337,G-F,12/10/16,IND,,POR,W,0,14,2,2,1,1,1,1,1,1,1,0,0,,0,1,1
15411,Glenn Robinson,22-346,G-F,12/19/16,IND,,WAS,W,1,31,2,5,0.4,1,2,0.5,1,3,0.333,0,0,,0,4,4
15412,Glenn Robinson,23-050,G-F,2/27/17,IND,@,HOU,W,0,9,2,2,1,1,1,1,1,1,1,0,0,,0,1,1
15413,Glenn Robinson,23-047,G-F,2/24/17,IND,,MEM,W,0,14,2,4,0.5,1,2,0.5,1,2,0.5,0,0,,2,1,3
15414,Glenn Robinson,23-012,G-F,1/20/17,IND,@,LAL,L,1,22,2,4,0.5,1,2,0.5,1,2,0.5,0,2,0,1,1,2
15415,Thomas Robinson,25-267,F,12/9/16,LAL,,PHO,L,0,11,1,1,1,1,1,1,0,0,,3,4,0.75,2,3,5
15416,Sergio Rodriguez,30-232,G,1/30/17,PHI,,SAC,W,0,14,2,5,0.4,1,2,0.5,1,3,0.333,0,0,,0,0,0
15417,Sergio Rodriguez,30-267,G,3/6/17,PHI,,MIL,L,0,24,2,7,0.286,1,3,0.333,1,4,0.25,0,0,,0,3,3
15418,Sergio Rodriguez,30-177,G,12/6/16,PHI,@,MEM,L,1,23,2,7,0.286,1,3,0.333,1,4,0.25,0,0,,0,3,3
15419,Sergio Rodriguez,30-234,G,2/1/17,PHI,@,DAL,L,0,13,2,6,0.333,1,2,0.5,1,4,0.25,0,0,,0,2,2
15420,Rajon Rondo,31-010,G,3/4/17,CHI,,LAC,L,0,29,2,7,0.286,1,6,0.167,1,1,1,0,0,,1,3,4
15421,Rajon Rondo,30-297,G,12/15/16,CHI,@,MIL,L,1,29,2,6,0.333,1,2,0.5,1,4,0.25,0,0,,0,5,5
15422,Rajon Rondo,30-310,G,12/28/16,CHI,,BRK,W,1,35,2,8,0.25,1,7,0.143,1,1,1,0,0,,2,7,9
15423,Rajon Rondo,31-024,G,3/18/17,CHI,,UTA,W,1,21,2,5,0.4,1,3,0.333,1,2,0.5,0,0,,0,2,2
15424,Rajon Rondo,30-350,G,2/6/17,CHI,@,SAC,W,0,20,2,6,0.333,2,4,0.5,0,2,0,1,2,0.5,0,2,2
15425,Derrick Rose,28-125,G,2/6/17,NYK,,LAL,L,1,32,2,8,0.25,2,7,0.286,0,1,0,1,1,1,0,4,4
15426,Terrence Ross,26-029,F-G,3/6/17,ORL,,NYK,L,1,35,2,10,0.2,1,4,0.25,1,6,0.167,0,0,,0,4,4
15427,Terrence Ross,25-350,F-G,1/20/17,TOR,@,CHO,L,0,27,2,9,0.222,1,5,0.2,1,4,0.25,0,0,,0,4,4
15428,Terry Rozier,22-356,G,3/8/17,BOS,@,GSW,W,0,14,2,6,0.333,1,2,0.5,1,4,0.25,0,0,,0,1,1
15429,Terry Rozier,22-321,G,2/1/17,BOS,,TOR,W,0,23,2,7,0.286,1,5,0.2,1,2,0.5,0,0,,2,5,7
15430,Terry Rozier,22-226,G,10/29/16,BOS,@,CHO,W,0,21,2,4,0.5,2,3,0.667,0,1,0,1,1,1,0,3,3
15431,Terry Rozier,22-354,G,3/6/17,BOS,@,LAC,L,0,20,2,7,0.286,1,3,0.333,1,4,0.25,0,0,,0,2,2
15432,Terry Rozier,22-244,G,11/16/16,BOS,,DAL,W,0,22,2,4,0.5,1,3,0.333,1,1,1,0,0,,0,3,3
15433,Terry Rozier,22-276,G,12/18/16,BOS,@,MIA,W,0,18,2,3,0.667,2,3,0.667,0,0,,1,2,0.5,0,1,1
15434,Terry Rozier,22-319,G,1/30/17,BOS,,DET,W,0,11,2,3,0.667,1,1,1,1,2,0.5,0,0,,0,1,1
15435,Terry Rozier,22-331,G,2/11/17,BOS,@,UTA,W,0,23,1,5,0.2,1,4,0.25,0,1,0,3,4,0.75,1,3,4
15436,Terry Rozier,22-223,G,10/26/16,BOS,,BRK,W,0,28,2,5,0.4,1,3,0.333,1,2,0.5,0,0,,0,3,3
15437,Terry Rozier,22-256,G,11/28/16,BOS,@,MIA,W,0,13,2,4,0.5,1,1,1,1,3,0.333,0,0,,0,3,3
15438,Terry Rozier,22-314,G,1/25/17,BOS,,HOU,W,0,19,2,7,0.286,1,4,0.25,1,3,0.333,0,0,,1,2,3
15439,Terry Rozier,22-234,G,11/6/16,BOS,,DEN,L,0,16,2,6,0.333,1,3,0.333,1,3,0.333,0,0,,0,2,2
15440,Terry Rozier,22-247,G,11/19/16,BOS,@,DET,W,0,14,1,3,0.333,0,1,0,1,2,0.5,2,2,1,1,4,5
15441,Terry Rozier,22-307,G,1/18/17,BOS,,NYK,L,0,24,1,8,0.125,0,4,0,1,4,0.25,2,2,1,0,1,1
15442,Ricky Rubio,26-116,G,2/14/17,MIN,,CLE,L,1,39,2,8,0.25,2,6,0.333,0,2,0,1,2,0.5,1,7,8
15443,Ricky Rubio,26-008,G,10/29/16,MIN,@,SAC,L,1,28,2,4,0.5,2,3,0.667,0,1,0,1,1,1,0,1,1
15444,Ricky Rubio,26-110,G,2/8/17,MIN,,TOR,W,1,21,2,7,0.286,1,6,0.167,1,1,1,0,0,,0,1,1
15445,Ricky Rubio,26-074,G,1/3/17,MIN,@,PHI,L,1,30,2,3,0.667,1,1,1,1,2,0.5,0,0,,1,2,3
15446,Ricky Rubio,26-070,G,12/30/16,MIN,,MIL,W,1,35,2,4,0.5,1,1,1,1,3,0.333,0,0,,1,0,1
15447,Damjan Rudez,30-239,F,2/11/17,ORL,@,DAL,L,0,12,2,6,0.333,1,3,0.333,1,3,0.333,0,0,,0,0,0
15448,Brandon Rush,31-114,G-F,10/29/16,MIN,@,SAC,L,0,12,2,3,0.667,1,1,1,1,2,0.5,0,0,,0,1,1
15449,Brandon Rush,31-214,G-F,2/6/17,MIN,,MIA,L,1,33,2,4,0.5,1,2,0.5,1,2,0.5,0,0,,0,3,3
15450,Brandon Rush,31-235,G-F,2/27/17,MIN,@,SAC,W,1,19,2,5,0.4,1,3,0.333,1,2,0.5,0,0,,0,2,2
15451,Brandon Rush,31-212,G-F,2/4/17,MIN,,MEM,L,1,24,1,5,0.2,0,2,0,1,3,0.333,2,2,1,1,2,3
15452,Brandon Rush,31-232,G-F,2/24/17,MIN,,DAL,W,1,23,2,5,0.4,1,2,0.5,1,3,0.333,0,0,,0,3,3
15453,Brandon Rush,31-251,G-F,3/15/17,MIN,@,BOS,L,1,28,2,7,0.286,1,2,0.5,1,5,0.2,0,0,,1,2,3
15454,Brandon Rush,31-220,G-F,2/12/17,MIN,,CHI,W,1,29,1,5,0.2,1,1,1,0,4,0,3,4,0.75,1,1,2
15455,D'Angelo Russell,20-326,G,1/14/17,LAL,@,LAC,L,1,28,1,7,0.143,1,6,0.167,0,1,0,3,5,0.6,1,4,5
15456,D'Angelo Russell,21-020,G,3/15/17,LAL,@,HOU,L,0,25,2,10,0.2,2,5,0.4,0,5,0,1,2,0.5,0,2,2
15457,D'Angelo Russell,20-329,G,1/17/17,LAL,,DEN,L,1,17,2,9,0.222,1,7,0.143,1,2,0.5,0,0,,1,1,2
15458,Domantas Sabonis,20-251,F,1/9/17,OKC,@,CHI,W,1,22,1,5,0.2,1,3,0.333,0,2,0,3,3,1,1,4,5
15459,Domantas Sabonis,20-215,F,12/4/16,OKC,,NOP,W,1,25,2,5,0.4,1,4,0.25,1,1,1,0,0,,0,2,2
15460,Domantas Sabonis,20-260,F,1/18/17,OKC,@,GSW,L,1,15,2,3,0.667,1,2,0.5,1,1,1,0,0,,0,2,2
15461,Domantas Sabonis,20-209,F,11/28/16,OKC,@,NYK,W,1,16,2,5,0.4,1,4,0.25,1,1,1,0,0,,0,1,1
15462,Domantas Sabonis,20-176,F,10/26/16,OKC,@,PHI,W,1,16,2,5,0.4,1,2,0.5,1,3,0.333,0,0,,0,4,4
15463,Domantas Sabonis,20-224,F,12/13/16,OKC,@,POR,L,1,20,2,4,0.5,1,3,0.333,1,1,1,0,0,,2,7,9
15464,Dario Saric,22-201,F,10/26/16,PHI,,OKC,L,1,27,2,12,0.167,2,8,0.25,0,4,0,1,2,0.5,1,6,7
15465,Dario Saric,22-204,F,10/29/16,PHI,,ATL,L,1,26,2,9,0.222,1,6,0.167,1,3,0.333,0,0,,0,4,4
15466,Tomas Satoransky,25-126,G,3/5/17,WAS,,ORL,W,0,7,2,2,1,1,1,1,1,1,1,0,0,,0,1,1
15467,Dennis Schroder,23-140,G,2/2/17,ATL,@,HOU,W,1,21,2,12,0.167,2,9,0.222,0,3,0,1,1,1,0,2,2
15468,Luis Scola,36-193,F,11/9/16,BRK,@,NYK,L,0,14,2,5,0.4,2,4,0.5,0,1,0,1,3,0.333,1,3,4
15469,Luis Scola,36-255,F,1/10/17,BRK,,ATL,L,0,16,2,6,0.333,1,4,0.25,1,2,0.5,0,0,,4,3,7
15470,Mike Scott,28-163,F,12/26/16,ATL,@,MIN,L,0,18,2,6,0.333,1,1,1,1,5,0.2,0,0,,0,3,3
15471,Mike Scott,28-160,F,12/23/16,ATL,@,DEN,W,0,12,1,4,0.25,1,1,1,0,3,0,3,4,0.75,1,3,4
15472,Mike Scott,28-156,F,12/19/16,ATL,@,OKC,W,0,8,2,4,0.5,1,3,0.333,1,1,1,0,0,,1,1,2
15473,Thabo Sefolosha,32-186,G-F,11/4/16,ATL,@,WAS,L,0,27,2,4,0.5,1,2,0.5,1,2,0.5,0,0,,0,2,2
15474,Thabo Sefolosha,32-308,G-F,3/6/17,ATL,,GSW,L,1,30,2,5,0.4,1,4,0.25,1,1,1,0,0,,1,3,4
15475,Thabo Sefolosha,32-214,G-F,12/2/16,ATL,,DET,L,1,17,2,5,0.4,1,4,0.25,1,1,1,0,0,,0,2,2
15476,Thabo Sefolosha,32-305,G-F,3/3/17,ATL,,CLE,L,1,31,2,7,0.286,1,5,0.2,1,2,0.5,0,2,0,2,3,5
15477,Thabo Sefolosha,32-303,G-F,3/1/17,ATL,,DAL,W,1,32,2,4,0.5,1,1,1,1,3,0.333,0,0,,1,4,5
15478,Thabo Sefolosha,32-190,G-F,11/8/16,ATL,@,CLE,W,1,35,2,6,0.333,1,3,0.333,1,3,0.333,0,0,,2,3,5
15479,Ramon Sessions,30-231,G,11/28/16,CHO,@,MEM,W,0,12,2,6,0.333,2,6,0.333,0,0,,1,1,1,0,2,2
15480,Ramon Sessions,30-292,G,1/28/17,CHO,,SAC,L,0,21,2,3,0.667,1,2,0.5,1,1,1,0,0,,0,2,2
15481,Ramon Sessions,30-274,G,1/10/17,CHO,@,HOU,L,0,14,2,5,0.4,1,4,0.25,1,1,1,0,0,,0,1,1
15482,Ramon Sessions,30-256,G,12/23/16,CHO,,CHI,W,0,16,2,5,0.4,2,4,0.5,0,1,0,1,2,0.5,0,1,1
15483,Iman Shumpert,26-125,G,10/29/16,CLE,,ORL,W,0,19,2,3,0.667,1,2,0.5,1,1,1,0,0,,0,0,0
15484,Iman Shumpert,26-223,G,2/4/17,CLE,@,NYK,W,1,36,2,7,0.286,1,1,1,1,6,0.167,0,0,,1,8,9
15485,Iman Shumpert,26-135,G,11/8/16,CLE,,ATL,L,0,22,2,4,0.5,1,2,0.5,1,2,0.5,0,0,,2,3,5
15486,Iman Shumpert,26-171,G,12/14/16,CLE,@,MEM,L,0,22,2,5,0.4,2,3,0.667,0,2,0,1,2,0.5,0,5,5
15487,Iman Shumpert,26-152,G,11/25/16,CLE,,DAL,W,0,11,1,3,0.333,0,0,,1,3,0.333,2,2,1,0,3,3
15488,Iman Shumpert,26-170,G,12/13/16,CLE,,MEM,W,0,24,2,5,0.4,1,2,0.5,1,3,0.333,0,0,,0,2,2
15489,Iman Shumpert,26-244,G,2/25/17,CLE,,CHI,L,1,23,2,9,0.222,2,5,0.4,0,4,0,1,2,0.5,1,5,6
15490,Iman Shumpert,26-242,G,2/23/17,CLE,,NYK,W,1,23,2,9,0.222,1,3,0.333,1,6,0.167,0,0,,1,2,3
15491,Pascal Siakam,22-365,F,2/3/17,TOR,@,ORL,L,0,10,2,2,1,2,2,1,0,0,,1,2,0.5,1,2,3
15492,Jonathon Simmons,27-079,G-F,12/2/16,SAS,,WAS,W,0,14,0,0,,0,0,,0,0,,5,6,0.833,0,0,0
15493,Jonathon Simmons,27-113,G-F,1/5/17,SAS,@,DEN,W,0,13,1,1,1,1,1,1,0,0,,3,4,0.75,0,0,0
15494,Jonathon Simmons,27-061,G-F,11/14/16,SAS,,MIA,W,0,22,1,5,0.2,1,3,0.333,0,2,0,3,4,0.75,2,2,4
15495,Jonathon Simmons,27-043,G-F,10/27/16,SAS,@,SAC,W,0,18,1,2,0.5,1,2,0.5,0,0,,3,4,0.75,1,1,2
15496,Jonathon Simmons,27-058,G-F,11/11/16,SAS,,DET,W,0,18,0,3,0,0,1,0,0,2,0,5,6,0.833,0,4,4
15497,Kyle Singler,28-223,F,12/13/16,OKC,@,POR,L,0,6,1,1,1,0,0,,1,1,1,2,2,1,0,2,2
15498,Kyle Singler,28-175,F,10/26/16,OKC,@,PHI,W,0,22,1,6,0.167,0,1,0,1,5,0.2,2,2,1,0,1,1
15499,Kyle Singler,28-259,F,1/18/17,OKC,@,GSW,L,0,17,2,4,0.5,1,2,0.5,1,2,0.5,0,0,,1,1,2
15500,Marcus Smart,22-285,G,12/16/16,BOS,,CHO,W,0,24,2,4,0.5,2,3,0.667,0,1,0,1,1,1,1,6,7
15501,Marcus Smart,23-002,G,3/8/17,BOS,@,GSW,W,0,25,1,8,0.125,1,6,0.167,0,2,0,3,4,0.75,2,1,3
15502,Marcus Smart,22-347,G,2/16/17,BOS,@,CHI,L,1,33,1,5,0.2,1,4,0.25,0,1,0,3,4,0.75,1,3,4
15503,Ish Smith,28-233,G,2/23/17,DET,,CHO,W,0,33,2,12,0.167,2,10,0.2,0,2,0,1,2,0.5,0,6,6
15504,Ish Smith,28-162,G,12/14/16,DET,@,DAL,W,0,18,2,5,0.4,2,4,0.5,0,1,0,1,2,0.5,1,3,4
15505,Jason Smith,30-341,F-C,2/6/17,WAS,,CLE,L,0,16,2,4,0.5,2,4,0.5,0,0,,1,2,0.5,2,3,5
15506,Tony Snell,25-067,G-F,1/16/17,MIL,,PHI,L,1,29,2,2,1,1,1,1,1,1,1,0,0,,0,4,4
15507,Tony Snell,24-362,G-F,11/6/16,MIL,@,DAL,L,1,36,2,8,0.25,1,1,1,1,7,0.143,0,0,,0,3,3
15508,Tony Snell,25-050,G-F,12/30/16,MIL,@,MIN,L,1,29,2,7,0.286,1,2,0.5,1,5,0.2,0,1,0,0,0,0
15509,Tony Snell,25-131,G-F,3/21/17,MIL,@,POR,W,1,36,2,5,0.4,1,2,0.5,1,3,0.333,0,0,,0,5,5
15510,Marreese Speights,29-206,C-F,2/26/17,LAC,,CHO,W,0,8,1,3,0.333,0,0,,1,3,0.333,2,2,1,0,0,0
15511,Marreese Speights,29-177,C-F,1/28/17,LAC,@,GSW,L,0,19,2,6,0.333,1,3,0.333,1,3,0.333,0,0,,0,3,3
15512,Marreese Speights,29-153,C-F,1/4/17,LAC,,MEM,W,0,13,1,6,0.167,0,2,0,1,4,0.25,2,2,1,2,4,6
15513,Marreese Speights,29-188,C-F,2/8/17,LAC,@,NYK,W,0,10,2,5,0.4,1,1,1,1,4,0.25,0,0,,1,2,3
15514,Marreese Speights,29-104,C-F,11/16/16,LAC,,MEM,L,0,14,2,5,0.4,2,4,0.5,0,1,0,1,1,1,1,1,2
15515,Marreese Speights,29-223,C-F,3/15/17,LAC,,MIL,L,0,11,2,5,0.4,2,2,1,0,3,0,1,2,0.5,1,5,6
15516,Nik Stauskas,23-147,G,3/3/17,PHI,,NYK,W,1,30,1,5,0.2,0,1,0,1,4,0.25,2,2,1,0,5,5
15517,Nik Stauskas,23-096,G,1/11/17,PHI,,NYK,W,1,22,2,6,0.333,1,2,0.5,1,4,0.25,0,0,,1,1,2
15518,Nik Stauskas,23-029,G,11/5/16,PHI,,CLE,L,0,19,2,5,0.4,1,1,1,1,4,0.25,0,0,,0,2,2
15519,Mirza Teletovic,31-053,F,11/10/16,MIL,,NOP,L,0,11,1,6,0.167,0,2,0,1,4,0.25,2,2,1,0,2,2
15520,Mirza Teletovic,31-138,F,2/3/17,MIL,@,DEN,L,0,9,2,4,0.5,1,1,1,1,3,0.333,0,0,,1,1,2
15521,Mirza Teletovic,31-180,F,3/17/17,MIL,@,LAL,W,0,22,2,7,0.286,1,2,0.5,1,5,0.2,0,1,0,0,5,5
15522,Mirza Teletovic,31-112,F,1/8/17,MIL,,WAS,L,1,31,2,8,0.25,1,3,0.333,1,5,0.2,0,0,,0,4,4
15523,Garrett Temple,30-232,G,12/26/16,SAC,,PHI,W,0,29,1,4,0.25,0,1,0,1,3,0.333,2,2,1,0,1,1
15524,Garrett Temple,30-250,G,1/13/17,SAC,,CLE,L,1,35,2,4,0.5,1,1,1,1,3,0.333,0,0,,0,2,2
15525,Garrett Temple,30-215,G,12/9/16,SAC,,NYK,L,0,26,2,6,0.333,1,2,0.5,1,4,0.25,0,0,,0,0,0
15526,Garrett Temple,30-210,G,12/4/16,SAC,@,NYK,L,0,18,2,3,0.667,1,1,1,1,2,0.5,0,0,,0,3,3
15527,Garrett Temple,30-226,G,12/20/16,SAC,,POR,W,0,24,1,3,0.333,1,2,0.5,0,1,0,3,5,0.6,0,3,3
15528,Garrett Temple,30-243,G,1/6/17,SAC,,LAC,L,0,33,2,7,0.286,1,5,0.2,1,2,0.5,0,0,,5,4,9
15529,Garrett Temple,30-224,G,12/18/16,SAC,@,DAL,L,1,36,1,10,0.1,0,2,0,1,8,0.125,2,2,1,1,4,5
15530,Jason Terry,39-134,G,1/27/17,MIL,@,TOR,L,0,11,1,3,0.333,0,1,0,1,2,0.5,2,2,1,1,1,2
15531,Jason Terry,39-115,G,1/8/17,MIL,,WAS,L,0,18,1,1,1,0,0,,1,1,1,2,2,1,0,1,1
15532,Jason Terry,39-146,G,2/8/17,MIL,,MIA,L,0,14,2,2,1,2,2,1,0,0,,1,2,0.5,0,1,1
15533,Jason Terry,39-183,G,3/17/17,MIL,@,LAL,W,0,16,1,4,0.25,0,1,0,1,3,0.333,2,2,1,0,0,0
15534,Jason Terry,39-123,G,1/16/17,MIL,,PHI,L,0,18,2,5,0.4,1,1,1,1,4,0.25,0,0,,0,0,0
15535,Jason Terry,39-179,G,3/13/17,MIL,@,MEM,L,0,20,1,2,0.5,0,0,,1,2,0.5,2,2,1,0,2,2
15536,Jason Terry,39-041,G,10/26/16,MIL,,CHO,L,0,18,2,4,0.5,2,3,0.667,0,1,0,1,1,1,0,2,2
15537,Jason Terry,39-177,G,3/11/17,MIL,,MIN,W,0,26,1,3,0.333,1,3,0.333,0,0,,3,3,1,1,2,3
15538,Lance Thomas,28-235,F,12/15/16,NYK,@,GSW,L,1,24,2,9,0.222,1,5,0.2,1,4,0.25,0,0,,0,1,1
15539,Lance Thomas,28-196,F,11/6/16,NYK,,UTA,L,0,29,2,5,0.4,1,4,0.25,1,1,1,0,0,,0,2,2
15540,Lance Thomas,28-250,F,12/30/16,NYK,@,NOP,L,0,18,2,5,0.4,1,3,0.333,1,2,0.5,0,0,,0,1,1
15541,Lance Thomas,28-227,F,12/7/16,NYK,,CLE,L,0,14,2,5,0.4,1,2,0.5,1,3,0.333,0,0,,0,2,2
15542,Hollis Thompson,25-334,G-F,3/3/17,NOP,,SAS,L,1,29,2,7,0.286,1,4,0.25,1,3,0.333,0,0,,0,2,2
15543,Hollis Thompson,25-244,G-F,12/3/16,PHI,,BOS,L,0,17,2,5,0.4,1,4,0.25,1,1,1,0,0,,0,2,2
15544,Hollis Thompson,25-255,G-F,12/14/16,PHI,,TOR,L,0,11,2,4,0.5,1,2,0.5,1,2,0.5,0,0,,1,2,3
15545,Hollis Thompson,25-222,G-F,11/11/16,PHI,,IND,W,0,13,2,3,0.667,2,2,1,0,1,0,1,1,1,0,4,4
15546,Hollis Thompson,25-339,G-F,3/8/17,NOP,,TOR,L,1,15,2,4,0.5,1,2,0.5,1,2,0.5,0,0,,0,3,3
15547,Hollis Thompson,25-271,G-F,12/30/16,PHI,@,DEN,W,0,23,2,6,0.333,1,3,0.333,1,3,0.333,0,0,,0,3,3
15548,Tristan Thompson,25-283,F-C,12/21/16,CLE,,MIL,W,1,26,2,6,0.333,2,6,0.333,0,0,,1,4,0.25,7,6,13
15549,Marcus Thornton,29-150,G,11/2/16,WAS,,TOR,L,0,14,2,4,0.5,2,4,0.5,0,0,,1,1,1,0,0,0
15550,Marcus Thornton,29-180,G,12/2/16,WAS,@,SAS,L,0,18,2,7,0.286,2,6,0.333,0,1,0,1,1,1,1,2,3
15551,Marcus Thornton,29-144,G,10/27/16,WAS,@,ATL,L,0,20,2,8,0.25,1,5,0.2,1,3,0.333,0,0,,0,1,1
15552,Marcus Thornton,29-192,G,12/14/16,WAS,,CHO,W,0,13,2,5,0.4,1,3,0.333,1,2,0.5,0,0,,0,1,1
15553,Marcus Thornton,29-204,G,12/26/16,WAS,,MIL,W,0,13,2,4,0.5,1,2,0.5,1,2,0.5,0,0,,0,1,1
15554,Anthony Tolliver,31-153,F-C,11/1/16,SAC,@,MIA,L,0,14,2,3,0.667,1,2,0.5,1,1,1,0,0,,1,3,4
15555,Anthony Tolliver,31-231,F-C,1/18/17,SAC,,IND,L,0,22,2,3,0.667,1,1,1,1,2,0.5,0,0,,0,3,3
15556,Anthony Tolliver,31-280,F-C,3/8/17,SAC,@,SAS,L,1,27,2,6,0.333,1,3,0.333,1,3,0.333,0,0,,0,2,2
15557,Anthony Tolliver,31-208,F-C,12/26/16,SAC,,PHI,W,0,23,2,5,0.4,1,1,1,1,4,0.25,0,0,,1,3,4
15558,P.J. Tucker,31-226,F,12/17/16,PHO,@,OKC,L,1,33,2,6,0.333,1,4,0.25,1,2,0.5,0,0,,1,1,2
15559,P.J. Tucker,31-224,F,12/15/16,PHO,,SAS,L,1,29,2,6,0.333,1,2,0.5,1,4,0.25,0,0,,0,1,1
15560,Evan Turner,28-008,G,11/4/16,POR,@,DAL,W,0,25,1,8,0.125,0,6,0,1,2,0.5,2,2,1,0,7,7
15561,Evan Turner,28-022,G,11/18/16,POR,@,NOP,L,0,19,1,7,0.143,0,4,0,1,3,0.333,2,2,1,1,1,2
15562,Evan Turner,28-044,G,12/10/16,POR,@,IND,L,0,21,2,6,0.333,1,4,0.25,1,2,0.5,0,0,,0,3,3
15563,Myles Turner,20-232,F-C,11/11/16,IND,@,PHI,L,1,21,2,6,0.333,1,4,0.25,1,2,0.5,0,0,,0,5,5
15564,Myles Turner,20-346,F-C,3/5/17,IND,@,ATL,W,1,30,2,7,0.286,2,6,0.333,0,1,0,1,1,1,3,2,5
15565,Beno Udrih,34-113,G,10/26/16,DET,@,TOR,L,0,15,1,5,0.2,1,4,0.25,0,1,0,3,4,0.75,0,1,1
15566,Beno Udrih,34-125,G,11/7/16,DET,@,LAC,L,0,24,1,8,0.125,0,7,0,1,1,1,2,2,1,1,1,2
15567,Beno Udrih,34-164,G,12/16/16,DET,@,WAS,L,0,6,1,1,1,0,0,,1,1,1,2,2,1,0,0,0
15568,Tyler Ulis,20-347,G,12/17/16,PHO,@,OKC,L,0,4,2,3,0.667,2,2,1,0,1,0,1,2,0.5,0,0,0
15569,Tyler Ulis,21-025,G,1/30/17,PHO,,MEM,L,0,15,2,5,0.4,1,3,0.333,1,2,0.5,0,0,,1,1,2
15570,Tyler Ulis,21-063,G,3/9/17,PHO,,LAL,L,0,16,1,5,0.2,1,4,0.25,0,1,0,3,4,0.75,0,0,0
15571,Jonas Valanciunas,24-182,C,11/4/16,TOR,,MIA,W,1,28,1,2,0.5,1,2,0.5,0,0,,3,4,0.75,2,9,11
15572,Denzel Valentine,23-017,G,12/3/16,CHI,@,DAL,L,0,20,2,5,0.4,1,2,0.5,1,3,0.333,0,0,,0,3,3
15573,Denzel Valentine,23-009,G,11/25/16,CHI,@,PHI,W,0,22,2,9,0.222,1,4,0.25,1,5,0.2,0,0,,0,3,3
15574,Denzel Valentine,23-084,G,2/8/17,CHI,@,GSW,L,0,21,2,11,0.182,1,4,0.25,1,7,0.143,0,0,,0,0,0
15575,Denzel Valentine,23-029,G,12/15/16,CHI,@,MIL,L,0,19,1,6,0.167,0,2,0,1,4,0.25,2,2,1,0,3,3
15576,Fred VanVleet,22-282,G,12/3/16,TOR,,ATL,W,0,4,2,2,1,1,1,1,1,1,1,0,0,,0,1,1
15577,Fred VanVleet,23-019,G,3/16/17,TOR,,OKC,L,0,12,2,4,0.5,1,3,0.333,1,1,1,0,0,,0,1,1
15578,Fred VanVleet,23-016,G,3/13/17,TOR,,DAL,W,0,22,2,6,0.333,1,5,0.2,1,1,1,0,0,,0,2,2
15579,Fred VanVleet,22-323,G,1/13/17,TOR,,BRK,W,0,3,2,4,0.5,1,3,0.333,1,1,1,0,0,,0,0,0
15580,Fred VanVleet,23-014,G,3/11/17,TOR,@,MIA,L,0,20,1,10,0.1,1,7,0.143,0,3,0,3,3,1,1,3,4
15581,Greivis Vasquez,29-286,G,10/28/16,BRK,,IND,W,0,14,1,3,0.333,0,2,0,1,1,1,2,3,0.667,0,1,1
15582,Rashad Vaughn,20-183,G,2/15/17,MIL,@,BRK,W,0,18,2,5,0.4,1,1,1,1,4,0.25,0,0,,0,3,3
15583,Rashad Vaughn,20-152,G,1/15/17,MIL,@,ATL,L,0,7,2,4,0.5,1,2,0.5,1,2,0.5,0,0,,0,1,1
15584,Rashad Vaughn,20-077,G,11/1/16,MIL,@,NOP,W,0,17,2,4,0.5,1,1,1,1,3,0.333,0,0,,0,1,1
15585,Rashad Vaughn,20-075,G,10/30/16,MIL,@,DET,L,0,22,2,8,0.25,1,4,0.25,1,4,0.25,0,0,,0,1,1
15586,Noah Vonleh,21-077,F,11/9/16,POR,@,LAC,L,1,26,2,8,0.25,1,6,0.167,1,2,0.5,0,0,,2,9,11
15587,Noah Vonleh,21-076,F,11/8/16,POR,,PHO,W,0,15,2,8,0.25,1,4,0.25,1,4,0.25,0,0,,3,5,8
15588,Noah Vonleh,21-111,F,12/13/16,POR,,OKC,W,1,19,2,4,0.5,2,4,0.5,0,0,,1,2,0.5,1,3,4
15589,Noah Vonleh,21-188,F,2/28/17,POR,@,DET,L,1,19,2,2,1,2,2,1,0,0,,1,2,0.5,1,2,3
15590,Noah Vonleh,21-124,F,12/26/16,POR,,TOR,L,0,15,2,5,0.4,2,5,0.4,0,0,,1,2,0.5,4,4,8
15591,Noah Vonleh,21-186,F,2/26/17,POR,@,TOR,L,1,21,2,3,0.667,2,3,0.667,0,0,,1,2,0.5,0,4,4
15592,Noah Vonleh,21-121,F,12/23/16,POR,,SAS,L,0,18,1,3,0.333,1,3,0.333,0,0,,3,4,0.75,1,3,4
15593,Sasha Vujacic,32-271,G,12/4/16,NYK,,SAC,W,0,16,2,2,1,1,1,1,1,1,1,0,0,,1,3,4
15594,Sasha Vujacic,32-267,G,11/30/16,NYK,@,MIN,W,0,11,2,4,0.5,1,2,0.5,1,2,0.5,0,0,,1,2,3
15595,Taurean Waller-Prince,22-328,F,2/13/17,ATL,@,POR,W,0,25,1,4,0.25,0,1,0,1,3,0.333,2,2,1,0,5,5
15596,Taurean Waller-Prince,22-319,F,2/4/17,ATL,,ORL,W,0,5,0,0,,0,0,,0,0,,5,6,0.833,0,1,1
15597,Taurean Waller-Prince,22-255,F,12/2/16,ATL,,DET,L,0,17,1,6,0.167,0,2,0,1,4,0.25,2,2,1,0,6,6
15598,Taurean Waller-Prince,22-356,F,3/13/17,ATL,@,SAS,L,0,10,2,4,0.5,1,2,0.5,1,2,0.5,0,0,,0,1,1
15599,C.J. Watson,32-290,G,2/1/17,ORL,,IND,L,0,19,2,4,0.5,1,3,0.333,1,1,1,0,0,,0,0,0
15600,C.J. Watson,32-302,G,2/13/17,ORL,@,MIA,W,1,17,2,6,0.333,1,4,0.25,1,2,0.5,0,0,,0,0,0
15601,C.J. Watson,32-213,G,11/16/16,ORL,,NOP,W,0,16,1,2,0.5,0,1,0,1,1,1,2,2,1,0,5,5
15602,C.J. Watson,32-278,G,1/20/17,ORL,,MIL,W,1,31,2,8,0.25,1,4,0.25,1,4,0.25,0,0,,1,4,5
15603,C.J. Watson,32-323,G,3/6/17,ORL,,NYK,L,0,12,2,3,0.667,1,2,0.5,1,1,1,0,0,,1,0,1
15604,C.J. Watson,32-290,G,2/1/17,ORL,,IND,L,0,19,2,4,0.5,1,3,0.333,1,1,1,0,0,,0,0,0
15605,C.J. Watson,32-302,G,2/13/17,ORL,@,MIA,W,1,17,2,6,0.333,1,4,0.25,1,2,0.5,0,0,,0,0,0
15606,David West,36-073,F,11/10/16,GSW,@,DEN,W,0,13,2,3,0.667,2,3,0.667,0,0,,1,2,0.5,0,0,0
15607,David West,36-072,F,11/9/16,GSW,,DAL,W,0,13,2,3,0.667,2,3,0.667,0,0,,1,1,1,2,1,3
15608,David West,36-118,F,12/25/16,GSW,@,CLE,L,0,14,1,3,0.333,1,3,0.333,0,0,,3,3,1,1,1,2
15609,Okaro White,24-163,F,1/23/17,MIA,,GSW,W,0,11,2,3,0.667,2,2,1,0,1,0,1,1,1,1,0,1
15610,Okaro White,24-175,F,2/4/17,MIA,,PHI,W,0,25,2,6,0.333,1,4,0.25,1,2,0.5,0,0,,1,2,3
15611,Isaiah Whitehead,21-239,G,11/2/16,BRK,,DET,W,0,20,2,5,0.4,1,4,0.25,1,1,1,0,0,,0,4,4
15612,Isaiah Whitehead,22-006,G,3/14/17,BRK,,OKC,L,0,33,2,7,0.286,1,5,0.2,1,2,0.5,0,2,0,0,5,5
15613,Isaiah Whitehead,21-315,G,1/17/17,BRK,,TOR,L,0,13,2,5,0.4,1,2,0.5,1,3,0.333,0,0,,0,1,1
15614,Isaiah Whitehead,21-306,G,1/8/17,BRK,,PHI,L,1,21,2,6,0.333,1,4,0.25,1,2,0.5,0,0,,0,3,3
15615,Hassan Whiteside,27-147,C,11/7/16,MIA,@,OKC,L,1,31,2,8,0.25,2,8,0.25,0,0,,1,2,0.5,1,11,12
15616,C.J. Wilcox,25-313,G,11/7/16,ORL,@,CHI,L,0,10,1,2,0.5,0,0,,1,2,0.5,2,2,1,0,1,1
15617,Alan Williams,23-298,F-C,11/21/16,PHO,@,WAS,L,0,16,2,3,0.667,2,3,0.667,0,0,,1,2,0.5,2,6,8
15618,Derrick Williams,25-195,F,12/6/16,MIA,,NYK,L,0,15,1,5,0.2,1,3,0.333,0,2,0,3,4,0.75,0,3,3
15619,Derrick Williams,25-173,F,11/14/16,MIA,@,SAS,L,1,16,2,6,0.333,2,4,0.5,0,2,0,1,2,0.5,0,1,1
15620,Derrick Williams,25-212,F,12/23/16,MIA,@,NOP,L,0,8,2,3,0.667,1,1,1,1,2,0.5,0,0,,0,5,5
15621,Derrick Williams,25-182,F,11/23/16,MIA,@,DET,L,1,12,2,5,0.4,2,3,0.667,0,2,0,1,2,0.5,1,1,2
15622,Derrick Williams,25-291,F,3/12/17,CLE,@,HOU,L,0,10,2,2,1,1,1,1,1,1,1,0,0,,0,1,1
15623,Derrick Williams,25-290,F,3/11/17,CLE,@,ORL,W,0,16,2,4,0.5,2,2,1,0,2,0,1,2,0.5,0,4,4
15624,Lou Williams,30-136,G,3/12/17,HOU,,CLE,W,0,15,2,7,0.286,1,5,0.2,1,2,0.5,0,0,,2,4,6
15625,Lou Williams,30-130,G,3/6/17,HOU,@,SAS,L,0,19,1,10,0.1,1,7,0.143,0,3,0,3,3,1,0,1,1
15626,Lou Williams,30-125,G,3/1/17,HOU,@,LAC,W,0,21,2,11,0.182,1,4,0.25,1,7,0.143,0,0,,1,1,2
15627,Marvin Williams,30-241,F,2/15/17,CHO,@,TOR,L,1,39,2,9,0.222,1,2,0.5,1,7,0.143,0,0,,2,7,9
15628,Marvin Williams,30-173,F,12/9/16,CHO,,ORL,W,1,21,1,5,0.2,0,1,0,1,4,0.25,2,2,1,1,5,6
15629,Reggie Williams,30-090,F,12/13/16,NOP,,GSW,L,0,9,1,3,0.333,0,1,0,1,2,0.5,2,2,1,0,0,0
15630,Troy Williams,21-337,F,12/1/16,MEM,,ORL,W,1,35,2,13,0.154,1,7,0.143,1,6,0.167,0,0,,0,2,2
15631,Jeff Withey,26-312,C,1/13/17,UTA,,DET,W,0,3,1,1,1,1,1,1,0,0,,3,3,1,1,0,1
15632,Christian Wood,21-151,F,2/25/17,CHO,@,SAC,W,0,10,1,3,0.333,1,2,0.5,0,1,0,3,4,0.75,3,1,4
15633,Brandan Wright,29-126,F-C,2/8/17,MEM,,PHO,W,0,21,2,8,0.25,2,8,0.25,0,0,,1,4,0.25,2,1,3
15634,Delon Wright,24-307,G,2/27/17,TOR,@,NYK,W,0,15,1,2,0.5,0,0,,1,2,0.5,2,2,1,0,1,1
15635,James Young,21-181,G-F,2/13/17,BOS,@,DAL,W,0,12,2,3,0.667,1,2,0.5,1,1,1,0,0,,2,2,4
15636,James Young,21-164,G-F,1/27/17,BOS,,ORL,W,0,9,1,2,0.5,0,1,0,1,1,1,2,3,0.667,0,1,1
15637,James Young,21-192,G-F,2/24/17,BOS,@,TOR,L,0,12,2,4,0.5,1,1,1,1,3,0.333,0,0,,0,1,1
15638,James Young,21-161,G-F,1/24/17,BOS,@,WAS,L,0,13,1,4,0.25,0,1,0,1,3,0.333,2,2,1,1,1,2
15639,James Young,21-184,G-F,2/16/17,BOS,@,CHI,L,0,9,2,3,0.667,1,2,0.5,1,1,1,0,0,,0,1,1
15640,Joe Young,24-226,G,2/8/17,IND,,CLE,L,0,2,2,2,1,1,1,1,1,1,1,0,0,,0,0,0
15641,Joe Young,24-131,G,11/5/16,IND,,CHI,W,0,3,2,2,1,2,2,1,0,0,,1,2,0.5,0,0,0
15642,Joe Young,24-199,G,1/12/17,IND,@,DEN,L,0,3,2,3,0.667,1,1,1,1,2,0.5,0,0,,0,0,0
15643,Nick Young,31-167,G-F,11/15/16,LAL,,BRK,W,1,28,2,8,0.25,1,2,0.5,1,6,0.167,0,0,,0,1,1
15644,Nick Young,31-259,G-F,2/15/17,LAL,@,PHO,L,1,24,2,10,0.2,1,4,0.25,1,6,0.167,0,0,,1,3,4
15645,Nick Young,31-205,G-F,12/23/16,LAL,@,ORL,L,1,28,2,7,0.286,1,4,0.25,1,3,0.333,0,2,0,1,2,3
15646,Nick Young,31-219,G-F,1/6/17,LAL,,MIA,W,1,29,1,9,0.111,0,3,0,1,6,0.167,2,2,1,1,4,5
15647,Thaddeus Young,28-141,F,11/9/16,IND,,PHI,W,1,36,2,6,0.333,2,5,0.4,0,1,0,1,4,0.25,1,4,5
15648,Thaddeus Young,28-171,F,12/9/16,IND,@,DAL,L,1,20,2,5,0.4,1,3,0.333,1,2,0.5,0,0,,0,4,4
15649,Thaddeus Young,28-216,F,1/23/17,IND,,NYK,L,1,31,2,6,0.333,1,5,0.2,1,1,1,0,0,,1,2,3
15650,Tyler Zeller,27-041,F-C,2/27/17,BOS,,ATL,L,0,9,2,2,1,2,2,1,0,0,,1,1,1,1,0,1
15651,Tyler Zeller,26-306,F-C,11/18/16,BOS,,GSW,L,0,23,2,6,0.333,2,6,0.333,0,0,,1,2,0.5,3,4,7
15652,Paul Zipser,22-334,G-F,1/17/17,CHI,,DAL,L,1,19,2,5,0.4,1,3,0.333,1,2,0.5,0,0,,0,3,3
15653,Paul Zipser,22-332,G-F,1/15/17,CHI,@,MEM,W,1,15,2,3,0.667,2,2,1,0,1,0,1,2,0.5,0,2,2
15654,Paul Zipser,22-341,G-F,1/24/17,CHI,@,ORL,W,0,20,1,4,0.25,0,1,0,1,3,0.333,2,2,1,0,1,1
15655,Ivica Zubac,19-327,C,2/8/17,LAL,@,DET,L,0,22,2,5,0.4,2,5,0.4,0,0,,1,2,0.5,1,1,2
15656,Alex Abrines,23-168,G-F,1/16/17,OKC,@,LAC,L,0,14,1,4,0.25,1,3,0.333,0,1,0,2,3,0.667,0,0,0
15657,Quincy Acy,26-146,F,3/1/17,BRK,@,SAC,W,0,11,1,2,0.5,0,0,,1,2,0.5,1,2,0.5,0,3,3
15658,Quincy Acy,26-096,F,1/10/17,BRK,,ATL,L,0,1,1,1,1,0,0,,1,1,1,1,3,0.333,1,0,1
15659,Steven Adams,23-230,C,3/7/17,OKC,,POR,L,1,29,1,1,1,1,1,1,0,0,,2,5,0.4,0,3,3
15660,Steven Adams,23-117,C,11/14/16,OKC,@,DET,L,1,29,1,3,0.333,1,3,0.333,0,0,,2,4,0.5,5,6,11
15661,Steven Adams,23-177,C,1/13/17,OKC,@,MIN,L,1,32,2,5,0.4,2,5,0.4,0,0,,0,0,,3,2,5
15662,Arron Afflalo,31-043,G,11/27/16,SAC,@,BRK,W,1,21,2,3,0.667,2,3,0.667,0,0,,0,0,,0,4,4
15663,Arron Afflalo,31-123,G,2/15/17,SAC,@,GSW,L,1,16,1,4,0.25,0,2,0,1,2,0.5,1,1,1,0,0,0
15664,Arron Afflalo,31-041,G,11/25/16,SAC,,HOU,L,0,16,2,6,0.333,2,4,0.5,0,2,0,0,0,,0,2,2
15665,Arron Afflalo,31-087,G,1/10/17,SAC,,DET,W,0,11,1,1,1,1,1,1,0,0,,2,2,1,0,1,1
15666,Alexis Ajinca,28-176,C,10/29/16,NOP,@,SAS,L,0,15,2,5,0.4,2,5,0.4,0,0,,0,0,,1,5,6
15667,Alexis Ajinca,28-313,C,3/15/17,NOP,@,MIA,L,0,8,2,2,1,2,2,1,0,0,,0,0,,1,2,3
15668,Alexis Ajinca,28-192,C,11/14/16,NOP,,BOS,W,0,6,2,4,0.5,2,4,0.5,0,0,,0,0,,1,1,2
15669,Cole Aldrich,28-033,C,12/3/16,MIN,@,CHO,W,0,22,2,4,0.5,2,4,0.5,0,0,,0,0,,3,5,8
15670,Cole Aldrich,28-139,C,3/19/17,MIN,@,NOP,L,0,7,2,2,1,2,2,1,0,0,,0,0,,0,2,2
15671,Cole Aldrich,28-049,C,12/19/16,MIN,,PHO,W,0,8,1,1,1,1,1,1,0,0,,2,2,1,0,0,0
15672,Cole Aldrich,27-361,C,10/26/16,MIN,@,MEM,L,0,10,2,4,0.5,2,4,0.5,0,0,,0,0,,1,1,2
15673,Cole Aldrich,28-067,C,1/6/17,MIN,@,WAS,L,0,8,2,2,1,2,2,1,0,0,,0,0,,2,2,4
15674,Cole Aldrich,28-085,C,1/24/17,MIN,@,PHO,W,0,8,2,2,1,2,2,1,0,0,,0,0,,1,3,4
15675,Cole Aldrich,28-025,C,11/25/16,MIN,@,PHO,W,0,11,0,1,0,0,1,0,0,0,,4,4,1,2,3,5
15676,Cole Aldrich,28-039,C,12/9/16,MIN,,DET,L,0,20,1,2,0.5,1,2,0.5,0,0,,2,3,0.667,0,1,1
15677,Cole Aldrich,28-008,C,11/8/16,MIN,@,BRK,L,0,23,1,3,0.333,1,3,0.333,0,0,,2,2,1,2,3,5
15678,Cole Aldrich,28-023,C,11/23/16,MIN,@,NOP,L,0,14,2,4,0.5,2,4,0.5,0,0,,0,0,,1,4,5
15679,Lavoy Allen,27-358,F-C,1/27/17,IND,,SAC,W,0,16,2,4,0.5,2,4,0.5,0,0,,0,0,,2,2,4
15680,Lavoy Allen,28-007,F-C,2/11/17,IND,,MIL,L,1,19,2,3,0.667,2,3,0.667,0,0,,0,2,0,3,3,6
15681,Lavoy Allen,27-277,F-C,11/7/16,IND,@,CHO,L,0,22,2,2,1,2,2,1,0,0,,0,0,,2,5,7
15682,Lavoy Allen,28-023,F-C,2/27/17,IND,@,HOU,W,0,22,2,9,0.222,2,9,0.222,0,0,,0,0,,6,5,11
15683,Lavoy Allen,27-288,F-C,11/18/16,IND,,PHO,L,0,13,2,3,0.667,2,3,0.667,0,0,,0,0,,2,2,4
15684,Lavoy Allen,28-021,F-C,2/25/17,IND,@,MIA,L,0,16,2,5,0.4,2,5,0.4,0,0,,0,0,,2,4,6
15685,Lavoy Allen,27-271,F-C,11/1/16,IND,,LAL,W,0,19,2,3,0.667,2,3,0.667,0,0,,0,0,,2,1,3
15686,Tony Allen,34-313,G-F,11/19/16,MEM,,MIN,W,1,20,2,8,0.25,2,8,0.25,0,0,,0,0,,0,1,1
15687,Tony Allen,35-004,G-F,1/15/17,MEM,,CHI,L,1,33,2,8,0.25,2,7,0.286,0,1,0,0,0,,2,6,8
15688,Tony Allen,35-021,G-F,2/1/17,MEM,@,DEN,W,1,30,2,8,0.25,2,8,0.25,0,0,,0,0,,2,1,3
15689,Tony Allen,34-298,G-F,11/4/16,MEM,,LAC,L,1,19,2,7,0.286,2,6,0.333,0,1,0,0,0,,1,2,3
15690,Tony Allen,34-296,G-F,11/2/16,MEM,,NOP,W,1,28,1,8,0.125,1,7,0.143,0,1,0,2,5,0.4,2,1,3
15691,Tony Allen,34-295,G-F,11/1/16,MEM,@,MIN,L,0,19,2,7,0.286,2,7,0.286,0,0,,0,0,,4,0,4
15692,Tony Allen,35-059,G-F,3/11/17,MEM,,ATL,L,0,21,2,7,0.286,2,7,0.286,0,0,,0,0,,3,2,5
15693,Tony Allen,34-319,G-F,11/25/16,MEM,,MIA,L,1,24,2,7,0.286,2,5,0.4,0,2,0,0,0,,2,1,3
15694,Chris Andersen,38-141,F-C,11/25/16,CLE,,DAL,W,0,19,2,4,0.5,2,3,0.667,0,1,0,0,0,,3,3,6
15695,Chris Andersen,38-155,F-C,12/9/16,CLE,,MIA,W,0,12,1,1,1,1,1,1,0,0,,2,2,1,1,3,4
15696,Alan Anderson,34-061,G-F,12/16/16,LAC,@,MIA,W,0,12,1,1,1,0,0,,1,1,1,1,2,0.5,0,0,0
15697,Justin Anderson,22-363,G,11/16/16,DAL,@,BOS,L,0,21,2,3,0.667,2,3,0.667,0,0,,0,0,,1,2,3
15698,Justin Anderson,23-011,G,11/30/16,DAL,,SAS,L,0,21,1,4,0.25,1,1,1,0,3,0,2,2,1,0,1,1
15699,Justin Anderson,22-353,G,11/6/16,DAL,,MIL,W,1,10,2,5,0.4,2,3,0.667,0,2,0,0,0,,0,2,2
15700,Kyle Anderson,23-135,F-G,2/2/17,SAS,,PHI,W,0,24,1,3,0.333,1,3,0.333,0,0,,2,2,1,0,5,5
15701,Kyle Anderson,23-129,F-G,1/27/17,SAS,@,NOP,L,0,18,0,2,0,0,1,0,0,1,0,4,4,1,0,2,2
15702,Kyle Anderson,23-101,F-G,12/30/16,SAS,,POR,W,1,28,2,6,0.333,2,4,0.5,0,2,0,0,0,,2,6,8
15703,Kyle Anderson,23-135,F-G,2/2/17,SAS,,PHI,W,0,24,1,3,0.333,1,3,0.333,0,0,,2,2,1,0,5,5
15704,Ryan Anderson,28-218,F,12/10/16,HOU,,DAL,W,1,30,2,8,0.25,2,5,0.4,0,3,0,0,0,,0,7,7
15705,Joel Anthony,34-171,C,1/27/17,SAS,@,NOP,L,0,8,1,1,1,1,1,1,0,0,,2,2,1,0,1,1
15706,Joel Anthony,34-214,C,3/11/17,SAS,,GSW,W,0,13,2,4,0.5,2,4,0.5,0,0,,0,0,,0,1,1
15707,Joel Anthony,34-177,C,2/2/17,SAS,,PHI,W,0,13,2,3,0.667,2,3,0.667,0,0,,0,0,,2,2,4
15708,Darrell Arthur,28-344,F,3/4/17,DEN,,CHO,L,0,16,2,5,0.4,2,3,0.667,0,2,0,0,0,,1,4,5
15709,Omer Asik,30-133,C,11/14/16,NOP,,BOS,W,1,12,2,2,1,2,2,1,0,0,,0,0,,1,3,4
15710,Omer Asik,30-151,C,12/2/16,NOP,,LAC,L,1,18,2,3,0.667,2,3,0.667,0,0,,0,0,,2,3,5
15711,D.J. Augustin,29-123,G,3/13/17,ORL,@,SAC,L,0,14,1,7,0.143,1,3,0.333,0,4,0,2,2,1,0,2,2
15712,D.J. Augustin,29-116,G,3/6/17,ORL,,NYK,L,0,13,1,4,0.25,0,1,0,1,3,0.333,1,2,0.5,1,0,1
15713,Luke Babbitt,27-161,F,11/28/16,MIA,,BOS,L,1,23,2,7,0.286,2,3,0.667,0,4,0,0,0,,0,2,2
15714,Ron Baker,23-217,G,11/2/16,NYK,,HOU,L,0,16,1,5,0.2,0,2,0,1,3,0.333,1,2,0.5,1,0,1
15715,Ron Baker,23-262,G,12/17/16,NYK,@,DEN,L,0,12,2,7,0.286,2,4,0.5,0,3,0,0,0,,1,4,5
15716,Wade Baldwin,20-280,G,1/3/17,MEM,@,LAL,L,0,8,0,0,,0,0,,0,0,,4,4,1,0,1,1
15717,Wade Baldwin,20-251,G,12/5/16,MEM,@,NOP,W,0,21,1,5,0.2,1,4,0.25,0,1,0,2,2,1,0,1,1
15718,Wade Baldwin,20-218,G,11/2/16,MEM,,NOP,W,0,24,2,5,0.4,2,5,0.4,0,0,,0,0,,0,3,3
15719,Leandro Barbosa,34-107,G,3/15/17,PHO,,SAC,L,0,10,2,6,0.333,2,6,0.333,0,0,,0,0,,0,2,2
15720,Leandro Barbosa,34-049,G,1/16/17,PHO,,UTA,L,0,16,2,3,0.667,2,2,1,0,1,0,0,0,,0,3,3
15721,Leandro Barbosa,34-068,G,2/4/17,PHO,,MIL,L,0,10,2,4,0.5,2,4,0.5,0,0,,0,0,,0,0,0
15722,Leandro Barbosa,33-361,G,11/23/16,PHO,@,ORL,W,0,16,2,3,0.667,2,3,0.667,0,0,,0,0,,0,2,2
15723,Leandro Barbosa,34-103,G,3/11/17,PHO,@,DAL,W,0,15,2,5,0.4,2,4,0.5,0,1,0,0,0,,0,0,0
15724,Leandro Barbosa,34-028,G,12/26/16,PHO,@,HOU,L,0,12,2,3,0.667,2,3,0.667,0,0,,0,0,,0,0,0
15725,Leandro Barbosa,34-045,G,1/12/17,PHO,,DAL,L,0,17,2,5,0.4,2,5,0.4,0,0,,0,0,,0,2,2
15726,Leandro Barbosa,34-059,G,1/26/17,PHO,@,DEN,L,0,9,2,3,0.667,2,3,0.667,0,0,,0,0,,0,1,1
15727,Leandro Barbosa,34-035,G,1/2/17,PHO,@,LAC,L,0,9,1,5,0.2,1,4,0.25,0,1,0,2,2,1,1,0,1
15728,Leandro Barbosa,34-072,G,2/8/17,PHO,@,MEM,L,0,17,2,11,0.182,2,7,0.286,0,4,0,0,0,,1,3,4
15729,Harrison Barnes,24-291,F,3/17/17,DAL,@,PHI,L,1,24,2,7,0.286,2,6,0.333,0,1,0,0,0,,0,5,5
15730,Matt Barnes,36-303,F,1/6/17,SAC,,LAC,L,1,24,1,6,0.167,0,4,0,1,2,0.5,1,2,0.5,1,5,6
15731,Brandon Bass,31-236,F,12/22/16,LAC,,SAS,W,0,13,2,4,0.5,2,4,0.5,0,0,,0,0,,1,3,4
15732,Brandon Bass,31-198,F,11/14/16,LAC,,BRK,W,0,22,2,4,0.5,2,4,0.5,0,0,,0,0,,0,4,4
15733,Brandon Bass,31-266,F,1/21/17,LAC,@,DEN,L,0,18,2,6,0.333,2,6,0.333,0,0,,0,0,,0,3,3
15734,Brandon Bass,31-291,F,2/15/17,LAC,,ATL,W,0,6,1,2,0.5,1,2,0.5,0,0,,2,2,1,0,1,1
15735,Brandon Bass,31-284,F,2/8/17,LAC,@,NYK,W,0,8,2,3,0.667,2,3,0.667,0,0,,0,0,,0,0,0
15736,Brandon Bass,31-313,F,3/9/17,LAC,@,MEM,W,0,4,2,2,1,2,2,1,0,0,,0,0,,0,1,1
15737,Brandon Bass,31-259,F,1/14/17,LAC,,LAL,W,0,9,2,3,0.667,2,3,0.667,0,0,,0,0,,0,2,2
15738,Brandon Bass,31-207,F,11/23/16,LAC,@,DAL,W,0,7,2,5,0.4,2,5,0.4,0,0,,0,0,,0,0,0
15739,Nicolas Batum,28-040,F-G,1/23/17,CHO,,WAS,L,1,38,2,9,0.222,2,6,0.333,0,3,0,0,0,,1,6,7
15740,Jerryd Bayless,28-093,G,11/21/16,PHI,,MIA,W,0,15,1,7,0.143,1,5,0.2,0,2,0,2,2,1,1,1,2
15741,Aron Baynes,29-357,C,11/30/16,DET,@,BOS,W,0,13,0,1,0,0,1,0,0,0,,4,4,1,1,2,3
15742,Aron Baynes,30-045,C,1/23/17,DET,,SAC,L,0,14,2,3,0.667,2,3,0.667,0,0,,0,0,,1,0,1
15743,Aron Baynes,30-021,C,12/30/16,DET,@,ATL,L,0,13,1,3,0.333,1,3,0.333,0,0,,2,2,1,1,2,3
15744,Aron Baynes,30-063,C,2/10/17,DET,,SAS,L,0,9,2,5,0.4,2,5,0.4,0,0,,0,0,,0,0,0
15745,Aron Baynes,29-339,C,11/12/16,DET,@,DEN,W,0,20,1,2,0.5,1,2,0.5,0,0,,2,2,1,0,2,2
15746,Aron Baynes,30-098,C,3/17/17,DET,,TOR,L,0,11,2,4,0.5,2,4,0.5,0,0,,0,0,,0,4,4
15747,Aron Baynes,29-352,C,11/25/16,DET,,LAC,W,0,21,2,7,0.286,2,7,0.286,0,0,,0,0,,2,4,6
15748,Aron Baynes,30-057,C,2/4/17,DET,@,IND,L,0,17,1,3,0.333,1,3,0.333,0,0,,2,4,0.5,2,2,4
15749,Aron Baynes,30-095,C,3/14/17,DET,@,CLE,L,0,19,2,6,0.333,2,6,0.333,0,0,,0,0,,5,1,6
15750,Aron Baynes,29-350,C,11/23/16,DET,,MIA,W,0,18,2,2,1,2,2,1,0,0,,0,0,,0,7,7
15751,Aron Baynes,30-034,C,1/12/17,DET,@,GSW,L,0,5,2,2,1,2,2,1,0,0,,0,0,,0,2,2
15752,Aron Baynes,30-092,C,3/11/17,DET,,NYK,W,0,18,2,4,0.5,2,4,0.5,0,0,,0,0,,3,3,6
15753,Aron Baynes,30-010,C,12/19/16,DET,@,CHI,L,0,18,1,3,0.333,1,3,0.333,0,0,,2,2,1,0,1,1
15754,Aron Baynes,30-008,C,12/17/16,DET,,IND,L,0,9,1,3,0.333,1,3,0.333,0,0,,2,2,1,1,3,4
15755,Aron Baynes,29-329,C,11/2/16,DET,@,BRK,L,0,19,2,5,0.4,2,5,0.4,0,0,,0,0,,3,1,4
15756,Aron Baynes,30-089,C,3/8/17,DET,@,IND,L,0,10,2,2,1,2,2,1,0,0,,0,0,,1,2,3
15757,Aron Baynes,29-345,C,11/18/16,DET,@,CLE,L,0,15,1,3,0.333,1,3,0.333,0,0,,2,2,1,1,6,7
15758,Malik Beasley,20-047,G,1/12/17,DEN,,IND,W,0,3,2,2,1,2,2,1,0,0,,0,0,,1,0,1
15759,Malik Beasley,20-072,G,2/6/17,DEN,,DAL,W,0,2,2,3,0.667,2,3,0.667,0,0,,0,0,,1,0,1
15760,Michael Beasley,27-299,F,11/3/16,MIL,,IND,W,0,13,2,6,0.333,2,5,0.4,0,1,0,0,0,,0,2,2
15761,Michael Beasley,27-294,F,10/29/16,MIL,,BRK,W,0,9,2,2,1,2,2,1,0,0,,0,0,,0,0,0
15762,Marco Belinelli,30-335,G-F,2/23/17,CHO,@,DET,L,0,23,2,7,0.286,2,4,0.5,0,3,0,0,0,,1,7,8
15763,DeAndre' Bembry,22-212,F,2/1/17,ATL,@,MIA,L,0,22,2,6,0.333,2,6,0.333,0,0,,0,1,0,0,3,3
15764,DeAndre' Bembry,22-226,F,2/15/17,ATL,@,LAC,L,0,8,2,3,0.667,2,3,0.667,0,0,,0,0,,0,2,2
15765,DeAndre' Bembry,22-200,F,1/20/17,ATL,,CHI,W,0,10,2,4,0.5,2,4,0.5,0,0,,0,0,,0,0,0
15766,DeAndre' Bembry,22-198,F,1/18/17,ATL,@,DET,L,0,12,1,2,0.5,1,2,0.5,0,0,,2,5,0.4,1,2,3
15767,Anthony Bennett,23-268,F,12/7/16,BRK,,DEN,W,0,7,2,3,0.667,2,2,1,0,1,0,0,0,,2,0,2
15768,Anthony Bennett,23-275,F,12/14/16,BRK,,LAL,W,0,13,1,5,0.2,1,2,0.5,0,3,0,2,2,1,1,4,5
15769,Davis Bertans,24-068,F,1/19/17,SAS,,DEN,W,0,15,1,2,0.5,0,0,,1,2,0.5,1,2,0.5,0,2,2
15770,Patrick Beverley,28-161,G,12/20/16,HOU,,SAS,L,1,32,2,7,0.286,2,3,0.667,0,4,0,0,0,,3,5,8
15771,Bismack Biyombo,24-197,C-F,3/13/17,ORL,@,SAC,L,0,16,1,3,0.333,1,3,0.333,0,0,,2,2,1,1,3,4
15772,Bismack Biyombo,24-096,C-F,12/2/16,ORL,@,PHI,W,1,32,1,1,1,1,1,1,0,0,,2,6,0.333,4,9,13
15773,Bismack Biyombo,24-143,C-F,1/18/17,ORL,@,NOP,L,0,19,2,4,0.5,2,4,0.5,0,0,,0,0,,0,6,6
15774,Bismack Biyombo,24-171,C-F,2/15/17,ORL,,SAS,L,0,16,1,2,0.5,1,2,0.5,0,0,,2,3,0.667,1,2,3
15775,Bismack Biyombo,24-139,C-F,1/14/17,ORL,@,UTA,L,0,15,0,2,0,0,2,0,0,0,,4,4,1,1,3,4
15776,Bismack Biyombo,24-075,C-F,11/11/16,ORL,,UTA,L,0,23,1,5,0.2,1,5,0.2,0,0,,2,4,0.5,0,8,8
15777,Bismack Biyombo,24-091,C-F,11/27/16,ORL,,MIL,L,1,33,1,5,0.2,1,5,0.2,0,0,,2,4,0.5,1,3,4
15778,Bismack Biyombo,24-154,C-F,1/29/17,ORL,@,TOR,W,0,15,2,3,0.667,2,3,0.667,0,0,,0,2,0,0,5,5
15779,Bismack Biyombo,24-136,C-F,1/11/17,ORL,@,LAC,L,0,16,2,3,0.667,2,3,0.667,0,0,,0,0,,0,2,2
15780,Bismack Biyombo,24-101,C-F,12/7/16,ORL,,BOS,L,1,26,1,2,0.5,1,2,0.5,0,0,,2,4,0.5,2,3,5
15781,Bismack Biyombo,24-163,C-F,2/7/17,ORL,@,HOU,L,0,18,2,6,0.333,2,6,0.333,0,0,,0,2,0,1,4,5
15782,Bismack Biyombo,24-187,C-F,3/3/17,ORL,,MIA,W,0,16,2,4,0.5,2,4,0.5,0,0,,0,0,,1,1,2
15783,Bismack Biyombo,24-201,C-F,3/17/17,ORL,@,PHO,W,0,16,1,1,1,1,1,1,0,0,,2,2,1,0,3,3
15784,Bismack Biyombo,24-160,C-F,2/4/17,ORL,@,ATL,L,0,25,1,2,0.5,1,2,0.5,0,0,,2,2,1,0,2,2
15785,Bismack Biyombo,24-067,C-F,11/3/16,ORL,,SAC,W,0,22,2,2,1,2,2,1,0,0,,0,0,,3,6,9
15786,Nemanja Bjelica,28-243,F,1/7/17,MIN,,UTA,L,0,11,2,2,1,2,2,1,0,0,,0,0,,0,1,1
15787,Nemanja Bjelica,28-270,F,2/3/17,MIN,@,DET,L,0,23,2,5,0.4,2,5,0.4,0,0,,0,0,,1,5,6
15788,Tarik Black,25-073,C-F,2/3/17,LAL,@,BOS,L,1,18,2,6,0.333,2,6,0.333,0,0,,0,2,0,4,2,6
15789,Tarik Black,24-339,C-F,10/26/16,LAL,,HOU,W,0,12,1,2,0.5,1,2,0.5,0,0,,2,2,1,1,3,4
15790,Tarik Black,24-350,C-F,11/6/16,LAL,,PHO,W,0,17,2,6,0.333,2,6,0.333,0,0,,0,0,,3,4,7
15791,Tarik Black,25-011,C-F,12/3/16,LAL,@,MEM,L,0,15,2,5,0.4,2,5,0.4,0,0,,0,0,,2,4,6
15792,Tarik Black,25-065,C-F,1/26/17,LAL,@,UTA,L,1,30,2,6,0.333,2,6,0.333,0,0,,0,0,,1,1,2
15793,Tarik Black,24-364,C-F,11/20/16,LAL,,CHI,L,0,16,1,3,0.333,1,3,0.333,0,0,,2,2,1,3,3,6
15794,Tarik Black,25-064,C-F,1/25/17,LAL,@,POR,L,0,8,2,3,0.667,2,3,0.667,0,0,,0,0,,2,4,6
15795,Tarik Black,24-346,C-F,11/2/16,LAL,@,ATL,W,0,16,2,4,0.5,2,4,0.5,0,0,,0,0,,2,1,3
15796,Bojan Bogdanovic,27-193,G-F,10/28/16,BRK,,IND,W,1,28,1,6,0.167,1,4,0.25,0,2,0,2,2,1,0,1,1
15797,Andrew Bogut,31-361,C,11/23/16,DAL,,LAC,L,1,25,2,2,1,2,2,1,0,0,,0,0,,4,8,12
15798,Andrew Bogut,31-335,C,10/28/16,DAL,,HOU,L,1,27,2,4,0.5,2,4,0.5,0,0,,0,0,,1,11,12
15799,Andrew Bogut,31-357,C,11/19/16,DAL,@,ORL,L,1,34,2,6,0.333,2,6,0.333,0,0,,0,0,,2,6,8
15800,Andrew Bogut,32-079,C,2/15/17,DAL,@,DET,L,0,18,2,4,0.5,2,4,0.5,0,0,,0,0,,3,5,8
15801,Andrew Bogut,31-335,C,10/28/16,DAL,,HOU,L,1,27,2,4,0.5,2,4,0.5,0,0,,0,0,,1,11,12
15802,Andrew Bogut,31-357,C,11/19/16,DAL,@,ORL,L,1,34,2,6,0.333,2,6,0.333,0,0,,0,0,,2,6,8
15803,Trevor Booker,28-343,F,11/2/16,BRK,,DET,W,1,30,2,6,0.333,2,6,0.333,0,0,,0,0,,1,3,4
15804,Trevor Booker,28-359,F,11/18/16,BRK,@,OKC,L,1,22,2,5,0.4,2,4,0.5,0,1,0,0,0,,0,4,4
15805,Trevor Booker,29-027,F,12/22/16,BRK,,GSW,L,1,24,2,5,0.4,2,5,0.4,0,0,,0,0,,3,4,7
15806,Trevor Booker,29-044,F,1/8/17,BRK,,PHI,L,1,18,2,3,0.667,2,3,0.667,0,0,,0,0,,1,3,4
15807,Trevor Booker,28-355,F,11/14/16,BRK,@,LAC,L,1,22,1,2,0.5,1,2,0.5,0,0,,2,2,1,0,3,3
15808,Corey Brewer,30-247,F-G,11/7/16,HOU,@,WAS,W,1,16,1,2,0.5,1,1,1,0,1,0,2,2,1,0,3,3
15809,Corey Brewer,31-000,F-G,3/5/17,LAL,,NOP,L,0,16,2,5,0.4,2,3,0.667,0,2,0,0,0,,0,2,2
15810,Corey Brewer,30-321,F-G,1/20/17,HOU,,GSW,L,0,19,1,4,0.25,1,3,0.333,0,1,0,2,2,1,0,1,1
15811,Corey Brewer,30-242,F-G,11/2/16,HOU,@,NYK,W,0,14,1,2,0.5,1,2,0.5,0,0,,2,2,1,1,2,3
15812,Corey Brewer,31-010,F-G,3/15/17,LAL,@,HOU,L,0,22,2,5,0.4,2,3,0.667,0,2,0,0,0,,0,3,3
15813,Corey Brewer,30-303,F-G,1/2/17,HOU,,WAS,W,1,16,2,4,0.5,2,2,1,0,2,0,0,0,,0,1,1
15814,Corey Brewer,31-007,F-G,3/12/17,LAL,,PHI,L,0,10,2,6,0.333,2,6,0.333,0,0,,0,0,,0,0,0
15815,Corey Brewer,30-347,F-G,2/15/17,HOU,,MIA,L,0,27,2,4,0.5,2,3,0.667,0,1,0,0,0,,1,1,2
15816,Corey Brewer,30-254,F-G,11/14/16,HOU,,PHI,W,0,14,1,2,0.5,1,1,1,0,1,0,2,2,1,1,3,4
15817,Corey Brewer,30-235,F-G,10/26/16,HOU,@,LAL,L,0,15,2,4,0.5,2,3,0.667,0,1,0,0,2,0,0,0,0
15818,Malcolm Brogdon,24-087,G,3/8/17,MIL,,NYK,W,1,22,1,8,0.125,1,5,0.2,0,3,0,2,2,1,1,0,1
15819,Malcolm Brogdon,24-001,G,12/12/16,MIL,@,TOR,L,0,23,1,6,0.167,1,4,0.25,0,2,0,2,2,1,1,1,2
15820,Malcolm Brogdon,24-047,G,1/27/17,MIL,@,TOR,L,0,25,2,5,0.4,2,5,0.4,0,0,,0,0,,0,2,2
15821,Malcolm Brogdon,24-041,G,1/21/17,MIL,@,MIA,L,0,30,1,10,0.1,1,8,0.125,0,2,0,2,2,1,0,2,2
15822,Malcolm Brogdon,23-341,G,11/16/16,MIL,@,ATL,L,0,21,2,6,0.333,2,4,0.5,0,2,0,0,0,,0,2,2
15823,Aaron Brooks,31-314,G,11/23/16,IND,,ATL,L,0,6,2,3,0.667,2,3,0.667,0,0,,0,0,,0,0,0
15824,Aaron Brooks,31-298,G,11/7/16,IND,@,CHO,L,0,21,1,7,0.143,1,4,0.25,0,3,0,2,2,1,0,2,2
15825,Aaron Brooks,31-341,G,12/20/16,IND,@,NYK,L,0,11,2,4,0.5,2,2,1,0,2,0,0,0,,0,0,0
15826,Aaron Brooks,31-309,G,11/18/16,IND,,PHO,L,0,12,2,6,0.333,2,5,0.4,0,1,0,0,0,,0,3,3
15827,Aaron Brooks,31-355,G,1/3/17,IND,@,DET,W,0,15,1,2,0.5,0,1,0,1,1,1,1,2,0.5,0,0,0
15828,Aaron Brooks,31-335,G,12/14/16,IND,@,MIA,L,0,17,2,7,0.286,2,6,0.333,0,1,0,0,0,,0,0,0
15829,Aaron Brooks,32-032,G,2/15/17,IND,@,CLE,L,0,8,1,3,0.333,0,1,0,1,2,0.5,1,1,1,1,0,1
15830,Jaylen Brown,20-098,F,1/30/17,BOS,,DET,W,1,18,2,6,0.333,2,4,0.5,0,2,0,0,0,,0,3,3
15831,Jaylen Brown,20-013,F,11/6/16,BOS,,DEN,L,1,21,1,7,0.143,1,4,0.25,0,3,0,2,2,1,2,1,3
15832,Jaylen Brown,20-059,F,12/22/16,BOS,@,IND,W,0,18,2,7,0.286,2,7,0.286,0,0,,0,0,,2,0,2
15833,Jaylen Brown,20-040,F,12/3/16,BOS,@,PHI,W,0,15,1,2,0.5,1,2,0.5,0,0,,2,2,1,0,2,2
15834,Jaylen Brown,20-023,F,11/16/16,BOS,,DAL,W,0,12,2,3,0.667,2,3,0.667,0,0,,0,0,,1,2,3
15835,Reggie Bullock,25-305,G-F,1/15/17,DET,@,LAL,W,1,29,2,6,0.333,2,4,0.5,0,2,0,0,1,0,0,1,1
15836,Trey Burke,24-084,G,2/4/17,WAS,,NOP,W,0,10,2,4,0.5,2,3,0.667,0,1,0,0,0,,0,1,1
15837,Trey Burke,23-359,G,11/5/16,WAS,@,ORL,L,0,16,2,5,0.4,2,5,0.4,0,0,,0,0,,0,0,0
15838,Trey Burke,24-065,G,1/16/17,WAS,,POR,W,0,20,2,8,0.25,2,6,0.333,0,2,0,0,0,,0,1,1
15839,Trey Burke,24-080,G,1/31/17,WAS,,NYK,W,0,19,2,6,0.333,2,5,0.4,0,1,0,0,0,,0,4,4
15840,Trey Burke,24-063,G,1/14/17,WAS,,PHI,W,0,18,2,5,0.4,2,3,0.667,0,2,0,0,0,,0,3,3
15841,Trey Burke,24-030,G,12/12/16,WAS,@,MIA,L,0,14,1,5,0.2,1,4,0.25,0,1,0,2,2,1,0,1,1
15842,Alec Burks,25-221,G,2/26/17,UTA,@,WAS,W,0,10,2,4,0.5,2,3,0.667,0,1,0,0,0,,0,1,1
15843,Alec Burks,25-171,G,1/7/17,UTA,@,MIN,W,0,7,2,3,0.667,2,3,0.667,0,0,,0,1,0,0,0,0
15844,Alec Burks,25-169,G,1/5/17,UTA,@,TOR,L,0,4,1,1,1,1,1,1,0,0,,2,3,0.667,0,1,1
15845,Kentavious Caldwell-Pope,23-352,G,2/4/17,DET,@,IND,L,1,32,2,9,0.222,2,6,0.333,0,3,0,0,0,,1,1,2
15846,Kentavious Caldwell-Pope,23-275,G,11/19/16,DET,,BOS,L,1,28,1,7,0.143,0,5,0,1,2,0.5,1,2,0.5,3,2,5
15847,Kentavious Caldwell-Pope,23-251,G,10/26/16,DET,@,TOR,L,1,39,2,9,0.222,2,6,0.333,0,3,0,0,0,,0,0,0
15848,Isaiah Canaan,25-165,G,11/2/16,CHI,@,BOS,L,0,19,1,4,0.25,0,1,0,1,3,0.333,1,2,0.5,0,0,0
15849,Isaiah Canaan,25-167,G,11/4/16,CHI,,NYK,L,0,14,2,5,0.4,2,3,0.667,0,2,0,0,0,,0,1,1
15850,Clint Capela,22-165,F-C,10/30/16,HOU,,DAL,W,1,26,2,7,0.286,2,7,0.286,0,0,,0,4,0,1,9,10
15851,Clint Capela,22-163,F-C,10/28/16,HOU,@,DAL,W,1,25,2,5,0.4,2,5,0.4,0,0,,0,0,,2,7,9
15852,DeMarre Carroll,30-102,F,11/6/16,TOR,,SAC,L,1,22,1,8,0.125,1,3,0.333,0,5,0,2,2,1,2,6,8
15853,DeMarre Carroll,30-142,F,12/16/16,TOR,,ATL,L,1,23,0,4,0,0,1,0,0,3,0,4,5,0.8,0,0,0
15854,DeMarre Carroll,30-202,F,2/14/17,TOR,@,CHI,L,1,40,1,4,0.25,1,1,1,0,3,0,2,2,1,0,5,5
15855,DeMarre Carroll,30-220,F,3/4/17,TOR,@,MIL,L,1,19,2,7,0.286,2,3,0.667,0,4,0,0,0,,2,4,6
15856,Vince Carter,40-054,G-F,3/21/17,MEM,@,NOP,L,1,34,2,9,0.222,2,3,0.667,0,6,0,0,0,,0,2,2
15857,Vince Carter,39-298,G-F,11/19/16,MEM,,MIN,W,0,26,0,7,0,0,2,0,0,5,0,4,5,0.8,2,3,5
15858,Vince Carter,39-338,G-F,12/29/16,MEM,,OKC,W,0,22,1,3,0.333,0,1,0,1,2,0.5,1,2,0.5,0,2,2
15859,Vince Carter,40-044,G-F,3/11/17,MEM,,ATL,L,0,21,1,5,0.2,1,2,0.5,0,3,0,2,2,1,0,2,2
15860,Vince Carter,40-042,G-F,3/9/17,MEM,,LAC,L,0,24,2,6,0.333,2,5,0.4,0,1,0,0,0,,0,2,2
15861,Michael Carter-Williams,25-129,G,2/16/17,CHI,,BOS,W,1,22,1,6,0.167,1,4,0.25,0,2,0,2,2,1,1,5,6
15862,Michael Carter-Williams,25-082,G,12/31/16,CHI,,MIL,L,1,25,1,6,0.167,0,2,0,1,4,0.25,1,2,0.5,0,1,1
15863,Michael Carter-Williams,25-123,G,2/10/17,CHI,@,PHO,L,0,8,2,3,0.667,2,3,0.667,0,0,,0,0,,0,0,0
15864,Michael Carter-Williams,25-151,G,3/10/17,CHI,,HOU,L,0,19,2,7,0.286,2,5,0.4,0,2,0,0,0,,1,1,2
15865,Michael Carter-Williams,25-079,G,12/28/16,CHI,,BRK,W,0,15,1,6,0.167,1,4,0.25,0,2,0,2,2,1,1,5,6
15866,Omri Casspi,28-126,F,10/26/16,SAC,@,PHO,W,0,9,2,2,1,2,2,1,0,0,,0,0,,1,2,3
15867,Omri Casspi,28-202,F,1/10/17,SAC,,DET,W,0,18,1,3,0.333,1,3,0.333,0,0,,2,4,0.5,2,8,10
15868,Willie Cauley-Stein,23-085,F-C,11/11/16,SAC,@,POR,L,0,8,2,2,1,2,2,1,0,0,,0,0,,2,0,2
15869,Willie Cauley-Stein,23-122,F-C,12/18/16,SAC,@,DAL,L,0,14,2,4,0.5,2,4,0.5,0,0,,0,2,0,1,5,6
15870,Willie Cauley-Stein,23-212,F-C,3/18/17,SAC,@,OKC,L,1,26,1,4,0.25,1,4,0.25,0,0,,2,2,1,1,2,3
15871,Willie Cauley-Stein,23-172,F-C,2/6/17,SAC,,CHI,L,0,7,2,2,1,2,2,1,0,0,,0,1,0,0,2,2
15872,Willie Cauley-Stein,23-077,F-C,11/3/16,SAC,@,ORL,L,0,25,2,5,0.4,2,5,0.4,0,0,,0,0,,0,1,1
15873,Willie Cauley-Stein,23-092,F-C,11/18/16,SAC,,LAC,L,0,8,2,5,0.4,2,5,0.4,0,0,,0,0,,1,0,1
15874,Willie Cauley-Stein,23-114,F-C,12/10/16,SAC,@,UTA,L,0,12,2,5,0.4,2,4,0.5,0,1,0,0,0,,1,1,2
15875,Willie Cauley-Stein,23-169,F-C,2/3/17,SAC,,PHO,L,0,14,2,4,0.5,2,4,0.5,0,0,,0,0,,1,3,4
15876,Willie Cauley-Stein,23-072,F-C,10/29/16,SAC,,MIN,W,0,8,2,3,0.667,2,3,0.667,0,0,,0,0,,0,0,0
15877,Tyson Chandler,34-074,C,12/15/16,PHO,,SAS,L,1,26,2,5,0.4,2,5,0.4,0,0,,0,0,,3,5,8
15878,Tyson Chandler,34-087,C,12/28/16,PHO,@,SAS,L,1,25,2,3,0.667,2,3,0.667,0,0,,0,0,,0,7,7
15879,Tyson Chandler,34-068,C,12/9/16,PHO,@,LAL,W,1,23,1,3,0.333,1,3,0.333,0,0,,2,4,0.5,1,9,10
15880,Tyson Chandler,34-134,C,2/13/17,PHO,,NOP,L,1,28,1,3,0.333,1,3,0.333,0,0,,2,2,1,1,7,8
15881,Tyson Chandler,34-116,C,1/26/17,PHO,@,DEN,L,1,23,2,2,1,2,2,1,0,0,,0,0,,1,4,5
15882,Tyson Chandler,34-029,C,10/31/16,PHO,@,LAC,L,1,18,1,2,0.5,1,2,0.5,0,0,,2,2,1,2,5,7
15883,Wilson Chandler,29-267,F,2/1/17,DEN,,MEM,L,0,25,2,6,0.333,2,5,0.4,0,1,0,0,1,0,0,3,3
15884,Marquese Chriss,19-210,F,1/28/17,PHO,,DEN,L,1,17,2,4,0.5,2,3,0.667,0,1,0,0,2,0,0,3,3
15885,Marquese Chriss,19-221,F,2/8/17,PHO,@,MEM,L,1,23,1,5,0.2,0,2,0,1,3,0.333,1,2,0.5,1,2,3
15886,Marquese Chriss,19-204,F,1/22/17,PHO,@,TOR,W,1,17,2,7,0.286,2,3,0.667,0,4,0,0,0,,0,1,1
15887,Marquese Chriss,19-134,F,11/13/16,PHO,@,GSW,L,1,16,2,4,0.5,2,3,0.667,0,1,0,0,0,,1,5,6
15888,Marquese Chriss,19-182,F,12/31/16,PHO,@,UTA,L,1,22,2,7,0.286,2,6,0.333,0,1,0,0,0,,1,1,2
15889,Rakeem Christmas,25-085,F,2/24/17,IND,,MEM,W,0,14,2,3,0.667,2,3,0.667,0,0,,0,0,,2,3,5
15890,Rakeem Christmas,25-086,F,2/25/17,IND,@,MIA,L,0,16,1,3,0.333,1,3,0.333,0,0,,2,2,1,4,3,7
15891,Semaj Christon,24-064,G,1/4/17,OKC,@,CHO,L,0,15,2,3,0.667,2,3,0.667,0,0,,0,0,,0,3,3
15892,Semaj Christon,23-360,G,10/26/16,OKC,@,PHI,W,0,15,2,5,0.4,2,4,0.5,0,1,0,0,0,,0,1,1
15893,Semaj Christon,24-042,G,12/13/16,OKC,@,POR,L,0,27,1,6,0.167,1,4,0.25,0,2,0,2,4,0.5,0,1,1
15894,Semaj Christon,24-104,G,2/13/17,OKC,@,WAS,L,0,11,2,5,0.4,2,5,0.4,0,0,,0,2,0,1,1,2
15895,Semaj Christon,24-052,G,12/23/16,OKC,@,BOS,W,0,21,2,5,0.4,2,2,1,0,3,0,0,0,,0,2,2
15896,Semaj Christon,24-002,G,11/3/16,OKC,@,GSW,L,0,19,2,6,0.333,2,4,0.5,0,2,0,0,0,,1,2,3
15897,Ian Clark,25-269,G,12/1/16,GSW,,HOU,L,0,12,2,6,0.333,2,4,0.5,0,2,0,0,0,,1,0,1
15898,Ian Clark,25-247,G,11/9/16,GSW,,DAL,W,0,12,2,5,0.4,2,3,0.667,0,2,0,0,0,,0,1,1
15899,Ian Clark,25-293,G,12/25/16,GSW,@,CLE,L,0,9,2,3,0.667,2,3,0.667,0,0,,0,0,,0,0,0
15900,Ian Clark,25-307,G,1/8/17,GSW,@,SAC,W,0,10,1,5,0.2,1,3,0.333,0,2,0,2,2,1,0,0,0
15901,Ian Clark,25-307,G,1/8/17,GSW,@,SAC,W,0,10,1,5,0.2,1,3,0.333,0,2,0,2,2,1,0,0,0
15902,Ian Clark,25-251,G,11/13/16,GSW,,PHO,W,0,5,2,2,1,2,2,1,0,0,,0,0,,0,0,0
15903,Jordan Clarkson,24-143,G,10/28/16,LAL,@,UTA,L,0,25,2,9,0.222,2,6,0.333,0,3,0,0,0,,0,2,2
15904,Jordan Clarkson,24-198,G,12/22/16,LAL,@,MIA,L,0,25,2,10,0.2,2,7,0.286,0,3,0,0,0,,0,2,2
15905,Jordan Clarkson,24-213,G,1/6/17,LAL,,MIA,W,0,10,2,4,0.5,2,3,0.667,0,1,0,0,0,,0,0,0
15906,Norris Cole,28-158,G,3/20/17,OKC,,GSW,L,0,3,2,2,1,2,2,1,0,0,,0,0,,0,0,0
15907,Norris Cole,28-143,G,3/5/17,OKC,@,DAL,L,0,24,2,7,0.286,2,4,0.5,0,3,0,0,0,,0,3,3
15908,Darren Collison,29-150,G,1/20/17,SAC,@,MEM,L,1,27,2,7,0.286,2,4,0.5,0,3,0,0,0,,0,3,3
15909,Quinn Cook,23-347,G,3/5/17,DAL,,OKC,W,0,14,2,4,0.5,2,4,0.5,0,0,,0,2,0,0,1,1
15910,Robert Covington,25-338,F,11/16/16,PHI,,WAS,W,1,23,1,7,0.143,1,2,0.5,0,5,0,2,4,0.5,1,6,7
15911,Robert Covington,25-327,F,11/5/16,PHI,,CLE,L,1,30,1,10,0.1,0,1,0,1,9,0.111,1,2,0.5,0,8,8
15912,Robert Covington,25-339,F,11/17/16,PHI,@,MIN,L,1,28,1,12,0.083,1,5,0.2,0,7,0,2,2,1,1,2,3
15913,Allen Crabbe,24-218,G-F,11/13/16,POR,,DEN,W,0,31,2,8,0.25,2,5,0.4,0,3,0,0,0,,0,2,2
15914,Allen Crabbe,24-339,G-F,3/14/17,POR,@,NOP,L,0,25,1,8,0.125,0,2,0,1,6,0.167,1,2,0.5,0,2,2
15915,Allen Crabbe,24-230,G-F,11/25/16,POR,,NOP,W,0,18,2,6,0.333,2,3,0.667,0,3,0,0,0,,0,1,1
15916,Allen Crabbe,24-320,G-F,2/23/17,POR,@,ORL,W,0,25,2,3,0.667,2,3,0.667,0,0,,0,0,,0,1,1
15917,Allen Crabbe,24-209,G-F,11/4/16,POR,@,DAL,W,0,33,2,9,0.222,2,4,0.5,0,5,0,0,0,,0,6,6
15918,Allen Crabbe,24-286,G-F,1/20/17,POR,@,PHI,L,0,25,1,3,0.333,1,3,0.333,0,0,,2,2,1,0,1,1
15919,Allen Crabbe,24-304,G-F,2/7/17,POR,@,DAL,W,0,22,1,6,0.167,1,2,0.5,0,4,0,2,2,1,0,0,0
15920,Jamal Crawford,36-343,G,2/26/17,LAC,,CHO,W,0,16,1,5,0.2,1,2,0.5,0,3,0,2,2,1,0,1,1
15921,Jae Crowder,26-138,F,11/21/16,BOS,@,MIN,W,1,24,2,6,0.333,2,3,0.667,0,3,0,0,0,,1,4,5
15922,Jae Crowder,26-217,F,2/8/17,BOS,@,SAC,L,1,32,0,6,0,0,2,0,0,4,0,4,4,1,0,2,2
15923,Dante Cunningham,29-318,F,3/6/17,NOP,@,UTA,L,0,26,2,6,0.333,2,2,1,0,4,0,0,0,,2,3,5
15924,Dante Cunningham,29-292,F,2/8/17,NOP,,UTA,L,0,24,2,4,0.5,2,3,0.667,0,1,0,0,0,,0,4,4
15925,Dante Cunningham,29-193,F,11/1/16,NOP,,MIL,L,1,38,1,9,0.111,0,5,0,1,4,0.25,1,2,0.5,1,4,5
15926,Dante Cunningham,29-210,F,11/18/16,NOP,,POR,W,1,25,2,4,0.5,2,2,1,0,2,0,0,0,,0,3,3
15927,Dante Cunningham,29-265,F,1/12/17,NOP,@,BRK,W,0,22,2,6,0.333,2,3,0.667,0,3,0,0,0,,2,3,5
15928,Dante Cunningham,29-280,F,1/27/17,NOP,,SAS,W,1,29,2,4,0.5,2,2,1,0,2,0,0,0,,0,2,2
15929,Seth Curry,26-108,G,12/9/16,DAL,,IND,W,0,25,2,8,0.25,2,5,0.4,0,3,0,0,1,0,0,0,0
15930,Seth Curry,26-168,G,2/7/17,DAL,,POR,L,1,27,1,1,1,1,1,1,0,0,,2,2,1,0,0,0
15931,Troy Daniels,25-106,G,10/29/16,MEM,@,NYK,L,0,12,1,5,0.2,1,2,0.5,0,3,0,2,2,1,0,0,0
15932,Deyonta Davis,19-365,F-C,12/1/16,MEM,,ORL,W,0,14,1,2,0.5,1,2,0.5,0,0,,2,2,1,1,1,2
15933,Deyonta Davis,19-362,F-C,11/28/16,MEM,,CHO,L,0,14,2,4,0.5,2,4,0.5,0,0,,0,0,,1,2,3
15934,Deyonta Davis,19-359,F-C,11/25/16,MEM,,MIA,L,0,15,2,3,0.667,2,3,0.667,0,0,,0,0,,3,2,5
15935,Ed Davis,27-208,F,12/30/16,POR,@,SAS,L,0,13,2,2,1,2,2,1,0,0,,0,0,,0,1,1
15936,Ed Davis,27-171,F,11/23/16,POR,@,CLE,L,1,18,1,4,0.25,1,4,0.25,0,0,,2,2,1,1,2,3
15937,Ed Davis,27-201,F,12/23/16,POR,,SAS,L,0,7,2,2,1,2,2,1,0,0,,0,0,,1,1,2
15938,Ed Davis,27-222,F,1/13/17,POR,,ORL,L,0,16,2,2,1,2,2,1,0,0,,0,0,,0,4,4
15939,Ed Davis,27-220,F,1/11/17,POR,,CLE,W,0,16,2,3,0.667,2,3,0.667,0,0,,0,0,,1,5,6
15940,Ed Davis,27-181,F,12/3/16,POR,,MIA,W,1,26,2,5,0.4,2,5,0.4,0,0,,0,0,,5,1,6
15941,Ed Davis,27-146,F,10/29/16,POR,@,DEN,W,0,13,2,2,1,2,2,1,0,0,,0,0,,0,2,2
15942,Dewayne Dedmon,27-213,C,3/13/17,SAS,,ATL,W,1,22,2,2,1,2,2,1,0,0,,0,0,,0,8,8
15943,Dewayne Dedmon,27-196,C,2/24/17,SAS,@,LAC,W,1,24,2,3,0.667,2,3,0.667,0,0,,0,0,,2,10,12
15944,Dewayne Dedmon,27-085,C,11/5/16,SAS,,LAC,L,0,19,2,4,0.5,2,4,0.5,0,0,,0,0,,0,3,3
15945,Dewayne Dedmon,27-132,C,12/22/16,SAS,@,LAC,L,0,15,1,3,0.333,1,3,0.333,0,0,,2,2,1,1,5,6
15946,Dewayne Dedmon,27-203,C,3/3/17,SAS,@,NOP,W,1,16,2,3,0.667,2,3,0.667,0,0,,0,0,,1,4,5
15947,Dewayne Dedmon,27-201,C,3/1/17,SAS,,IND,W,1,16,1,1,1,1,1,1,0,0,,2,2,1,1,2,3
15948,Dewayne Dedmon,27-215,C,3/15/17,SAS,,POR,L,1,20,2,2,1,2,2,1,0,0,,0,0,,1,4,5
15949,Sam Dekker,22-192,F,11/14/16,HOU,,PHI,W,0,27,2,4,0.5,2,3,0.667,0,1,0,0,2,0,4,3,7
15950,Sam Dekker,22-308,F,3/10/17,HOU,@,CHI,W,0,18,1,4,0.25,1,3,0.333,0,1,0,2,4,0.5,1,5,6
15951,Sam Dekker,22-173,F,10/26/16,HOU,@,LAL,L,0,14,2,3,0.667,2,2,1,0,1,0,0,0,,0,1,1
15952,Sam Dekker,22-205,F,11/27/16,HOU,@,POR,W,0,18,2,5,0.4,2,2,1,0,3,0,0,0,,0,2,2
15953,Sam Dekker,22-262,F,1/23/17,HOU,@,MIL,L,0,16,2,7,0.286,2,4,0.5,0,3,0,0,0,,0,1,1
15954,Sam Dekker,22-279,F,2/9/17,HOU,@,CHO,W,0,20,2,7,0.286,2,4,0.5,0,3,0,0,0,,1,1,2
15955,Malcolm Delaney,27-302,G,1/7/17,ATL,@,DAL,W,0,25,2,6,0.333,2,6,0.333,0,0,,0,0,,0,3,3
15956,Malcolm Delaney,27-334,G,2/8/17,ATL,,DEN,W,0,25,2,8,0.25,2,6,0.333,0,2,0,0,0,,1,4,5
15957,Malcolm Delaney,27-357,G,3/3/17,ATL,,CLE,L,0,7,2,3,0.667,2,2,1,0,1,0,0,0,,0,1,1
15958,Malcolm Delaney,27-252,G,11/18/16,ATL,@,CHO,L,0,17,2,8,0.25,2,5,0.4,0,3,0,0,0,,0,1,1
15959,Malcolm Delaney,27-281,G,12/17/16,ATL,,CHO,L,0,13,2,5,0.4,2,4,0.5,0,1,0,0,0,,0,0,0
15960,Malcolm Delaney,27-250,G,11/16/16,ATL,,MIL,W,0,17,2,5,0.4,2,4,0.5,0,1,0,0,0,,0,4,4
15961,Malcolm Delaney,27-296,G,1/1/17,ATL,,SAS,W,0,20,2,5,0.4,2,5,0.4,0,0,,0,0,,0,4,4
15962,Malcolm Delaney,27-313,G,1/18/17,ATL,@,DET,L,0,14,1,5,0.2,0,3,0,1,2,0.5,1,2,0.5,0,3,3
15963,Malcolm Delaney,27-327,G,2/1/17,ATL,@,MIA,L,0,11,1,4,0.25,1,3,0.333,0,1,0,2,2,1,0,0,0
15964,Malcolm Delaney,27-230,G,10/27/16,ATL,,WAS,W,0,20,2,7,0.286,2,6,0.333,0,1,0,0,0,,0,1,1
15965,Malcolm Delaney,27-261,G,11/27/16,ATL,@,LAL,L,0,12,2,4,0.5,2,4,0.5,0,0,,0,0,,0,2,2
15966,Malcolm Delaney,27-273,G,12/9/16,ATL,@,MIL,W,0,18,2,7,0.286,2,5,0.4,0,2,0,0,1,0,0,6,6
15967,Malcolm Delaney,27-292,G,12/28/16,ATL,,NYK,W,0,10,2,4,0.5,2,3,0.667,0,1,0,0,1,0,0,0,0
15968,Malcolm Delaney,27-324,G,1/29/17,ATL,,NYK,W,0,22,1,6,0.167,1,5,0.2,0,1,0,2,2,1,0,2,2
15969,Malcolm Delaney,27-271,G,12/7/16,ATL,,MIA,W,0,17,2,6,0.333,2,5,0.4,0,1,0,0,0,,0,2,2
15970,Malcolm Delaney,27-322,G,1/27/17,ATL,,WAS,L,0,23,1,6,0.167,1,3,0.333,0,3,0,2,4,0.5,0,2,2
15971,Malcolm Delaney,27-242,G,11/8/16,ATL,@,CLE,W,0,14,2,3,0.667,2,3,0.667,0,0,,0,0,,0,4,4
15972,Matthew Dellavedova,26-065,G,11/12/16,MIL,,MEM,W,1,26,2,4,0.5,2,3,0.667,0,1,0,0,0,,1,1,2
15973,Matthew Dellavedova,26-124,G,1/10/17,MIL,@,SAS,W,0,23,2,5,0.4,2,4,0.5,0,1,0,0,0,,1,1,2
15974,Matthew Dellavedova,26-172,G,2/27/17,MIL,@,CLE,L,1,32,2,10,0.2,2,5,0.4,0,5,0,0,0,,0,3,3
15975,Matthew Dellavedova,26-148,G,2/3/17,MIL,@,DEN,L,1,31,2,5,0.4,2,4,0.5,0,1,0,0,0,,2,2,4
15976,Luol Deng,31-225,F,11/27/16,LAL,,ATL,W,1,19,2,5,0.4,2,3,0.667,0,2,0,0,0,,0,4,4
15977,Luol Deng,31-223,F,11/25/16,LAL,,GSW,L,1,22,2,9,0.222,2,7,0.286,0,2,0,0,0,,1,3,4
15978,Luol Deng,31-304,F,2/14/17,LAL,,SAC,L,0,21,2,5,0.4,2,4,0.5,0,1,0,0,0,,1,2,3
15979,Luol Deng,31-284,F,1/25/17,LAL,@,POR,L,1,26,2,7,0.286,2,3,0.667,0,4,0,0,0,,0,4,4
15980,Cheick Diallo,20-089,F,12/11/16,NOP,@,PHO,W,0,9,1,3,0.333,1,3,0.333,0,0,,2,2,1,2,2,4
15981,Boris Diaw,34-303,F-C,2/13/17,UTA,,LAC,L,0,18,2,3,0.667,2,3,0.667,0,0,,0,2,0,0,3,3
15982,Boris Diaw,34-323,F-C,3/5/17,UTA,@,SAC,W,0,26,2,4,0.5,2,3,0.667,0,1,0,0,0,,0,1,1
15983,Boris Diaw,34-249,F-C,12/21/16,UTA,,SAC,L,1,24,2,3,0.667,2,3,0.667,0,0,,0,0,,1,2,3
15984,Boris Diaw,34-299,F-C,2/9/17,UTA,@,DAL,L,0,14,2,2,1,2,2,1,0,0,,0,0,,0,1,1
15985,Boris Diaw,34-336,F-C,3/18/17,UTA,@,CHI,L,0,16,2,6,0.333,2,5,0.4,0,1,0,0,0,,2,1,3
15986,Boris Diaw,34-334,F-C,3/16/17,UTA,@,CLE,L,0,17,2,3,0.667,2,2,1,0,1,0,0,2,0,1,0,1
15987,Boris Diaw,34-231,F-C,12/3/16,UTA,,DEN,W,1,23,2,5,0.4,2,4,0.5,0,1,0,0,0,,1,5,6
15988,Boris Diaw,34-279,F-C,1/20/17,UTA,@,DAL,W,0,17,2,2,1,2,2,1,0,0,,0,0,,0,2,2
15989,Boris Diaw,34-296,F-C,2/6/17,UTA,@,ATL,W,0,20,2,4,0.5,2,3,0.667,0,1,0,0,0,,0,1,1
15990,Boris Diaw,34-227,F-C,11/29/16,UTA,,HOU,W,1,13,2,2,1,2,2,1,0,0,,0,0,,0,2,2
15991,Boris Diaw,34-244,F-C,12/16/16,UTA,,DAL,W,1,18,2,2,1,2,2,1,0,0,,0,0,,1,1,2
15992,Boris Diaw,34-329,F-C,3/11/17,UTA,@,OKC,L,0,11,2,2,1,2,2,1,0,0,,0,0,,0,2,2
15993,Boris Diaw,34-326,F-C,3/8/17,UTA,@,HOU,W,0,14,2,4,0.5,2,4,0.5,0,0,,0,0,,3,1,4
15994,Gorgui Dieng,26-361,C,1/13/17,MIN,,OKC,W,1,33,1,10,0.1,1,9,0.111,0,1,0,2,2,1,0,3,3
15995,Gorgui Dieng,27-004,C,1/22/17,MIN,,DEN,W,1,17,2,3,0.667,2,3,0.667,0,0,,0,0,,0,1,1
15996,Gorgui Dieng,26-334,C,12/17/16,MIN,,HOU,L,1,33,2,3,0.667,2,3,0.667,0,0,,0,0,,1,5,6
15997,Gorgui Dieng,27-037,C,2/24/17,MIN,,DAL,W,1,32,1,4,0.25,1,4,0.25,0,0,,2,2,1,2,1,3
15998,Spencer Dinwiddie,23-248,G,12/10/16,BRK,@,SAS,L,0,10,2,3,0.667,2,3,0.667,0,0,,0,0,,0,1,1
15999,Spencer Dinwiddie,23-268,G,12/30/16,BRK,@,WAS,L,0,23,2,2,1,2,2,1,0,0,,0,0,,0,0,0
16000,Spencer Dinwiddie,23-279,G,1/10/17,BRK,,ATL,L,0,22,1,5,0.2,1,5,0.2,0,0,,2,2,1,2,5,7
16001,Spencer Dinwiddie,23-345,G,3/17/17,BRK,,BOS,L,0,29,1,5,0.2,1,3,0.333,0,2,0,2,2,1,1,2,3
16002,Toney Douglas,30-272,G,12/13/16,MEM,@,CLE,L,0,15,2,7,0.286,2,5,0.4,0,2,0,0,0,,0,2,2
16003,Toney Douglas,30-269,G,12/10/16,MEM,,GSW,W,0,23,2,9,0.222,2,7,0.286,0,2,0,0,0,,1,2,3
16004,Toney Douglas,30-352,G,3/3/17,MEM,@,DAL,L,0,20,1,2,0.5,1,1,1,0,1,0,2,2,1,0,2,2
16005,Toney Douglas,30-349,G,2/28/17,MEM,,PHO,W,0,22,2,5,0.4,2,4,0.5,0,1,0,0,0,,0,5,5
16006,Toney Douglas,30-360,G,3/11/17,MEM,,ATL,L,0,6,2,3,0.667,2,3,0.667,0,0,,0,0,,1,0,1
16007,Jared Dudley,31-108,F-G,10/26/16,PHO,,SAC,L,1,26,2,4,0.5,2,4,0.5,0,0,,0,2,0,0,2,2
16008,Jared Dudley,31-138,F-G,11/25/16,PHO,,MIN,L,0,20,2,5,0.4,2,3,0.667,0,2,0,0,0,,2,4,6
16009,Jared Dudley,31-166,F-G,12/23/16,PHO,,PHI,W,0,13,2,4,0.5,2,3,0.667,0,1,0,0,0,,0,1,1
16010,Jared Dudley,31-248,F-G,3/15/17,PHO,,SAC,L,0,16,2,5,0.4,2,3,0.667,0,2,0,0,0,,1,2,3
16011,Mike Dunleavy,36-040,F-G,10/25/16,CLE,,NYK,W,0,23,2,3,0.667,2,2,1,0,1,0,0,0,,0,4,4
16012,Mike Dunleavy,36-128,F-G,1/21/17,ATL,,PHI,W,0,18,2,5,0.4,2,5,0.4,0,0,,0,0,,0,2,2
16013,Kris Dunn,22-348,G,3/1/17,MIN,@,UTA,W,0,20,1,2,0.5,0,0,,1,2,0.5,1,2,0.5,0,1,1
16014,Kris Dunn,22-346,G,2/27/17,MIN,@,SAC,W,0,17,2,3,0.667,2,3,0.667,0,0,,0,0,,1,0,1
16015,Kris Dunn,22-301,G,1/13/17,MIN,,OKC,W,0,12,2,4,0.5,2,4,0.5,0,0,,0,0,,1,1,2
16016,Kris Dunn,22-318,G,1/30/17,MIN,,ORL,W,0,17,2,5,0.4,2,3,0.667,0,2,0,0,0,,0,1,1
16017,Kris Dunn,22-362,G,3/15/17,MIN,@,BOS,L,0,16,2,6,0.333,2,6,0.333,0,0,,0,0,,0,1,1
16018,Kris Dunn,22-343,G,2/24/17,MIN,,DAL,W,0,13,2,3,0.667,2,3,0.667,0,0,,0,0,,0,1,1
16019,Kris Dunn,22-265,G,12/8/16,MIN,@,TOR,L,0,19,2,5,0.4,2,5,0.4,0,0,,0,0,,0,1,1
16020,Kris Dunn,22-358,G,3/11/17,MIN,@,MIL,L,0,20,1,6,0.167,1,4,0.25,0,2,0,2,2,1,0,3,3
16021,Kris Dunn,22-225,G,10/29/16,MIN,@,SAC,L,0,20,1,2,0.5,0,1,0,1,1,1,1,4,0.25,0,1,1
16022,Kris Dunn,22-242,G,11/15/16,MIN,,CHO,L,0,13,2,3,0.667,2,3,0.667,0,0,,0,0,,1,1,2
16023,Wayne Ellington,29-071,G,1/8/17,MIA,@,LAC,L,1,20,1,7,0.143,1,2,0.5,0,5,0,2,2,1,0,0,0
16024,Wayne Ellington,29-093,G,1/30/17,MIA,,BRK,W,0,18,2,5,0.4,2,3,0.667,0,2,0,0,0,,0,0,0
16025,Monta Ellis,31-063,G,12/28/16,IND,@,WAS,L,0,18,1,5,0.2,1,3,0.333,0,2,0,2,2,1,0,1,1
16026,Monta Ellis,31-035,G,11/30/16,IND,@,POR,L,1,25,1,5,0.2,1,4,0.25,0,1,0,2,2,1,0,1,1
16027,Monta Ellis,31-067,G,1/1/17,IND,,ORL,W,0,16,2,3,0.667,2,3,0.667,0,0,,0,0,,0,4,4
16028,James Ennis,26-229,F,2/15/17,MEM,,NOP,L,0,15,2,5,0.4,2,3,0.667,0,2,0,0,0,,0,0,0
16029,James Ennis,26-183,F,12/31/16,MEM,@,SAC,W,0,24,1,5,0.2,1,2,0.5,0,3,0,2,2,1,1,3,4
16030,Tyler Ennis,22-070,G,11/2/16,HOU,@,NYK,W,0,10,2,5,0.4,2,5,0.4,0,0,,0,0,,0,1,1
16031,Tyler Ennis,22-077,G,11/9/16,HOU,@,SAS,W,0,7,2,4,0.5,2,3,0.667,0,1,0,0,0,,1,0,1
16032,Tyreke Evans,27-090,G-F,12/18/16,NOP,@,SAS,L,0,15,2,9,0.222,2,5,0.4,0,4,0,0,0,,0,6,6
16033,Tyreke Evans,27-110,G-F,1/7/17,NOP,@,BOS,L,0,20,1,6,0.167,1,4,0.25,0,2,0,2,2,1,0,3,3
16034,Tyreke Evans,27-149,G-F,2/15/17,NOP,@,MEM,W,0,27,2,7,0.286,2,6,0.333,0,1,0,0,0,,0,5,5
16035,Tyreke Evans,27-105,G-F,1/2/17,NOP,@,CLE,L,0,19,2,9,0.222,2,8,0.25,0,1,0,0,0,,1,2,3
16036,Dante Exum,21-184,G,1/13/17,UTA,,DET,W,0,16,2,4,0.5,2,2,1,0,2,0,0,0,,0,2,2
16037,Dante Exum,21-111,G,11/1/16,UTA,@,SAS,W,0,14,1,2,0.5,1,1,1,0,1,0,2,3,0.667,0,3,3
16038,Dante Exum,21-121,G,11/11/16,UTA,@,ORL,W,1,22,2,8,0.25,2,4,0.5,0,4,0,0,0,,1,3,4
16039,Dante Exum,21-107,G,10/28/16,UTA,,LAL,W,0,22,1,2,0.5,1,1,1,0,1,0,2,2,1,0,0,0
16040,Kenneth Faried,27-049,F,1/7/17,DEN,@,OKC,L,0,19,2,5,0.4,2,5,0.4,0,0,,0,0,,4,6,10
16041,Kenneth Faried,27-018,F,12/7/16,DEN,@,BRK,L,1,12,1,2,0.5,1,2,0.5,0,0,,2,2,1,3,2,5
16042,Kenneth Faried,27-077,F,2/4/17,DEN,@,SAS,L,1,14,2,3,0.667,2,3,0.667,0,0,,0,2,0,4,0,4
16043,Kenneth Faried,26-352,F,11/5/16,DEN,@,DET,L,0,16,1,8,0.125,1,8,0.125,0,0,,2,2,1,5,1,6
16044,Kenneth Faried,27-034,F,12/23/16,DEN,,ATL,L,0,21,2,5,0.4,2,5,0.4,0,0,,0,0,,0,4,4
16045,Derrick Favors,25-167,F-C,12/29/16,UTA,,PHI,W,1,25,1,7,0.143,1,7,0.143,0,0,,2,4,0.5,4,8,12
16046,Derrick Favors,25-177,F-C,1/8/17,UTA,@,MEM,L,1,25,2,7,0.286,2,6,0.333,0,1,0,0,0,,1,2,3
16047,Derrick Favors,25-159,F-C,12/21/16,UTA,,SAC,L,0,16,2,6,0.333,2,6,0.333,0,0,,0,0,,1,3,4
16048,Derrick Favors,25-152,F-C,12/14/16,UTA,,OKC,W,0,13,1,3,0.333,1,3,0.333,0,0,,2,2,1,0,4,4
16049,Kay Felder,21-287,G,1/10/17,CLE,@,UTA,L,0,5,2,3,0.667,2,3,0.667,0,0,,0,0,,0,0,0
16050,Kay Felder,21-307,G,1/30/17,CLE,@,DAL,L,0,4,2,2,1,2,2,1,0,0,,0,0,,0,0,0
16051,Kay Felder,21-253,G,12/7/16,CLE,@,NYK,W,0,10,2,6,0.333,2,5,0.4,0,1,0,0,0,,0,0,0
16052,Kay Felder,21-312,G,2/4/17,CLE,@,NYK,W,0,14,2,6,0.333,2,5,0.4,0,1,0,0,0,,0,1,1
16053,Cristiano Felicio,24-242,F-C,3/6/17,CHI,@,DET,L,0,14,2,4,0.5,2,4,0.5,0,0,,0,0,,1,2,3
16054,Cristiano Felicio,24-198,F-C,1/21/17,CHI,,SAC,W,0,15,1,2,0.5,1,2,0.5,0,0,,2,2,1,2,8,10
16055,Cristiano Felicio,24-152,F-C,12/6/16,CHI,@,DET,L,0,15,2,4,0.5,2,4,0.5,0,0,,0,1,0,4,2,6
16056,Cristiano Felicio,24-179,F-C,1/2/17,CHI,,CHO,W,0,19,2,2,1,2,2,1,0,0,,0,0,,3,2,5
16057,Cristiano Felicio,24-116,F-C,10/31/16,CHI,@,BRK,W,0,23,2,4,0.5,2,4,0.5,0,0,,0,0,,2,5,7
16058,Cristiano Felicio,24-192,F-C,1/15/17,CHI,@,MEM,W,0,11,2,3,0.667,2,3,0.667,0,0,,0,0,,0,1,1
16059,Cristiano Felicio,24-112,F-C,10/27/16,CHI,,BOS,W,0,8,1,2,0.5,1,2,0.5,0,0,,2,2,1,0,0,0
16060,Cristiano Felicio,24-224,F-C,2/16/17,CHI,,BOS,W,0,16,1,3,0.333,1,3,0.333,0,0,,2,2,1,2,3,5
16061,Cristiano Felicio,24-246,F-C,3/10/17,CHI,,HOU,L,0,22,2,5,0.4,2,5,0.4,0,0,,0,0,,0,7,7
16062,Cristiano Felicio,24-159,F-C,12/13/16,CHI,,MIN,L,0,15,2,4,0.5,2,4,0.5,0,0,,0,0,,3,2,5
16063,Cristiano Felicio,24-187,F-C,1/10/17,CHI,@,WAS,L,0,14,1,3,0.333,1,3,0.333,0,0,,2,2,1,1,1,2
16064,Cristiano Felicio,24-202,F-C,1/25/17,CHI,,ATL,L,0,20,2,2,1,2,2,1,0,0,,0,0,,2,4,6
16065,Raymond Felton,32-150,G,11/23/16,LAC,@,DAL,W,0,22,2,5,0.4,2,2,1,0,3,0,0,0,,1,3,4
16066,Raymond Felton,32-268,G,3/21/17,LAC,@,LAL,W,0,23,2,4,0.5,2,4,0.5,0,0,,0,1,0,0,1,1
16067,Raymond Felton,32-161,G,12/4/16,LAC,,IND,L,0,14,2,5,0.4,2,3,0.667,0,2,0,0,0,,2,0,2
16068,Raymond Felton,32-143,G,11/16/16,LAC,,MEM,L,0,14,2,5,0.4,2,5,0.4,0,0,,0,0,,1,3,4
16069,Raymond Felton,32-265,G,3/18/17,LAC,,CLE,W,0,22,2,5,0.4,2,3,0.667,0,2,0,0,0,,0,0,0
16070,Raymond Felton,32-127,G,10/31/16,LAC,,PHO,W,0,18,1,3,0.333,0,2,0,1,1,1,1,2,0.5,0,1,1
16071,Raymond Felton,32-250,G,3/3/17,LAC,@,MIL,L,0,15,2,5,0.4,2,4,0.5,0,1,0,0,0,,1,1,2
16072,Raymond Felton,32-126,G,10/30/16,LAC,,UTA,W,0,19,2,6,0.333,2,4,0.5,0,2,0,0,0,,0,2,2
16073,Raymond Felton,32-260,G,3/13/17,LAC,@,UTA,L,0,14,2,4,0.5,2,3,0.667,0,1,0,0,0,,0,2,2
16074,Raymond Felton,32-152,G,11/25/16,LAC,@,DET,L,0,14,2,2,1,2,2,1,0,0,,0,0,,0,1,1
16075,Raymond Felton,32-123,G,10/27/16,LAC,@,POR,W,0,16,2,3,0.667,2,3,0.667,0,0,,0,0,,0,1,1
16076,Yogi Ferrell,23-312,G,3/17/17,DAL,@,PHI,L,1,23,2,5,0.4,2,5,0.4,0,0,,0,0,,0,5,5
16077,Dorian Finney-Smith,23-194,F,11/14/16,DAL,@,NYK,L,1,21,2,4,0.5,2,3,0.667,0,1,0,0,0,,1,2,3
16078,Dorian Finney-Smith,23-237,F,12/27/16,DAL,,HOU,L,0,25,2,3,0.667,2,2,1,0,1,0,0,0,,0,1,1
16079,Dorian Finney-Smith,23-246,F,1/5/17,DAL,,PHO,L,1,17,2,4,0.5,2,3,0.667,0,1,0,0,0,,1,0,1
16080,Dorian Finney-Smith,23-299,F,2/27/17,DAL,,MIA,W,0,14,2,4,0.5,2,4,0.5,0,0,,0,0,,2,1,3
16081,Dorian Finney-Smith,23-211,F,12/1/16,DAL,@,CHO,L,1,25,1,4,0.25,0,2,0,1,2,0.5,1,2,0.5,0,2,2
16082,Randy Foye,33-130,G,2/1/17,BRK,,NYK,L,1,17,2,5,0.4,2,3,0.667,0,2,0,0,0,,0,4,4
16083,Tim Frazier,26-001,G,11/2/16,NOP,@,MEM,L,1,15,1,5,0.2,1,3,0.333,0,2,0,2,2,1,0,1,1
16084,Tim Frazier,26-015,G,11/16/16,NOP,@,ORL,L,1,28,1,7,0.143,1,6,0.167,0,1,0,2,2,1,0,3,3
16085,Tim Frazier,26-011,G,11/12/16,NOP,,LAL,L,1,29,2,8,0.25,2,7,0.286,0,1,0,0,0,,0,2,2
16086,Channing Frye,33-286,C-F,2/27/17,CLE,,MIL,W,0,14,1,6,0.167,1,3,0.333,0,3,0,2,2,1,1,2,3
16087,Channing Frye,33-274,C-F,2/15/17,CLE,,IND,W,1,30,1,8,0.125,1,2,0.5,0,6,0,2,2,1,0,8,8
16088,Channing Frye,33-239,C-F,1/11/17,CLE,@,POR,L,0,12,1,6,0.167,0,5,0,1,1,1,1,2,0.5,4,1,5
16089,Channing Frye,33-257,C-F,1/29/17,CLE,,OKC,W,0,15,2,4,0.5,2,2,1,0,2,0,0,0,,0,5,5
16090,Langston Galloway,24-354,G,11/27/16,NOP,@,DAL,L,0,24,2,6,0.333,2,4,0.5,0,2,0,0,0,,0,0,0
16091,Langston Galloway,25-053,G,1/31/17,NOP,@,TOR,L,0,20,1,6,0.167,1,1,1,0,5,0,2,2,1,1,3,4
16092,Langston Galloway,24-335,G,11/8/16,NOP,@,SAC,L,0,16,2,9,0.222,2,4,0.5,0,5,0,0,0,,0,2,2
16093,Langston Galloway,25-068,G,2/15/17,NOP,@,MEM,W,0,11,1,3,0.333,0,1,0,1,2,0.5,1,2,0.5,0,0,0
16094,Langston Galloway,24-359,G,12/2/16,NOP,,LAC,L,0,19,2,10,0.2,2,5,0.4,0,5,0,0,0,,1,2,3
16095,Langston Galloway,25-061,G,2/8/17,NOP,,UTA,L,0,12,1,5,0.2,1,2,0.5,0,3,0,2,2,1,0,0,0
16096,Jonathan Gibson,29-025,G,12/3/16,DAL,,CHI,W,0,17,2,7,0.286,2,5,0.4,0,2,0,0,0,,0,2,2
16097,Taj Gibson,31-267,F,3/18/17,OKC,,SAC,W,1,16,1,3,0.333,1,3,0.333,0,0,,2,2,1,0,4,4
16098,Manu Ginobili,39-199,G,2/12/17,SAS,@,NYK,L,0,17,2,9,0.222,2,5,0.4,0,4,0,0,0,,2,1,3
16099,Manu Ginobili,39-159,G,1/3/17,SAS,,TOR,W,0,18,1,3,0.333,0,1,0,1,2,0.5,1,2,0.5,0,1,1
16100,Manu Ginobili,39-094,G,10/30/16,SAS,@,MIA,W,0,28,2,8,0.25,2,7,0.286,0,1,0,0,0,,2,4,6
16101,Archie Goodwin,22-214,G,3/19/17,BRK,,DAL,L,0,14,1,3,0.333,0,2,0,1,1,1,1,2,0.5,1,1,2
16102,Aaron Gordon,21-122,F,1/16/17,ORL,@,DEN,L,1,28,2,6,0.333,2,2,1,0,4,0,0,0,,0,4,4
16103,Marcin Gortat,32-295,C-F,12/8/16,WAS,,DEN,W,1,36,2,4,0.5,2,4,0.5,0,0,,0,0,,2,5,7
16104,Marcin Gortat,32-253,C-F,10/27/16,WAS,@,ATL,L,1,32,2,6,0.333,2,6,0.333,0,0,,0,0,,3,8,11
16105,Marcin Gortat,32-268,C-F,11/11/16,WAS,,CLE,L,1,26,2,5,0.4,2,5,0.4,0,0,,0,2,0,4,11,15
16106,Marcin Gortat,33-031,C-F,3/20/17,WAS,@,BOS,L,1,12,2,4,0.5,2,4,0.5,0,0,,0,2,0,1,3,4
16107,Marcin Gortat,32-313,C-F,12/26/16,WAS,,MIL,W,1,42,2,5,0.4,2,5,0.4,0,0,,0,0,,2,10,12
16108,Treveon Graham,23-041,G,12/9/16,CHO,,ORL,W,0,5,1,2,0.5,1,1,1,0,1,0,2,2,1,0,1,1
16109,Jerami Grant,22-240,F,11/7/16,OKC,,MIA,W,0,15,1,4,0.25,0,2,0,1,2,0.5,1,2,0.5,0,1,1
16110,Jerami Grant,22-358,F,3/5/17,OKC,@,DAL,L,0,19,1,2,0.5,1,2,0.5,0,0,,2,2,1,0,4,4
16111,Jerami Grant,22-286,F,12/23/16,OKC,@,BOS,W,0,29,1,4,0.25,1,2,0.5,0,2,0,2,2,1,0,2,2
16112,Jerami Grant,22-238,F,11/5/16,OKC,,MIN,W,0,20,2,2,1,2,2,1,0,0,,0,2,0,0,2,2
16113,Jerami Grant,22-284,F,12/21/16,OKC,@,NOP,W,0,21,1,1,1,0,0,,1,1,1,1,2,0.5,1,0,1
16114,Jerami Grant,22-296,F,1/2/17,OKC,@,MIL,L,0,29,2,4,0.5,2,3,0.667,0,1,0,0,2,0,0,3,3
16115,Jerian Grant,24-075,G,12/23/16,CHI,@,CHO,L,0,13,2,3,0.667,2,3,0.667,0,0,,0,0,,0,0,0
16116,Danny Green,29-216,G-F,1/24/17,SAS,@,TOR,W,1,35,2,12,0.167,2,4,0.5,0,8,0,0,0,,1,6,7
16117,Danny Green,29-269,G-F,3/18/17,SAS,@,MEM,L,1,25,0,2,0,0,0,,0,2,0,4,4,1,1,4,5
16118,Draymond Green,26-343,F,2/10/17,GSW,@,MEM,W,1,38,2,6,0.333,2,3,0.667,0,3,0,0,0,,0,11,11
16119,Draymond Green,26-269,F,11/28/16,GSW,,ATL,W,1,39,2,9,0.222,2,6,0.333,0,3,0,0,0,,1,2,3
16120,Draymond Green,26-248,F,11/7/16,GSW,,NOP,W,1,35,2,7,0.286,2,6,0.333,0,1,0,0,0,,2,10,12
16121,Gerald Green,30-281,G-F,11/2/16,BOS,,CHI,W,0,14,1,3,0.333,1,1,1,0,2,0,2,2,1,1,0,1
16122,Gerald Green,31-004,G-F,1/30/17,BOS,,DET,W,0,14,1,5,0.2,1,4,0.25,0,1,0,2,2,1,0,2,2
16123,Gerald Green,30-277,G-F,10/29/16,BOS,@,CHO,W,0,11,1,4,0.25,1,2,0.5,0,2,0,2,2,1,0,0,0
16124,JaMychal Green,26-267,F,3/15/17,MEM,@,CHI,W,1,23,2,5,0.4,2,3,0.667,0,2,0,0,0,,1,6,7
16125,JaMychal Green,26-204,F,1/11/17,MEM,@,OKC,L,1,32,2,10,0.2,2,7,0.286,0,3,0,0,0,,2,8,10
16126,JaMychal Green,26-199,F,1/6/17,MEM,@,GSW,W,1,20,1,3,0.333,0,1,0,1,2,0.5,1,3,0.333,1,1,2
16127,JaMychal Green,26-213,F,1/20/17,MEM,,SAC,W,1,33,2,5,0.4,2,3,0.667,0,2,0,0,0,,2,5,7
16128,JaMychal Green,26-252,F,2/28/17,MEM,,PHO,W,1,18,2,2,1,2,2,1,0,0,,0,0,,0,3,3
16129,JaMychal Green,26-148,F,11/16/16,MEM,@,LAC,W,1,22,2,4,0.5,2,3,0.667,0,1,0,0,0,,2,8,10
16130,Jeff Green,30-204,F,3/20/17,ORL,,PHI,W,0,16,1,3,0.333,1,3,0.333,0,0,,2,2,1,0,0,0
16131,Jeff Green,30-075,F,11/11/16,ORL,,UTA,L,1,23,1,6,0.167,1,3,0.333,0,3,0,2,2,1,0,3,3
16132,Jeff Green,30-120,F,12/26/16,ORL,,MEM,W,0,24,2,11,0.182,2,9,0.222,0,2,0,0,0,,1,2,3
16133,Justin Hamilton,26-343,C,3/10/17,BRK,@,DAL,L,0,15,2,2,1,2,2,1,0,0,,0,0,,0,1,1
16134,Justin Hamilton,26-284,C,1/10/17,BRK,,ATL,L,0,26,2,8,0.25,2,3,0.667,0,5,0,0,0,,2,4,6
16135,Tim Hardaway,24-289,G,12/30/16,ATL,,DET,W,0,17,2,8,0.25,2,5,0.4,0,3,0,0,0,,1,1,2
16136,Maurice Harkless,23-274,F-G,2/9/17,POR,,BOS,L,1,23,2,5,0.4,2,4,0.5,0,1,0,0,0,,0,4,4
16137,Maurice Harkless,23-307,F-G,3/14/17,POR,@,NOP,L,1,20,1,3,0.333,1,1,1,0,2,0,2,2,1,0,0,0
16138,Montrezl Harrell,22-284,F-C,11/5/16,HOU,@,ATL,L,0,15,2,2,1,2,2,1,0,0,,0,0,,2,1,3
16139,Montrezl Harrell,22-326,F-C,12/17/16,HOU,@,MIN,W,0,14,2,4,0.5,2,4,0.5,0,0,,0,0,,0,0,0
16140,Montrezl Harrell,23-030,F-C,2/25/17,HOU,,MIN,W,0,7,2,3,0.667,2,3,0.667,0,0,,0,0,,1,1,2
16141,Devin Harris,34-002,G,3/1/17,DAL,@,ATL,L,0,16,1,2,0.5,0,0,,1,2,0.5,1,2,0.5,0,1,1
16142,Devin Harris,33-307,G,12/30/16,DAL,@,GSW,L,0,18,1,4,0.25,0,0,,1,4,0.25,1,2,0.5,1,1,2
16143,Devin Harris,33-300,G,12/23/16,DAL,@,LAC,W,0,12,2,4,0.5,2,3,0.667,0,1,0,0,0,,0,1,1
16144,Devin Harris,33-317,G,1/9/17,DAL,@,MIN,L,0,14,2,5,0.4,2,4,0.5,0,1,0,0,0,,0,1,1
16145,Devin Harris,33-334,G,1/26/17,DAL,@,OKC,L,0,20,2,5,0.4,2,2,1,0,3,0,0,0,,0,3,3
16146,Andrew Harrison,22-001,G,10/29/16,MEM,@,NYK,L,1,25,2,5,0.4,2,3,0.667,0,2,0,0,0,,0,0,0
16147,Andrew Harrison,21-364,G,10/26/16,MEM,,MIN,W,1,38,1,7,0.143,1,3,0.333,0,4,0,2,4,0.5,1,2,3
16148,Andrew Harrison,22-028,G,11/25/16,MEM,,MIA,L,1,35,0,8,0,0,6,0,0,2,0,4,4,1,1,4,5
16149,Andrew Harrison,22-092,G,1/28/17,MEM,@,UTA,W,0,18,2,4,0.5,2,3,0.667,0,1,0,0,0,,0,1,1
16150,Udonis Haslem,36-240,F-C,2/4/17,MIA,,PHI,W,0,7,2,4,0.5,2,3,0.667,0,1,0,0,0,,1,3,4
16151,Udonis Haslem,36-169,F-C,11/25/16,MIA,@,MEM,W,0,9,2,2,1,2,2,1,0,0,,0,0,,1,2,3
16152,Spencer Hawes,28-181,C-F,10/26/16,CHO,@,MIL,W,0,13,2,4,0.5,2,3,0.667,0,1,0,0,0,,0,2,2
16153,Spencer Hawes,28-214,C-F,11/28/16,CHO,@,MEM,W,0,27,1,3,0.333,1,1,1,0,2,0,2,2,1,0,1,1
16154,Spencer Hawes,28-267,C-F,1/20/17,CHO,,TOR,W,0,5,2,2,1,2,2,1,0,0,,0,0,,0,3,3
16155,Spencer Hawes,28-221,C-F,12/5/16,CHO,@,DAL,W,0,8,2,4,0.5,2,2,1,0,2,0,0,0,,1,1,2
16156,Spencer Hawes,28-279,C-F,2/1/17,CHO,@,GSW,L,1,25,2,6,0.333,2,5,0.4,0,1,0,0,0,,2,2,4
16157,Gerald Henderson,29-002,G,12/11/16,PHI,@,DET,W,1,22,2,6,0.333,2,4,0.5,0,2,0,0,0,,0,0,0
16158,John Henson,25-303,C-F,10/26/16,MIL,,CHO,L,0,10,2,4,0.5,2,4,0.5,0,0,,0,0,,1,3,4
16159,John Henson,25-359,C-F,12/21/16,MIL,@,CLE,L,1,19,2,7,0.286,2,7,0.286,0,0,,0,0,,3,5,8
16160,John Henson,26-009,C-F,1/6/17,MIL,,NYK,L,1,20,1,4,0.25,1,4,0.25,0,0,,2,2,1,1,6,7
16161,John Henson,26-058,C-F,2/24/17,MIL,,UTA,L,0,13,2,4,0.5,2,4,0.5,0,0,,0,0,,0,2,2
16162,John Henson,25-318,C-F,11/10/16,MIL,,NOP,L,0,17,2,5,0.4,2,5,0.4,0,0,,0,2,0,3,3,6
16163,John Henson,26-021,C-F,1/18/17,MIL,@,HOU,L,1,19,2,3,0.667,2,3,0.667,0,0,,0,0,,1,4,5
16164,John Henson,25-353,C-F,12/15/16,MIL,,CHI,W,1,26,2,9,0.222,2,8,0.25,0,1,0,0,1,0,6,4,10
16165,John Henson,25-313,C-F,11/5/16,MIL,,SAC,W,0,16,2,3,0.667,2,3,0.667,0,0,,0,1,0,4,0,4
16166,John Henson,26-002,C-F,12/30/16,MIL,@,MIN,L,1,20,2,4,0.5,2,4,0.5,0,0,,0,2,0,1,2,3
16167,John Henson,26-018,C-F,1/15/17,MIL,@,ATL,L,1,22,2,4,0.5,2,4,0.5,0,0,,0,0,,1,4,5
16168,Juan Hernangomez,21-106,F,1/12/17,DEN,,IND,W,0,3,2,2,1,2,2,1,0,0,,0,0,,0,0,0
16169,Juan Hernangomez,21-101,F,1/7/17,DEN,@,OKC,L,0,14,2,3,0.667,2,3,0.667,0,0,,0,0,,1,4,5
16170,Juan Hernangomez,21-136,F,2/11/17,DEN,@,CLE,L,0,17,1,6,0.167,1,5,0.2,0,1,0,2,2,1,3,2,5
16171,Juan Hernangomez,21-075,F,12/12/16,DEN,@,DAL,L,0,19,1,3,0.333,1,1,1,0,2,0,2,2,1,2,1,3
16172,Willy Hernangomez,22-220,C,1/2/17,NYK,,ORL,L,0,16,2,3,0.667,2,3,0.667,0,0,,0,2,0,1,2,3
16173,Willy Hernangomez,22-293,C,3/16/17,NYK,,BRK,L,1,19,2,7,0.286,2,7,0.286,0,0,,0,0,,1,5,6
16174,Willy Hernangomez,22-155,C,10/29/16,NYK,,MEM,W,0,8,2,3,0.667,2,3,0.667,0,0,,0,2,0,1,1,2
16175,Willy Hernangomez,22-151,C,10/25/16,NYK,@,CLE,L,0,9,2,3,0.667,2,3,0.667,0,0,,0,0,,1,0,1
16176,Willy Hernangomez,22-191,C,12/4/16,NYK,,SAC,W,0,12,1,1,1,1,1,1,0,0,,2,2,1,0,4,4
16177,Willy Hernangomez,22-245,C,1/27/17,NYK,,CHO,W,0,15,2,5,0.4,2,5,0.4,0,0,,0,0,,4,3,7
16178,Willy Hernangomez,22-171,C,11/14/16,NYK,,DAL,W,0,13,2,6,0.333,2,6,0.333,0,0,,0,0,,2,4,6
16179,Mario Hezonja,21-345,F-G,2/4/17,ORL,@,ATL,L,0,12,1,3,0.333,1,2,0.5,0,1,0,2,2,1,0,3,3
16180,Mario Hezonja,22-000,F-G,2/25/17,ORL,,ATL,W,0,23,2,6,0.333,2,4,0.5,0,2,0,0,0,,0,4,4
16181,Roy Hibbert,29-365,C,12/10/16,CHO,@,CLE,L,0,13,0,0,,0,0,,0,0,,4,4,1,1,1,2
16182,Roy Hibbert,30-018,C,12/29/16,CHO,,MIA,W,0,15,2,3,0.667,2,3,0.667,0,0,,0,0,,3,1,4
16183,Roy Hibbert,30-033,C,1/13/17,CHO,@,PHI,L,0,10,0,1,0,0,1,0,0,0,,4,4,1,1,0,1
16184,Roy Hibbert,29-350,C,11/25/16,CHO,@,NYK,L,0,21,1,5,0.2,1,5,0.2,0,0,,2,2,1,3,5,8
16185,Roy Hibbert,30-017,C,12/28/16,CHO,@,ORL,W,0,16,2,4,0.5,2,4,0.5,0,0,,0,0,,1,2,3
16186,Roy Hibbert,30-030,C,1/10/17,CHO,@,HOU,L,1,19,2,2,1,2,2,1,0,0,,0,0,,2,3,5
16187,Roy Hibbert,30-015,C,12/26/16,CHO,@,BRK,L,0,19,2,3,0.667,2,3,0.667,0,0,,0,0,,2,2,4
16188,Roy Hibbert,30-012,C,12/23/16,CHO,,CHI,W,0,16,2,2,1,2,2,1,0,0,,0,0,,0,5,5
16189,Roy Hibbert,29-344,C,11/19/16,CHO,@,NOP,L,1,17,2,4,0.5,2,4,0.5,0,0,,0,0,,0,2,2
16190,Roy Hibbert,29-354,C,11/29/16,CHO,,DET,L,0,13,1,2,0.5,1,2,0.5,0,0,,2,3,0.667,0,1,1
16191,Roy Hibbert,30-003,C,12/14/16,CHO,@,WAS,L,0,18,0,0,,0,0,,0,0,,4,4,1,2,4,6
16192,Buddy Hield,22-351,G,12/2/16,NOP,,LAC,L,0,3,2,2,1,2,2,1,0,0,,0,0,,0,0,0
16193,Buddy Hield,22-314,G,10/26/16,NOP,,DEN,L,0,17,2,8,0.25,2,5,0.4,0,3,0,0,0,,1,0,1
16194,Nene Hilario,34-126,F-C,1/17/17,HOU,@,MIA,L,0,24,1,1,1,1,1,1,0,0,,2,4,0.5,1,6,7
16195,Nene Hilario,34-057,F-C,11/9/16,HOU,@,SAS,W,0,21,2,3,0.667,2,3,0.667,0,0,,0,0,,0,2,2
16196,Nene Hilario,34-055,F-C,11/7/16,HOU,@,WAS,W,0,21,2,3,0.667,2,3,0.667,0,0,,0,0,,0,5,5
16197,Nene Hilario,34-142,F-C,2/2/17,HOU,,ATL,L,0,17,2,4,0.5,2,4,0.5,0,0,,0,0,,0,3,3
16198,Nene Hilario,34-069,F-C,11/21/16,HOU,@,DET,W,0,13,2,4,0.5,2,4,0.5,0,0,,0,0,,2,5,7
16199,Nene Hilario,34-101,F-C,12/23/16,HOU,@,MEM,L,0,18,1,3,0.333,1,3,0.333,0,0,,2,2,1,2,3,5
16200,Nene Hilario,34-115,F-C,1/6/17,HOU,@,ORL,W,0,25,2,5,0.4,2,5,0.4,0,0,,0,0,,0,4,4
16201,Nene Hilario,34-142,F-C,2/2/17,HOU,,ATL,L,0,17,2,4,0.5,2,4,0.5,0,0,,0,0,,0,3,3
16202,Nene Hilario,34-069,F-C,11/21/16,HOU,@,DET,W,0,13,2,4,0.5,2,4,0.5,0,0,,0,0,,2,5,7
16203,Jordan Hill,29-151,C-F,12/25/16,MIN,@,OKC,L,0,19,2,7,0.286,2,7,0.286,0,0,,0,0,,3,3,6
16204,Jordan Hill,29-097,C-F,11/1/16,MIN,,MEM,W,0,5,2,3,0.667,2,3,0.667,0,0,,0,0,,2,1,3
16205,Solomon Hill,25-246,F,11/19/16,NOP,,CHO,W,0,25,0,1,0,0,1,0,0,0,,4,4,1,0,2,2
16206,Solomon Hill,25-295,F,1/7/17,NOP,@,BOS,L,1,17,2,4,0.5,2,3,0.667,0,1,0,0,0,,1,1,2
16207,Solomon Hill,25-348,F,3/1/17,NOP,,DET,W,1,27,1,5,0.2,1,2,0.5,0,3,0,2,2,1,1,3,4
16208,Solomon Hill,25-362,F,3/15/17,NOP,@,MIA,L,1,26,1,7,0.143,1,5,0.2,0,2,0,2,2,1,1,3,4
16209,Solomon Hill,25-304,F,1/16/17,NOP,@,IND,L,1,30,2,6,0.333,2,4,0.5,0,2,0,0,0,,1,3,4
16210,Solomon Hill,25-319,F,1/31/17,NOP,@,TOR,L,1,23,1,3,0.333,0,0,,1,3,0.333,1,2,0.5,0,2,2
16211,Jrue Holiday,26-267,G,3/6/17,NOP,@,UTA,L,1,23,1,9,0.111,0,7,0,1,2,0.5,1,2,0.5,2,3,5
16212,Justin Holiday,27-316,G,2/15/17,NYK,@,OKC,L,0,16,1,4,0.25,0,1,0,1,3,0.333,1,2,0.5,0,1,1
16213,Justin Holiday,27-237,G,11/28/16,NYK,,OKC,L,0,15,2,5,0.4,2,3,0.667,0,2,0,0,0,,0,4,4
16214,Justin Holiday,27-281,G,1/11/17,NYK,@,PHI,L,0,15,2,5,0.4,2,4,0.5,0,1,0,0,0,,0,2,2
16215,Justin Holiday,27-213,G,11/4/16,NYK,@,CHI,W,0,14,1,2,0.5,0,0,,1,2,0.5,1,2,0.5,0,0,0
16216,Rondae Hollis-Jefferson,22-009,F,1/12/17,BRK,,NOP,L,0,18,2,8,0.25,2,7,0.286,0,1,0,0,0,,2,2,4
16217,Rondae Hollis-Jefferson,22-077,F,3/21/17,BRK,,DET,W,1,27,2,7,0.286,2,7,0.286,0,0,,0,0,,0,4,4
16218,Rondae Hollis-Jefferson,22-003,F,1/6/17,BRK,,CLE,L,0,15,1,6,0.167,1,6,0.167,0,0,,2,2,1,1,3,4
16219,Rondae Hollis-Jefferson,22-031,F,2/3/17,BRK,,IND,L,1,20,1,2,0.5,1,2,0.5,0,0,,2,2,1,0,6,6
16220,Rondae Hollis-Jefferson,21-325,F,11/23/16,BRK,,BOS,L,1,15,1,4,0.25,0,2,0,1,2,0.5,1,4,0.25,1,3,4
16221,Rondae Hollis-Jefferson,22-027,F,1/30/17,BRK,@,MIA,L,0,22,1,3,0.333,1,2,0.5,0,1,0,2,2,1,2,9,11
16222,Rondae Hollis-Jefferson,22-066,F,3/10/17,BRK,@,DAL,L,1,18,2,5,0.4,2,5,0.4,0,0,,0,0,,0,5,5
16223,Richaun Holmes,23-106,F-C,1/29/17,PHI,@,CHI,L,0,22,2,8,0.25,2,8,0.25,0,0,,0,0,,1,2,3
16224,Richaun Holmes,23-030,F-C,11/14/16,PHI,@,HOU,L,0,8,2,4,0.5,2,3,0.667,0,1,0,0,0,,1,2,3
16225,Richaun Holmes,23-057,F-C,12/11/16,PHI,@,DET,W,0,11,2,6,0.333,2,6,0.333,0,0,,0,0,,0,1,1
16226,Richaun Holmes,23-110,F-C,2/2/17,PHI,@,SAS,L,0,19,1,4,0.25,1,4,0.25,0,0,,2,6,0.333,2,4,6
16227,Richaun Holmes,23-033,F-C,11/17/16,PHI,@,MIN,L,0,3,2,3,0.667,2,2,1,0,1,0,0,0,,1,1,2
16228,Rodney Hood,24-142,G-F,3/11/17,UTA,@,OKC,L,1,21,1,5,0.2,1,3,0.333,0,2,0,2,2,1,0,2,2
16229,Al Horford,30-268,C-F,2/26/17,BOS,@,DET,W,1,36,2,11,0.182,2,8,0.25,0,3,0,0,0,,0,9,9
16230,Dwight Howard,30-353,C,11/25/16,ATL,@,UTA,L,1,27,2,9,0.222,2,9,0.222,0,0,,0,0,,2,5,7
16231,Dwight Howard,31-041,C,1/18/17,ATL,@,DET,L,1,21,1,1,1,1,1,1,0,0,,2,2,1,1,2,3
16232,Dwight Howard,31-078,C,2/24/17,ATL,,MIA,L,1,23,2,4,0.5,2,4,0.5,0,0,,0,3,0,1,6,7
16233,Marcelo Huertas,33-182,G,11/23/16,LAL,@,GSW,L,0,12,2,4,0.5,2,4,0.5,0,0,,0,0,,0,1,1
16234,Marcelo Huertas,33-234,G,1/14/17,LAL,@,LAC,L,0,12,2,4,0.5,2,4,0.5,0,0,,0,2,0,0,0,0
16235,Marcelo Huertas,33-156,G,10/28/16,LAL,@,UTA,L,0,15,2,6,0.333,2,6,0.333,0,0,,0,0,,1,3,4
16236,Kris Humphries,32-018,F-C,2/24/17,ATL,,MIA,L,0,10,2,3,0.667,2,3,0.667,0,0,,0,0,,1,3,4
16237,Kris Humphries,31-290,F-C,11/22/16,ATL,,NOP,L,0,14,2,4,0.5,2,2,1,0,2,0,0,0,,0,3,3
16238,Serge Ibaka,27-040,F-C,10/28/16,ORL,@,DET,L,1,19,2,6,0.333,2,6,0.333,0,0,,0,0,,2,1,3
16239,Serge Ibaka,27-131,F-C,1/27/17,ORL,@,BOS,L,1,21,2,8,0.25,2,6,0.333,0,2,0,0,0,,0,0,0
16240,Andre Iguodala,32-315,G-F,12/8/16,GSW,@,UTA,W,0,24,2,5,0.4,2,4,0.5,0,1,0,0,0,,2,3,5
16241,Andre Iguodala,32-300,G-F,11/23/16,GSW,,LAL,W,0,21,2,7,0.286,2,3,0.667,0,4,0,0,0,,0,2,2
16242,Andre Iguodala,32-276,G-F,10/30/16,GSW,@,PHO,W,0,28,2,5,0.4,2,2,1,0,3,0,0,0,,1,2,3
16243,Andre Iguodala,32-340,G-F,1/2/17,GSW,,DEN,W,0,22,2,4,0.5,2,3,0.667,0,1,0,0,0,,1,2,3
16244,Andre Iguodala,33-031,G-F,2/28/17,GSW,@,WAS,L,0,31,2,5,0.4,2,3,0.667,0,2,0,0,0,,1,2,3
16245,Andre Iguodala,32-290,G-F,11/13/16,GSW,,PHO,W,0,24,1,4,0.25,0,1,0,1,3,0.333,1,2,0.5,0,3,3
16246,Ersan Ilyasova,29-257,F,1/27/17,PHI,,HOU,L,1,22,2,7,0.286,2,4,0.5,0,3,0,0,0,,0,3,3
16247,Joe Ingles,29-169,F-G,3/20/17,UTA,@,IND,L,0,27,1,3,0.333,0,0,,1,3,0.333,1,2,0.5,1,6,7
16248,Joe Ingles,29-125,F-G,2/4/17,UTA,,CHO,W,1,30,1,6,0.167,0,0,,1,6,0.167,1,2,0.5,0,9,9
16249,Joe Ingles,29-057,F-G,11/28/16,UTA,@,MIN,W,0,14,2,6,0.333,2,5,0.4,0,1,0,0,0,,0,2,2
16250,Brandon Ingram,19-111,F,12/22/16,LAL,@,MIA,L,1,35,2,7,0.286,2,5,0.4,0,2,0,0,2,0,4,4,8
16251,Brandon Ingram,19-094,F,12/5/16,LAL,,UTA,L,1,25,1,6,0.167,1,5,0.2,0,1,0,2,2,1,0,2,2
16252,Brandon Ingram,19-109,F,12/20/16,LAL,@,CHO,L,0,28,2,4,0.5,2,3,0.667,0,1,0,0,0,,1,3,4
16253,Brandon Ingram,19-077,F,11/18/16,LAL,,SAS,L,0,27,1,9,0.111,1,6,0.167,0,3,0,2,2,1,1,4,5
16254,Brandon Ingram,19-151,F,1/31/17,LAL,,DEN,W,0,21,2,8,0.25,2,6,0.333,0,2,0,0,0,,0,2,2
16255,Brandon Ingram,19-069,F,11/10/16,LAL,@,SAC,W,0,28,2,5,0.4,2,4,0.5,0,1,0,0,2,0,1,5,6
16256,Pierre Jackson,25-149,G,1/25/17,DAL,,NYK,W,0,24,2,8,0.25,2,4,0.5,0,4,0,0,1,0,0,3,3
16257,Reggie Jackson,26-313,G,2/23/17,DET,,CHO,W,1,20,1,6,0.167,1,4,0.25,0,2,0,2,2,1,0,1,1
16258,Reggie Jackson,26-298,G,2/8/17,DET,,LAL,W,1,23,2,5,0.4,2,3,0.667,0,2,0,0,2,0,0,2,2
16259,Al Jefferson,31-302,C-F,11/1/16,IND,,LAL,W,0,14,2,6,0.333,2,6,0.333,0,0,,0,0,,2,5,7
16260,Al Jefferson,32-060,C-F,3/5/17,IND,@,ATL,W,0,13,2,4,0.5,2,4,0.5,0,0,,0,2,0,1,7,8
16261,Al Jefferson,31-353,C-F,12/22/16,IND,,BOS,L,0,15,2,4,0.5,2,4,0.5,0,0,,0,0,,2,5,7
16262,Al Jefferson,32-008,C-F,1/12/17,IND,@,DEN,L,0,8,2,5,0.4,2,5,0.4,0,0,,0,0,,1,1,2
16263,Al Jefferson,31-322,C-F,11/21/16,IND,,GSW,L,1,21,2,4,0.5,2,4,0.5,0,0,,0,0,,0,6,6
16264,Al Jefferson,31-306,C-F,11/5/16,IND,,CHI,W,0,17,2,7,0.286,2,7,0.286,0,0,,0,0,,1,5,6
16265,Al Jefferson,32-001,C-F,1/5/17,IND,,BRK,W,0,14,2,5,0.4,2,5,0.4,0,0,,0,0,,0,2,2
16266,Al Jefferson,31-336,C-F,12/5/16,IND,@,GSW,L,0,8,2,6,0.333,2,6,0.333,0,0,,0,0,,2,1,3
16267,Richard Jefferson,36-235,F,2/11/17,CLE,,DEN,W,0,18,1,4,0.25,1,1,1,0,3,0,2,2,1,0,2,2
16268,Richard Jefferson,36-133,F,11/1/16,CLE,,HOU,W,0,20,1,2,0.5,1,1,1,0,1,0,2,2,1,0,3,3
16269,Richard Jefferson,36-212,F,1/19/17,CLE,,PHO,W,0,23,2,5,0.4,2,3,0.667,0,2,0,0,0,,1,1,2
16270,Richard Jefferson,36-176,F,12/14/16,CLE,@,MEM,L,0,10,1,3,0.333,0,1,0,1,2,0.5,1,2,0.5,0,0,0
16271,Richard Jefferson,36-193,F,12/31/16,CLE,@,CHO,W,0,19,1,3,0.333,1,1,1,0,2,0,2,3,0.667,0,1,1
16272,Richard Jefferson,36-225,F,2/1/17,CLE,,MIN,W,0,28,2,5,0.4,2,3,0.667,0,2,0,0,0,,1,4,5
16273,Richard Jefferson,36-172,F,12/10/16,CLE,,CHO,W,0,17,2,3,0.667,2,2,1,0,1,0,0,0,,0,2,2
16274,Brandon Jennings,27-090,G,12/22/16,NYK,,ORL,W,0,22,1,5,0.2,0,3,0,1,2,0.5,1,2,0.5,1,0,1
16275,Brandon Jennings,27-138,G,2/8/17,NYK,,LAC,L,0,17,2,3,0.667,2,2,1,0,1,0,0,0,,0,0,0
16276,Brandon Jennings,27-166,G,3/8/17,WAS,@,DEN,W,0,18,2,7,0.286,2,3,0.667,0,4,0,0,2,0,0,2,2
16277,Brandon Jennings,27-060,G,11/22/16,NYK,,POR,W,0,22,2,6,0.333,2,2,1,0,4,0,0,0,,1,2,3
16278,Jonas Jerebko,29-311,F,1/7/17,BOS,,NOP,W,0,15,2,3,0.667,2,3,0.667,0,0,,0,0,,2,4,6
16279,Jonas Jerebko,29-246,F,11/3/16,BOS,@,CLE,L,0,13,2,6,0.333,2,6,0.333,0,0,,0,0,,1,0,1
16280,Jonas Jerebko,29-291,F,12/18/16,BOS,@,MIA,W,0,23,2,7,0.286,2,5,0.4,0,2,0,0,0,,2,1,3
16281,Jonas Jerebko,29-322,F,1/18/17,BOS,,NYK,L,0,16,2,3,0.667,2,3,0.667,0,0,,0,0,,0,1,1
16282,Jonas Jerebko,29-239,F,10/27/16,BOS,@,CHI,L,0,10,1,3,0.333,0,2,0,1,1,1,1,2,0.5,0,1,1
16283,Jonas Jerebko,29-361,F,2/26/17,BOS,@,DET,W,0,13,1,6,0.167,1,4,0.25,0,2,0,2,2,1,1,1,2
16284,Jonas Jerebko,29-257,F,11/14/16,BOS,@,NOP,L,0,19,2,6,0.333,2,3,0.667,0,3,0,0,0,,0,2,2
16285,Jonas Jerebko,30-013,F,3/15/17,BOS,,MIN,W,0,24,2,3,0.667,2,3,0.667,0,0,,0,0,,0,5,5
16286,Jonas Jerebko,29-273,F,11/30/16,BOS,,DET,L,0,15,2,2,1,2,2,1,0,0,,0,0,,1,3,4
16287,Jonas Jerebko,29-238,F,10/26/16,BOS,,BRK,W,0,19,1,8,0.125,1,3,0.333,0,5,0,2,2,1,0,1,1
16288,Amir Johnson,29-301,F,2/26/17,BOS,@,DET,W,1,19,2,3,0.667,2,3,0.667,0,0,,0,0,,1,8,9
16289,Amir Johnson,29-211,F,11/28/16,BOS,@,MIA,W,1,13,2,2,1,2,2,1,0,0,,0,1,0,1,2,3
16290,Amir Johnson,29-240,F,12/27/16,BOS,,MEM,W,1,25,2,6,0.333,2,6,0.333,0,0,,0,0,,4,6,10
16291,Amir Johnson,29-274,F,1/30/17,BOS,,DET,W,0,15,2,5,0.4,2,4,0.5,0,1,0,0,0,,2,3,5
16292,Amir Johnson,29-323,F,3/20/17,BOS,,WAS,W,1,21,2,6,0.333,2,6,0.333,0,0,,0,0,,2,1,3
16293,Amir Johnson,29-254,F,1/10/17,BOS,@,TOR,L,1,16,2,5,0.4,2,4,0.5,0,1,0,0,0,,2,3,5
16294,Amir Johnson,29-189,F,11/6/16,BOS,,DEN,L,1,16,2,5,0.4,2,5,0.4,0,0,,0,0,,0,1,1
16295,James Johnson,29-255,F,11/1/16,MIA,,SAC,W,0,18,1,5,0.2,1,3,0.333,0,2,0,2,2,1,0,7,7
16296,Joe Johnson,35-242,G-F,2/26/17,UTA,@,WAS,W,0,24,2,6,0.333,2,3,0.667,0,3,0,0,0,,0,1,1
16297,Joe Johnson,35-152,G-F,11/28/16,UTA,@,MIN,W,0,16,2,4,0.5,2,3,0.667,0,1,0,0,0,,0,0,0
16298,Joe Johnson,35-240,G-F,2/24/17,UTA,@,MIL,W,0,27,1,4,0.25,1,3,0.333,0,1,0,2,2,1,0,2,2
16299,Joe Johnson,35-149,G-F,11/25/16,UTA,,ATL,W,0,24,2,7,0.286,2,3,0.667,0,4,0,0,0,,1,10,11
16300,Joe Johnson,35-229,G-F,2/13/17,UTA,,LAC,L,0,28,2,6,0.333,2,5,0.4,0,1,0,0,0,,1,5,6
16301,Joe Johnson,35-242,G-F,2/26/17,UTA,@,WAS,W,0,24,2,6,0.333,2,3,0.667,0,3,0,0,0,,0,1,1
16302,Stanley Johnson,20-286,F,3/11/17,DET,,NYK,W,0,19,2,7,0.286,2,5,0.4,0,2,0,0,0,,2,3,5
16303,Stanley Johnson,20-248,F,2/1/17,DET,,NOP,W,0,25,2,7,0.286,2,7,0.286,0,0,,0,0,,2,3,5
16304,Stanley Johnson,20-215,F,12/30/16,DET,@,ATL,L,0,21,2,4,0.5,2,2,1,0,2,0,0,0,,0,2,2
16305,Wesley Johnson,29-212,F-G,2/8/17,LAC,@,NYK,W,0,9,2,3,0.667,2,2,1,0,1,0,0,0,,0,2,2
16306,Wesley Johnson,29-135,F-G,11/23/16,LAC,@,DAL,W,0,15,2,5,0.4,2,3,0.667,0,2,0,0,0,,1,3,4
16307,Wesley Johnson,29-241,F-G,3/9/17,LAC,@,MEM,W,0,10,2,5,0.4,2,3,0.667,0,2,0,0,0,,0,1,1
16308,Nikola Jokic,22-004,C-F,2/23/17,DEN,@,SAC,L,1,26,2,7,0.286,2,5,0.4,0,2,0,0,0,,2,8,10
16309,Nikola Jokic,21-265,C-F,11/10/16,DEN,,GSW,L,1,18,1,5,0.2,1,2,0.5,0,3,0,2,2,1,1,2,3
16310,Damian Jones,21-254,F-C,3/11/17,GSW,@,SAS,L,0,21,2,6,0.333,2,6,0.333,0,0,,0,2,0,3,2,5
16311,Damian Jones,21-228,F-C,2/13/17,GSW,@,DEN,L,0,12,2,3,0.667,2,3,0.667,0,0,,0,0,,0,1,1
16312,Damian Jones,21-216,F-C,2/1/17,GSW,,CHO,W,0,4,1,1,1,1,1,1,0,0,,2,2,1,1,1,2
16313,Derrick Jones,20-025,F,3/12/17,PHO,,POR,L,1,25,1,2,0.5,1,2,0.5,0,0,,2,2,1,0,3,3
16314,Terrence Jones,24-303,F,11/7/16,NOP,@,GSW,L,0,15,2,5,0.4,2,3,0.667,0,2,0,0,0,,0,1,1
16315,Terrence Jones,24-364,F,1/7/17,NOP,@,BOS,L,0,16,2,5,0.4,2,4,0.5,0,1,0,0,0,,0,1,1
16316,Terrence Jones,24-294,F,10/29/16,NOP,@,SAS,L,0,14,2,7,0.286,2,4,0.5,0,3,0,0,0,,0,4,4
16317,Tyus Jones,20-281,G,2/15/17,MIN,@,DEN,W,0,11,2,5,0.4,2,3,0.667,0,2,0,0,0,,0,0,0
16318,Tyus Jones,20-254,G,1/19/17,MIN,@,LAC,W,0,12,1,4,0.25,0,3,0,1,1,1,1,2,0.5,0,0,0
16319,DeAndre Jordan,28-205,C,2/11/17,LAC,@,CHO,W,1,28,2,5,0.4,2,5,0.4,0,0,,0,0,,3,13,16
16320,Cory Joseph,25-148,G,1/15/17,TOR,,NYK,W,0,25,2,9,0.222,2,8,0.25,0,1,0,0,0,,0,4,4
16321,Cory Joseph,25-130,G,12/28/16,TOR,@,GSW,L,0,17,1,5,0.2,1,4,0.25,0,1,0,2,2,1,3,1,4
16322,Cory Joseph,25-125,G,12/23/16,TOR,@,UTA,W,0,20,2,8,0.25,2,7,0.286,0,1,0,0,0,,0,1,1
16323,Cory Joseph,25-172,G,2/8/17,TOR,@,MIN,L,0,22,1,3,0.333,1,2,0.5,0,1,0,2,2,1,0,2,2
16324,Cory Joseph,25-074,G,11/2/16,TOR,@,WAS,W,0,17,2,4,0.5,2,3,0.667,0,1,0,0,0,,0,1,1
16325,Cory Joseph,25-090,G,11/18/16,TOR,@,DEN,W,0,20,2,9,0.222,2,7,0.286,0,2,0,0,0,,1,1,2
16326,Frank Kaminsky,23-228,F-C,11/18/16,CHO,,ATL,W,0,20,2,11,0.182,2,7,0.286,0,4,0,0,0,,0,6,6
16327,Frank Kaminsky,23-269,F-C,12/29/16,CHO,,MIA,W,0,19,1,11,0.091,1,7,0.143,0,4,0,2,2,1,2,4,6
16328,Frank Kaminsky,23-343,F-C,3/13/17,CHO,,CHI,L,0,24,2,7,0.286,2,3,0.667,0,4,0,0,0,,0,1,1
16329,Enes Kanter,24-161,C,10/28/16,OKC,,PHO,W,0,12,1,4,0.25,1,4,0.25,0,0,,2,4,0.5,1,1,2
16330,Enes Kanter,24-280,C,2/24/17,OKC,,LAL,W,0,19,2,12,0.167,2,11,0.182,0,1,0,0,0,,4,3,7
16331,Enes Kanter,24-251,C,1/26/17,OKC,,DAL,W,0,9,1,3,0.333,1,3,0.333,0,0,,2,4,0.5,1,3,4
16332,Ryan Kelly,25-221,F,11/16/16,ATL,,MIL,W,0,8,1,2,0.5,1,1,1,0,1,0,2,2,1,0,0,0
16333,Michael Kidd-Gilchrist,23-094,F,12/29/16,CHO,,MIA,W,1,33,2,7,0.286,2,7,0.286,0,0,,0,0,,0,6,6
16334,Michael Kidd-Gilchrist,23-165,F,3/10/17,CHO,,ORL,W,1,19,2,4,0.5,2,4,0.5,0,0,,0,0,,0,4,4
16335,Michael Kidd-Gilchrist,23-082,F,12/17/16,CHO,@,ATL,W,1,20,2,7,0.286,2,6,0.333,0,1,0,0,0,,2,0,2
16336,Sean Kilpatrick,27-000,G,1/6/17,BRK,,CLE,L,0,19,2,9,0.222,2,6,0.333,0,3,0,0,0,,0,2,2
16337,Sean Kilpatrick,27-054,G,3/1/17,BRK,@,SAC,W,0,21,1,5,0.2,1,2,0.5,0,3,0,2,2,1,0,3,3
16338,Sean Kilpatrick,27-026,G,2/1/17,BRK,,NYK,L,0,19,2,8,0.25,2,5,0.4,0,3,0,0,0,,1,2,3
16339,Brandon Knight,24-355,G,11/21/16,PHO,@,WAS,L,1,28,2,7,0.286,2,5,0.4,0,2,0,0,0,,0,6,6
16340,Brandon Knight,25-059,G,1/30/17,PHO,,MEM,L,0,16,1,4,0.25,1,2,0.5,0,2,0,2,2,1,0,2,2
16341,Kyle Korver,35-319,G-F,1/30/17,CLE,@,DAL,L,0,26,1,2,0.5,0,0,,1,2,0.5,1,2,0.5,1,2,3
16342,Kyle Korver,35-354,G-F,3/6/17,CLE,,MIA,L,0,20,2,7,0.286,2,2,1,0,5,0,0,0,,0,3,3
16343,Kyle Korver,35-243,G-F,11/15/16,ATL,@,MIA,W,1,29,2,4,0.5,2,2,1,0,2,0,0,0,,0,2,2
16344,Kyle Korver,35-349,G-F,3/1/17,CLE,@,BOS,L,0,26,1,7,0.143,0,3,0,1,4,0.25,1,1,1,0,2,2
16345,Kosta Koufos,27-248,C,10/29/16,SAC,,MIN,W,1,20,2,5,0.4,2,5,0.4,0,0,,0,0,,3,4,7
16346,Kosta Koufos,27-260,C,11/10/16,SAC,,LAL,L,1,19,2,2,1,2,2,1,0,0,,0,0,,1,2,3
16347,Kosta Koufos,27-278,C,11/28/16,SAC,@,WAS,L,1,25,1,3,0.333,1,3,0.333,0,0,,2,2,1,4,3,7
16348,Kosta Koufos,27-356,C,2/14/17,SAC,@,LAL,W,1,26,2,4,0.5,2,4,0.5,0,0,,0,0,,0,4,4
16349,Kosta Koufos,27-354,C,2/12/17,SAC,,NOP,W,1,15,2,6,0.333,2,6,0.333,0,0,,0,0,,3,4,7
16350,Kosta Koufos,27-255,C,11/5/16,SAC,@,MIL,L,1,13,2,4,0.5,2,4,0.5,0,0,,0,0,,4,3,7
16351,Kosta Koufos,27-290,C,12/10/16,SAC,@,UTA,L,1,13,2,4,0.5,2,4,0.5,0,0,,0,0,,1,0,1
16352,Kosta Koufos,27-289,C,12/9/16,SAC,,NYK,L,1,14,2,2,1,2,2,1,0,0,,0,0,,0,3,3
16353,Kosta Koufos,27-336,C,1/25/17,SAC,@,CLE,W,1,18,1,2,0.5,1,2,0.5,0,0,,2,2,1,2,4,6
16354,Kosta Koufos,27-250,C,10/31/16,SAC,@,ATL,L,1,25,2,5,0.4,2,5,0.4,0,0,,0,0,,1,7,8
16355,Mindaugas Kuzminskas,27-110,F,2/6/17,NYK,,LAL,L,0,19,2,6,0.333,2,5,0.4,0,1,0,0,0,,1,0,1
16356,Mindaugas Kuzminskas,27-040,F,11/28/16,NYK,,OKC,L,0,7,1,2,0.5,1,1,1,0,1,0,2,2,1,0,0,0
16357,Mindaugas Kuzminskas,27-137,F,3/5/17,NYK,,GSW,L,0,11,1,2,0.5,1,2,0.5,0,0,,2,4,0.5,1,0,1
16358,Mindaugas Kuzminskas,27-044,F,12/2/16,NYK,,MIN,W,0,19,2,4,0.5,2,3,0.667,0,1,0,0,0,,0,1,1
16359,Mindaugas Kuzminskas,27-112,F,2/8/17,NYK,,LAC,L,0,20,2,8,0.25,2,3,0.667,0,5,0,0,0,,0,0,0
16360,Skal Labissiere,20-346,F,2/27/17,SAC,,MIN,L,0,14,2,4,0.5,2,4,0.5,0,0,,0,0,,2,4,6
16361,Jeremy Lamb,24-183,G-F,11/29/16,CHO,,DET,L,0,13,1,5,0.2,1,3,0.333,0,2,0,2,2,1,0,1,1
16362,Jeremy Lamb,24-276,G-F,3/2/17,CHO,@,PHO,L,0,13,1,3,0.333,1,3,0.333,0,0,,2,2,1,0,3,3
16363,Jeremy Lamb,24-292,G-F,3/18/17,CHO,,WAS,W,0,14,1,4,0.25,1,3,0.333,0,1,0,2,2,1,0,5,5
16364,Nicolas Laprovittola,26-319,G,12/15/16,SAS,@,PHO,W,0,3,1,1,1,1,1,1,0,0,,2,2,1,0,0,0
16365,Joffrey Lauvergne,25-151,C-F,2/28/17,CHI,,DEN,L,0,4,2,3,0.667,2,3,0.667,0,0,,0,0,,0,1,1
16366,Joffrey Lauvergne,25-124,C-F,2/1/17,OKC,,CHI,L,0,14,1,3,0.333,0,1,0,1,2,0.5,1,2,0.5,0,1,1
16367,Joffrey Lauvergne,25-065,C-F,12/4/16,OKC,,NOP,W,0,18,2,6,0.333,2,5,0.4,0,1,0,0,0,,4,7,11
16368,Joffrey Lauvergne,25-123,C-F,1/31/17,OKC,@,SAS,L,0,16,2,8,0.25,2,7,0.286,0,1,0,0,0,,1,4,5
16369,Joffrey Lauvergne,25-134,C-F,2/11/17,OKC,,GSW,L,0,9,2,3,0.667,2,2,1,0,1,0,0,0,,0,3,3
16370,Joffrey Lauvergne,25-099,C-F,1/7/17,OKC,,DEN,W,0,5,2,3,0.667,2,2,1,0,1,0,0,0,,0,0,0
16371,Joffrey Lauvergne,25-132,C-F,2/9/17,OKC,,CLE,W,0,21,2,8,0.25,2,6,0.333,0,2,0,0,0,,3,1,4
16372,Zach LaVine,21-318,G,1/22/17,MIN,,DEN,W,1,33,2,8,0.25,2,5,0.4,0,3,0,0,0,,0,2,2
16373,Zach LaVine,21-240,G,11/5/16,MIN,@,OKC,L,1,26,1,6,0.167,0,3,0,1,3,0.333,1,1,1,1,1,2
16374,Ty Lawson,29-073,G,1/15/17,SAC,,OKC,L,0,21,0,3,0,0,1,0,0,2,0,4,4,1,0,1,1
16375,Ty Lawson,29-088,G,1/30/17,SAC,@,PHI,L,0,27,2,5,0.4,2,4,0.5,0,1,0,0,0,,0,3,3
16376,Ty Lawson,29-036,G,12/9/16,SAC,,NYK,L,0,18,1,5,0.2,1,3,0.333,0,2,0,2,3,0.667,0,3,3
16377,Ty Lawson,29-114,G,2/25/17,SAC,,CHO,L,0,23,1,5,0.2,0,3,0,1,2,0.5,1,2,0.5,2,2,4
16378,Courtney Lee,31-045,G,11/17/16,NYK,@,WAS,L,1,23,2,9,0.222,2,8,0.25,0,1,0,0,0,,0,3,3
16379,Courtney Lee,31-128,G,2/8/17,NYK,,LAC,L,1,32,2,4,0.5,2,3,0.667,0,1,0,0,0,,0,1,1
16380,David Lee,33-189,F,11/4/16,SAS,@,UTA,W,0,14,2,2,1,2,2,1,0,0,,0,0,,1,0,1
16381,David Lee,33-221,F,12/6/16,SAS,@,MIN,W,0,12,2,4,0.5,2,4,0.5,0,0,,0,0,,0,2,2
16382,David Lee,33-238,F,12/23/16,SAS,@,POR,W,0,20,2,6,0.333,2,6,0.333,0,0,,0,0,,3,6,9
16383,David Lee,33-258,F,1/12/17,SAS,,LAL,W,0,14,1,3,0.333,1,3,0.333,0,0,,2,2,1,0,3,3
16384,David Lee,33-203,F,11/18/16,SAS,@,LAL,W,0,18,1,1,1,1,1,1,0,0,,2,2,1,1,2,3
16385,David Lee,33-309,F,3/4/17,SAS,,MIN,W,0,14,2,3,0.667,2,3,0.667,0,0,,0,0,,2,4,6
16386,David Lee,33-201,F,11/16/16,SAS,@,SAC,W,0,11,2,4,0.5,2,4,0.5,0,0,,0,0,,2,1,3
16387,David Lee,33-233,F,12/18/16,SAS,,NOP,W,0,18,2,3,0.667,2,3,0.667,0,0,,0,1,0,2,4,6
16388,David Lee,33-196,F,11/11/16,SAS,,DET,W,0,16,2,2,1,2,2,1,0,0,,0,0,,1,1,2
16389,David Lee,33-211,F,11/26/16,SAS,@,WAS,W,0,20,2,4,0.5,2,4,0.5,0,0,,0,0,,0,7,7
16390,Alex Len,23-220,C,1/22/17,PHO,@,TOR,W,0,21,2,3,0.667,2,3,0.667,0,0,,0,0,,1,9,10
16391,Alex Len,23-219,C,1/21/17,PHO,@,NYK,W,0,10,0,3,0,0,3,0,0,0,,4,4,1,0,3,3
16392,Alex Len,23-198,C,12/31/16,PHO,@,UTA,L,0,23,2,5,0.4,2,5,0.4,0,0,,0,0,,2,2,4
16393,Alex Len,23-217,C,1/19/17,PHO,@,CLE,L,0,8,2,3,0.667,2,3,0.667,0,0,,0,0,,0,3,3
16394,Alex Len,23-145,C,11/8/16,PHO,@,POR,L,1,17,1,5,0.2,1,5,0.2,0,0,,2,2,1,4,5,9
16395,Alex Len,23-253,C,2/24/17,PHO,@,CHI,L,1,35,2,6,0.333,2,5,0.4,0,1,0,0,2,0,1,6,7
16396,Alex Len,23-212,C,1/14/17,PHO,,SAS,W,0,21,1,2,0.5,1,1,1,0,1,0,2,2,1,1,3,4
16397,Alex Len,23-141,C,11/4/16,PHO,@,NOP,W,0,15,1,4,0.25,1,4,0.25,0,0,,2,2,1,3,7,10
16398,Alex Len,23-224,C,1/26/17,PHO,@,DEN,L,0,11,2,5,0.4,2,5,0.4,0,0,,0,0,,2,1,3
16399,Meyers Leonard,24-362,C-F,2/23/17,POR,@,ORL,W,0,11,1,2,0.5,1,1,1,0,1,0,2,2,1,1,3,4
16400,Meyers Leonard,24-287,C-F,12/10/16,POR,@,IND,L,0,22,2,7,0.286,2,3,0.667,0,4,0,0,0,,0,4,4
16401,Caris LeVert,22-162,G-F,2/3/17,BRK,,IND,L,1,30,1,9,0.111,1,5,0.2,0,4,0,2,2,1,0,5,5
16402,Caris LeVert,22-190,G-F,3/3/17,BRK,@,UTA,L,1,20,2,6,0.333,2,2,1,0,4,0,0,0,,0,2,2
16403,Caris LeVert,22-158,G-F,1/30/17,BRK,@,MIA,L,0,27,2,8,0.25,2,6,0.333,0,2,0,0,0,,3,3,6
16404,DeAndre Liggins,28-275,G,12/31/16,CLE,@,CHO,W,1,26,2,5,0.4,2,2,1,0,3,0,0,0,,1,1,2
16405,DeAndre Liggins,28-338,G,3/4/17,CLE,@,MIA,L,0,29,2,6,0.333,2,6,0.333,0,0,,0,2,0,2,6,8
16406,DeAndre Liggins,28-232,G,11/18/16,CLE,,DET,W,0,12,1,3,0.333,1,3,0.333,0,0,,2,2,1,1,3,4
16407,DeAndre Liggins,28-230,G,11/16/16,CLE,@,IND,L,0,27,1,2,0.5,1,2,0.5,0,0,,2,2,1,1,1,2
16408,DeAndre Liggins,28-208,G,10/25/16,CLE,,NYK,W,0,12,2,3,0.667,2,3,0.667,0,0,,0,0,,0,3,3
16409,Jeremy Lin,28-208,G,3/19/17,BRK,,DAL,L,1,7,2,4,0.5,2,3,0.667,0,1,0,0,0,,0,0,0
16410,Shaun Livingston,31-076,G,11/26/16,GSW,,MIN,W,0,23,2,7,0.286,2,7,0.286,0,0,,0,0,,1,2,3
16411,Shaun Livingston,31-093,G,12/13/16,GSW,@,NOP,W,0,17,2,5,0.4,2,5,0.4,0,0,,0,0,,0,2,2
16412,Shaun Livingston,31-190,G,3/20/17,GSW,@,OKC,W,0,17,1,5,0.2,1,5,0.2,0,0,,2,2,1,0,1,1
16413,Shaun Livingston,31-057,G,11/7/16,GSW,,NOP,W,0,17,2,4,0.5,2,4,0.5,0,0,,0,0,,1,2,3
16414,Shaun Livingston,31-103,G,12/23/16,GSW,@,DET,W,0,15,2,5,0.4,2,5,0.4,0,0,,0,0,,0,1,1
16415,Shaun Livingston,31-071,G,11/21/16,GSW,@,IND,W,0,16,1,2,0.5,1,2,0.5,0,0,,2,2,1,1,2,3
16416,Shaun Livingston,31-184,G,3/14/17,GSW,,PHI,W,0,12,1,1,1,1,1,1,0,0,,2,2,1,0,2,2
16417,Shaun Livingston,31-085,G,12/5/16,GSW,,IND,W,0,14,2,2,1,2,2,1,0,0,,0,0,,0,2,2
16418,Shaun Livingston,31-102,G,12/22/16,GSW,@,BRK,W,0,18,2,4,0.5,2,4,0.5,0,0,,0,0,,0,2,2
16419,Shaun Livingston,31-083,G,12/3/16,GSW,,PHO,W,0,18,2,3,0.667,2,3,0.667,0,0,,0,1,0,0,4,4
16420,Shaun Livingston,31-134,G,1/23/17,GSW,@,MIA,L,0,21,2,4,0.5,2,4,0.5,0,0,,0,0,,1,4,5
16421,Shaun Livingston,31-049,G,10/30/16,GSW,@,PHO,W,0,14,2,3,0.667,2,3,0.667,0,0,,0,1,0,0,1,1
16422,Shaun Livingston,31-081,G,12/1/16,GSW,,HOU,L,0,20,2,4,0.5,2,4,0.5,0,0,,0,0,,1,2,3
16423,Shaun Livingston,31-131,G,1/20/17,GSW,@,HOU,W,0,18,2,3,0.667,2,3,0.667,0,0,,0,0,,0,2,2
16424,Shaun Livingston,31-047,G,10/28/16,GSW,@,NOP,W,0,15,2,3,0.667,2,3,0.667,0,0,,0,0,,0,1,1
16425,Shawn Long,24-050,F,3/20/17,PHI,@,ORL,L,0,11,1,1,1,1,1,1,0,0,,2,2,1,1,1,2
16426,Kevon Looney,20-301,F-C,12/3/16,GSW,,PHO,W,0,7,2,3,0.667,2,2,1,0,1,0,0,0,,0,2,2
16427,Kevon Looney,21-005,F-C,2/11/17,GSW,@,OKC,W,0,11,1,2,0.5,1,2,0.5,0,0,,2,2,1,0,0,0
16428,Kevon Looney,20-315,F-C,12/17/16,GSW,,POR,W,0,12,2,6,0.333,2,6,0.333,0,0,,0,0,,2,3,5
16429,Kevon Looney,20-364,F-C,2/4/17,GSW,@,SAC,L,0,12,1,1,1,1,1,1,0,0,,2,2,1,0,2,2
16430,Kevon Looney,20-309,F-C,12/11/16,GSW,@,MIN,W,1,18,2,2,1,2,2,1,0,0,,0,0,,1,2,3
16431,Kevon Looney,20-362,F-C,2/2/17,GSW,@,LAC,W,0,13,1,1,1,1,1,1,0,0,,2,2,1,2,1,3
16432,Kevon Looney,20-271,F-C,11/3/16,GSW,,OKC,W,0,11,2,2,1,2,2,1,0,0,,0,0,,2,4,6
16433,Kevon Looney,20-306,F-C,12/8/16,GSW,@,UTA,W,0,3,2,2,1,2,2,1,0,0,,0,0,,0,0,0
16434,Kevon Looney,20-357,F-C,1/28/17,GSW,,LAC,W,0,12,2,4,0.5,2,3,0.667,0,1,0,0,0,,1,3,4
16435,Kevon Looney,20-320,F-C,12/22/16,GSW,@,BRK,W,1,18,2,5,0.4,2,5,0.4,0,0,,0,0,,2,4,6
16436,Kevon Looney,20-265,F-C,10/28/16,GSW,@,NOP,W,0,7,1,1,1,1,1,1,0,0,,2,2,1,1,2,3
16437,Robin Lopez,28-213,C,10/31/16,CHI,@,BRK,W,1,19,1,5,0.2,1,5,0.2,0,0,,2,2,1,2,3,5
16438,Robin Lopez,28-343,C,3/10/17,CHI,,HOU,L,1,20,2,6,0.333,2,6,0.333,0,0,,0,0,,1,3,4
16439,Robin Lopez,28-253,C,12/10/16,CHI,,MIA,W,1,31,2,7,0.286,2,7,0.286,0,0,,0,0,,4,6,10
16440,Timothe Luwawu-Cabarrot,21-252,F,1/16/17,PHI,@,MIL,W,0,17,1,3,0.333,1,3,0.333,0,0,,2,2,1,2,1,3
16441,Timothe Luwawu-Cabarrot,21-189,F,11/14/16,PHI,@,HOU,L,0,9,2,3,0.667,2,3,0.667,0,0,,0,0,,0,1,1
16442,Timothe Luwawu-Cabarrot,21-239,F,1/3/17,PHI,,MIN,W,0,22,0,2,0,0,1,0,0,1,0,4,4,1,0,2,2
16443,Timothe Luwawu-Cabarrot,21-207,F,12/2/16,PHI,,ORL,L,0,6,1,3,0.333,1,2,0.5,0,1,0,2,2,1,0,3,3
16444,Timothe Luwawu-Cabarrot,21-254,F,1/18/17,PHI,,TOR,W,0,17,1,6,0.167,1,4,0.25,0,2,0,2,2,1,1,1,2
16445,Trey Lyles,21-069,F,1/13/17,UTA,,DET,W,0,17,2,5,0.4,2,2,1,0,3,0,0,0,,0,5,5
16446,Trey Lyles,21-007,F,11/12/16,UTA,@,MIA,W,0,20,2,7,0.286,2,5,0.4,0,2,0,0,0,,0,5,5
16447,Shelvin Mack,26-217,G,11/25/16,UTA,,ATL,W,0,18,2,6,0.333,2,4,0.5,0,2,0,0,0,,0,0,0
16448,Shelvin Mack,26-251,G,12/29/16,UTA,,PHI,W,0,19,2,5,0.4,2,4,0.5,0,1,0,0,0,,1,1,2
16449,Shelvin Mack,26-186,G,10/25/16,UTA,@,POR,L,0,15,2,5,0.4,2,4,0.5,0,1,0,0,0,,0,1,1
16450,Shelvin Mack,26-261,G,1/8/17,UTA,@,MEM,L,0,15,2,5,0.4,2,4,0.5,0,1,0,0,0,,1,3,4
16451,Shelvin Mack,26-198,G,11/6/16,UTA,@,NYK,W,0,12,2,3,0.667,2,3,0.667,0,0,,0,0,,0,3,3
16452,Shelvin Mack,26-211,G,11/19/16,UTA,@,HOU,L,0,22,2,6,0.333,2,4,0.5,0,2,0,0,1,0,0,1,1
16453,Shelvin Mack,26-194,G,11/2/16,UTA,,DAL,W,0,14,1,8,0.125,0,2,0,1,6,0.167,1,2,0.5,0,2,2
16454,Shelvin Mack,26-191,G,10/30/16,UTA,@,LAC,L,0,14,2,5,0.4,2,3,0.667,0,2,0,0,0,,0,0,0
16455,Ian Mahinmi,30-120,C,3/5/17,WAS,,ORL,W,0,20,1,4,0.25,1,4,0.25,0,0,,2,2,1,1,4,5
16456,Ian Mahinmi,30-100,C,2/13/17,WAS,,OKC,W,0,15,0,0,,0,0,,0,0,,4,6,0.667,0,0,0
16457,Thon Maker,19-338,F-C,1/28/17,MIL,,BOS,L,1,10,2,5,0.4,2,5,0.4,0,0,,0,0,,0,2,2
16458,Thon Maker,19-356,F-C,2/15/17,MIL,@,BRK,W,1,14,1,2,0.5,0,1,0,1,1,1,1,2,0.5,0,4,4
16459,Thon Maker,20-011,F-C,3/8/17,MIL,,NYK,W,1,11,2,7,0.286,2,5,0.4,0,2,0,0,0,,1,2,3
16460,Thon Maker,19-278,F-C,11/29/16,MIL,,CLE,W,0,3,1,2,0.5,1,2,0.5,0,0,,2,2,1,0,1,1
16461,Thon Maker,20-006,F-C,3/3/17,MIL,,LAC,W,1,16,2,8,0.25,2,4,0.5,0,4,0,0,0,,0,1,1
16462,Boban Marjanovic,28-211,C,3/14/17,DET,@,CLE,L,0,2,1,2,0.5,1,2,0.5,0,0,,2,2,1,0,1,1
16463,Boban Marjanovic,28-141,C,1/3/17,DET,,IND,L,0,10,2,5,0.4,2,5,0.4,0,0,,0,0,,2,2,4
16464,Boban Marjanovic,28-177,C,2/8/17,DET,,LAL,W,0,4,2,2,1,2,2,1,0,0,,0,0,,3,1,4
16465,Boban Marjanovic,28-091,C,11/14/16,DET,,OKC,W,0,12,2,6,0.333,2,6,0.333,0,0,,0,0,,0,4,4
16466,Boban Marjanovic,28-216,C,3/19/17,DET,,PHO,W,0,2,1,1,1,1,1,1,0,0,,2,2,1,0,0,0
16467,Jarell Martin,22-206,F,12/16/16,MEM,,SAC,L,0,12,1,2,0.5,1,1,1,0,1,0,2,2,1,2,0,2
16468,Jarell Martin,22-159,F,10/30/16,MEM,,WAS,W,1,19,1,4,0.25,1,3,0.333,0,1,0,2,2,1,1,4,5
16469,Jarell Martin,22-172,F,11/12/16,MEM,@,MIL,L,0,19,1,3,0.333,1,2,0.5,0,1,0,2,2,1,0,5,5
16470,Jarell Martin,22-216,F,12/26/16,MEM,@,ORL,L,0,16,2,3,0.667,2,3,0.667,0,0,,0,0,,0,8,8
16471,Wesley Matthews,30-061,G,12/14/16,DAL,,DET,L,1,38,2,10,0.2,2,5,0.4,0,5,0,0,0,,0,2,2
16472,Luc Mbah a Moute,30-056,F,11/4/16,LAC,@,MEM,W,1,18,2,2,1,2,2,1,0,0,,0,0,,0,1,1
16473,Luc Mbah a Moute,30-178,F,3/6/17,LAC,,BOS,W,1,15,2,4,0.5,2,3,0.667,0,1,0,0,0,,0,3,3
16474,Luc Mbah a Moute,30-192,F,3/20/17,LAC,,NYK,W,1,21,2,4,0.5,2,2,1,0,2,0,0,0,,0,3,3
16475,Luc Mbah a Moute,30-068,F,11/16/16,LAC,,MEM,L,1,21,0,5,0,0,3,0,0,2,0,4,6,0.667,0,2,2
16476,Luc Mbah a Moute,30-129,F,1/16/17,LAC,,OKC,W,1,19,2,3,0.667,2,3,0.667,0,0,,0,0,,0,2,2
16477,Luc Mbah a Moute,30-092,F,12/10/16,LAC,,NOP,W,1,18,1,5,0.2,1,4,0.25,0,1,0,2,2,1,0,1,1
16478,Luc Mbah a Moute,30-059,F,11/7/16,LAC,,DET,W,1,25,2,3,0.667,2,3,0.667,0,0,,0,0,,0,2,2
16479,James Michael McAdoo,23-332,F,12/1/16,GSW,,HOU,L,0,8,2,2,1,2,2,1,0,0,,0,0,,0,2,2
16480,James Michael McAdoo,24-050,F,2/23/17,GSW,,LAC,W,0,8,2,4,0.5,2,4,0.5,0,0,,0,0,,1,1,2
16481,James Michael McAdoo,24-025,F,1/29/17,GSW,@,POR,W,0,11,1,1,1,1,1,1,0,0,,2,2,1,1,1,2
16482,James Michael McAdoo,24-066,F,3/11/17,GSW,@,SAS,L,0,23,2,7,0.286,2,7,0.286,0,0,,0,2,0,1,4,5
16483,James Michael McAdoo,24-038,F,2/11/17,GSW,@,OKC,W,0,10,2,3,0.667,2,3,0.667,0,0,,0,2,0,0,0,0
16484,James Michael McAdoo,24-055,F,2/28/17,GSW,@,WAS,L,0,12,2,2,1,2,2,1,0,0,,0,0,,0,4,4
16485,Patrick McCaw,21-113,G,2/15/17,GSW,,SAC,W,0,18,1,4,0.25,1,1,1,0,3,0,2,2,1,0,2,2
16486,Patrick McCaw,21-092,G,1/25/17,GSW,@,CHO,W,0,12,2,3,0.667,2,2,1,0,1,0,0,0,,0,2,2
16487,Patrick McCaw,21-131,G,3/5/17,GSW,@,NYK,W,0,16,2,3,0.667,2,3,0.667,0,0,,0,0,,1,1,2
16488,T.J. McConnell,24-276,G,12/26/16,PHI,@,SAC,L,0,23,1,4,0.25,1,4,0.25,0,0,,2,4,0.5,1,1,2
16489,T.J. McConnell,24-295,G,1/14/17,PHI,@,WAS,L,1,22,2,8,0.25,2,7,0.286,0,1,0,0,0,,0,3,3
16490,T.J. McConnell,24-294,G,1/13/17,PHI,,CHO,W,1,31,2,4,0.5,2,4,0.5,0,0,,0,0,,1,2,3
16491,T.J. McConnell,24-222,G,11/2/16,PHI,@,CHO,L,0,22,2,7,0.286,2,4,0.5,0,3,0,0,0,,0,1,1
16492,T.J. McConnell,24-253,G,12/3/16,PHI,,BOS,L,0,16,2,5,0.4,2,5,0.4,0,0,,0,0,,1,1,2
16493,T.J. McConnell,24-289,G,1/8/17,PHI,@,BRK,W,1,36,2,11,0.182,2,9,0.222,0,2,0,0,0,,0,8,8
16494,T.J. McConnell,24-252,G,12/2/16,PHI,,ORL,L,0,17,2,6,0.333,2,5,0.4,0,1,0,0,0,,0,2,2
16495,T.J. McConnell,24-339,G,2/27/17,PHI,,GSW,L,1,20,2,3,0.667,2,3,0.667,0,0,,0,0,,1,1,2
16496,T.J. McConnell,24-234,G,11/14/16,PHI,@,HOU,L,0,21,2,4,0.5,2,3,0.667,0,1,0,0,0,,1,1,2
16497,T.J. McConnell,24-314,G,2/2/17,PHI,@,SAS,L,1,32,2,5,0.4,2,4,0.5,0,1,0,0,0,,0,5,5
16498,Chris McCullough,21-357,F,1/27/17,BRK,@,CLE,L,0,5,2,2,1,2,2,1,0,0,,0,0,,1,0,1
16499,K.J. McDaniels,23-266,G-F,11/1/16,HOU,@,CLE,L,0,20,2,7,0.286,2,4,0.5,0,3,0,0,0,,0,1,1
16500,K.J. McDaniels,23-294,G-F,11/29/16,HOU,@,UTA,L,0,3,1,2,0.5,0,1,0,1,1,1,1,2,0.5,0,1,1
16501,Doug McDermott,25-036,F,2/8/17,CHI,@,GSW,L,0,17,2,6,0.333,2,5,0.4,0,1,0,0,0,,0,0,0
16502,Doug McDermott,25-007,F,1/10/17,CHI,@,WAS,L,1,24,2,11,0.182,2,6,0.333,0,5,0,0,0,,0,1,1
16503,JaVale McGee,28-363,C,1/16/17,GSW,,CLE,W,0,9,2,3,0.667,2,3,0.667,0,0,,0,0,,0,3,3
16504,JaVale McGee,28-295,C,11/9/16,GSW,,DAL,W,0,4,2,2,1,2,2,1,0,0,,0,2,0,1,0,1
16505,JaVale McGee,29-035,C,2/23/17,GSW,,LAC,W,0,12,1,3,0.333,1,2,0.5,0,1,0,2,2,1,3,1,4
16506,JaVale McGee,28-289,C,11/3/16,GSW,,OKC,W,0,5,2,3,0.667,2,3,0.667,0,0,,0,0,,0,0,0
16507,JaVale McGee,29-048,C,3/8/17,GSW,,BOS,L,0,5,2,4,0.5,2,4,0.5,0,0,,0,0,,2,1,3
16508,JaVale McGee,28-323,C,12/7/16,GSW,@,LAC,W,0,4,1,2,0.5,1,2,0.5,0,0,,2,2,1,1,0,1
16509,JaVale McGee,28-287,C,11/1/16,GSW,@,POR,W,0,6,2,3,0.667,2,3,0.667,0,0,,0,0,,0,0,0
16510,JaVale McGee,29-046,C,3/6/17,GSW,@,ATL,W,0,9,2,3,0.667,2,3,0.667,0,0,,0,0,,0,1,1
16511,JaVale McGee,29-061,C,3/21/17,GSW,@,DAL,W,0,9,2,4,0.5,2,4,0.5,0,0,,0,2,0,1,3,4
16512,JaVale McGee,28-353,C,1/6/17,GSW,,MEM,L,0,5,2,2,1,2,2,1,0,0,,0,0,,0,0,0
16513,JaVale McGee,29-022,C,2/10/17,GSW,@,MEM,W,1,18,2,5,0.4,2,5,0.4,0,0,,0,0,,3,1,4
16514,JaVale McGee,29-042,C,3/2/17,GSW,@,CHI,L,0,10,1,3,0.333,1,3,0.333,0,0,,2,2,1,0,1,1
16515,JaVale McGee,28-302,C,11/16/16,GSW,@,TOR,W,0,4,2,4,0.5,2,4,0.5,0,0,,0,0,,1,0,1
16516,Rodney McGruder,25-197,G,2/11/17,MIA,@,PHI,L,1,26,2,6,0.333,2,5,0.4,0,1,0,0,0,,2,2,4
16517,Rodney McGruder,25-215,G,3/1/17,MIA,,PHI,W,1,19,2,5,0.4,2,2,1,0,3,0,0,0,,2,1,3
16518,Rodney McGruder,25-226,G,3/12/17,MIA,@,IND,L,1,19,2,5,0.4,2,4,0.5,0,1,0,0,0,,2,1,3
16519,Rodney McGruder,25-101,G,11/7/16,MIA,@,OKC,L,0,4,1,1,1,0,0,,1,1,1,1,2,0.5,0,1,1
16520,Ben McLemore,23-319,G,12/26/16,SAC,,PHI,W,1,17,2,7,0.286,2,4,0.5,0,3,0,0,0,,0,2,2
16521,Ben McLemore,23-344,G,1/20/17,SAC,@,MEM,L,0,12,2,6,0.333,2,4,0.5,0,2,0,0,0,,0,0,0
16522,Ben McLemore,23-290,G,11/27/16,SAC,@,BRK,W,0,7,2,4,0.5,2,3,0.667,0,1,0,0,0,,0,1,1
16523,Ben McLemore,23-324,G,12/31/16,SAC,,MEM,L,1,15,2,4,0.5,2,2,1,0,2,0,0,0,,0,0,0
16524,Jordan McRae,25-310,G,2/1/17,CLE,,MIN,W,0,4,1,1,1,0,0,,1,1,1,1,2,0.5,0,2,2
16525,Jordan McRae,25-280,G,1/2/17,CLE,,NOP,W,1,16,1,5,0.2,1,2,0.5,0,3,0,2,2,1,0,3,3
16526,Josh McRoberts,29-258,F,11/12/16,MIA,,UTA,L,0,13,2,4,0.5,2,3,0.667,0,1,0,0,0,,0,0,0
16527,Josh McRoberts,29-298,F,12/22/16,MIA,,LAL,W,1,16,2,2,1,2,2,1,0,0,,0,0,,1,1,2
16528,Jodie Meeks,29-110,G,12/9/16,ORL,@,CHO,L,0,20,0,8,0,0,4,0,0,4,0,4,4,1,1,4,5
16529,Salah Mejri,30-182,C,12/14/16,DAL,,DET,L,1,27,2,4,0.5,2,4,0.5,0,0,,0,0,,1,7,8
16530,Salah Mejri,30-197,C,12/29/16,DAL,@,LAL,W,0,12,2,2,1,2,2,1,0,0,,0,0,,3,3,6
16531,Salah Mejri,30-218,C,1/19/17,DAL,@,MIA,L,0,19,2,2,1,2,2,1,0,0,,0,0,,0,3,3
16532,Salah Mejri,30-144,C,11/6/16,DAL,,MIL,W,0,13,2,4,0.5,2,4,0.5,0,0,,0,0,,1,5,6
16533,Salah Mejri,30-233,C,2/3/17,DAL,@,POR,W,0,18,0,0,,0,0,,0,0,,4,4,1,1,4,5
16534,Salah Mejri,30-214,C,1/15/17,DAL,,MIN,W,0,18,2,3,0.667,2,3,0.667,0,0,,0,0,,3,5,8
16535,Salah Mejri,30-211,C,1/12/17,DAL,@,PHO,W,0,16,2,2,1,2,2,1,0,0,,0,0,,2,5,7
16536,Salah Mejri,30-241,C,2/11/17,DAL,,ORL,W,0,19,2,3,0.667,2,3,0.667,0,0,,0,0,,4,11,15
16537,Salah Mejri,30-261,C,3/3/17,DAL,,MEM,W,0,10,2,2,1,2,2,1,0,0,,0,0,,1,2,3
16538,Salah Mejri,30-275,C,3/17/17,DAL,@,PHI,L,0,12,2,3,0.667,2,3,0.667,0,0,,0,2,0,0,2,2
16539,Jordan Mickey,22-202,F,1/27/17,BOS,,ORL,W,0,6,2,3,0.667,2,2,1,0,1,0,0,0,,0,2,2
16540,Jordan Mickey,22-186,F,1/11/17,BOS,,WAS,W,1,14,1,1,1,1,1,1,0,0,,2,3,0.667,1,1,2
16541,Jordan Mickey,22-151,F,12/7/16,BOS,@,ORL,W,0,2,2,3,0.667,2,3,0.667,0,0,,0,0,,3,0,3
16542,Patty Mills,28-086,G,11/5/16,SAS,,LAC,L,1,25,1,7,0.143,1,4,0.25,0,3,0,2,2,1,1,2,3
16543,Paul Millsap,31-352,F,1/27/17,ATL,,WAS,L,1,23,1,7,0.143,1,5,0.2,0,2,0,2,4,0.5,0,4,4
16544,Nikola Mirotic,25-348,F,1/24/17,CHI,@,ORL,W,0,19,1,5,0.2,1,2,0.5,0,3,0,2,2,1,0,3,3
16545,Greg Monroe,26-273,C-F,3/4/17,MIL,,TOR,W,0,22,2,9,0.222,2,9,0.222,0,0,,0,0,,4,2,6
16546,Greg Monroe,26-165,C-F,11/16/16,MIL,@,ATL,L,0,7,1,4,0.25,1,4,0.25,0,0,,2,2,1,2,1,3
16547,E'Twaun Moore,27-353,G,2/15/17,NOP,@,MEM,W,0,18,2,8,0.25,2,5,0.4,0,3,0,0,0,,0,1,1
16548,E'Twaun Moore,27-243,G,10/28/16,NOP,,GSW,L,1,26,2,6,0.333,2,4,0.5,0,2,0,0,0,,0,3,3
16549,Marcus Morris,27-070,F,11/11/16,DET,@,SAS,L,1,31,2,11,0.182,2,8,0.25,0,3,0,0,0,,1,1,2
16550,Anthony Morrow,31-083,G,12/19/16,OKC,,ATL,L,1,19,1,5,0.2,1,2,0.5,0,3,0,2,2,1,0,0,0
16551,Anthony Morrow,31-075,G,12/11/16,OKC,,BOS,W,0,28,2,8,0.25,2,4,0.5,0,4,0,0,0,,1,0,1
16552,Donatas Motiejunas,26-133,F-C,1/31/17,NOP,@,TOR,L,0,25,2,6,0.333,2,5,0.4,0,1,0,0,0,,2,2,4
16553,Donatas Motiejunas,26-146,F-C,2/13/17,NOP,@,PHO,W,0,18,2,6,0.333,2,4,0.5,0,2,0,0,0,,1,6,7
16554,Donatas Motiejunas,26-180,F-C,3/19/17,NOP,,MIN,W,0,6,2,3,0.667,2,3,0.667,0,0,,0,2,0,0,0,0
16555,Timofey Mozgov,30-148,C,12/11/16,LAL,,NYK,L,1,22,2,5,0.4,2,5,0.4,0,0,,0,0,,1,3,4
16556,Timofey Mozgov,30-160,C,12/23/16,LAL,@,ORL,L,1,25,1,7,0.143,1,7,0.143,0,0,,2,2,1,2,5,7
16557,Timofey Mozgov,30-190,C,1/22/17,LAL,@,DAL,L,1,20,1,5,0.2,1,5,0.2,0,0,,2,2,1,3,5,8
16558,Timofey Mozgov,30-115,C,11/8/16,LAL,,DAL,L,1,20,2,4,0.5,2,4,0.5,0,0,,0,0,,0,2,2
16559,Timofey Mozgov,30-188,C,1/20/17,LAL,,IND,W,1,25,2,5,0.4,2,5,0.4,0,0,,0,0,,4,7,11
16560,Timofey Mozgov,30-185,C,1/17/17,LAL,,DEN,L,1,10,2,3,0.667,2,3,0.667,0,0,,0,0,,1,0,1
16561,Timofey Mozgov,30-213,C,2/14/17,LAL,,SAC,L,0,11,2,3,0.667,2,3,0.667,0,0,,0,0,,2,1,3
16562,Timofey Mozgov,30-111,C,11/4/16,LAL,,GSW,W,1,16,2,2,1,2,2,1,0,0,,0,0,,3,2,5
16563,Timofey Mozgov,30-202,C,2/3/17,LAL,@,BOS,L,1,15,1,4,0.25,1,4,0.25,0,0,,2,2,1,1,5,6
16564,Timofey Mozgov,30-153,C,12/16/16,LAL,@,PHI,W,1,19,2,5,0.4,2,5,0.4,0,0,,0,0,,1,4,5
16565,Timofey Mozgov,30-120,C,11/13/16,LAL,@,MIN,L,1,15,2,3,0.667,2,3,0.667,0,0,,0,0,,1,3,4
16566,Emmanuel Mudiay,21-003,G,3/8/17,DEN,,WAS,L,0,8,2,5,0.4,2,5,0.4,0,0,,0,0,,0,1,1
16567,Emmanuel Mudiay,20-280,G,12/10/16,DEN,@,ORL,W,1,23,2,6,0.333,2,5,0.4,0,1,0,0,0,,0,3,3
16568,Emmanuel Mudiay,20-275,G,12/5/16,DEN,@,PHI,W,1,21,1,6,0.167,1,5,0.2,0,1,0,2,2,1,0,1,1
16569,Shabazz Muhammad,24-111,F-G,3/4/17,MIN,@,SAS,L,0,16,2,4,0.5,2,3,0.667,0,1,0,0,0,,2,0,2
16570,Shabazz Muhammad,24-006,F-G,11/19/16,MIN,@,MEM,L,0,18,2,2,1,2,2,1,0,0,,0,0,,0,2,2
16571,Shabazz Muhammad,23-365,F-G,11/12/16,MIN,,LAC,L,0,15,1,2,0.5,1,2,0.5,0,0,,2,2,1,0,1,1
16572,Shabazz Muhammad,24-118,F-G,3/11/17,MIN,@,MIL,L,0,16,2,7,0.286,2,6,0.333,0,1,0,0,1,0,0,2,2
16573,Shabazz Muhammad,24-013,F-G,11/26/16,MIN,@,GSW,L,0,9,0,2,0,0,0,,0,2,0,4,4,1,0,1,1
16574,Dejounte Murray,20-126,G,1/23/17,SAS,@,BRK,W,1,22,2,8,0.25,2,6,0.333,0,2,0,0,0,,1,5,6
16575,Dejounte Murray,20-097,G,12/25/16,SAS,,CHI,W,0,2,2,2,1,2,2,1,0,0,,0,0,,0,0,0
16576,Dejounte Murray,20-171,G,3/9/17,SAS,@,OKC,L,1,24,2,6,0.333,2,5,0.4,0,1,0,0,0,,1,5,6
16577,Dejounte Murray,20-138,G,2/4/17,SAS,,DEN,W,0,9,2,5,0.4,2,4,0.5,0,1,0,0,0,,0,0,0
16578,Dejounte Murray,20-170,G,3/8/17,SAS,,SAC,W,0,13,1,3,0.333,1,3,0.333,0,0,,2,3,0.667,0,3,3
16579,Dejounte Murray,20-094,G,12/22/16,SAS,@,LAC,L,0,8,2,5,0.4,2,5,0.4,0,0,,0,2,0,1,1,2
16580,Dejounte Murray,20-063,G,11/21/16,SAS,,DAL,W,1,15,2,3,0.667,2,3,0.667,0,0,,0,0,,0,2,2
16581,Jamal Murray,19-296,G,12/15/16,DEN,,POR,W,0,16,1,6,0.167,1,4,0.25,0,2,0,2,2,1,1,1,2
16582,Jamal Murray,20-011,G,3/6/17,DEN,,SAC,W,0,18,2,4,0.5,2,2,1,0,2,0,0,0,,0,0,0
16583,Jamal Murray,19-319,G,1/7/17,DEN,@,OKC,L,0,14,1,2,0.5,1,2,0.5,0,0,,2,2,1,0,1,1
16584,Jamal Murray,19-338,G,1/26/17,DEN,,PHO,W,0,6,1,3,0.333,1,2,0.5,0,1,0,2,2,1,1,0,1
16585,Mike Muscala,25-142,F-C,11/20/16,ATL,@,NYK,L,0,19,1,5,0.2,1,4,0.25,0,1,0,2,2,1,1,1,2
16586,Mike Muscala,25-227,F-C,2/13/17,ATL,@,POR,W,0,13,2,3,0.667,2,3,0.667,0,0,,0,0,,1,3,4
16587,Larry Nance Jr.,23-319,F,11/15/16,LAL,,BRK,W,0,18,2,5,0.4,2,5,0.4,0,0,,0,0,,0,4,4
16588,Larry Nance Jr.,23-350,F,12/16/16,LAL,@,PHI,W,0,34,2,3,0.667,2,3,0.667,0,0,,0,0,,4,7,11
16589,Larry Nance Jr.,24-073,F,3/15/17,LAL,@,HOU,L,0,8,2,2,1,2,2,1,0,0,,0,0,,2,0,2
16590,Larry Nance Jr.,24-054,F,2/24/17,LAL,@,OKC,L,0,25,2,4,0.5,2,4,0.5,0,0,,0,0,,6,6,12
16591,Larry Nance Jr.,23-327,F,11/23/16,LAL,@,GSW,L,0,18,1,2,0.5,1,2,0.5,0,0,,2,2,1,0,7,7
16592,Larry Nance Jr.,24-025,F,1/26/17,LAL,@,UTA,L,0,23,2,4,0.5,2,4,0.5,0,0,,0,0,,4,3,7
16593,Larry Nance Jr.,24-021,F,1/22/17,LAL,@,DAL,L,0,10,2,2,1,2,2,1,0,0,,0,0,,1,0,1
16594,Larry Nance Jr.,23-322,F,11/18/16,LAL,,SAS,L,0,23,1,3,0.333,1,3,0.333,0,0,,2,2,1,1,3,4
16595,Larry Nance Jr.,24-063,F,3/5/17,LAL,,NOP,L,0,20,2,3,0.667,2,3,0.667,0,0,,0,0,,1,4,5
16596,Larry Nance Jr.,24-079,F,3/21/17,LAL,,LAC,L,0,8,2,3,0.667,2,3,0.667,0,0,,0,0,,2,1,3
16597,Shabazz Napier,25-186,G,1/16/17,POR,@,WAS,L,0,16,2,7,0.286,2,5,0.4,0,2,0,0,0,,1,3,4
16598,Shabazz Napier,25-132,G,11/23/16,POR,@,CLE,L,0,4,1,3,0.333,0,1,0,1,2,0.5,1,1,1,0,0,0
16599,Shabazz Napier,25-127,G,11/18/16,POR,@,NOP,L,0,2,1,1,1,1,1,1,0,0,,2,2,1,0,1,1
16600,Maurice Ndour,24-137,F,11/2/16,NYK,,HOU,L,0,19,2,2,1,2,2,1,0,0,,0,0,,0,1,1
16601,Maurice Ndour,24-151,F,11/16/16,NYK,,DET,W,0,9,2,3,0.667,2,2,1,0,1,0,0,0,,0,1,1
16602,Maurice Ndour,24-196,F,12/31/16,NYK,@,HOU,L,0,9,2,3,0.667,2,3,0.667,0,0,,0,0,,1,1,2
16603,Maurice Ndour,24-144,F,11/9/16,NYK,,BRK,W,0,8,2,3,0.667,2,3,0.667,0,0,,0,0,,0,2,2
16604,Maurice Ndour,24-137,F,11/2/16,NYK,,HOU,L,0,19,2,2,1,2,2,1,0,0,,0,0,,0,1,1
16605,Gary Neal,32-107,G,1/18/17,ATL,@,DET,L,0,13,0,4,0,0,3,0,0,1,0,4,4,1,0,1,1
16606,Raul Neto,24-222,G,12/27/16,UTA,@,LAL,W,0,14,2,5,0.4,2,3,0.667,0,2,0,0,0,,0,2,2
16607,Raul Neto,24-216,G,12/21/16,UTA,,SAC,L,0,14,2,4,0.5,2,3,0.667,0,1,0,0,0,,0,1,1
16608,Raul Neto,24-242,G,1/16/17,UTA,@,PHO,W,0,11,2,5,0.4,2,4,0.5,0,1,0,0,0,,0,1,1
16609,Georges Niang,23-134,F,10/29/16,IND,@,CHI,L,0,16,2,5,0.4,2,3,0.667,0,2,0,0,0,,1,1,2
16610,Andrew Nicholson,27-085,F,3/3/17,BRK,@,UTA,L,0,6,2,3,0.667,2,2,1,0,1,0,0,0,,2,2,4
16611,Andrew Nicholson,26-330,F,11/2/16,WAS,,TOR,L,0,9,2,4,0.5,2,4,0.5,0,0,,0,1,0,0,1,1
16612,Andrew Nicholson,26-347,F,11/19/16,WAS,,MIA,L,0,6,2,3,0.667,2,3,0.667,0,0,,0,0,,0,0,0
16613,Andrew Nicholson,27-037,F,1/14/17,WAS,,PHI,W,0,10,2,5,0.4,2,5,0.4,0,0,,0,0,,1,0,1
16614,Joakim Noah,31-345,C,2/4/17,NYK,,CLE,L,1,6,2,2,1,2,2,1,0,0,,0,0,,2,0,2
16615,Joakim Noah,31-255,C,11/6/16,NYK,,UTA,L,1,20,2,3,0.667,2,3,0.667,0,0,,0,0,,2,3,5
16616,Joakim Noah,31-290,C,12/11/16,NYK,@,LAL,W,1,20,2,4,0.5,2,4,0.5,0,0,,0,0,,1,2,3
16617,Joakim Noah,31-288,C,12/9/16,NYK,@,SAC,W,1,28,1,3,0.333,1,3,0.333,0,0,,2,2,1,1,8,9
16618,Joakim Noah,31-319,C,1/9/17,NYK,,NOP,L,1,18,2,3,0.667,2,3,0.667,0,0,,0,0,,3,7,10
16619,Joakim Noah,31-317,C,1/7/17,NYK,@,IND,L,1,21,2,4,0.5,2,4,0.5,0,0,,0,2,0,2,4,6
16620,Joakim Noah,31-261,C,11/12/16,NYK,@,TOR,L,1,33,2,9,0.222,2,9,0.222,0,0,,0,2,0,8,10,18
16621,Nerlens Noel,22-304,C-F,2/8/17,PHI,,SAS,L,0,22,1,4,0.25,1,4,0.25,0,0,,2,5,0.4,2,3,5
16622,Nerlens Noel,22-286,C-F,1/21/17,PHI,@,ATL,L,0,13,2,2,1,2,2,1,0,0,,0,0,,1,2,3
16623,Nerlens Noel,22-257,C-F,12/23/16,PHI,@,PHO,L,0,10,1,1,1,1,1,1,0,0,,2,4,0.5,0,1,1
16624,Nerlens Noel,22-254,C-F,12/20/16,PHI,,NOP,L,0,7,2,2,1,2,2,1,0,0,,0,0,,2,1,3
16625,Lucas Nogueira,24-192,C,2/3/17,TOR,@,ORL,L,0,25,2,3,0.667,2,3,0.667,0,0,,0,2,0,1,6,7
16626,Lucas Nogueira,24-159,C,1/1/17,TOR,@,LAL,W,0,20,2,3,0.667,2,3,0.667,0,0,,0,0,,0,2,2
16627,Lucas Nogueira,24-173,C,1/15/17,TOR,,NYK,W,1,35,2,3,0.667,2,3,0.667,0,0,,0,2,0,1,3,4
16628,Lucas Nogueira,24-187,C,1/29/17,TOR,,ORL,L,0,12,2,2,1,2,2,1,0,0,,0,0,,1,1,2
16629,Lucas Nogueira,24-153,C,12/26/16,TOR,@,POR,W,0,21,0,1,0,0,1,0,0,0,,4,4,1,1,7,8
16630,Lucas Nogueira,24-166,C,1/8/17,TOR,,HOU,L,0,13,2,2,1,2,2,1,0,0,,0,0,,1,3,4
16631,Lucas Nogueira,24-127,C,11/30/16,TOR,,MEM,W,0,18,2,3,0.667,2,3,0.667,0,0,,0,0,,1,1,2
16632,Lucas Nogueira,24-163,C,1/5/17,TOR,,UTA,W,1,26,2,5,0.4,2,5,0.4,0,0,,0,2,0,5,1,6
16633,Jusuf Nurkic,22-075,C,11/6/16,DEN,@,BOS,W,1,13,1,5,0.2,1,5,0.2,0,0,,2,4,0.5,1,5,6
16634,Jusuf Nurkic,22-127,C,12/28/16,DEN,,MIN,W,0,9,2,2,1,2,2,1,0,0,,0,0,,0,4,4
16635,Jusuf Nurkic,22-162,C,2/1/17,DEN,,MEM,L,1,19,1,4,0.25,1,4,0.25,0,0,,2,4,0.5,1,2,3
16636,Jusuf Nurkic,22-099,C,11/30/16,DEN,,MIA,L,1,17,2,3,0.667,2,3,0.667,0,0,,0,0,,3,3,6
16637,Jusuf Nurkic,22-111,C,12/12/16,DEN,@,DAL,L,1,18,2,6,0.333,2,6,0.333,0,0,,0,0,,3,3,6
16638,David Nwaba,24-062,PG,3/17/17,LAL,,MIL,L,0,13,2,3,0.667,2,3,0.667,0,0,,0,1,0,2,0,2
16639,David Nwaba,24-060,PG,3/15/17,LAL,@,HOU,L,0,18,2,5,0.4,2,5,0.4,0,0,,0,0,,1,1,2
16640,David Nwaba,24-054,PG,3/9/17,LAL,@,PHO,W,0,14,1,3,0.333,1,3,0.333,0,0,,2,2,1,0,3,3
16641,Kyle O'Quinn,26-253,F-C,12/4/16,NYK,,SAC,W,0,14,2,5,0.4,2,5,0.4,0,0,,0,0,,3,6,9
16642,Kyle O'Quinn,26-221,F-C,11/2/16,NYK,,HOU,L,0,5,2,2,1,2,2,1,0,0,,0,0,,0,1,1
16643,Kyle O'Quinn,26-340,F-C,3/1/17,NYK,@,ORL,W,0,19,2,6,0.333,2,4,0.5,0,2,0,0,0,,3,4,7
16644,Kyle O'Quinn,26-338,F-C,2/27/17,NYK,,TOR,L,0,15,2,3,0.667,2,2,1,0,1,0,0,0,,2,4,6
16645,Kyle O'Quinn,26-334,F-C,2/23/17,NYK,@,CLE,L,0,19,2,6,0.333,2,6,0.333,0,0,,0,1,0,6,4,10
16646,Kyle O'Quinn,26-295,F-C,1/15/17,NYK,@,TOR,L,0,11,2,7,0.286,2,7,0.286,0,0,,0,0,,2,3,5
16647,Kyle O'Quinn,26-347,F-C,3/8/17,NYK,@,MIL,L,0,11,2,5,0.4,2,5,0.4,0,0,,0,0,,1,3,4
16648,Kyle O'Quinn,26-323,F-C,2/12/17,NYK,,SAS,W,0,21,1,3,0.333,1,3,0.333,0,0,,2,2,1,0,7,7
16649,Kyle O'Quinn,26-225,F-C,11/6/16,NYK,,UTA,L,0,13,1,4,0.25,1,4,0.25,0,0,,2,2,1,1,0,1
16650,Kyle O'Quinn,26-241,F-C,11/22/16,NYK,,POR,W,1,24,2,6,0.333,2,6,0.333,0,0,,0,0,,1,4,5
16651,Jahlil Okafor,21-062,C-F,2/15/17,PHI,@,BOS,L,0,17,2,5,0.4,2,5,0.4,0,0,,0,2,0,1,3,4
16652,Jahlil Okafor,21-074,C-F,2/27/17,PHI,,GSW,L,1,17,2,3,0.667,2,3,0.667,0,0,,0,0,,0,3,3
16653,Jahlil Okafor,21-094,C-F,3/19/17,PHI,,BOS,W,1,12,2,4,0.5,2,4,0.5,0,0,,0,0,,1,0,1
16654,Jahlil Okafor,20-335,C-F,11/14/16,PHI,@,HOU,L,0,22,2,11,0.182,2,11,0.182,0,0,,0,0,,2,1,3
16655,Kelly Olynyk,25-243,C-F,12/18/16,BOS,@,MIA,W,0,13,1,5,0.2,1,3,0.333,0,2,0,2,4,0.5,0,2,2
16656,Kelly Olynyk,25-274,C-F,1/18/17,BOS,,NYK,L,0,13,2,6,0.333,2,5,0.4,0,1,0,0,0,,1,1,2
16657,Kelly Olynyk,25-311,C-F,2/24/17,BOS,@,TOR,L,0,16,1,3,0.333,1,3,0.333,0,0,,2,2,1,2,3,5
16658,Kelly Olynyk,25-321,C-F,3/6/17,BOS,@,LAC,L,0,20,2,6,0.333,2,4,0.5,0,2,0,0,0,,4,3,7
16659,Kelly Oubre,21-012,F,12/21/16,WAS,@,CHI,W,0,22,1,4,0.25,1,2,0.5,0,2,0,2,2,1,1,4,5
16660,Kelly Oubre,21-098,F,3/17/17,WAS,,CHI,W,0,15,2,5,0.4,2,3,0.667,0,2,0,0,0,,2,2,4
16661,Kelly Oubre,20-359,F,12/2/16,WAS,@,SAS,L,0,13,2,4,0.5,2,3,0.667,0,1,0,0,0,,0,1,1
16662,Kelly Oubre,21-055,F,2/2/17,WAS,,LAL,W,0,24,2,5,0.4,2,2,1,0,3,0,0,0,,1,0,1
16663,Kelly Oubre,21-079,F,2/26/17,WAS,,UTA,L,0,9,2,5,0.4,2,4,0.5,0,1,0,0,0,,0,0,0
16664,Kelly Oubre,21-049,F,1/27/17,WAS,@,ATL,W,0,30,2,11,0.182,2,6,0.333,0,5,0,0,0,,0,1,1
16665,Kelly Oubre,21-066,F,2/13/17,WAS,,OKC,W,0,12,2,4,0.5,2,4,0.5,0,0,,0,0,,0,1,1
16666,Kelly Oubre,21-101,F,3/20/17,WAS,@,BOS,L,0,24,2,5,0.4,2,2,1,0,3,0,0,0,,0,4,4
16667,Zaza Pachulia,32-301,C,12/7/16,GSW,@,LAC,W,1,22,2,4,0.5,2,3,0.667,0,1,0,0,0,,3,2,5
16668,Zaza Pachulia,32-283,C,11/19/16,GSW,@,MIL,W,1,17,2,7,0.286,2,7,0.286,0,0,,0,0,,6,4,10
16669,Zaza Pachulia,32-341,C,1/16/17,GSW,,CLE,W,1,21,2,7,0.286,2,7,0.286,0,0,,0,0,,3,10,13
16670,Zaza Pachulia,32-282,C,11/18/16,GSW,@,BOS,W,1,21,2,5,0.4,2,5,0.4,0,0,,0,0,,4,9,13
16671,Zaza Pachulia,32-319,C,12/25/16,GSW,@,CLE,L,1,13,2,3,0.667,2,3,0.667,0,0,,0,0,,1,4,5
16672,Zaza Pachulia,32-353,C,1/28/17,GSW,,LAC,W,1,14,2,3,0.667,2,3,0.667,0,0,,0,0,,2,4,6
16673,Zaza Pachulia,32-277,C,11/13/16,GSW,,PHO,W,1,12,1,3,0.333,1,3,0.333,0,0,,2,2,1,1,5,6
16674,Zaza Pachulia,32-292,C,11/28/16,GSW,,ATL,W,1,16,2,2,1,2,2,1,0,0,,0,0,,2,4,6
16675,Zaza Pachulia,32-274,C,11/10/16,GSW,@,DEN,W,1,14,2,2,1,2,2,1,0,0,,0,0,,2,2,4
16676,Zaza Pachulia,32-311,C,12/17/16,GSW,,POR,W,1,17,1,3,0.333,1,3,0.333,0,0,,2,4,0.5,4,3,7
16677,Georgios Papagiannis,19-227,C,2/15/17,SAC,@,GSW,L,0,8,2,3,0.667,2,3,0.667,0,0,,0,0,,1,3,4
16678,Jabari Parker,21-319,F,1/28/17,MIL,,BOS,L,1,31,2,13,0.154,2,10,0.2,0,3,0,0,0,,4,4,8
16679,Tony Parker,34-290,G,3/3/17,SAS,@,NOP,W,1,24,2,7,0.286,2,7,0.286,0,0,,0,0,,0,1,1
16680,Tony Parker,34-305,G,3/18/17,SAS,@,MEM,L,1,25,2,8,0.25,2,6,0.333,0,2,0,0,0,,0,2,2
16681,Tony Parker,34-163,G,10/27/16,SAS,@,SAC,W,1,25,0,6,0,0,5,0,0,1,0,4,4,1,0,0,0
16682,Chandler Parsons,28-059,F,12/23/16,MEM,,HOU,W,1,15,2,7,0.286,2,6,0.333,0,1,0,0,0,,0,3,3
16683,Chandler Parsons,28-126,F,2/28/17,MEM,,PHO,W,1,23,1,4,0.25,0,1,0,1,3,0.333,1,2,0.5,0,0,0
16684,Chandler Parsons,28-022,F,11/16/16,MEM,@,LAC,W,1,14,2,6,0.333,2,4,0.5,0,2,0,0,0,,0,2,2
16685,Chandler Parsons,28-122,F,2/24/17,MEM,@,IND,L,1,19,2,6,0.333,2,4,0.5,0,2,0,0,0,,0,1,1
16686,Lamar Patterson,25-173,G-F,2/1/17,ATL,@,MIA,L,0,12,2,5,0.4,2,4,0.5,0,1,0,0,1,0,1,3,4
16687,Patrick Patterson,27-235,F,11/4/16,TOR,,MIA,W,0,29,2,8,0.25,2,4,0.5,0,4,0,0,0,,1,6,7
16688,Cameron Payne,22-160,G,1/15/17,OKC,@,SAC,W,0,18,2,7,0.286,2,4,0.5,0,3,0,0,0,,1,1,2
16689,Cameron Payne,22-158,G,1/13/17,OKC,@,MIN,L,0,16,2,6,0.333,2,4,0.5,0,2,0,0,0,,0,4,4
16690,Cameron Payne,22-212,G,3/8/17,CHI,@,ORL,L,0,17,2,4,0.5,2,4,0.5,0,0,,0,0,,0,1,1
16691,Cameron Payne,22-206,G,3/2/17,CHI,,GSW,W,0,13,2,5,0.4,2,3,0.667,0,2,0,0,0,,0,0,0
16692,Elfrid Payton,22-259,G,11/7/16,ORL,@,CHI,L,1,19,2,3,0.667,2,3,0.667,0,0,,0,0,,0,0,0
16693,Elfrid Payton,22-271,G,11/19/16,ORL,,DAL,W,1,20,2,3,0.667,2,3,0.667,0,0,,0,0,,0,3,3
16694,Elfrid Payton,22-310,G,12/28/16,ORL,,CHO,L,0,27,2,10,0.2,2,8,0.25,0,2,0,0,0,,2,1,3
16695,Paul Pierce,39-049,F-G,12/1/16,LAC,@,CLE,W,0,15,1,2,0.5,1,1,1,0,1,0,2,2,1,0,4,4
16696,Marshall Plumlee,24-249,C,3/20/17,NYK,@,LAC,L,0,20,2,3,0.667,2,3,0.667,0,0,,0,4,0,0,4,4
16697,Marshall Plumlee,24-139,C,11/30/16,NYK,@,MIN,W,0,19,1,1,1,1,1,1,0,0,,2,3,0.667,1,4,5
16698,Mason Plumlee,26-312,C-F,1/11/17,POR,,CLE,W,1,24,2,6,0.333,2,6,0.333,0,0,,0,2,0,1,4,5
16699,Mason Plumlee,26-249,C-F,11/9/16,POR,@,LAC,L,1,20,1,12,0.083,1,11,0.091,0,1,0,2,2,1,2,2,4
16700,Mason Plumlee,26-278,C-F,12/8/16,POR,@,MEM,L,1,31,1,9,0.111,1,9,0.111,0,0,,2,6,0.333,1,5,6
16701,Mason Plumlee,26-242,C-F,11/2/16,POR,@,PHO,L,1,21,2,11,0.182,2,11,0.182,0,0,,0,0,,2,10,12
16702,Mason Plumlee,26-257,C-F,11/17/16,POR,@,HOU,L,1,30,2,5,0.4,2,5,0.4,0,0,,0,0,,0,8,8
16703,Mason Plumlee,27-015,C-F,3/20/17,DEN,@,HOU,L,1,24,2,5,0.4,2,5,0.4,0,0,,0,0,,2,5,7
16704,Mason Plumlee,26-287,C-F,12/17/16,POR,@,GSW,L,1,18,1,6,0.167,1,6,0.167,0,0,,2,5,0.4,0,2,2
16705,Miles Plumlee,28-156,C-F,2/4/17,CHO,@,UTA,L,0,18,2,3,0.667,2,3,0.667,0,0,,0,0,,2,6,8
16706,Miles Plumlee,28-146,C-F,1/25/17,MIL,,PHI,L,1,17,2,6,0.333,2,6,0.333,0,0,,0,0,,1,5,6
16707,Miles Plumlee,28-066,C-F,11/6/16,MIL,@,DAL,L,1,18,2,3,0.667,2,3,0.667,0,0,,0,0,,2,1,3
16708,Miles Plumlee,28-165,C-F,2/13/17,CHO,,PHI,L,0,9,2,2,1,2,2,1,0,0,,0,0,,0,3,3
16709,Miles Plumlee,28-063,C-F,11/3/16,MIL,,IND,W,1,22,1,2,0.5,1,2,0.5,0,0,,2,4,0.5,1,2,3
16710,Miles Plumlee,28-161,C-F,2/9/17,CHO,,HOU,L,0,13,2,2,1,2,2,1,0,0,,0,0,,1,3,4
16711,Miles Plumlee,28-159,C-F,2/7/17,CHO,,BRK,W,0,15,2,3,0.667,2,3,0.667,0,0,,0,0,,2,1,3
16712,Jakob Poeltl,21-109,C,2/1/17,TOR,@,BOS,L,0,9,2,2,1,2,2,1,0,0,,0,0,,3,1,4
16713,Jakob Poeltl,21-080,C,1/3/17,TOR,@,SAS,L,0,26,1,4,0.25,1,4,0.25,0,0,,2,4,0.5,6,3,9
16714,Jakob Poeltl,21-078,C,1/1/17,TOR,@,LAL,W,0,9,1,1,1,1,1,1,0,0,,2,2,1,1,1,2
16715,Jakob Poeltl,21-122,C,2/14/17,TOR,@,CHI,L,1,18,2,2,1,2,2,1,0,0,,0,0,,0,1,1
16716,Jakob Poeltl,21-149,C,3/13/17,TOR,,DAL,W,0,12,1,1,1,1,1,1,0,0,,2,2,1,0,2,2
16717,Jakob Poeltl,21-025,C,11/9/16,TOR,@,OKC,W,1,19,2,4,0.5,2,4,0.5,0,0,,0,0,,2,0,2
16718,Jakob Poeltl,21-116,C,2/8/17,TOR,@,MIN,L,0,16,2,2,1,2,2,1,0,0,,0,0,,1,3,4
16719,Jakob Poeltl,21-020,C,11/4/16,TOR,,MIA,W,0,20,1,4,0.25,1,4,0.25,0,0,,2,2,1,4,2,6
16720,Jakob Poeltl,21-090,C,1/13/17,TOR,,BRK,W,0,8,1,2,0.5,1,2,0.5,0,0,,2,2,1,1,0,1
16721,Bobby Portis,21-266,F,11/2/16,CHI,@,BOS,L,0,11,2,2,1,2,2,1,0,0,,0,0,,3,4,7
16722,Bobby Portis,21-297,F,12/3/16,CHI,@,DAL,L,0,20,1,4,0.25,0,2,0,1,2,0.5,1,2,0.5,1,4,5
16723,Bobby Portis,21-354,F,1/29/17,CHI,,PHI,W,1,14,2,6,0.333,2,6,0.333,0,0,,0,0,,1,4,5
16724,Bobby Portis,21-340,F,1/15/17,CHI,@,MEM,W,0,16,2,3,0.667,2,2,1,0,1,0,0,0,,1,4,5
16725,Bobby Portis,22-000,F,2/10/17,CHI,@,PHO,L,0,4,1,3,0.333,1,3,0.333,0,0,,2,2,1,1,0,1
16726,Dwight Powell,25-130,F-C,11/27/16,DAL,,NOP,W,0,26,2,3,0.667,2,3,0.667,0,0,,0,0,,1,2,3
16727,Dwight Powell,25-193,F-C,1/29/17,DAL,@,SAS,W,0,10,1,1,1,1,1,1,0,0,,2,2,1,0,2,2
16728,Dwight Powell,25-156,F-C,12/23/16,DAL,@,LAC,W,0,18,2,3,0.667,2,3,0.667,0,0,,0,0,,2,2,4
16729,Dwight Powell,25-190,F-C,1/26/17,DAL,@,OKC,L,0,14,2,5,0.4,2,3,0.667,0,2,0,0,0,,0,3,3
16730,Dwight Powell,25-230,F-C,3/7/17,DAL,,LAL,W,0,8,1,1,1,1,1,1,0,0,,2,2,1,1,1,2
16731,Dwight Powell,25-122,F-C,11/19/16,DAL,@,ORL,L,0,21,0,6,0,0,6,0,0,0,,4,5,0.8,2,4,6
16732,Norman Powell,23-192,G,12/3/16,TOR,,ATL,W,0,7,2,3,0.667,2,3,0.667,0,0,,0,0,,0,1,1
16733,Norman Powell,23-242,G,1/22/17,TOR,,PHO,L,0,6,1,2,0.5,0,0,,1,2,0.5,1,2,0.5,0,0,0
16734,Norman Powell,23-240,G,1/20/17,TOR,@,CHO,L,1,26,2,9,0.222,2,5,0.4,0,4,0,0,0,,0,4,4
16735,Norman Powell,23-165,G,11/6/16,TOR,,SAC,L,0,10,1,3,0.333,1,1,1,0,2,0,2,2,1,0,0,0
16736,Norman Powell,23-249,G,1/29/17,TOR,,ORL,L,0,13,1,3,0.333,1,2,0.5,0,1,0,2,2,1,0,2,2
16737,Norman Powell,23-177,G,11/18/16,TOR,@,DEN,W,0,12,1,4,0.25,1,4,0.25,0,0,,2,2,1,1,2,3
16738,Tim Quarterman,22-013,G,11/9/16,POR,@,LAC,L,0,6,2,2,1,2,2,1,0,0,,0,0,,1,0,1
16739,Chasson Randle,24-035,G,3/12/17,NYK,@,BRK,L,0,12,1,3,0.333,1,2,0.5,0,1,0,2,2,1,1,0,1
16740,Julius Randle,22-046,F,1/14/17,LAL,@,LAC,L,1,28,2,7,0.286,2,7,0.286,0,0,,0,0,,1,7,8
16741,Julius Randle,22-108,F,3/17/17,LAL,,MIL,L,1,32,1,6,0.167,1,5,0.2,0,1,0,2,4,0.5,5,7,12
16742,Zach Randolph,35-248,F,3/21/17,MEM,@,NOP,L,0,19,2,11,0.182,2,9,0.222,0,2,0,0,0,,4,6,10
16743,Willie Reed,26-303,F-C,3/15/17,MIA,,NOP,W,0,10,1,5,0.2,1,5,0.2,0,0,,2,2,1,4,0,4
16744,Willie Reed,26-239,F-C,1/10/17,MIA,@,GSW,L,0,11,1,3,0.333,1,3,0.333,0,0,,2,2,1,0,4,4
16745,Willie Reed,26-300,F-C,3/12/17,MIA,@,IND,L,0,14,2,3,0.667,2,3,0.667,0,0,,0,1,0,2,4,6
16746,Willie Reed,26-237,F-C,1/8/17,MIA,@,LAC,L,0,17,2,6,0.333,2,6,0.333,0,0,,0,0,,2,8,10
16747,Willie Reed,26-205,F-C,12/7/16,MIA,@,ATL,L,0,12,2,2,1,2,2,1,0,0,,0,0,,1,1,2
16748,Willie Reed,26-294,F-C,3/6/17,MIA,@,CLE,W,0,12,2,5,0.4,2,5,0.4,0,0,,0,0,,2,5,7
16749,Willie Reed,26-169,F-C,11/1/16,MIA,,SAC,W,0,9,2,2,1,2,2,1,0,0,,0,0,,0,2,2
16750,Willie Reed,26-230,F-C,1/1/17,MIA,,DET,L,1,18,2,3,0.667,2,3,0.667,0,0,,0,0,,0,2,2
16751,Willie Reed,26-307,F-C,3/19/17,MIA,,POR,L,0,17,2,3,0.667,2,3,0.667,0,0,,0,0,,1,1,2
16752,Willie Reed,26-285,F-C,2/25/17,MIA,,IND,W,0,10,2,3,0.667,2,3,0.667,0,0,,0,0,,0,1,1
16753,Josh Richardson,23-069,G,11/23/16,MIA,@,DET,L,1,20,2,5,0.4,2,4,0.5,0,1,0,0,0,,0,4,4
16754,Josh Richardson,23-067,G,11/21/16,MIA,@,PHI,L,1,29,1,11,0.091,0,3,0,1,8,0.125,1,2,0.5,0,2,2
16755,Austin Rivers,24-093,G,11/2/16,LAC,,OKC,L,0,20,2,8,0.25,2,6,0.333,0,2,0,0,0,,0,0,0
16756,Austin Rivers,24-215,G,3/4/17,LAC,@,CHI,W,0,19,1,5,0.2,0,1,0,1,4,0.25,1,2,0.5,1,1,2
16757,Andre Roberson,25-021,G-F,12/25/16,OKC,,MIN,W,1,27,2,5,0.4,2,4,0.5,0,1,0,0,0,,2,2,4
16758,Andre Roberson,25-001,G-F,12/5/16,OKC,@,ATL,W,1,38,1,4,0.25,1,2,0.5,0,2,0,2,2,1,0,3,3
16759,Andre Roberson,24-348,G-F,11/16/16,OKC,,HOU,W,1,32,2,11,0.182,2,6,0.333,0,5,0,0,0,,1,6,7
16760,Andre Roberson,24-346,G-F,11/14/16,OKC,@,DET,L,1,29,2,3,0.667,2,2,1,0,1,0,0,1,0,0,4,4
16761,Andre Roberson,24-358,G-F,11/26/16,OKC,,DET,W,1,30,2,4,0.5,2,3,0.667,0,1,0,0,0,,0,1,1
16762,Andre Roberson,25-056,G-F,1/29/17,OKC,@,CLE,L,1,23,2,5,0.4,2,3,0.667,0,2,0,0,0,,1,4,5
16763,Andre Roberson,25-007,G-F,12/11/16,OKC,,BOS,W,1,33,2,7,0.286,2,3,0.667,0,4,0,0,0,,1,4,5
16764,Brian Roberts,31-087,G,2/28/17,CHO,@,LAL,W,0,14,1,2,0.5,1,1,1,0,1,0,2,2,1,0,1,1
16765,Brian Roberts,31-082,G,2/23/17,CHO,@,DET,L,0,11,1,5,0.2,1,4,0.25,0,1,0,2,2,1,0,3,3
16766,Brian Roberts,30-362,G,11/29/16,CHO,,DET,L,0,4,0,0,,0,0,,0,0,,4,4,1,0,1,1
16767,Glenn Robinson,23-027,G-F,2/4/17,IND,,DET,W,0,27,2,5,0.4,2,3,0.667,0,2,0,0,0,,0,6,6
16768,Glenn Robinson,23-063,G-F,3/12/17,IND,,MIA,W,0,13,2,3,0.667,2,3,0.667,0,0,,0,0,,0,3,3
16769,Glenn Robinson,23-019,G-F,1/27/17,IND,,SAC,W,0,19,1,2,0.5,1,1,1,0,1,0,2,4,0.5,1,1,2
16770,Glenn Robinson,23-071,G-F,3/20/17,IND,,UTA,W,0,12,1,4,0.25,0,2,0,1,2,0.5,1,1,1,0,3,3
16771,Glenn Robinson,23-065,G-F,3/14/17,IND,@,NYK,L,0,11,1,2,0.5,0,0,,1,2,0.5,1,2,0.5,1,0,1
16772,Thomas Robinson,25-297,F,1/8/17,LAL,,ORL,W,0,10,2,5,0.4,2,5,0.4,0,0,,0,0,,2,4,6
16773,Thomas Robinson,25-260,F,12/2/16,LAL,@,TOR,L,0,10,2,4,0.5,2,4,0.5,0,0,,0,4,0,2,2,4
16774,Thomas Robinson,25-270,F,12/12/16,LAL,@,SAC,L,0,19,2,5,0.4,2,5,0.4,0,0,,0,0,,3,3,6
16775,Thomas Robinson,25-269,F,12/11/16,LAL,,NYK,L,0,11,2,3,0.667,2,3,0.667,0,0,,0,1,0,0,4,4
16776,Thomas Robinson,25-301,F,1/12/17,LAL,@,SAS,L,0,10,2,2,1,2,2,1,0,0,,0,0,,1,2,3
16777,Thomas Robinson,25-240,F,11/12/16,LAL,@,NOP,W,0,7,2,2,1,2,2,1,0,0,,0,0,,2,2,4
16778,Thomas Robinson,25-283,F,12/25/16,LAL,,LAC,W,0,16,2,3,0.667,2,3,0.667,0,0,,0,0,,2,7,9
16779,Sergio Rodriguez,30-220,G,1/18/17,PHI,,TOR,W,0,19,2,5,0.4,2,2,1,0,3,0,0,1,0,1,6,7
16780,Sergio Rodriguez,30-272,G,3/11/17,PHI,@,LAC,L,0,18,2,5,0.4,2,3,0.667,0,2,0,0,0,,0,2,2
16781,Sergio Rodriguez,30-244,G,2/11/17,PHI,,MIA,W,0,16,1,5,0.2,1,3,0.333,0,2,0,2,2,1,0,2,2
16782,Sergio Rodriguez,30-187,G,12/16/16,PHI,,LAL,L,1,25,2,7,0.286,2,4,0.5,0,3,0,0,0,,1,4,5
16783,Sergio Rodriguez,30-227,G,1/25/17,PHI,@,MIL,W,0,18,1,1,1,0,0,,1,1,1,1,2,0.5,0,0,0
16784,Sergio Rodriguez,30-210,G,1/8/17,PHI,@,BRK,W,0,12,2,6,0.333,2,6,0.333,0,0,,0,0,,0,0,0
16785,Sergio Rodriguez,30-222,G,1/20/17,PHI,,POR,W,0,17,2,7,0.286,2,5,0.4,0,2,0,0,0,,0,1,1
16786,Rajon Rondo,30-328,G,1/15/17,CHI,@,MEM,W,0,21,2,5,0.4,2,4,0.5,0,1,0,0,0,,1,2,3
16787,Rajon Rondo,30-248,G,10/27/16,CHI,,BOS,W,1,33,1,9,0.111,0,7,0,1,2,0.5,1,2,0.5,0,6,6
16788,Rajon Rondo,30-325,G,1/12/17,CHI,@,NYK,L,0,23,2,9,0.222,2,7,0.286,0,2,0,0,0,,0,2,2
16789,Rajon Rondo,30-337,G,1/24/17,CHI,@,ORL,W,0,15,2,3,0.667,2,2,1,0,1,0,0,0,,0,1,1
16790,Rajon Rondo,30-256,G,11/4/16,CHI,,NYK,L,1,30,2,10,0.2,2,8,0.25,0,2,0,0,0,,1,4,5
16791,Rajon Rondo,30-272,G,11/20/16,CHI,@,LAL,W,1,36,2,9,0.222,2,8,0.25,0,1,0,0,0,,1,8,9
16792,Rajon Rondo,30-292,G,12/10/16,CHI,,MIA,W,1,33,2,6,0.333,2,5,0.4,0,1,0,0,0,,1,4,5
16793,Terrence Ross,25-264,F-G,10/26/16,TOR,,DET,W,0,19,2,4,0.5,2,3,0.667,0,1,0,0,0,,0,4,4
16794,Terrence Ross,25-308,F-G,12/9/16,TOR,@,BOS,W,0,17,2,5,0.4,2,4,0.5,0,1,0,0,0,,0,2,2
16795,Terrence Ross,25-357,F-G,1/27/17,TOR,,MIL,W,0,18,1,7,0.143,0,2,0,1,5,0.2,1,2,0.5,0,6,6
16796,Terrence Ross,25-325,F-G,12/26/16,TOR,@,POR,W,0,15,2,8,0.25,2,6,0.333,0,2,0,0,0,,0,2,2
16797,Terrence Ross,25-289,F-G,11/20/16,TOR,@,SAC,L,0,15,2,5,0.4,2,3,0.667,0,2,0,0,0,,0,1,1
16798,Terrence Ross,25-319,F-G,12/20/16,TOR,,BRK,W,0,23,2,7,0.286,2,5,0.4,0,2,0,0,0,,1,3,4
16799,Terry Rozier,22-344,G,2/24/17,BOS,@,TOR,L,0,17,2,6,0.333,2,4,0.5,0,2,0,0,0,,0,2,2
16800,Terry Rozier,22-263,G,12/5/16,BOS,@,HOU,L,0,14,2,6,0.333,2,4,0.5,0,2,0,0,0,,0,3,3
16801,Terry Rozier,22-296,G,1/7/17,BOS,,NOP,W,0,13,2,3,0.667,2,3,0.667,0,0,,0,0,,1,2,3
16802,Terry Rozier,22-313,G,1/24/17,BOS,@,WAS,L,0,18,1,6,0.167,1,4,0.25,0,2,0,2,2,1,1,0,1
16803,Ricky Rubio,26-005,G,10/26/16,MIN,@,MEM,L,1,33,1,5,0.2,1,4,0.25,0,1,0,2,5,0.4,1,3,4
16804,Ricky Rubio,26-097,G,1/26/17,MIN,,IND,L,1,33,2,6,0.333,2,4,0.5,0,2,0,0,0,,1,1,2
16805,Ricky Rubio,26-046,G,12/6/16,MIN,,SAS,L,1,31,2,9,0.222,2,6,0.333,0,3,0,0,0,,0,5,5
16806,Ricky Rubio,26-077,G,1/6/17,MIN,@,WAS,L,1,35,2,3,0.667,2,3,0.667,0,0,,0,0,,1,4,5
16807,Ricky Rubio,26-027,G,11/17/16,MIN,,PHI,W,1,25,1,5,0.2,1,2,0.5,0,3,0,2,2,1,0,4,4
16808,Brandon Rush,31-247,G-F,3/11/17,MIN,@,MIL,L,1,30,2,6,0.333,2,6,0.333,0,0,,0,0,,0,3,3
16809,D'Angelo Russell,20-308,G,12/27/16,LAL,,UTA,L,1,25,2,11,0.182,2,8,0.25,0,3,0,0,0,,0,1,1
16810,D'Angelo Russell,20-349,G,2/6/17,LAL,@,NYK,W,1,20,1,4,0.25,1,3,0.333,0,1,0,2,2,1,1,1,2
16811,Domantas Sabonis,20-204,F,11/23/16,OKC,@,SAC,L,1,15,2,3,0.667,2,3,0.667,0,0,,0,0,,0,0,0
16812,Domantas Sabonis,20-222,F,12/11/16,OKC,,BOS,W,1,17,2,6,0.333,2,4,0.5,0,2,0,0,0,,1,4,5
16813,Domantas Sabonis,20-321,F,3/20/17,OKC,,GSW,L,0,12,2,4,0.5,2,3,0.667,0,1,0,0,0,,1,3,4
16814,Domantas Sabonis,20-216,F,12/5/16,OKC,@,ATL,W,1,19,2,5,0.4,2,2,1,0,3,0,0,0,,0,1,1
16815,Domantas Sabonis,20-299,F,2/26/17,OKC,,NOP,W,1,8,2,3,0.667,2,2,1,0,1,0,0,1,0,0,1,1
16816,Domantas Sabonis,20-315,F,3/14/17,OKC,@,BRK,W,0,22,2,6,0.333,2,6,0.333,0,0,,0,2,0,0,1,1
16817,Dario Saric,22-302,F,2/4/17,PHI,@,MIA,L,0,27,1,9,0.111,1,6,0.167,0,3,0,2,4,0.5,1,3,4
16818,Dario Saric,22-231,F,11/25/16,PHI,,CHI,L,0,22,1,6,0.167,1,6,0.167,0,0,,2,2,1,0,7,7
16819,Dario Saric,22-247,F,12/11/16,PHI,@,DET,W,0,20,1,3,0.333,1,3,0.333,0,0,,2,2,1,1,1,2
16820,Dario Saric,22-213,F,11/7/16,PHI,,UTA,L,1,23,2,6,0.333,2,6,0.333,0,0,,0,0,,0,2,2
16821,Tomas Satoransky,25-005,G,11/4/16,WAS,,ATL,W,0,22,2,6,0.333,2,3,0.667,0,3,0,0,0,,0,3,3
16822,Tomas Satoransky,25-018,G,11/17/16,WAS,,NYK,W,0,18,2,2,1,2,2,1,0,0,,0,0,,0,1,1
16823,Tomas Satoransky,25-097,G,2/4/17,WAS,,NOP,W,0,11,1,1,1,1,1,1,0,0,,2,2,1,0,0,0
16824,Tomas Satoransky,25-076,G,1/14/17,WAS,,PHI,W,0,21,0,3,0,0,3,0,0,0,,4,4,1,2,2,4
16825,Tomas Satoransky,25-093,G,1/31/17,WAS,,NYK,W,0,11,2,5,0.4,2,5,0.4,0,0,,0,0,,1,0,1
16826,Tomas Satoransky,25-010,G,11/9/16,WAS,,BOS,W,0,32,2,6,0.333,2,5,0.4,0,1,0,0,0,,2,2,4
16827,Tomas Satoransky,25-103,G,2/10/17,WAS,,IND,W,0,13,1,2,0.5,1,2,0.5,0,0,,2,2,1,1,0,1
16828,Dennis Schroder,23-120,G,1/13/17,ATL,,BOS,L,1,23,2,11,0.182,2,8,0.25,0,3,0,0,0,,1,2,3
16829,Luis Scola,36-184,F,10/31/16,BRK,,CHI,L,0,16,2,5,0.4,2,4,0.5,0,1,0,0,0,,4,4,8
16830,Luis Scola,36-199,F,11/15/16,BRK,@,LAL,L,0,12,2,6,0.333,2,5,0.4,0,1,0,0,1,0,2,4,6
16831,Luis Scola,36-181,F,10/28/16,BRK,,IND,W,0,15,2,6,0.333,2,4,0.5,0,2,0,0,0,,2,3,5
16832,Luis Scola,36-232,F,12/18/16,BRK,@,PHI,L,0,12,2,4,0.5,2,4,0.5,0,0,,0,0,,0,3,3
16833,Luis Scola,36-188,F,11/4/16,BRK,,CHO,L,0,16,2,3,0.667,2,2,1,0,1,0,0,0,,0,5,5
16834,Mike Scott,28-158,F,12/21/16,ATL,,MIN,L,0,18,1,4,0.25,1,3,0.333,0,1,0,2,2,1,3,1,4
16835,Mike Scott,28-188,F,1/20/17,ATL,,CHI,W,0,21,2,5,0.4,2,3,0.667,0,2,0,0,0,,0,2,2
16836,Thabo Sefolosha,32-242,G-F,12/30/16,ATL,,DET,W,1,23,2,6,0.333,2,5,0.4,0,1,0,0,1,0,0,5,5
16837,Thabo Sefolosha,32-312,G-F,3/10/17,ATL,,TOR,W,0,25,2,5,0.4,2,4,0.5,0,1,0,0,0,,1,5,6
16838,Thabo Sefolosha,32-184,G-F,11/2/16,ATL,,LAL,L,0,19,2,6,0.333,2,4,0.5,0,2,0,0,0,,1,3,4
16839,Thabo Sefolosha,32-205,G-F,11/23/16,ATL,@,IND,W,1,33,2,8,0.25,2,6,0.333,0,2,0,0,0,,0,7,7
16840,Thabo Sefolosha,32-182,G-F,10/31/16,ATL,,SAC,W,0,24,2,5,0.4,2,3,0.667,0,2,0,0,0,,1,6,7
16841,Thabo Sefolosha,32-233,G-F,12/21/16,ATL,,MIN,L,1,33,2,6,0.333,2,4,0.5,0,2,0,0,0,,0,6,6
16842,Thabo Sefolosha,32-228,G-F,12/16/16,ATL,@,TOR,W,1,28,2,6,0.333,2,6,0.333,0,0,,0,0,,2,6,8
16843,Wayne Selden,22-172,G-F,3/21/17,MEM,@,NOP,L,1,16,2,6,0.333,2,2,1,0,4,0,0,0,,0,2,2
16844,Kevin Seraphin,26-340,F,11/11/16,IND,@,PHI,L,0,8,2,3,0.667,2,3,0.667,0,0,,0,0,,0,1,1
16845,Kevin Seraphin,26-332,F,11/3/16,IND,@,MIL,L,0,5,2,3,0.667,2,3,0.667,0,0,,0,0,,1,0,1
16846,Kevin Seraphin,26-364,F,12/5/16,IND,@,GSW,L,0,15,2,5,0.4,2,5,0.4,0,0,,0,0,,2,4,6
16847,Kevin Seraphin,26-330,F,11/1/16,IND,,LAL,W,0,8,2,2,1,2,2,1,0,0,,0,0,,1,2,3
16848,Kevin Seraphin,26-345,F,11/16/16,IND,,CLE,W,0,8,2,3,0.667,2,3,0.667,0,0,,0,0,,0,0,0
16849,Kevin Seraphin,27-023,F,12/30/16,IND,,CHI,W,0,14,2,3,0.667,2,3,0.667,0,0,,0,0,,1,1,2
16850,Kevin Seraphin,27-070,F,2/15/17,IND,@,CLE,L,1,27,2,3,0.667,2,3,0.667,0,0,,0,0,,0,3,3
16851,Kevin Seraphin,27-102,F,3/19/17,IND,@,TOR,L,0,6,2,3,0.667,2,3,0.667,0,0,,0,0,,0,2,2
16852,Ramon Sessions,30-240,G,12/7/16,CHO,,DET,W,0,14,1,5,0.2,1,3,0.333,0,2,0,2,2,1,0,0,0
16853,Ramon Sessions,30-205,G,11/2/16,CHO,,PHI,W,0,22,1,3,0.333,1,2,0.5,0,1,0,2,4,0.5,1,2,3
16854,Ramon Sessions,30-247,G,12/14/16,CHO,@,WAS,L,0,12,1,3,0.333,0,2,0,1,1,1,1,2,0.5,0,1,1
16855,Ramon Sessions,30-264,G,12/31/16,CHO,,CLE,L,0,17,1,5,0.2,1,4,0.25,0,1,0,2,2,1,3,2,5
16856,Ramon Sessions,30-282,G,1/18/17,CHO,,POR,W,0,18,2,8,0.25,2,7,0.286,0,1,0,0,0,,0,4,4
16857,Ramon Sessions,30-198,G,10/26/16,CHO,@,MIL,W,0,13,2,4,0.5,2,4,0.5,0,0,,0,0,,0,0,0
16858,Ramon Sessions,30-277,G,1/13/17,CHO,@,PHI,L,0,9,1,5,0.2,1,4,0.25,0,1,0,2,2,1,0,1,1
16859,Ramon Sessions,30-212,G,11/9/16,CHO,,UTA,W,0,16,1,5,0.2,1,5,0.2,0,0,,2,2,1,1,0,1
16860,Ramon Sessions,30-291,G,1/27/17,CHO,@,NYK,L,0,14,1,3,0.333,1,3,0.333,0,0,,2,2,1,1,1,2
16861,Iman Shumpert,26-142,G,11/15/16,CLE,,TOR,W,0,27,1,5,0.2,0,0,,1,5,0.2,1,2,0.5,0,2,2
16862,Iman Shumpert,26-192,G,1/4/17,CLE,,CHI,L,0,24,1,5,0.2,1,4,0.25,0,1,0,2,3,0.667,1,2,3
16863,Iman Shumpert,26-158,G,12/1/16,CLE,,LAC,L,0,20,1,4,0.25,1,2,0.5,0,2,0,2,2,1,0,2,2
16864,Iman Shumpert,26-188,G,12/31/16,CLE,@,CHO,W,0,21,2,6,0.333,2,4,0.5,0,2,0,0,0,,1,2,3
16865,Pascal Siakam,22-362,F,1/31/17,TOR,,NOP,W,0,7,2,4,0.5,2,4,0.5,0,0,,0,0,,2,3,5
16866,Pascal Siakam,23-035,F,3/11/17,TOR,@,MIA,L,0,9,2,4,0.5,2,3,0.667,0,1,0,0,0,,1,4,5
16867,Pascal Siakam,22-267,F,10/28/16,TOR,,CLE,L,1,15,2,4,0.5,2,4,0.5,0,0,,0,0,,3,0,3
16868,Pascal Siakam,22-300,F,11/30/16,TOR,,MEM,W,1,18,2,2,1,2,2,1,0,0,,0,0,,2,0,2
16869,Pascal Siakam,22-316,F,12/16/16,TOR,,ATL,L,1,8,2,3,0.667,2,3,0.667,0,0,,0,0,,0,0,0
16870,Pascal Siakam,22-360,F,1/29/17,TOR,,ORL,L,0,11,2,3,0.667,2,3,0.667,0,0,,0,0,,0,0,0
16871,Pascal Siakam,22-265,F,10/26/16,TOR,,DET,W,1,22,2,2,1,2,2,1,0,0,,0,0,,2,7,9
16872,Pascal Siakam,22-314,F,12/14/16,TOR,@,PHI,W,1,15,2,8,0.25,2,8,0.25,0,0,,0,0,,3,2,5
16873,Pascal Siakam,22-358,F,1/27/17,TOR,,MIL,W,0,10,2,4,0.5,2,4,0.5,0,0,,0,0,,1,2,3
16874,Pascal Siakam,22-329,F,12/29/16,TOR,@,PHO,L,1,22,2,5,0.4,2,5,0.4,0,0,,0,0,,3,2,5
16875,Pascal Siakam,22-279,F,11/9/16,TOR,@,OKC,W,1,13,2,3,0.667,2,3,0.667,0,0,,0,0,,0,4,4
16876,Pascal Siakam,22-348,F,1/17/17,TOR,@,BRK,W,0,15,2,5,0.4,2,5,0.4,0,0,,0,0,,2,0,2
16877,Pascal Siakam,22-290,F,11/20/16,TOR,@,SAC,L,1,21,2,5,0.4,2,5,0.4,0,0,,0,0,,3,3,6
16878,Pascal Siakam,22-346,F,1/15/17,TOR,,NYK,W,0,13,2,3,0.667,2,3,0.667,0,0,,0,0,,2,2,4
16879,Pascal Siakam,22-272,F,11/2/16,TOR,@,WAS,W,1,18,2,4,0.5,2,4,0.5,0,0,,0,0,,0,3,3
16880,Jonathon Simmons,27-152,G-F,2/13/17,SAS,@,IND,W,0,13,2,3,0.667,2,3,0.667,0,0,,0,0,,0,3,3
16881,Jonathon Simmons,27-092,G-F,12/15/16,SAS,@,PHO,W,0,23,1,2,0.5,1,2,0.5,0,0,,2,2,1,0,2,2
16882,Jonathon Simmons,27-145,G-F,2/6/17,SAS,@,MEM,L,1,24,2,8,0.25,2,6,0.333,0,2,0,0,0,,0,2,2
16883,Jonathon Simmons,27-072,G-F,11/25/16,SAS,@,BOS,W,0,13,2,4,0.5,2,4,0.5,0,0,,0,0,,0,0,0
16884,Jonathon Simmons,27-105,G-F,12/28/16,SAS,,PHO,W,0,25,2,6,0.333,2,5,0.4,0,1,0,0,0,,1,4,5
16885,Kyle Singler,28-179,F,10/30/16,OKC,,LAL,W,0,18,2,3,0.667,2,2,1,0,1,0,0,0,,1,1,2
16886,Kyle Singler,28-177,F,10/28/16,OKC,,PHO,W,0,33,2,6,0.333,2,2,1,0,4,0,0,0,,0,3,3
16887,Kyle Singler,28-227,F,12/17/16,OKC,,PHO,W,0,14,1,2,0.5,1,1,1,0,1,0,2,2,1,0,1,1
16888,Marcus Smart,22-255,G,11/16/16,BOS,,DAL,W,1,36,1,6,0.167,1,3,0.333,0,3,0,2,4,0.5,1,6,7
16889,Marcus Smart,22-318,G,1/18/17,BOS,,NYK,L,1,32,1,6,0.167,1,4,0.25,0,2,0,2,2,1,2,1,3
16890,Marcus Smart,22-262,G,11/23/16,BOS,@,BRK,W,0,31,2,10,0.2,2,6,0.333,0,4,0,0,0,,2,6,8
16891,Ish Smith,28-136,G,11/18/16,DET,@,CLE,L,1,23,1,9,0.111,1,9,0.111,0,0,,2,2,1,1,2,3
16892,Ish Smith,28-255,G,3/17/17,DET,,TOR,L,0,20,2,9,0.222,2,8,0.25,0,1,0,0,0,,0,3,3
16893,Ish Smith,28-214,G,2/4/17,DET,@,IND,L,0,21,2,5,0.4,2,4,0.5,0,1,0,0,0,,0,3,3
16894,Ish Smith,28-159,G,12/11/16,DET,,PHI,L,0,23,2,5,0.4,2,4,0.5,0,1,0,0,0,,0,2,2
16895,Ish Smith,28-249,G,3/11/17,DET,,NYK,W,0,18,2,9,0.222,2,9,0.222,0,0,,0,0,,0,3,3
16896,Ish Smith,28-191,G,1/12/17,DET,@,GSW,L,0,16,2,7,0.286,2,5,0.4,0,2,0,0,0,,0,1,1
16897,Ish Smith,28-167,G,12/19/16,DET,@,CHI,L,0,18,2,7,0.286,2,6,0.333,0,1,0,0,0,,1,2,3
16898,Jason Smith,30-306,F-C,1/2/17,WAS,@,HOU,L,0,9,2,3,0.667,2,3,0.667,0,0,,0,0,,0,2,2
16899,Jason Smith,30-337,F-C,2/2/17,WAS,,LAL,W,0,15,2,5,0.4,2,4,0.5,0,1,0,0,0,,1,4,5
16900,Jason Smith,30-271,F-C,11/28/16,WAS,,SAC,W,0,22,2,8,0.25,2,8,0.25,0,0,,0,0,,0,4,4
16901,Jason Smith,30-268,F-C,11/25/16,WAS,@,ORL,W,0,13,2,4,0.5,2,4,0.5,0,0,,0,0,,1,1,2
16902,Jason Smith,31-011,F-C,3/13/17,WAS,@,MIN,L,0,8,2,3,0.667,2,3,0.667,0,0,,0,0,,0,2,2
16903,Jason Smith,30-262,F-C,11/19/16,WAS,,MIA,L,0,10,2,3,0.667,2,3,0.667,0,0,,0,0,,0,1,1
16904,Jason Smith,30-292,F-C,12/19/16,WAS,@,IND,L,0,5,2,2,1,2,2,1,0,0,,0,0,,1,2,3
16905,Jason Smith,30-289,F-C,12/16/16,WAS,,DET,W,0,5,2,2,1,2,2,1,0,0,,0,0,,0,0,0
16906,Jason Smith,30-307,F-C,1/3/17,WAS,@,DAL,L,0,8,2,3,0.667,2,3,0.667,0,0,,0,0,,0,1,1
16907,Jason Smith,30-271,F-C,11/28/16,WAS,,SAC,W,0,22,2,8,0.25,2,8,0.25,0,0,,0,0,,0,4,4
16908,Jason Smith,30-306,F-C,1/2/17,WAS,@,HOU,L,0,9,2,3,0.667,2,3,0.667,0,0,,0,0,,0,2,2
16909,Jason Smith,30-337,F-C,2/2/17,WAS,,LAL,W,0,15,2,5,0.4,2,4,0.5,0,1,0,0,0,,1,4,5
16910,Jason Smith,30-285,F-C,12/12/16,WAS,@,MIA,L,0,10,2,3,0.667,2,3,0.667,0,0,,0,0,,0,2,2
16911,Jason Smith,30-320,F-C,1/16/17,WAS,,POR,W,0,18,1,4,0.25,1,4,0.25,0,0,,2,2,1,1,1,2
16912,Jason Smith,30-269,F-C,11/26/16,WAS,,SAS,L,0,16,2,6,0.333,2,5,0.4,0,1,0,0,0,,2,2,4
16913,Tony Snell,24-355,G-F,10/30/16,MIL,@,DET,L,1,26,2,7,0.286,2,5,0.4,0,2,0,0,0,,1,3,4
16914,Tony Snell,25-025,G-F,12/5/16,MIL,,SAS,L,1,35,1,6,0.167,1,1,1,0,5,0,2,2,1,0,2,2
16915,Tony Snell,25-085,G-F,2/3/17,MIL,@,DEN,L,1,19,1,3,0.333,1,2,0.5,0,1,0,2,3,0.667,0,0,0
16916,Marreese Speights,29-106,C-F,11/18/16,LAC,@,SAC,W,0,11,2,5,0.4,2,3,0.667,0,2,0,0,0,,0,3,3
16917,Marreese Speights,29-087,C-F,10/30/16,LAC,,UTA,W,0,17,1,8,0.125,0,2,0,1,6,0.167,1,2,0.5,0,4,4
16918,Marreese Speights,29-099,C-F,11/11/16,LAC,@,OKC,W,0,14,2,7,0.286,2,5,0.4,0,2,0,0,0,,0,2,2
16919,Marreese Speights,29-228,C-F,3/20/17,LAC,,NYK,W,0,16,1,3,0.333,1,1,1,0,2,0,2,2,1,1,3,4
16920,Marreese Speights,29-212,C-F,3/4/17,LAC,@,CHI,W,0,17,2,8,0.25,2,5,0.4,0,3,0,0,0,,3,3,6
16921,Nik Stauskas,23-059,G,12/5/16,PHI,,DEN,L,1,35,1,7,0.143,0,2,0,1,5,0.2,1,2,0.5,1,2,3
16922,Nik Stauskas,23-080,G,12/26/16,PHI,@,SAC,L,0,19,2,4,0.5,2,3,0.667,0,1,0,0,0,,0,1,1
16923,Nik Stauskas,23-122,G,2/6/17,PHI,@,DET,L,1,28,2,7,0.286,2,2,1,0,5,0,0,0,,0,3,3
16924,Nik Stauskas,23-091,G,1/6/17,PHI,@,BOS,L,1,25,1,6,0.167,1,4,0.25,0,2,0,2,2,1,1,2,3
16925,Lance Stephenson,26-184,G-F,3/8/17,MIN,,LAC,W,0,16,2,4,0.5,2,3,0.667,0,1,0,0,0,,0,3,3
16926,Lance Stephenson,26-162,G-F,2/14/17,MIN,,CLE,L,0,3,2,2,1,2,2,1,0,0,,0,0,,0,0,0
16927,Diamond Stone,19-353,C,1/28/17,LAC,@,GSW,L,0,5,1,2,0.5,1,2,0.5,0,0,,2,2,1,0,1,1
16928,Jared Sullinger,24-336,F,2/3/17,TOR,@,ORL,L,0,9,2,6,0.333,2,4,0.5,0,2,0,0,0,,3,1,4
16929,Jeff Teague,28-140,G,10/28/16,IND,@,BRK,L,1,29,2,13,0.154,2,9,0.222,0,4,0,0,0,,1,3,4
16930,Mirza Teletovic,31-085,F,12/12/16,MIL,@,TOR,L,0,19,2,7,0.286,2,2,1,0,5,0,0,0,,0,7,7
16931,Garrett Temple,30-184,G,11/8/16,SAC,,NOP,W,0,19,1,4,0.25,0,0,,1,4,0.25,1,1,1,0,2,2
16932,Garrett Temple,30-194,G,11/18/16,SAC,,LAC,L,0,23,1,4,0.25,0,1,0,1,3,0.333,1,2,0.5,0,2,2
16933,Jason Terry,39-067,G,11/21/16,MIL,,ORL,W,0,20,2,4,0.5,2,2,1,0,2,0,0,0,,0,2,2
16934,Jason Terry,39-174,G,3/8/17,MIL,,NYK,W,0,30,2,7,0.286,2,3,0.667,0,4,0,0,0,,0,7,7
16935,Jason Terry,39-172,G,3/6/17,MIL,@,PHI,W,0,27,2,7,0.286,2,3,0.667,0,4,0,0,0,,1,1,2
16936,Jason Terry,39-063,G,11/17/16,MIL,@,MIA,L,0,16,1,1,1,0,0,,1,1,1,1,1,1,1,0,1
16937,Jason Terry,39-181,G,3/15/17,MIL,@,LAC,W,0,24,2,5,0.4,2,2,1,0,3,0,0,0,,0,3,3
16938,Jason Terry,39-107,G,12/31/16,MIL,@,CHI,W,0,22,1,3,0.333,0,1,0,1,2,0.5,1,2,0.5,0,0,0
16939,Lance Thomas,28-237,F,12/17/16,NYK,@,DEN,L,0,11,1,2,0.5,1,2,0.5,0,0,,2,2,1,0,0,0
16940,Lance Thomas,28-263,F,1/12/17,NYK,,CHI,W,1,29,2,9,0.222,2,8,0.25,0,1,0,0,0,,2,0,2
16941,Hollis Thompson,25-264,G-F,12/23/16,PHI,@,PHO,L,0,22,2,3,0.667,2,2,1,0,1,0,0,0,,0,2,2
16942,Hollis Thompson,25-213,G-F,11/2/16,PHI,@,CHO,L,0,20,2,9,0.222,2,6,0.333,0,3,0,0,0,,1,4,5
16943,Hollis Thompson,25-206,G-F,10/26/16,PHI,,OKC,L,0,13,2,5,0.4,2,3,0.667,0,2,0,0,2,0,1,1,2
16944,Hollis Thompson,25-223,G-F,11/12/16,PHI,@,ATL,L,0,22,1,5,0.2,1,2,0.5,0,3,0,2,2,1,1,2,3
16945,Tristan Thompson,26-001,F-C,3/14/17,CLE,,DET,W,1,26,2,4,0.5,2,4,0.5,0,0,,0,0,,2,7,9
16946,Tristan Thompson,25-349,F-C,2/25/17,CLE,,CHI,L,1,32,2,5,0.4,2,5,0.4,0,0,,0,0,,3,6,9
16947,Tristan Thompson,25-245,F-C,11/13/16,CLE,,CHO,W,1,30,1,2,0.5,1,2,0.5,0,0,,2,6,0.333,3,9,12
16948,Tristan Thompson,25-361,F-C,3/9/17,CLE,@,DET,L,1,26,2,5,0.4,2,5,0.4,0,0,,0,2,0,3,1,4
16949,Tristan Thompson,26-006,F-C,3/19/17,CLE,@,LAL,W,1,26,2,2,1,2,2,1,0,0,,0,0,,6,4,10
16950,Tristan Thompson,25-233,F-C,11/1/16,CLE,,HOU,W,1,27,2,2,1,2,2,1,0,0,,0,0,,6,4,10
16951,Tristan Thompson,25-355,F-C,3/3/17,CLE,@,ATL,W,1,31,2,3,0.667,2,3,0.667,0,0,,0,0,,2,3,5
16952,Marcus Thornton,29-152,G,11/4/16,WAS,,ATL,W,0,17,2,5,0.4,2,4,0.5,0,1,0,0,0,,1,0,1
16953,Anthony Tolliver,31-238,F-C,1/25/17,SAC,@,CLE,W,0,20,2,5,0.4,2,3,0.667,0,2,0,0,0,,0,1,1
16954,Anthony Tolliver,31-273,F-C,3/1/17,SAC,,BRK,L,0,27,0,7,0,0,1,0,0,6,0,4,6,0.667,0,6,6
16955,Anthony Tolliver,31-258,F-C,2/14/17,SAC,@,LAL,W,0,19,2,4,0.5,2,2,1,0,2,0,0,0,,0,2,2
16956,P.J. Tucker,31-204,F,11/25/16,PHO,,MIN,L,0,28,1,4,0.25,0,2,0,1,2,0.5,1,2,0.5,1,4,5
16957,P.J. Tucker,31-218,F,12/9/16,PHO,@,LAL,W,1,25,2,4,0.5,2,4,0.5,0,0,,0,0,,1,4,5
16958,P.J. Tucker,31-183,F,11/4/16,PHO,@,NOP,W,0,33,2,6,0.333,2,3,0.667,0,3,0,0,0,,1,7,8
16959,P.J. Tucker,31-300,F,3/1/17,TOR,,WAS,L,0,21,2,3,0.667,2,2,1,0,1,0,0,0,,2,3,5
16960,P.J. Tucker,31-245,F,1/5/17,PHO,@,DAL,W,0,34,2,6,0.333,2,5,0.4,0,1,0,0,0,,5,4,9
16961,P.J. Tucker,31-228,F,12/19/16,PHO,@,MIN,L,1,36,2,8,0.25,2,6,0.333,0,2,0,0,0,,1,5,6
16962,Evan Turner,28-085,G,1/20/17,POR,@,PHI,L,1,28,2,10,0.2,2,9,0.222,0,1,0,0,0,,1,0,1
16963,Evan Turner,28-000,G,10/27/16,POR,,LAC,L,0,23,2,8,0.25,2,7,0.286,0,1,0,0,0,,1,5,6
16964,Evan Turner,28-096,G,1/31/17,POR,,CHO,W,1,22,2,7,0.286,2,4,0.5,0,3,0,0,0,,0,1,1
16965,Evan Turner,28-073,G,1/8/17,POR,,DET,L,0,25,2,5,0.4,2,4,0.5,0,1,0,0,0,,0,3,3
16966,Myles Turner,20-347,F-C,3/6/17,IND,@,CHO,L,1,32,2,6,0.333,2,5,0.4,0,1,0,0,0,,1,6,7
16967,Beno Udrih,34-143,G,11/25/16,DET,,LAC,W,0,14,2,6,0.333,2,5,0.4,0,1,0,0,0,,0,2,2
16968,Beno Udrih,34-191,G,1/12/17,DET,@,GSW,L,0,11,1,5,0.2,1,3,0.333,0,2,0,2,2,1,0,0,0
16969,Tyler Ulis,20-325,G,11/25/16,PHO,,MIN,L,0,14,1,5,0.2,1,4,0.25,0,1,0,2,2,1,0,1,1
16970,Tyler Ulis,20-323,G,11/23/16,PHO,@,ORL,W,0,16,2,5,0.4,2,5,0.4,0,0,,0,0,,0,0,0
16971,Tyler Ulis,20-321,G,11/21/16,PHO,@,WAS,L,0,10,2,3,0.667,2,3,0.667,0,0,,0,0,,0,0,0
16972,Tyler Ulis,21-017,G,1/22/17,PHO,@,TOR,W,0,6,2,4,0.5,2,4,0.5,0,0,,0,0,,0,0,0
16973,Tyler Ulis,20-300,G,10/31/16,PHO,@,LAC,L,0,18,1,5,0.2,1,4,0.25,0,1,0,2,2,1,1,1,2
16974,Tyler Ulis,20-333,G,12/3/16,PHO,@,GSW,L,0,12,1,3,0.333,0,2,0,1,1,1,1,2,0.5,1,0,1
16975,Jonas Valanciunas,24-213,C,12/5/16,TOR,,CLE,L,1,25,1,8,0.125,1,8,0.125,0,0,,2,2,1,3,7,10
16976,Denzel Valentine,23-125,G,3/21/17,CHI,@,TOR,L,0,35,1,7,0.143,0,2,0,1,5,0.2,1,1,1,0,5,5
16977,Denzel Valentine,23-086,G,2/10/17,CHI,@,PHO,L,0,15,2,4,0.5,2,2,1,0,2,0,0,2,0,0,2,2
16978,Denzel Valentine,22-355,G,11/5/16,CHI,@,IND,L,0,8,1,3,0.333,0,1,0,1,2,0.5,1,2,0.5,1,1,2
16979,Fred VanVleet,22-297,G,12/18/16,TOR,@,ORL,W,0,23,2,5,0.4,2,4,0.5,0,1,0,0,0,,0,2,2
16980,Rashad Vaughn,20-164,G,1/27/17,MIL,@,TOR,L,0,30,1,8,0.125,0,2,0,1,6,0.167,1,2,0.5,1,5,6
16981,Noah Vonleh,21-160,F,1/31/17,POR,,CHO,W,1,20,2,9,0.222,2,9,0.222,0,0,,0,0,,4,6,10
16982,Noah Vonleh,21-158,F,1/29/17,POR,,GSW,L,1,18,2,4,0.5,2,4,0.5,0,0,,0,0,,3,2,5
16983,Noah Vonleh,21-199,F,3/11/17,POR,,WAS,L,1,18,2,3,0.667,2,3,0.667,0,0,,0,0,,2,6,8
16984,Noah Vonleh,21-197,F,3/9/17,POR,,PHI,W,1,12,2,2,1,2,2,1,0,0,,0,0,,1,3,4
16985,Noah Vonleh,21-147,F,1/18/17,POR,@,CHO,L,0,18,2,10,0.2,2,10,0.2,0,0,,0,0,,6,1,7
16986,Noah Vonleh,21-165,F,2/5/17,POR,@,OKC,L,1,15,2,4,0.5,2,4,0.5,0,0,,0,0,,4,0,4
16987,Noah Vonleh,21-126,F,12/28/16,POR,,SAC,W,0,17,1,3,0.333,1,3,0.333,0,0,,2,2,1,2,1,3
16988,Noah Vonleh,21-163,F,2/3/17,POR,,DAL,L,1,7,2,3,0.667,2,3,0.667,0,0,,0,2,0,2,1,3
16989,Nikola Vucevic,26-020,C,11/13/16,ORL,@,OKC,W,1,19,2,10,0.2,2,10,0.2,0,0,,0,0,,4,3,7
16990,Nikola Vucevic,26-018,C,11/11/16,ORL,,UTA,L,1,26,2,12,0.167,2,11,0.182,0,1,0,0,0,,2,6,8
16991,Sasha Vujacic,32-251,G,11/14/16,NYK,,DAL,W,0,12,1,2,0.5,1,2,0.5,0,0,,2,2,1,0,2,2
16992,Dwyane Wade,35-003,G,1/20/17,CHI,@,ATL,L,1,20,2,10,0.2,2,8,0.25,0,2,0,0,0,,1,2,3
16993,Dwyane Wade,34-293,G,11/5/16,CHI,@,IND,L,1,22,1,9,0.111,1,7,0.143,0,2,0,2,2,1,0,1,1
16994,Dion Waiters,25-025,G,1/4/17,MIA,@,SAC,W,0,10,2,4,0.5,2,3,0.667,0,1,0,0,0,,0,1,1
16995,Dion Waiters,24-338,G,11/12/16,MIA,,UTA,L,1,19,1,4,0.25,1,4,0.25,0,0,,2,4,0.5,0,1,1
16996,Dion Waiters,24-330,G,11/4/16,MIA,@,TOR,L,1,24,2,8,0.25,2,6,0.333,0,2,0,0,0,,1,1,2
16997,Taurean Waller-Prince,22-221,F,10/29/16,ATL,@,PHI,W,0,6,1,2,0.5,1,1,1,0,1,0,2,2,1,0,0,0
16998,Taurean Waller-Prince,22-266,F,12/13/16,ATL,,ORL,L,0,2,2,2,1,2,2,1,0,0,,0,0,,0,1,1
16999,Taurean Waller-Prince,22-243,F,11/20/16,ATL,@,NYK,L,0,18,2,8,0.25,2,6,0.333,0,2,0,0,0,,3,2,5
17000,Taurean Waller-Prince,22-260,F,12/7/16,ATL,,MIA,W,0,12,1,5,0.2,1,4,0.25,0,1,0,2,2,1,0,2,2
17001,T.J. Warren,23-139,F,1/22/17,PHO,@,TOR,W,1,21,2,6,0.333,2,5,0.4,0,1,0,0,0,,0,3,3
17002,T.J. Warren,23-138,F,1/21/17,PHO,@,NYK,W,1,29,2,6,0.333,2,6,0.333,0,0,,0,0,,2,1,3
17003,T.J. Warren,23-115,F,12/29/16,PHO,,TOR,W,0,27,2,11,0.182,2,10,0.2,0,1,0,0,2,0,1,2,3
17004,T.J. Warren,23-156,F,2/8/17,PHO,@,MEM,L,1,18,2,6,0.333,2,6,0.333,0,0,,0,1,0,0,4,4
17005,C.J. Watson,32-249,G,12/22/16,ORL,@,NYK,L,0,17,2,5,0.4,2,2,1,0,3,0,0,0,,0,1,1
17006,C.J. Watson,32-255,G,12/28/16,ORL,,CHO,L,0,22,1,6,0.167,0,2,0,1,4,0.25,1,2,0.5,1,0,1
17007,C.J. Watson,32-334,G,3/17/17,ORL,@,PHO,W,0,15,2,3,0.667,2,2,1,0,1,0,0,0,,0,0,0
17008,Briante Weber,24-043,PG,2/10/17,GSW,@,MEM,W,0,2,1,1,1,1,1,1,0,0,,2,3,0.667,0,0,0
17009,Briante Weber,24-074,PG,3/13/17,CHO,,CHI,L,0,5,2,2,1,2,2,1,0,0,,0,0,,0,1,1
17010,Briante Weber,24-058,PG,2/25/17,GSW,,BRK,W,0,2,2,3,0.667,2,2,1,0,1,0,0,0,,0,1,1
17011,David West,36-121,F,12/28/16,GSW,,TOR,W,0,10,2,2,1,2,2,1,0,0,,0,0,,0,2,2
17012,David West,36-201,F,3/18/17,GSW,,MIL,W,0,12,2,3,0.667,2,3,0.667,0,0,,0,0,,0,1,1
17013,David West,36-101,F,12/8/16,GSW,@,UTA,W,0,12,2,3,0.667,2,3,0.667,0,0,,0,0,,0,2,2
17014,David West,36-067,F,11/4/16,GSW,@,LAL,L,0,6,2,4,0.5,2,4,0.5,0,0,,0,0,,1,0,1
17015,David West,36-098,F,12/5/16,GSW,,IND,W,0,9,1,3,0.333,1,3,0.333,0,0,,2,2,1,1,4,5
17016,David West,36-113,F,12/20/16,GSW,,UTA,W,0,11,2,3,0.667,2,3,0.667,0,0,,0,0,,1,2,3
17017,David West,36-182,F,2/27/17,GSW,@,PHI,W,0,13,1,3,0.333,1,3,0.333,0,0,,2,2,1,0,1,1
17018,David West,36-064,F,11/1/16,GSW,@,POR,W,0,11,2,3,0.667,2,3,0.667,0,0,,0,0,,0,4,4
17019,David West,36-081,F,11/18/16,GSW,@,BOS,W,0,13,2,5,0.4,2,5,0.4,0,0,,0,0,,0,2,2
17020,David West,36-110,F,12/17/16,GSW,,POR,W,0,7,2,3,0.667,2,3,0.667,0,0,,0,0,,1,2,3
17021,David West,36-128,F,1/4/17,GSW,,POR,W,0,14,2,2,1,2,2,1,0,0,,0,0,,1,3,4
17022,David West,36-062,F,10/30/16,GSW,@,PHO,W,0,8,2,6,0.333,2,5,0.4,0,1,0,0,0,,1,2,3
17023,David West,36-178,F,2/23/17,GSW,,LAC,W,0,11,2,4,0.5,2,4,0.5,0,0,,0,0,,1,3,4
17024,Okaro White,24-220,F,3/21/17,MIA,,PHO,W,0,9,1,3,0.333,1,3,0.333,0,0,,2,2,1,4,1,5
17025,Okaro White,24-195,F,2/24/17,MIA,@,ATL,W,0,18,1,3,0.333,0,2,0,1,1,1,1,2,0.5,2,6,8
17026,Okaro White,24-200,F,3/1/17,MIA,,PHI,W,0,25,2,6,0.333,2,6,0.333,0,0,,0,0,,1,2,3
17027,Isaiah Whitehead,21-310,G,1/12/17,BRK,,NOP,L,1,16,2,7,0.286,2,5,0.4,0,2,0,0,0,,0,2,2
17028,Isaiah Whitehead,21-252,G,11/15/16,BRK,@,LAL,L,0,9,2,4,0.5,2,3,0.667,0,1,0,0,0,,0,0,0
17029,Isaiah Whitehead,21-283,G,12/16/16,BRK,@,ORL,L,1,24,2,3,0.667,2,3,0.667,0,0,,0,0,,0,3,3
17030,Isaiah Whitehead,21-262,G,11/25/16,BRK,@,IND,L,1,29,1,5,0.2,1,3,0.333,0,2,0,2,2,1,0,2,2
17031,Isaiah Whitehead,21-260,G,11/23/16,BRK,,BOS,L,1,24,2,8,0.25,2,8,0.25,0,0,,0,0,,0,4,4
17032,Isaiah Whitehead,21-330,G,2/1/17,BRK,,NYK,L,1,23,2,9,0.222,2,9,0.222,0,0,,0,0,,1,3,4
17033,Isaiah Whitehead,21-255,G,11/18/16,BRK,@,OKC,L,0,17,2,6,0.333,2,4,0.5,0,2,0,0,0,,0,1,1
17034,Isaiah Whitehead,21-295,G,12/28/16,BRK,@,CHI,L,1,19,2,4,0.5,2,3,0.667,0,1,0,0,0,,0,2,2
17035,Hassan Whiteside,27-165,C,11/25/16,MIA,@,MEM,W,1,27,1,6,0.167,1,6,0.167,0,0,,2,5,0.4,4,8,12
17036,C.J. Wilcox,26-002,G,1/1/17,ORL,@,IND,L,0,4,2,3,0.667,2,3,0.667,0,0,,0,0,,0,0,0
17037,Deron Williams,32-248,G,3/1/17,CLE,@,BOS,L,0,24,2,8,0.25,2,6,0.333,0,2,0,0,0,,0,2,2
17038,Deron Williams,32-152,G,11/25/16,DAL,@,CLE,L,1,15,2,6,0.333,2,5,0.4,0,1,0,0,0,,0,2,2
17039,Deron Williams,32-256,G,3/9/17,CLE,@,DET,L,0,17,1,1,1,0,0,,1,1,1,1,1,1,0,0,0
17040,Marvin Williams,30-269,F,3/15/17,CHO,@,IND,L,1,34,2,8,0.25,2,5,0.4,0,3,0,0,0,,0,6,6
17041,Marvin Williams,30-178,F,12/14/16,CHO,@,WAS,L,1,26,2,6,0.333,2,3,0.667,0,3,0,0,0,,1,3,4
17042,Marvin Williams,30-239,F,2/13/17,CHO,,PHI,L,1,33,1,7,0.143,1,2,0.5,0,5,0,2,2,1,0,0,0
17043,Jeff Withey,27-001,C,3/8/17,UTA,@,HOU,W,0,12,2,4,0.5,2,4,0.5,0,0,,0,0,,2,3,5
17044,Jeff Withey,26-257,C,11/19/16,UTA,@,HOU,L,0,10,1,3,0.333,1,3,0.333,0,0,,2,2,1,2,4,6
17045,Jeff Withey,26-273,C,12/5/16,UTA,@,LAL,W,0,5,2,2,1,2,2,1,0,0,,0,0,,0,1,1
17046,Jeff Withey,26-239,C,11/1/16,UTA,@,SAS,W,0,11,0,2,0,0,2,0,0,0,,4,4,1,0,2,2
17047,Jeff Withey,26-250,C,11/12/16,UTA,@,MIA,W,0,15,2,2,1,2,2,1,0,0,,0,0,,2,0,2
17048,Jeff Withey,26-267,C,11/29/16,UTA,,HOU,W,0,15,2,3,0.667,2,3,0.667,0,0,,0,0,,0,4,4
17049,Jeff Withey,26-266,C,11/28/16,UTA,@,MIN,W,0,11,2,3,0.667,2,3,0.667,0,0,,0,0,,1,2,3
17050,Jeff Withey,26-282,C,12/14/16,UTA,,OKC,W,0,4,2,2,1,2,2,1,0,0,,0,0,,1,0,1
17051,Jeff Withey,26-245,C,11/7/16,UTA,@,PHI,W,0,6,2,2,1,2,2,1,0,0,,0,0,,2,0,2
17052,Jeff Withey,27-006,C,3/13/17,UTA,,LAC,W,0,8,2,3,0.667,2,3,0.667,0,0,,0,0,,2,1,3
17053,Christian Wood,21-165,F,3/11/17,CHO,,NOP,L,0,13,1,3,0.333,1,3,0.333,0,0,,2,2,1,4,1,5
17054,Christian Wood,21-152,F,2/26/17,CHO,@,LAC,L,0,23,2,4,0.5,2,3,0.667,0,1,0,0,0,,3,3,6
17055,Christian Wood,21-127,F,2/1/17,CHO,@,GSW,L,0,7,1,1,1,1,1,1,0,0,,2,2,1,0,1,1
17056,Metta World Peace,37-022,F,12/5/16,LAL,,UTA,L,1,12,2,5,0.4,2,5,0.4,0,0,,0,0,,1,0,1
17057,Brandan Wright,29-161,F-C,3/15/17,MEM,@,CHI,W,0,11,2,3,0.667,2,3,0.667,0,0,,0,1,0,2,2,4
17058,Brandan Wright,29-159,F-C,3/13/17,MEM,,MIL,W,0,11,2,2,1,2,2,1,0,0,,0,0,,1,0,1
17059,Brandan Wright,29-122,F-C,2/4/17,MEM,@,MIN,W,0,20,2,6,0.333,2,6,0.333,0,0,,0,0,,4,2,6
17060,Delon Wright,24-327,G,3/19/17,TOR,,IND,W,0,24,2,6,0.333,2,4,0.5,0,2,0,0,0,,2,1,3
17061,Nick Young,31-209,G-F,12/27/16,LAL,,UTA,L,1,23,2,8,0.25,2,4,0.5,0,4,0,0,0,,0,2,2
17062,Thaddeus Young,28-162,F,11/30/16,IND,@,POR,L,1,24,2,6,0.333,2,6,0.333,0,0,,0,0,,0,5,5
17063,Thaddeus Young,28-266,F,3/14/17,IND,@,NYK,L,1,37,2,4,0.5,2,3,0.667,0,1,0,0,0,,2,5,7
17064,Thaddeus Young,28-205,F,1/12/17,IND,@,DEN,L,1,28,2,5,0.4,2,3,0.667,0,2,0,0,0,,1,3,4
17065,Thaddeus Young,28-258,F,3/6/17,IND,@,CHO,L,1,21,2,5,0.4,2,5,0.4,0,0,,0,0,,0,2,2
17066,Thaddeus Young,28-257,F,3/5/17,IND,@,ATL,W,1,24,2,5,0.4,2,5,0.4,0,0,,0,2,0,1,4,5
17067,Thaddeus Young,28-253,F,3/1/17,IND,@,SAS,L,1,11,2,6,0.333,2,6,0.333,0,0,,0,0,,2,0,2
17068,Tyler Zeller,27-062,F-C,3/20/17,BOS,,WAS,W,0,6,2,4,0.5,2,4,0.5,0,0,,0,0,,2,1,3
17069,Tyler Zeller,26-304,F-C,11/16/16,BOS,,DAL,W,0,8,2,6,0.333,2,6,0.333,0,0,,0,0,,2,2,4
17070,Tyler Zeller,27-030,F-C,2/16/17,BOS,@,CHI,L,0,9,2,2,1,2,2,1,0,0,,0,0,,0,0,0
17071,Tyler Zeller,27-015,F-C,2/1/17,BOS,,TOR,W,0,16,2,3,0.667,2,3,0.667,0,0,,0,0,,2,3,5
17072,Tyler Zeller,27-011,F-C,1/28/17,BOS,@,MIL,W,0,15,2,6,0.333,2,6,0.333,0,0,,0,2,0,3,2,5
17073,Paul Zipser,23-028,G-F,3/18/17,CHI,,UTA,W,1,29,1,1,1,0,0,,1,1,1,1,2,0.5,0,4,4
17074,Paul Zipser,23-016,G-F,3/6/17,CHI,@,DET,L,1,31,2,4,0.5,2,4,0.5,0,0,,0,0,,1,3,4
17075,Ivica Zubac,19-308,C,1/20/17,LAL,,IND,W,0,6,2,2,1,2,2,1,0,0,,0,0,,0,1,1
17076,Ivica Zubac,19-347,C,2/28/17,LAL,,CHO,L,0,8,2,6,0.333,2,5,0.4,0,1,0,0,0,,0,2,2
17077,Ivica Zubac,19-303,C,1/15/17,LAL,,DET,L,0,9,2,4,0.5,2,4,0.5,0,0,,0,0,,1,4,5
17078,Ivica Zubac,19-321,C,2/2/17,LAL,@,WAS,L,0,11,2,4,0.5,2,4,0.5,0,0,,0,0,,1,2,3
17079,Alex Abrines,23-135,G-F,12/14/16,OKC,@,UTA,L,0,3,1,2,0.5,0,0,,1,2,0.5,0,0,,0,0,0
17080,Alex Abrines,23-086,G-F,10/26/16,OKC,@,PHI,W,0,13,1,2,0.5,0,1,0,1,1,1,0,0,,0,1,1
17081,Alex Abrines,23-102,G-F,11/11/16,OKC,,LAC,L,0,13,1,2,0.5,1,1,1,0,1,0,1,2,0.5,0,1,1
17082,Alex Abrines,23-100,G-F,11/9/16,OKC,,TOR,L,0,5,1,1,1,0,0,,1,1,1,0,0,,0,0,0
17083,Alex Abrines,23-144,G-F,12/23/16,OKC,@,BOS,W,0,6,1,2,0.5,0,1,0,1,1,1,0,0,,2,0,2
17084,Alex Abrines,23-157,G-F,1/5/17,OKC,@,HOU,L,0,17,1,2,0.5,1,1,1,0,1,0,1,2,0.5,1,1,2
17085,Alex Abrines,23-175,G-F,1/23/17,OKC,@,UTA,W,0,13,1,4,0.25,0,0,,1,4,0.25,0,0,,0,1,1
17086,Alex Abrines,23-220,G-F,3/9/17,OKC,,SAS,W,0,12,1,6,0.167,0,1,0,1,5,0.2,0,0,,1,2,3
17087,Quincy Acy,26-022,F,10/28/16,DAL,,HOU,L,0,8,1,5,0.2,0,2,0,1,3,0.333,0,0,,0,1,1
17088,Arron Afflalo,31-019,G,11/3/16,SAC,@,ORL,L,1,18,1,6,0.167,1,4,0.25,0,2,0,1,1,1,0,0,0
17089,Arron Afflalo,31-058,G,12/12/16,SAC,,LAL,W,0,13,1,5,0.2,0,2,0,1,3,0.333,0,0,,0,0,0
17090,Arron Afflalo,31-050,G,12/4/16,SAC,@,NYK,L,1,17,1,4,0.25,0,3,0,1,1,1,0,0,,0,2,2
17091,Arron Afflalo,31-044,G,11/28/16,SAC,@,WAS,L,1,21,1,6,0.167,1,3,0.333,0,3,0,1,1,1,0,1,1
17092,Cole Aldrich,28-017,C,11/17/16,MIN,,PHI,W,0,14,1,1,1,1,1,1,0,0,,1,1,1,1,2,3
17093,Cole Aldrich,28-137,C,3/17/17,MIN,@,MIA,L,0,10,1,1,1,1,1,1,0,0,,1,1,1,0,2,2
17094,Lavoy Allen,27-365,F-C,2/3/17,IND,@,BRK,W,0,21,1,2,0.5,1,2,0.5,0,0,,1,2,0.5,1,2,3
17095,Al-Farouq Aminu,26-179,F,3/19/17,POR,@,MIA,W,0,23,1,1,1,0,0,,1,1,1,0,0,,1,4,5
17096,Al-Farouq Aminu,26-075,F,12/5/16,POR,@,CHI,W,0,17,1,3,0.333,1,3,0.333,0,0,,1,4,0.25,0,3,3
17097,Alan Anderson,34-046,G-F,12/1/16,LAC,@,CLE,W,0,5,1,3,0.333,0,1,0,1,2,0.5,0,0,,0,1,1
17098,Alan Anderson,34-024,G-F,11/9/16,LAC,,POR,W,0,9,1,3,0.333,0,1,0,1,2,0.5,0,0,,1,0,1
17099,Alan Anderson,34-133,G-F,2/26/17,LAC,,CHO,W,0,5,1,2,0.5,1,1,1,0,1,0,1,1,1,0,1,1
17100,Alan Anderson,34-090,G-F,1/14/17,LAC,,LAL,W,0,7,1,3,0.333,0,0,,1,3,0.333,0,0,,0,0,0
17101,Alan Anderson,34-133,G-F,2/26/17,LAC,,CHO,W,0,5,1,2,0.5,1,1,1,0,1,0,1,1,1,0,1,1
17102,Justin Anderson,23-040,G,12/29/16,DAL,@,LAL,W,0,10,1,3,0.333,0,2,0,1,1,1,0,0,,0,2,2
17103,Justin Anderson,23-079,G,2/6/17,DAL,@,DEN,L,0,12,1,8,0.125,0,4,0,1,4,0.25,0,0,,1,1,2
17104,Justin Anderson,23-049,G,1/7/17,DAL,,ATL,L,0,3,1,1,1,0,0,,1,1,1,0,0,,0,0,0
17105,Kyle Anderson,23-035,F-G,10/25/16,SAS,@,GSW,W,1,22,1,1,1,0,0,,1,1,1,0,0,,2,2,4
17106,Kyle Anderson,23-067,F-G,11/26/16,SAS,@,WAS,W,0,9,1,1,1,1,1,1,0,0,,1,2,0.5,0,1,1
17107,Kyle Anderson,23-180,F-G,3/19/17,SAS,,SAC,W,0,22,1,3,0.333,0,2,0,1,1,1,0,0,,0,4,4
17108,Kyle Anderson,23-116,F-G,1/14/17,SAS,@,PHO,L,0,9,1,1,1,0,0,,1,1,1,0,0,,0,0,0
17109,Ryan Anderson,28-302,F,3/4/17,HOU,,MEM,W,1,24,1,10,0.1,0,3,0,1,7,0.143,0,0,,0,1,1
17110,Trevor Ariza,31-205,F,1/21/17,HOU,@,MEM,W,1,36,1,8,0.125,0,2,0,1,6,0.167,0,0,,1,9,10
17111,Trevor Ariza,31-217,F,2/2/17,HOU,,ATL,L,1,37,1,12,0.083,0,2,0,1,10,0.1,0,0,,0,5,5
17112,Darrell Arthur,28-253,F,12/3/16,DEN,@,UTA,L,0,12,1,4,0.25,0,3,0,1,1,1,0,0,,0,1,1
17113,Darrell Arthur,28-309,F,1/28/17,DEN,@,PHO,W,0,15,1,4,0.25,0,2,0,1,2,0.5,0,0,,2,1,3
17114,Darrell Arthur,28-323,F,2/11/17,DEN,@,CLE,L,1,20,1,5,0.2,0,0,,1,5,0.2,0,0,,2,1,3
17115,Darrell Arthur,28-350,F,3/10/17,DEN,,BOS,W,0,7,1,4,0.25,0,2,0,1,2,0.5,0,0,,1,2,3
17116,Darrell Arthur,28-225,F,11/5/16,DEN,@,DET,L,0,7,1,3,0.333,0,2,0,1,1,1,0,0,,0,2,2
17117,Darrell Arthur,28-257,F,12/7/16,DEN,@,BRK,L,0,11,1,1,1,0,0,,1,1,1,0,0,,0,0,0
17118,D.J. Augustin,29-034,G,12/14/16,ORL,,LAC,L,1,30,1,5,0.2,0,1,0,1,4,0.25,0,0,,0,1,1
17119,D.J. Augustin,29-085,G,2/3/17,ORL,,TOR,W,0,16,0,2,0,0,1,0,0,1,0,3,5,0.6,1,0,1
17120,D.J. Augustin,29-033,G,12/13/16,ORL,@,ATL,W,1,15,1,4,0.25,0,1,0,1,3,0.333,0,0,,0,0,0
17121,D.J. Augustin,28-353,G,10/28/16,ORL,@,DET,L,0,16,1,5,0.2,0,4,0,1,1,1,0,0,,0,0,0
17122,D.J. Augustin,29-120,G,3/10/17,ORL,@,CHO,L,0,13,0,1,0,0,1,0,0,0,,3,3,1,0,1,1
17123,D.J. Augustin,29-095,G,2/13/17,ORL,@,MIA,W,0,15,1,4,0.25,0,3,0,1,1,1,0,0,,0,1,1
17124,D.J. Augustin,29-093,G,2/11/17,ORL,@,DAL,L,0,26,1,5,0.2,1,2,0.5,0,3,0,1,2,0.5,1,3,4
17125,Luke Babbitt,27-137,F,11/4/16,MIA,@,TOR,L,1,27,1,5,0.2,0,0,,1,5,0.2,0,0,,1,4,5
17126,Luke Babbitt,27-272,F,3/19/17,MIA,,POR,L,1,17,1,2,0.5,0,0,,1,2,0.5,0,0,,0,3,3
17127,Luke Babbitt,27-154,F,11/21/16,MIA,@,PHI,L,0,11,1,1,1,0,0,,1,1,1,0,0,,0,2,2
17128,Luke Babbitt,27-235,F,2/10/17,MIA,@,BRK,W,1,10,1,1,1,0,0,,1,1,1,0,0,,0,1,1
17129,Luke Babbitt,27-152,F,11/19/16,MIA,@,WAS,W,0,8,1,2,0.5,0,1,0,1,1,1,0,0,,1,0,1
17130,Luke Babbitt,27-231,F,2/6/17,MIA,@,MIN,W,1,13,1,5,0.2,0,1,0,1,4,0.25,0,0,,0,0,0
17131,Luke Babbitt,27-213,F,1/19/17,MIA,,DAL,W,1,17,1,3,0.333,0,0,,1,3,0.333,0,0,,0,3,3
17132,Luke Babbitt,27-224,F,1/30/17,MIA,,BRK,W,1,7,1,2,0.5,0,0,,1,2,0.5,0,0,,0,2,2
17133,Luke Babbitt,27-259,F,3/6/17,MIA,@,CLE,W,1,9,1,4,0.25,0,2,0,1,2,0.5,0,0,,0,2,2
17134,Luke Babbitt,27-143,F,11/10/16,MIA,,CHI,L,1,16,1,3,0.333,0,1,0,1,2,0.5,0,0,,0,0,0
17135,Luke Babbitt,27-238,F,2/13/17,MIA,,ORL,L,1,12,1,1,1,0,0,,1,1,1,0,0,,0,1,1
17136,Luke Babbitt,27-274,F,3/21/17,MIA,,PHO,W,1,16,1,4,0.25,0,0,,1,4,0.25,0,0,,0,5,5
17137,Luke Babbitt,27-221,F,1/27/17,MIA,@,CHI,W,1,16,1,3,0.333,0,0,,1,3,0.333,0,0,,0,1,1
17138,Ron Baker,23-297,G,1/21/17,NYK,,PHO,L,0,19,1,4,0.25,0,3,0,1,1,1,0,0,,0,3,3
17139,Leandro Barbosa,34-074,G,2/10/17,PHO,,CHI,W,0,13,1,5,0.2,0,3,0,1,2,0.5,0,0,,0,0,0
17140,J.J. Barea,32-268,G,3/21/17,DAL,,GSW,L,0,17,1,7,0.143,0,4,0,1,3,0.333,0,0,,1,2,3
17141,Matt Barnes,36-292,F,12/26/16,SAC,,PHI,W,0,13,1,3,0.333,0,1,0,1,2,0.5,0,0,,0,2,2
17142,Matt Barnes,36-232,F,10/27/16,SAC,,SAS,L,0,27,1,4,0.25,0,1,0,1,3,0.333,0,0,,0,0,0
17143,Matt Barnes,36-264,F,11/28/16,SAC,@,WAS,L,0,27,1,6,0.167,1,3,0.333,0,3,0,1,2,0.5,0,2,2
17144,Matt Barnes,36-318,F,1/21/17,SAC,@,CHI,L,0,21,1,4,0.25,0,2,0,1,2,0.5,0,0,,0,3,3
17145,Matt Barnes,36-361,F,3/5/17,GSW,@,NYK,W,1,19,1,3,0.333,0,0,,1,3,0.333,0,0,,1,2,3
17146,Will Barton,25-363,G,1/3/17,DEN,,SAC,L,0,16,1,3,0.333,0,2,0,1,1,1,0,0,,0,4,4
17147,Brandon Bass,31-256,F,1/11/17,LAC,,ORL,W,0,8,1,2,0.5,1,2,0.5,0,0,,1,1,1,0,1,1
17148,Brandon Bass,31-307,F,3/3/17,LAC,@,MIL,L,0,6,1,2,0.5,1,2,0.5,0,0,,1,1,1,1,2,3
17149,Aron Baynes,29-336,C,11/9/16,DET,@,PHO,L,0,13,0,0,,0,0,,0,0,,3,4,0.75,1,1,2
17150,Aron Baynes,30-079,C,2/26/17,DET,,BOS,L,0,12,1,1,1,1,1,1,0,0,,1,2,0.5,1,0,1
17151,Kent Bazemore,27-131,G-F,11/9/16,ATL,,CHI,W,1,22,1,4,0.25,1,3,0.333,0,1,0,1,2,0.5,0,1,1
17152,Kent Bazemore,27-147,G-F,11/25/16,ATL,@,UTA,L,1,20,1,9,0.111,1,8,0.125,0,1,0,1,2,0.5,0,4,4
17153,Bradley Beal,23-134,G,11/9/16,WAS,,BOS,W,1,11,1,8,0.125,1,7,0.143,0,1,0,1,2,0.5,2,2,4
17154,Malik Beasley,20-001,G,11/27/16,DEN,@,PHO,W,0,6,1,5,0.2,0,2,0,1,3,0.333,0,0,,0,1,1
17155,Michael Beasley,27-363,F,1/6/17,MIL,,NYK,L,0,12,1,4,0.25,1,3,0.333,0,1,0,1,1,1,0,0,0
17156,Marco Belinelli,30-327,G-F,2/15/17,CHO,@,TOR,L,0,22,1,6,0.167,0,2,0,1,4,0.25,0,0,,0,1,1
17157,Marco Belinelli,30-344,G-F,3/4/17,CHO,@,DEN,W,0,28,1,8,0.125,0,5,0,1,3,0.333,0,0,,0,3,3
17158,DeAndre' Bembry,22-190,F,1/10/17,ATL,@,BRK,W,0,3,1,3,0.333,1,2,0.5,0,1,0,1,2,0.5,0,0,0
17159,Dragan Bender,19-028,F,12/15/16,PHO,,SAS,L,0,12,1,4,0.25,0,1,0,1,3,0.333,0,0,,0,3,3
17160,Dragan Bender,19-008,F,11/25/16,PHO,,MIN,L,0,7,1,2,0.5,0,0,,1,2,0.5,0,2,0,0,1,1
17161,Dragan Bender,19-026,F,12/13/16,PHO,,NYK,W,0,8,1,3,0.333,0,0,,1,3,0.333,0,0,,0,0,0
17162,Dragan Bender,19-006,F,11/23/16,PHO,@,ORL,W,0,13,1,3,0.333,0,2,0,1,1,1,0,0,,0,4,4
17163,Dragan Bender,19-063,F,1/19/17,PHO,@,CLE,L,0,18,1,5,0.2,0,0,,1,5,0.2,0,0,,0,1,1
17164,Dragan Bender,19-042,F,12/29/16,PHO,,TOR,W,0,11,1,3,0.333,0,0,,1,3,0.333,0,0,,1,2,3
17165,Dragan Bender,19-019,F,12/6/16,PHO,@,UTA,L,0,28,1,5,0.2,0,0,,1,5,0.2,0,0,,0,3,3
17166,Anthony Bennett,23-271,F,12/10/16,BRK,@,SAS,L,0,15,1,7,0.143,0,3,0,1,4,0.25,0,0,,2,5,7
17167,Davis Bertans,24-117,F,3/9/17,SAS,@,OKC,L,0,14,1,5,0.2,0,2,0,1,3,0.333,0,0,,0,4,4
17168,Davis Bertans,24-032,F,12/14/16,SAS,,BOS,W,0,15,1,3,0.333,0,0,,1,3,0.333,0,0,,0,1,1
17169,Davis Bertans,24-009,F,11/21/16,SAS,,DAL,W,1,20,1,3,0.333,0,0,,1,3,0.333,0,0,,1,1,2
17170,Davis Bertans,24-109,F,3/1/17,SAS,,IND,W,0,7,1,1,1,0,0,,1,1,1,0,0,,0,1,1
17171,Davis Bertans,23-352,F,10/29/16,SAS,,NOP,W,0,12,1,4,0.25,0,2,0,1,2,0.5,0,0,,1,2,3
17172,Davis Bertans,24-006,F,11/18/16,SAS,@,LAL,W,0,7,1,2,0.5,0,0,,1,2,0.5,0,0,,0,1,1
17173,Davis Bertans,24-106,F,2/26/17,SAS,@,LAL,W,0,8,1,1,1,0,0,,1,1,1,0,0,,0,1,1
17174,Davis Bertans,24-126,F,3/18/17,SAS,@,MEM,L,0,8,1,2,0.5,0,0,,1,2,0.5,0,0,,0,1,1
17175,Davis Bertans,24-092,F,2/12/17,SAS,@,NYK,L,0,14,1,2,0.5,0,1,0,1,1,1,0,0,,3,1,4
17176,Patrick Beverley,28-239,G,3/8/17,HOU,,UTA,L,1,34,1,7,0.143,0,3,0,1,4,0.25,0,0,,1,1,2
17177,Patrick Beverley,28-197,G,1/25/17,HOU,@,BOS,L,1,32,1,6,0.167,1,3,0.333,0,3,0,1,1,1,1,1,2
17178,Patrick Beverley,28-249,G,3/18/17,HOU,@,DEN,W,1,31,1,7,0.143,1,4,0.25,0,3,0,1,2,0.5,2,3,5
17179,Patrick Beverley,28-142,G,12/1/16,HOU,@,GSW,W,1,29,1,6,0.167,0,3,0,1,3,0.333,0,0,,1,6,7
17180,Patrick Beverley,28-241,G,3/10/17,HOU,@,CHI,W,1,29,0,4,0,0,1,0,0,3,0,3,4,0.75,3,3,6
17181,Patrick Beverley,28-150,G,12/9/16,HOU,@,OKC,W,1,32,1,8,0.125,0,3,0,1,5,0.2,0,0,,4,8,12
17182,Bismack Biyombo,24-062,C-F,10/29/16,ORL,@,CLE,L,0,19,1,3,0.333,1,3,0.333,0,0,,1,4,0.25,7,2,9
17183,Bismack Biyombo,24-095,C-F,12/1/16,ORL,@,MEM,L,1,34,1,4,0.25,1,4,0.25,0,0,,1,2,0.5,3,11,14
17184,Bismack Biyombo,24-073,C-F,11/9/16,ORL,,MIN,L,0,26,0,3,0,0,3,0,0,0,,3,6,0.5,3,4,7
17185,Bismack Biyombo,24-089,C-F,11/25/16,ORL,,WAS,L,0,30,0,0,,0,0,,0,0,,3,6,0.5,0,6,6
17186,Bismack Biyombo,24-200,C-F,3/16/17,ORL,@,GSW,L,0,18,1,4,0.25,1,4,0.25,0,0,,1,1,1,3,7,10
17187,Nemanja Bjelica,28-245,F,1/9/17,MIN,,DAL,W,0,29,1,2,0.5,0,0,,1,2,0.5,0,0,,1,4,5
17188,Nemanja Bjelica,28-262,F,1/26/17,MIN,,IND,L,0,16,1,6,0.167,0,1,0,1,5,0.2,0,0,,0,3,3
17189,Nemanja Bjelica,28-275,F,2/8/17,MIN,,TOR,W,0,15,1,3,0.333,0,0,,1,3,0.333,0,0,,0,0,0
17190,Nemanja Bjelica,28-226,F,12/21/16,MIN,@,ATL,W,0,19,1,6,0.167,0,1,0,1,5,0.2,0,0,,1,2,3
17191,Nemanja Bjelica,28-170,F,10/26/16,MIN,@,MEM,L,0,15,1,4,0.25,1,3,0.333,0,1,0,1,2,0.5,0,1,1
17192,Nemanja Bjelica,28-310,F,3/15/17,MIN,@,BOS,L,0,11,1,4,0.25,0,2,0,1,2,0.5,0,0,,1,3,4
17193,Nemanja Bjelica,28-200,F,11/25/16,MIN,@,PHO,W,0,13,1,4,0.25,0,0,,1,4,0.25,0,0,,0,2,2
17194,Nemanja Bjelica,28-264,F,1/28/17,MIN,,BRK,W,0,14,1,4,0.25,0,0,,1,4,0.25,0,0,,0,0,0
17195,Bojan Bogdanovic,27-262,G-F,1/5/17,BRK,@,IND,L,1,12,1,7,0.143,0,3,0,1,4,0.25,0,0,,0,1,1
17196,Joel Bolomboy,22-276,F,10/30/16,UTA,@,LAC,L,0,4,1,1,1,1,1,1,0,0,,1,2,0.5,0,1,1
17197,Trevor Booker,29-031,F,12/26/16,BRK,,CHO,W,1,22,1,3,0.333,1,3,0.333,0,0,,1,2,0.5,0,12,12
17198,Corey Brewer,30-239,F-G,10/30/16,HOU,,DAL,W,0,15,1,2,0.5,0,0,,1,2,0.5,0,0,,0,2,2
17199,Corey Brewer,30-284,F-G,12/14/16,HOU,,SAC,W,0,13,1,1,1,0,0,,1,1,1,0,0,,1,1,2
17200,Corey Brewer,30-280,F-G,12/10/16,HOU,,DAL,W,0,11,1,1,1,0,0,,1,1,1,0,0,,0,1,1
17201,Corey Brewer,30-280,F-G,12/10/16,HOU,,DAL,W,0,11,1,1,1,0,0,,1,1,1,0,0,,0,1,1
17202,Corey Brewer,30-339,F-G,2/7/17,HOU,,ORL,W,0,12,1,2,0.5,1,2,0.5,0,0,,1,1,1,0,3,3
17203,Malcolm Brogdon,23-330,G,11/5/16,MIL,,SAC,W,0,27,1,6,0.167,1,4,0.25,0,2,0,1,1,1,1,4,5
17204,Aaron Brooks,31-325,G,12/4/16,IND,@,LAC,W,0,5,0,1,0,0,1,0,0,0,,3,3,1,1,0,1
17205,Aaron Brooks,32-006,G,1/20/17,IND,@,LAL,L,0,13,1,3,0.333,0,1,0,1,2,0.5,0,3,0,1,1,2
17206,Aaron Brooks,32-004,G,1/18/17,IND,@,SAC,W,0,14,1,3,0.333,0,1,0,1,2,0.5,0,0,,1,0,1
17207,Aaron Brooks,31-331,G,12/10/16,IND,,POR,W,0,13,1,6,0.167,1,4,0.25,0,2,0,1,1,1,1,1,2
17208,Anthony Brown,24-055,F-G,12/4/16,NOP,@,OKC,L,0,19,1,5,0.2,0,1,0,1,4,0.25,0,0,,1,4,5
17209,Bobby Brown,32-109,G,1/11/17,HOU,@,MIN,L,0,1,1,1,1,0,0,,1,1,1,0,0,,0,1,1
17210,Jaylen Brown,20-009,F,11/2/16,BOS,,CHI,W,0,8,1,3,0.333,0,1,0,1,2,0.5,0,0,,1,1,2
17211,Jaylen Brown,20-016,F,11/9/16,BOS,@,WAS,L,1,13,1,2,0.5,1,2,0.5,0,0,,1,2,0.5,0,2,2
17212,Jaylen Brown,20-135,F,3/8/17,BOS,@,GSW,W,0,15,1,2,0.5,1,2,0.5,0,0,,1,3,0.333,0,3,3
17213,Nicolas Brussino,23-282,G-F,12/9/16,DAL,,IND,W,0,12,1,3,0.333,0,1,0,1,2,0.5,0,0,,0,3,3
17214,Nicolas Brussino,23-280,G-F,12/7/16,DAL,,SAC,L,0,12,1,4,0.25,1,1,1,0,3,0,1,1,1,0,1,1
17215,Nicolas Brussino,23-300,G-F,12/27/16,DAL,,HOU,L,0,9,1,4,0.25,0,0,,1,4,0.25,0,0,,1,1,2
17216,Nicolas Brussino,23-364,G-F,3/1/17,DAL,@,ATL,L,0,9,1,3,0.333,0,2,0,1,1,1,0,0,,2,0,2
17217,Nicolas Brussino,23-252,G-F,11/9/16,DAL,@,GSW,L,0,24,1,4,0.25,0,1,0,1,3,0.333,0,0,,1,1,2
17218,Nicolas Brussino,23-266,G-F,11/23/16,DAL,,LAC,L,0,15,1,3,0.333,0,1,0,1,2,0.5,0,0,,0,1,1
17219,Reggie Bullock,25-358,G-F,3/9/17,DET,,CLE,W,0,14,1,3,0.333,0,1,0,1,2,0.5,0,0,,0,4,4
17220,Trey Burke,24-096,G,2/16/17,WAS,@,IND,W,0,13,1,3,0.333,0,1,0,1,2,0.5,0,0,,0,3,3
17221,Trey Burke,23-353,G,10/30/16,WAS,@,MEM,L,0,16,1,4,0.25,1,4,0.25,0,0,,1,2,0.5,0,1,1
17222,Trey Burke,24-037,G,12/19/16,WAS,@,IND,L,0,6,1,2,0.5,0,0,,1,2,0.5,0,0,,0,0,0
17223,Trey Burke,24-055,G,1/6/17,WAS,,MIN,W,0,11,1,2,0.5,0,1,0,1,1,1,0,0,,1,0,1
17224,Trey Burke,24-068,G,1/19/17,WAS,@,NYK,W,0,7,1,2,0.5,0,0,,1,2,0.5,0,0,,0,0,0
17225,Alec Burks,25-206,G,2/11/17,UTA,,BOS,L,0,18,1,4,0.25,1,3,0.333,0,1,0,1,2,0.5,1,0,1
17226,Alec Burks,25-199,G,2/4/17,UTA,,CHO,W,0,20,1,9,0.111,1,6,0.167,0,3,0,1,2,0.5,1,0,1
17227,Jimmy Butler,27-135,G-F,1/27/17,CHI,,MIA,L,0,33,1,13,0.077,1,11,0.091,0,2,0,1,2,0.5,1,2,3
17228,Bruno Caboclo,21-072,F,12/2/16,TOR,,LAL,W,0,4,1,2,0.5,0,0,,1,2,0.5,0,0,,0,0,0
17229,Jose Calderon,35-045,G,11/12/16,LAL,@,NOP,W,0,3,1,1,1,0,0,,1,1,1,0,0,,0,1,1
17230,Isaiah Canaan,25-256,G,2/1/17,CHI,@,OKC,W,0,7,1,2,0.5,0,1,0,1,1,1,0,0,,0,1,1
17231,Vince Carter,40-049,G-F,3/16/17,MEM,@,ATL,W,1,29,1,2,0.5,1,1,1,0,1,0,1,2,0.5,0,0,0
17232,Vince Carter,39-322,G-F,12/13/16,MEM,@,CLE,L,0,18,1,4,0.25,0,0,,1,4,0.25,0,0,,0,2,2
17233,Vince Carter,39-353,G-F,1/13/17,MEM,@,HOU,W,0,21,1,3,0.333,1,2,0.5,0,1,0,1,2,0.5,1,1,2
17234,Vince Carter,39-335,G-F,12/26/16,MEM,@,ORL,L,0,15,1,4,0.25,0,1,0,1,3,0.333,0,0,,0,1,1
17235,Vince Carter,39-274,G-F,10/26/16,MEM,,MIN,W,0,28,1,4,0.25,1,2,0.5,0,2,0,1,2,0.5,1,6,7
17236,Vince Carter,39-348,G-F,1/8/17,MEM,,UTA,W,0,25,1,3,0.333,0,0,,1,3,0.333,0,0,,0,1,1
17237,Vince Carter,40-039,G-F,3/6/17,MEM,,BRK,L,0,21,1,5,0.2,0,2,0,1,3,0.333,0,0,,1,1,2
17238,Vince Carter,39-346,G-F,1/6/17,MEM,@,GSW,W,0,14,1,6,0.167,0,2,0,1,4,0.25,0,0,,0,2,2
17239,Michael Carter-Williams,25-121,G,2/8/17,CHI,@,GSW,L,1,25,1,9,0.111,1,7,0.143,0,2,0,1,2,0.5,1,3,4
17240,Michael Carter-Williams,25-094,G,1/12/17,CHI,@,NYK,L,1,16,1,8,0.125,1,6,0.167,0,2,0,1,1,1,1,3,4
17241,Michael Carter-Williams,25-102,G,1/20/17,CHI,@,ATL,L,1,19,1,6,0.167,0,4,0,1,2,0.5,0,0,,1,2,3
17242,Willie Cauley-Stein,23-070,F-C,10/27/16,SAC,,SAS,L,0,11,1,3,0.333,1,3,0.333,0,0,,1,2,0.5,0,0,0
17243,Tyson Chandler,34-080,C,12/21/16,PHO,,HOU,L,1,20,1,1,1,1,1,1,0,0,,1,3,0.333,3,3,6
17244,Tyson Chandler,34-095,C,1/5/17,PHO,@,DAL,W,1,28,1,2,0.5,1,2,0.5,0,0,,1,2,0.5,4,14,18
17245,Wilson Chandler,29-259,F,1/24/17,DEN,,UTA,W,0,20,1,4,0.25,0,1,0,1,3,0.333,0,0,,1,2,3
17246,Marquese Chriss,19-174,F,12/23/16,PHO,,PHI,W,1,7,1,2,0.5,0,0,,1,2,0.5,0,0,,0,1,1
17247,Rakeem Christmas,24-356,F,11/21/16,IND,,GSW,L,0,6,1,3,0.333,1,3,0.333,0,0,,1,1,1,1,1,2
17248,Rakeem Christmas,25-104,F,3/15/17,IND,,CHO,W,0,11,0,1,0,0,1,0,0,0,,3,4,0.75,1,1,2
17249,Semaj Christon,24-054,G,12/25/16,OKC,,MIN,W,0,18,1,3,0.333,0,2,0,1,1,1,0,0,,1,2,3
17250,Semaj Christon,24-117,G,2/26/17,OKC,,NOP,W,0,11,1,5,0.2,1,3,0.333,0,2,0,1,2,0.5,0,0,0
17251,Ian Clark,25-256,G,11/18/16,GSW,@,BOS,W,0,7,1,2,0.5,0,1,0,1,1,1,0,0,,1,0,1
17252,Ian Clark,25-237,G,10/30/16,GSW,@,PHO,W,0,16,1,5,0.2,0,2,0,1,3,0.333,0,0,,0,2,2
17253,Ian Clark,25-248,G,11/10/16,GSW,@,DEN,W,0,11,1,4,0.25,0,1,0,1,3,0.333,0,0,,0,0,0
17254,Ian Clark,25-263,G,11/25/16,GSW,@,LAL,W,0,9,1,2,0.5,0,1,0,1,1,1,0,0,,0,0,0
17255,Darren Collison,29-122,G,12/23/16,SAC,@,MIN,W,1,20,1,5,0.2,0,3,0,1,2,0.5,0,0,,0,1,1
17256,Pat Connaughton,23-359,G,12/30/16,POR,@,SAS,L,0,6,1,2,0.5,0,1,0,1,1,1,0,0,,0,1,1
17257,Pat Connaughton,23-314,G,11/15/16,POR,,CHI,L,0,9,1,1,1,1,1,1,0,0,,1,1,1,0,1,1
17258,Pat Connaughton,24-040,G,2/15/17,POR,@,UTA,L,0,20,0,2,0,0,0,,0,2,0,3,3,1,1,6,7
17259,Pat Connaughton,23-342,G,12/13/16,POR,,OKC,W,0,5,1,2,0.5,1,2,0.5,0,0,,1,2,0.5,0,0,0
17260,Pat Connaughton,24-007,G,1/13/17,POR,,ORL,L,0,13,1,4,0.25,0,1,0,1,3,0.333,0,0,,1,0,1
17261,Pat Connaughton,24-038,G,2/13/17,POR,,ATL,L,0,10,1,6,0.167,0,3,0,1,3,0.333,0,0,,2,1,3
17262,Robert Covington,25-341,F,11/19/16,PHI,,PHO,W,1,18,1,5,0.2,0,1,0,1,4,0.25,0,2,0,0,5,5
17263,Jamal Crawford,36-232,G,11/7/16,LAC,,DET,W,0,19,1,4,0.25,0,1,0,1,3,0.333,0,0,,0,1,1
17264,Jamal Crawford,36-361,G,3/16/17,LAC,@,DEN,L,0,25,1,6,0.167,0,4,0,1,2,0.5,0,0,,0,3,3
17265,Jae Crowder,26-170,F,12/23/16,BOS,,OKC,L,1,32,1,6,0.167,1,3,0.333,0,3,0,1,1,1,1,3,4
17266,Dante Cunningham,29-310,F,2/26/17,NOP,@,OKC,L,0,21,1,2,0.5,0,0,,1,2,0.5,0,0,,0,1,1
17267,Dante Cunningham,29-269,F,1/16/17,NOP,@,IND,L,1,31,1,7,0.143,0,2,0,1,5,0.2,0,0,,1,1,2
17268,Dante Cunningham,29-204,F,11/12/16,NOP,,LAL,L,1,18,1,3,0.333,0,1,0,1,2,0.5,0,0,,1,3,4
17269,Dante Cunningham,29-331,F,3/19/17,NOP,,MIN,W,0,22,1,3,0.333,0,2,0,1,1,1,0,0,,1,2,3
17270,Seth Curry,26-200,G,3/11/17,DAL,,PHO,L,1,33,1,8,0.125,1,5,0.2,0,3,0,1,1,1,0,3,3
17271,Seth Curry,26-122,G,12/23/16,DAL,@,LAC,W,0,25,1,4,0.25,0,2,0,1,2,0.5,0,0,,1,0,1
17272,Troy Daniels,25-133,G,11/25/16,MEM,,MIA,L,1,19,1,5,0.2,0,1,0,1,4,0.25,0,0,,1,2,3
17273,Troy Daniels,25-180,G,1/11/17,MEM,@,OKC,L,0,10,1,4,0.25,0,0,,1,4,0.25,0,0,,0,0,0
17274,Troy Daniels,25-239,G,3/11/17,MEM,,ATL,L,0,22,1,10,0.1,0,3,0,1,7,0.143,0,0,,0,1,1
17275,Deyonta Davis,20-088,F-C,2/28/17,MEM,,PHO,W,0,2,1,1,1,1,1,1,0,0,,1,1,1,0,0,0
17276,Deyonta Davis,19-353,F-C,11/19/16,MEM,,MIN,W,0,9,1,2,0.5,1,2,0.5,0,0,,1,2,0.5,1,2,3
17277,Ed Davis,27-168,F,11/20/16,POR,@,BRK,W,1,19,0,1,0,0,1,0,0,0,,3,4,0.75,2,4,6
17278,Dewayne Dedmon,27-184,C,2/12/17,SAS,@,NYK,L,1,24,1,2,0.5,1,2,0.5,0,0,,1,2,0.5,1,6,7
17279,Dewayne Dedmon,27-144,C,1/3/17,SAS,,TOR,W,0,24,1,1,1,1,1,1,0,0,,1,2,0.5,2,4,6
17280,Dewayne Dedmon,27-140,C,12/30/16,SAS,,POR,W,0,13,1,1,1,1,1,1,0,0,,1,2,0.5,2,6,8
17281,Sam Dekker,22-203,F,11/25/16,HOU,@,SAC,W,0,15,1,3,0.333,0,0,,1,3,0.333,0,0,,1,1,2
17282,Sam Dekker,22-201,F,11/23/16,HOU,,TOR,L,0,17,1,5,0.2,0,2,0,1,3,0.333,0,0,,0,4,4
17283,Sam Dekker,22-183,F,11/5/16,HOU,@,ATL,L,0,17,1,6,0.167,0,3,0,1,3,0.333,0,0,,2,2,4
17284,Sam Dekker,22-297,F,2/27/17,HOU,,IND,L,0,12,1,5,0.2,0,2,0,1,3,0.333,0,0,,0,0,0
17285,Sam Dekker,22-270,F,1/31/17,HOU,,SAC,W,0,18,1,4,0.25,0,1,0,1,3,0.333,0,0,,0,5,5
17286,Malcolm Delaney,27-336,G,2/10/17,ATL,@,SAC,L,0,15,1,4,0.25,1,3,0.333,0,1,0,1,1,1,0,1,1
17287,Malcolm Delaney,27-267,G,12/3/16,ATL,@,TOR,L,0,17,1,4,0.25,1,2,0.5,0,2,0,1,2,0.5,1,0,1
17288,Matthew Dellavedova,26-169,G,2/24/17,MIL,,UTA,L,1,27,1,6,0.167,1,4,0.25,0,2,0,1,1,1,0,1,1
17289,Matthew Dellavedova,26-129,G,1/15/17,MIL,@,ATL,L,0,24,1,2,0.5,1,2,0.5,0,0,,1,3,0.333,1,2,3
17290,Matthew Dellavedova,26-082,G,11/29/16,MIL,,CLE,W,1,25,1,5,0.2,1,4,0.25,0,1,0,1,1,1,0,3,3
17291,Luol Deng,31-202,F,11/4/16,LAL,,GSW,W,1,19,1,6,0.167,0,3,0,1,3,0.333,0,0,,1,3,4
17292,Luol Deng,31-262,F,1/3/17,LAL,,MEM,W,1,31,1,4,0.25,0,1,0,1,3,0.333,0,0,,2,4,6
17293,Luol Deng,31-257,F,12/29/16,LAL,,DAL,L,1,34,1,4,0.25,1,3,0.333,0,1,0,1,2,0.5,0,2,2
17294,Luol Deng,31-298,F,2/8/17,LAL,@,DET,L,0,21,1,5,0.2,0,1,0,1,4,0.25,0,0,,0,3,3
17295,Luol Deng,31-271,F,1/12/17,LAL,@,SAS,L,1,19,1,5,0.2,0,2,0,1,3,0.333,0,0,,0,1,1
17296,Luol Deng,31-293,F,2/3/17,LAL,@,BOS,L,1,20,1,5,0.2,0,3,0,1,2,0.5,0,0,,1,5,6
17297,Boris Diaw,34-215,F-C,11/17/16,UTA,,CHI,L,1,22,1,6,0.167,0,2,0,1,4,0.25,0,0,,0,1,1
17298,Spencer Dinwiddie,23-334,G,3/6/17,BRK,@,MEM,W,0,24,1,5,0.2,0,2,0,1,3,0.333,0,0,,0,3,3
17299,Spencer Dinwiddie,23-342,G,3/14/17,BRK,,OKC,L,0,25,0,4,0,0,3,0,0,1,0,3,4,0.75,0,0,0
17300,Spencer Dinwiddie,23-301,G,2/1/17,BRK,,NYK,L,0,19,1,6,0.167,1,4,0.25,0,2,0,1,2,0.5,0,2,2
17301,Toney Douglas,30-327,G,2/6/17,MEM,,SAS,W,0,17,1,4,0.25,0,1,0,1,3,0.333,0,0,,0,1,1
17302,Andre Drummond,23-164,C,1/21/17,DET,,WAS,W,1,18,1,2,0.5,1,2,0.5,0,0,,1,4,0.25,3,7,10
17303,Andre Drummond,23-111,C,11/29/16,DET,@,CHO,W,1,13,1,6,0.167,1,6,0.167,0,0,,1,1,1,1,5,6
17304,Andre Drummond,23-126,C,12/14/16,DET,@,DAL,W,1,27,1,3,0.333,1,3,0.333,0,0,,1,2,0.5,4,13,17
17305,Jared Dudley,31-245,F-G,3/12/17,PHO,,POR,L,0,24,1,2,0.5,0,0,,1,2,0.5,0,0,,0,7,7
17306,Jared Dudley,31-229,F-G,2/24/17,PHO,@,CHI,L,0,20,1,4,0.25,0,1,0,1,3,0.333,0,0,,0,1,1
17307,Jared Dudley,31-220,F-G,2/15/17,PHO,,LAL,W,0,19,1,3,0.333,0,0,,1,3,0.333,0,0,,0,4,4
17308,Mike Dunleavy,36-153,F-G,2/15/17,ATL,@,LAC,L,0,15,1,2,0.5,0,1,0,1,1,1,0,0,,0,4,4
17309,Mike Dunleavy,36-151,F-G,2/13/17,ATL,@,POR,W,0,8,1,4,0.25,0,0,,1,4,0.25,0,0,,0,1,1
17310,Mike Dunleavy,36-083,F-G,12/7/16,CLE,@,NYK,W,0,15,1,3,0.333,0,0,,1,3,0.333,0,0,,0,2,2
17311,Mike Dunleavy,36-132,F-G,1/25/17,ATL,@,CHI,W,0,7,1,3,0.333,0,1,0,1,2,0.5,0,0,,1,0,1
17312,Mike Dunleavy,36-054,F-G,11/8/16,CLE,,ATL,L,0,13,1,4,0.25,0,0,,1,4,0.25,0,0,,0,1,1
17313,Mike Dunleavy,36-144,F-G,2/6/17,ATL,,UTA,L,0,16,1,2,0.5,0,0,,1,2,0.5,0,0,,0,2,2
17314,Mike Dunleavy,36-049,F-G,11/3/16,CLE,,BOS,W,0,13,0,1,0,0,0,,0,1,0,3,4,0.75,0,1,1
17315,Mike Dunleavy,36-096,F-G,12/20/16,CLE,@,MIL,W,0,14,1,2,0.5,0,0,,1,2,0.5,0,0,,0,2,2
17316,Kris Dunn,22-252,G,11/25/16,MIN,@,PHO,W,0,11,1,4,0.25,0,3,0,1,1,1,0,0,,0,0,0
17317,Kris Dunn,22-283,G,12/26/16,MIN,,ATL,W,0,24,1,4,0.25,1,3,0.333,0,1,0,1,2,0.5,0,6,6
17318,Kris Dunn,22-297,G,1/9/17,MIN,,DAL,W,0,18,1,3,0.333,1,2,0.5,0,1,0,1,2,0.5,0,1,1
17319,Kris Dunn,22-314,G,1/26/17,MIN,,IND,L,0,15,1,1,1,0,0,,1,1,1,0,2,0,0,0,0
17320,Kris Dunn,22-282,G,12/25/16,MIN,@,OKC,L,0,18,1,2,0.5,0,0,,1,2,0.5,0,0,,0,2,2
17321,Kris Dunn,22-280,G,12/23/16,MIN,,SAC,L,0,14,1,4,0.25,1,3,0.333,0,1,0,1,3,0.333,1,2,3
17322,Kris Dunn,22-230,G,11/3/16,MIN,,DEN,L,1,30,1,6,0.167,1,5,0.2,0,1,0,1,2,0.5,1,4,5
17323,Kris Dunn,22-239,G,11/12/16,MIN,,LAC,L,0,19,0,4,0,0,3,0,0,1,0,3,4,0.75,0,4,4
17324,Henry Ellenson,19-331,F,12/9/16,DET,@,MIN,W,0,4,1,3,0.333,0,0,,1,3,0.333,0,0,,0,0,0
17325,Henry Ellenson,20-000,F,1/13/17,DET,@,UTA,L,0,5,1,4,0.25,1,2,0.5,0,2,0,1,1,1,0,0,0
17326,Henry Ellenson,19-365,F,1/12/17,DET,@,GSW,L,0,5,1,1,1,0,0,,1,1,1,0,0,,0,2,2
17327,Wayne Ellington,29-073,G,1/10/17,MIA,@,GSW,L,0,7,0,1,0,0,0,,0,1,0,3,3,1,0,0,0
17328,Monta Ellis,31-130,G,3/5/17,IND,@,ATL,W,0,22,1,6,0.167,0,3,0,1,3,0.333,0,2,0,1,2,3
17329,Monta Ellis,31-101,G,2/4/17,IND,,DET,W,0,24,1,6,0.167,1,4,0.25,0,2,0,1,2,0.5,0,5,5
17330,James Ennis,26-251,F,3/9/17,MEM,,LAC,L,1,18,1,2,0.5,1,1,1,0,1,0,1,1,1,0,1,1
17331,James Ennis,26-204,F,1/21/17,MEM,,HOU,L,0,28,1,6,0.167,0,1,0,1,5,0.2,0,0,,1,2,3
17332,James Ennis,26-263,F,3/21/17,MEM,@,NOP,L,0,15,1,4,0.25,0,1,0,1,3,0.333,0,0,,0,4,4
17333,Tyler Ennis,22-124,G,12/26/16,HOU,,PHO,W,0,6,1,3,0.333,1,2,0.5,0,1,0,1,1,1,0,0,0
17334,Tyler Ennis,22-160,G,1/31/17,HOU,,SAC,W,0,3,1,2,0.5,0,0,,1,2,0.5,0,0,,0,0,0
17335,Tyler Ennis,22-085,G,11/17/16,HOU,,POR,W,0,5,1,2,0.5,0,1,0,1,1,1,0,0,,0,0,0
17336,Dante Exum,21-203,G,2/1/17,UTA,,MIL,W,0,8,1,3,0.333,0,1,0,1,2,0.5,0,0,,0,2,2
17337,Jordan Farmar,29-342,G,11/6/16,SAC,@,TOR,W,0,11,1,2,0.5,0,1,0,1,1,1,0,0,,0,1,1
17338,Kay Felder,21-302,G,1/25/17,CLE,,SAC,L,0,11,1,2,0.5,1,2,0.5,0,0,,1,4,0.25,0,0,0
17339,Cristiano Felicio,24-149,F-C,12/3/16,CHI,@,DAL,L,0,15,1,3,0.333,1,3,0.333,0,0,,1,2,0.5,2,2,4
17340,Cristiano Felicio,24-218,F-C,2/10/17,CHI,@,PHO,L,0,22,1,5,0.2,1,5,0.2,0,0,,1,2,0.5,1,5,6
17341,Raymond Felton,32-145,G,11/18/16,LAC,@,SAC,W,0,13,1,3,0.333,0,0,,1,3,0.333,0,0,,0,0,0
17342,Raymond Felton,32-227,G,2/8/17,LAC,@,NYK,W,0,21,1,6,0.167,0,5,0,1,1,1,0,0,,3,2,5
17343,Raymond Felton,32-263,G,3/16/17,LAC,@,DEN,L,0,15,0,2,0,0,2,0,0,0,,3,4,0.75,0,1,1
17344,Raymond Felton,32-185,G,12/28/16,LAC,@,NOP,L,0,22,1,5,0.2,0,1,0,1,4,0.25,0,0,,0,1,1
17345,Raymond Felton,32-148,G,11/21/16,LAC,,TOR,W,0,13,1,3,0.333,0,2,0,1,1,1,0,0,,0,2,2
17346,Dorian Finney-Smith,23-250,F,1/9/17,DAL,@,MIN,L,0,7,1,1,1,0,0,,1,1,1,0,0,,0,0,0
17347,Dorian Finney-Smith,23-248,F,1/7/17,DAL,,ATL,L,0,22,1,4,0.25,0,0,,1,4,0.25,0,0,,0,0,0
17348,Dorian Finney-Smith,23-226,F,12/16/16,DAL,@,UTA,L,1,24,1,2,0.5,0,0,,1,2,0.5,0,0,,0,2,2
17349,Dorian Finney-Smith,23-260,F,1/19/17,DAL,@,MIA,L,0,11,1,1,1,0,0,,1,1,1,0,0,,0,2,2
17350,Dorian Finney-Smith,23-287,F,2/15/17,DAL,@,DET,L,0,9,1,2,0.5,1,1,1,0,1,0,1,1,1,0,1,1
17351,Dorian Finney-Smith,23-310,F,3/10/17,DAL,,BRK,W,0,15,1,3,0.333,0,1,0,1,2,0.5,0,0,,2,2,4
17352,Bryn Forbes,23-121,G,11/21/16,SAS,,DAL,W,0,10,1,3,0.333,0,2,0,1,1,1,0,0,,0,1,1
17353,Bryn Forbes,23-188,G,1/27/17,SAS,@,NOP,L,0,4,1,2,0.5,0,1,0,1,1,1,0,0,,0,0,0
17354,Bryn Forbes,23-238,G,3/18/17,SAS,@,MEM,L,0,1,1,1,1,0,0,,1,1,1,0,0,,0,0,0
17355,Randy Foye,33-093,G,12/26/16,BRK,,CHO,W,0,21,1,2,0.5,0,0,,1,2,0.5,0,0,,0,1,1
17356,Randy Foye,33-115,G,1/17/17,BRK,,TOR,L,0,18,1,5,0.2,1,2,0.5,0,3,0,1,2,0.5,1,1,2
17357,Randy Foye,33-066,G,11/29/16,BRK,,LAC,W,0,17,1,5,0.2,0,3,0,1,2,0.5,0,0,,1,4,5
17358,Randy Foye,33-165,G,3/8/17,BRK,@,ATL,L,1,14,1,2,0.5,0,0,,1,2,0.5,0,0,,0,1,1
17359,Randy Foye,33-045,G,11/8/16,BRK,,MIN,W,0,14,1,3,0.333,0,0,,1,3,0.333,0,0,,0,1,1
17360,Randy Foye,33-178,G,3/21/17,BRK,,DET,W,1,21,1,5,0.2,0,1,0,1,4,0.25,0,0,,0,5,5
17361,Randy Foye,33-077,G,12/10/16,BRK,@,SAS,L,0,21,1,4,0.25,0,0,,1,4,0.25,0,0,,0,2,2
17362,Randy Foye,33-137,G,2/8/17,BRK,,WAS,L,1,25,1,4,0.25,1,1,1,0,3,0,1,2,0.5,0,5,5
17363,Randy Foye,33-134,G,2/5/17,BRK,,TOR,L,1,25,1,1,1,0,0,,1,1,1,0,0,,0,0,0
17364,Randy Foye,33-132,G,2/3/17,BRK,,IND,L,1,23,1,5,0.2,0,2,0,1,3,0.333,0,0,,0,1,1
17365,Tim Frazier,26-124,G,3/5/17,NOP,@,LAL,W,0,12,1,4,0.25,0,3,0,1,1,1,0,0,,0,0,0
17366,Tim Frazier,26-138,G,3/19/17,NOP,,MIN,W,1,23,1,3,0.333,0,1,0,1,2,0.5,0,0,,0,2,2
17367,Channing Frye,33-288,C-F,3/1/17,CLE,@,BOS,L,1,13,1,4,0.25,0,0,,1,4,0.25,0,0,,0,2,2
17368,Channing Frye,33-303,C-F,3/16/17,CLE,,UTA,W,0,18,1,6,0.167,0,1,0,1,5,0.2,0,0,,1,4,5
17369,Channing Frye,33-251,C-F,1/23/17,CLE,@,NOP,L,0,5,1,4,0.25,0,1,0,1,3,0.333,0,0,,1,0,1
17370,Channing Frye,33-226,C-F,12/29/16,CLE,,BOS,W,0,15,1,4,0.25,0,2,0,1,2,0.5,0,0,,1,2,3
17371,Channing Frye,33-306,C-F,3/19/17,CLE,@,LAL,W,0,13,1,3,0.333,0,0,,1,3,0.333,0,0,,0,1,1
17372,Langston Galloway,25-012,G,12/21/16,NOP,,OKC,L,0,6,1,1,1,0,0,,1,1,1,0,0,,0,0,0
17373,Langston Galloway,25-047,G,1/25/17,NOP,,OKC,L,0,18,1,9,0.111,0,4,0,1,5,0.2,0,0,,0,2,2
17374,Langston Galloway,25-024,G,1/2/17,NOP,@,CLE,L,0,13,1,5,0.2,0,1,0,1,4,0.25,0,0,,0,2,2
17375,Langston Galloway,25-057,G,2/4/17,NOP,@,WAS,L,0,8,1,2,0.5,0,1,0,1,1,1,0,0,,0,0,0
17376,Langston Galloway,24-352,G,11/25/16,NOP,@,POR,L,0,18,1,2,0.5,0,1,0,1,1,1,0,0,,0,0,0
17377,Pau Gasol,36-195,F-C,1/17/17,SAS,,MIN,W,1,17,1,2,0.5,1,2,0.5,0,0,,1,2,0.5,1,4,5
17378,Pau Gasol,36-192,F-C,1/14/17,SAS,@,PHO,L,1,27,1,4,0.25,1,4,0.25,0,0,,1,6,0.167,0,10,10
17379,Jonathan Gibson,29-041,G,12/19/16,DAL,@,DEN,L,0,6,1,3,0.333,0,1,0,1,2,0.5,0,0,,0,1,1
17380,Jonathan Gibson,29-022,G,11/30/16,DAL,,SAS,L,0,4,1,2,0.5,0,0,,1,2,0.5,0,0,,0,1,1
17381,Taj Gibson,31-252,F,3/3/17,OKC,@,PHO,L,0,14,1,3,0.333,1,3,0.333,0,0,,1,2,0.5,1,3,4
17382,Taj Gibson,31-256,F,3/7/17,OKC,,POR,L,0,23,1,2,0.5,1,2,0.5,0,0,,1,2,0.5,5,3,8
17383,Manu Ginobili,39-166,G,1/10/17,SAS,,MIL,L,0,15,1,6,0.167,0,1,0,1,5,0.2,0,0,,0,1,1
17384,Manu Ginobili,39-120,G,11/25/16,SAS,@,BOS,W,0,22,0,6,0,0,2,0,0,4,0,3,4,0.75,1,1,2
17385,Manu Ginobili,39-163,G,1/7/17,SAS,,CHO,W,0,20,1,7,0.143,0,4,0,1,3,0.333,0,0,,1,1,2
17386,Manu Ginobili,39-197,G,2/10/17,SAS,@,DET,W,0,17,1,4,0.25,0,2,0,1,2,0.5,0,0,,0,2,2
17387,Manu Ginobili,39-195,G,2/8/17,SAS,@,PHI,W,0,18,1,3,0.333,0,1,0,1,2,0.5,0,0,,0,0,0
17388,Manu Ginobili,39-135,G,12/10/16,SAS,,BRK,W,0,18,1,3,0.333,0,1,0,1,2,0.5,0,0,,0,1,1
17389,Manu Ginobili,39-150,G,12/25/16,SAS,,CHI,W,0,20,1,4,0.25,0,1,0,1,3,0.333,0,0,,0,2,2
17390,Manu Ginobili,39-228,G,3/13/17,SAS,,ATL,W,0,23,1,4,0.25,0,1,0,1,3,0.333,0,0,,1,3,4
17391,Treveon Graham,23-009,G,11/7/16,CHO,,IND,W,0,14,1,2,0.5,0,0,,1,2,0.5,0,0,,0,2,2
17392,Treveon Graham,23-063,G,12/31/16,CHO,,CLE,L,0,2,1,1,1,0,0,,1,1,1,0,2,0,0,0,0
17393,Treveon Graham,23-142,G,3/20/17,CHO,,ATL,W,0,2,1,1,1,0,0,,1,1,1,0,0,,0,0,0
17394,Jerami Grant,22-301,F,1/7/17,OKC,,DEN,W,0,24,1,3,0.333,1,1,1,0,2,0,1,1,1,0,0,0
17395,Jerami Grant,22-355,F,3/2/17,OKC,@,POR,L,0,20,0,0,,0,0,,0,0,,3,4,0.75,1,0,1
17396,Jerami Grant,22-251,F,11/18/16,OKC,,BRK,W,0,12,1,1,1,1,1,1,0,0,,1,2,0.5,0,3,3
17397,Jerami Grant,22-328,F,2/3/17,OKC,,MEM,W,0,14,1,3,0.333,1,3,0.333,0,0,,1,2,0.5,0,1,1
17398,Jerami Grant,22-309,F,1/15/17,OKC,@,SAC,W,0,19,1,2,0.5,0,1,0,1,1,1,0,0,,0,2,2
17399,Jerami Grant,22-325,F,1/31/17,OKC,@,SAS,L,0,11,1,2,0.5,1,2,0.5,0,0,,1,2,0.5,0,3,3
17400,Jerami Grant,22-360,F,3/7/17,OKC,,POR,L,0,11,1,3,0.333,0,1,0,1,2,0.5,0,0,,0,0,0
17401,Jerian Grant,24-124,G,2/10/17,CHI,@,PHO,L,1,21,1,4,0.25,0,2,0,1,2,0.5,0,0,,0,2,2
17402,Jerian Grant,24-041,G,11/19/16,CHI,@,LAC,L,0,15,1,4,0.25,0,1,0,1,3,0.333,0,0,,1,0,1
17403,Danny Green,29-163,G-F,12/2/16,SAS,,WAS,W,1,24,1,4,0.25,0,0,,1,4,0.25,0,0,,0,0,0
17404,Danny Green,29-252,G-F,3/1/17,SAS,,IND,W,1,28,1,7,0.143,0,2,0,1,5,0.2,0,0,,0,2,2
17405,Danny Green,29-145,G-F,11/14/16,SAS,,MIA,W,1,15,1,2,0.5,0,1,0,1,1,1,0,0,,0,1,1
17406,Danny Green,29-266,G-F,3/15/17,SAS,,POR,L,1,31,1,7,0.143,0,1,0,1,6,0.167,0,0,,0,3,3
17407,Danny Green,29-247,G-F,2/24/17,SAS,@,LAC,W,1,28,1,4,0.25,0,1,0,1,3,0.333,0,0,,1,2,3
17408,Danny Green,29-238,G-F,2/15/17,SAS,@,ORL,W,1,18,1,4,0.25,0,1,0,1,3,0.333,0,0,,2,4,6
17409,Danny Green,29-204,G-F,1/12/17,SAS,,LAL,W,1,24,1,4,0.25,0,1,0,1,3,0.333,0,0,,0,4,4
17410,Draymond Green,26-288,F,12/17/16,GSW,,POR,W,1,29,1,4,0.25,1,2,0.5,0,2,0,1,2,0.5,0,12,12
17411,Gerald Green,30-346,G-F,1/6/17,BOS,,PHI,W,0,4,1,1,1,0,0,,1,1,1,0,0,,0,0,0
17412,Gerald Green,30-353,G-F,1/13/17,BOS,@,ATL,W,0,8,1,6,0.167,0,2,0,1,4,0.25,0,0,,0,1,1
17413,JaMychal Green,26-176,F,12/14/16,MEM,,CLE,W,1,25,1,5,0.2,1,4,0.25,0,1,0,1,2,0.5,2,5,7
17414,JaMychal Green,26-261,F,3/9/17,MEM,,LAC,L,0,22,1,4,0.25,1,3,0.333,0,1,0,1,2,0.5,1,4,5
17415,JaMychal Green,26-196,F,1/3/17,MEM,@,LAL,L,1,22,1,4,0.25,1,2,0.5,0,2,0,1,1,1,0,6,6
17416,Jeff Green,30-087,F,11/23/16,ORL,,PHO,L,1,23,0,7,0,0,6,0,0,1,0,3,4,0.75,1,2,3
17417,Jeff Green,30-103,F,12/9/16,ORL,@,CHO,L,0,24,1,5,0.2,1,4,0.25,0,1,0,1,1,1,1,3,4
17418,Jeff Green,30-101,F,12/7/16,ORL,,BOS,L,0,22,1,5,0.2,0,3,0,1,2,0.5,0,0,,1,1,2
17419,Jeff Green,30-165,F,2/9/17,ORL,,PHI,L,0,18,1,7,0.143,0,5,0,1,2,0.5,0,0,,0,5,5
17420,Jeff Green,30-112,F,12/18/16,ORL,,TOR,L,0,25,1,7,0.143,1,3,0.333,0,4,0,1,2,0.5,0,3,3
17421,Jeff Green,30-078,F,11/14/16,ORL,@,IND,L,1,22,1,4,0.25,1,1,1,0,3,0,1,2,0.5,1,1,2
17422,Jeff Green,30-194,F,3/10/17,ORL,@,CHO,L,0,6,1,1,1,0,0,,1,1,1,0,0,,0,0,0
17423,Justin Hamilton,26-313,C,2/8/17,BRK,,WAS,L,0,16,1,5,0.2,0,1,0,1,4,0.25,0,2,0,1,2,3
17424,Justin Hamilton,26-227,C,11/14/16,BRK,@,LAC,L,1,21,1,5,0.2,0,1,0,1,4,0.25,0,0,,1,2,3
17425,Justin Hamilton,26-269,C,12/26/16,BRK,,CHO,W,0,15,1,2,0.5,0,0,,1,2,0.5,0,0,,0,3,3
17426,Justin Hamilton,26-320,C,2/15/17,BRK,,MIL,L,0,13,1,3,0.333,0,1,0,1,2,0.5,0,0,,0,3,3
17427,A.J. Hammons,24-111,C,12/16/16,DAL,@,UTA,L,0,3,1,1,1,0,0,,1,1,1,0,0,,0,1,1
17428,A.J. Hammons,24-107,C,12/12/16,DAL,,DEN,W,0,3,1,2,0.5,0,1,0,1,1,1,0,0,,0,0,0
17429,Tim Hardaway,24-234,G,11/5/16,ATL,,HOU,W,0,19,1,5,0.2,1,3,0.333,0,2,0,1,2,0.5,0,1,1
17430,Tim Hardaway,24-313,G,1/23/17,ATL,,LAC,L,0,23,1,6,0.167,1,2,0.5,0,4,0,1,2,0.5,0,2,2
17431,Maurice Harkless,23-254,F-G,1/20/17,POR,@,PHI,L,0,19,1,5,0.2,1,4,0.25,0,1,0,1,2,0.5,3,1,4
17432,Maurice Harkless,23-308,F-G,3/15/17,POR,@,SAS,W,1,19,1,3,0.333,0,2,0,1,1,1,0,0,,1,0,1
17433,Justin Harper,27-188,F,3/6/17,PHI,,MIL,L,0,4,1,1,1,0,0,,1,1,1,0,0,,0,0,0
17434,Montrezl Harrell,22-288,F-C,11/9/16,HOU,@,SAS,W,0,5,1,1,1,1,1,1,0,0,,1,1,1,1,0,1
17435,Devin Harris,33-284,G,12/7/16,DAL,,SAC,L,0,17,1,3,0.333,1,1,1,0,2,0,1,2,0.5,0,4,4
17436,Devin Harris,33-280,G,12/3/16,DAL,,CHI,W,0,17,1,4,0.25,0,1,0,1,3,0.333,0,0,,2,1,3
17437,Devin Harris,33-278,G,12/1/16,DAL,@,CHO,L,0,11,1,3,0.333,0,1,0,1,2,0.5,0,0,,0,0,0
17438,Devin Harris,33-304,G,12/27/16,DAL,,HOU,L,0,14,1,3,0.333,0,0,,1,3,0.333,0,0,,0,1,1
17439,Gary Harris,22-052,G,11/5/16,DEN,@,DET,L,0,16,1,5,0.2,1,4,0.25,0,1,0,1,2,0.5,1,2,3
17440,Gary Harris,22-097,G,12/20/16,DEN,@,LAC,L,1,19,1,6,0.167,0,4,0,1,2,0.5,0,0,,1,1,2
17441,Joe Harris,25-151,G,2/5/17,BRK,,TOR,L,0,24,1,6,0.167,0,2,0,1,4,0.25,0,0,,0,4,4
17442,Joe Harris,25-147,G,2/1/17,BRK,,NYK,L,0,9,1,4,0.25,0,1,0,1,3,0.333,0,0,,0,0,0
17443,Joe Harris,25-159,G,2/13/17,BRK,,MEM,L,0,10,1,2,0.5,0,0,,1,2,0.5,0,0,,0,1,1
17444,Joe Harris,25-079,G,11/25/16,BRK,@,IND,L,0,24,1,6,0.167,0,1,0,1,5,0.2,0,0,,0,2,2
17445,Andrew Harrison,22-099,G,2/4/17,MEM,@,MIN,W,1,19,1,5,0.2,0,2,0,1,3,0.333,0,0,,0,1,1
17446,Andrew Harrison,22-031,G,11/28/16,MEM,,CHO,L,0,24,1,8,0.125,0,3,0,1,5,0.2,0,0,,0,1,1
17447,Andrew Harrison,22-123,G,2/28/17,MEM,,PHO,W,0,2,1,1,1,0,0,,1,1,1,0,0,,0,1,1
17448,Andrew Harrison,22-072,G,1/8/17,MEM,,UTA,W,0,8,1,4,0.25,0,1,0,1,3,0.333,0,0,,0,0,0
17449,Udonis Haslem,36-208,F-C,1/3/17,MIA,@,PHO,L,0,16,1,1,1,1,1,1,0,0,,1,1,1,2,3,5
17450,Spencer Hawes,28-232,C-F,12/16/16,CHO,@,BOS,L,0,14,1,3,0.333,1,1,1,0,2,0,1,2,0.5,0,3,3
17451,Gerald Henderson,28-344,G,11/17/16,PHI,@,MIN,L,1,15,1,4,0.25,0,2,0,1,2,0.5,0,0,,0,1,1
17452,Gerald Henderson,29-036,G,1/14/17,PHI,@,WAS,L,0,15,1,4,0.25,1,2,0.5,0,2,0,1,2,0.5,0,1,1
17453,Juan Hernangomez,21-055,F,11/22/16,DEN,,CHI,W,0,11,1,4,0.25,1,3,0.333,0,1,0,1,1,1,0,1,1
17454,Juan Hernangomez,21-071,F,12/8/16,DEN,@,WAS,L,0,12,0,2,0,0,0,,0,2,0,3,4,0.75,1,3,4
17455,Juan Hernangomez,21-049,F,11/16/16,DEN,,PHO,W,0,10,1,1,1,0,0,,1,1,1,0,0,,0,3,3
17456,Juan Hernangomez,21-140,F,2/15/17,DEN,,MIN,L,1,33,1,6,0.167,0,1,0,1,5,0.2,0,0,,0,1,1
17457,Juan Hernangomez,21-159,F,3/6/17,DEN,,SAC,W,0,8,1,2,0.5,1,1,1,0,1,0,1,2,0.5,1,0,1
17458,Juan Hernangomez,21-157,F,3/4/17,DEN,,CHO,L,0,13,1,2,0.5,0,1,0,1,1,1,0,0,,1,1,2
17459,Willy Hernangomez,22-218,C,12/31/16,NYK,@,HOU,L,0,19,1,5,0.2,1,4,0.25,0,1,0,1,2,0.5,3,7,10
17460,Mario Hezonja,21-247,F-G,10/29/16,ORL,@,CLE,L,0,10,1,4,0.25,0,1,0,1,3,0.333,0,0,,0,4,4
17461,Mario Hezonja,21-334,F-G,1/24/17,ORL,,CHI,L,0,13,1,3,0.333,0,1,0,1,2,0.5,0,0,,0,4,4
17462,Mario Hezonja,21-244,F-G,10/26/16,ORL,,MIA,L,0,14,1,5,0.2,1,5,0.2,0,0,,1,2,0.5,2,1,3
17463,Mario Hezonja,21-314,F-G,1/4/17,ORL,,ATL,L,0,2,1,2,0.5,0,0,,1,2,0.5,0,0,,0,0,0
17464,Mario Hezonja,21-330,F-G,1/20/17,ORL,,MIL,W,0,13,1,5,0.2,0,2,0,1,3,0.333,0,0,,1,3,4
17465,Mario Hezonja,21-288,F-G,12/9/16,ORL,@,CHO,L,0,8,1,3,0.333,0,1,0,1,2,0.5,0,0,,0,2,2
17466,Mario Hezonja,21-350,F-G,2/9/17,ORL,,PHI,L,1,18,1,4,0.25,0,2,0,1,2,0.5,0,0,,1,3,4
17467,Mario Hezonja,21-326,F-G,1/16/17,ORL,@,DEN,L,0,21,1,4,0.25,0,2,0,1,2,0.5,0,0,,0,2,2
17468,Mario Hezonja,22-020,F-G,3/17/17,ORL,@,PHO,W,0,16,1,5,0.2,1,4,0.25,0,1,0,1,2,0.5,0,2,2
17469,Mario Hezonja,21-324,F-G,1/14/17,ORL,@,UTA,L,0,4,1,1,1,0,0,,1,1,1,0,0,,0,0,0
17470,Mario Hezonja,21-323,F-G,1/13/17,ORL,@,POR,W,0,7,1,2,0.5,0,1,0,1,1,1,0,0,,1,0,1
17471,Roy Hibbert,29-364,C,12/9/16,CHO,,ORL,W,0,18,0,6,0,0,6,0,0,0,,3,6,0.5,1,4,5
17472,Roy Hibbert,30-024,C,1/4/17,CHO,,OKC,W,1,21,0,1,0,0,1,0,0,0,,3,4,0.75,1,1,2
17473,Buddy Hield,23-037,G,1/23/17,NOP,,CLE,W,1,18,1,4,0.25,0,2,0,1,2,0.5,0,0,,0,2,2
17474,Buddy Hield,23-006,G,12/23/16,NOP,,MIA,W,1,18,1,8,0.125,0,4,0,1,4,0.25,0,0,,0,3,3
17475,George Hill,30-241,G,12/31/16,UTA,,PHO,W,1,7,1,3,0.333,1,3,0.333,0,0,,1,2,0.5,0,1,1
17476,Solomon Hill,25-350,F,3/3/17,NOP,,SAS,L,1,40,1,5,0.2,0,2,0,1,3,0.333,0,0,,1,0,1
17477,Solomon Hill,25-327,F,2/8/17,NOP,,UTA,L,1,25,1,3,0.333,0,0,,1,3,0.333,0,0,,0,0,0
17478,Solomon Hill,25-256,F,11/29/16,NOP,,LAL,W,1,28,0,4,0,0,1,0,0,3,0,3,4,0.75,0,7,7
17479,Solomon Hill,25-293,F,1/5/17,NOP,,ATL,L,1,22,1,4,0.25,0,1,0,1,3,0.333,0,0,,0,3,3
17480,Solomon Hill,25-224,F,10/28/16,NOP,,GSW,L,1,24,1,4,0.25,1,3,0.333,0,1,0,1,2,0.5,0,1,1
17481,Solomon Hill,25-342,F,2/23/17,NOP,,HOU,L,1,27,1,4,0.25,0,0,,1,4,0.25,0,0,,0,3,3
17482,Solomon Hill,25-355,F,3/8/17,NOP,,TOR,L,1,24,1,5,0.2,0,1,0,1,4,0.25,0,0,,1,4,5
17483,Solomon Hill,25-280,F,12/23/16,NOP,,MIA,W,0,24,1,6,0.167,0,3,0,1,3,0.333,0,0,,2,1,3
17484,Darrun Hilliard,23-247,G,12/16/16,DET,@,WAS,L,0,6,1,2,0.5,0,1,0,1,1,1,0,0,,0,0,0
17485,Darrun Hilliard,23-208,G,11/7/16,DET,@,LAC,L,0,12,0,2,0,0,1,0,0,1,0,3,4,0.75,0,2,2
17486,Justin Holiday,27-246,G,12/7/16,NYK,,CLE,L,0,14,1,3,0.333,0,1,0,1,2,0.5,0,0,,1,3,4
17487,Justin Holiday,27-291,G,1/21/17,NYK,,PHO,L,0,5,1,1,1,0,0,,1,1,1,0,0,,1,1,2
17488,Justin Holiday,27-276,G,1/6/17,NYK,@,MIL,W,0,8,1,2,0.5,0,0,,1,2,0.5,0,0,,0,1,1
17489,Justin Holiday,27-305,G,2/4/17,NYK,,CLE,L,0,22,1,6,0.167,1,2,0.5,0,4,0,1,2,0.5,0,2,2
17490,Justin Holiday,27-324,G,2/23/17,NYK,@,CLE,L,0,12,1,4,0.25,1,3,0.333,0,1,0,1,3,0.333,0,3,3
17491,Justin Holiday,27-340,G,3/11/17,NYK,@,DET,L,0,12,1,4,0.25,0,1,0,1,3,0.333,0,0,,0,1,1
17492,Rondae Hollis-Jefferson,22-043,F,2/15/17,BRK,,MIL,L,1,20,1,3,0.333,1,2,0.5,0,1,0,1,3,0.333,3,7,10
17493,Richaun Holmes,23-049,F-C,12/3/16,PHI,,BOS,L,0,11,0,2,0,0,1,0,0,1,0,3,4,0.75,1,0,1
17494,Richaun Holmes,23-121,F-C,2/13/17,PHI,@,CHO,W,0,19,1,3,0.333,1,3,0.333,0,0,,1,4,0.25,2,2,4
17495,Richaun Holmes,23-023,F-C,11/7/16,PHI,,UTA,L,0,5,1,2,0.5,0,1,0,1,1,1,0,0,,0,1,1
17496,Richaun Holmes,23-035,F-C,11/19/16,PHI,,PHO,W,0,7,1,2,0.5,1,2,0.5,0,0,,1,2,0.5,0,1,1
17497,Rodney Hood,24-079,G-F,1/7/17,UTA,@,MIN,W,1,21,1,6,0.167,0,4,0,1,2,0.5,0,0,,0,5,5
17498,Rodney Hood,24-127,G-F,2/24/17,UTA,@,MIL,W,1,21,1,9,0.111,0,4,0,1,5,0.2,0,0,,0,2,2
17499,Rodney Hood,24-104,G-F,2/1/17,UTA,,MIL,W,1,8,1,3,0.333,0,1,0,1,2,0.5,0,0,,1,0,1
17500,Marcelo Huertas,33-254,G,2/3/17,LAL,@,BOS,L,0,8,1,1,1,0,0,,1,1,1,0,0,,0,1,1
17501,Marcelo Huertas,33-254,G,2/3/17,LAL,@,BOS,L,0,8,1,1,1,0,0,,1,1,1,0,0,,0,1,1
17502,Kris Humphries,31-286,F-C,11/18/16,ATL,@,CHO,L,0,4,1,2,0.5,0,1,0,1,1,1,0,0,,0,2,2
17503,Kris Humphries,31-266,F-C,10/29/16,ATL,@,PHI,W,0,22,1,6,0.167,1,5,0.2,0,1,0,1,2,0.5,1,9,10
17504,Kris Humphries,32-009,F-C,2/15/17,ATL,@,LAC,L,0,14,1,2,0.5,1,1,1,0,1,0,1,2,0.5,1,3,4
17505,Andre Iguodala,32-281,G-F,11/4/16,GSW,@,LAL,L,0,23,1,4,0.25,0,1,0,1,3,0.333,0,0,,0,3,3
17506,Andre Iguodala,32-280,G-F,11/3/16,GSW,,OKC,W,0,25,1,5,0.2,1,4,0.25,0,1,0,1,2,0.5,0,3,3
17507,Andre Iguodala,32-312,G-F,12/5/16,GSW,,IND,W,0,19,1,2,0.5,1,2,0.5,0,0,,1,1,1,0,2,2
17508,Andre Iguodala,32-327,G-F,12/20/16,GSW,,UTA,W,0,26,1,3,0.333,0,2,0,1,1,1,0,0,,0,1,1
17509,Ersan Ilyasova,29-267,F,2/6/17,PHI,@,DET,L,1,20,1,8,0.125,1,3,0.333,0,5,0,1,2,0.5,0,1,1
17510,Joe Ingles,29-160,F-G,3/11/17,UTA,@,OKC,L,0,23,1,2,0.5,1,1,1,0,1,0,1,2,0.5,0,6,6
17511,Joe Ingles,29-122,F-G,2/1/17,UTA,,MIL,W,0,23,1,4,0.25,0,0,,1,4,0.25,0,0,,0,3,3
17512,Joe Ingles,29-054,F-G,11/25/16,UTA,,ATL,W,0,10,1,3,0.333,0,0,,1,3,0.333,0,0,,0,0,0
17513,Joe Ingles,29-088,F-G,12/29/16,UTA,,PHI,W,0,16,1,4,0.25,0,2,0,1,2,0.5,0,0,,0,1,1
17514,Joe Ingles,29-052,F-G,11/23/16,UTA,,DEN,W,0,13,1,3,0.333,1,1,1,0,2,0,1,2,0.5,0,4,4
17515,Joe Ingles,29-114,F-G,1/24/17,UTA,@,DEN,L,1,20,1,4,0.25,0,1,0,1,3,0.333,0,0,,0,3,3
17516,Joe Ingles,29-031,F-G,11/2/16,UTA,,DAL,W,0,23,1,5,0.2,0,2,0,1,3,0.333,0,0,,0,1,1
17517,Joe Ingles,29-129,F-G,2/8/17,UTA,@,NOP,W,1,22,1,3,0.333,0,0,,1,3,0.333,0,0,,0,2,2
17518,Joe Ingles,29-149,F-G,2/28/17,UTA,@,OKC,L,0,19,1,4,0.25,0,2,0,1,2,0.5,0,0,,0,1,1
17519,Joe Ingles,29-058,F-G,11/29/16,UTA,,HOU,W,0,12,1,1,1,0,0,,1,1,1,0,0,,0,2,2
17520,Brandon Ingram,19-166,F,2/15/17,LAL,@,PHO,L,1,29,1,7,0.143,1,6,0.167,0,1,0,1,2,0.5,0,2,2
17521,Brandon Ingram,19-100,F,12/11/16,LAL,,NYK,L,0,26,1,8,0.125,0,5,0,1,3,0.333,0,0,,0,2,2
17522,Brandon Ingram,19-061,F,11/2/16,LAL,@,ATL,W,0,22,1,2,0.5,0,1,0,1,1,1,0,0,,0,2,2
17523,Brandon Ingram,19-118,F,12/29/16,LAL,,DAL,L,0,32,1,5,0.2,1,4,0.25,0,1,0,1,2,0.5,1,5,6
17524,Pierre Jackson,25-123,G,12/30/16,DAL,@,GSW,L,0,12,1,6,0.167,1,5,0.2,0,1,0,1,1,1,0,1,1
17525,Richard Jefferson,36-140,F,11/8/16,CLE,,ATL,L,0,7,1,2,0.5,0,0,,1,2,0.5,0,0,,0,0,0
17526,Richard Jefferson,36-263,F,3/11/17,CLE,@,ORL,W,1,27,1,6,0.167,0,2,0,1,4,0.25,0,0,,1,3,4
17527,Richard Jefferson,36-204,F,1/11/17,CLE,@,POR,L,0,13,1,2,0.5,1,1,1,0,1,0,1,1,1,0,1,1
17528,Richard Jefferson,36-238,F,2/14/17,CLE,@,MIN,W,0,11,1,1,1,1,1,1,0,0,,1,2,0.5,0,2,2
17529,Richard Jefferson,36-201,F,1/8/17,CLE,@,PHO,W,0,19,1,3,0.333,0,1,0,1,2,0.5,0,0,,0,0,0
17530,Richard Jefferson,36-164,F,12/2/16,CLE,@,CHI,L,0,15,1,1,1,0,0,,1,1,1,0,0,,0,0,0
17531,John Jenkins,25-284,G,12/15/16,PHO,,SAS,L,0,3,1,1,1,0,0,,1,1,1,0,0,,0,0,0
17532,Brandon Jennings,27-169,G,3/11/17,WAS,@,POR,W,0,16,1,4,0.25,1,3,0.333,0,1,0,1,2,0.5,0,1,1
17533,Brandon Jennings,27-063,G,11/25/16,NYK,,CHO,W,0,16,1,4,0.25,0,1,0,1,3,0.333,0,0,,0,3,3
17534,Brandon Jennings,27-124,G,1/25/17,NYK,@,DAL,L,0,21,1,6,0.167,0,3,0,1,3,0.333,0,0,,0,0,0
17535,Brandon Jennings,27-047,G,11/9/16,NYK,,BRK,W,0,27,1,6,0.167,0,2,0,1,4,0.25,0,0,,0,3,3
17536,Brandon Jennings,27-118,G,1/19/17,NYK,,WAS,L,0,24,1,4,0.25,0,2,0,1,2,0.5,0,0,,0,1,1
17537,Brandon Jennings,27-175,G,3/17/17,WAS,,CHI,W,0,17,1,4,0.25,0,2,0,1,2,0.5,0,0,,0,4,4
17538,Brandon Jennings,27-103,G,1/4/17,NYK,,MIL,L,0,16,1,4,0.25,0,2,0,1,2,0.5,0,0,,0,0,0
17539,Brandon Jennings,27-173,G,3/15/17,WAS,,DAL,L,0,16,1,3,0.333,0,0,,1,3,0.333,0,0,,0,2,2
17540,Brandon Jennings,27-081,G,12/13/16,NYK,@,PHO,L,0,28,1,6,0.167,1,4,0.25,0,2,0,1,1,1,0,0,0
17541,Jonas Jerebko,29-241,F,10/29/16,BOS,@,CHO,W,0,19,1,1,1,0,0,,1,1,1,0,0,,0,2,2
17542,Jonas Jerebko,29-338,F,2/3/17,BOS,,LAL,W,0,21,1,2,0.5,1,1,1,0,1,0,1,1,1,0,3,3
17543,Jonas Jerebko,29-359,F,2/24/17,BOS,@,TOR,L,0,19,1,5,0.2,0,2,0,1,3,0.333,0,0,,2,3,5
17544,Jonas Jerebko,29-320,F,1/16/17,BOS,,CHO,W,0,14,1,1,1,0,0,,1,1,1,0,0,,0,1,1
17545,Jonas Jerebko,29-334,F,1/30/17,BOS,,DET,W,1,24,1,2,0.5,0,0,,1,2,0.5,0,0,,1,9,10
17546,Jonas Jerebko,29-252,F,11/9/16,BOS,@,WAS,L,0,12,1,2,0.5,0,0,,1,2,0.5,0,0,,0,2,2
17547,Jonas Jerebko,29-348,F,2/13/17,BOS,@,DAL,W,0,13,1,2,0.5,0,0,,1,2,0.5,0,0,,0,4,4
17548,Jonas Jerebko,29-364,F,3/1/17,BOS,,CLE,W,0,19,1,1,1,0,0,,1,1,1,0,0,,1,5,6
17549,Jonas Jerebko,29-310,F,1/6/17,BOS,,PHI,W,0,14,1,3,0.333,0,0,,1,3,0.333,0,0,,0,0,0
17550,Amir Johnson,29-186,F,11/3/16,BOS,@,CLE,L,1,26,1,5,0.2,1,3,0.333,0,2,0,1,1,1,2,2,4
17551,Amir Johnson,29-265,F,1/21/17,BOS,,POR,L,1,29,1,2,0.5,1,1,1,0,1,0,1,2,0.5,5,2,7
17552,Amir Johnson,29-229,F,12/16/16,BOS,,CHO,W,1,13,1,1,1,1,1,1,0,0,,1,4,0.25,0,4,4
17553,Amir Johnson,29-313,F,3/10/17,BOS,@,DEN,L,1,13,1,4,0.25,1,4,0.25,0,0,,1,2,0.5,2,2,4
17554,Amir Johnson,29-227,F,12/14/16,BOS,@,SAS,L,1,17,1,3,0.333,1,3,0.333,0,0,,1,2,0.5,1,2,3
17555,Joe Johnson,35-172,G-F,12/18/16,UTA,@,MEM,W,0,20,1,6,0.167,0,2,0,1,4,0.25,0,0,,0,2,2
17556,Joe Johnson,35-222,G-F,2/6/17,UTA,@,ATL,W,0,21,1,7,0.143,0,5,0,1,2,0.5,0,0,,1,2,3
17557,Joe Johnson,35-198,G-F,1/13/17,UTA,,DET,W,0,17,1,5,0.2,0,3,0,1,2,0.5,0,0,,0,2,2
17558,Joe Johnson,35-147,G-F,11/23/16,UTA,,DEN,W,0,23,1,5,0.2,1,4,0.25,0,1,0,1,1,1,0,0,0
17559,Stanley Johnson,20-281,F,3/6/17,DET,,CHI,W,0,16,1,6,0.167,1,4,0.25,0,2,0,1,2,0.5,0,4,4
17560,Stanley Johnson,20-169,F,11/14/16,DET,,OKC,W,0,14,1,3,0.333,0,1,0,1,2,0.5,0,0,,0,1,1
17561,Stanley Johnson,20-257,F,2/10/17,DET,,SAS,L,0,14,1,5,0.2,0,2,0,1,3,0.333,0,0,,0,0,0
17562,Stanley Johnson,20-152,F,10/28/16,DET,,ORL,W,0,28,1,4,0.25,0,2,0,1,2,0.5,0,0,,1,0,1
17563,Stanley Johnson,20-202,F,12/17/16,DET,,IND,L,0,20,1,6,0.167,1,3,0.333,0,3,0,1,2,0.5,0,1,1
17564,Stanley Johnson,20-219,F,1/3/17,DET,,IND,L,0,15,1,4,0.25,0,1,0,1,3,0.333,0,0,,0,1,1
17565,Stanley Johnson,20-211,F,12/26/16,DET,,CLE,W,0,12,1,4,0.25,0,2,0,1,2,0.5,0,0,,0,1,1
17566,Tyler Johnson,24-268,G,1/30/17,MIA,,BRK,W,0,19,1,7,0.143,1,5,0.2,0,2,0,1,2,0.5,0,1,1
17567,Tyler Johnson,24-198,G,11/21/16,MIA,@,PHI,L,0,30,1,7,0.143,0,5,0,1,2,0.5,0,0,,2,7,9
17568,Wesley Johnson,29-154,F-G,12/12/16,LAC,,POR,W,0,8,1,2,0.5,0,0,,1,2,0.5,0,0,,0,1,1
17569,Wesley Johnson,29-112,F-G,10/31/16,LAC,,PHO,W,0,17,1,3,0.333,0,0,,1,3,0.333,0,0,,0,5,5
17570,Wesley Johnson,29-111,F-G,10/30/16,LAC,,UTA,W,0,19,1,4,0.25,0,1,0,1,3,0.333,0,0,,1,5,6
17571,Wesley Johnson,29-243,F-G,3/11/17,LAC,,PHI,W,0,9,1,1,1,0,0,,1,1,1,0,0,,0,0,0
17572,Wesley Johnson,29-201,F-G,1/28/17,LAC,@,GSW,L,0,10,1,4,0.25,0,1,0,1,3,0.333,0,0,,0,2,2
17573,Wesley Johnson,29-108,F-G,10/27/16,LAC,@,POR,W,0,12,1,2,0.5,1,1,1,0,1,0,1,1,1,0,2,2
17574,Wesley Johnson,29-123,F-G,11/11/16,LAC,@,OKC,W,0,11,1,5,0.2,0,2,0,1,3,0.333,0,0,,1,4,5
17575,Wesley Johnson,29-175,F-G,1/2/17,LAC,,PHO,W,0,15,1,2,0.5,0,0,,1,2,0.5,0,0,,0,2,2
17576,Wesley Johnson,29-235,F-G,3/3/17,LAC,@,MIL,L,0,4,1,2,0.5,0,0,,1,2,0.5,0,0,,0,0,0
17577,Wesley Johnson,29-187,F-G,1/14/17,LAC,,LAL,W,0,14,1,2,0.5,0,1,0,1,1,1,0,0,,0,4,4
17578,Wesley Johnson,29-137,F-G,11/25/16,LAC,@,DET,L,0,12,1,1,1,0,0,,1,1,1,0,0,,0,3,3
17579,Derrick Jones,20-032,F,3/19/17,PHO,@,DET,L,1,26,1,9,0.111,1,9,0.111,0,0,,1,3,0.333,3,2,5
17580,Derrick Jones,19-304,F,12/15/16,PHO,,SAS,L,0,3,1,1,1,1,1,1,0,0,,1,1,1,0,0,0
17581,James Jones,36-128,F-G,2/9/17,CLE,@,OKC,L,0,1,1,1,1,0,0,,1,1,1,0,0,,0,1,1
17582,James Jones,36-127,F-G,2/8/17,CLE,@,IND,W,0,2,1,1,1,0,0,,1,1,1,0,0,,0,0,0
17583,James Jones,36-092,F-G,1/4/17,CLE,,CHI,L,0,15,1,3,0.333,0,1,0,1,2,0.5,0,0,,0,5,5
17584,James Jones,36-118,F-G,1/30/17,CLE,@,DAL,L,0,3,1,1,1,0,0,,1,1,1,0,0,,0,0,0
17585,James Jones,36-090,F-G,1/2/17,CLE,,NOP,W,0,8,1,2,0.5,0,0,,1,2,0.5,0,0,,0,0,0
17586,James Jones,36-043,F-G,11/16/16,CLE,@,IND,L,0,1,1,1,1,0,0,,1,1,1,0,0,,0,0,0
17587,James Jones,36-134,F-G,2/15/17,CLE,,IND,W,0,3,1,2,0.5,0,0,,1,2,0.5,0,0,,0,0,0
17588,James Jones,36-056,F-G,11/29/16,CLE,@,MIL,L,0,11,1,3,0.333,0,1,0,1,2,0.5,0,0,,0,0,0
17589,Tyus Jones,20-187,G,11/13/16,MIN,,LAL,W,0,17,1,2,0.5,0,0,,1,2,0.5,0,0,,0,0,0
17590,Tyus Jones,20-202,G,11/28/16,MIN,,UTA,L,0,14,1,2,0.5,0,0,,1,2,0.5,0,0,,0,1,1
17591,Tyus Jones,20-307,G,3/13/17,MIN,,WAS,W,0,9,0,2,0,0,2,0,0,0,,3,3,1,0,0,0
17592,Cory Joseph,25-155,G,1/22/17,TOR,,PHO,L,0,25,1,5,0.2,1,4,0.25,0,1,0,1,2,0.5,0,2,2
17593,Cory Joseph,25-138,G,1/5/17,TOR,,UTA,W,0,18,1,8,0.125,1,8,0.125,0,0,,1,1,1,2,1,3
17594,Cory Joseph,25-162,G,1/29/17,TOR,,ORL,L,0,18,1,6,0.167,0,4,0,1,2,0.5,0,0,,1,0,1
17595,Cory Joseph,25-092,G,11/20/16,TOR,@,SAC,L,0,21,1,5,0.2,0,3,0,1,2,0.5,0,0,,0,2,2
17596,Frank Kaminsky,23-223,F-C,11/13/16,CHO,@,CLE,L,0,23,1,6,0.167,1,3,0.333,0,3,0,1,2,0.5,0,5,5
17597,Ryan Kelly,25-261,F,12/26/16,ATL,@,MIN,L,0,8,1,3,0.333,0,1,0,1,2,0.5,0,0,,0,1,1
17598,Ryan Kelly,25-230,F,11/25/16,ATL,@,UTA,L,0,7,1,1,1,0,0,,1,1,1,0,0,,0,3,3
17599,Michael Kidd-Gilchrist,23-081,F,12/16/16,CHO,@,BOS,L,1,22,1,4,0.25,0,3,0,1,1,1,0,0,,0,5,5
17600,Michael Kidd-Gilchrist,23-032,F,10/28/16,CHO,@,MIA,W,1,28,1,5,0.2,1,5,0.2,0,0,,1,2,0.5,2,3,5
17601,Sean Kilpatrick,26-319,G,11/20/16,BRK,,POR,L,0,20,1,9,0.111,1,7,0.143,0,2,0,1,2,0.5,0,4,4
17602,Sean Kilpatrick,27-032,G,2/7/17,BRK,@,CHO,L,0,18,1,4,0.25,0,0,,1,4,0.25,0,0,,0,0,0
17603,Brandon Knight,25-037,G,1/8/17,PHO,,CLE,L,0,14,0,4,0,0,1,0,0,3,0,3,4,0.75,1,0,1
17604,Brandon Knight,25-071,G,2/11/17,PHO,@,HOU,L,1,20,1,8,0.125,1,6,0.167,0,2,0,1,2,0.5,0,0,0
17605,Brandon Knight,25-048,G,1/19/17,PHO,@,CLE,L,0,4,1,3,0.333,0,2,0,1,1,1,0,0,,0,0,0
17606,Kyle Korver,35-253,G-F,11/25/16,ATL,@,UTA,L,1,26,1,3,0.333,0,1,0,1,2,0.5,0,1,0,0,4,4
17607,Kyle Korver,35-232,G-F,11/4/16,ATL,@,WAS,L,1,21,1,9,0.111,0,3,0,1,6,0.167,0,0,,0,3,3
17608,Kyle Korver,35-230,G-F,11/2/16,ATL,,LAL,L,1,27,1,6,0.167,0,0,,1,6,0.167,0,0,,0,4,4
17609,Kyle Korver,35-318,G-F,1/29/17,CLE,,OKC,W,0,16,1,7,0.143,0,1,0,1,6,0.167,0,0,,0,1,1
17610,Kyle Korver,35-258,G-F,11/30/16,ATL,@,PHO,L,1,16,1,2,0.5,0,1,0,1,1,1,0,0,,0,1,1
17611,Kyle Korver,35-256,G-F,11/28/16,ATL,@,GSW,L,1,30,1,6,0.167,0,2,0,1,4,0.25,0,0,,1,1,2
17612,Kosta Koufos,27-339,C,1/28/17,SAC,@,CHO,W,1,12,1,3,0.333,1,3,0.333,0,0,,1,2,0.5,0,3,3
17613,Mindaugas Kuzminskas,27-067,F,12/25/16,NYK,,BOS,L,0,9,1,3,0.333,0,1,0,1,2,0.5,0,0,,1,0,1
17614,Mindaugas Kuzminskas,27-129,F,2/25/17,NYK,,PHI,W,0,22,1,3,0.333,1,2,0.5,0,1,0,1,1,1,0,0,0
17615,Mindaugas Kuzminskas,27-046,F,12/4/16,NYK,,SAC,W,0,4,1,2,0.5,0,0,,1,2,0.5,0,0,,0,0,0
17616,Skal Labissiere,20-319,F,1/31/17,SAC,@,HOU,L,0,8,0,2,0,0,2,0,0,0,,3,4,0.75,2,1,3
17617,Skal Labissiere,20-308,F,1/20/17,SAC,@,MEM,L,0,6,1,1,1,1,1,1,0,0,,1,2,0.5,1,2,3
17618,Jeremy Lamb,24-274,G-F,2/28/17,CHO,@,LAL,W,0,19,1,4,0.25,1,3,0.333,0,1,0,1,1,1,0,3,3
17619,Jeremy Lamb,24-246,G-F,1/31/17,CHO,@,POR,L,0,6,1,4,0.25,0,2,0,1,2,0.5,0,0,,0,2,2
17620,Jeremy Lamb,24-191,G-F,12/7/16,CHO,,DET,W,0,12,1,4,0.25,1,2,0.5,0,2,0,1,2,0.5,0,0,0
17621,Nicolas Laprovittola,26-314,G,12/10/16,SAS,,BRK,W,0,12,1,4,0.25,0,2,0,1,2,0.5,0,0,,0,0,0
17622,Nicolas Laprovittola,26-309,G,12/5/16,SAS,@,MIL,W,0,9,1,3,0.333,0,1,0,1,2,0.5,0,0,,0,0,0
17623,Joffrey Lauvergne,25-054,C-F,11/23/16,OKC,@,SAC,L,0,6,1,2,0.5,0,1,0,1,1,1,0,0,,1,0,1
17624,Joffrey Lauvergne,25-066,C-F,12/5/16,OKC,@,ATL,W,0,5,1,1,1,1,1,1,0,0,,1,2,0.5,1,0,1
17625,Joffrey Lauvergne,25-088,C-F,12/27/16,OKC,@,MIA,W,0,11,1,2,0.5,1,2,0.5,0,0,,1,2,0.5,0,2,2
17626,Joffrey Lauvergne,25-033,C-F,11/2/16,OKC,@,LAC,W,0,17,1,1,1,1,1,1,0,0,,1,2,0.5,1,3,4
17627,Joffrey Lauvergne,25-084,C-F,12/23/16,OKC,@,BOS,W,0,13,0,3,0,0,2,0,0,1,0,3,4,0.75,0,4,4
17628,Joffrey Lauvergne,25-045,C-F,11/14/16,OKC,@,DET,L,0,16,1,6,0.167,0,4,0,1,2,0.5,0,0,,0,5,5
17629,Joffrey Lauvergne,25-118,C-F,1/26/17,OKC,,DAL,W,0,7,1,3,0.333,1,2,0.5,0,1,0,1,1,1,0,0,0
17630,Joffrey Lauvergne,25-163,C-F,3/12/17,CHI,@,BOS,L,0,17,1,7,0.143,0,4,0,1,3,0.333,0,0,,0,2,2
17631,Joffrey Lauvergne,25-094,C-F,1/2/17,OKC,@,MIL,L,0,14,1,2,0.5,1,2,0.5,0,0,,1,2,0.5,1,2,3
17632,Ty Lawson,29-013,G,11/16/16,SAC,,SAS,L,1,20,1,2,0.5,0,1,0,1,1,1,0,0,,1,1,2
17633,Jake Layman,22-353,F,2/23/17,POR,@,ORL,W,0,6,1,1,1,0,0,,1,1,1,0,0,,0,0,0
17634,Jake Layman,22-315,F,1/16/17,POR,@,WAS,L,0,11,1,4,0.25,1,1,1,0,3,0,1,2,0.5,0,2,2
17635,Alex Len,23-134,C,10/28/16,PHO,@,OKC,L,0,14,1,4,0.25,1,4,0.25,0,0,,1,2,0.5,0,0,0
17636,Meyers Leonard,24-245,C-F,10/29/16,POR,@,DEN,W,0,11,1,5,0.2,0,1,0,1,4,0.25,0,0,,0,1,1
17637,Meyers Leonard,24-292,C-F,12/15/16,POR,@,DEN,L,0,10,1,3,0.333,0,0,,1,3,0.333,0,0,,0,1,1
17638,Meyers Leonard,24-335,C-F,1/27/17,POR,,MEM,W,0,14,1,5,0.2,0,1,0,1,4,0.25,0,0,,0,1,1
17639,Meyers Leonard,24-307,C-F,12/30/16,POR,@,SAS,L,0,13,1,2,0.5,0,1,0,1,1,1,0,0,,0,1,1
17640,Meyers Leonard,25-010,C-F,3/9/17,POR,,PHI,W,0,15,1,3,0.333,0,1,0,1,2,0.5,0,0,,1,3,4
17641,Meyers Leonard,24-253,C-F,11/6/16,POR,@,MEM,W,0,11,1,4,0.25,0,2,0,1,2,0.5,0,0,,0,1,1
17642,Meyers Leonard,24-344,C-F,2/5/17,POR,@,OKC,L,0,19,1,1,1,0,0,,1,1,1,0,0,,0,7,7
17643,Caris LeVert,22-111,G-F,12/14/16,BRK,,LAL,W,0,11,1,3,0.333,1,1,1,0,2,0,1,2,0.5,0,4,4
17644,Caris LeVert,22-125,G-F,12/28/16,BRK,@,CHI,L,0,20,1,4,0.25,0,0,,1,4,0.25,0,0,,0,2,2
17645,Caris LeVert,22-141,G-F,1/13/17,BRK,@,TOR,L,0,19,1,5,0.2,0,0,,1,5,0.2,0,0,,0,1,1
17646,Caris LeVert,22-117,G-F,12/20/16,BRK,@,TOR,L,0,19,1,6,0.167,0,3,0,1,3,0.333,0,0,,0,1,1
17647,DeAndre Liggins,28-239,G,11/25/16,CLE,,DAL,W,0,13,1,3,0.333,1,3,0.333,0,0,,1,1,1,1,2,3
17648,DeAndre Liggins,28-257,G,12/13/16,CLE,,MEM,W,1,32,1,7,0.143,0,4,0,1,3,0.333,0,2,0,1,4,5
17649,DeAndre Liggins,28-267,G,12/23/16,CLE,,BRK,W,1,17,1,3,0.333,0,1,0,1,2,0.5,0,0,,0,0,0
17650,DeAndre Liggins,28-243,G,11/29/16,CLE,@,MIL,L,0,5,1,2,0.5,1,2,0.5,0,0,,1,1,1,0,0,0
17651,DeAndre Liggins,28-264,G,12/20/16,CLE,@,MIL,W,0,20,1,2,0.5,0,0,,1,2,0.5,0,0,,0,2,2
17652,Shaun Livingston,31-169,G,2/27/17,GSW,@,PHI,W,0,15,1,2,0.5,1,2,0.5,0,0,,1,2,0.5,0,2,2
17653,Shaun Livingston,31-069,G,11/19/16,GSW,@,MIL,W,0,15,1,5,0.2,1,5,0.2,0,0,,1,2,0.5,2,1,3
17654,Shaun Livingston,31-068,G,11/18/16,GSW,@,BOS,W,0,18,1,2,0.5,1,2,0.5,0,0,,1,2,0.5,0,2,2
17655,Shaun Livingston,31-066,G,11/16/16,GSW,@,TOR,W,0,18,1,1,1,1,1,1,0,0,,1,1,1,1,2,3
17656,Kevon Looney,20-349,F-C,1/20/17,GSW,@,HOU,W,0,11,1,1,1,1,1,1,0,0,,1,1,1,2,1,3
17657,Kevon Looney,20-345,F-C,1/16/17,GSW,,CLE,W,0,9,0,2,0,0,2,0,0,0,,3,4,0.75,4,1,5
17658,Kevon Looney,21-007,F-C,2/13/17,GSW,@,DEN,L,0,16,1,3,0.333,0,2,0,1,1,1,0,0,,2,4,6
17659,Robin Lopez,28-283,C,1/9/17,CHI,,OKC,L,1,26,1,7,0.143,1,7,0.143,0,0,,1,1,1,1,3,4
17660,Kevin Love,28-131,F,1/16/17,CLE,@,GSW,L,1,16,1,6,0.167,1,4,0.25,0,2,0,1,1,1,2,1,3
17661,Timothe Luwawu-Cabarrot,21-216,F,12/11/16,PHI,@,DET,W,0,5,1,1,1,0,0,,1,1,1,0,0,,0,1,1
17662,Timothe Luwawu-Cabarrot,21-282,F,2/15/17,PHI,@,BOS,L,0,14,1,6,0.167,1,3,0.333,0,3,0,1,2,0.5,0,1,1
17663,Trey Lyles,21-052,F,12/27/16,UTA,@,LAL,W,0,13,1,1,1,0,0,,1,1,1,0,0,,1,5,6
17664,Trey Lyles,21-131,F,3/16/17,UTA,@,CLE,L,0,11,1,3,0.333,0,2,0,1,1,1,0,0,,0,4,4
17665,Trey Lyles,21-076,F,1/20/17,UTA,@,DAL,W,0,16,1,4,0.25,1,3,0.333,0,1,0,1,2,0.5,0,4,4
17666,Trey Lyles,21-116,F,3/1/17,UTA,,MIN,L,0,20,1,6,0.167,1,5,0.2,0,1,0,1,2,0.5,0,0,0
17667,Trey Lyles,21-056,F,12/31/16,UTA,,PHO,W,0,18,1,5,0.2,1,2,0.5,0,3,0,1,2,0.5,0,4,4
17668,Shelvin Mack,26-212,G,11/20/16,UTA,@,DEN,L,0,16,1,8,0.125,1,8,0.125,0,0,,1,2,0.5,1,3,4
17669,Shelvin Mack,26-293,G,2/9/17,UTA,@,DAL,L,0,25,1,4,0.25,0,3,0,1,1,1,0,0,,1,4,5
17670,Shelvin Mack,26-292,G,2/8/17,UTA,@,NOP,W,0,5,1,2,0.5,1,1,1,0,1,0,1,2,0.5,0,1,1
17671,Thon Maker,19-365,F-C,2/24/17,MIL,,UTA,L,1,14,1,2,0.5,0,1,0,1,1,1,0,0,,0,2,2
17672,Thon Maker,20-013,F-C,3/10/17,MIL,,IND,W,1,5,1,2,0.5,1,1,1,0,1,0,1,1,1,0,0,0
17673,Thon Maker,19-310,F-C,12/31/16,MIL,@,CHI,W,0,2,1,1,1,0,0,,1,1,1,0,0,,0,0,0
17674,Thon Maker,19-254,F-C,11/5/16,MIL,,SAC,W,0,9,1,2,0.5,1,1,1,0,1,0,1,2,0.5,2,4,6
17675,Thon Maker,20-004,F-C,3/1/17,MIL,,DEN,L,1,7,1,2,0.5,0,1,0,1,1,1,0,0,,0,1,1
17676,Thon Maker,20-018,F-C,3/15/17,MIL,@,LAC,W,1,7,1,3,0.333,0,0,,1,3,0.333,0,0,,0,0,0
17677,Thon Maker,19-300,F-C,12/21/16,MIL,@,CLE,L,0,8,1,1,1,1,1,1,0,0,,1,2,0.5,0,3,3
17678,Thon Maker,19-328,F-C,1/18/17,MIL,@,HOU,L,0,3,1,2,0.5,1,1,1,0,1,0,1,1,1,0,2,2
17679,Thon Maker,20-016,F-C,3/13/17,MIL,@,MEM,L,1,11,1,2,0.5,0,1,0,1,1,1,0,0,,0,1,1
17680,Thon Maker,19-291,F-C,12/12/16,MIL,@,TOR,L,0,6,1,2,0.5,1,2,0.5,0,0,,1,2,0.5,1,2,3
17681,Boban Marjanovic,28-109,C,12/2/16,DET,@,ATL,W,0,4,1,1,1,1,1,1,0,0,,1,2,0.5,1,1,2
17682,Boban Marjanovic,28-135,C,12/28/16,DET,,MIL,L,0,4,1,2,0.5,1,2,0.5,0,0,,1,2,0.5,1,2,3
17683,Jarell Martin,22-166,F,11/6/16,MEM,,POR,L,0,7,0,2,0,0,2,0,0,0,,3,4,0.75,2,0,2
17684,Jarell Martin,22-196,F,12/6/16,MEM,,PHI,W,0,10,1,1,1,0,0,,1,1,1,0,0,,0,2,2
17685,Jarell Martin,22-210,F,12/20/16,MEM,,BOS,L,0,17,1,3,0.333,1,3,0.333,0,0,,1,2,0.5,2,6,8
17686,Wesley Matthews,30-154,G,3/17/17,DAL,@,PHI,L,1,24,1,8,0.125,1,3,0.333,0,5,0,1,2,0.5,0,2,2
17687,Luc Mbah a Moute,30-134,F,1/21/17,LAC,@,DEN,L,1,25,1,3,0.333,0,2,0,1,1,1,0,0,,0,1,1
17688,Luc Mbah a Moute,30-051,F,10/30/16,LAC,,UTA,W,1,16,1,5,0.2,1,3,0.333,0,2,0,1,2,0.5,4,0,4
17689,Luc Mbah a Moute,30-077,F,11/25/16,LAC,@,DET,L,1,21,1,3,0.333,1,1,1,0,2,0,1,1,1,1,1,2
17690,Luc Mbah a Moute,30-061,F,11/9/16,LAC,,POR,W,1,23,1,2,0.5,0,1,0,1,1,1,0,2,0,1,4,5
17691,Luc Mbah a Moute,30-075,F,11/23/16,LAC,@,DAL,W,1,20,1,2,0.5,0,0,,1,2,0.5,0,0,,0,1,1
17692,Patrick McCaw,21-096,G,1/29/17,GSW,@,POR,W,0,20,1,2,0.5,0,0,,1,2,0.5,0,0,,0,1,1
17693,Patrick McCaw,21-077,G,1/10/17,GSW,,MIA,W,1,19,1,3,0.333,0,1,0,1,2,0.5,0,0,,0,3,3
17694,Patrick McCaw,21-031,G,11/25/16,GSW,@,LAL,W,0,12,1,2,0.5,0,0,,1,2,0.5,0,0,,0,1,1
17695,Patrick McCaw,21-046,G,12/10/16,GSW,@,MEM,L,0,21,1,3,0.333,0,1,0,1,2,0.5,0,0,,0,4,4
17696,Patrick McCaw,21-090,G,1/23/17,GSW,@,MIA,L,0,18,1,2,0.5,0,0,,1,2,0.5,0,0,,0,0,0
17697,Patrick McCaw,21-003,G,10/28/16,GSW,@,NOP,W,0,10,1,1,1,0,0,,1,1,1,0,0,,0,0,0
17698,Patrick McCaw,21-106,G,2/8/17,GSW,,CHI,W,0,9,1,3,0.333,0,1,0,1,2,0.5,0,0,,0,1,1
17699,Patrick McCaw,21-058,G,12/22/16,GSW,@,BRK,W,0,8,1,2,0.5,0,1,0,1,1,1,0,0,,0,0,0
17700,Patrick McCaw,21-025,G,11/19/16,GSW,@,MIL,W,0,17,1,4,0.25,0,1,0,1,3,0.333,0,0,,1,0,1
17701,Sheldon McClellan,24-037,G,1/27/17,WAS,@,ATL,W,0,9,1,2,0.5,0,0,,1,2,0.5,0,0,,0,4,4
17702,T.J. McConnell,24-264,G,12/14/16,PHI,,TOR,L,0,20,1,2,0.5,1,2,0.5,0,0,,1,2,0.5,0,3,3
17703,Chris McCullough,21-345,F,1/15/17,BRK,,HOU,L,0,6,1,1,1,1,1,1,0,0,,1,2,0.5,0,0,0
17704,K.J. McDaniels,24-029,G-F,3/10/17,BRK,@,DAL,L,0,2,1,1,1,1,1,1,0,0,,1,1,1,0,1,1
17705,K.J. McDaniels,23-279,G-F,11/14/16,HOU,,PHI,W,0,6,1,2,0.5,0,0,,1,2,0.5,0,0,,0,2,2
17706,Doug McDermott,25-018,F,1/21/17,CHI,,SAC,W,0,21,1,5,0.2,0,2,0,1,3,0.333,0,0,,0,0,0
17707,Doug McDermott,25-034,F,2/6/17,CHI,@,SAC,W,0,9,1,1,1,1,1,1,0,0,,1,4,0.25,1,0,1
17708,JaVale McGee,29-050,C,3/10/17,GSW,@,MIN,L,0,9,1,2,0.5,1,2,0.5,0,0,,1,2,0.5,1,2,3
17709,JaVale McGee,29-016,C,2/4/17,GSW,@,SAC,L,1,13,1,3,0.333,1,3,0.333,0,0,,1,1,1,1,1,2
17710,Rodney McGruder,25-140,G,12/16/16,MIA,,LAC,L,1,34,1,6,0.167,0,2,0,1,4,0.25,0,0,,1,4,5
17711,Rodney McGruder,25-161,G,1/6/17,MIA,@,LAL,L,1,19,1,4,0.25,0,2,0,1,2,0.5,0,0,,0,2,2
17712,Rodney McGruder,25-159,G,1/4/17,MIA,@,SAC,W,1,25,1,5,0.2,1,2,0.5,0,3,0,1,2,0.5,1,5,6
17713,Rodney McGruder,25-178,G,1/23/17,MIA,,GSW,W,1,28,1,5,0.2,1,3,0.333,0,2,0,1,4,0.25,0,3,3
17714,Rodney McGruder,25-124,G,11/30/16,MIA,@,DEN,W,1,25,1,6,0.167,0,4,0,1,2,0.5,0,0,,4,3,7
17715,Rodney McGruder,25-174,G,1/19/17,MIA,,DAL,W,1,24,1,4,0.25,0,2,0,1,2,0.5,0,0,,1,4,5
17716,Rodney McGruder,25-165,G,1/10/17,MIA,@,GSW,L,1,32,1,5,0.2,1,4,0.25,0,1,0,1,2,0.5,2,5,7
17717,Ben McLemore,23-264,G,11/1/16,SAC,@,MIA,L,0,18,1,7,0.143,0,3,0,1,4,0.25,0,0,,0,1,1
17718,Jordan McRae,25-332,G,2/23/17,CLE,,NYK,W,0,3,1,1,1,0,0,,1,1,1,0,0,,0,0,0
17719,Jordan McRae,25-248,G,12/1/16,CLE,,LAC,L,0,6,1,3,0.333,0,2,0,1,1,1,0,0,,0,1,1
17720,Josh McRoberts,29-299,F,12/23/16,MIA,@,NOP,L,1,15,1,3,0.333,0,1,0,1,2,0.5,0,0,,0,2,2
17721,Jodie Meeks,29-121,G,12/20/16,ORL,@,MIA,W,0,13,1,5,0.2,0,3,0,1,2,0.5,0,0,,0,1,1
17722,Jodie Meeks,29-140,G,1/8/17,ORL,@,LAL,L,0,18,1,5,0.2,0,2,0,1,3,0.333,0,0,,0,1,1
17723,Jodie Meeks,29-111,G,12/10/16,ORL,,DEN,L,0,14,1,4,0.25,0,2,0,1,2,0.5,0,0,,0,1,1
17724,Salah Mejri,30-268,C,3/10/17,DAL,,BRK,W,0,14,1,1,1,1,1,1,0,0,,1,2,0.5,1,8,9
17725,Salah Mejri,30-225,C,1/26/17,DAL,@,OKC,L,0,17,1,2,0.5,1,2,0.5,0,0,,1,2,0.5,3,3,6
17726,Salah Mejri,30-169,C,12/1/16,DAL,@,CHO,L,1,27,1,4,0.25,1,4,0.25,0,0,,1,2,0.5,5,6,11
17727,Salah Mejri,30-216,C,1/17/17,DAL,@,CHI,W,0,19,1,2,0.5,1,2,0.5,0,0,,1,2,0.5,3,2,5
17728,Jordan Mickey,22-112,F,10/29/16,BOS,@,CHO,W,0,8,1,3,0.333,1,3,0.333,0,0,,1,2,0.5,1,1,2
17729,C.J. Miles,29-273,G-F,1/16/17,IND,,NOP,W,0,14,1,7,0.143,1,4,0.25,0,3,0,1,1,1,1,2,3
17730,C.J. Miles,29-298,G-F,2/10/17,IND,@,WAS,L,1,21,1,6,0.167,0,1,0,1,5,0.2,0,0,,0,2,2
17731,C.J. Miles,29-260,G-F,1/3/17,IND,@,DET,W,0,12,1,4,0.25,0,1,0,1,3,0.333,0,0,,0,3,3
17732,Mike Miller,36-335,F-G,1/19/17,DEN,@,SAS,L,0,11,1,4,0.25,0,2,0,1,2,0.5,0,0,,1,2,3
17733,Patty Mills,28-161,G,1/19/17,SAS,,DEN,W,0,16,1,5,0.2,0,2,0,1,3,0.333,0,2,0,0,1,1
17734,Patty Mills,28-169,G,1/27/17,SAS,@,NOP,L,0,22,1,6,0.167,0,2,0,1,4,0.25,0,0,,1,0,1
17735,Patty Mills,28-133,G,12/22/16,SAS,@,LAC,L,0,17,1,5,0.2,0,2,0,1,3,0.333,0,0,,0,2,2
17736,Patty Mills,28-205,G,3/4/17,SAS,,MIN,W,0,32,1,9,0.111,0,3,0,1,6,0.167,0,0,,0,1,1
17737,Nikola Mirotic,25-333,F,1/9/17,CHI,,OKC,L,0,16,1,4,0.25,0,0,,1,4,0.25,0,0,,0,1,1
17738,E'Twaun Moore,27-327,G,1/20/17,NOP,,BRK,L,0,17,1,4,0.25,0,2,0,1,2,0.5,0,0,,0,1,1
17739,Marcus Morris,27-196,F,3/17/17,DET,,TOR,L,1,35,1,13,0.077,0,9,0,1,4,0.25,0,0,,0,5,5
17740,Anthony Morrow,31-078,G,12/14/16,OKC,@,UTA,L,0,28,1,4,0.25,1,2,0.5,0,2,0,1,2,0.5,1,1,2
17741,Anthony Morrow,31-160,G,3/6/17,CHI,@,DET,L,0,5,1,1,1,0,0,,1,1,1,0,0,,0,0,0
17742,Anthony Morrow,31-141,G,2/15/17,OKC,,NYK,W,0,7,1,2,0.5,0,1,0,1,1,1,0,0,,0,0,0
17743,Anthony Morrow,31-085,G,12/21/16,OKC,@,NOP,W,1,18,1,3,0.333,0,2,0,1,1,1,0,0,,0,1,1
17744,Donatas Motiejunas,26-111,F-C,1/9/17,NOP,@,NYK,W,0,16,1,2,0.5,0,1,0,1,1,1,0,0,,1,2,3
17745,Donatas Motiejunas,26-141,F-C,2/8/17,NOP,,UTA,L,0,20,1,3,0.333,1,2,0.5,0,1,0,1,2,0.5,1,4,5
17746,Emmanuel Mudiay,20-263,G,11/23/16,DEN,@,UTA,L,1,18,1,8,0.125,1,7,0.143,0,1,0,1,2,0.5,0,0,0
17747,Emmanuel Mudiay,20-322,G,1/21/17,DEN,,LAC,W,1,17,0,8,0,0,5,0,0,3,0,3,4,0.75,1,1,2
17748,Shabazz Muhammad,24-017,F-G,11/30/16,MIN,,NYK,L,0,8,1,4,0.25,1,4,0.25,0,0,,1,2,0.5,1,0,1
17749,Shabazz Muhammad,24-025,F-G,12/8/16,MIN,@,TOR,L,0,20,1,3,0.333,1,3,0.333,0,0,,1,2,0.5,2,0,2
17750,Jamal Murray,19-300,G,12/19/16,DEN,,DAL,W,0,14,1,4,0.25,0,2,0,1,2,0.5,0,0,,0,2,2
17751,Mike Muscala,25-134,F-C,11/12/16,ATL,,PHI,W,0,19,1,4,0.25,1,3,0.333,0,1,0,1,2,0.5,2,4,6
17752,Mike Muscala,25-178,F-C,12/26/16,ATL,@,MIN,L,0,18,1,4,0.25,0,0,,1,4,0.25,0,0,,2,0,2
17753,Larry Nance Jr.,23-346,F,12/12/16,LAL,@,SAC,L,0,17,1,3,0.333,1,3,0.333,0,0,,1,2,0.5,1,2,3
17754,Shabazz Napier,25-113,G,11/4/16,POR,@,DAL,W,0,9,1,2,0.5,0,0,,1,2,0.5,0,0,,0,2,2
17755,Shabazz Napier,25-227,G,2/26/17,POR,@,TOR,L,0,9,1,2,0.5,0,0,,1,2,0.5,0,0,,0,1,1
17756,Shabazz Napier,25-124,G,11/15/16,POR,,CHI,L,0,4,1,2,0.5,0,1,0,1,1,1,0,2,0,0,1,1
17757,Shabazz Napier,25-171,G,1/1/17,POR,@,MIN,W,0,9,1,2,0.5,0,0,,1,2,0.5,0,0,,0,1,1
17758,Shabazz Napier,25-214,G,2/13/17,POR,,ATL,L,0,6,1,2,0.5,0,1,0,1,1,1,0,0,,0,0,0
17759,Shabazz Napier,25-233,G,3/4/17,POR,,BRK,W,0,15,1,5,0.2,0,2,0,1,3,0.333,0,0,,1,0,1
17760,Maurice Ndour,24-136,F,11/1/16,NYK,@,DET,L,0,6,1,2,0.5,1,2,0.5,0,0,,1,2,0.5,0,2,2
17761,Jameer Nelson,34-270,G,11/5/16,DEN,@,DET,L,0,24,1,8,0.125,0,4,0,1,4,0.25,0,0,,0,2,2
17762,Jameer Nelson,34-314,G,12/19/16,DEN,,DAL,W,0,15,1,3,0.333,0,0,,1,3,0.333,0,0,,1,0,1
17763,Jameer Nelson,34-331,G,1/5/17,DEN,,SAS,L,0,20,1,5,0.2,0,3,0,1,2,0.5,0,0,,0,0,0
17764,Jameer Nelson,34-323,G,12/28/16,DEN,,MIN,W,0,21,1,4,0.25,0,2,0,1,2,0.5,0,0,,0,2,2
17765,Raul Neto,24-196,G,12/1/16,UTA,,MIA,L,0,7,1,1,1,0,0,,1,1,1,0,0,,0,0,0
17766,Raul Neto,24-272,G,2/15/17,UTA,,POR,W,0,3,1,1,1,1,1,1,0,0,,1,1,1,0,1,1
17767,Andrew Nicholson,27-092,F,3/10/17,BRK,@,DAL,L,0,13,1,4,0.25,0,1,0,1,3,0.333,0,0,,0,6,6
17768,Andrew Nicholson,27-010,F,12/18/16,WAS,,LAC,W,0,13,1,2,0.5,1,2,0.5,0,0,,1,1,1,0,0,0
17769,Joakim Noah,31-342,C,2/1/17,NYK,@,BRK,W,1,13,1,2,0.5,1,2,0.5,0,0,,1,2,0.5,1,6,7
17770,Joakim Noah,31-335,C,1/25/17,NYK,@,DAL,L,1,19,1,3,0.333,1,3,0.333,0,0,,1,2,0.5,2,6,8
17771,Nerlens Noel,22-260,C-F,12/26/16,PHI,@,SAC,L,0,3,1,2,0.5,1,2,0.5,0,0,,1,1,1,0,1,1
17772,Lucas Nogueira,24-175,C,1/17/17,TOR,@,BRK,W,1,7,1,2,0.5,0,1,0,1,1,1,0,0,,1,1,2
17773,Lucas Nogueira,24-143,C,12/16/16,TOR,,ATL,L,0,14,1,4,0.25,1,4,0.25,0,0,,1,2,0.5,2,3,5
17774,Steve Novak,33-200,F,12/30/16,MIL,@,MIN,L,0,3,1,1,1,0,0,,1,1,1,0,0,,0,0,0
17775,Dirk Nowitzki,38-215,F,1/20/17,DAL,,UTA,L,1,25,1,13,0.077,1,9,0.111,0,4,0,1,1,1,2,8,10
17776,Jusuf Nurkic,22-147,C,1/17/17,DEN,@,LAL,W,0,8,1,1,1,1,1,1,0,0,,1,2,0.5,0,3,3
17777,Jusuf Nurkic,22-167,C,2/6/17,DEN,,DAL,W,0,5,1,2,0.5,1,2,0.5,0,0,,1,2,0.5,1,1,2
17778,Jusuf Nurkic,22-142,C,1/12/17,DEN,,IND,W,0,8,1,1,1,1,1,1,0,0,,1,2,0.5,0,2,2
17779,Kyle O'Quinn,26-303,F-C,1/23/17,NYK,@,IND,W,0,8,1,1,1,1,1,1,0,0,,1,2,0.5,0,3,3
17780,Kyle O'Quinn,26-247,F-C,11/28/16,NYK,,OKC,L,0,17,1,4,0.25,1,3,0.333,0,1,0,1,1,1,3,3,6
17781,Kyle O'Quinn,26-228,F-C,11/9/16,NYK,,BRK,W,0,5,1,1,1,1,1,1,0,0,,1,2,0.5,1,1,2
17782,Jahlil Okafor,21-003,C-F,12/18/16,PHI,,BRK,W,1,28,0,9,0,0,9,0,0,0,,3,4,0.75,5,5,10
17783,Kelly Olynyk,25-216,C-F,11/21/16,BOS,@,MIN,W,0,13,1,2,0.5,0,0,,1,2,0.5,0,0,,0,3,3
17784,Kelly Oubre,20-339,F,11/12/16,WAS,@,CHI,L,0,9,1,2,0.5,0,0,,1,2,0.5,0,0,,0,1,1
17785,Kelly Oubre,21-094,F,3/13/17,WAS,@,MIN,L,0,1,1,1,1,0,0,,1,1,1,0,0,,0,0,0
17786,Kelly Oubre,21-040,F,1/18/17,WAS,,MEM,W,0,20,1,3,0.333,1,1,1,0,2,0,1,1,1,0,4,4
17787,Kelly Oubre,21-021,F,12/30/16,WAS,,BRK,W,0,13,1,3,0.333,1,2,0.5,0,1,0,1,1,1,0,1,1
17788,Kelly Oubre,21-077,F,2/24/17,WAS,@,PHI,L,0,19,1,5,0.2,0,2,0,1,3,0.333,0,0,,0,1,1
17789,Kelly Oubre,21-069,F,2/16/17,WAS,@,IND,W,0,16,1,4,0.25,1,2,0.5,0,2,0,1,2,0.5,1,0,1
17790,Kelly Oubre,20-363,F,12/6/16,WAS,,ORL,L,0,21,1,4,0.25,0,2,0,1,2,0.5,0,0,,1,4,5
17791,Kelly Oubre,21-032,F,1/10/17,WAS,,CHI,W,0,23,1,6,0.167,1,3,0.333,0,3,0,1,2,0.5,0,5,5
17792,Zaza Pachulia,32-299,C,12/5/16,GSW,,IND,W,1,18,1,3,0.333,1,3,0.333,0,0,,1,2,0.5,3,2,5
17793,Tony Parker,34-259,G,1/31/17,SAS,,OKC,W,1,25,0,3,0,0,2,0,0,1,0,3,4,0.75,0,6,6
17794,Tony Parker,34-166,G,10/30/16,SAS,@,MIA,W,1,22,1,4,0.25,0,3,0,1,1,1,0,0,,0,2,2
17795,Tony Parker,34-291,G,3/4/17,SAS,,MIN,W,1,17,1,5,0.2,0,2,0,1,3,0.333,0,4,0,0,1,1
17796,Chandler Parsons,28-104,F,2/6/17,MEM,,SAS,W,1,23,1,10,0.1,0,8,0,1,2,0.5,0,0,,0,5,5
17797,Lamar Patterson,25-187,G-F,2/15/17,ATL,@,LAC,L,0,10,1,4,0.25,0,1,0,1,3,0.333,0,0,,0,2,2
17798,Patrick Patterson,27-350,F,2/27/17,TOR,@,NYK,W,0,18,1,6,0.167,0,0,,1,6,0.167,0,0,,0,2,2
17799,Patrick Patterson,28-002,F,3/16/17,TOR,,OKC,L,0,22,0,4,0,0,1,0,0,3,0,3,4,0.75,1,3,4
17800,Patrick Patterson,27-231,F,10/31/16,TOR,,DEN,W,0,33,1,4,0.25,1,3,0.333,0,1,0,1,2,0.5,3,4,7
17801,Patrick Patterson,27-350,F,2/27/17,TOR,@,NYK,W,0,18,1,6,0.167,0,0,,1,6,0.167,0,0,,0,2,2
17802,Patrick Patterson,28-002,F,3/16/17,TOR,,OKC,L,0,22,0,4,0,0,1,0,0,3,0,3,4,0.75,1,3,4
17803,Patrick Patterson,27-231,F,10/31/16,TOR,,DEN,W,0,33,1,4,0.25,1,3,0.333,0,1,0,1,2,0.5,3,4,7
17804,Patrick Patterson,27-226,F,10/26/16,TOR,,DET,W,0,26,1,5,0.2,1,3,0.333,0,2,0,1,2,0.5,0,4,4
17805,Adreian Payne,25-296,F-C,12/11/16,MIN,,GSW,L,0,6,1,3,0.333,1,2,0.5,0,1,0,1,2,0.5,1,2,3
17806,Elfrid Payton,22-283,G,12/1/16,ORL,@,MEM,L,0,29,1,8,0.125,1,7,0.143,0,1,0,1,2,0.5,0,3,3
17807,Paul Pierce,39-071,F-G,12/23/16,LAC,,DAL,L,1,11,1,2,0.5,0,0,,1,2,0.5,0,0,,0,3,3
17808,Paul Pierce,39-115,F-G,2/5/17,LAC,@,BOS,L,1,5,1,2,0.5,0,1,0,1,1,1,0,0,,0,0,0
17809,Miles Plumlee,28-061,C-F,11/1/16,MIL,@,NOP,W,1,14,0,2,0,0,2,0,0,0,,3,4,0.75,0,3,3
17810,Miles Plumlee,28-076,C-F,11/16/16,MIL,@,ATL,L,0,5,1,2,0.5,1,2,0.5,0,0,,1,1,1,2,0,2
17811,Jakob Poeltl,21-114,C,2/6/17,TOR,,LAC,W,0,9,1,2,0.5,1,2,0.5,0,0,,1,1,1,1,2,3
17812,Bobby Portis,22-035,F,3/17/17,CHI,@,WAS,L,1,16,1,5,0.2,1,3,0.333,0,2,0,1,2,0.5,0,6,6
17813,Bobby Portis,21-294,F,11/30/16,CHI,,LAL,L,0,11,1,2,0.5,1,2,0.5,0,0,,1,2,0.5,4,0,4
17814,Kristaps Porzingis,21-092,F-C,11/2/16,NYK,,HOU,L,1,28,0,4,0,0,4,0,0,0,,3,4,0.75,2,6,8
17815,Dwight Powell,25-198,F-C,2/3/17,DAL,@,POR,W,0,8,1,1,1,1,1,1,0,0,,1,2,0.5,0,2,2
17816,Dwight Powell,25-222,F-C,2/27/17,DAL,,MIA,W,0,6,1,1,1,1,1,1,0,0,,1,2,0.5,0,1,1
17817,Dwight Powell,25-119,F-C,11/16/16,DAL,@,BOS,L,0,29,1,8,0.125,1,7,0.143,0,1,0,1,2,0.5,1,7,8
17818,Norman Powell,23-278,G,2/27/17,TOR,@,NYK,W,0,18,1,6,0.167,0,4,0,1,2,0.5,0,0,,1,4,5
17819,Norman Powell,23-189,G,11/30/16,TOR,,MEM,W,0,4,1,1,1,0,0,,1,1,1,0,0,,0,0,0
17820,Norman Powell,23-275,G,2/24/17,TOR,,BOS,W,0,17,1,5,0.2,1,4,0.25,0,1,0,1,2,0.5,0,4,4
17821,Norman Powell,23-175,G,11/16/16,TOR,,GSW,L,0,11,1,2,0.5,0,1,0,1,1,1,0,0,,0,1,1
17822,Ronnie Price,33-235,G,2/11/17,PHO,@,HOU,L,0,5,1,1,1,0,0,,1,1,1,0,0,,0,0,0
17823,Tim Quarterman,22-027,G,11/23/16,POR,@,CLE,L,0,4,1,1,1,0,0,,1,1,1,0,0,,0,0,0
17824,Tim Quarterman,22-111,G,2/15/17,POR,@,UTA,L,0,4,1,3,0.333,0,2,0,1,1,1,0,0,,0,0,0
17825,Chasson Randle,23-351,G,1/21/17,PHI,@,ATL,L,0,3,1,1,1,0,0,,1,1,1,0,0,,0,0,0
17826,Chasson Randle,23-344,G,1/14/17,PHI,@,WAS,L,0,6,1,1,1,0,0,,1,1,1,0,0,,0,0,0
17827,Julius Randle,21-359,F,11/22/16,LAL,,OKC,W,1,21,1,5,0.2,0,4,0,1,1,1,0,0,,0,5,5
17828,J.J. Redick,32-255,G,3/6/17,LAC,,BOS,W,1,18,1,5,0.2,0,3,0,1,2,0.5,0,0,,0,2,2
17829,Willie Reed,26-275,F-C,2/15/17,MIA,@,HOU,W,0,16,1,2,0.5,1,2,0.5,0,0,,1,2,0.5,2,4,6
17830,Willie Reed,26-201,F-C,12/3/16,MIA,@,POR,L,0,7,1,1,1,1,1,1,0,0,,1,2,0.5,1,1,2
17831,Josh Richardson,23-177,G,3/11/17,MIA,,TOR,W,0,22,1,4,0.25,1,3,0.333,0,1,0,1,2,0.5,0,3,3
17832,Malachi Richardson,21-022,G,1/27/17,SAC,@,IND,L,0,4,1,2,0.5,0,1,0,1,1,1,0,0,,0,0,0
17833,Malachi Richardson,21-036,G,2/10/17,SAC,,ATL,W,0,8,1,1,1,0,0,,1,1,1,0,0,,0,0,0
17834,Malachi Richardson,20-305,G,11/5/16,SAC,@,MIL,L,0,6,1,3,0.333,0,0,,1,3,0.333,0,0,,0,0,0
17835,Malachi Richardson,21-034,G,2/8/17,SAC,,BOS,W,0,4,1,2,0.5,0,1,0,1,1,1,0,0,,0,1,1
17836,Malachi Richardson,21-016,G,1/21/17,SAC,@,CHI,L,0,8,1,2,0.5,1,1,1,0,1,0,1,2,0.5,0,2,2
17837,Malachi Richardson,21-038,G,2/12/17,SAC,,NOP,W,0,13,1,4,0.25,1,2,0.5,0,2,0,1,1,1,0,1,1
17838,Austin Rivers,24-105,G,11/14/16,LAC,,BRK,W,0,25,1,6,0.167,1,4,0.25,0,2,0,1,2,0.5,0,3,3
17839,Austin Rivers,24-112,G,11/21/16,LAC,,TOR,W,0,16,1,5,0.2,1,5,0.2,0,0,,1,1,1,0,1,1
17840,Austin Rivers,24-110,G,11/19/16,LAC,,CHI,W,0,21,1,2,0.5,1,1,1,0,1,0,1,2,0.5,0,2,2
17841,Andre Roberson,25-086,G-F,2/28/17,OKC,,UTA,W,1,30,1,2,0.5,0,1,0,1,1,1,0,0,,0,4,4
17842,Andre Roberson,25-045,G-F,1/18/17,OKC,@,GSW,L,1,34,1,7,0.143,1,4,0.25,0,3,0,1,2,0.5,1,1,2
17843,Brian Roberts,31-098,G,3/11/17,CHO,,NOP,L,0,13,1,4,0.25,0,2,0,1,2,0.5,0,0,,0,1,1
17844,Brian Roberts,31-091,G,3/4/17,CHO,@,DEN,W,0,10,1,5,0.2,0,3,0,1,2,0.5,0,0,,0,1,1
17845,Glenn Robinson,22-306,G-F,11/9/16,IND,,PHI,W,0,7,1,2,0.5,0,1,0,1,1,1,0,0,,0,0,0
17846,Glenn Robinson,22-339,G-F,12/12/16,IND,,CHO,W,1,33,1,2,0.5,0,0,,1,2,0.5,0,0,,1,5,6
17847,Glenn Robinson,22-353,G-F,12/26/16,IND,@,CHI,L,1,32,1,5,0.2,0,2,0,1,3,0.333,0,0,,2,4,6
17848,Glenn Robinson,22-347,G-F,12/20/16,IND,@,NYK,L,1,33,1,7,0.143,1,6,0.167,0,1,0,1,2,0.5,3,0,3
17849,Glenn Robinson,23-070,G-F,3/19/17,IND,@,TOR,L,0,17,0,4,0,0,1,0,0,3,0,3,4,0.75,1,3,4
17850,Thomas Robinson,25-263,F,12/5/16,LAL,,UTA,L,0,16,1,2,0.5,1,2,0.5,0,0,,1,2,0.5,1,5,6
17851,Sergio Rodriguez,30-216,G,1/14/17,PHI,@,WAS,L,0,20,1,6,0.167,0,3,0,1,3,0.333,0,0,,0,1,1
17852,Sergio Rodriguez,30-231,G,1/29/17,PHI,@,CHI,L,0,6,1,2,0.5,0,0,,1,2,0.5,0,0,,0,0,0
17853,Sergio Rodriguez,30-275,G,3/14/17,PHI,@,GSW,L,0,17,1,7,0.143,0,1,0,1,6,0.167,0,0,,1,0,1
17854,Sergio Rodriguez,30-200,G,12/29/16,PHI,@,UTA,L,1,16,1,6,0.167,0,2,0,1,4,0.25,0,0,,0,2,2
17855,Sergio Rodriguez,30-273,G,3/12/17,PHI,@,LAL,W,0,18,1,6,0.167,0,3,0,1,3,0.333,0,0,,1,0,1
17856,Rajon Rondo,30-347,G,2/3/17,CHI,@,HOU,L,0,20,1,5,0.2,0,3,0,1,2,0.5,0,0,,2,3,5
17857,Rajon Rondo,30-303,G,12/21/16,CHI,,WAS,L,1,34,1,10,0.1,0,8,0,1,2,0.5,0,0,,1,5,6
17858,Rajon Rondo,30-338,G,1/25/17,CHI,,ATL,L,0,10,1,1,1,1,1,1,0,0,,1,2,0.5,0,1,1
17859,Rajon Rondo,30-354,G,2/10/17,CHI,@,PHO,L,0,23,1,4,0.25,0,2,0,1,2,0.5,0,0,,1,2,3
17860,Derrick Rose,28-041,G,11/14/16,NYK,,DAL,W,1,28,1,6,0.167,1,5,0.2,0,1,0,1,2,0.5,0,4,4
17861,Terrence Ross,25-299,F-G,11/30/16,TOR,,MEM,W,0,17,1,6,0.167,0,1,0,1,5,0.2,0,0,,0,1,1
17862,Terrence Ross,26-001,F-G,2/6/17,TOR,,LAC,W,0,19,1,4,0.25,0,0,,1,4,0.25,0,0,,1,2,3
17863,Terry Rozier,22-281,G,12/23/16,BOS,,OKC,L,0,8,1,2,0.5,0,1,0,1,1,1,0,0,,0,2,2
17864,Terry Rozier,22-325,G,2/5/17,BOS,,LAC,W,0,12,1,2,0.5,0,0,,1,2,0.5,0,0,,1,2,3
17865,Terry Rozier,22-258,G,11/30/16,BOS,,DET,L,0,15,1,5,0.2,1,3,0.333,0,2,0,1,1,1,0,2,2
17866,Terry Rozier,22-253,G,11/25/16,BOS,,SAS,L,0,20,1,3,0.333,1,1,1,0,2,0,1,1,1,0,2,2
17867,Ricky Rubio,26-066,G,12/26/16,MIN,,ATL,W,1,24,1,4,0.25,0,1,0,1,3,0.333,0,0,,1,0,1
17868,Ricky Rubio,26-065,G,12/25/16,MIN,@,OKC,L,1,30,1,4,0.25,1,4,0.25,0,0,,1,1,1,2,4,6
17869,Ricky Rubio,26-042,G,12/2/16,MIN,@,NYK,L,1,30,1,4,0.25,1,2,0.5,0,2,0,1,1,1,1,2,3
17870,Damjan Rudez,30-147,F,11/11/16,ORL,,UTA,L,0,16,1,1,1,0,0,,1,1,1,0,0,,1,1,2
17871,Damjan Rudez,30-184,F,12/18/16,ORL,,TOR,L,0,10,1,2,0.5,0,0,,1,2,0.5,0,0,,0,1,1
17872,Damjan Rudez,30-180,F,12/14/16,ORL,,LAC,L,0,5,1,3,0.333,0,1,0,1,2,0.5,0,0,,1,1,2
17873,Damjan Rudez,30-176,F,12/10/16,ORL,,DEN,L,0,6,1,1,1,0,0,,1,1,1,0,0,,0,0,0
17874,Damjan Rudez,30-226,F,1/29/17,ORL,@,TOR,W,0,7,1,2,0.5,0,1,0,1,1,1,0,0,,0,1,1
17875,Damjan Rudez,30-150,F,11/14/16,ORL,@,IND,L,0,13,1,1,1,0,0,,1,1,1,0,0,,0,1,1
17876,Brandon Rush,31-155,G-F,12/9/16,MIN,,DET,L,0,12,1,1,1,0,0,,1,1,1,0,0,,0,1,1
17877,D'Angelo Russell,20-292,G,12/11/16,LAL,,NYK,L,1,17,1,8,0.125,0,5,0,1,3,0.333,0,0,,0,0,0
17878,Domantas Sabonis,20-194,F,11/13/16,OKC,,ORL,L,1,18,1,6,0.167,0,2,0,1,4,0.25,0,0,,0,2,2
17879,Domantas Sabonis,20-207,F,11/26/16,OKC,,DET,W,1,24,1,4,0.25,0,2,0,1,2,0.5,0,0,,1,2,3
17880,Domantas Sabonis,20-306,F,3/5/17,OKC,@,DAL,L,1,20,1,5,0.2,1,3,0.333,0,2,0,1,2,0.5,0,7,7
17881,Domantas Sabonis,20-203,F,11/22/16,OKC,@,LAL,L,1,22,1,3,0.333,0,1,0,1,2,0.5,0,0,,0,4,4
17882,Domantas Sabonis,20-220,F,12/9/16,OKC,,HOU,L,1,24,1,5,0.2,0,2,0,1,3,0.333,0,0,,0,3,3
17883,Domantas Sabonis,20-236,F,12/25/16,OKC,,MIN,W,1,20,1,5,0.2,1,2,0.5,0,3,0,1,1,1,1,6,7
17884,Domantas Sabonis,20-232,F,12/21/16,OKC,@,NOP,W,1,12,1,3,0.333,0,1,0,1,2,0.5,0,0,,0,4,4
17885,Domantas Sabonis,20-195,F,11/14/16,OKC,@,DET,L,1,23,1,5,0.2,0,2,0,1,3,0.333,0,0,,0,1,1
17886,Dario Saric,22-288,F,1/21/17,PHI,@,ATL,L,0,15,1,10,0.1,0,5,0,1,5,0.2,0,0,,0,4,4
17887,Dario Saric,22-287,F,1/20/17,PHI,,POR,W,0,24,1,12,0.083,0,7,0,1,5,0.2,0,0,,2,4,6
17888,Dario Saric,22-229,F,11/23/16,PHI,,MEM,L,0,22,1,6,0.167,0,1,0,1,5,0.2,0,0,,2,3,5
17889,Dario Saric,22-227,F,11/21/16,PHI,,MIA,W,0,17,1,4,0.25,0,1,0,1,3,0.333,0,0,,0,4,4
17890,Dario Saric,22-211,F,11/5/16,PHI,,CLE,L,1,18,1,5,0.2,1,4,0.25,0,1,0,1,2,0.5,0,7,7
17891,Dario Saric,22-278,F,1/11/17,PHI,,NYK,W,0,21,1,8,0.125,0,5,0,1,3,0.333,0,0,,1,2,3
17892,Tomas Satoransky,25-081,G,1/19/17,WAS,@,NYK,W,0,14,1,2,0.5,0,1,0,1,1,1,0,0,,0,2,2
17893,Tomas Satoransky,25-095,G,2/2/17,WAS,,LAL,W,0,9,1,2,0.5,0,1,0,1,1,1,0,0,,1,2,3
17894,Tomas Satoransky,25-129,G,3/8/17,WAS,@,DEN,W,0,5,1,2,0.5,0,1,0,1,1,1,0,0,,0,0,0
17895,Mike Scott,28-184,F,1/16/17,ATL,@,NYK,W,0,10,1,5,0.2,0,3,0,1,2,0.5,0,0,,1,1,2
17896,Thabo Sefolosha,32-244,G-F,1/1/17,ATL,,SAS,W,1,16,0,3,0,0,2,0,0,1,0,3,4,0.75,1,1,2
17897,Thabo Sefolosha,32-259,G-F,1/16/17,ATL,@,NYK,W,1,22,1,4,0.25,0,2,0,1,2,0.5,0,0,,0,4,4
17898,Thabo Sefolosha,32-256,G-F,1/13/17,ATL,,BOS,L,1,24,0,3,0,0,1,0,0,2,0,3,4,0.75,0,3,3
17899,Thabo Sefolosha,32-197,G-F,11/15/16,ATL,@,MIA,W,0,23,0,2,0,0,0,,0,2,0,3,4,0.75,0,2,2
17900,Wayne Selden,22-166,G-F,3/15/17,NOP,@,MIA,L,1,13,1,2,0.5,0,0,,1,2,0.5,0,0,,0,1,1
17901,Ramon Sessions,30-271,G,1/7/17,CHO,@,SAS,L,0,15,1,6,0.167,1,5,0.2,0,1,0,1,2,0.5,0,1,1
17902,Ramon Sessions,30-200,G,10/28/16,CHO,@,MIA,W,0,17,1,9,0.111,1,7,0.143,0,2,0,1,2,0.5,1,3,4
17903,Ramon Sessions,30-214,G,11/11/16,CHO,,TOR,L,0,16,1,4,0.25,0,2,0,1,2,0.5,0,0,,0,1,1
17904,Iman Shumpert,26-190,G,1/2/17,CLE,,NOP,W,0,31,1,7,0.143,1,4,0.25,0,3,0,1,2,0.5,2,2,4
17905,Iman Shumpert,26-246,G,2/27/17,CLE,,MIL,W,1,31,1,4,0.25,0,1,0,1,3,0.333,0,0,,0,4,4
17906,Pascal Siakam,22-332,F,1/1/17,TOR,@,LAL,W,1,31,1,4,0.25,1,4,0.25,0,0,,1,2,0.5,1,9,10
17907,Pascal Siakam,23-004,F,2/8/17,TOR,@,MIN,L,1,20,1,2,0.5,1,2,0.5,0,0,,1,4,0.25,3,2,5
17908,Jonathon Simmons,27-102,G-F,12/25/16,SAS,,CHI,W,0,12,1,4,0.25,0,2,0,1,2,0.5,0,0,,0,0,0
17909,Jonathon Simmons,27-051,G-F,11/4/16,SAS,@,UTA,W,0,21,1,3,0.333,1,3,0.333,0,0,,1,2,0.5,0,4,4
17910,Jonathon Simmons,27-115,G-F,1/7/17,SAS,,CHO,W,0,19,1,6,0.167,0,4,0,1,2,0.5,0,0,,0,2,2
17911,Jonathon Simmons,27-097,G-F,12/20/16,SAS,@,HOU,W,0,10,1,2,0.5,1,2,0.5,0,0,,1,2,0.5,0,2,2
17912,Jonathon Simmons,27-077,G-F,11/30/16,SAS,@,DAL,W,0,23,1,5,0.2,1,5,0.2,0,0,,1,2,0.5,1,0,1
17913,Kyle Singler,28-241,F,12/31/16,OKC,,LAC,W,0,5,1,1,1,0,0,,1,1,1,0,0,,0,2,2
17914,Kyle Singler,28-233,F,12/23/16,OKC,@,BOS,W,0,8,1,2,0.5,0,0,,1,2,0.5,0,0,,0,0,0
17915,Marcus Smart,22-271,G,12/2/16,BOS,,SAC,W,0,23,1,4,0.25,0,1,0,1,3,0.333,0,0,,0,1,1
17916,Ish Smith,28-165,G,12/17/16,DET,,IND,L,0,19,1,4,0.25,1,2,0.5,0,2,0,1,1,1,0,1,1
17917,Ish Smith,28-182,G,1/3/17,DET,,IND,L,0,16,1,2,0.5,0,0,,1,2,0.5,0,2,0,0,0,0
17918,Ish Smith,28-223,G,2/13/17,DET,@,MIL,L,0,17,1,4,0.25,1,4,0.25,0,0,,1,2,0.5,0,3,3
17919,J.R. Smith,31-083,G-F,12/1/16,CLE,,LAC,L,1,24,1,3,0.333,0,0,,1,3,0.333,0,0,,0,2,2
17920,J.R. Smith,31-181,G-F,3/9/17,CLE,@,DET,L,0,19,1,9,0.111,0,1,0,1,8,0.125,0,0,,0,1,1
17921,J.R. Smith,31-055,G-F,11/3/16,CLE,,BOS,W,1,35,1,5,0.2,0,1,0,1,4,0.25,0,0,,0,2,2
17922,J.R. Smith,31-077,G-F,11/25/16,CLE,,DAL,W,1,26,1,11,0.091,0,1,0,1,10,0.1,0,0,,0,2,2
17923,Jason Smith,30-351,F-C,2/16/17,WAS,@,IND,W,0,13,1,2,0.5,0,1,0,1,1,1,0,0,,1,2,3
17924,Jason Smith,30-299,F-C,12/26/16,WAS,,MIL,W,0,6,1,1,1,1,1,1,0,0,,1,2,0.5,0,1,1
17925,Jason Smith,30-296,F-C,12/23/16,WAS,@,MIL,L,0,11,1,1,1,1,1,1,0,0,,1,1,1,0,1,1
17926,Jason Smith,30-328,F-C,1/24/17,WAS,,BOS,W,0,14,1,2,0.5,1,2,0.5,0,0,,1,2,0.5,1,2,3
17927,Tony Snell,24-361,G-F,11/5/16,MIL,,SAC,W,1,23,1,6,0.167,0,1,0,1,5,0.2,0,0,,1,5,6
17928,Tony Snell,25-029,G-F,12/9/16,MIL,,ATL,L,1,31,1,5,0.2,0,1,0,1,4,0.25,0,0,,0,5,5
17929,Tony Snell,25-113,G-F,3/3/17,MIL,,LAC,W,1,23,1,4,0.25,0,2,0,1,2,0.5,0,0,,0,3,3
17930,Tony Snell,25-041,G-F,12/21/16,MIL,@,CLE,L,1,20,1,3,0.333,0,2,0,1,1,1,0,0,,1,0,1
17931,Tony Snell,25-055,G-F,1/4/17,MIL,@,NYK,W,1,20,1,5,0.2,0,0,,1,5,0.2,0,0,,0,3,3
17932,Marreese Speights,29-172,C-F,1/23/17,LAC,@,ATL,W,0,10,1,2,0.5,0,1,0,1,1,1,0,0,,0,1,1
17933,Marreese Speights,29-221,C-F,3/13/17,LAC,@,UTA,L,0,11,1,3,0.333,0,1,0,1,2,0.5,0,0,,0,0,0
17934,Marreese Speights,29-204,C-F,2/24/17,LAC,,SAS,L,0,15,1,6,0.167,0,3,0,1,3,0.333,0,0,,1,3,4
17935,Marreese Speights,29-113,C-F,11/25/16,LAC,@,DET,L,0,14,1,7,0.143,1,5,0.2,0,2,0,1,2,0.5,1,1,2
17936,Nik Stauskas,23-033,G,11/9/16,PHI,@,IND,L,0,17,1,2,0.5,0,0,,1,2,0.5,0,0,,0,1,1
17937,Nik Stauskas,23-153,G,3/9/17,PHI,@,POR,L,1,26,0,6,0,0,2,0,0,4,0,3,4,0.75,0,0,0
17938,Rodney Stuckey,30-318,G,3/5/17,IND,@,ATL,W,0,16,1,5,0.2,0,4,0,1,1,1,0,2,0,0,2,2
17939,Rodney Stuckey,30-293,G,2/8/17,IND,,CLE,L,0,12,1,5,0.2,1,4,0.25,0,1,0,1,2,0.5,0,1,1
17940,Jared Sullinger,24-322,F,1/20/17,TOR,@,CHO,L,0,17,1,5,0.2,0,1,0,1,4,0.25,0,0,,0,2,2
17941,Mirza Teletovic,31-094,F,12/21/16,MIL,@,CLE,L,0,19,1,4,0.25,1,1,1,0,3,0,1,2,0.5,0,5,5
17942,Mirza Teletovic,31-162,F,2/27/17,MIL,@,CLE,L,0,9,1,3,0.333,0,1,0,1,2,0.5,0,0,,0,0,0
17943,Mirza Teletovic,31-176,F,3/13/17,MIL,@,MEM,L,0,14,1,1,1,0,0,,1,1,1,0,0,,0,2,2
17944,Mirza Teletovic,31-046,F,11/3/16,MIL,,IND,W,0,15,1,3,0.333,0,0,,1,3,0.333,0,0,,0,0,0
17945,Mirza Teletovic,31-171,F,3/8/17,MIL,,NYK,W,0,7,1,1,1,1,1,1,0,0,,1,2,0.5,0,0,0
17946,Mirza Teletovic,31-062,F,11/19/16,MIL,,GSW,L,0,12,1,5,0.2,0,0,,1,5,0.2,0,0,,0,3,3
17947,Mirza Teletovic,31-060,F,11/17/16,MIL,@,MIA,L,0,12,1,3,0.333,0,0,,1,3,0.333,0,0,,0,1,1
17948,Mirza Teletovic,31-145,F,2/10/17,MIL,,LAL,L,0,19,1,6,0.167,0,1,0,1,5,0.2,0,0,,0,3,3
17949,Mirza Teletovic,31-143,F,2/8/17,MIL,,MIA,L,0,13,1,5,0.2,0,2,0,1,3,0.333,0,0,,0,2,2
17950,Mirza Teletovic,31-166,F,3/3/17,MIL,,LAC,W,0,11,1,5,0.2,0,1,0,1,4,0.25,0,0,,0,2,2
17951,Garrett Temple,30-174,G,10/29/16,SAC,,MIN,W,0,14,1,3,0.333,0,0,,1,3,0.333,0,0,,0,0,0
17952,Garrett Temple,30-204,G,11/28/16,SAC,@,WAS,L,0,28,1,5,0.2,0,2,0,1,3,0.333,0,1,0,1,0,1
17953,Garrett Temple,30-268,G,1/31/17,SAC,@,HOU,L,1,18,1,4,0.25,0,1,0,1,3,0.333,0,0,,0,3,3
17954,Garrett Temple,30-203,G,11/27/16,SAC,@,BRK,W,0,27,1,6,0.167,1,3,0.333,0,3,0,1,1,1,0,3,3
17955,Garrett Temple,30-237,G,12/31/16,SAC,,MEM,L,0,31,1,5,0.2,0,1,0,1,4,0.25,0,0,,1,2,3
17956,Garrett Temple,30-216,G,12/10/16,SAC,@,UTA,L,0,24,1,5,0.2,1,4,0.25,0,1,0,1,1,1,1,1,2
17957,Jason Terry,39-170,G,3/4/17,MIL,,TOR,W,0,21,1,4,0.25,0,0,,1,4,0.25,0,0,,0,3,3
17958,Jason Terry,39-079,G,12/3/16,MIL,,BRK,W,0,17,1,3,0.333,0,1,0,1,2,0.5,0,0,,0,1,1
17959,Jason Terry,39-058,G,11/12/16,MIL,,MEM,W,0,22,1,2,0.5,0,1,0,1,1,1,0,0,,0,1,1
17960,Jason Terry,39-077,G,12/1/16,MIL,@,BRK,W,0,14,1,5,0.2,0,1,0,1,4,0.25,0,0,,0,0,0
17961,Jason Terry,39-109,G,1/2/17,MIL,,OKC,W,0,16,1,3,0.333,0,1,0,1,2,0.5,0,0,,0,0,0
17962,Jason Terry,39-167,G,3/1/17,MIL,,DEN,L,0,22,1,3,0.333,0,1,0,1,2,0.5,0,0,,1,1,2
17963,Jason Terry,39-075,G,11/29/16,MIL,,CLE,W,0,23,1,4,0.25,0,1,0,1,3,0.333,0,0,,0,1,1
17964,Jason Terry,39-091,G,12/15/16,MIL,,CHI,W,0,17,1,2,0.5,0,1,0,1,1,1,0,0,,0,1,1
17965,Jason Terry,39-106,G,12/30/16,MIL,@,MIN,L,0,23,1,1,1,0,0,,1,1,1,0,0,,0,1,1
17966,Jason Terry,39-122,G,1/15/17,MIL,@,ATL,L,0,22,1,3,0.333,0,0,,1,3,0.333,0,0,,0,4,4
17967,Jason Terry,39-164,G,2/26/17,MIL,,PHO,W,0,16,1,1,1,0,0,,1,1,1,0,0,,0,0,0
17968,Jason Terry,39-086,G,12/10/16,MIL,@,WAS,L,0,11,1,2,0.5,0,0,,1,2,0.5,0,0,,0,0,0
17969,Jason Terry,39-104,G,12/28/16,MIL,@,DET,W,0,20,1,3,0.333,0,0,,1,3,0.333,0,0,,2,2,4
17970,Jason Terry,39-135,G,1/28/17,MIL,,BOS,L,0,20,1,6,0.167,0,2,0,1,4,0.25,0,0,,0,1,1
17971,Jason Terry,39-117,G,1/10/17,MIL,@,SAS,W,0,17,1,2,0.5,0,0,,1,2,0.5,0,0,,0,0,0
17972,Jason Terry,39-148,G,2/10/17,MIL,,LAL,L,0,16,1,1,1,0,0,,1,1,1,0,0,,1,0,1
17973,Jason Terry,39-187,G,3/21/17,MIL,@,POR,W,0,22,1,3,0.333,0,2,0,1,1,1,0,0,,0,3,3
17974,Lance Thomas,28-192,F,11/2/16,NYK,,HOU,L,0,10,1,2,0.5,0,1,0,1,1,1,0,0,,0,2,2
17975,Lance Thomas,28-245,F,12/25/16,NYK,,BOS,L,0,9,1,3,0.333,1,2,0.5,0,1,0,1,1,1,2,0,2
17976,Lance Thomas,28-258,F,1/7/17,NYK,@,IND,L,0,16,1,3,0.333,0,1,0,1,2,0.5,0,0,,1,0,1
17977,Lance Thomas,28-222,F,12/2/16,NYK,,MIN,W,0,3,1,2,0.5,0,0,,1,2,0.5,0,0,,0,0,0
17978,Lance Thomas,28-297,F,2/15/17,NYK,@,OKC,L,0,15,1,2,0.5,1,2,0.5,0,0,,1,1,1,1,3,4
17979,Hollis Thompson,25-238,G-F,11/27/16,PHI,,CLE,L,0,19,1,3,0.333,0,1,0,1,2,0.5,0,0,,0,2,2
17980,Hollis Thompson,25-326,G-F,2/23/17,NOP,,HOU,L,0,5,1,3,0.333,1,2,0.5,0,1,0,1,2,0.5,0,0,0
17981,Hollis Thompson,25-337,G-F,3/6/17,NOP,@,UTA,L,1,8,1,4,0.25,0,0,,1,4,0.25,0,0,,0,2,2
17982,Hollis Thompson,25-209,G-F,10/29/16,PHI,,ATL,L,0,20,1,4,0.25,0,3,0,1,1,1,0,0,,0,5,5
17983,Hollis Thompson,25-225,G-F,11/14/16,PHI,@,HOU,L,0,14,1,4,0.25,1,4,0.25,0,0,,1,2,0.5,2,0,2
17984,Tristan Thompson,25-269,F-C,12/7/16,CLE,@,NYK,W,1,34,0,5,0,0,5,0,0,0,,3,4,0.75,6,14,20
17985,Tristan Thompson,25-263,F-C,12/1/16,CLE,,LAC,L,1,34,1,3,0.333,1,3,0.333,0,0,,1,2,0.5,4,4,8
17986,Marcus Thornton,29-167,G,11/19/16,WAS,,MIA,L,0,23,1,3,0.333,1,2,0.5,0,1,0,1,1,1,0,1,1
17987,Marcus Thornton,29-212,G,1/3/17,WAS,@,DAL,L,0,15,1,3,0.333,0,0,,1,3,0.333,0,0,,0,0,0
17988,Anthony Tolliver,31-259,F-C,2/15/17,SAC,@,GSW,L,0,29,1,7,0.143,1,2,0.5,0,5,0,1,2,0.5,4,3,7
17989,Anthony Tolliver,31-152,F-C,10/31/16,SAC,@,ATL,L,0,14,1,3,0.333,0,0,,1,3,0.333,0,0,,0,1,1
17990,Anthony Tolliver,31-210,F-C,12/28/16,SAC,@,POR,L,0,29,1,6,0.167,0,2,0,1,4,0.25,0,0,,0,4,4
17991,Anthony Tolliver,31-170,F-C,11/18/16,SAC,,LAC,L,0,5,0,1,0,0,0,,0,1,0,3,3,1,0,0,0
17992,Anthony Tolliver,31-267,F-C,2/23/17,SAC,,DEN,W,1,31,1,5,0.2,0,3,0,1,2,0.5,0,0,,0,8,8
17993,Anthony Tolliver,31-283,F-C,3/11/17,SAC,,DEN,L,0,11,1,4,0.25,0,1,0,1,3,0.333,0,0,,1,1,2
17994,Anthony Tolliver,31-162,F-C,11/10/16,SAC,,LAL,L,0,16,1,3,0.333,0,0,,1,3,0.333,0,0,,2,1,3
17995,P.J. Tucker,31-188,F,11/9/16,PHO,,DET,W,0,20,0,4,0,0,3,0,0,1,0,3,4,0.75,3,3,6
17996,P.J. Tucker,31-282,F,2/11/17,PHO,@,HOU,L,0,21,1,4,0.25,0,3,0,1,1,1,0,0,,1,5,6
17997,P.J. Tucker,31-181,F,11/2/16,PHO,,POR,W,0,20,1,3,0.333,1,2,0.5,0,1,0,1,2,0.5,0,5,5
17998,Evan Turner,28-051,G,12/17/16,POR,@,GSW,L,0,17,1,5,0.2,0,4,0,1,1,1,0,0,,0,1,1
17999,Evan Turner,27-364,G,10/25/16,POR,,UTA,W,0,26,1,7,0.143,1,7,0.143,0,0,,1,1,1,0,5,5
18000,Evan Turner,28-012,G,11/8/16,POR,,PHO,W,0,23,1,3,0.333,0,1,0,1,2,0.5,0,0,,0,2,2
18001,Myles Turner,20-360,F-C,3/19/17,IND,@,TOR,L,1,29,1,4,0.25,1,2,0.5,0,2,0,1,2,0.5,1,4,5
18002,Beno Udrih,34-139,G,11/21/16,DET,,HOU,L,0,16,1,2,0.5,0,1,0,1,1,1,0,0,,0,2,2
18003,Tyler Ulis,21-019,G,1/24/17,PHO,,MIN,L,0,6,1,3,0.333,0,2,0,1,1,1,0,0,,0,1,1
18004,Jonas Valanciunas,24-271,C,2/1/17,TOR,@,BOS,L,1,12,1,1,1,1,1,1,0,0,,1,2,0.5,0,3,3
18005,Denzel Valentine,23-001,G,11/17/16,CHI,@,UTA,W,0,15,1,3,0.333,0,0,,1,3,0.333,0,0,,0,1,1
18006,Denzel Valentine,23-088,G,2/12/17,CHI,@,MIN,L,0,23,1,4,0.25,0,0,,1,4,0.25,0,0,,1,3,4
18007,Denzel Valentine,22-357,G,11/7/16,CHI,,ORL,W,0,6,1,2,0.5,0,1,0,1,1,1,0,0,,0,1,1
18008,Denzel Valentine,23-033,G,12/19/16,CHI,,DET,W,0,12,1,2,0.5,0,0,,1,2,0.5,0,0,,0,4,4
18009,Denzel Valentine,22-352,G,11/2/16,CHI,@,BOS,L,0,7,1,2,0.5,0,1,0,1,1,1,0,0,,0,0,0
18010,Denzel Valentine,22-350,G,10/31/16,CHI,@,BRK,W,0,7,1,3,0.333,0,0,,1,3,0.333,0,0,,0,0,0
18011,Fred VanVleet,22-337,G,1/27/17,TOR,,MIL,W,0,6,1,2,0.5,0,1,0,1,1,1,0,0,,1,0,1
18012,Fred VanVleet,23-004,G,3/1/17,TOR,,WAS,L,0,5,1,3,0.333,0,2,0,1,1,1,0,0,,0,0,0
18013,Anderson Varejao,34-122,F-C,1/28/17,GSW,,LAC,W,0,5,1,1,1,1,1,1,0,0,,1,2,0.5,0,1,1
18014,Rashad Vaughn,20-195,G,2/27/17,MIL,@,CLE,L,0,14,1,4,0.25,0,1,0,1,3,0.333,0,0,,0,5,5
18015,Noah Vonleh,21-202,F,3/14/17,POR,@,NOP,L,1,23,0,2,0,0,2,0,0,0,,3,6,0.5,1,8,9
18016,Nikola Vucevic,26-110,C,2/11/17,ORL,@,DAL,L,1,27,1,5,0.2,1,5,0.2,0,0,,1,2,0.5,2,8,10
18017,Sasha Vujacic,32-297,G,12/30/16,NYK,@,NOP,L,1,22,1,2,0.5,0,0,,1,2,0.5,0,0,,0,2,2
18018,Sasha Vujacic,32-329,G,1/31/17,NYK,@,WAS,L,0,5,0,2,0,0,1,0,0,1,0,3,4,0.75,0,0,0
18019,Sasha Vujacic,33-012,G,3/20/17,NYK,@,LAC,L,0,3,1,3,0.333,0,0,,1,3,0.333,0,0,,0,0,0
18020,Sasha Vujacic,32-246,G,11/9/16,NYK,,BRK,W,0,13,1,5,0.2,0,1,0,1,4,0.25,0,0,,0,5,5
18021,Sasha Vujacic,32-352,G,2/23/17,NYK,@,CLE,L,0,2,1,1,1,0,0,,1,1,1,0,0,,0,0,0
18022,Dion Waiters,25-083,G,3/3/17,MIA,@,ORL,L,1,20,1,11,0.091,1,6,0.167,0,5,0,1,2,0.5,2,0,2
18023,Taurean Waller-Prince,22-349,F,3/6/17,ATL,,GSW,L,0,10,1,1,1,0,0,,1,1,1,0,0,,0,1,1
18024,Taurean Waller-Prince,22-316,F,2/1/17,ATL,@,MIA,L,0,6,1,3,0.333,1,3,0.333,0,0,,1,1,1,0,2,2
18025,C.J. Watson,32-260,G,1/2/17,ORL,@,NYK,W,0,18,1,4,0.25,1,3,0.333,0,1,0,1,1,1,0,3,3
18026,C.J. Watson,32-259,G,1/1/17,ORL,@,IND,L,0,19,1,6,0.167,0,1,0,1,5,0.2,0,0,,0,4,4
18027,C.J. Watson,32-211,G,11/14/16,ORL,@,IND,L,0,17,1,5,0.2,0,2,0,1,3,0.333,0,0,,0,2,2
18028,C.J. Watson,32-269,G,1/11/17,ORL,@,LAC,L,0,12,1,3,0.333,1,2,0.5,0,1,0,1,1,1,1,1,2
18029,C.J. Watson,32-204,G,11/7/16,ORL,@,CHI,L,0,10,1,3,0.333,0,2,0,1,1,1,0,0,,0,3,3
18030,C.J. Watson,32-245,G,12/18/16,ORL,,TOR,L,0,9,1,4,0.25,0,1,0,1,3,0.333,0,0,,0,0,0
18031,C.J. Watson,32-218,G,11/21/16,ORL,@,MIL,L,0,10,1,2,0.5,0,1,0,1,1,1,0,0,,0,0,0
18032,David West,36-086,F,11/23/16,GSW,,LAL,W,0,15,1,3,0.333,1,3,0.333,0,0,,1,2,0.5,1,4,5
18033,David West,36-060,F,10/28/16,GSW,@,NOP,W,0,9,1,3,0.333,1,3,0.333,0,0,,1,2,0.5,1,0,1
18034,David West,36-104,F,12/11/16,GSW,@,MIN,W,0,14,1,4,0.25,1,4,0.25,0,0,,1,2,0.5,0,2,2
18035,Okaro White,24-167,F,1/27/17,MIA,@,CHI,W,0,21,1,2,0.5,0,1,0,1,1,1,0,0,,0,4,4
18036,Okaro White,24-177,F,2/6/17,MIA,@,MIN,W,0,6,1,1,1,1,1,1,0,0,,1,1,1,1,0,1
18037,Okaro White,24-198,F,2/27/17,MIA,@,DAL,L,0,10,1,1,1,0,0,,1,1,1,0,0,,0,0,0
18038,Isaiah Whitehead,21-319,G,1/21/17,BRK,@,CHO,L,0,23,1,2,0.5,0,1,0,1,1,1,0,0,,0,3,3
18039,Isaiah Whitehead,21-235,G,10/29/16,BRK,@,MIL,L,0,8,1,1,1,1,1,1,0,0,,1,2,0.5,0,0,0
18040,C.J. Wilcox,25-303,G,10/28/16,ORL,@,DET,L,0,12,1,3,0.333,0,1,0,1,2,0.5,0,0,,0,1,1
18041,Derrick Williams,25-223,F,1/3/17,MIA,@,PHO,L,0,24,0,7,0,0,6,0,0,1,0,3,4,0.75,2,2,4
18042,Derrick Williams,25-285,F,3/6/17,CLE,,MIA,L,0,19,1,3,0.333,0,1,0,1,2,0.5,0,0,,1,3,4
18043,Derrick Williams,25-205,F,12/16/16,MIA,,LAC,L,0,2,1,2,0.5,1,2,0.5,0,0,,1,1,1,1,0,1
18044,Derrick Williams,25-233,F,1/13/17,MIA,@,MIL,L,0,7,1,1,1,0,0,,1,1,1,0,0,,0,2,2
18045,Derrick Williams,25-196,F,12/7/16,MIA,@,ATL,L,0,20,1,5,0.2,1,2,0.5,0,3,0,1,2,0.5,0,5,5
18046,Troy Williams,21-350,F,12/14/16,MEM,,CLE,W,1,19,1,4,0.25,0,2,0,1,2,0.5,0,0,,0,2,2
18047,Troy Williams,21-304,F,10/29/16,MEM,@,NYK,L,0,9,1,2,0.5,0,0,,1,2,0.5,0,2,0,0,0,0
18048,Kyle Wiltjer,24-043,F,12/2/16,HOU,@,DEN,W,0,4,1,1,1,0,0,,1,1,1,0,0,,0,1,1
18049,Kyle Wiltjer,24-148,F,3/17/17,HOU,@,NOP,L,0,3,1,2,0.5,0,1,0,1,1,1,0,0,,1,1,2
18050,Jeff Withey,26-242,C,11/4/16,UTA,,SAS,L,0,7,0,2,0,0,1,0,0,1,0,3,4,0.75,0,2,2
18051,Jeff Withey,26-261,C,11/23/16,UTA,,DEN,W,0,16,1,2,0.5,1,2,0.5,0,0,,1,2,0.5,1,4,5
18052,Metta World Peace,37-120,F,3/13/17,LAL,@,DEN,L,0,5,0,1,0,0,0,,0,1,0,3,4,0.75,0,2,2
18053,Delon Wright,24-316,G,3/8/17,TOR,@,NOP,W,0,12,1,5,0.2,0,3,0,1,2,0.5,0,0,,3,2,5
18054,James Young,21-202,G-F,3/6/17,BOS,@,LAC,L,0,13,1,4,0.25,0,0,,1,4,0.25,0,0,,0,1,1
18055,Nick Young,31-268,G-F,2/24/17,LAL,@,OKC,L,1,20,1,9,0.111,0,1,0,1,8,0.125,0,0,,0,5,5
18056,Cody Zeller,24-054,F-C,11/28/16,CHO,@,MEM,W,1,21,1,3,0.333,1,3,0.333,0,0,,1,2,0.5,2,6,8
18057,Tyler Zeller,27-059,F-C,3/17/17,BOS,@,BRK,W,0,7,1,1,1,1,1,1,0,0,,1,2,0.5,0,1,1
18058,Paul Zipser,23-022,G-F,3/12/17,CHI,@,BOS,L,0,15,1,4,0.25,0,2,0,1,2,0.5,0,0,,0,2,2
18059,Paul Zipser,23-018,G-F,3/8/17,CHI,@,ORL,L,1,14,1,4,0.25,0,3,0,1,1,1,0,0,,0,2,2
18060,Paul Zipser,22-302,G-F,12/16/16,CHI,,MIL,L,0,9,1,4,0.25,1,2,0.5,0,2,0,1,2,0.5,0,2,2
18061,Alex Abrines,23-170,G-F,1/18/17,OKC,@,GSW,L,0,14,1,1,1,1,1,1,0,0,,0,0,,0,1,1
18062,Alex Abrines,23-194,G-F,2/11/17,OKC,,GSW,L,0,9,0,0,,0,0,,0,0,,2,2,1,0,0,0
18063,Alex Abrines,23-192,G-F,2/9/17,OKC,,CLE,W,0,9,1,2,0.5,1,1,1,0,1,0,0,0,,0,1,1
18064,Alex Abrines,23-231,G-F,3/20/17,OKC,,GSW,L,0,20,0,8,0,0,1,0,0,7,0,2,2,1,0,3,3
18065,Alex Abrines,23-229,G-F,3/18/17,OKC,,SAC,W,0,12,1,3,0.333,1,1,1,0,2,0,0,0,,0,1,1
18066,Quincy Acy,26-039,F,11/14/16,DAL,@,NYK,L,0,2,1,2,0.5,1,2,0.5,0,0,,0,1,0,0,0,0
18067,Quincy Acy,26-029,F,11/4/16,DAL,,POR,L,0,11,1,3,0.333,1,2,0.5,0,1,0,0,0,,1,2,3
18068,Steven Adams,23-105,C,11/2/16,OKC,@,LAC,W,1,31,1,3,0.333,1,3,0.333,0,0,,0,0,,2,9,11
18069,Steven Adams,23-225,C,3/2/17,OKC,@,POR,L,1,24,1,4,0.25,1,4,0.25,0,0,,0,0,,2,4,6
18070,Steven Adams,23-223,C,2/28/17,OKC,,UTA,W,1,27,1,6,0.167,1,6,0.167,0,0,,0,2,0,2,4,6
18071,Arron Afflalo,31-142,G,3/6/17,SAC,@,DEN,L,1,21,1,6,0.167,1,4,0.25,0,2,0,0,0,,0,0,0
18072,Arron Afflalo,31-112,G,2/4/17,SAC,,GSW,W,1,36,0,3,0,0,2,0,0,1,0,2,3,0.667,0,2,2
18073,Arron Afflalo,31-069,G,12/23/16,SAC,@,MIN,W,0,23,1,4,0.25,1,3,0.333,0,1,0,0,0,,0,0,0
18074,Arron Afflalo,31-060,G,12/14/16,SAC,@,HOU,L,0,8,1,4,0.25,1,2,0.5,0,2,0,0,0,,0,1,1
18075,Arron Afflalo,31-083,G,1/6/17,SAC,,LAC,L,0,22,1,6,0.167,1,5,0.2,0,1,0,0,0,,1,1,2
18076,Alexis Ajinca,28-179,C,11/1/16,NOP,,MIL,L,0,6,1,2,0.5,1,2,0.5,0,0,,0,0,,1,1,2
18077,Alexis Ajinca,28-210,C,12/2/16,NOP,,LAC,L,0,10,1,3,0.333,1,3,0.333,0,0,,0,0,,0,3,3
18078,Alexis Ajinca,28-223,C,12/15/16,NOP,,IND,W,1,19,1,2,0.5,1,2,0.5,0,0,,0,0,,2,6,8
18079,Alexis Ajinca,28-312,C,3/14/17,NOP,,POR,W,0,5,1,1,1,1,1,1,0,0,,0,0,,0,0,0
18080,Cole Aldrich,28-003,C,11/3/16,MIN,,DEN,L,0,9,1,2,0.5,1,2,0.5,0,0,,0,0,,0,0,0
18081,Cole Aldrich,28-019,C,11/19/16,MIN,@,MEM,L,0,6,1,1,1,1,1,1,0,0,,0,0,,0,1,1
18082,Cole Aldrich,28-072,C,1/11/17,MIN,,HOU,W,0,4,1,1,1,1,1,1,0,0,,0,0,,1,1,2
18083,Cole Aldrich,28-091,C,1/30/17,MIN,,ORL,W,0,4,1,2,0.5,1,2,0.5,0,0,,0,0,,0,1,1
18084,Cole Aldrich,28-001,C,11/1/16,MIN,,MEM,W,0,10,1,1,1,1,1,1,0,0,,0,0,,0,4,4
18085,Cole Aldrich,28-104,C,2/12/17,MIN,,CHI,W,0,9,1,1,1,1,1,1,0,0,,0,0,,1,2,3
18086,Cole Aldrich,28-015,C,11/15/16,MIN,,CHO,L,0,15,1,2,0.5,1,2,0.5,0,0,,0,0,,2,3,5
18087,Cole Aldrich,28-030,C,11/30/16,MIN,,NYK,L,0,6,1,1,1,1,1,1,0,0,,0,0,,0,2,2
18088,Cole Aldrich,28-102,C,2/10/17,MIN,,NOP,L,0,3,1,1,1,1,1,1,0,0,,0,0,,1,1,2
18089,Cole Aldrich,28-013,C,11/13/16,MIN,,LAL,W,0,14,1,3,0.333,1,3,0.333,0,0,,0,2,0,1,2,3
18090,Cole Aldrich,28-043,C,12/13/16,MIN,@,CHI,W,0,11,1,2,0.5,1,2,0.5,0,0,,0,0,,2,2,4
18091,Cole Aldrich,28-005,C,11/5/16,MIN,@,OKC,L,0,15,1,1,1,1,1,1,0,0,,0,2,0,2,3,5
18092,Cole Aldrich,28-021,C,11/21/16,MIN,,BOS,L,0,8,1,2,0.5,1,2,0.5,0,0,,0,0,,0,3,3
18093,Cole Aldrich,28-036,C,12/6/16,MIN,,SAS,L,0,15,1,3,0.333,1,3,0.333,0,0,,0,0,,1,0,1
18094,Lavoy Allen,27-300,F-C,11/30/16,IND,@,POR,L,0,17,0,1,0,0,1,0,0,0,,2,2,1,1,1,2
18095,Lavoy Allen,28-044,F-C,3/20/17,IND,,UTA,W,0,16,1,1,1,1,1,1,0,0,,0,0,,1,2,3
18096,Lavoy Allen,27-284,F-C,11/14/16,IND,,ORL,W,0,16,1,2,0.5,1,2,0.5,0,0,,0,0,,1,2,3
18097,Lavoy Allen,28-043,F-C,3/19/17,IND,@,TOR,L,0,16,1,2,0.5,1,2,0.5,0,0,,0,0,,2,1,3
18098,Lavoy Allen,27-282,F-C,11/12/16,IND,,BOS,L,0,26,1,6,0.167,1,6,0.167,0,0,,0,0,,3,1,4
18099,Lavoy Allen,27-295,F-C,11/25/16,IND,,BRK,W,0,24,1,3,0.333,1,3,0.333,0,0,,0,0,,3,5,8
18100,Lavoy Allen,27-357,F-C,1/26/17,IND,@,MIN,W,0,17,0,1,0,0,1,0,0,0,,2,2,1,0,5,5
18101,Lavoy Allen,27-286,F-C,11/16/16,IND,,CLE,W,0,10,1,2,0.5,1,2,0.5,0,0,,0,0,,2,0,2
18102,Lavoy Allen,28-044,F-C,3/20/17,IND,,UTA,W,0,16,1,1,1,1,1,1,0,0,,0,0,,1,2,3
18103,Lavoy Allen,27-284,F-C,11/14/16,IND,,ORL,W,0,16,1,2,0.5,1,2,0.5,0,0,,0,0,,1,2,3
18104,Lavoy Allen,27-300,F-C,11/30/16,IND,@,POR,L,0,17,0,1,0,0,1,0,0,0,,2,2,1,1,1,2
18105,Lavoy Allen,28-043,F-C,3/19/17,IND,@,TOR,L,0,16,1,2,0.5,1,2,0.5,0,0,,0,0,,2,1,3
18106,Lavoy Allen,27-282,F-C,11/12/16,IND,,BOS,L,0,26,1,6,0.167,1,6,0.167,0,0,,0,0,,3,1,4
18107,Lavoy Allen,27-357,F-C,1/26/17,IND,@,MIN,W,0,17,0,1,0,0,1,0,0,0,,2,2,1,0,5,5
18108,Lavoy Allen,27-265,F-C,10/26/16,IND,,DAL,W,0,11,1,3,0.333,1,3,0.333,0,0,,0,0,,1,4,5
18109,Lavoy Allen,27-281,F-C,11/11/16,IND,@,PHI,L,0,20,0,3,0,0,3,0,0,0,,2,2,1,0,2,2
18110,Lavoy Allen,27-295,F-C,11/25/16,IND,,BRK,W,0,24,1,3,0.333,1,3,0.333,0,0,,0,0,,3,5,8
18111,Tony Allen,35-000,G-F,1/11/17,MEM,@,OKC,L,1,22,1,5,0.2,1,5,0.2,0,0,,0,0,,1,1,2
18112,Tony Allen,35-016,G-F,1/27/17,MEM,@,POR,L,1,35,1,5,0.2,1,3,0.333,0,2,0,0,2,0,0,7,7
18113,Tony Allen,34-363,G-F,1/8/17,MEM,,UTA,W,1,23,1,3,0.333,1,3,0.333,0,0,,0,0,,1,4,5
18114,Al-Farouq Aminu,26-160,F,2/28/17,POR,@,DET,L,0,24,0,5,0,0,2,0,0,3,0,2,2,1,0,6,6
18115,Al-Farouq Aminu,26-175,F,3/15/17,POR,@,SAS,W,0,31,0,4,0,0,1,0,0,3,0,2,2,1,1,7,8
18116,Al-Farouq Aminu,26-126,F,1/25/17,POR,,LAL,W,0,28,1,5,0.2,1,4,0.25,0,1,0,0,0,,1,5,6
18117,Al-Farouq Aminu,26-169,F,3/9/17,POR,,PHI,W,0,38,1,7,0.143,1,4,0.25,0,3,0,0,0,,2,3,5
18118,Al-Farouq Aminu,26-181,F,3/21/17,POR,,MIL,L,0,19,0,4,0,0,3,0,0,1,0,2,6,0.333,1,6,7
18119,Al-Farouq Aminu,26-077,F,12/7/16,POR,@,MIL,L,0,18,1,5,0.2,1,3,0.333,0,2,0,0,0,,2,2,4
18120,Al-Farouq Aminu,26-102,F,1/1/17,POR,@,MIN,W,1,36,1,7,0.143,1,5,0.2,0,2,0,0,0,,0,6,6
18121,Al-Farouq Aminu,26-048,F,11/8/16,POR,,PHO,W,1,4,1,1,1,1,1,1,0,0,,0,0,,0,0,0
18122,Chris Andersen,38-153,F-C,12/7/16,CLE,@,NYK,W,0,8,1,1,1,1,1,1,0,0,,0,0,,0,1,1
18123,Chris Andersen,38-110,F-C,10/25/16,CLE,,NYK,W,0,6,1,1,1,1,1,1,0,0,,0,0,,0,0,0
18124,Chris Andersen,38-147,F-C,12/1/16,CLE,,LAC,L,0,8,0,0,,0,0,,0,0,,2,4,0.5,0,1,1
18125,Chris Andersen,38-145,F-C,11/29/16,CLE,@,MIL,L,0,11,0,1,0,0,1,0,0,0,,2,2,1,0,3,3
18126,Chris Andersen,38-139,F-C,11/23/16,CLE,,POR,W,0,4,1,3,0.333,1,2,0.5,0,1,0,0,0,,0,1,1
18127,Chris Andersen,38-134,F-C,11/18/16,CLE,,DET,W,0,9,0,5,0,0,4,0,0,1,0,2,2,1,2,2,4
18128,Chris Andersen,38-160,F-C,12/14/16,CLE,@,MEM,L,0,20,1,3,0.333,1,3,0.333,0,0,,0,0,,0,4,4
18129,Alan Anderson,34-071,G-F,12/26/16,LAC,,DEN,L,0,10,1,1,1,1,1,1,0,0,,0,0,,1,0,1
18130,Alan Anderson,34-120,G-F,2/13/17,LAC,@,UTA,W,0,10,1,2,0.5,1,1,1,0,1,0,0,0,,0,0,0
18131,Justin Anderson,23-062,G,1/20/17,DAL,,UTA,L,0,2,1,1,1,1,1,1,0,0,,0,0,,0,0,0
18132,Justin Anderson,23-112,G,3/11/17,PHI,@,LAC,L,0,17,1,2,0.5,1,2,0.5,0,0,,0,0,,2,4,6
18133,Justin Anderson,23-051,G,1/9/17,DAL,@,MIN,L,0,6,1,2,0.5,1,1,1,0,1,0,0,0,,0,0,0
18134,Justin Anderson,23-086,G,2/13/17,DAL,,BOS,L,0,1,1,1,1,1,1,1,0,0,,0,0,,0,0,0
18135,Justin Anderson,23-029,G,12/18/16,DAL,,SAC,W,0,2,0,1,0,0,1,0,0,0,,2,2,1,0,1,1
18136,Justin Anderson,23-082,G,2/9/17,DAL,,UTA,W,0,10,1,2,0.5,1,1,1,0,1,0,0,0,,1,1,2
18137,Kyle Anderson,23-141,F-G,2/8/17,SAS,@,PHI,W,0,6,1,1,1,1,1,1,0,0,,0,0,,0,2,2
18138,Kyle Anderson,23-105,F-G,1/3/17,SAS,,TOR,W,0,8,1,1,1,1,1,1,0,0,,0,0,,0,1,1
18139,Kyle Anderson,23-123,F-G,1/21/17,SAS,@,CLE,W,0,18,1,3,0.333,1,1,1,0,2,0,0,0,,0,4,4
18140,Kyle Anderson,23-165,F-G,3/4/17,SAS,,MIN,W,0,8,1,3,0.333,1,2,0.5,0,1,0,0,0,,1,1,2
18141,Kyle Anderson,23-045,F-G,11/4/16,SAS,@,UTA,W,1,24,1,3,0.333,1,3,0.333,0,0,,0,0,,0,3,3
18142,Kyle Anderson,23-042,F-G,11/1/16,SAS,,UTA,L,0,14,0,3,0,0,2,0,0,1,0,2,2,1,0,1,1
18143,Kyle Anderson,23-062,F-G,11/21/16,SAS,,DAL,W,0,13,1,1,1,1,1,1,0,0,,0,0,,1,1,2
18144,Kyle Anderson,23-081,F-G,12/10/16,SAS,,BRK,W,0,10,1,4,0.25,1,4,0.25,0,0,,0,0,,1,2,3
18145,Kyle Anderson,23-179,F-G,3/18/17,SAS,@,MEM,L,0,1,1,1,1,1,1,1,0,0,,0,0,,0,0,0
18146,Kyle Anderson,23-057,F-G,11/16/16,SAS,@,SAC,W,0,3,1,2,0.5,1,2,0.5,0,0,,0,0,,0,0,0
18147,Kyle Anderson,23-146,F-G,2/13/17,SAS,@,IND,W,0,9,0,1,0,0,1,0,0,0,,2,4,0.5,1,2,3
18148,Kyle Anderson,23-037,F-G,10/27/16,SAS,@,SAC,W,1,27,1,2,0.5,1,2,0.5,0,0,,0,0,,0,8,8
18149,Kyle Anderson,23-076,F-G,12/5/16,SAS,@,MIL,W,0,4,1,2,0.5,1,1,1,0,1,0,0,0,,0,1,1
18150,Kyle Anderson,23-094,F-G,12/23/16,SAS,@,POR,W,0,16,1,2,0.5,1,2,0.5,0,0,,0,0,,0,2,2
18151,Ryan Anderson,28-213,F,12/5/16,HOU,,BOS,W,1,29,0,6,0,0,1,0,0,5,0,2,2,1,0,6,6
18152,Joel Anthony,34-183,C,2/8/17,SAS,@,PHI,W,0,3,1,2,0.5,1,2,0.5,0,0,,0,0,,1,1,2
18153,Joel Anthony,34-222,C,3/19/17,SAS,,SAC,W,0,6,1,2,0.5,1,2,0.5,0,0,,0,0,,0,1,1
18154,Joel Anthony,34-179,C,2/4/17,SAS,,DEN,W,0,15,1,1,1,1,1,1,0,0,,0,0,,1,1,2
18155,Trevor Ariza,31-261,F,3/18/17,HOU,@,DEN,W,1,34,1,4,0.25,1,2,0.5,0,2,0,0,0,,0,9,9
18156,Trevor Ariza,31-213,F,1/29/17,HOU,@,IND,L,1,25,0,5,0,0,1,0,0,4,0,2,2,1,0,9,9
18157,Darrell Arthur,28-351,F,3/11/17,DEN,@,SAC,W,0,15,1,4,0.25,1,1,1,0,3,0,0,0,,0,1,1
18158,Darrell Arthur,28-262,F,12/12/16,DEN,@,DAL,L,1,5,1,1,1,1,1,1,0,0,,0,0,,1,0,1
18159,Darrell Arthur,28-223,F,11/3/16,DEN,@,MIN,W,0,9,1,3,0.333,1,2,0.5,0,1,0,0,0,,0,2,2
18160,Darrell Arthur,28-341,F,3/1/17,DEN,@,MIL,W,0,6,1,1,1,1,1,1,0,0,,0,0,,1,1,2
18161,Omer Asik,30-137,C,11/18/16,NOP,,POR,W,1,17,1,2,0.5,1,2,0.5,0,0,,0,0,,1,4,5
18162,Omer Asik,30-169,C,12/20/16,NOP,@,PHI,W,0,16,0,2,0,0,2,0,0,0,,2,2,1,4,2,6
18163,Omer Asik,30-116,C,10/28/16,NOP,,GSW,L,1,8,1,1,1,1,1,1,0,0,,0,0,,0,3,3
18164,Omer Asik,30-131,C,11/12/16,NOP,,LAL,L,1,13,1,3,0.333,1,3,0.333,0,0,,0,0,,2,3,5
18165,Omer Asik,30-146,C,11/27/16,NOP,@,DAL,L,1,7,1,1,1,1,1,1,0,0,,0,0,,2,2,4
18166,Omer Asik,30-114,C,10/26/16,NOP,,DEN,L,1,17,1,3,0.333,1,3,0.333,0,0,,0,0,,0,1,1
18167,D.J. Augustin,29-042,G,12/22/16,ORL,@,NYK,L,1,20,1,4,0.25,1,2,0.5,0,2,0,0,0,,0,3,3
18168,D.J. Augustin,29-011,G,11/21/16,ORL,@,MIL,L,0,13,0,6,0,0,4,0,0,2,0,2,2,1,1,2,3
18169,Luke Babbitt,27-204,F,1/10/17,MIA,@,GSW,L,1,18,1,6,0.167,1,3,0.333,0,3,0,0,0,,0,1,1
18170,Ron Baker,23-226,G,11/11/16,NYK,@,BOS,L,0,8,1,3,0.333,1,2,0.5,0,1,0,0,0,,0,0,0
18171,Ron Baker,23-278,G,1/2/17,NYK,,ORL,L,0,2,0,0,,0,0,,0,0,,2,2,1,0,0,0
18172,Ron Baker,23-295,G,1/19/17,NYK,,WAS,L,1,20,1,4,0.25,1,3,0.333,0,1,0,0,0,,1,1,2
18173,Ron Baker,23-317,G,2/10/17,NYK,,DEN,L,0,20,1,4,0.25,1,2,0.5,0,2,0,0,0,,0,1,1
18174,Ron Baker,23-338,G,3/3/17,NYK,@,PHI,L,0,14,1,3,0.333,1,2,0.5,0,1,0,0,0,,1,2,3
18175,Ron Baker,23-349,G,3/14/17,NYK,,IND,W,0,22,1,1,1,1,1,1,0,0,,0,0,,0,1,1
18176,Wade Baldwin,20-246,G,11/30/16,MEM,@,TOR,L,0,24,1,6,0.167,1,5,0.2,0,1,0,0,0,,0,3,3
18177,Wade Baldwin,20-228,G,11/12/16,MEM,@,MIL,L,0,12,1,2,0.5,1,1,1,0,1,0,0,0,,0,1,1
18178,Wade Baldwin,20-220,G,11/4/16,MEM,,LAC,L,0,14,1,5,0.2,1,4,0.25,0,1,0,0,0,,1,1,2
18179,Leandro Barbosa,33-342,G,11/4/16,PHO,@,NOP,W,0,11,1,6,0.167,1,6,0.167,0,0,,0,0,,0,1,1
18180,Leandro Barbosa,33-357,G,11/19/16,PHO,@,PHI,L,0,10,1,3,0.333,1,3,0.333,0,0,,0,0,,0,0,0
18181,Leandro Barbosa,34-077,G,2/13/17,PHO,,NOP,L,0,11,1,4,0.25,1,4,0.25,0,0,,0,0,,0,1,1
18182,Leandro Barbosa,33-340,G,11/2/16,PHO,,POR,W,0,11,1,2,0.5,1,2,0.5,0,0,,0,0,,0,0,0
18183,Leandro Barbosa,34-097,G,3/5/17,PHO,,BOS,W,0,13,1,8,0.125,1,6,0.167,0,2,0,0,0,,2,1,3
18184,Leandro Barbosa,34-019,G,12/17/16,PHO,@,OKC,L,0,10,1,5,0.2,1,4,0.25,0,1,0,0,0,,0,0,0
18185,Leandro Barbosa,34-047,G,1/14/17,PHO,,SAS,W,0,6,1,4,0.25,1,4,0.25,0,0,,0,0,,0,1,1
18186,Leandro Barbosa,33-344,G,11/6/16,PHO,@,LAL,L,0,14,1,5,0.2,1,4,0.25,0,1,0,0,0,,1,1,2
18187,J.J. Barea,32-178,G,12/21/16,DAL,@,POR,W,0,9,1,7,0.143,1,5,0.2,0,2,0,0,0,,0,1,1
18188,J.J. Barea,32-200,G,1/12/17,DAL,@,PHO,W,0,19,1,8,0.125,1,3,0.333,0,5,0,0,0,,0,1,1
18189,J.J. Barea,32-260,G,3/13/17,DAL,@,TOR,L,0,17,1,6,0.167,1,5,0.2,0,1,0,0,0,,0,2,2
18190,Matt Barnes,36-273,F,12/7/16,SAC,@,DAL,W,0,24,1,2,0.5,1,1,1,0,1,0,0,0,,0,3,3
18191,Matt Barnes,36-270,F,12/4/16,SAC,@,NYK,L,0,17,1,11,0.091,1,7,0.143,0,4,0,0,0,,2,1,3
18192,Matt Barnes,36-324,F,1/27/17,SAC,@,IND,L,0,21,0,3,0,0,1,0,0,2,0,2,2,1,0,2,2
18193,Matt Barnes,36-286,F,12/20/16,SAC,,POR,W,1,19,0,4,0,0,2,0,0,2,0,2,4,0.5,1,3,4
18194,Matt Barnes,36-358,F,3/2/17,GSW,@,CHI,L,0,12,1,1,1,1,1,1,0,0,,0,0,,0,0,0
18195,Matt Barnes,36-239,F,11/3/16,SAC,@,ORL,L,0,9,1,2,0.5,1,1,1,0,1,0,0,0,,1,2,3
18196,Matt Barnes,36-276,F,12/10/16,SAC,@,UTA,L,0,15,1,5,0.2,1,3,0.333,0,2,0,0,0,,0,2,2
18197,Will Barton,26-064,G,3/11/17,DEN,@,SAC,W,0,16,1,6,0.167,1,2,0.5,0,4,0,0,0,,0,3,3
18198,Brandon Bass,31-216,F,12/2/16,LAC,@,NOP,W,0,5,1,2,0.5,1,2,0.5,0,0,,0,0,,1,0,1
18199,Brandon Bass,31-282,F,2/6/17,LAC,@,TOR,L,0,7,1,2,0.5,1,2,0.5,0,0,,0,0,,0,0,0
18200,Brandon Bass,31-237,F,12/23/16,LAC,,DAL,L,0,8,1,2,0.5,1,2,0.5,0,0,,0,0,,1,2,3
18201,Brandon Bass,31-216,F,12/2/16,LAC,@,NOP,W,0,5,1,2,0.5,1,2,0.5,0,0,,0,0,,1,0,1
18202,Brandon Bass,31-282,F,2/6/17,LAC,@,TOR,L,0,7,1,2,0.5,1,2,0.5,0,0,,0,0,,0,0,0
18203,Aron Baynes,30-030,C,1/8/17,DET,@,POR,W,0,6,1,3,0.333,1,3,0.333,0,0,,0,0,,0,1,1
18204,Aron Baynes,30-050,C,1/28/17,DET,@,MIA,L,0,13,0,2,0,0,2,0,0,0,,2,2,1,3,2,5
18205,Aron Baynes,29-359,C,12/2/16,DET,@,ATL,W,0,16,0,0,,0,0,,0,0,,2,2,1,0,0,0
18206,Aron Baynes,30-023,C,1/1/17,DET,@,MIA,W,0,9,1,1,1,1,1,1,0,0,,0,0,,1,3,4
18207,Aron Baynes,30-065,C,2/12/17,DET,@,TOR,W,0,21,1,1,1,1,1,1,0,0,,0,0,,3,4,7
18208,Aron Baynes,29-328,C,11/1/16,DET,,NYK,W,0,13,1,3,0.333,1,3,0.333,0,0,,0,0,,1,3,4
18209,Aron Baynes,30-007,C,12/16/16,DET,@,WAS,L,0,17,1,2,0.5,1,2,0.5,0,0,,0,0,,2,0,2
18210,Aron Baynes,30-082,C,3/1/17,DET,@,NOP,L,0,13,1,3,0.333,1,3,0.333,0,0,,0,0,,1,5,6
18211,Aron Baynes,30-002,C,12/11/16,DET,,PHI,L,0,12,1,3,0.333,1,3,0.333,0,0,,0,0,,2,2,4
18212,Aron Baynes,29-338,C,11/11/16,DET,@,SAS,L,0,15,1,2,0.5,1,2,0.5,0,0,,0,0,,1,3,4
18213,Aron Baynes,30-000,C,12/9/16,DET,@,MIN,W,0,16,1,2,0.5,1,2,0.5,0,0,,0,0,,1,1,2
18214,Aron Baynes,30-017,C,12/26/16,DET,,CLE,W,0,12,1,1,1,1,1,1,0,0,,0,0,,1,3,4
18215,Aron Baynes,30-035,C,1/13/17,DET,@,UTA,L,1,18,1,3,0.333,1,3,0.333,0,0,,0,0,,0,0,0
18216,Aron Baynes,29-334,C,11/7/16,DET,@,LAC,L,0,15,1,4,0.25,1,4,0.25,0,0,,0,1,0,0,4,4
18217,Aron Baynes,29-348,C,11/21/16,DET,,HOU,L,0,14,0,3,0,0,3,0,0,0,,2,2,1,0,1,1
18218,Aron Baynes,30-012,C,12/21/16,DET,,MEM,L,0,10,1,1,1,1,1,1,0,0,,0,0,,0,1,1
18219,Aron Baynes,30-068,C,2/15/17,DET,,DAL,W,0,26,1,8,0.125,1,8,0.125,0,0,,0,0,,2,9,11
18220,Aron Baynes,29-361,C,12/4/16,DET,,ORL,L,0,13,1,3,0.333,1,3,0.333,0,0,,0,0,,0,6,6
18221,Kent Bazemore,27-203,G-F,1/20/17,ATL,,CHI,W,1,19,1,2,0.5,1,1,1,0,1,0,0,0,,0,2,2
18222,Kent Bazemore,27-229,G-F,2/15/17,ATL,@,LAC,L,1,17,0,4,0,0,2,0,0,2,0,2,2,1,0,1,1
18223,Kent Bazemore,27-178,G-F,12/26/16,ATL,@,MIN,L,1,24,1,3,0.333,1,1,1,0,2,0,0,0,,0,2,2
18224,Kent Bazemore,27-247,G-F,3/5/17,ATL,,IND,L,1,19,1,7,0.143,1,3,0.333,0,4,0,0,0,,1,2,3
18225,Kent Bazemore,27-188,G-F,1/5/17,ATL,@,NOP,W,1,21,1,4,0.25,1,4,0.25,0,0,,0,0,,0,3,3
18226,Malik Beasley,20-107,G,3/13/17,DEN,,LAL,W,0,3,1,1,1,1,1,1,0,0,,0,0,,0,2,2
18227,Malik Beasley,20-038,G,1/3/17,DEN,,SAC,L,0,1,1,1,1,1,1,1,0,0,,0,0,,0,1,1
18228,Michael Beasley,27-291,F,10/26/16,MIL,,CHO,L,0,19,1,5,0.2,1,5,0.2,0,0,,0,2,0,1,1,2
18229,Michael Beasley,27-338,F,12/12/16,MIL,@,TOR,L,0,16,1,5,0.2,1,4,0.25,0,1,0,0,0,,2,2,4
18230,Michael Beasley,27-321,F,11/25/16,MIL,,TOR,L,0,16,1,7,0.143,1,6,0.167,0,1,0,0,0,,0,8,8
18231,Michael Beasley,27-336,F,12/10/16,MIL,@,WAS,L,0,5,1,3,0.333,1,3,0.333,0,0,,0,0,,1,0,1
18232,Michael Beasley,28-011,F,1/20/17,MIL,@,ORL,L,0,7,1,4,0.25,1,4,0.25,0,0,,0,0,,0,2,2
18233,Michael Beasley,27-359,F,1/2/17,MIL,,OKC,W,0,10,1,2,0.5,1,2,0.5,0,0,,0,0,,0,3,3
18234,Marco Belinelli,30-224,G-F,11/4/16,CHO,@,BRK,W,0,21,1,6,0.167,1,4,0.25,0,2,0,0,0,,0,3,3
18235,DeAndre' Bembry,22-250,F,3/11/17,ATL,@,MEM,W,0,3,1,3,0.333,1,3,0.333,0,0,,0,0,,0,0,0
18236,DeAndre' Bembry,22-144,F,11/25/16,ATL,@,UTA,L,0,7,1,1,1,1,1,1,0,0,,0,0,,0,0,0
18237,DeAndre' Bembry,22-238,F,2/27/17,ATL,@,BOS,W,0,3,1,1,1,1,1,1,0,0,,0,0,,0,0,0
18238,DeAndre' Bembry,22-141,F,11/22/16,ATL,,NOP,L,0,12,1,4,0.25,1,3,0.333,0,1,0,0,0,,0,1,1
18239,DeAndre' Bembry,22-236,F,2/25/17,ATL,@,ORL,L,0,4,1,1,1,1,1,1,0,0,,0,0,,1,0,1
18240,DeAndre' Bembry,22-235,F,2/24/17,ATL,,MIA,L,0,10,1,2,0.5,1,1,1,0,1,0,0,0,,0,0,0
18241,DeAndre' Bembry,22-117,F,10/29/16,ATL,@,PHI,W,0,6,1,3,0.333,1,2,0.5,0,1,0,0,0,,1,1,2
18242,DeAndre' Bembry,22-115,F,10/27/16,ATL,,WAS,W,0,2,1,1,1,1,1,1,0,0,,0,0,,0,1,1
18243,DeAndre' Bembry,22-259,F,3/20/17,ATL,@,CHO,L,0,10,1,3,0.333,1,1,1,0,2,0,0,0,,1,1,2
18244,Dragan Bender,19-047,F,1/3/17,PHO,,MIA,W,0,16,1,5,0.2,1,2,0.5,0,3,0,0,0,,0,2,2
18245,Dragan Bender,19-002,F,11/19/16,PHO,@,PHI,L,0,12,1,3,0.333,1,1,1,0,2,0,0,1,0,0,1,1
18246,Dragan Bender,19-022,F,12/9/16,PHO,@,LAL,W,0,8,1,3,0.333,1,1,1,0,2,0,0,0,,0,0,0
18247,Davis Bertans,24-127,F,3/19/17,SAS,,SAC,W,1,15,1,3,0.333,1,1,1,0,2,0,0,0,,0,1,1
18248,Davis Bertans,24-080,F,1/31/17,SAS,,OKC,W,0,23,1,6,0.167,1,2,0.5,0,4,0,0,1,0,2,3,5
18249,Patrick Beverley,28-226,G,2/23/17,HOU,@,NOP,W,1,30,1,3,0.333,1,1,1,0,2,0,0,0,,2,10,12
18250,Patrick Beverley,28-230,G,2/27/17,HOU,,IND,L,1,28,1,6,0.167,1,2,0.5,0,4,0,0,0,,1,5,6
18251,Bismack Biyombo,24-129,C-F,1/4/17,ORL,,ATL,L,1,21,0,2,0,0,2,0,0,0,,2,2,1,1,1,2
18252,Bismack Biyombo,24-065,C-F,11/1/16,ORL,@,PHI,W,0,21,0,1,0,0,1,0,0,0,,2,2,1,4,4,8
18253,Bismack Biyombo,24-181,C-F,2/25/17,ORL,,ATL,W,0,17,1,3,0.333,1,3,0.333,0,0,,0,0,,0,4,4
18254,Bismack Biyombo,24-157,C-F,2/1/17,ORL,,IND,L,0,17,1,3,0.333,1,3,0.333,0,0,,0,2,0,1,1,2
18255,Bismack Biyombo,24-179,C-F,2/23/17,ORL,,POR,L,0,15,0,0,,0,0,,0,0,,2,2,1,2,3,5
18256,Bismack Biyombo,24-061,C-F,10/28/16,ORL,@,DET,L,0,23,1,5,0.2,1,5,0.2,0,0,,0,0,,1,2,3
18257,Bismack Biyombo,24-138,C-F,1/13/17,ORL,@,POR,W,0,16,1,3,0.333,1,3,0.333,0,0,,0,0,,2,3,5
18258,Bismack Biyombo,24-169,C-F,2/13/17,ORL,@,MIA,W,0,16,1,2,0.5,1,2,0.5,0,0,,0,0,,5,5,10
18259,Bismack Biyombo,24-149,C-F,1/24/17,ORL,,CHI,L,0,16,1,3,0.333,1,3,0.333,0,0,,0,0,,0,4,4
18260,Bismack Biyombo,24-071,C-F,11/7/16,ORL,@,CHI,L,0,19,1,5,0.2,1,5,0.2,0,0,,0,0,,2,5,7
18261,Bismack Biyombo,24-131,C-F,1/6/17,ORL,,HOU,L,1,20,1,3,0.333,1,3,0.333,0,0,,0,0,,2,3,5
18262,Nemanja Bjelica,28-194,F,11/19/16,MIN,@,MEM,L,0,14,0,4,0,0,1,0,0,3,0,2,2,1,0,4,4
18263,Nemanja Bjelica,28-230,F,12/25/16,MIN,@,OKC,L,0,12,1,2,0.5,1,2,0.5,0,0,,0,0,,0,1,1
18264,Nemanja Bjelica,28-228,F,12/23/16,MIN,,SAC,L,0,11,1,3,0.333,1,2,0.5,0,1,0,0,0,,0,1,1
18265,Nemanja Bjelica,28-273,F,2/6/17,MIN,,MIA,L,0,14,1,1,1,1,1,1,0,0,,0,2,0,1,2,3
18266,Nemanja Bjelica,28-255,F,1/19/17,MIN,@,LAC,W,0,19,1,3,0.333,1,1,1,0,2,0,0,0,,0,1,1
18267,Nemanja Bjelica,28-291,F,2/24/17,MIN,,DAL,W,0,15,1,2,0.5,1,1,1,0,1,0,0,0,,0,2,2
18268,Tarik Black,24-343,C-F,10/30/16,LAL,@,OKC,L,0,11,1,2,0.5,1,2,0.5,0,0,,0,0,,1,3,4
18269,Tarik Black,24-357,C-F,11/13/16,LAL,@,MIN,L,0,12,0,1,0,0,1,0,0,0,,2,2,1,1,1,2
18270,Tarik Black,25-044,C-F,1/5/17,LAL,@,POR,L,0,15,1,2,0.5,1,2,0.5,0,0,,0,0,,1,4,5
18271,Tarik Black,25-096,C-F,2/26/17,LAL,,SAS,L,1,16,0,0,,0,0,,0,0,,2,2,1,2,2,4
18272,Tarik Black,24-352,C-F,11/8/16,LAL,,DAL,L,0,15,1,2,0.5,1,2,0.5,0,0,,0,0,,0,3,3
18273,Tarik Black,25-085,C-F,2/15/17,LAL,@,PHO,L,1,9,0,2,0,0,2,0,0,0,,2,2,1,0,2,2
18274,Tarik Black,25-049,C-F,1/10/17,LAL,,POR,L,0,17,0,0,,0,0,,0,0,,2,4,0.5,1,3,4
18275,Bojan Bogdanovic,27-312,G-F,2/24/17,WAS,@,PHI,L,0,18,1,5,0.2,1,2,0.5,0,3,0,0,0,,0,4,4
18276,Andrew Bogut,31-340,C,11/2/16,DAL,@,UTA,L,1,17,1,2,0.5,1,2,0.5,0,0,,0,0,,0,9,9
18277,Andrew Bogut,31-363,C,11/25/16,DAL,@,CLE,L,1,22,1,3,0.333,1,3,0.333,0,0,,0,1,0,5,6,11
18278,Andrew Bogut,32-031,C,12/29/16,DAL,@,LAL,W,1,22,1,2,0.5,1,2,0.5,0,0,,0,0,,2,5,7
18279,Andrew Bogut,31-356,C,11/18/16,DAL,,MEM,L,1,21,1,4,0.25,1,4,0.25,0,0,,0,0,,5,5,10
18280,Andrew Bogut,32-058,C,1/25/17,DAL,,NYK,W,0,21,1,1,1,1,1,1,0,0,,0,0,,1,3,4
18281,Andrew Bogut,31-346,C,11/8/16,DAL,@,LAL,W,1,29,1,5,0.2,1,4,0.25,0,1,0,0,0,,2,7,9
18282,Andrew Bogut,32-042,C,1/9/17,DAL,@,MIN,L,1,18,1,2,0.5,1,2,0.5,0,0,,0,0,,3,1,4
18283,Andrew Bogut,31-344,C,11/6/16,DAL,,MIL,W,1,34,1,4,0.25,1,4,0.25,0,0,,0,0,,3,13,16
18284,Andrew Bogut,32-040,C,1/7/17,DAL,,ATL,L,1,29,1,3,0.333,1,3,0.333,0,0,,0,0,,0,11,11
18285,Joel Bolomboy,22-321,F,12/14/16,UTA,,OKC,W,0,2,1,1,1,1,1,1,0,0,,0,0,,0,0,0
18286,Joel Bolomboy,22-300,F,11/23/16,UTA,,DEN,W,0,2,1,2,0.5,1,1,1,0,1,0,0,0,,0,1,1
18287,Trevor Booker,29-021,F,12/16/16,BRK,@,ORL,L,1,30,0,5,0,0,3,0,0,2,0,2,2,1,3,6,9
18288,Trevor Booker,29-116,F,3/21/17,BRK,,DET,W,0,14,1,4,0.25,1,4,0.25,0,0,,0,0,,1,4,5
18289,Corey Brewer,30-360,F-G,2/28/17,LAL,,CHO,L,0,11,1,3,0.333,1,1,1,0,2,0,0,0,,0,1,1
18290,Corey Brewer,30-306,F-G,1/5/17,HOU,,OKC,W,0,13,1,2,0.5,1,1,1,0,1,0,0,0,,0,2,2
18291,Corey Brewer,30-319,F-G,1/18/17,HOU,,MIL,W,1,18,1,6,0.167,1,3,0.333,0,3,0,0,0,,1,3,4
18292,Corey Brewer,30-272,F-G,12/2/16,HOU,@,DEN,W,0,13,1,1,1,1,1,1,0,0,,0,0,,0,0,0
18293,Corey Brewer,30-356,F-G,2/24/17,LAL,@,OKC,L,0,4,1,2,0.5,1,2,0.5,0,0,,0,0,,0,0,0
18294,Corey Brewer,30-271,F-G,12/1/16,HOU,@,GSW,W,0,13,1,3,0.333,1,2,0.5,0,1,0,0,0,,0,2,2
18295,Corey Brewer,30-286,F-G,12/16/16,HOU,,NOP,W,0,16,1,2,0.5,1,1,1,0,1,0,0,0,,0,0,0
18296,Corey Brewer,31-004,F-G,3/9/17,LAL,@,PHO,W,0,12,1,3,0.333,1,2,0.5,0,1,0,0,0,,0,1,1
18297,Corey Brewer,31-016,F-G,3/21/17,LAL,,LAC,L,0,12,1,5,0.2,1,4,0.25,0,1,0,0,2,0,1,0,1
18298,Corey Brewer,30-279,F-G,12/9/16,HOU,@,OKC,W,0,12,1,3,0.333,1,1,1,0,2,0,0,2,0,0,2,2
18299,Corey Brewer,30-309,F-G,1/8/17,HOU,@,TOR,W,0,14,1,4,0.25,1,2,0.5,0,2,0,0,0,,0,2,2
18300,Malcolm Brogdon,23-360,G,12/5/16,MIL,,SAS,L,0,16,1,6,0.167,1,4,0.25,0,2,0,0,0,,0,0,0
18301,Malcolm Brogdon,23-323,G,10/29/16,MIL,,BRK,W,0,13,0,5,0,0,4,0,0,1,0,2,2,1,0,1,1
18302,Aaron Brooks,32-051,G,3/6/17,IND,@,CHO,L,0,10,1,4,0.25,1,3,0.333,0,1,0,0,0,,0,1,1
18303,Aaron Brooks,32-007,G,1/21/17,IND,@,UTA,L,0,6,1,3,0.333,1,1,1,0,2,0,0,0,,0,0,0
18304,Aaron Brooks,31-302,G,11/11/16,IND,@,PHI,L,0,18,1,3,0.333,1,1,1,0,2,0,0,0,,0,0,0
18305,Aaron Brooks,32-002,G,1/16/17,IND,,NOP,W,0,11,1,4,0.25,1,3,0.333,0,1,0,0,0,,0,1,1
18306,Aaron Brooks,31-300,G,11/9/16,IND,,PHI,W,0,12,1,3,0.333,1,3,0.333,0,0,,0,0,,0,1,1
18307,Aaron Brooks,31-343,G,12/22/16,IND,,BOS,L,0,13,0,3,0,0,2,0,0,1,0,2,2,1,0,2,2
18308,Aaron Brooks,31-359,G,1/7/17,IND,,NYK,W,0,16,1,3,0.333,1,3,0.333,0,0,,0,0,,1,2,3
18309,Aaron Brooks,32-015,G,1/29/17,IND,,HOU,W,0,12,1,3,0.333,1,1,1,0,2,0,0,0,,0,1,1
18310,Anthony Brown,24-104,F-G,1/22/17,ORL,,GSW,L,0,4,1,2,0.5,1,2,0.5,0,0,,0,0,,2,1,3
18311,Bobby Brown,32-140,G,2/11/17,HOU,,PHO,W,0,5,1,2,0.5,1,2,0.5,0,0,,0,0,,0,0,0
18312,Bobby Brown,32-054,G,11/17/16,HOU,,POR,W,0,5,1,4,0.25,1,3,0.333,0,1,0,0,0,,0,1,1
18313,Bobby Brown,32-167,G,3/10/17,HOU,@,CHI,W,0,2,1,1,1,1,1,1,0,0,,0,0,,0,0,0
18314,Jaylen Brown,20-093,F,1/25/17,BOS,,HOU,W,1,13,1,4,0.25,1,2,0.5,0,2,0,0,0,,0,3,3
18315,Jaylen Brown,20-057,F,12/20/16,BOS,@,MEM,W,0,11,1,6,0.167,1,3,0.333,0,3,0,0,0,,0,1,1
18316,Jaylen Brown,20-055,F,12/18/16,BOS,@,MIA,W,0,8,1,2,0.5,1,2,0.5,0,0,,0,0,,0,0,0
18317,Jaylen Brown,20-089,F,1/21/17,BOS,,POR,L,0,13,0,2,0,0,1,0,0,1,0,2,2,1,0,4,4
18318,Jaylen Brown,20-146,F,3/19/17,BOS,@,PHI,L,0,12,1,6,0.167,1,4,0.25,0,2,0,0,0,,0,2,2
18319,Jaylen Brown,20-053,F,12/16/16,BOS,,CHO,W,0,9,1,5,0.2,1,3,0.333,0,2,0,0,0,,0,1,1
18320,Jaylen Brown,20-032,F,11/25/16,BOS,,SAS,L,0,6,1,3,0.333,1,3,0.333,0,0,,0,1,0,0,2,2
18321,Jaylen Brown,20-081,F,1/13/17,BOS,@,ATL,W,0,8,1,5,0.2,1,3,0.333,0,2,0,0,0,,0,3,3
18322,Jaylen Brown,20-078,F,1/10/17,BOS,@,TOR,L,0,8,1,3,0.333,1,3,0.333,0,0,,0,0,,0,1,1
18323,Jaylen Brown,20-110,F,2/11/17,BOS,@,UTA,W,1,12,1,1,1,1,1,1,0,0,,0,0,,0,4,4
18324,Nicolas Brussino,23-303,G-F,12/30/16,DAL,@,GSW,L,0,12,1,2,0.5,1,1,1,0,1,0,0,0,,2,1,3
18325,Nicolas Brussino,23-330,G-F,1/26/17,DAL,@,OKC,L,0,22,1,3,0.333,1,1,1,0,2,0,0,0,,1,5,6
18326,Nicolas Brussino,24-019,G-F,3/21/17,DAL,,GSW,L,0,5,1,4,0.25,1,3,0.333,0,1,0,0,0,,2,2,4
18327,Nicolas Brussino,23-268,G-F,11/25/16,DAL,@,CLE,L,0,16,1,3,0.333,1,1,1,0,2,0,0,0,,1,3,4
18328,Nicolas Brussino,23-287,G-F,12/14/16,DAL,,DET,L,0,1,1,1,1,1,1,1,0,0,,0,0,,0,0,0
18329,Nicolas Brussino,24-011,G-F,3/13/17,DAL,@,TOR,L,0,12,1,5,0.2,1,1,1,0,4,0,0,0,,0,0,0
18330,Nicolas Brussino,23-240,G-F,10/28/16,DAL,,HOU,L,0,1,0,0,,0,0,,0,0,,2,2,1,0,0,0
18331,Reggie Bullock,25-322,G-F,2/1/17,DET,,NOP,W,0,5,1,2,0.5,1,1,1,0,1,0,0,0,,0,1,1
18332,Reggie Bullock,25-318,G-F,1/28/17,DET,@,MIA,L,0,6,1,4,0.25,1,3,0.333,0,1,0,0,0,,0,1,1
18333,Reggie Bullock,25-353,G-F,3/4/17,DET,@,PHI,W,0,11,0,0,,0,0,,0,0,,2,2,1,1,0,1
18334,Reggie Bullock,26-005,G-F,3/21/17,DET,@,BRK,L,0,13,1,3,0.333,1,2,0.5,0,1,0,0,0,,1,0,1
18335,Reggie Bullock,25-344,G-F,2/23/17,DET,,CHO,W,0,7,1,1,1,1,1,1,0,0,,0,0,,0,2,2
18336,Trey Burke,24-004,G,11/16/16,WAS,@,PHI,L,0,5,1,5,0.2,1,5,0.2,0,0,,0,0,,0,0,0
18337,Trey Burke,24-060,G,1/11/17,WAS,@,BOS,L,0,9,1,3,0.333,1,3,0.333,0,0,,0,0,,0,0,0
18338,Trey Burke,24-024,G,12/6/16,WAS,,ORL,L,0,6,1,2,0.5,1,2,0.5,0,0,,0,0,,0,0,0
18339,Trey Burke,24-020,G,12/2/16,WAS,@,SAS,L,0,11,1,4,0.25,1,4,0.25,0,0,,0,0,,0,0,0
18340,Trey Burke,24-016,G,11/28/16,WAS,,SAC,W,0,11,1,5,0.2,1,4,0.25,0,1,0,0,0,,0,0,0
18341,Trey Burke,24-051,G,1/2/17,WAS,@,HOU,L,0,11,1,3,0.333,1,2,0.5,0,1,0,0,0,,0,0,0
18342,Alec Burks,25-219,G,2/24/17,UTA,@,MIL,W,0,13,1,2,0.5,1,1,1,0,1,0,0,0,,0,0,0
18343,Alec Burks,25-177,G,1/13/17,UTA,,DET,W,0,5,1,4,0.25,1,3,0.333,0,1,0,0,0,,0,0,0
18344,Alec Burks,25-236,G,3/13/17,UTA,,LAC,W,0,11,0,2,0,0,2,0,0,0,,2,2,1,1,4,5
18345,Jose Calderon,35-163,G,3/10/17,ATL,,TOR,W,0,13,1,2,0.5,1,1,1,0,1,0,0,0,,0,1,1
18346,Jose Calderon,35-173,G,3/20/17,ATL,@,CHO,L,0,6,1,2,0.5,1,1,1,0,1,0,0,0,,1,0,1
18347,Jose Calderon,35-116,G,1/22/17,LAL,@,DAL,L,0,18,1,4,0.25,1,2,0.5,0,2,0,0,0,,0,2,2
18348,Jose Calderon,35-062,G,11/29/16,LAL,@,NOP,L,1,16,1,5,0.2,1,2,0.5,0,3,0,0,0,,0,1,1
18349,Kentavious Caldwell-Pope,24-018,G,3/8/17,DET,@,IND,L,1,27,1,4,0.25,1,3,0.333,0,1,0,0,1,0,0,1,1
18350,Kentavious Caldwell-Pope,23-351,G,2/3/17,DET,,MIN,W,1,37,1,7,0.143,1,5,0.2,0,2,0,0,0,,2,3,5
18351,Isaiah Canaan,25-185,G,11/22/16,CHI,@,DEN,L,0,18,1,6,0.167,1,2,0.5,0,4,0,0,0,,0,1,1
18352,Isaiah Canaan,25-168,G,11/5/16,CHI,@,IND,L,0,14,0,1,0,0,0,,0,1,0,2,2,1,0,0,0
18353,Isaiah Canaan,25-199,G,12/6/16,CHI,@,DET,L,0,23,1,5,0.2,1,3,0.333,0,2,0,0,0,,0,3,3
18354,Isaiah Canaan,25-295,G,3/12/17,CHI,@,BOS,L,0,5,1,3,0.333,1,1,1,0,2,0,0,0,,0,0,0
18355,DeMarre Carroll,30-177,F,1/20/17,TOR,@,CHO,L,1,26,1,7,0.143,1,5,0.2,0,2,0,0,0,,1,0,1
18356,DeMarre Carroll,30-232,F,3/16/17,TOR,,OKC,L,1,15,1,3,0.333,1,1,1,0,2,0,0,0,,1,2,3
18357,DeMarre Carroll,30-155,F,12/29/16,TOR,@,PHO,L,1,19,0,2,0,0,0,,0,2,0,2,2,1,1,3,4
18358,DeMarre Carroll,30-149,F,12/23/16,TOR,@,UTA,W,1,24,1,6,0.167,1,3,0.333,0,3,0,0,0,,0,4,4
18359,DeMarre Carroll,30-181,F,1/24/17,TOR,,SAS,L,1,15,0,6,0,0,3,0,0,3,0,2,2,1,2,2,4
18360,Vince Carter,39-325,G-F,12/16/16,MEM,,SAC,L,0,18,1,5,0.2,1,1,1,0,4,0,0,2,0,0,6,6
18361,Michael Carter-Williams,25-153,G,3/12/17,CHI,@,BOS,L,0,8,0,0,,0,0,,0,0,,2,4,0.5,1,0,1
18362,Michael Carter-Williams,25-147,G,3/6/17,CHI,@,DET,L,0,10,0,0,,0,0,,0,0,,2,2,1,0,3,3
18363,Michael Carter-Williams,25-137,G,2/24/17,CHI,,PHO,W,1,8,1,5,0.2,1,3,0.333,0,2,0,0,0,,0,0,0
18364,Michael Carter-Williams,25-103,G,1/21/17,CHI,,SAC,W,1,20,1,6,0.167,1,5,0.2,0,1,0,0,0,,1,6,7
18365,Omri Casspi,28-205,F,1/13/17,SAC,,CLE,L,0,6,1,1,1,1,1,1,0,0,,0,0,,0,1,1
18366,Omri Casspi,28-142,F,11/11/16,SAC,@,POR,L,0,17,1,4,0.25,1,3,0.333,0,1,0,0,0,,0,1,1
18367,Omri Casspi,28-137,F,11/6/16,SAC,@,TOR,W,0,10,1,1,1,1,1,1,0,0,,0,0,,0,1,1
18368,Omri Casspi,28-192,F,12/31/16,SAC,,MEM,L,0,6,1,4,0.25,1,3,0.333,0,1,0,0,0,,1,0,1
18369,Omri Casspi,28-159,F,11/28/16,SAC,@,WAS,L,0,16,1,4,0.25,1,3,0.333,0,1,0,0,0,,0,3,3
18370,Omri Casspi,28-187,F,12/26/16,SAC,,PHI,W,0,13,1,4,0.25,1,4,0.25,0,0,,0,0,,2,3,5
18371,Willie Cauley-Stein,23-191,F-C,2/25/17,SAC,,CHO,L,0,28,0,5,0,0,5,0,0,0,,2,2,1,0,2,2
18372,Willie Cauley-Stein,23-094,F-C,11/20/16,SAC,,TOR,W,0,4,1,2,0.5,1,2,0.5,0,0,,0,0,,1,0,1
18373,Willie Cauley-Stein,23-127,F-C,12/23/16,SAC,@,MIN,W,0,8,1,3,0.333,1,3,0.333,0,0,,0,0,,0,2,2
18374,Willie Cauley-Stein,23-150,F-C,1/15/17,SAC,,OKC,L,0,5,1,2,0.5,1,2,0.5,0,0,,0,0,,1,0,1
18375,Willie Cauley-Stein,23-139,F-C,1/4/17,SAC,,MIA,L,0,7,1,2,0.5,1,2,0.5,0,0,,0,0,,2,1,3
18376,Willie Cauley-Stein,23-162,F-C,1/27/17,SAC,@,IND,L,0,12,0,1,0,0,1,0,0,0,,2,2,1,1,0,1
18377,Tyson Chandler,34-120,C,1/30/17,PHO,,MEM,L,1,22,0,2,0,0,2,0,0,0,,2,2,1,1,3,4
18378,Tyson Chandler,34-062,C,12/3/16,PHO,@,GSW,L,1,20,1,1,1,1,1,1,0,0,,0,0,,4,5,9
18379,Wilson Chandler,29-216,F,12/12/16,DEN,@,DAL,L,0,23,1,3,0.333,1,2,0.5,0,1,0,0,0,,0,1,1
18380,Wilson Chandler,29-230,F,12/26/16,DEN,@,LAC,W,1,29,1,4,0.25,1,3,0.333,0,1,0,0,0,,1,3,4
18381,Marquese Chriss,19-137,F,11/16/16,PHO,@,DEN,L,1,12,1,1,1,1,1,1,0,0,,0,1,0,0,1,1
18382,Marquese Chriss,19-184,F,1/2/17,PHO,@,LAC,L,1,12,1,5,0.2,1,3,0.333,0,2,0,0,0,,1,0,1
18383,Marquese Chriss,19-216,F,2/3/17,PHO,@,SAC,W,1,16,1,6,0.167,1,3,0.333,0,3,0,0,0,,0,2,2
18384,Marquese Chriss,19-148,F,11/27/16,PHO,,DEN,L,1,10,1,2,0.5,1,2,0.5,0,0,,0,0,,0,0,0
18385,Marquese Chriss,19-125,F,11/4/16,PHO,@,NOP,W,0,10,1,3,0.333,1,3,0.333,0,0,,0,0,,0,2,2
18386,Marquese Chriss,19-187,F,1/5/17,PHO,@,DAL,W,1,18,0,2,0,0,2,0,0,0,,2,2,1,1,7,8
18387,Rakeem Christmas,25-095,F,3/6/17,IND,@,CHO,L,0,9,1,1,1,1,1,1,0,0,,0,0,,1,1,2
18388,Rakeem Christmas,25-094,F,3/5/17,IND,@,ATL,W,0,4,1,1,1,1,1,1,0,0,,0,0,,1,1,2
18389,Rakeem Christmas,25-103,F,3/14/17,IND,@,NYK,L,0,17,0,1,0,0,1,0,0,0,,2,2,1,1,4,5
18390,Rakeem Christmas,25-097,F,3/8/17,IND,,DET,W,0,5,1,3,0.333,1,3,0.333,0,0,,0,0,,0,1,1
18391,Semaj Christon,24-060,G,12/31/16,OKC,,LAC,W,0,19,1,5,0.2,1,3,0.333,0,2,0,0,0,,1,0,1
18392,Semaj Christon,24-133,G,3/14/17,OKC,@,BRK,W,0,17,1,1,1,1,1,1,0,0,,0,0,,0,3,3
18393,Semaj Christon,24-058,G,12/29/16,OKC,@,MEM,L,0,27,1,4,0.25,1,1,1,0,3,0,0,0,,1,2,3
18394,Semaj Christon,24-006,G,11/7/16,OKC,,MIA,W,0,21,1,4,0.25,1,4,0.25,0,0,,0,0,,1,3,4
18395,Semaj Christon,24-034,G,12/5/16,OKC,@,ATL,W,0,14,1,3,0.333,1,2,0.5,0,1,0,0,0,,0,2,2
18396,Semaj Christon,24-091,G,1/31/17,OKC,@,SAS,L,0,5,0,2,0,0,2,0,0,0,,2,2,1,0,1,1
18397,Semaj Christon,24-033,G,12/4/16,OKC,,NOP,W,0,11,1,3,0.333,1,2,0.5,0,1,0,0,1,0,0,1,1
18398,Semaj Christon,24-065,G,1/5/17,OKC,@,HOU,L,0,12,1,4,0.25,1,3,0.333,0,1,0,0,0,,0,0,0
18399,Semaj Christon,24-137,G,3/18/17,OKC,,SAC,W,0,12,1,1,1,1,1,1,0,0,,0,0,,0,0,0
18400,Semaj Christon,24-029,G,11/30/16,OKC,,WAS,W,0,15,1,2,0.5,1,1,1,0,1,0,0,0,,1,0,1
18401,Semaj Christon,24-137,G,3/18/17,OKC,,SAC,W,0,12,1,1,1,1,1,1,0,0,,0,0,,0,0,0
18402,Semaj Christon,24-029,G,11/30/16,OKC,,WAS,W,0,15,1,2,0.5,1,1,1,0,1,0,0,0,,1,0,1
18403,Semaj Christon,23-362,G,10/28/16,OKC,,PHO,W,0,11,1,4,0.25,1,4,0.25,0,0,,0,2,0,1,1,2
18404,Ian Clark,25-331,G,2/1/17,GSW,,CHO,W,0,16,1,6,0.167,1,3,0.333,0,3,0,0,0,,1,3,4
18405,Ian Clark,25-328,G,1/29/17,GSW,@,POR,W,0,13,0,1,0,0,0,,0,1,0,2,2,1,0,2,2
18406,Ian Clark,25-353,G,2/23/17,GSW,,LAC,W,0,9,1,3,0.333,1,2,0.5,0,1,0,0,0,,0,2,2
18407,Ian Clark,26-001,G,3/8/17,GSW,,BOS,L,0,6,1,1,1,1,1,1,0,0,,0,0,,0,0,0
18408,Ian Clark,25-322,G,1/23/17,GSW,@,MIA,L,0,12,1,2,0.5,1,2,0.5,0,0,,0,0,,0,0,0
18409,Ian Clark,25-360,G,3/2/17,GSW,@,CHI,L,0,7,0,1,0,0,1,0,0,0,,2,2,1,1,0,1
18410,Ian Clark,25-358,G,2/28/17,GSW,@,WAS,L,0,2,1,2,0.5,1,2,0.5,0,0,,0,0,,0,0,0
18411,Ian Clark,25-245,G,11/7/16,GSW,,NOP,W,0,13,1,3,0.333,1,1,1,0,2,0,0,0,,0,2,2
18412,Ian Clark,25-315,G,1/16/17,GSW,,CLE,W,0,12,0,3,0,0,1,0,0,2,0,2,4,0.5,0,3,3
18413,Ian Clark,25-242,G,11/4/16,GSW,@,LAL,L,0,13,1,5,0.2,1,3,0.333,0,2,0,0,0,,0,2,2
18414,Jordan Clarkson,24-208,G,1/1/17,LAL,,TOR,L,0,17,1,5,0.2,1,3,0.333,0,2,0,0,1,0,0,1,1
18415,Jordan Clarkson,24-241,G,2/3/17,LAL,@,BOS,L,0,22,1,7,0.143,1,4,0.25,0,3,0,0,0,,1,0,1
18416,Norris Cole,28-145,G,3/7/17,OKC,,POR,L,0,6,1,2,0.5,1,2,0.5,0,0,,0,0,,0,0,0
18417,Norris Cole,28-141,G,3/3/17,OKC,@,PHO,L,0,10,1,6,0.167,1,5,0.2,0,1,0,0,0,,0,1,1
18418,Darren Collison,29-208,G,3/19/17,SAC,@,SAS,L,1,24,1,8,0.125,1,8,0.125,0,0,,0,0,,0,2,2
18419,Darren Collison,29-117,G,12/18/16,SAC,@,DAL,L,1,25,1,8,0.125,1,5,0.2,0,3,0,0,1,0,0,1,1
18420,Nick Collison,36-049,F,12/14/16,OKC,@,UTA,L,0,16,1,2,0.5,1,2,0.5,0,0,,0,0,,2,2,4
18421,Nick Collison,36-100,F,2/3/17,OKC,,MEM,W,0,11,0,0,,0,0,,0,0,,2,4,0.5,1,2,3
18422,Pat Connaughton,24-021,G,1/27/17,POR,,MEM,W,0,13,1,2,0.5,1,2,0.5,0,0,,0,0,,1,1,2
18423,Pat Connaughton,23-316,G,11/17/16,POR,@,HOU,L,0,6,1,2,0.5,1,2,0.5,0,0,,0,0,,0,1,1
18424,Pat Connaughton,24-010,G,1/16/17,POR,@,WAS,L,0,5,1,1,1,1,1,1,0,0,,0,0,,0,1,1
18425,Quinn Cook,23-341,G,2/27/17,DAL,,MIA,W,0,17,1,5,0.2,1,2,0.5,0,3,0,0,0,,0,2,2
18426,Robert Covington,25-347,F,11/25/16,PHI,,CHI,L,1,20,0,4,0,0,1,0,0,3,0,2,2,1,1,0,1
18427,Allen Crabbe,24-206,G-F,11/1/16,POR,,GSW,L,0,20,1,2,0.5,1,1,1,0,1,0,0,0,,1,0,1
18428,Allen Crabbe,24-228,G-F,11/23/16,POR,@,CLE,L,0,24,1,6,0.167,1,4,0.25,0,2,0,0,0,,1,4,5
18429,Jamal Crawford,36-300,G,1/14/17,LAC,,LAL,W,0,22,1,9,0.111,1,8,0.125,0,1,0,0,0,,0,0,0
18430,Jamal Crawford,36-294,G,1/8/17,LAC,,MIA,W,0,31,1,12,0.083,1,8,0.125,0,4,0,0,0,,0,1,1
18431,Jamal Crawford,36-234,G,11/9/16,LAC,,POR,W,0,19,1,6,0.167,1,2,0.5,0,4,0,0,0,,0,1,1
18432,Dante Cunningham,29-285,F,2/1/17,NOP,@,DET,L,0,22,1,2,0.5,1,1,1,0,1,0,0,0,,0,2,2
18433,Dante Cunningham,29-309,F,2/25/17,NOP,@,DAL,L,0,17,1,2,0.5,1,1,1,0,1,0,0,0,,0,3,3
18434,Dante Cunningham,29-215,F,11/23/16,NOP,,MIN,W,1,12,1,2,0.5,1,2,0.5,0,0,,0,0,,0,2,2
18435,Troy Daniels,25-228,G,2/28/17,MEM,,PHO,W,0,12,0,3,0,0,1,0,0,2,0,2,2,1,0,1,1
18436,Troy Daniels,25-184,G,1/15/17,MEM,,CHI,L,0,7,0,5,0,0,0,,0,5,0,2,2,1,0,0,0
18437,Deyonta Davis,20-001,F-C,12/3/16,MEM,,LAL,W,0,7,1,2,0.5,1,2,0.5,0,0,,0,0,,1,1,2
18438,Deyonta Davis,20-054,F-C,1/25/17,MEM,,TOR,W,0,7,0,2,0,0,2,0,0,0,,2,2,1,1,3,4
18439,Deyonta Davis,19-364,F-C,11/30/16,MEM,@,TOR,L,0,10,1,3,0.333,1,3,0.333,0,0,,0,0,,1,2,3
18440,Deyonta Davis,19-348,F-C,11/14/16,MEM,@,UTA,W,0,13,1,3,0.333,1,3,0.333,0,0,,0,1,0,2,1,3
18441,Deyonta Davis,19-360,F-C,11/26/16,MEM,@,MIA,W,0,11,1,1,1,1,1,1,0,0,,0,0,,1,0,1
18442,Deyonta Davis,20-101,F-C,3/13/17,MEM,,MIL,W,0,2,1,1,1,1,1,1,0,0,,0,0,,0,0,0
18443,Ed Davis,27-152,F,11/4/16,POR,@,DAL,W,0,9,1,1,1,1,1,1,0,0,,0,2,0,2,1,3
18444,Ed Davis,27-166,F,11/18/16,POR,@,NOP,L,1,21,1,4,0.25,1,4,0.25,0,0,,0,0,,3,8,11
18445,Ed Davis,27-150,F,11/2/16,POR,@,PHO,L,0,15,1,3,0.333,1,3,0.333,0,0,,0,0,,2,4,6
18446,Ed Davis,27-193,F,12/15/16,POR,@,DEN,L,0,15,0,3,0,0,3,0,0,0,,2,2,1,4,3,7
18447,Ed Davis,27-178,F,11/30/16,POR,,IND,W,1,32,1,3,0.333,1,3,0.333,0,0,,0,0,,5,4,9
18448,Ed Davis,27-161,F,11/13/16,POR,,DEN,W,0,21,1,4,0.25,1,4,0.25,0,0,,0,2,0,3,4,7
18449,Ed Davis,27-229,F,1/20/17,POR,@,PHI,L,0,15,1,2,0.5,1,2,0.5,0,0,,0,0,,1,5,6
18450,Ed Davis,27-225,F,1/16/17,POR,@,WAS,L,0,5,0,0,,0,0,,0,0,,2,2,1,0,0,0
18451,Ed Davis,27-156,F,11/8/16,POR,,PHO,W,0,17,1,2,0.5,1,2,0.5,0,0,,0,1,0,1,1,2
18452,Ed Davis,27-185,F,12/7/16,POR,@,MIL,L,1,17,1,3,0.333,1,3,0.333,0,0,,0,0,,2,3,5
18453,Ed Davis,27-154,F,11/6/16,POR,@,MEM,W,0,13,0,1,0,0,1,0,0,0,,2,2,1,0,4,4
18454,Dewayne Dedmon,27-221,C,3/21/17,SAS,@,MIN,W,1,21,0,1,0,0,1,0,0,0,,2,4,0.5,1,4,5
18455,Dewayne Dedmon,27-146,C,1/5/17,SAS,@,DEN,W,0,13,1,2,0.5,1,2,0.5,0,0,,0,0,,1,2,3
18456,Dewayne Dedmon,27-218,C,3/18/17,SAS,@,MEM,L,1,20,1,1,1,1,1,1,0,0,,0,0,,1,2,3
18457,Dewayne Dedmon,27-162,C,1/21/17,SAS,@,CLE,W,0,10,1,2,0.5,1,2,0.5,0,0,,0,0,,0,4,4
18458,Dewayne Dedmon,27-178,C,2/6/17,SAS,@,MEM,L,1,27,1,3,0.333,1,3,0.333,0,0,,0,0,,1,11,12
18459,Dewayne Dedmon,27-155,C,1/14/17,SAS,@,PHO,L,0,14,1,1,1,1,1,1,0,0,,0,0,,1,2,3
18460,Dewayne Dedmon,27-092,C,11/12/16,SAS,@,HOU,W,0,7,1,2,0.5,1,2,0.5,0,0,,0,0,,1,0,1
18461,Dewayne Dedmon,27-170,C,1/29/17,SAS,,DAL,L,0,14,1,2,0.5,1,2,0.5,0,0,,0,0,,0,6,6
18462,Dewayne Dedmon,27-074,C,10/25/16,SAS,@,GSW,W,0,17,1,4,0.25,1,4,0.25,0,0,,0,0,,4,4,8
18463,Dewayne Dedmon,27-208,C,3/8/17,SAS,,SAC,W,1,14,0,1,0,0,1,0,0,0,,2,2,1,0,5,5
18464,Sam Dekker,22-304,F,3/6/17,HOU,@,SAS,L,0,14,1,5,0.2,1,2,0.5,0,3,0,0,0,,1,3,4
18465,Sam Dekker,22-316,F,3/18/17,HOU,@,DEN,W,0,8,1,1,1,1,1,1,0,0,,0,0,,0,1,1
18466,Sam Dekker,22-229,F,12/21/16,HOU,@,PHO,W,0,17,1,2,0.5,1,1,1,0,1,0,0,4,0,3,3,6
18467,Sam Dekker,22-299,F,3/1/17,HOU,@,LAC,W,0,11,1,3,0.333,1,1,1,0,2,0,0,0,,1,5,6
18468,Sam Dekker,22-272,F,2/2/17,HOU,,ATL,L,0,12,1,5,0.2,1,3,0.333,0,2,0,0,0,,0,1,1
18469,Sam Dekker,22-197,F,11/19/16,HOU,,UTA,W,0,16,1,2,0.5,1,1,1,0,1,0,0,0,,0,1,1
18470,Sam Dekker,22-225,F,12/17/16,HOU,@,MIN,W,0,17,1,4,0.25,1,2,0.5,0,2,0,0,0,,2,2,4
18471,Sam Dekker,22-175,F,10/28/16,HOU,@,DAL,W,0,13,1,3,0.333,1,1,1,0,2,0,0,0,,0,4,4
18472,Sam Dekker,22-306,F,3/8/17,HOU,,UTA,L,0,22,1,4,0.25,1,1,1,0,3,0,0,0,,0,1,1
18473,Malcolm Delaney,27-294,G,12/30/16,ATL,,DET,W,0,16,1,4,0.25,1,3,0.333,0,1,0,0,0,,0,3,3
18474,Malcolm Delaney,27-339,G,2/13/17,ATL,@,POR,W,0,13,0,5,0,0,3,0,0,2,0,2,2,1,0,0,0
18475,Malcolm Delaney,27-290,G,12/26/16,ATL,@,MIN,L,0,21,1,6,0.167,1,3,0.333,0,3,0,0,0,,0,1,1
18476,Malcolm Delaney,27-359,G,3/5/17,ATL,,IND,L,0,11,1,2,0.5,1,2,0.5,0,0,,0,0,,0,0,0
18477,Malcolm Delaney,27-320,G,1/25/17,ATL,@,CHI,W,0,18,1,4,0.25,1,3,0.333,0,1,0,0,0,,1,1,2
18478,Malcolm Delaney,27-236,G,11/2/16,ATL,,LAL,L,0,18,0,4,0,0,3,0,0,1,0,2,2,1,1,2,3
18479,Malcolm Delaney,27-355,G,3/1/17,ATL,,DAL,W,0,15,0,2,0,0,1,0,0,1,0,2,2,1,0,1,1
18480,Malcolm Delaney,27-283,G,12/19/16,ATL,@,OKC,W,0,11,1,3,0.333,1,1,1,0,2,0,0,0,,0,1,1
18481,Malcolm Delaney,27-264,G,11/30/16,ATL,@,PHO,L,0,9,1,4,0.25,1,3,0.333,0,1,0,0,0,,0,0,0
18482,Malcolm Delaney,27-351,G,2/25/17,ATL,@,ORL,L,1,15,1,4,0.25,1,3,0.333,0,1,0,0,0,,0,0,0
18483,Malcolm Delaney,27-328,G,2/2/17,ATL,@,HOU,W,0,25,1,10,0.1,1,7,0.143,0,3,0,0,0,,0,5,5
18484,Matthew Dellavedova,26-059,G,11/6/16,MIL,@,DAL,L,1,33,1,7,0.143,1,4,0.25,0,3,0,0,0,,0,5,5
18485,Matthew Dellavedova,26-095,G,12/12/16,MIL,@,TOR,L,1,28,1,8,0.125,1,6,0.167,0,2,0,0,0,,0,0,0
18486,Matthew Dellavedova,26-122,G,1/8/17,MIL,,WAS,L,0,18,1,5,0.2,1,2,0.5,0,3,0,0,0,,0,2,2
18487,Matthew Dellavedova,26-104,G,12/21/16,MIL,@,CLE,L,1,25,1,4,0.25,1,1,1,0,3,0,0,0,,0,2,2
18488,Luol Deng,31-260,F,1/1/17,LAL,,TOR,L,1,30,1,6,0.167,1,4,0.25,0,2,0,0,0,,1,2,3
18489,Luol Deng,31-230,F,12/2/16,LAL,@,TOR,L,1,24,1,6,0.167,1,4,0.25,0,2,0,0,0,,1,2,3
18490,Luol Deng,31-274,F,1/15/17,LAL,,DET,L,1,36,1,6,0.167,1,3,0.333,0,3,0,0,0,,2,5,7
18491,Luol Deng,31-208,F,11/10/16,LAL,@,SAC,W,1,23,1,5,0.2,1,3,0.333,0,2,0,0,0,,0,6,6
18492,Luol Deng,31-206,F,11/8/16,LAL,,DAL,L,1,30,1,5,0.2,1,3,0.333,0,2,0,0,0,,1,4,5
18493,Luol Deng,31-235,F,12/7/16,LAL,@,HOU,L,1,22,1,5,0.2,1,5,0.2,0,0,,0,0,,0,2,2
18494,Cheick Diallo,20-129,F,1/20/17,NOP,,BRK,L,0,10,1,6,0.167,1,6,0.167,0,0,,0,0,,3,3,6
18495,Boris Diaw,34-318,F-C,2/28/17,UTA,@,OKC,L,0,13,1,3,0.333,1,2,0.5,0,1,0,0,0,,0,1,1
18496,Boris Diaw,34-192,F-C,10/25/16,UTA,@,POR,L,1,32,1,8,0.125,1,5,0.2,0,3,0,0,0,,1,2,3
18497,Boris Diaw,34-242,F-C,12/14/16,UTA,,OKC,W,1,25,1,6,0.167,1,6,0.167,0,0,,0,0,,1,0,1
18498,Boris Diaw,34-291,F-C,2/1/17,UTA,,MIL,W,1,20,1,6,0.167,1,3,0.333,0,3,0,0,0,,1,1,2
18499,Boris Diaw,34-223,F-C,11/25/16,UTA,,ATL,W,1,19,1,6,0.167,1,2,0.5,0,4,0,0,0,,1,2,3
18500,Boris Diaw,34-257,F-C,12/29/16,UTA,,PHI,W,0,17,1,4,0.25,1,4,0.25,0,0,,0,0,,0,0,0
18501,Boris Diaw,34-324,F-C,3/6/17,UTA,,NOP,W,0,24,1,4,0.25,1,2,0.5,0,2,0,0,0,,0,1,1
18502,Boris Diaw,34-338,F-C,3/20/17,UTA,@,IND,L,0,14,1,3,0.333,1,2,0.5,0,1,0,0,0,,2,2,4
18503,Boris Diaw,34-251,F-C,12/23/16,UTA,,TOR,L,1,13,1,3,0.333,1,3,0.333,0,0,,0,0,,1,3,4
18504,Boris Diaw,34-267,F-C,1/8/17,UTA,@,MEM,L,0,19,1,2,0.5,1,2,0.5,0,0,,0,0,,0,3,3
18505,Boris Diaw,34-218,F-C,11/20/16,UTA,@,DEN,L,0,8,0,0,,0,0,,0,0,,2,2,1,1,1,2
18506,Boris Diaw,34-248,F-C,12/20/16,UTA,@,GSW,L,1,16,1,5,0.2,1,5,0.2,0,0,,0,0,,0,3,3
18507,Boris Diaw,34-298,F-C,2/8/17,UTA,@,NOP,W,0,15,1,2,0.5,1,2,0.5,0,0,,0,0,,1,2,3
18508,Boris Diaw,34-318,F-C,2/28/17,UTA,@,OKC,L,0,13,1,3,0.333,1,2,0.5,0,1,0,0,0,,0,1,1
18509,Gorgui Dieng,26-290,C,11/3/16,MIN,,DEN,L,1,28,1,6,0.167,1,6,0.167,0,0,,0,0,,2,2,4
18510,Gorgui Dieng,27-040,C,2/27/17,MIN,@,SAC,W,1,20,0,8,0,0,7,0,0,1,0,2,2,1,1,9,10
18511,Gorgui Dieng,26-319,C,12/2/16,MIN,@,NYK,L,1,18,1,2,0.5,1,2,0.5,0,0,,0,0,,1,4,5
18512,Gorgui Dieng,27-017,C,2/4/17,MIN,,MEM,L,1,35,1,6,0.167,1,6,0.167,0,0,,0,0,,4,9,13
18513,Gorgui Dieng,26-300,C,11/13/16,MIN,,LAL,W,1,31,1,4,0.25,1,4,0.25,0,0,,0,0,,2,7,9
18514,Gorgui Dieng,27-014,C,2/1/17,MIN,@,CLE,L,1,21,1,4,0.25,1,4,0.25,0,0,,0,0,,2,4,6
18515,Spencer Dinwiddie,23-260,G,12/22/16,BRK,,GSW,L,0,11,1,3,0.333,1,3,0.333,0,0,,0,0,,0,0,0
18516,Spencer Dinwiddie,23-308,G,2/8/17,BRK,,WAS,L,1,16,1,4,0.25,1,3,0.333,0,1,0,0,0,,1,1,2
18517,Spencer Dinwiddie,23-338,G,3/10/17,BRK,@,DAL,L,0,22,1,2,0.5,1,1,1,0,1,0,0,0,,0,0,0
18518,Spencer Dinwiddie,23-266,G,12/28/16,BRK,@,CHI,L,0,15,0,3,0,0,3,0,0,0,,2,2,1,0,1,1
18519,Toney Douglas,30-362,G,3/13/17,MEM,,MIL,W,0,2,0,0,,0,0,,0,0,,2,2,1,0,0,0
18520,Toney Douglas,30-265,G,12/6/16,MEM,,PHI,W,0,6,1,3,0.333,1,2,0.5,0,1,0,0,0,,1,1,2
18521,Toney Douglas,30-322,G,2/1/17,MEM,@,DEN,W,0,5,1,2,0.5,1,1,1,0,1,0,0,0,,0,0,0
18522,Toney Douglas,30-347,G,2/26/17,MEM,@,DEN,W,0,20,1,4,0.25,1,2,0.5,0,2,0,0,0,,2,2,4
18523,Jared Dudley,31-146,F-G,12/3/16,PHO,@,GSW,L,0,13,1,4,0.25,1,2,0.5,0,2,0,0,0,,0,2,2
18524,Jared Dudley,31-121,F-G,11/8/16,PHO,@,POR,L,0,22,1,2,0.5,1,1,1,0,1,0,0,0,,0,4,4
18525,Jared Dudley,31-200,F-G,1/26/17,PHO,@,DEN,L,0,18,1,2,0.5,1,1,1,0,1,0,0,0,,1,1,2
18526,Jared Dudley,31-164,F-G,12/21/16,PHO,,HOU,L,0,13,1,3,0.333,1,1,1,0,2,0,0,0,,0,2,2
18527,Mike Dunleavy,36-073,F-G,11/27/16,CLE,@,PHI,W,0,9,1,6,0.167,1,3,0.333,0,3,0,0,0,,0,0,0
18528,Mike Dunleavy,36-125,F-G,1/18/17,ATL,@,DET,L,0,21,1,4,0.25,1,2,0.5,0,2,0,0,0,,2,2,4
18529,Mike Dunleavy,36-043,F-G,10/28/16,CLE,@,TOR,W,0,16,1,4,0.25,1,3,0.333,0,1,0,0,0,,0,0,0
18530,Mike Dunleavy,36-059,F-G,11/13/16,CLE,,CHO,W,1,17,1,6,0.167,1,3,0.333,0,3,0,0,0,,0,3,3
18531,Kris Dunn,22-244,G,11/17/16,MIN,,PHI,W,0,23,1,3,0.333,1,2,0.5,0,1,0,0,0,,0,3,3
18532,Kris Dunn,22-274,G,12/17/16,MIN,,HOU,L,0,13,1,6,0.167,1,4,0.25,0,2,0,0,0,,1,1,2
18533,Kris Dunn,23-001,G,3/19/17,MIN,@,NOP,L,0,13,1,3,0.333,1,2,0.5,0,1,0,0,0,,0,1,1
18534,Kris Dunn,22-270,G,12/13/16,MIN,@,CHI,W,0,13,1,3,0.333,1,2,0.5,0,1,0,0,0,,1,1,2
18535,Kris Dunn,22-364,G,3/17/17,MIN,@,MIA,L,0,14,1,2,0.5,1,2,0.5,0,0,,0,0,,1,1,2
18536,Kris Dunn,22-253,G,11/26/16,MIN,@,GSW,L,0,10,1,2,0.5,1,2,0.5,0,0,,0,0,,0,2,2
18537,Kris Dunn,22-285,G,12/28/16,MIN,@,DEN,L,0,14,1,5,0.2,1,4,0.25,0,1,0,0,0,,0,0,0
18538,Kris Dunn,22-236,G,11/9/16,MIN,@,ORL,W,1,17,1,3,0.333,1,3,0.333,0,0,,0,0,,0,2,2
18539,Kris Dunn,22-316,G,1/28/17,MIN,,BRK,W,0,26,1,2,0.5,1,1,1,0,1,0,0,0,,0,5,5
18540,Kris Dunn,22-334,G,2/15/17,MIN,@,DEN,W,0,20,1,4,0.25,1,4,0.25,0,0,,0,0,,0,4,4
18541,Kris Dunn,22-295,G,1/7/17,MIN,,UTA,L,0,14,1,3,0.333,1,2,0.5,0,1,0,0,0,,0,2,2
18542,Kris Dunn,22-312,G,1/24/17,MIN,@,PHO,W,0,14,1,7,0.143,1,4,0.25,0,3,0,0,0,,0,3,3
18543,Kris Dunn,22-333,G,2/14/17,MIN,,CLE,L,0,9,1,3,0.333,1,3,0.333,0,0,,0,0,,0,1,1
18544,Kris Dunn,22-357,G,3/10/17,MIN,,GSW,W,0,12,1,4,0.25,1,4,0.25,0,0,,0,0,,0,2,2
18545,Jarell Eddie,25-142,G-F,3/21/17,PHO,@,MIA,L,0,4,1,2,0.5,1,1,1,0,1,0,0,0,,1,0,1
18546,Henry Ellenson,19-363,F,1/10/17,DET,@,SAC,L,0,7,1,3,0.333,1,1,1,0,2,0,0,0,,1,1,2
18547,Henry Ellenson,19-289,F,10/28/16,DET,,ORL,W,0,2,1,1,1,1,1,1,0,0,,0,0,,0,3,3
18548,Henry Ellenson,20-005,F,1/18/17,DET,,ATL,W,0,2,1,1,1,1,1,1,0,0,,0,0,,0,0,0
18549,Wayne Ellington,29-069,G,1/6/17,MIA,@,LAL,L,0,16,0,6,0,0,2,0,0,4,0,2,3,0.667,0,2,2
18550,Monta Ellis,31-103,G,2/6/17,IND,,OKC,W,0,22,1,3,0.333,1,3,0.333,0,0,,0,2,0,0,2,2
18551,Monta Ellis,31-003,G,10/29/16,IND,@,CHI,L,1,28,1,6,0.167,1,5,0.2,0,1,0,0,0,,0,2,2
18552,Monta Ellis,31-065,G,12/30/16,IND,,CHI,W,0,13,1,2,0.5,1,2,0.5,0,0,,0,0,,0,1,1
18553,Monta Ellis,31-084,G,1/18/17,IND,@,SAC,W,0,29,1,6,0.167,1,5,0.2,0,1,0,0,1,0,2,2,4
18554,Monta Ellis,31-082,G,1/16/17,IND,,NOP,W,0,19,1,2,0.5,1,2,0.5,0,0,,0,0,,0,1,1
18555,Monta Ellis,31-010,G,11/5/16,IND,,CHI,W,1,32,1,2,0.5,1,1,1,0,1,0,0,0,,0,7,7
18556,Monta Ellis,31-071,G,1/5/17,IND,,BRK,W,0,21,1,3,0.333,1,3,0.333,0,0,,0,0,,0,1,1
18557,James Ennis,26-260,F,3/18/17,MEM,,SAS,W,0,14,0,1,0,0,1,0,0,0,,2,2,1,0,1,1
18558,James Ennis,26-255,F,3/13/17,MEM,,MIL,W,0,12,1,2,0.5,1,2,0.5,0,0,,0,0,,0,1,1
18559,Tyler Ennis,22-073,G,11/5/16,HOU,@,ATL,L,0,7,1,2,0.5,1,2,0.5,0,0,,0,0,,1,1,2
18560,Tyler Ennis,22-131,G,1/2/17,HOU,,WAS,W,0,6,1,4,0.25,1,3,0.333,0,1,0,0,0,,0,0,0
18561,Tyler Ennis,22-158,G,1/29/17,HOU,@,IND,L,0,3,1,1,1,1,1,1,0,0,,0,0,,0,0,0
18562,Tyler Ennis,22-067,G,10/30/16,HOU,,DAL,W,0,9,1,4,0.25,1,2,0.5,0,2,0,0,0,,0,0,0
18563,Tyler Ennis,22-149,G,1/20/17,HOU,,GSW,L,0,3,1,1,1,1,1,1,0,0,,0,0,,0,0,0
18564,Tyler Ennis,22-191,G,3/3/17,LAL,,BOS,L,0,16,1,7,0.143,1,6,0.167,0,1,0,0,0,,1,1,2
18565,Tyler Ennis,22-207,G,3/19/17,LAL,,CLE,L,0,5,1,2,0.5,1,2,0.5,0,0,,0,0,,0,0,0
18566,Tyreke Evans,27-098,G-F,12/26/16,NOP,,DAL,W,0,11,1,4,0.25,1,2,0.5,0,2,0,0,0,,0,0,0
18567,Tyreke Evans,27-132,G-F,1/29/17,NOP,,WAS,L,0,18,1,3,0.333,1,2,0.5,0,1,0,0,2,0,0,2,2
18568,Dante Exum,21-139,G,11/29/16,UTA,,HOU,W,0,8,1,4,0.25,1,2,0.5,0,2,0,0,0,,1,2,3
18569,Dante Exum,21-199,G,1/28/17,UTA,,MEM,L,0,5,0,0,,0,0,,0,0,,2,2,1,0,0,0
18570,Dante Exum,21-213,G,2/11/17,UTA,,BOS,L,0,6,1,4,0.25,1,2,0.5,0,2,0,0,0,,0,0,0
18571,Dante Exum,21-235,G,3/5/17,UTA,@,SAC,W,0,13,1,5,0.2,1,3,0.333,0,2,0,0,0,,1,0,1
18572,Dante Exum,21-148,G,12/8/16,UTA,,GSW,L,1,37,1,11,0.091,1,6,0.167,0,5,0,0,0,,1,2,3
18573,Dante Exum,21-185,G,1/14/17,UTA,,ORL,W,0,8,1,4,0.25,1,2,0.5,0,2,0,0,0,,0,0,0
18574,Dante Exum,21-246,G,3/16/17,UTA,@,CLE,L,0,20,1,5,0.2,1,5,0.2,0,0,,0,0,,4,1,5
18575,Dante Exum,21-176,G,1/5/17,UTA,@,TOR,L,0,14,1,3,0.333,1,1,1,0,2,0,0,0,,0,0,0
18576,Dante Exum,21-230,G,2/28/17,UTA,@,OKC,L,0,8,1,4,0.25,1,4,0.25,0,0,,0,0,,0,0,0
18577,Kenneth Faried,27-023,F,12/12/16,DEN,@,DAL,L,0,8,1,2,0.5,1,2,0.5,0,0,,0,0,,0,0,0
18578,Kenneth Faried,27-096,F,2/23/17,DEN,@,SAC,L,1,14,1,7,0.143,1,7,0.143,0,0,,0,0,,2,1,3
18579,Kenneth Faried,27-016,F,12/5/16,DEN,@,PHI,W,1,13,0,1,0,0,1,0,0,0,,2,2,1,0,2,2
18580,Derrick Favors,25-204,F-C,2/4/17,UTA,,CHO,W,0,10,1,2,0.5,1,2,0.5,0,0,,0,0,,0,4,4
18581,Derrick Favors,25-215,F-C,2/15/17,UTA,,POR,W,1,26,1,3,0.333,1,3,0.333,0,0,,0,0,,1,5,6
18582,Kay Felder,21-290,G,1/13/17,CLE,@,SAC,W,0,1,1,1,1,1,1,1,0,0,,0,0,,0,0,0
18583,Kay Felder,21-288,G,1/11/17,CLE,@,POR,L,0,13,0,6,0,0,5,0,0,1,0,2,4,0.5,0,2,2
18584,Kay Felder,21-285,G,1/8/17,CLE,@,PHO,W,0,8,1,2,0.5,1,2,0.5,0,0,,0,0,,0,0,0
18585,Kay Felder,21-227,G,11/11/16,CLE,@,WAS,W,0,8,1,2,0.5,1,2,0.5,0,0,,0,0,,0,2,2
18586,Kay Felder,21-259,G,12/13/16,CLE,,MEM,W,0,8,1,2,0.5,1,2,0.5,0,0,,0,0,,0,4,4
18587,Kay Felder,21-317,G,2/9/17,CLE,@,OKC,L,0,6,0,0,,0,0,,0,0,,2,2,1,0,0,0
18588,Kay Felder,21-214,G,10/29/16,CLE,,ORL,W,0,5,1,3,0.333,1,2,0.5,0,1,0,0,0,,1,0,1
18589,Kay Felder,21-296,G,1/19/17,CLE,,PHO,W,0,2,1,2,0.5,1,2,0.5,0,0,,0,0,,0,0,0
18590,Kay Felder,21-247,G,12/1/16,CLE,,LAC,L,0,11,0,3,0,0,3,0,0,0,,2,2,1,0,1,1
18591,Kay Felder,21-293,G,1/16/17,CLE,@,GSW,L,0,7,1,6,0.167,1,4,0.25,0,2,0,0,0,,0,0,0
18592,Cristiano Felicio,24-174,F-C,12/28/16,CHI,,BRK,W,0,11,1,3,0.333,1,3,0.333,0,0,,0,0,,2,7,9
18593,Cristiano Felicio,24-131,F-C,11/15/16,CHI,@,POR,W,0,4,1,4,0.25,1,4,0.25,0,0,,0,0,,3,2,5
18594,Cristiano Felicio,24-172,F-C,12/26/16,CHI,,IND,W,0,12,0,1,0,0,1,0,0,0,,2,4,0.5,1,1,2
18595,Cristiano Felicio,24-123,F-C,11/7/16,CHI,,ORL,W,0,6,1,1,1,1,1,1,0,0,,0,0,,1,2,3
18596,Cristiano Felicio,24-121,F-C,11/5/16,CHI,@,IND,L,0,13,1,3,0.333,1,3,0.333,0,0,,0,0,,2,1,3
18597,Cristiano Felicio,24-120,F-C,11/4/16,CHI,,NYK,L,0,9,1,1,1,1,1,1,0,0,,0,0,,1,0,1
18598,Cristiano Felicio,24-254,F-C,3/18/17,CHI,,UTA,W,0,11,1,1,1,1,1,1,0,0,,0,0,,0,0,0
18599,Cristiano Felicio,24-197,F-C,1/20/17,CHI,@,ATL,L,0,11,0,1,0,0,1,0,0,0,,2,2,1,1,1,2
18600,Cristiano Felicio,24-238,F-C,3/2/17,CHI,,GSW,W,0,26,1,1,1,1,1,1,0,0,,0,0,,2,9,11
18601,Cristiano Felicio,24-253,F-C,3/17/17,CHI,@,WAS,L,0,6,1,2,0.5,1,2,0.5,0,0,,0,0,,2,2,4
18602,Cristiano Felicio,24-211,F-C,2/3/17,CHI,@,HOU,L,0,7,1,2,0.5,1,2,0.5,0,0,,0,0,,0,0,0
18603,Cristiano Felicio,24-251,F-C,3/15/17,CHI,,MEM,L,0,24,1,1,1,1,1,1,0,0,,0,0,,1,1,2
18604,Cristiano Felicio,24-249,F-C,3/13/17,CHI,@,CHO,W,0,14,1,1,1,1,1,1,0,0,,0,0,,1,6,7
18605,Raymond Felton,32-262,G,3/15/17,LAC,,MIL,L,0,13,1,5,0.2,1,3,0.333,0,2,0,0,0,,0,2,2
18606,Raymond Felton,32-136,G,11/9/16,LAC,,POR,W,0,24,1,6,0.167,1,3,0.333,0,3,0,0,0,,0,0,0
18607,Raymond Felton,32-255,G,3/8/17,LAC,@,MIN,L,0,16,1,3,0.333,1,3,0.333,0,0,,0,0,,0,0,0
18608,Raymond Felton,32-146,G,11/19/16,LAC,,CHI,W,0,10,1,4,0.25,1,3,0.333,0,1,0,0,0,,0,2,2
18609,Raymond Felton,32-212,G,1/24/17,LAC,@,PHI,L,0,17,1,3,0.333,1,1,1,0,2,0,0,0,,0,1,1
18610,Raymond Felton,32-232,G,2/13/17,LAC,@,UTA,W,0,21,1,8,0.125,1,6,0.167,0,2,0,0,0,,1,3,4
18611,Raymond Felton,32-267,G,3/20/17,LAC,,NYK,W,0,20,0,5,0,0,4,0,0,1,0,2,2,1,1,4,5
18612,Raymond Felton,32-251,G,3/4/17,LAC,@,CHI,W,0,13,1,1,1,1,1,1,0,0,,0,0,,0,0,0
18613,Yogi Ferrell,23-206,G,12/1/16,BRK,,MIL,L,0,3,1,1,1,1,1,1,0,0,,0,0,,0,0,0
18614,Yogi Ferrell,23-187,G,11/12/16,BRK,@,PHO,W,0,13,1,3,0.333,1,1,1,0,2,0,0,0,,0,1,1
18615,Dorian Finney-Smith,23-199,F,11/19/16,DAL,@,ORL,L,1,14,0,2,0,0,1,0,0,1,0,2,2,1,0,2,2
18616,Dorian Finney-Smith,23-278,F,2/6/17,DAL,@,DEN,L,0,14,1,3,0.333,1,2,0.5,0,1,0,0,0,,0,0,0
18617,Dorian Finney-Smith,23-315,F,3/15/17,DAL,@,WAS,W,1,20,1,4,0.25,1,2,0.5,0,2,0,0,0,,1,7,8
18618,Dorian Finney-Smith,23-236,F,12/26/16,DAL,@,NOP,L,1,17,1,1,1,1,1,1,0,0,,0,0,,2,1,3
18619,Dorian Finney-Smith,23-253,F,1/12/17,DAL,@,PHO,W,0,10,0,2,0,0,1,0,0,1,0,2,2,1,1,0,1
18620,Dorian Finney-Smith,23-307,F,3/7/17,DAL,,LAL,W,0,23,1,4,0.25,1,3,0.333,0,1,0,0,0,,0,1,1
18621,Dorian Finney-Smith,23-283,F,2/11/17,DAL,,ORL,W,0,15,1,5,0.2,1,2,0.5,0,3,0,0,0,,1,2,3
18622,Dorian Finney-Smith,23-231,F,12/21/16,DAL,@,POR,W,1,31,1,3,0.333,1,1,1,0,2,0,0,0,,1,3,4
18623,Bryn Forbes,23-175,G,1/14/17,SAS,@,PHO,L,0,5,1,1,1,1,1,1,0,0,,0,0,,0,1,1
18624,Bryn Forbes,23-229,G,3/9/17,SAS,@,OKC,L,0,16,1,4,0.25,1,2,0.5,0,2,0,0,0,,0,2,2
18625,Bryn Forbes,23-098,G,10/29/16,SAS,,NOP,W,0,15,1,3,0.333,1,2,0.5,0,1,0,0,0,,0,1,1
18626,Bryn Forbes,23-235,G,3/15/17,SAS,,POR,L,0,9,1,2,0.5,1,2,0.5,0,0,,0,0,,0,0,0
18627,Bryn Forbes,23-184,G,1/23/17,SAS,@,BRK,W,0,13,1,6,0.167,1,3,0.333,0,3,0,0,0,,1,1,2
18628,Randy Foye,33-123,G,1/25/17,BRK,,MIA,L,1,28,1,5,0.2,1,2,0.5,0,3,0,0,0,,1,1,2
18629,Randy Foye,33-060,G,11/23/16,BRK,,BOS,L,0,12,1,3,0.333,1,2,0.5,0,1,0,0,0,,0,2,2
18630,Randy Foye,33-055,G,11/18/16,BRK,@,OKC,L,1,16,1,3,0.333,1,2,0.5,0,1,0,0,0,,0,1,1
18631,Randy Foye,33-154,G,2/25/17,BRK,@,GSW,L,1,20,1,5,0.2,1,2,0.5,0,3,0,0,0,,0,3,3
18632,Randy Foye,33-169,G,3/12/17,BRK,,NYK,W,1,12,1,2,0.5,1,1,1,0,1,0,0,0,,0,2,2
18633,Randy Foye,33-144,G,2/15/17,BRK,,MIL,L,1,16,1,4,0.25,1,3,0.333,0,1,0,0,0,,1,2,3
18634,Randy Foye,33-090,G,12/23/16,BRK,@,CLE,L,0,13,0,2,0,0,1,0,0,1,0,2,2,1,0,1,1
18635,Tim Frazier,26-052,G,12/23/16,NOP,,MIA,W,0,9,1,4,0.25,1,2,0.5,0,2,0,0,0,,0,2,2
18636,Tim Frazier,26-140,G,3/21/17,NOP,,MEM,W,1,28,0,3,0,0,1,0,0,2,0,2,2,1,0,2,2
18637,Tim Frazier,26-097,G,2/6/17,NOP,,PHO,W,0,9,1,1,1,1,1,1,0,0,,0,0,,0,0,0
18638,Tim Frazier,26-122,G,3/3/17,NOP,,SAS,L,0,10,1,2,0.5,1,2,0.5,0,0,,0,0,,1,0,1
18639,Tim Frazier,26-091,G,1/31/17,NOP,@,TOR,L,0,12,1,3,0.333,1,1,1,0,2,0,0,0,,1,0,1
18640,Tim Frazier,26-117,G,2/26/17,NOP,@,OKC,L,0,15,1,4,0.25,1,3,0.333,0,1,0,0,2,0,0,1,1
18641,Tim Frazier,26-116,G,2/25/17,NOP,@,DAL,L,0,10,1,2,0.5,1,2,0.5,0,0,,0,0,,0,0,0
18642,Tim Frazier,26-114,G,2/23/17,NOP,,HOU,L,0,23,1,6,0.167,1,2,0.5,0,4,0,0,0,,2,2,4
18643,Tim Frazier,26-127,G,3/8/17,NOP,,TOR,L,0,16,1,2,0.5,1,1,1,0,1,0,0,0,,0,2,2
18644,Langston Galloway,24-361,G,12/4/16,NOP,@,OKC,L,0,13,1,7,0.143,1,4,0.25,0,3,0,0,0,,2,1,3
18645,Langston Galloway,25-059,G,2/6/17,NOP,,PHO,W,0,7,1,4,0.25,1,1,1,0,3,0,0,0,,0,1,1
18646,Langston Galloway,25-036,G,1/14/17,NOP,@,CHI,L,0,14,1,2,0.5,1,2,0.5,0,0,,0,0,,0,0,0
18647,Marc Gasol,31-337,C,12/31/16,MEM,@,SAC,W,1,21,0,6,0,0,5,0,0,1,0,2,2,1,0,2,2
18648,Pau Gasol,36-111,F-C,10/25/16,SAS,@,GSW,W,1,18,1,4,0.25,1,4,0.25,0,0,,0,0,,0,4,4
18649,Pau Gasol,36-126,F-C,11/9/16,SAS,,HOU,L,1,13,1,2,0.5,1,2,0.5,0,0,,0,0,,1,6,7
18650,Michael Gbinije,24-177,G,11/29/16,DET,@,CHO,W,0,2,1,2,0.5,1,2,0.5,0,0,,0,0,,1,0,1
18651,Michael Gbinije,24-143,G,10/26/16,DET,@,TOR,L,0,2,0,1,0,0,0,,0,1,0,2,2,1,0,0,0
18652,Alonzo Gee,29-178,G,11/23/16,DEN,@,UTA,L,0,12,1,1,1,1,1,1,0,0,,0,0,,0,1,1
18653,Alonzo Gee,29-175,G,11/20/16,DEN,,UTA,W,0,7,0,1,0,0,1,0,0,0,,2,2,1,0,2,2
18654,Jonathan Gibson,29-036,G,12/14/16,DAL,,DET,L,0,1,0,0,,0,0,,0,0,,2,2,1,0,0,0
18655,Taj Gibson,31-233,F,2/12/17,CHI,@,MIN,L,1,17,1,4,0.25,1,4,0.25,0,0,,0,0,,2,3,5
18656,Manu Ginobili,39-111,G,11/16/16,SAS,@,SAC,W,0,16,1,5,0.2,1,2,0.5,0,3,0,0,0,,0,1,1
18657,Manu Ginobili,39-189,G,2/2/17,SAS,,PHI,W,0,9,0,3,0,0,2,0,0,1,0,2,3,0.667,0,4,4
18658,Manu Ginobili,39-202,G,2/15/17,SAS,@,ORL,W,0,16,1,2,0.5,1,2,0.5,0,0,,0,0,,1,1,2
18659,Manu Ginobili,39-168,G,1/12/17,SAS,,LAL,W,0,9,0,2,0,0,1,0,0,1,0,2,2,1,0,0,0
18660,Manu Ginobili,39-200,G,2/13/17,SAS,@,IND,W,0,11,0,3,0,0,2,0,0,1,0,2,2,1,0,0,0
18661,Manu Ginobili,39-140,G,12/15/16,SAS,@,PHO,W,0,15,0,3,0,0,2,0,0,1,0,2,2,1,0,1,1
18662,Aaron Gordon,21-103,F,12/28/16,ORL,,CHO,L,1,25,1,5,0.2,1,3,0.333,0,2,0,0,0,,2,2,4
18663,Aaron Gordon,21-114,F,1/8/17,ORL,@,LAL,L,1,24,0,5,0,0,1,0,0,4,0,2,4,0.5,1,5,6
18664,Marcin Gortat,33-021,C-F,3/10/17,WAS,@,SAC,W,1,22,1,3,0.333,1,3,0.333,0,0,,0,0,,1,8,9
18665,Treveon Graham,23-132,G,3/10/17,CHO,,ORL,W,0,7,1,2,0.5,1,2,0.5,0,0,,0,0,,0,0,0
18666,Treveon Graham,23-076,G,1/13/17,CHO,@,PHI,L,0,4,0,0,,0,0,,0,0,,2,2,1,0,0,0
18667,Treveon Graham,23-013,G,11/11/16,CHO,,TOR,L,1,24,1,2,0.5,1,2,0.5,0,0,,0,0,,0,3,3
18668,Jerami Grant,22-246,F,11/13/16,OKC,,ORL,L,0,14,1,3,0.333,1,3,0.333,0,0,,0,2,0,0,2,2
18669,Jerami Grant,22-307,F,1/13/17,OKC,@,MIN,L,0,20,0,0,,0,0,,0,0,,2,2,1,0,3,3
18670,Jerami Grant,22-274,F,12/11/16,OKC,,BOS,W,0,6,1,1,1,1,1,1,0,0,,0,0,,0,1,1
18671,Jerami Grant,22-272,F,12/9/16,OKC,,HOU,L,0,23,1,2,0.5,1,2,0.5,0,0,,0,2,0,2,0,2
18672,Jerami Grant,22-320,F,1/26/17,OKC,,DAL,W,0,22,1,1,1,1,1,1,0,0,,0,0,,1,6,7
18673,Jerami Grant,22-334,F,2/9/17,OKC,,CLE,W,0,17,1,2,0.5,1,2,0.5,0,0,,0,0,,2,0,2
18674,Jerami Grant,22-299,F,1/5/17,OKC,@,HOU,L,0,22,1,5,0.2,1,4,0.25,0,1,0,0,0,,0,4,4
18675,Jerami Grant,22-317,F,1/23/17,OKC,@,UTA,W,0,19,1,3,0.333,1,2,0.5,0,1,0,0,0,,0,2,2
18676,Jerami Grant,22-298,F,1/4/17,OKC,@,CHO,L,0,27,1,2,0.5,1,2,0.5,0,0,,0,0,,1,3,4
18677,Jerami Grant,22-330,F,2/5/17,OKC,,POR,W,0,8,1,2,0.5,1,2,0.5,0,0,,0,0,,0,0,0
18678,Jerian Grant,24-128,G,2/14/17,CHI,,TOR,W,1,15,1,5,0.2,1,3,0.333,0,2,0,0,0,,0,0,0
18679,Jerian Grant,24-029,G,11/7/16,CHI,,ORL,W,0,8,1,6,0.167,1,4,0.25,0,2,0,0,0,,1,2,3
18680,Jerian Grant,24-054,G,12/2/16,CHI,,CLE,W,0,6,1,1,1,1,1,1,0,0,,0,0,,0,1,1
18681,Jerian Grant,24-146,G,3/4/17,CHI,,LAC,L,1,10,1,3,0.333,1,3,0.333,0,0,,0,0,,0,0,0
18682,Jerian Grant,24-052,G,11/30/16,CHI,,LAL,L,0,7,1,3,0.333,1,2,0.5,0,1,0,0,0,,0,0,0
18683,Jerian Grant,24-068,G,12/16/16,CHI,,MIL,L,0,5,1,2,0.5,1,2,0.5,0,0,,0,0,,0,1,1
18684,Jerian Grant,24-082,G,12/30/16,CHI,@,IND,L,0,8,0,1,0,0,0,,0,1,0,2,2,1,1,0,1
18685,Danny Green,29-160,G-F,11/29/16,SAS,,ORL,L,1,24,1,4,0.25,1,1,1,0,3,0,0,0,,0,5,5
18686,Draymond Green,26-314,F,1/12/17,GSW,,DET,W,1,30,0,4,0,0,2,0,0,2,0,2,2,1,1,8,9
18687,Draymond Green,26-348,F,2/15/17,GSW,,SAC,W,1,15,0,3,0,0,1,0,0,2,0,2,2,1,0,2,2
18688,Draymond Green,26-276,F,12/5/16,GSW,,IND,W,1,27,1,6,0.167,1,4,0.25,0,2,0,0,0,,1,4,5
18689,Draymond Green,27-016,F,3/20/17,GSW,@,OKC,W,1,26,0,4,0,0,3,0,0,1,0,2,4,0.5,1,9,10
18690,Gerald Green,31-006,G-F,2/1/17,BOS,,TOR,W,0,6,1,3,0.333,1,2,0.5,0,1,0,0,0,,0,1,1
18691,Gerald Green,31-038,G-F,3/5/17,BOS,@,PHO,L,0,15,1,5,0.2,1,2,0.5,0,3,0,0,0,,1,3,4
18692,Gerald Green,31-001,G-F,1/27/17,BOS,,ORL,W,0,15,1,5,0.2,1,4,0.25,0,1,0,0,0,,1,2,3
18693,Gerald Green,30-275,G-F,10/27/16,BOS,@,CHI,L,0,10,1,4,0.25,1,2,0.5,0,2,0,0,0,,0,2,2
18694,Gerald Green,30-295,G-F,11/16/16,BOS,,DAL,W,0,7,1,4,0.25,1,2,0.5,0,2,0,0,0,,1,1,2
18695,Gerald Green,30-339,G-F,12/30/16,BOS,,MIA,W,0,6,1,2,0.5,1,2,0.5,0,0,,0,0,,0,1,1
18696,Gerald Green,31-010,G-F,2/5/17,BOS,,LAC,W,0,8,1,3,0.333,1,1,1,0,2,0,0,0,,0,1,1
18697,JaMychal Green,26-175,F,12/13/16,MEM,@,CLE,L,1,29,1,10,0.1,1,9,0.111,0,1,0,0,0,,5,3,8
18698,JaMychal Green,26-160,F,11/28/16,MEM,,CHO,L,1,28,1,4,0.25,1,3,0.333,0,1,0,0,0,,1,4,5
18699,JaMychal Green,26-265,F,3/13/17,MEM,,MIL,W,1,24,0,2,0,0,1,0,0,1,0,2,2,1,3,3,6
18700,JaMychal Green,26-136,F,11/4/16,MEM,,LAC,L,1,17,1,3,0.333,1,2,0.5,0,1,0,0,0,,0,0,0
18701,Jeff Green,30-152,F,1/27/17,ORL,@,BOS,L,0,16,0,5,0,0,3,0,0,2,0,2,2,1,2,2,4
18702,Jeff Green,30-201,F,3/17/17,ORL,@,PHO,W,0,14,1,9,0.111,1,7,0.143,0,2,0,0,0,,2,6,8
18703,Jeff Green,30-065,F,11/1/16,ORL,@,PHI,W,0,12,1,5,0.2,1,3,0.333,0,2,0,0,0,,0,2,2
18704,Justin Hamilton,26-265,C,12/22/16,BRK,,GSW,L,0,18,1,3,0.333,1,1,1,0,2,0,0,0,,0,4,4
18705,Justin Hamilton,26-236,C,11/23/16,BRK,,BOS,L,0,19,0,2,0,0,1,0,0,1,0,2,3,0.667,0,0,0
18706,Justin Hamilton,26-297,C,1/23/17,BRK,,SAS,L,0,16,1,3,0.333,1,1,1,0,2,0,0,0,,1,3,4
18707,Justin Hamilton,26-250,C,12/7/16,BRK,,DEN,W,0,12,1,4,0.25,1,1,1,0,3,0,0,0,,1,1,2
18708,Justin Hamilton,26-248,C,12/5/16,BRK,,WAS,L,0,13,1,4,0.25,1,1,1,0,3,0,0,0,,0,2,2
18709,Justin Hamilton,26-273,C,12/30/16,BRK,@,WAS,L,0,17,1,3,0.333,1,3,0.333,0,0,,0,0,,1,3,4
18710,Justin Hamilton,26-330,C,2/25/17,BRK,@,GSW,L,0,17,1,6,0.167,1,5,0.2,0,1,0,0,0,,2,2,4
18711,A.J. Hammons,24-125,C,12/30/16,DAL,@,GSW,L,0,6,1,1,1,1,1,1,0,0,,0,0,,0,0,0
18712,A.J. Hammons,24-098,C,12/3/16,DAL,,CHI,W,0,2,1,2,0.5,1,2,0.5,0,0,,0,0,,0,1,1
18713,Tim Hardaway,24-254,G,11/25/16,ATL,@,UTA,L,0,18,1,5,0.2,1,3,0.333,0,2,0,0,0,,0,1,1
18714,Tim Hardaway,24-280,G,12/21/16,ATL,,MIN,L,0,1,1,1,1,1,1,1,0,0,,0,0,,0,0,0
18715,Maurice Harkless,23-305,F-G,3/12/17,POR,@,PHO,W,1,22,1,2,0.5,1,2,0.5,0,0,,0,4,0,0,1,1
18716,Maurice Harkless,23-312,F-G,3/19/17,POR,@,MIA,W,1,29,1,4,0.25,1,3,0.333,0,1,0,0,0,,3,2,5
18717,Maurice Harkless,23-268,F-G,2/3/17,POR,,DAL,L,0,20,1,5,0.2,1,3,0.333,0,2,0,0,0,,1,1,2
18718,Montrezl Harrell,22-276,F-C,10/28/16,HOU,@,DAL,W,0,4,1,1,1,1,1,1,0,0,,0,0,,0,1,1
18719,Montrezl Harrell,22-308,F-C,11/29/16,HOU,@,UTA,L,0,7,1,3,0.333,1,3,0.333,0,0,,0,0,,1,0,1
18720,Montrezl Harrell,22-304,F-C,11/25/16,HOU,@,SAC,W,0,3,1,1,1,1,1,1,0,0,,0,2,0,0,0,0
18721,Montrezl Harrell,22-293,F-C,11/14/16,HOU,,PHI,W,0,6,1,3,0.333,1,3,0.333,0,0,,0,1,0,0,1,1
18722,Montrezl Harrell,23-043,F-C,3/10/17,HOU,@,CHI,W,0,6,1,1,1,1,1,1,0,0,,0,0,,0,3,3
18723,Devin Harris,33-320,G,1/12/17,DAL,@,PHO,W,0,16,0,3,0,0,2,0,0,1,0,2,4,0.5,0,1,1
18724,Devin Harris,33-298,G,12/21/16,DAL,@,POR,W,0,19,1,5,0.2,1,2,0.5,0,3,0,0,0,,0,3,3
18725,Devin Harris,33-293,G,12/16/16,DAL,@,UTA,L,0,18,0,1,0,0,1,0,0,0,,2,2,1,1,0,1
18726,Devin Harris,33-338,G,1/30/17,DAL,,CLE,W,0,19,1,5,0.2,1,2,0.5,0,3,0,0,0,,0,1,1
18727,Joe Harris,25-177,G,3/3/17,BRK,@,UTA,L,0,10,1,4,0.25,1,2,0.5,0,2,0,0,0,,1,0,1
18728,Joe Harris,25-125,G,1/10/17,BRK,,ATL,L,1,14,1,2,0.5,1,1,1,0,1,0,0,0,,0,1,1
18729,Joe Harris,25-121,G,1/6/17,BRK,,CLE,L,1,18,1,9,0.111,1,4,0.25,0,5,0,0,0,,3,3,6
18730,Manny Harris,27-181,G,3/21/17,DAL,,GSW,L,0,4,1,3,0.333,1,3,0.333,0,0,,0,0,,1,0,1
18731,Andrew Harrison,22-039,G,12/6/16,MEM,,PHI,W,1,28,1,9,0.111,1,7,0.143,0,2,0,0,0,,0,4,4
18732,Andrew Harrison,22-070,G,1/6/17,MEM,@,GSW,W,0,5,1,1,1,1,1,1,0,0,,0,0,,1,0,1
18733,Andrew Harrison,22-053,G,12/20/16,MEM,,BOS,L,0,18,0,4,0,0,1,0,0,3,0,2,2,1,0,1,1
18734,Andrew Harrison,22-051,G,12/18/16,MEM,,UTA,L,0,24,1,7,0.143,1,6,0.167,0,1,0,0,0,,2,0,2
18735,Andrew Harrison,22-089,G,1/25/17,MEM,,TOR,W,0,19,0,1,0,0,1,0,0,0,,2,2,1,1,2,3
18736,Andrew Harrison,22-103,G,2/8/17,MEM,,PHO,W,0,2,0,0,,0,0,,0,0,,2,2,1,0,0,0
18737,Andrew Harrison,22-134,G,3/11/17,MEM,,ATL,L,0,14,0,3,0,0,1,0,0,2,0,2,5,0.4,0,3,3
18738,Andrew Harrison,22-047,G,12/14/16,MEM,,CLE,W,1,20,1,6,0.167,1,5,0.2,0,1,0,0,0,,0,1,1
18739,Andrew Harrison,22-098,G,2/3/17,MEM,@,OKC,L,0,14,1,2,0.5,1,2,0.5,0,0,,0,0,,0,0,0
18740,Andrew Harrison,22-015,G,11/12/16,MEM,@,MIL,L,0,17,1,3,0.333,1,1,1,0,2,0,0,0,,0,0,0
18741,Spencer Hawes,28-225,C-F,12/9/16,CHO,,ORL,W,0,8,1,4,0.25,1,2,0.5,0,2,0,0,0,,0,1,1
18742,Spencer Hawes,28-197,C-F,11/11/16,CHO,,TOR,L,0,6,1,7,0.143,1,5,0.2,0,2,0,0,0,,4,1,5
18743,Spencer Hawes,28-247,C-F,12/31/16,CHO,,CLE,L,0,3,0,0,,0,0,,0,0,,2,2,1,0,0,0
18744,Spencer Hawes,28-314,C-F,3/8/17,MIL,,NYK,W,0,8,1,2,0.5,1,1,1,0,1,0,0,0,,1,1,2
18745,Spencer Hawes,28-312,C-F,3/6/17,MIL,@,PHI,W,0,6,1,4,0.25,1,2,0.5,0,2,0,0,0,,0,0,0
18746,Gerald Henderson,29-007,G,12/16/16,PHI,,LAL,L,1,22,0,4,0,0,2,0,0,2,0,2,2,1,2,3,5
18747,Gerald Henderson,29-082,G,3/1/17,PHI,@,MIA,L,1,11,1,3,0.333,1,2,0.5,0,1,0,0,0,,0,0,0
18748,Gerald Henderson,28-365,G,12/8/16,PHI,@,NOP,W,1,24,1,6,0.167,1,5,0.2,0,1,0,0,0,,0,4,4
18749,John Henson,26-016,C-F,1/13/17,MIL,,MIA,W,1,19,1,5,0.2,1,5,0.2,0,0,,0,0,,3,2,5
18750,John Henson,26-075,C-F,3/13/17,MIL,@,MEM,L,0,16,1,5,0.2,1,5,0.2,0,0,,0,0,,3,2,5
18751,John Henson,25-329,C-F,11/21/16,MIL,,ORL,W,1,22,1,5,0.2,1,5,0.2,0,0,,0,0,,0,2,2
18752,John Henson,26-011,C-F,1/8/17,MIL,,WAS,L,1,15,1,3,0.333,1,3,0.333,0,0,,0,0,,0,1,1
18753,John Henson,26-007,C-F,1/4/17,MIL,@,NYK,W,1,14,1,1,1,1,1,1,0,0,,0,0,,0,2,2
18754,John Henson,26-044,C-F,2/10/17,MIL,,LAL,L,1,16,1,1,1,1,1,1,0,0,,0,0,,0,3,3
18755,Juan Hernangomez,21-110,F,1/16/17,DEN,,ORL,W,0,3,1,1,1,1,1,1,0,0,,0,0,,0,2,2
18756,Juan Hernangomez,21-153,F,2/28/17,DEN,@,CHI,W,0,7,0,0,,0,0,,0,0,,2,2,1,0,1,1
18757,Juan Hernangomez,21-053,F,11/20/16,DEN,,UTA,W,0,5,1,2,0.5,1,1,1,0,1,0,0,2,0,0,0,0
18758,Juan Hernangomez,21-036,F,11/3/16,DEN,@,MIN,W,0,11,1,1,1,1,1,1,0,0,,0,0,,0,2,2
18759,Juan Hernangomez,21-115,F,1/21/17,DEN,,LAC,W,0,5,0,0,,0,0,,0,0,,2,2,1,0,0,0
18760,Willy Hernangomez,22-173,C,11/16/16,NYK,,DET,W,0,4,1,2,0.5,1,2,0.5,0,0,,0,0,,1,1,2
18761,Willy Hernangomez,22-217,C,12/30/16,NYK,@,NOP,L,0,7,1,1,1,1,1,1,0,0,,0,0,,1,1,2
18762,Mario Hezonja,22-004,F-G,3/1/17,ORL,,NYK,L,0,21,1,2,0.5,1,2,0.5,0,0,,0,0,,0,4,4
18763,Mario Hezonja,21-250,F-G,11/1/16,ORL,@,PHI,W,0,12,1,4,0.25,1,3,0.333,0,1,0,0,0,,0,1,1
18764,Mario Hezonja,21-274,F-G,11/25/16,ORL,,WAS,L,0,9,1,2,0.5,1,2,0.5,0,0,,0,0,,0,1,1
18765,Mario Hezonja,21-318,F-G,1/8/17,ORL,@,LAL,L,0,1,0,1,0,0,1,0,0,0,,2,2,1,2,0,2
18766,Mario Hezonja,21-289,F-G,12/10/16,ORL,,DEN,L,0,7,1,1,1,1,1,1,0,0,,0,0,,0,0,0
18767,Mario Hezonja,22-011,F-G,3/8/17,ORL,,CHI,W,0,19,1,7,0.143,1,2,0.5,0,5,0,0,0,,0,5,5
18768,Mario Hezonja,21-286,F-G,12/7/16,ORL,,BOS,L,0,5,1,2,0.5,1,2,0.5,0,0,,0,0,,0,0,0
18769,Roy Hibbert,30-092,C,3/13/17,DEN,,LAL,W,0,3,1,1,1,1,1,1,0,0,,0,0,,0,0,0
18770,Roy Hibbert,30-041,C,1/21/17,CHO,,BRK,W,0,14,1,2,0.5,1,2,0.5,0,0,,0,0,,0,0,0
18771,Roy Hibbert,30-040,C,1/20/17,CHO,,TOR,W,0,19,1,2,0.5,1,2,0.5,0,0,,0,0,,2,2,4
18772,Roy Hibbert,30-089,C,3/10/17,DEN,,BOS,W,0,2,1,2,0.5,1,2,0.5,0,0,,0,0,,1,0,1
18773,Roy Hibbert,30-051,C,1/31/17,CHO,@,POR,L,1,13,1,3,0.333,1,3,0.333,0,0,,0,0,,1,6,7
18774,Roy Hibbert,29-362,C,12/7/16,CHO,,DET,W,0,16,1,5,0.2,1,5,0.2,0,0,,0,0,,1,6,7
18775,Roy Hibbert,29-346,C,11/21/16,CHO,,MEM,L,1,11,1,1,1,1,1,1,0,0,,0,0,,1,0,1
18776,Roy Hibbert,30-047,C,1/27/17,CHO,@,NYK,L,1,18,1,3,0.333,1,3,0.333,0,0,,0,0,,0,4,4
18777,Buddy Hield,23-004,G,12/21/16,NOP,,OKC,L,1,19,0,3,0,0,0,,0,3,0,2,2,1,0,1,1
18778,Buddy Hield,22-338,G,11/19/16,NOP,,CHO,W,0,6,1,4,0.25,1,2,0.5,0,2,0,0,0,,0,0,0
18779,Buddy Hield,22-316,G,10/28/16,NOP,,GSW,L,0,19,1,6,0.167,1,4,0.25,0,2,0,0,0,,0,1,1
18780,Buddy Hield,23-028,G,1/14/17,NOP,@,CHI,L,1,12,1,5,0.2,1,4,0.25,0,1,0,0,0,,0,2,2
18781,Nene Hilario,34-151,F-C,2/11/17,HOU,,PHO,W,0,12,1,3,0.333,1,3,0.333,0,0,,0,0,,1,6,7
18782,Nene Hilario,34-095,F-C,12/17/16,HOU,@,MIN,W,0,13,1,4,0.25,1,4,0.25,0,0,,0,1,0,0,2,2
18783,Nene Hilario,34-094,F-C,12/16/16,HOU,,NOP,W,0,10,1,3,0.333,1,3,0.333,0,0,,0,0,,2,1,3
18784,Nene Hilario,34-109,F-C,12/31/16,HOU,,NYK,W,0,12,1,2,0.5,1,2,0.5,0,0,,0,2,0,1,1,2
18785,Nene Hilario,34-053,F-C,11/5/16,HOU,@,ATL,L,0,12,1,5,0.2,1,5,0.2,0,0,,0,0,,4,1,5
18786,Nene Hilario,34-071,F-C,11/23/16,HOU,,TOR,L,0,6,1,2,0.5,1,2,0.5,0,0,,0,0,,0,1,1
18787,George Hill,30-301,G,3/1/17,UTA,,MIN,L,1,20,1,3,0.333,1,2,0.5,0,1,0,0,0,,0,2,2
18788,Jordan Hill,29-101,C-F,11/5/16,MIN,@,OKC,L,0,6,0,0,,0,0,,0,0,,2,2,1,1,2,3
18789,Solomon Hill,25-297,F,1/9/17,NOP,@,NYK,W,1,23,1,5,0.2,1,2,0.5,0,3,0,0,0,,0,2,2
18790,Solomon Hill,25-243,F,11/16/16,NOP,@,ORL,L,0,20,0,2,0,0,2,0,0,0,,2,2,1,0,1,1
18791,Solomon Hill,25-277,F,12/20/16,NOP,@,PHI,W,1,33,1,2,0.5,1,1,1,0,1,0,0,0,,0,3,3
18792,Solomon Hill,25-222,F,10/26/16,NOP,,DEN,L,1,27,1,7,0.143,1,3,0.333,0,4,0,0,0,,0,1,1
18793,Solomon Hill,25-344,F,2/25/17,NOP,@,DAL,L,1,36,1,4,0.25,1,1,1,0,3,0,0,0,,0,4,4
18794,Solomon Hill,25-250,F,11/23/16,NOP,,MIN,W,0,18,1,4,0.25,1,1,1,0,3,0,0,0,,0,5,5
18795,Solomon Hill,25-234,F,11/7/16,NOP,@,GSW,L,1,32,0,4,0,0,3,0,0,1,0,2,2,1,0,5,5
18796,Darrun Hilliard,23-248,G,12/17/16,DET,,IND,L,0,12,1,3,0.333,1,3,0.333,0,0,,0,0,,0,3,3
18797,Darrun Hilliard,23-280,G,1/18/17,DET,,ATL,W,0,9,0,2,0,0,1,0,0,1,0,2,2,1,0,4,4
18798,Darrun Hilliard,23-227,G,11/26/16,DET,@,OKC,L,0,12,1,3,0.333,1,2,0.5,0,1,0,0,0,,0,1,1
18799,Darrun Hilliard,23-224,G,11/23/16,DET,,MIA,W,0,5,0,0,,0,0,,0,0,,2,2,1,0,0,0
18800,Darrun Hilliard,23-335,G,3/14/17,DET,@,CLE,L,0,7,1,2,0.5,1,1,1,0,1,0,0,0,,0,1,1
18801,Darrun Hilliard,23-259,G,12/28/16,DET,,MIL,L,0,4,1,1,1,1,1,1,0,0,,0,0,,0,0,0
18802,Darrun Hilliard,23-332,G,3/11/17,DET,,NYK,W,0,2,1,1,1,1,1,1,0,0,,0,0,,0,1,1
18803,Darrun Hilliard,23-215,G,11/14/16,DET,,OKC,W,0,1,1,1,1,1,1,1,0,0,,0,0,,0,0,0
18804,Darrun Hilliard,23-235,G,12/4/16,DET,,ORL,L,0,12,1,6,0.167,1,6,0.167,0,0,,0,0,,0,0,0
18805,Justin Holiday,27-221,G,11/12/16,NYK,@,TOR,L,0,14,1,4,0.25,1,3,0.333,0,1,0,0,0,,0,0,0
18806,Justin Holiday,27-337,G,3/8/17,NYK,@,MIL,L,0,12,1,1,1,1,1,1,0,0,,0,0,,0,0,0
18807,Justin Holiday,27-215,G,11/6/16,NYK,,UTA,L,0,13,1,2,0.5,1,2,0.5,0,0,,0,0,,0,1,1
18808,Justin Holiday,27-277,G,1/7/17,NYK,@,IND,L,0,8,1,3,0.333,1,2,0.5,0,1,0,0,0,,0,0,0
18809,Justin Holiday,27-341,G,3/12/17,NYK,@,BRK,L,0,10,1,5,0.2,1,4,0.25,0,1,0,0,0,,0,1,1
18810,Justin Holiday,27-239,G,11/30/16,NYK,@,MIN,W,0,20,1,8,0.125,1,5,0.2,0,3,0,0,0,,0,4,4
18811,Rondae Hollis-Jefferson,21-300,F,10/29/16,BRK,@,MIL,L,1,23,1,4,0.25,1,3,0.333,0,1,0,0,0,,1,4,5
18812,Rondae Hollis-Jefferson,21-317,F,11/15/16,BRK,@,LAL,L,1,18,1,5,0.2,1,3,0.333,0,2,0,0,0,,0,2,2
18813,Rondae Hollis-Jefferson,21-299,F,10/28/16,BRK,,IND,W,1,25,1,5,0.2,1,3,0.333,0,2,0,0,0,,2,3,5
18814,Rondae Hollis-Jefferson,21-302,F,10/31/16,BRK,,CHI,L,1,30,1,7,0.143,1,7,0.143,0,0,,0,0,,1,2,3
18815,Richaun Holmes,23-048,F-C,12/2/16,PHI,,ORL,L,0,8,1,3,0.333,1,2,0.5,0,1,0,0,0,,0,1,1
18816,Richaun Holmes,23-114,F-C,2/6/17,PHI,@,DET,L,0,6,1,2,0.5,1,2,0.5,0,0,,0,0,,2,1,3
18817,Richaun Holmes,23-109,F-C,2/1/17,PHI,@,DAL,L,0,6,1,1,1,1,1,1,0,0,,0,0,,0,0,0
18818,Rodney Hood,24-068,G-F,12/27/16,UTA,@,LAL,W,1,25,1,7,0.143,1,5,0.2,0,2,0,0,0,,0,2,2
18819,Rodney Hood,24-064,G-F,12/23/16,UTA,,TOR,L,1,13,1,6,0.167,1,2,0.5,0,4,0,0,0,,0,0,0
18820,Dwight Howard,30-360,C,12/2/16,ATL,,DET,L,1,25,1,4,0.25,1,4,0.25,0,0,,0,0,,1,5,6
18821,Dwight Howard,30-326,C,10/29/16,ATL,@,PHI,W,1,19,1,4,0.25,1,4,0.25,0,0,,0,0,,3,4,7
18822,Marcelo Huertas,33-230,G,1/10/17,LAL,,POR,L,0,3,1,1,1,1,1,1,0,0,,0,0,,0,1,1
18823,Marcelo Huertas,33-226,G,1/6/17,LAL,,MIA,W,0,2,1,1,1,1,1,1,0,0,,0,0,,0,0,0
18824,Marcelo Huertas,33-266,G,2/15/17,LAL,@,PHO,L,0,9,1,4,0.25,1,3,0.333,0,1,0,0,0,,0,0,0
18825,Marcelo Huertas,33-212,G,12/23/16,LAL,@,ORL,L,0,17,1,4,0.25,1,3,0.333,0,1,0,0,0,,0,2,2
18826,Marcelo Huertas,33-194,G,12/5/16,LAL,,UTA,L,0,18,1,3,0.333,1,2,0.5,0,1,0,0,0,,0,1,1
18827,Marcelo Huertas,33-192,G,12/3/16,LAL,@,MEM,L,0,14,1,3,0.333,1,3,0.333,0,0,,0,0,,0,2,2
18828,Marcelo Huertas,33-232,G,1/12/17,LAL,@,SAS,L,0,15,0,6,0,0,5,0,0,1,0,2,2,1,0,1,1
18829,Kris Humphries,32-042,F-C,3/20/17,ATL,@,CHO,L,0,9,1,2,0.5,1,1,1,0,1,0,0,0,,0,6,6
18830,Kris Humphries,31-277,F-C,11/9/16,ATL,,CHI,W,0,12,0,1,0,0,1,0,0,0,,2,2,1,1,1,2
18831,Kris Humphries,31-344,F-C,1/15/17,ATL,,MIL,W,0,11,1,3,0.333,1,3,0.333,0,0,,0,0,,1,2,3
18832,Kris Humphries,31-293,F-C,11/25/16,ATL,@,UTA,L,0,7,1,2,0.5,1,1,1,0,1,0,0,0,,0,1,1
18833,Kris Humphries,31-342,F-C,1/13/17,ATL,,BOS,L,0,4,1,1,1,1,1,1,0,0,,0,0,,0,1,1
18834,Kris Humphries,31-354,F-C,1/25/17,ATL,@,CHI,W,0,14,1,4,0.25,1,2,0.5,0,2,0,0,0,,0,5,5
18835,Kris Humphries,31-334,F-C,1/5/17,ATL,@,NOP,W,0,10,1,4,0.25,1,3,0.333,0,1,0,0,0,,0,2,2
18836,Kris Humphries,31-303,F-C,12/5/16,ATL,,OKC,L,0,4,1,2,0.5,1,2,0.5,0,0,,0,0,,1,0,1
18837,Andre Iguodala,32-286,G-F,11/9/16,GSW,,DAL,W,0,13,1,2,0.5,1,1,1,0,1,0,0,0,,1,1,2
18838,Andre Iguodala,32-284,G-F,11/7/16,GSW,,NOP,W,0,31,0,4,0,0,0,,0,4,0,2,2,1,0,4,4
18839,Andre Iguodala,32-330,G-F,12/23/16,GSW,@,DET,W,0,26,1,2,0.5,1,2,0.5,0,0,,0,0,,1,2,3
18840,Andre Iguodala,32-344,G-F,1/6/17,GSW,,MEM,L,0,27,1,3,0.333,1,2,0.5,0,1,0,0,0,,2,1,3
18841,Andre Iguodala,32-363,G-F,1/25/17,GSW,@,CHO,W,0,30,1,2,0.5,1,2,0.5,0,0,,0,0,,2,8,10
18842,Andre Iguodala,33-011,G-F,2/8/17,GSW,,CHI,W,0,22,0,1,0,0,0,,0,1,0,2,2,1,1,2,3
18843,Andre Iguodala,32-337,G-F,12/30/16,GSW,,DAL,W,0,23,0,3,0,0,0,,0,3,0,2,2,1,0,4,4
18844,Andre Iguodala,33-007,G-F,2/4/17,GSW,@,SAC,L,0,35,1,5,0.2,1,2,0.5,0,3,0,0,0,,1,5,6
18845,Andre Iguodala,32-271,G-F,10/25/16,GSW,,SAS,L,0,27,1,3,0.333,1,1,1,0,2,0,0,0,,1,1,2
18846,Andre Iguodala,33-030,G-F,2/27/17,GSW,@,PHI,W,0,28,1,2,0.5,1,1,1,0,1,0,0,0,,3,7,10
18847,Andre Iguodala,32-287,G-F,11/10/16,GSW,@,DEN,W,0,23,1,4,0.25,1,3,0.333,0,1,0,0,0,,0,3,3
18848,Joe Ingles,29-111,F-G,1/21/17,UTA,,IND,W,1,33,1,6,0.167,1,3,0.333,0,3,0,0,0,,0,4,4
18849,Joe Ingles,29-147,F-G,2/26/17,UTA,@,WAS,W,0,19,1,2,0.5,1,1,1,0,1,0,0,0,,0,6,6
18850,Joe Ingles,29-041,F-G,11/12/16,UTA,@,MIA,W,0,16,1,2,0.5,1,2,0.5,0,0,,0,0,,0,1,1
18851,Joe Ingles,29-023,F-G,10/25/16,UTA,@,POR,L,0,14,1,1,1,1,1,1,0,0,,0,0,,0,0,0
18852,Joe Ingles,29-038,F-G,11/9/16,UTA,@,CHO,L,0,12,0,2,0,0,0,,0,2,0,2,2,1,0,0,0
18853,Brandon Ingram,19-161,F,2/10/17,LAL,@,MIL,W,1,20,1,3,0.333,1,2,0.5,0,1,0,0,0,,0,2,2
18854,Brandon Ingram,19-105,F,12/16/16,LAL,@,PHI,W,0,21,1,8,0.125,1,6,0.167,0,2,0,0,0,,1,2,3
18855,Brandon Ingram,19-060,F,11/1/16,LAL,@,IND,L,0,15,1,4,0.25,1,2,0.5,0,2,0,0,0,,0,3,3
18856,Brandon Ingram,19-056,F,10/28/16,LAL,@,UTA,L,0,4,1,2,0.5,1,1,1,0,1,0,0,0,,0,0,0
18857,Demetrius Jackson,22-063,G,11/9/16,BOS,@,WAS,L,0,4,1,1,1,1,1,1,0,0,,0,2,0,0,0,0
18858,Pierre Jackson,25-127,G,1/3/17,DAL,,WAS,W,0,3,0,1,0,0,1,0,0,0,,2,2,1,0,0,0
18859,Al Jefferson,31-317,C-F,11/16/16,IND,,CLE,W,0,7,1,4,0.25,1,4,0.25,0,0,,0,0,,0,1,1
18860,Al Jefferson,31-298,C-F,10/28/16,IND,@,BRK,L,0,12,1,5,0.2,1,5,0.2,0,0,,0,0,,0,2,2
18861,Al Jefferson,31-324,C-F,11/23/16,IND,,ATL,L,0,13,1,3,0.333,1,3,0.333,0,0,,0,0,,0,1,1
18862,Al Jefferson,32-040,C-F,2/13/17,IND,,SAS,L,0,14,1,6,0.167,1,6,0.167,0,0,,0,0,,0,3,3
18863,Al Jefferson,31-321,C-F,11/20/16,IND,@,OKC,W,0,14,1,5,0.2,1,5,0.2,0,0,,0,0,,3,2,5
18864,Richard Jefferson,36-171,F,12/9/16,CLE,,MIA,W,0,15,1,4,0.25,1,2,0.5,0,2,0,0,0,,0,3,3
18865,Richard Jefferson,36-135,F,11/3/16,CLE,,BOS,W,0,14,1,2,0.5,1,1,1,0,1,0,0,0,,0,3,3
18866,Richard Jefferson,36-258,F,3/6/17,CLE,,MIA,L,1,29,1,3,0.333,1,2,0.5,0,1,0,0,0,,1,0,1
18867,Richard Jefferson,36-199,F,1/6/17,CLE,@,BRK,W,0,15,0,3,0,0,1,0,0,2,0,2,2,1,0,1,1
18868,Richard Jefferson,36-129,F,10/28/16,CLE,@,TOR,W,0,20,0,4,0,0,1,0,0,3,0,2,4,0.5,1,1,2
18869,Richard Jefferson,36-145,F,11/13/16,CLE,,CHO,W,0,26,1,5,0.2,1,2,0.5,0,3,0,0,1,0,2,6,8
18870,Richard Jefferson,36-159,F,11/27/16,CLE,@,PHI,W,0,28,1,6,0.167,1,1,1,0,5,0,0,0,,2,2,4
18871,Richard Jefferson,36-175,F,12/13/16,CLE,,MEM,W,0,17,1,3,0.333,1,2,0.5,0,1,0,0,0,,1,1,2
18872,Richard Jefferson,36-188,F,12/26/16,CLE,@,DET,L,1,22,1,4,0.25,1,2,0.5,0,2,0,0,0,,1,1,2
18873,Richard Jefferson,36-239,F,2/15/17,CLE,,IND,W,0,18,0,2,0,0,0,,0,2,0,2,2,1,2,0,2
18874,John Jenkins,25-272,G,12/3/16,PHO,@,GSW,L,0,4,1,2,0.5,1,2,0.5,0,0,,0,0,,0,0,0
18875,John Jenkins,25-258,G,11/19/16,PHO,@,PHI,L,0,4,0,1,0,0,1,0,0,0,,2,2,1,0,1,1
18876,Brandon Jennings,27-165,G,3/7/17,WAS,@,PHO,W,0,5,1,3,0.333,1,3,0.333,0,0,,0,0,,0,0,0
18877,Brandon Jennings,27-120,G,1/21/17,NYK,,PHO,L,0,12,0,3,0,0,0,,0,3,0,2,2,1,0,1,1
18878,Brandon Jennings,27-163,G,3/5/17,WAS,,ORL,W,0,17,1,3,0.333,1,1,1,0,2,0,0,0,,1,1,2
18879,Brandon Jennings,27-176,G,3/18/17,WAS,@,CHO,L,0,16,1,6,0.167,1,2,0.5,0,4,0,0,0,,1,2,3
18880,Brandon Jennings,27-070,G,12/2/16,NYK,,MIN,W,0,19,1,4,0.25,1,2,0.5,0,2,0,0,0,,0,3,3
18881,Brandon Jennings,27-155,G,2/25/17,NYK,,PHI,W,0,12,0,3,0,0,3,0,0,0,,2,3,0.667,0,2,2
18882,Brandon Jennings,27-115,G,1/16/17,NYK,,ATL,L,0,20,1,4,0.25,1,1,1,0,3,0,0,0,,0,3,3
18883,Brandon Jennings,27-171,G,3/13/17,WAS,@,MIN,L,0,15,1,3,0.333,1,2,0.5,0,1,0,0,0,,0,0,0
18884,Brandon Jennings,27-142,G,2/12/17,NYK,,SAS,W,0,18,1,1,1,1,1,1,0,0,,0,0,,0,3,3
18885,Brandon Jennings,27-096,G,12/28/16,NYK,@,ATL,L,0,28,1,5,0.2,1,1,1,0,4,0,0,0,,0,4,4
18886,Jonas Jerebko,29-351,F,2/16/17,BOS,@,CHI,L,0,11,1,2,0.5,1,1,1,0,1,0,0,0,,0,3,3
18887,Jonas Jerebko,29-298,F,12/25/16,BOS,@,NYK,W,0,13,1,5,0.2,1,2,0.5,0,3,0,0,0,,1,1,2
18888,Jonas Jerebko,29-296,F,12/23/16,BOS,,OKC,L,0,15,1,2,0.5,1,2,0.5,0,0,,0,0,,0,6,6
18889,Jonas Jerebko,29-261,F,11/18/16,BOS,,GSW,L,0,15,1,1,1,1,1,1,0,0,,0,0,,0,2,2
18890,Jonas Jerebko,29-343,F,2/8/17,BOS,@,SAC,L,0,10,1,3,0.333,1,2,0.5,0,1,0,0,0,,1,1,2
18891,Jonas Jerebko,30-010,F,3/12/17,BOS,,CHI,W,0,6,1,2,0.5,1,1,1,0,1,0,0,0,,2,2,4
18892,Amir Johnson,29-181,F,10/29/16,BOS,@,CHO,W,1,21,1,4,0.25,1,3,0.333,0,1,0,0,0,,1,4,5
18893,Amir Johnson,29-315,F,3/12/17,BOS,,CHI,W,1,27,1,4,0.25,1,3,0.333,0,1,0,0,0,,0,4,4
18894,Amir Johnson,29-299,F,2/24/17,BOS,@,TOR,L,1,19,1,3,0.333,1,3,0.333,0,0,,0,0,,0,6,6
18895,Amir Johnson,29-260,F,1/16/17,BOS,,CHO,W,1,21,1,3,0.333,1,2,0.5,0,1,0,0,0,,1,5,6
18896,Amir Johnson,29-194,F,11/11/16,BOS,,NYK,W,1,21,0,1,0,0,1,0,0,0,,2,2,1,2,1,3
18897,Amir Johnson,29-290,F,2/15/17,BOS,,PHI,W,1,15,1,4,0.25,1,4,0.25,0,0,,0,0,,1,5,6
18898,Amir Johnson,29-206,F,11/23/16,BOS,@,BRK,W,1,19,1,2,0.5,1,2,0.5,0,0,,0,0,,2,7,9
18899,Amir Johnson,29-204,F,11/21/16,BOS,@,MIN,W,1,15,1,2,0.5,1,1,1,0,1,0,0,0,,0,2,2
18900,Amir Johnson,29-322,F,3/19/17,BOS,@,PHI,L,1,23,1,1,1,1,1,1,0,0,,0,0,,0,1,1
18901,Amir Johnson,29-315,F,3/12/17,BOS,,CHI,W,1,27,1,4,0.25,1,3,0.333,0,1,0,0,0,,0,4,4
18902,Brice Johnson,22-262,F,3/16/17,LAC,@,DEN,L,0,4,1,3,0.333,1,3,0.333,0,0,,0,0,,0,1,1
18903,James Johnson,30-004,F,2/24/17,MIA,@,ATL,W,0,16,0,4,0,0,3,0,0,1,0,2,2,1,2,0,2
18904,James Johnson,29-287,F,12/3/16,MIA,@,POR,L,0,17,1,5,0.2,1,4,0.25,0,1,0,0,0,,1,3,4
18905,Joe Johnson,35-159,G-F,12/5/16,UTA,@,LAL,W,0,19,1,6,0.167,1,2,0.5,0,4,0,0,2,0,0,2,2
18906,Joe Johnson,35-192,G-F,1/7/17,UTA,@,MIN,W,0,13,1,3,0.333,1,2,0.5,0,1,0,0,0,,0,1,1
18907,Joe Johnson,35-206,G-F,1/21/17,UTA,,IND,W,0,21,1,6,0.167,1,3,0.333,0,3,0,0,0,,0,2,2
18908,Joe Johnson,35-264,G-F,3/20/17,UTA,@,IND,L,1,31,1,7,0.143,1,3,0.333,0,4,0,0,0,,0,4,4
18909,Joe Johnson,35-135,G-F,11/11/16,UTA,@,ORL,W,0,11,1,2,0.5,1,2,0.5,0,0,,0,0,,0,1,1
18910,Joe Johnson,35-185,G-F,12/31/16,UTA,,PHO,W,0,17,1,4,0.25,1,3,0.333,0,1,0,0,0,,0,2,2
18911,Joe Johnson,35-133,G-F,11/9/16,UTA,@,CHO,L,0,23,1,6,0.167,1,3,0.333,0,3,0,0,0,,1,3,4
18912,Stanley Johnson,20-194,F,12/9/16,DET,@,MIN,W,0,4,1,1,1,1,1,1,0,0,,0,0,,1,2,3
18913,Stanley Johnson,20-260,F,2/13/17,DET,@,MIL,L,0,15,1,3,0.333,1,1,1,0,2,0,0,0,,1,0,1
18914,Stanley Johnson,20-171,F,11/16/16,DET,@,NYK,L,0,11,1,2,0.5,1,2,0.5,0,0,,0,0,,0,1,1
18915,Stanley Johnson,20-226,F,1/10/17,DET,@,SAC,L,0,23,1,6,0.167,1,5,0.2,0,1,0,0,0,,0,1,1
18916,Stanley Johnson,20-279,F,3/4/17,DET,@,PHI,W,0,18,1,6,0.167,1,4,0.25,0,2,0,0,0,,0,2,2
18917,Stanley Johnson,20-239,F,1/23/17,DET,,SAC,L,0,3,1,1,1,1,1,1,0,0,,0,0,,0,0,0
18918,Stanley Johnson,20-150,F,10/26/16,DET,@,TOR,L,0,14,1,4,0.25,1,3,0.333,0,1,0,0,0,,0,3,3
18919,Stanley Johnson,20-276,F,3/1/17,DET,@,NOP,L,0,22,1,7,0.143,1,4,0.25,0,3,0,0,0,,2,1,3
18920,Stanley Johnson,20-184,F,11/29/16,DET,@,CHO,W,0,10,1,1,1,1,1,1,0,0,,0,0,,0,0,0
18921,Stanley Johnson,20-290,F,3/15/17,DET,,UTA,L,0,12,1,4,0.25,1,2,0.5,0,2,0,0,0,,0,1,1
18922,Stanley Johnson,20-176,F,11/21/16,DET,,HOU,L,0,10,1,3,0.333,1,2,0.5,0,1,0,0,0,,0,1,1
18923,Stanley Johnson,20-213,F,12/28/16,DET,,MIL,L,0,16,1,5,0.2,1,2,0.5,0,3,0,0,0,,1,1,2
18924,Tyler Johnson,24-309,G,3/12/17,MIA,@,IND,L,0,25,1,9,0.111,1,5,0.2,0,4,0,0,0,,0,2,2
18925,Wesley Johnson,29-116,F-G,11/4/16,LAC,@,MEM,W,0,12,1,3,0.333,1,2,0.5,0,1,0,0,0,,0,0,0
18926,Wesley Johnson,29-139,F-G,11/27/16,LAC,@,IND,L,0,10,1,3,0.333,1,2,0.5,0,1,0,0,0,,0,2,2
18927,Wesley Johnson,29-158,F-G,12/16/16,LAC,@,MIA,W,0,8,1,1,1,1,1,1,0,0,,0,0,,0,4,4
18928,Wesley Johnson,29-170,F-G,12/28/16,LAC,@,NOP,L,1,19,1,7,0.143,1,5,0.2,0,2,0,0,0,,4,4,8
18929,Wesley Johnson,29-247,F-G,3/15/17,LAC,,MIL,L,0,11,1,2,0.5,1,2,0.5,0,0,,0,0,,0,0,0
18930,Wesley Johnson,29-156,F-G,12/14/16,LAC,@,ORL,W,0,15,1,3,0.333,1,1,1,0,2,0,0,0,,0,5,5
18931,Wesley Johnson,29-167,F-G,12/25/16,LAC,@,LAL,L,0,24,1,5,0.2,1,2,0.5,0,3,0,0,0,,1,4,5
18932,Wesley Johnson,29-205,F-G,2/1/17,LAC,@,PHO,W,0,11,1,1,1,1,1,1,0,0,,0,0,,0,0,0
18933,Wesley Johnson,29-227,F-G,2/23/17,LAC,@,GSW,L,0,6,1,2,0.5,1,1,1,0,1,0,0,0,,1,2,3
18934,Wesley Johnson,29-179,F-G,1/6/17,LAC,@,SAC,W,0,17,1,3,0.333,1,1,1,0,2,0,0,0,,0,4,4
18935,Wesley Johnson,29-177,F-G,1/4/17,LAC,,MEM,W,0,6,1,1,1,1,1,1,0,0,,0,0,,0,1,1
18936,Wesley Johnson,29-197,F-G,1/24/17,LAC,@,PHI,L,0,12,1,1,1,1,1,1,0,0,,0,0,,1,4,5
18937,Wesley Johnson,29-215,F-G,2/11/17,LAC,@,CHO,W,0,10,1,3,0.333,1,2,0.5,0,1,0,0,0,,1,1,2
18938,Wesley Johnson,29-238,F-G,3/6/17,LAC,,BOS,W,0,16,1,2,0.5,1,1,1,0,1,0,0,0,,0,2,2
18939,Wesley Johnson,29-162,F-G,12/20/16,LAC,,DEN,W,0,14,1,4,0.25,1,1,1,0,3,0,0,0,,0,1,1
18940,Wesley Johnson,29-194,F-G,1/21/17,LAC,@,DEN,L,0,25,1,4,0.25,1,2,0.5,0,2,0,0,0,,1,6,7
18941,Wesley Johnson,29-236,F-G,3/4/17,LAC,@,CHI,W,0,14,1,2,0.5,1,1,1,0,1,0,0,0,,0,1,1
18942,Wesley Johnson,29-117,F-G,11/5/16,LAC,@,SAS,W,0,19,1,4,0.25,1,3,0.333,0,1,0,0,0,,1,3,4
18943,Wesley Johnson,29-160,F-G,12/18/16,LAC,@,WAS,L,0,10,1,2,0.5,1,2,0.5,0,0,,0,0,,1,1,2
18944,Nikola Jokic,22-005,C-F,2/24/17,DEN,,BRK,W,1,15,1,1,1,1,1,1,0,0,,0,0,,3,2,5
18945,Damian Jones,21-223,F-C,2/8/17,GSW,,CHI,W,0,4,1,1,1,1,1,1,0,0,,0,0,,1,1,2
18946,Derrick Jones,19-362,F,2/11/17,PHO,@,HOU,L,0,5,1,2,0.5,1,2,0.5,0,0,,0,0,,1,0,1
18947,Derrick Jones,20-011,F,2/26/17,PHO,@,MIL,L,0,10,1,1,1,1,1,1,0,0,,0,0,,0,0,0
18948,Derrick Jones,20-024,F,3/11/17,PHO,@,DAL,W,1,26,1,3,0.333,1,2,0.5,0,1,0,0,0,,1,6,7
18949,James Jones,36-161,F-G,3/14/17,CLE,,DET,W,0,6,0,1,0,0,0,,0,1,0,2,3,0.667,0,1,1
18950,James Jones,36-120,F-G,2/1/17,CLE,,MIN,W,0,9,1,2,0.5,1,1,1,0,1,0,0,0,,0,2,2
18951,James Jones,36-151,F-G,3/4/17,CLE,@,MIA,L,1,27,1,3,0.333,1,1,1,0,2,0,0,0,,0,3,3
18952,James Jones,36-045,F-G,11/18/16,CLE,,DET,W,0,2,1,2,0.5,1,1,1,0,1,0,0,0,,0,0,0
18953,James Jones,36-117,F-G,1/29/17,CLE,,OKC,W,0,11,1,2,0.5,1,1,1,0,1,0,0,0,,0,0,0
18954,James Jones,36-113,F-G,1/25/17,CLE,,SAC,L,0,14,0,2,0,0,0,,0,2,0,2,5,0.4,1,2,3
18955,Terrence Jones,25-020,F,1/29/17,NOP,,WAS,L,0,10,0,6,0,0,4,0,0,2,0,2,2,1,1,2,3
18956,Tyus Jones,20-309,G,3/15/17,MIN,@,BOS,L,0,9,1,2,0.5,1,2,0.5,0,0,,0,0,,0,1,1
18957,Tyus Jones,20-269,G,2/3/17,MIN,@,DET,L,0,15,1,2,0.5,1,1,1,0,1,0,0,0,,0,1,1
18958,Tyus Jones,20-229,G,12/25/16,MIN,@,OKC,L,0,4,1,1,1,1,1,1,0,0,,0,0,,0,1,1
18959,Tyus Jones,20-304,G,3/10/17,MIN,,GSW,W,0,11,1,3,0.333,1,2,0.5,0,1,0,0,0,,0,1,1
18960,Tyus Jones,20-177,G,11/3/16,MIN,,DEN,L,0,18,1,5,0.2,1,3,0.333,0,2,0,0,0,,1,1,2
18961,Tyus Jones,20-175,G,11/1/16,MIN,,MEM,W,0,19,1,3,0.333,1,2,0.5,0,1,0,0,0,,0,2,2
18962,Tyus Jones,20-298,G,3/4/17,MIN,@,SAS,L,0,14,1,4,0.25,1,3,0.333,0,1,0,0,0,,0,1,1
18963,Tyus Jones,20-191,G,11/17/16,MIN,,PHI,W,0,3,0,0,,0,0,,0,0,,2,2,1,1,1,2
18964,Cory Joseph,25-076,G,11/4/16,TOR,,MIA,W,0,13,1,4,0.25,1,2,0.5,0,2,0,0,0,,0,4,4
18965,Cory Joseph,25-153,G,1/20/17,TOR,@,CHO,L,0,21,1,5,0.2,1,4,0.25,0,1,0,0,0,,0,2,2
18966,Cory Joseph,25-164,G,1/31/17,TOR,,NOP,W,0,24,1,6,0.167,1,6,0.167,0,0,,0,0,,0,0,0
18967,Frank Kaminsky,23-239,F-C,11/29/16,CHO,,DET,L,1,27,1,11,0.091,1,5,0.2,0,6,0,0,0,,0,3,3
18968,Frank Kaminsky,23-278,F-C,1/7/17,CHO,@,SAS,L,0,21,0,3,0,0,0,,0,3,0,2,2,1,0,4,4
18969,Frank Kaminsky,23-296,F-C,1/25/17,CHO,,GSW,L,0,18,1,8,0.125,1,5,0.2,0,3,0,0,0,,0,2,2
18970,Enes Kanter,24-227,C,1/2/17,OKC,@,MIL,L,0,22,1,6,0.167,1,6,0.167,0,0,,0,0,,2,3,5
18971,Ryan Kelly,25-341,F,3/16/17,ATL,,MEM,L,0,2,1,1,1,1,1,1,0,0,,0,0,,0,0,0
18972,Michael Kidd-Gilchrist,23-044,F,11/9/16,CHO,,UTA,W,1,33,0,5,0,0,4,0,0,1,0,2,2,1,1,8,9
18973,Michael Kidd-Gilchrist,23-075,F,12/10/16,CHO,@,CLE,L,1,23,1,2,0.5,1,2,0.5,0,0,,0,0,,0,2,2
18974,Michael Kidd-Gilchrist,23-153,F,2/26/17,CHO,@,LAC,L,1,21,1,3,0.333,1,3,0.333,0,0,,0,0,,1,5,6
18975,Sean Kilpatrick,27-067,G,3/14/17,BRK,,OKC,L,0,7,1,2,0.5,1,2,0.5,0,0,,0,0,,0,1,1
18976,Brandon Knight,25-064,G,2/4/17,PHO,,MIL,L,0,7,1,5,0.2,1,3,0.333,0,2,0,0,0,,1,0,1
18977,Brandon Knight,24-340,G,11/6/16,PHO,@,LAL,L,0,17,1,8,0.125,1,6,0.167,0,2,0,0,0,,0,0,0
18978,Brandon Knight,25-057,G,1/28/17,PHO,,DEN,L,0,16,1,8,0.125,1,5,0.2,0,3,0,0,0,,0,1,1
18979,Kyle Korver,35-300,G-F,1/11/17,CLE,@,POR,L,0,25,1,5,0.2,1,2,0.5,0,3,0,0,0,,0,2,2
18980,Kyle Korver,35-299,G-F,1/10/17,CLE,@,UTA,L,0,18,1,5,0.2,1,3,0.333,0,2,0,0,0,,0,3,3
18981,Kyle Korver,35-293,G-F,1/4/17,ATL,@,ORL,W,0,17,1,5,0.2,1,3,0.333,0,2,0,0,0,,0,3,3
18982,Kosta Koufos,27-245,C,10/26/16,SAC,@,PHO,W,1,13,1,6,0.167,1,6,0.167,0,0,,0,1,0,0,4,4
18983,Kosta Koufos,27-324,C,1/13/17,SAC,,CLE,L,0,6,1,3,0.333,1,3,0.333,0,0,,0,0,,2,3,5
18984,Kosta Koufos,27-352,C,2/10/17,SAC,,ATL,W,1,18,1,4,0.25,1,4,0.25,0,0,,0,0,,1,3,4
18985,Kosta Koufos,27-253,C,11/3/16,SAC,@,ORL,L,1,20,1,3,0.333,1,3,0.333,0,0,,0,0,,1,6,7
18986,Kosta Koufos,27-301,C,12/21/16,SAC,@,UTA,W,1,12,1,1,1,1,1,1,0,0,,0,0,,1,3,4
18987,Kosta Koufos,27-319,C,1/8/17,SAC,,GSW,L,0,16,1,3,0.333,1,3,0.333,0,0,,0,0,,1,6,7
18988,Kosta Koufos,27-284,C,12/4/16,SAC,@,NYK,L,1,19,1,7,0.143,1,7,0.143,0,0,,0,0,,5,6,11
18989,Kosta Koufos,27-300,C,12/20/16,SAC,,POR,W,1,14,1,2,0.5,1,2,0.5,0,0,,0,0,,0,0,0
18990,Kosta Koufos,27-346,C,2/4/17,SAC,,GSW,W,1,13,1,1,1,1,1,1,0,0,,0,0,,0,5,5
18991,Mindaugas Kuzminskas,27-037,F,11/25/16,NYK,,CHO,W,0,24,0,6,0,0,2,0,0,4,0,2,2,1,1,3,4
18992,Mindaugas Kuzminskas,27-048,F,12/6/16,NYK,@,MIA,W,0,10,1,5,0.2,1,2,0.5,0,3,0,0,0,,1,2,3
18993,Mindaugas Kuzminskas,27-098,F,1/25/17,NYK,@,DAL,L,0,12,1,3,0.333,1,1,1,0,2,0,0,0,,1,0,1
18994,Mindaugas Kuzminskas,27-026,F,11/14/16,NYK,,DAL,W,0,3,1,2,0.5,1,1,1,0,1,0,0,0,,0,0,0
18995,Mindaugas Kuzminskas,27-024,F,11/12/16,NYK,@,TOR,L,0,11,1,4,0.25,1,4,0.25,0,0,,0,0,,2,2,4
18996,Skal Labissiere,20-288,F,12/31/16,SAC,,MEM,L,0,3,1,1,1,1,1,1,0,0,,0,0,,0,2,2
18997,Skal Labissiere,20-271,F,12/14/16,SAC,@,HOU,L,0,7,1,2,0.5,1,2,0.5,0,0,,0,0,,1,0,1
18998,Skal Labissiere,20-327,F,2/8/17,SAC,,BOS,W,0,1,0,0,,0,0,,0,0,,2,2,1,0,0,0
18999,Jeremy Lamb,24-198,G-F,12/14/16,CHO,@,WAS,L,0,11,1,3,0.333,1,2,0.5,0,1,0,0,0,,0,1,1
19000,Jeremy Lamb,24-177,G-F,11/23/16,CHO,,SAS,L,0,6,1,2,0.5,1,2,0.5,0,0,,0,0,,0,3,3
19001,Jeremy Lamb,24-204,G-F,12/20/16,CHO,,LAL,W,0,11,0,6,0,0,5,0,0,1,0,2,2,1,1,2,3
19002,Jeremy Lamb,24-220,G-F,1/5/17,CHO,@,DET,L,0,13,1,7,0.143,1,4,0.25,0,3,0,0,0,,0,1,1
19003,Nicolas Laprovittola,26-278,G,11/4/16,SAS,@,UTA,W,0,18,0,6,0,0,2,0,0,4,0,2,2,1,0,1,1
19004,Joffrey Lauvergne,25-172,C-F,3/21/17,CHI,@,TOR,L,0,7,1,3,0.333,1,3,0.333,0,0,,0,0,,0,1,1
19005,Joffrey Lauvergne,25-030,C-F,10/30/16,OKC,,LAL,W,0,8,1,2,0.5,1,1,1,0,1,0,0,0,,0,2,2
19006,Joffrey Lauvergne,25-168,C-F,3/17/17,CHI,@,WAS,L,0,8,1,1,1,1,1,1,0,0,,0,0,,0,2,2
19007,Joffrey Lauvergne,25-080,C-F,12/19/16,OKC,,ATL,L,0,4,1,2,0.5,1,1,1,0,1,0,0,0,,1,1,2
19008,Joffrey Lauvergne,25-117,C-F,1/25/17,OKC,@,NOP,W,0,10,1,5,0.2,1,3,0.333,0,2,0,0,0,,0,2,2
19009,Joffrey Lauvergne,25-075,C-F,12/14/16,OKC,@,UTA,L,0,8,1,5,0.2,1,4,0.25,0,1,0,0,0,,3,0,3
19010,Joffrey Lauvergne,25-161,C-F,3/10/17,CHI,,HOU,L,0,16,1,6,0.167,1,4,0.25,0,2,0,0,0,,2,7,9
19011,Ty Lawson,29-058,G,12/31/16,SAC,,MEM,L,0,10,0,3,0,0,2,0,0,1,0,2,2,1,1,1,2
19012,Ty Lawson,28-364,G,11/1/16,SAC,@,MIA,L,1,37,1,6,0.167,1,4,0.25,0,2,0,0,0,,0,5,5
19013,Jake Layman,23-011,F,3/18/17,POR,@,ATL,W,0,3,0,0,,0,0,,0,0,,2,2,1,0,0,0
19014,Jake Layman,23-007,F,3/14/17,POR,@,NOP,L,0,10,0,3,0,0,2,0,0,1,0,2,2,1,0,1,1
19015,Jake Layman,22-263,F,11/25/16,POR,,NOP,W,0,5,1,1,1,1,1,1,0,0,,0,0,,0,0,0
19016,Jake Layman,22-258,F,11/20/16,POR,@,BRK,W,0,4,1,3,0.333,1,1,1,0,2,0,0,0,,0,3,3
19017,Jake Layman,22-276,F,12/8/16,POR,@,MEM,L,0,12,0,5,0,0,2,0,0,3,0,2,2,1,1,0,1
19018,Courtney Lee,31-168,G,3/20/17,NYK,@,LAC,L,1,22,1,6,0.167,1,3,0.333,0,3,0,0,0,,0,2,2
19019,David Lee,33-260,F,1/14/17,SAS,@,PHO,L,0,13,1,1,1,1,1,1,0,0,,0,0,,1,2,3
19020,David Lee,33-220,F,12/5/16,SAS,@,MIL,W,0,9,1,1,1,1,1,1,0,0,,0,0,,0,2,2
19021,David Lee,33-285,F,2/8/17,SAS,@,PHI,W,0,14,1,2,0.5,1,2,0.5,0,0,,0,0,,0,6,6
19022,David Lee,33-323,F,3/18/17,SAS,@,MEM,L,0,11,1,3,0.333,1,3,0.333,0,0,,0,0,,1,2,3
19023,David Lee,33-214,F,11/29/16,SAS,,ORL,L,0,12,0,4,0,0,4,0,0,0,,2,2,1,1,2,3
19024,David Lee,33-301,F,2/24/17,SAS,@,LAC,W,0,11,1,5,0.2,1,5,0.2,0,0,,0,0,,2,3,5
19025,Alex Len,23-235,C,2/6/17,PHO,@,NOP,L,0,9,1,4,0.25,1,4,0.25,0,0,,0,0,,1,4,5
19026,Alex Len,23-232,C,2/3/17,PHO,@,SAC,W,0,16,1,2,0.5,1,2,0.5,0,0,,0,0,,1,4,5
19027,Alex Len,23-206,C,1/8/17,PHO,,CLE,L,0,6,1,3,0.333,1,3,0.333,0,0,,0,0,,0,0,0
19028,Meyers Leonard,24-274,C-F,11/27/16,POR,,HOU,L,0,10,1,3,0.333,1,1,1,0,2,0,0,0,,0,1,1
19029,Meyers Leonard,24-352,C-F,2/13/17,POR,,ATL,L,1,24,1,7,0.143,1,1,1,0,6,0,0,2,0,2,4,6
19030,Meyers Leonard,25-019,C-F,3/18/17,POR,@,ATL,W,0,3,1,2,0.5,1,1,1,0,1,0,0,0,,0,1,1
19031,Meyers Leonard,24-282,C-F,12/5/16,POR,@,CHI,W,0,12,1,3,0.333,1,1,1,0,2,0,0,0,,0,2,2
19032,Meyers Leonard,24-337,C-F,1/29/17,POR,,GSW,L,0,7,1,2,0.5,1,2,0.5,0,0,,0,0,,0,2,2
19033,Jon Leuer,27-263,F,2/1/17,DET,,NOP,W,1,17,1,7,0.143,1,4,0.25,0,3,0,0,0,,0,4,4
19034,Jon Leuer,27-232,F,1/1/17,DET,@,MIA,W,1,28,1,4,0.25,1,4,0.25,0,0,,0,0,,2,1,3
19035,Jon Leuer,27-211,F,12/11/16,DET,,PHI,L,0,22,1,3,0.333,1,3,0.333,0,0,,0,0,,1,1,2
19036,Jon Leuer,27-274,F,2/12/17,DET,@,TOR,W,1,17,1,5,0.2,1,3,0.333,0,2,0,0,0,,0,0,0
19037,Jon Leuer,27-311,F,3/21/17,DET,@,BRK,L,0,22,0,7,0,0,5,0,0,2,0,2,2,1,1,4,5
19038,Caris LeVert,22-107,G-F,12/10/16,BRK,@,SAS,L,0,15,1,5,0.2,1,2,0.5,0,3,0,0,0,,0,1,1
19039,Caris LeVert,22-174,G-F,2/15/17,BRK,,MIL,L,0,13,0,3,0,0,1,0,0,2,0,2,2,1,0,2,2
19040,Caris LeVert,22-172,G-F,2/13/17,BRK,,MEM,L,0,21,1,6,0.167,1,2,0.5,0,4,0,0,0,,0,2,2
19041,Caris LeVert,22-197,G-F,3/10/17,BRK,@,DAL,L,1,22,1,5,0.2,1,3,0.333,0,2,0,0,0,,1,2,3
19042,Caris LeVert,22-115,G-F,12/18/16,BRK,@,PHI,L,0,11,1,3,0.333,1,2,0.5,0,1,0,0,0,,0,1,1
19043,DeAndre Liggins,28-329,G,2/23/17,CLE,,NYK,W,0,3,1,2,0.5,1,2,0.5,0,0,,0,0,,0,2,2
19044,DeAndre Liggins,28-286,G,1/11/17,CLE,@,POR,L,1,18,1,5,0.2,1,1,1,0,4,0,0,0,,0,1,1
19045,DeAndre Liggins,28-352,G,3/18/17,CLE,@,LAC,L,0,18,1,3,0.333,1,3,0.333,0,0,,0,0,,1,2,3
19046,DeAndre Liggins,28-348,G,3/14/17,CLE,,DET,W,0,7,0,0,,0,0,,0,0,,2,2,1,0,2,2
19047,DeAndre Liggins,28-279,G,1/4/17,CLE,,CHI,L,1,23,1,5,0.2,1,3,0.333,0,2,0,0,0,,0,3,3
19048,DeAndre Liggins,28-277,G,1/2/17,CLE,,NOP,W,1,19,1,5,0.2,1,4,0.25,0,1,0,0,0,,0,3,3
19049,DeAndre Liggins,28-305,G,1/30/17,CLE,@,DAL,L,0,8,1,2,0.5,1,2,0.5,0,0,,0,0,,0,1,1
19050,DeAndre Liggins,28-237,G,11/23/16,CLE,,POR,W,0,4,1,2,0.5,1,2,0.5,0,0,,0,1,0,0,1,1
19051,Shaun Livingston,31-188,G,3/18/17,GSW,,MIL,W,0,18,1,4,0.25,1,4,0.25,0,0,,0,0,,0,2,2
19052,Shaun Livingston,31-105,G,12/25/16,GSW,@,CLE,L,0,18,0,2,0,0,2,0,0,0,,2,2,1,0,3,3
19053,Shaun Livingston,31-181,G,3/11/17,GSW,@,SAS,L,1,27,1,7,0.143,1,7,0.143,0,0,,0,0,,1,2,3
19054,Shaun Livingston,31-100,G,12/20/16,GSW,,UTA,W,0,18,1,4,0.25,1,4,0.25,0,0,,0,0,,1,1,2
19055,Shaun Livingston,31-136,G,1/25/17,GSW,@,CHO,W,0,18,1,7,0.143,1,7,0.143,0,0,,0,0,,0,1,1
19056,Shaun Livingston,31-178,G,3/8/17,GSW,,BOS,L,0,14,1,2,0.5,1,2,0.5,0,0,,0,0,,0,0,0
19057,Shaun Livingston,31-176,G,3/6/17,GSW,@,ATL,W,0,17,1,6,0.167,1,6,0.167,0,0,,0,0,,1,2,3
19058,Shaun Livingston,31-044,G,10/25/16,GSW,,SAS,L,0,13,1,3,0.333,1,2,0.5,0,1,0,0,0,,0,2,2
19059,Shaun Livingston,31-152,G,2/10/17,GSW,@,MEM,W,0,12,0,3,0,0,3,0,0,0,,2,2,1,0,1,1
19060,Shaun Livingston,31-075,G,11/25/16,GSW,@,LAL,W,0,15,1,4,0.25,1,4,0.25,0,0,,0,0,,0,2,2
19061,Shaun Livingston,31-108,G,12/28/16,GSW,,TOR,W,0,12,1,1,1,1,1,1,0,0,,0,0,,0,0,0
19062,Shaun Livingston,31-150,G,2/8/17,GSW,,CHI,W,0,16,1,2,0.5,1,2,0.5,0,0,,0,0,,0,1,1
19063,Shawn Long,24-047,F,3/17/17,PHI,,DAL,W,0,9,1,2,0.5,1,1,1,0,1,0,0,0,,1,2,3
19064,Kevon Looney,20-275,F-C,11/7/16,GSW,,NOP,W,0,9,1,2,0.5,1,2,0.5,0,0,,0,0,,0,0,0
19065,Kevon Looney,20-341,F-C,1/12/17,GSW,,DET,W,0,4,1,1,1,1,1,1,0,0,,0,0,,0,2,2
19066,Kevon Looney,21-021,F-C,2/27/17,GSW,@,PHI,W,0,1,1,1,1,1,1,1,0,0,,0,0,,0,0,0
19067,Kevon Looney,20-361,F-C,2/1/17,GSW,,CHO,W,0,9,1,2,0.5,1,1,1,0,1,0,0,1,0,0,1,1
19068,Kevon Looney,20-269,F-C,11/1/16,GSW,@,POR,W,0,8,1,3,0.333,1,3,0.333,0,0,,0,0,,2,2,4
19069,Kevon Looney,20-267,F-C,10/30/16,GSW,@,PHO,W,0,3,1,2,0.5,1,2,0.5,0,0,,0,1,0,0,0,0
19070,Kevon Looney,20-305,F-C,12/7/16,GSW,@,LAC,W,0,5,1,1,1,1,1,1,0,0,,0,0,,2,0,2
19071,Kevon Looney,21-042,F-C,3/20/17,GSW,@,OKC,W,0,5,1,2,0.5,1,2,0.5,0,0,,0,0,,1,1,2
19072,Kevon Looney,20-281,F-C,11/13/16,GSW,,PHO,W,0,7,1,1,1,1,1,1,0,0,,0,1,0,1,1,2
19073,Kevon Looney,20-303,F-C,12/5/16,GSW,,IND,W,0,14,1,4,0.25,1,3,0.333,0,1,0,0,0,,2,3,5
19074,Kevon Looney,21-038,F-C,3/16/17,GSW,,ORL,W,0,7,1,3,0.333,1,3,0.333,0,0,,0,0,,0,2,2
19075,Kevon Looney,20-278,F-C,11/10/16,GSW,@,DEN,W,0,6,1,1,1,1,1,1,0,0,,0,0,,1,1,2
19076,Kevon Looney,21-033,F-C,3/11/17,GSW,@,SAS,L,1,17,1,8,0.125,1,7,0.143,0,1,0,0,0,,4,0,4
19077,Robin Lopez,28-273,C,12/30/16,CHI,@,IND,L,1,19,0,0,,0,0,,0,0,,2,2,1,1,1,2
19078,Robin Lopez,28-299,C,1/25/17,CHI,,ATL,L,1,28,1,5,0.2,1,5,0.2,0,0,,0,0,,1,5,6
19079,John Lucas III,33-350,G,11/5/16,MIN,@,OKC,L,0,6,1,4,0.25,1,3,0.333,0,1,0,0,0,,0,0,0
19080,Timothe Luwawu-Cabarrot,21-249,F,1/13/17,PHI,,CHO,W,0,10,1,2,0.5,1,1,1,0,1,0,0,0,,0,2,2
19081,Timothe Luwawu-Cabarrot,21-261,F,1/25/17,PHI,@,MIL,W,0,11,1,1,1,1,1,1,0,0,,0,0,,0,0,0
19082,Timothe Luwawu-Cabarrot,21-187,F,11/12/16,PHI,@,ATL,L,0,3,1,1,1,1,1,1,0,0,,0,0,,0,0,0
19083,Timothe Luwawu-Cabarrot,21-210,F,12/5/16,PHI,,DEN,L,0,10,0,2,0,0,2,0,0,0,,2,2,1,0,0,0
19084,Timothe Luwawu-Cabarrot,21-242,F,1/6/17,PHI,@,BOS,L,0,8,1,2,0.5,1,2,0.5,0,0,,0,0,,0,3,3
19085,Timothe Luwawu-Cabarrot,21-182,F,11/7/16,PHI,,UTA,L,0,4,1,1,1,1,1,1,0,0,,0,2,0,0,1,1
19086,Timothe Luwawu-Cabarrot,21-208,F,12/3/16,PHI,,BOS,L,0,10,0,0,,0,0,,0,0,,2,4,0.5,0,2,2
19087,Timothe Luwawu-Cabarrot,21-292,F,2/25/17,PHI,@,NYK,L,0,12,0,3,0,0,0,,0,3,0,2,2,1,1,1,2
19088,Timothe Luwawu-Cabarrot,21-256,F,1/20/17,PHI,,POR,W,0,14,1,3,0.333,1,2,0.5,0,1,0,0,0,,0,2,2
19089,Timothe Luwawu-Cabarrot,21-315,F,3/20/17,PHI,@,ORL,L,1,23,0,4,0,0,2,0,0,2,0,2,2,1,0,3,3
19090,Timothe Luwawu-Cabarrot,21-194,F,11/19/16,PHI,,PHO,W,0,5,1,3,0.333,1,3,0.333,0,0,,0,0,,0,0,0
19091,Timothe Luwawu-Cabarrot,21-265,F,1/29/17,PHI,@,CHI,L,0,14,1,4,0.25,1,3,0.333,0,1,0,0,0,,0,1,1
19092,Trey Lyles,21-077,F,1/21/17,UTA,,IND,W,0,12,1,8,0.125,1,4,0.25,0,4,0,0,0,,0,2,2
19093,Trey Lyles,21-039,F,12/14/16,UTA,,OKC,W,0,14,1,4,0.25,1,3,0.333,0,1,0,0,0,,0,3,3
19094,Trey Lyles,21-070,F,1/14/17,UTA,,ORL,W,0,14,1,5,0.2,1,2,0.5,0,3,0,0,0,,0,1,1
19095,Trey Lyles,21-100,F,2/13/17,UTA,,LAC,L,0,13,0,9,0,0,5,0,0,4,0,2,2,1,1,6,7
19096,Shelvin Mack,26-209,G,11/17/16,UTA,,CHI,L,0,13,1,3,0.333,1,3,0.333,0,0,,0,0,,0,0,0
19097,Shelvin Mack,26-266,G,1/13/17,UTA,,DET,W,0,5,1,3,0.333,1,2,0.5,0,1,0,0,0,,0,2,2
19098,Ian Mahinmi,30-095,C,2/8/17,WAS,@,BRK,W,0,12,1,3,0.333,1,3,0.333,0,0,,0,0,,2,3,5
19099,Thon Maker,19-307,F-C,12/28/16,MIL,@,DET,W,0,3,1,3,0.333,1,1,1,0,2,0,0,0,,0,0,0
19100,Thon Maker,20-001,F-C,2/26/17,MIL,,PHO,W,1,14,0,5,0,0,3,0,0,2,0,2,2,1,1,1,2
19101,Thon Maker,19-307,F-C,12/28/16,MIL,@,DET,W,0,3,1,3,0.333,1,1,1,0,2,0,0,0,,0,0,0
19102,Boban Marjanovic,28-095,C,11/18/16,DET,@,CLE,L,0,6,1,4,0.25,1,4,0.25,0,0,,0,0,,2,3,5
19103,Boban Marjanovic,28-159,C,1/21/17,DET,,WAS,W,0,5,1,1,1,1,1,1,0,0,,0,0,,0,1,1
19104,Boban Marjanovic,28-156,C,1/18/17,DET,,ATL,W,0,2,1,2,0.5,1,2,0.5,0,0,,0,0,,0,2,2
19105,Boban Marjanovic,28-082,C,11/5/16,DET,,DEN,W,0,2,1,2,0.5,1,2,0.5,0,0,,0,0,,0,1,1
19106,Boban Marjanovic,28-124,C,12/17/16,DET,,IND,L,0,4,1,2,0.5,1,2,0.5,0,0,,0,2,0,0,0,0
19107,Boban Marjanovic,28-212,C,3/15/17,DET,,UTA,L,0,5,1,2,0.5,1,2,0.5,0,0,,0,0,,1,1,2
19108,Boban Marjanovic,28-074,C,10/28/16,DET,,ORL,W,0,2,1,2,0.5,1,2,0.5,0,0,,0,0,,0,0,0
19109,Jarell Martin,22-213,F,12/23/16,MEM,,HOU,W,0,15,1,2,0.5,1,2,0.5,0,0,,0,0,,1,3,4
19110,Jarell Martin,22-198,F,12/8/16,MEM,,POR,W,0,13,1,2,0.5,1,2,0.5,0,0,,0,0,,0,1,1
19111,Jarell Martin,22-211,F,12/21/16,MEM,@,DET,W,0,11,1,1,1,1,1,1,0,0,,0,0,,1,0,1
19112,Jarell Martin,22-227,F,1/6/17,MEM,@,GSW,W,0,5,0,0,,0,0,,0,0,,2,2,1,0,3,3
19113,Jarell Martin,22-183,F,11/23/16,MEM,@,PHI,W,0,12,1,5,0.2,1,5,0.2,0,0,,0,0,,1,2,3
19114,Jarell Martin,22-195,F,12/5/16,MEM,@,NOP,W,0,20,1,8,0.125,1,7,0.143,0,1,0,0,2,0,3,6,9
19115,Jarell Martin,22-178,F,11/18/16,MEM,@,DAL,W,0,4,1,2,0.5,1,2,0.5,0,0,,0,0,,1,2,3
19116,Wesley Matthews,30-150,G,3/13/17,DAL,@,TOR,L,1,18,1,5,0.2,1,2,0.5,0,3,0,0,0,,0,1,1
19117,Wesley Matthews,30-087,G,1/9/17,DAL,@,MIN,L,1,37,1,7,0.143,1,4,0.25,0,3,0,0,0,,0,4,4
19118,Luc Mbah a Moute,30-150,F,2/6/17,LAC,@,TOR,L,0,12,1,4,0.25,1,3,0.333,0,1,0,0,0,,0,1,1
19119,Luc Mbah a Moute,30-149,F,2/5/17,LAC,@,BOS,L,0,14,1,3,0.333,1,3,0.333,0,0,,0,0,,0,1,1
19120,Luc Mbah a Moute,30-183,F,3/11/17,LAC,,PHI,W,1,12,1,1,1,1,1,1,0,0,,0,0,,0,1,1
19121,Luc Mbah a Moute,30-167,F,2/23/17,LAC,@,GSW,L,1,14,1,5,0.2,1,4,0.25,0,1,0,0,0,,0,0,0
19122,Luc Mbah a Moute,30-089,F,12/7/16,LAC,,GSW,L,1,15,0,3,0,0,3,0,0,0,,2,2,1,0,1,1
19123,Luc Mbah a Moute,30-180,F,3/8/17,LAC,@,MIN,L,1,16,1,2,0.5,1,2,0.5,0,0,,0,0,,0,0,0
19124,Luc Mbah a Moute,30-054,F,11/2/16,LAC,,OKC,L,1,24,0,1,0,0,0,,0,1,0,2,4,0.5,0,1,1
19125,Luc Mbah a Moute,30-190,F,3/18/17,LAC,,CLE,W,1,14,1,2,0.5,1,1,1,0,1,0,0,0,,0,2,2
19126,Luc Mbah a Moute,30-152,F,2/8/17,LAC,@,NYK,W,1,26,1,3,0.333,1,1,1,0,2,0,0,0,,0,2,2
19127,Luc Mbah a Moute,30-052,F,10/31/16,LAC,,PHO,W,1,20,1,3,0.333,1,2,0.5,0,1,0,0,1,0,0,1,1
19128,Luc Mbah a Moute,30-081,F,11/29/16,LAC,@,BRK,L,1,20,0,3,0,0,2,0,0,1,0,2,4,0.5,1,3,4
19129,James Michael McAdoo,23-341,F,12/10/16,GSW,@,MEM,L,0,8,1,1,1,1,1,1,0,0,,0,0,,0,0,0
19130,James Michael McAdoo,24-035,F,2/8/17,GSW,,CHI,W,0,16,1,2,0.5,1,2,0.5,0,0,,0,0,,0,0,0
19131,James Michael McAdoo,24-075,F,3/20/17,GSW,@,OKC,W,0,7,1,2,0.5,1,2,0.5,0,0,,0,0,,0,0,0
19132,James Michael McAdoo,23-336,F,12/5/16,GSW,,IND,W,0,8,1,2,0.5,1,1,1,0,1,0,0,1,0,0,3,3
19133,James Michael McAdoo,24-031,F,2/4/17,GSW,@,SAC,L,0,10,1,2,0.5,1,2,0.5,0,0,,0,0,,1,0,1
19134,James Michael McAdoo,24-054,F,2/27/17,GSW,@,PHI,W,0,6,1,4,0.25,1,4,0.25,0,0,,0,0,,4,0,4
19135,James Michael McAdoo,24-073,F,3/18/17,GSW,,MIL,W,0,4,1,1,1,1,1,1,0,0,,0,0,,0,2,2
19136,James Michael McAdoo,23-326,F,11/25/16,GSW,@,LAL,W,0,2,1,1,1,1,1,1,0,0,,0,0,,0,0,0
19137,James Michael McAdoo,24-028,F,2/1/17,GSW,,CHO,W,0,18,1,3,0.333,1,3,0.333,0,0,,0,0,,1,0,1
19138,James Michael McAdoo,23-319,F,11/18/16,GSW,@,BOS,W,0,8,1,1,1,1,1,1,0,0,,0,0,,0,0,0
19139,Patrick McCaw,21-142,G,3/16/17,GSW,,ORL,W,1,20,1,2,0.5,1,1,1,0,1,0,0,0,,0,0,0
19140,Patrick McCaw,21-125,G,2/27/17,GSW,@,PHI,W,0,8,0,0,,0,0,,0,0,,2,2,1,0,1,1
19141,Patrick McCaw,21-000,G,10/25/16,GSW,,SAS,L,0,9,1,3,0.333,1,1,1,0,2,0,0,0,,0,0,0
19142,Patrick McCaw,21-140,G,3/14/17,GSW,,PHI,W,1,14,1,2,0.5,1,2,0.5,0,0,,0,0,,0,0,0
19143,Patrick McCaw,21-085,G,1/18/17,GSW,,OKC,W,0,4,1,1,1,1,1,1,0,0,,0,0,,0,1,1
19144,Patrick McCaw,21-137,G,3/11/17,GSW,@,SAS,L,1,42,0,12,0,0,6,0,0,6,0,2,2,1,1,1,2
19145,Patrick McCaw,21-083,G,1/16/17,GSW,,CLE,W,0,5,0,0,,0,0,,0,0,,2,2,1,0,1,1
19146,Patrick McCaw,21-121,G,2/23/17,GSW,,LAC,W,0,12,1,3,0.333,1,3,0.333,0,0,,0,0,,1,1,2
19147,Patrick McCaw,21-024,G,11/18/16,GSW,@,BOS,W,0,16,1,3,0.333,1,1,1,0,2,0,0,0,,0,1,1
19148,Patrick McCaw,21-039,G,12/3/16,GSW,,PHO,W,0,8,1,2,0.5,1,2,0.5,0,0,,0,0,,0,0,0
19149,Patrick McCaw,21-051,G,12/15/16,GSW,,NYK,W,0,15,1,4,0.25,1,3,0.333,0,1,0,0,0,,0,1,1
19150,Patrick McCaw,21-032,G,11/26/16,GSW,,MIN,W,0,13,1,1,1,1,1,1,0,0,,0,0,,1,1,2
19151,Sheldon McClellan,23-326,G,11/11/16,WAS,,CLE,L,0,12,1,5,0.2,1,2,0.5,0,3,0,0,0,,0,1,1
19152,Sheldon McClellan,23-324,G,11/9/16,WAS,,BOS,W,0,3,1,2,0.5,1,1,1,0,1,0,0,0,,0,0,0
19153,Sheldon McClellan,24-054,G,2/13/17,WAS,,OKC,W,0,3,1,1,1,1,1,1,0,0,,0,0,,0,0,0
19154,T.J. McConnell,24-221,G,11/1/16,PHI,,ORL,L,0,16,1,3,0.333,1,2,0.5,0,1,0,0,0,,0,1,1
19155,T.J. McConnell,24-236,G,11/16/16,PHI,,WAS,W,0,20,1,2,0.5,1,2,0.5,0,0,,0,0,,0,3,3
19156,T.J. McConnell,24-232,G,11/12/16,PHI,@,ATL,L,0,23,1,2,0.5,1,2,0.5,0,0,,0,0,,0,0,0
19157,T.J. McConnell,24-247,G,11/27/16,PHI,,CLE,L,0,20,1,4,0.25,1,4,0.25,0,0,,0,0,,2,2,4
19158,T.J. McConnell,24-258,G,12/8/16,PHI,@,NOP,W,0,19,1,5,0.2,1,4,0.25,0,1,0,0,0,,1,2,3
19159,T.J. McConnell,24-346,G,3/6/17,PHI,,MIL,L,1,24,1,4,0.25,1,4,0.25,0,0,,0,0,,1,1,2
19160,T.J. McConnell,24-241,G,11/21/16,PHI,,MIA,W,0,14,1,2,0.5,1,2,0.5,0,0,,0,0,,0,0,0
19161,Chris McCullough,21-287,F,11/18/16,BRK,@,OKC,L,0,4,1,2,0.5,1,2,0.5,0,0,,0,0,,0,0,0
19162,Chris McCullough,21-353,F,1/23/17,BRK,,SAS,L,0,5,1,2,0.5,1,1,1,0,1,0,0,0,,0,0,0
19163,Chris McCullough,21-322,F,12/23/16,BRK,@,CLE,L,0,7,1,2,0.5,1,1,1,0,1,0,0,0,,0,2,2
19164,Chris McCullough,21-264,F,10/26/16,BRK,@,BOS,L,0,4,1,2,0.5,1,2,0.5,0,0,,0,0,,2,0,2
19165,K.J. McDaniels,23-344,G-F,1/18/17,HOU,,MIL,W,0,2,1,1,1,1,1,1,0,0,,0,0,,0,0,0
19166,K.J. McDaniels,24-022,G-F,3/3/17,BRK,@,UTA,L,0,15,1,4,0.25,1,2,0.5,0,2,0,0,0,,0,1,1
19167,K.J. McDaniels,23-297,G-F,12/2/16,HOU,@,DEN,W,0,4,1,3,0.333,1,3,0.333,0,0,,0,0,,0,0,0
19168,K.J. McDaniels,23-364,G-F,2/7/17,HOU,,ORL,W,0,2,1,1,1,1,1,1,0,0,,0,0,,0,0,0
19169,K.J. McDaniels,23-264,G-F,10/30/16,HOU,,DAL,W,0,16,1,4,0.25,1,3,0.333,0,1,0,0,0,,1,1,2
19170,K.J. McDaniels,23-322,G-F,12/27/16,HOU,@,DAL,W,0,8,0,2,0,0,1,0,0,1,0,2,2,1,0,1,1
19171,K.J. McDaniels,23-321,G-F,12/26/16,HOU,,PHO,W,0,4,1,3,0.333,1,2,0.5,0,1,0,0,0,,1,2,3
19172,K.J. McDaniels,24-027,G-F,3/8/17,BRK,@,ATL,L,0,5,1,3,0.333,1,2,0.5,0,1,0,0,0,,1,0,1
19173,K.J. McDaniels,24-025,G-F,3/6/17,BRK,@,MEM,W,0,5,1,4,0.25,1,3,0.333,0,1,0,0,0,,2,0,2
19174,K.J. McDaniels,23-309,G-F,12/14/16,HOU,,SAC,W,0,6,1,2,0.5,1,1,1,0,1,0,0,0,,0,1,1
19175,Doug McDermott,25-017,F,1/20/17,CHI,@,ATL,L,0,16,1,3,0.333,1,2,0.5,0,1,0,0,0,,0,5,5
19176,Doug McDermott,25-054,F,2/26/17,OKC,,NOP,W,0,23,1,4,0.25,1,3,0.333,0,1,0,0,0,,0,5,5
19177,Doug McDermott,25-009,F,1/12/17,CHI,@,NYK,L,0,17,0,5,0,0,3,0,0,2,0,2,2,1,0,2,2
19178,Doug McDermott,25-063,F,3/7/17,OKC,,POR,L,0,14,0,1,0,0,1,0,0,0,,2,2,1,0,0,0
19179,JaVale McGee,29-039,C,2/27/17,GSW,@,PHI,W,0,5,1,3,0.333,1,3,0.333,0,0,,0,0,,1,0,1
19180,JaVale McGee,29-054,C,3/14/17,GSW,,PHI,W,0,3,1,1,1,1,1,1,0,0,,0,2,0,0,0,0
19181,JaVale McGee,28-365,C,1/18/17,GSW,,OKC,W,0,6,1,2,0.5,1,1,1,0,1,0,0,2,0,0,2,2
19182,JaVale McGee,29-051,C,3/11/17,GSW,@,SAS,L,0,6,1,3,0.333,1,3,0.333,0,0,,0,0,,1,0,1
19183,JaVale McGee,28-327,C,12/11/16,GSW,@,MIN,W,0,6,1,2,0.5,1,2,0.5,0,0,,0,0,,0,0,0
19184,JaVale McGee,28-344,C,12/28/16,GSW,,TOR,W,0,7,1,2,0.5,1,2,0.5,0,0,,0,0,,0,2,2
19185,JaVale McGee,28-341,C,12/25/16,GSW,@,CLE,L,0,9,1,3,0.333,1,3,0.333,0,0,,0,2,0,2,1,3
19186,JaVale McGee,28-357,C,1/10/17,GSW,,MIA,W,0,9,1,1,1,1,1,1,0,0,,0,0,,0,3,3
19187,JaVale McGee,28-355,C,1/8/17,GSW,@,SAC,W,0,4,1,1,1,1,1,1,0,0,,0,0,,1,0,1
19188,JaVale McGee,28-280,C,10/25/16,GSW,,SAS,L,0,4,1,2,0.5,1,2,0.5,0,0,,0,1,0,0,0,0
19189,JaVale McGee,29-006,C,1/25/17,GSW,@,CHO,W,0,4,1,1,1,1,1,1,0,0,,0,0,,0,1,1
19190,JaVale McGee,29-040,C,2/28/17,GSW,@,WAS,L,0,3,0,0,,0,0,,0,0,,2,2,1,0,0,0
19191,JaVale McGee,28-299,C,11/13/16,GSW,,PHO,W,0,3,0,0,,0,0,,0,0,,2,2,1,0,1,1
19192,JaVale McGee,29-056,C,3/16/17,GSW,,ORL,W,0,7,0,1,0,0,1,0,0,0,,2,4,0.5,0,1,1
19193,Rodney McGruder,25-235,G,3/21/17,MIA,,PHO,W,1,24,1,4,0.25,1,2,0.5,0,2,0,0,0,,1,4,5
19194,Rodney McGruder,25-111,G,11/17/16,MIA,,MIL,W,0,19,1,4,0.25,1,1,1,0,3,0,0,0,,1,1,2
19195,Rodney McGruder,25-138,G,12/14/16,MIA,,IND,W,1,18,0,3,0,0,0,,0,3,0,2,2,1,3,2,5
19196,Rodney McGruder,25-108,G,11/14/16,MIA,@,SAS,L,0,18,1,2,0.5,1,1,1,0,1,0,0,0,,0,2,2
19197,Rodney McGruder,25-229,G,3/15/17,MIA,,NOP,W,1,17,1,3,0.333,1,2,0.5,0,1,0,0,0,,0,2,2
19198,Rodney McGruder,25-187,G,2/1/17,MIA,,ATL,W,1,29,1,7,0.143,1,5,0.2,0,2,0,0,0,,2,3,5
19199,Rodney McGruder,25-098,G,11/4/16,MIA,@,TOR,L,0,6,1,2,0.5,1,1,1,0,1,0,0,0,,1,1,2
19200,Rodney McGruder,25-222,G,3/8/17,MIA,,CHO,W,1,14,1,3,0.333,1,1,1,0,2,0,0,0,,0,1,1
19201,Ben McLemore,23-281,G,11/18/16,SAC,,LAC,L,0,3,0,0,,0,0,,0,0,,2,2,1,0,0,0
19202,Ben McLemore,23-355,G,1/31/17,SAC,@,HOU,L,0,12,1,3,0.333,1,1,1,0,2,0,0,0,,0,1,1
19203,Ben McLemore,23-274,G,11/11/16,SAC,@,POR,L,0,18,0,2,0,0,1,0,0,1,0,2,2,1,0,0,0
19204,Ben McLemore,24-023,G,3/6/17,SAC,@,DEN,L,0,13,1,2,0.5,1,1,1,0,1,0,0,0,,0,2,2
19205,Ben McLemore,23-361,G,2/6/17,SAC,,CHI,L,1,16,1,6,0.167,1,4,0.25,0,2,0,0,0,,0,1,1
19206,Jordan McRae,25-211,G,10/25/16,CLE,,NYK,W,0,6,1,4,0.25,1,4,0.25,0,0,,0,0,,0,0,0
19207,Jordan McRae,25-240,G,11/23/16,CLE,,POR,W,0,15,1,9,0.111,1,7,0.143,0,2,0,0,0,,1,2,3
19208,Jordan McRae,25-260,G,12/13/16,CLE,,MEM,W,0,3,1,1,1,1,1,1,0,0,,0,0,,0,1,1
19209,Jordan McRae,25-230,G,11/13/16,CLE,,CHO,W,0,14,1,4,0.25,1,2,0.5,0,2,0,0,0,,0,2,2
19210,Jordan McRae,25-256,G,12/9/16,CLE,,MIA,W,0,6,1,3,0.333,1,2,0.5,0,1,0,0,0,,0,0,0
19211,Josh McRoberts,29-269,F,11/23/16,MIA,@,DET,L,0,16,1,5,0.2,1,3,0.333,0,2,0,0,0,,0,7,7
19212,Josh McRoberts,29-283,F,12/7/16,MIA,@,ATL,L,1,30,1,5,0.2,1,4,0.25,0,1,0,0,0,,1,1,2
19213,Josh McRoberts,29-267,F,11/21/16,MIA,@,PHI,L,0,12,1,4,0.25,1,3,0.333,0,1,0,0,0,,3,1,4
19214,Josh McRoberts,29-274,F,11/28/16,MIA,,BOS,L,0,7,1,2,0.5,1,2,0.5,0,0,,0,0,,1,1,2
19215,Josh McRoberts,29-272,F,11/26/16,MIA,,MEM,L,0,13,1,1,1,1,1,1,0,0,,0,0,,0,2,2
19216,Jodie Meeks,29-119,G,12/18/16,ORL,,TOR,L,0,24,1,6,0.167,1,4,0.25,0,2,0,0,0,,0,0,0
19217,Salah Mejri,30-236,C,2/6/17,DAL,@,DEN,L,0,7,1,1,1,1,1,1,0,0,,0,0,,0,1,1
19218,Salah Mejri,30-271,C,3/13/17,DAL,@,TOR,L,0,7,1,1,1,1,1,1,0,0,,0,0,,1,0,1
19219,Salah Mejri,30-269,C,3/11/17,DAL,,PHO,L,0,16,0,2,0,0,2,0,0,0,,2,2,1,1,6,7
19220,Salah Mejri,30-243,C,2/13/17,DAL,,BOS,L,0,14,1,2,0.5,1,2,0.5,0,0,,0,0,,3,7,10
19221,Salah Mejri,30-135,C,10/28/16,DAL,,HOU,L,0,1,1,1,1,1,1,1,0,0,,0,0,,0,0,0
19222,Salah Mejri,30-175,C,12/7/16,DAL,,SAC,L,1,11,1,3,0.333,1,3,0.333,0,0,,0,0,,3,4,7
19223,Salah Mejri,30-189,C,12/21/16,DAL,@,POR,W,1,24,1,1,1,1,1,1,0,0,,0,0,,1,5,6
19224,Salah Mejri,30-208,C,1/9/17,DAL,@,MIN,L,0,10,1,2,0.5,1,2,0.5,0,0,,0,0,,0,3,3
19225,Salah Mejri,30-263,C,3/5/17,DAL,,OKC,W,0,10,1,2,0.5,1,2,0.5,0,0,,0,0,,0,2,2
19226,Salah Mejri,30-187,C,12/19/16,DAL,@,DEN,L,1,13,1,1,1,1,1,1,0,0,,0,1,0,0,2,2
19227,Salah Mejri,30-152,C,11/14/16,DAL,@,NYK,L,0,11,0,0,,0,0,,0,0,,2,2,1,0,0,0
19228,Salah Mejri,30-221,C,1/22/17,DAL,,LAL,W,0,15,0,1,0,0,1,0,0,0,,2,2,1,1,4,5
19229,Jordan Mickey,22-125,F,11/11/16,BOS,,NYK,W,0,3,1,2,0.5,1,2,0.5,0,0,,0,0,,2,1,3
19230,Jordan Mickey,22-123,F,11/9/16,BOS,@,WAS,L,0,8,1,2,0.5,1,2,0.5,0,0,,0,0,,1,1,2
19231,Jordan Mickey,22-196,F,1/21/17,BOS,,POR,L,0,13,1,3,0.333,1,3,0.333,0,0,,0,0,,2,1,3
19232,Jordan Mickey,22-117,F,11/3/16,BOS,@,CLE,L,0,10,1,2,0.5,1,2,0.5,0,0,,0,0,,0,1,1
19233,Jordan Mickey,22-193,F,1/18/17,BOS,,NYK,L,0,6,0,1,0,0,1,0,0,0,,2,2,1,0,0,0
19234,Jordan Mickey,22-233,F,2/27/17,BOS,,ATL,L,0,3,1,2,0.5,1,2,0.5,0,0,,0,0,,0,0,0
19235,C.J. Miles,29-233,G-F,12/7/16,IND,@,PHO,W,0,16,1,7,0.143,1,2,0.5,0,5,0,0,0,,0,3,3
19236,Mike Miller,36-337,F-G,1/21/17,DEN,,LAC,W,0,5,0,0,,0,0,,0,0,,2,2,1,1,2,3
19237,Patty Mills,28-183,G,2/10/17,SAS,@,DET,W,0,16,1,3,0.333,1,2,0.5,0,1,0,0,0,,0,1,1
19238,Patty Mills,28-202,G,3/1/17,SAS,,IND,W,0,27,1,7,0.143,1,3,0.333,0,4,0,0,0,,0,2,2
19239,Patty Mills,28-136,G,12/25/16,SAS,,CHI,W,0,17,1,3,0.333,1,3,0.333,0,0,,0,0,,0,0,0
19240,Nikola Mirotic,25-272,F,11/9/16,CHI,@,ATL,L,0,11,0,3,0,0,0,,0,3,0,2,2,1,0,1,1
19241,Nikola Mirotic,25-282,F,11/19/16,CHI,@,LAC,L,0,16,1,7,0.143,1,2,0.5,0,5,0,0,0,,0,1,1
19242,Nikola Mirotic,25-295,F,12/2/16,CHI,,CLE,W,0,22,1,9,0.111,1,4,0.25,0,5,0,0,0,,2,7,9
19243,Greg Monroe,26-170,C-F,11/21/16,MIL,,ORL,W,0,8,1,4,0.25,1,4,0.25,0,0,,0,0,,0,2,2
19244,Greg Monroe,26-168,C-F,11/19/16,MIL,,GSW,L,0,2,1,2,0.5,1,2,0.5,0,0,,0,0,,0,0,0
19245,Greg Monroe,26-228,C-F,1/18/17,MIL,@,HOU,L,0,18,1,4,0.25,1,4,0.25,0,0,,0,0,,2,2,4
19246,Greg Monroe,26-180,C-F,12/1/16,MIL,@,BRK,W,0,20,1,4,0.25,1,4,0.25,0,0,,0,0,,3,3,6
19247,E'Twaun Moore,27-342,G,2/4/17,NOP,@,WAS,L,0,25,1,2,0.5,1,2,0.5,0,0,,0,2,0,0,1,1
19248,E'Twaun Moore,27-265,G,11/19/16,NOP,,CHO,W,1,18,1,7,0.143,1,6,0.167,0,1,0,0,0,,1,3,4
19249,E'Twaun Moore,28-011,G,3/11/17,NOP,@,CHO,W,0,25,1,7,0.143,1,3,0.333,0,4,0,0,0,,0,0,0
19250,E'Twaun Moore,27-275,G,11/29/16,NOP,,LAL,W,0,17,1,7,0.143,1,4,0.25,0,3,0,0,0,,0,2,2
19251,Marcus Morris,27-105,F,12/16/16,DET,@,WAS,L,1,24,1,8,0.125,1,5,0.2,0,3,0,0,0,,0,3,3
19252,Marcus Morris,27-112,F,12/23/16,DET,,GSW,L,1,20,1,7,0.143,1,4,0.25,0,3,0,0,0,,0,3,3
19253,Anthony Morrow,31-087,G,12/23/16,OKC,@,BOS,W,1,12,1,5,0.2,1,2,0.5,0,3,0,0,0,,0,0,0
19254,Anthony Morrow,31-068,G,12/4/16,OKC,,NOP,W,0,25,1,7,0.143,1,2,0.5,0,5,0,0,0,,1,2,3
19255,Anthony Morrow,31-043,G,11/9/16,OKC,,TOR,L,0,9,1,3,0.333,1,1,1,0,2,0,0,0,,0,1,1
19256,Anthony Morrow,31-093,G,12/29/16,OKC,@,MEM,L,1,19,1,3,0.333,1,2,0.5,0,1,0,0,0,,0,0,0
19257,Anthony Morrow,31-036,G,11/2/16,OKC,@,LAC,W,0,10,1,3,0.333,1,3,0.333,0,0,,0,0,,0,0,0
19258,Anthony Morrow,31-056,G,11/22/16,OKC,@,LAL,L,0,9,1,2,0.5,1,1,1,0,1,0,0,0,,0,0,0
19259,Anthony Morrow,31-089,G,12/25/16,OKC,,MIN,W,1,12,1,4,0.25,1,1,1,0,3,0,0,0,,0,1,1
19260,Donatas Motiejunas,26-120,F-C,1/18/17,NOP,,ORL,W,0,3,0,0,,0,0,,0,0,,2,3,0.667,0,1,1
19261,Donatas Motiejunas,26-116,F-C,1/14/17,NOP,@,CHI,L,0,7,1,2,0.5,1,2,0.5,0,0,,0,0,,1,1,2
19262,Donatas Motiejunas,26-143,F-C,2/10/17,NOP,@,MIN,W,0,19,1,3,0.333,1,2,0.5,0,1,0,0,0,,3,1,4
19263,Timofey Mozgov,30-154,C,12/17/16,LAL,@,CLE,L,1,15,1,6,0.167,1,6,0.167,0,0,,0,0,,1,3,4
19264,Timofey Mozgov,30-139,C,12/2/16,LAL,@,TOR,L,1,18,1,6,0.167,1,6,0.167,0,0,,0,0,,2,2,4
19265,Timofey Mozgov,30-137,C,11/30/16,LAL,@,CHI,W,1,17,1,4,0.25,1,4,0.25,0,0,,0,0,,1,1,2
19266,Emmanuel Mudiay,20-335,G,2/3/17,DEN,,MIL,W,0,18,1,5,0.2,1,4,0.25,0,1,0,0,0,,1,2,3
19267,Emmanuel Mudiay,20-356,G,2/24/17,DEN,,BRK,W,0,5,0,1,0,0,1,0,0,0,,2,2,1,0,0,0
19268,Shabazz Muhammad,24-023,F-G,12/6/16,MIN,,SAS,L,0,20,1,6,0.167,1,5,0.2,0,1,0,0,0,,1,2,3
19269,Shabazz Muhammad,24-008,F-G,11/21/16,MIN,,BOS,L,0,16,1,4,0.25,1,2,0.5,0,2,0,0,0,,0,2,2
19270,Shabazz Muhammad,23-348,F-G,10/26/16,MIN,@,MEM,L,0,14,1,6,0.167,1,5,0.2,0,1,0,0,0,,1,1,2
19271,Shabazz Muhammad,24-120,F-G,3/13/17,MIN,,WAS,W,0,15,1,6,0.167,1,5,0.2,0,1,0,0,0,,0,2,2
19272,Dejounte Murray,20-106,G,1/3/17,SAS,,TOR,W,0,8,1,3,0.333,1,2,0.5,0,1,0,0,0,,1,1,2
19273,Dejounte Murray,20-102,G,12/30/16,SAS,,POR,W,0,6,1,4,0.25,1,3,0.333,0,1,0,0,0,,0,0,0
19274,Dejounte Murray,20-149,G,2/15/17,SAS,@,ORL,W,0,6,1,2,0.5,1,2,0.5,0,0,,0,0,,1,3,4
19275,Dejounte Murray,20-046,G,11/4/16,SAS,@,UTA,W,0,3,0,2,0,0,2,0,0,0,,2,2,1,0,0,0
19276,Dejounte Murray,20-071,G,11/29/16,SAS,,ORL,L,0,4,0,1,0,0,0,,0,1,0,2,2,1,0,1,1
19277,Dejounte Murray,20-166,G,3/4/17,SAS,,MIN,W,0,4,1,1,1,1,1,1,0,0,,0,0,,0,1,1
19278,Dejounte Murray,20-108,G,1/5/17,SAS,@,DEN,W,0,6,1,3,0.333,1,3,0.333,0,0,,0,0,,0,0,0
19279,Jamal Murray,19-283,G,12/2/16,DEN,,HOU,L,0,17,1,7,0.143,1,2,0.5,0,5,0,0,0,,1,2,3
19280,Jamal Murray,19-315,G,1/3/17,DEN,,SAC,L,0,14,1,5,0.2,1,2,0.5,0,3,0,0,0,,0,0,0
19281,Jamal Murray,19-291,G,12/10/16,DEN,@,ORL,W,0,22,1,6,0.167,1,3,0.333,0,3,0,0,0,,0,1,1
19282,Jamal Murray,19-307,G,12/26/16,DEN,@,LAC,W,0,12,1,3,0.333,1,2,0.5,0,1,0,0,0,,0,1,1
19283,Jamal Murray,19-304,G,12/23/16,DEN,,ATL,L,0,17,1,3,0.333,1,1,1,0,2,0,0,0,,0,1,1
19284,Jamal Murray,19-353,G,2/10/17,DEN,@,NYK,W,0,15,1,4,0.25,1,3,0.333,0,1,0,0,0,,1,2,3
19285,Mike Muscala,25-220,F-C,2/6/17,ATL,,UTA,L,0,21,1,3,0.333,1,2,0.5,0,1,0,0,0,,0,1,1
19286,Mike Muscala,25-169,F-C,12/17/16,ATL,,CHO,L,0,13,1,4,0.25,1,3,0.333,0,1,0,0,0,,1,0,1
19287,Mike Muscala,25-184,F-C,1/1/17,ATL,,SAS,W,0,19,1,4,0.25,1,3,0.333,0,1,0,0,0,,0,1,1
19288,Mike Muscala,25-212,F-C,1/29/17,ATL,,NYK,W,0,22,1,3,0.333,1,2,0.5,0,1,0,0,0,,1,7,8
19289,Mike Muscala,25-260,F-C,3/18/17,ATL,,POR,L,0,8,1,3,0.333,1,3,0.333,0,0,,0,0,,2,1,3
19290,Mike Muscala,25-147,F-C,11/25/16,ATL,@,UTA,L,0,17,1,6,0.167,1,5,0.2,0,1,0,0,1,0,0,2,2
19291,Mike Muscala,25-180,F-C,12/28/16,ATL,,NYK,W,0,14,1,4,0.25,1,3,0.333,0,1,0,0,0,,3,2,5
19292,Larry Nance Jr.,23-303,F,10/30/16,LAL,@,OKC,L,0,12,1,2,0.5,1,2,0.5,0,0,,0,0,,1,1,2
19293,Larry Nance Jr.,23-351,F,12/17/16,LAL,@,CLE,L,0,27,1,3,0.333,1,3,0.333,0,0,,0,0,,1,4,5
19294,Larry Nance Jr.,24-058,F,2/28/17,LAL,,CHO,L,0,21,0,0,,0,0,,0,0,,2,2,1,0,3,3
19295,Larry Nance Jr.,24-056,F,2/26/17,LAL,,SAS,L,0,13,1,5,0.2,1,5,0.2,0,0,,0,0,,0,2,2
19296,Larry Nance Jr.,24-071,F,3/13/17,LAL,@,DEN,L,0,23,1,8,0.125,1,7,0.143,0,1,0,0,0,,3,5,8
19297,Larry Nance Jr.,23-314,F,11/10/16,LAL,@,SAC,W,0,22,1,2,0.5,1,1,1,0,1,0,0,0,,0,7,7
19298,Larry Nance Jr.,24-030,F,1/31/17,LAL,,DEN,W,0,18,1,3,0.333,1,3,0.333,0,0,,0,0,,0,0,0
19299,Larry Nance Jr.,23-310,F,11/6/16,LAL,,PHO,W,0,3,0,0,,0,0,,0,0,,2,2,1,1,0,1
19300,Larry Nance Jr.,24-045,F,2/15/17,LAL,@,PHO,L,0,22,1,4,0.25,1,4,0.25,0,0,,0,0,,0,3,3
19301,Larry Nance Jr.,23-303,F,10/30/16,LAL,@,OKC,L,0,12,1,2,0.5,1,2,0.5,0,0,,0,0,,1,1,2
19302,Larry Nance Jr.,24-058,F,2/28/17,LAL,,CHO,L,0,21,0,0,,0,0,,0,0,,2,2,1,0,3,3
19303,Shabazz Napier,25-231,G,3/2/17,POR,,OKC,W,0,6,1,1,1,1,1,1,0,0,,0,1,0,0,0,0
19304,Shabazz Napier,25-180,G,1/10/17,POR,@,LAL,W,0,3,1,1,1,1,1,1,0,0,,0,0,,0,1,1
19305,Shabazz Napier,25-241,G,3/12/17,POR,@,PHO,W,0,12,1,3,0.333,1,3,0.333,0,0,,0,0,,1,0,1
19306,Shabazz Napier,25-152,G,12/13/16,POR,,OKC,W,0,7,0,0,,0,0,,0,0,,2,2,1,0,1,1
19307,Shabazz Napier,25-238,G,3/9/17,POR,,PHI,W,0,16,0,0,,0,0,,0,0,,2,2,1,1,0,1
19308,Shabazz Napier,25-236,G,3/7/17,POR,@,OKC,W,0,13,1,1,1,1,1,1,0,0,,0,0,,0,2,2
19309,Maurice Ndour,24-157,F,11/22/16,NYK,,POR,W,0,3,0,1,0,0,1,0,0,0,,2,2,1,0,0,0
19310,Maurice Ndour,24-198,F,1/2/17,NYK,,ORL,L,0,2,1,1,1,1,1,1,0,0,,0,0,,0,0,0
19311,Maurice Ndour,24-149,F,11/14/16,NYK,,DAL,W,0,13,1,3,0.333,1,2,0.5,0,1,0,0,0,,1,2,3
19312,Maurice Ndour,24-182,F,12/17/16,NYK,@,DEN,L,0,2,0,0,,0,0,,0,0,,2,2,1,1,1,2
19313,Maurice Ndour,24-211,F,1/15/17,NYK,@,TOR,L,0,7,1,3,0.333,1,3,0.333,0,0,,0,0,,0,1,1
19314,Jameer Nelson,34-343,G,1/17/17,DEN,@,LAL,W,0,20,1,2,0.5,1,1,1,0,1,0,0,0,,1,0,1
19315,Jameer Nelson,34-285,G,11/20/16,DEN,,UTA,W,0,21,1,2,0.5,1,2,0.5,0,0,,0,0,,0,3,3
19316,Jameer Nelson,34-363,G,2/6/17,DEN,,DAL,W,1,33,1,6,0.167,1,1,1,0,5,0,0,0,,1,3,4
19317,Jameer Nelson,34-307,G,12/12/16,DEN,@,DAL,L,0,17,1,8,0.125,1,4,0.25,0,4,0,0,0,,1,0,1
19318,Raul Neto,24-228,G,1/2/17,UTA,@,BRK,W,0,13,1,1,1,1,1,1,0,0,,0,0,,0,1,1
19319,Raul Neto,24-291,G,3/6/17,UTA,,NOP,W,0,14,1,3,0.333,1,2,0.5,0,1,0,0,0,,0,0,0
19320,Raul Neto,24-190,G,11/25/16,UTA,,ATL,W,0,3,1,1,1,1,1,1,0,0,,0,0,,0,0,0
19321,Raul Neto,24-188,G,11/23/16,UTA,,DEN,W,0,2,1,1,1,1,1,1,0,0,,0,0,,0,0,0
19322,Raul Neto,24-270,G,2/13/17,UTA,,LAC,L,0,6,1,1,1,1,1,1,0,0,,0,0,,0,0,0
19323,Georges Niang,23-243,F,2/15/17,IND,@,CLE,L,0,3,1,2,0.5,1,1,1,0,1,0,0,0,,0,1,1
19324,Georges Niang,23-232,F,2/4/17,IND,,DET,W,0,2,1,1,1,1,1,1,0,0,,0,0,,0,1,1
19325,Georges Niang,23-226,F,1/29/17,IND,,HOU,W,0,3,1,1,1,1,1,1,0,0,,0,0,,0,0,0
19326,Georges Niang,23-217,F,1/20/17,IND,@,LAL,L,0,2,1,3,0.333,1,2,0.5,0,1,0,0,0,,0,0,0
19327,Georges Niang,23-209,F,1/12/17,IND,@,DEN,L,0,3,1,1,1,1,1,1,0,0,,0,0,,0,0,0
19328,Georges Niang,23-154,F,11/18/16,IND,,PHO,L,0,17,0,2,0,0,2,0,0,0,,2,2,1,0,2,2
19329,Andrew Nicholson,26-345,F,11/17/16,WAS,,NYK,W,0,6,1,2,0.5,1,2,0.5,0,0,,0,0,,0,0,0
19330,Andrew Nicholson,27-002,F,12/10/16,WAS,,MIL,W,0,9,1,3,0.333,1,3,0.333,0,0,,0,0,,0,1,1
19331,Andrew Nicholson,27-029,F,1/6/17,WAS,,MIN,W,0,5,1,2,0.5,1,1,1,0,1,0,0,0,,0,1,1
19332,Andrew Nicholson,27-096,F,3/14/17,BRK,,OKC,L,0,2,1,2,0.5,1,1,1,0,1,0,0,0,,0,1,1
19333,Andrew Nicholson,26-344,F,11/16/16,WAS,@,PHI,L,0,13,1,1,1,1,1,1,0,0,,0,0,,0,0,0
19334,Andrew Nicholson,26-364,F,12/6/16,WAS,,ORL,L,0,8,1,1,1,1,1,1,0,0,,0,0,,0,1,1
19335,Andrew Nicholson,27-020,F,12/28/16,WAS,,IND,W,0,7,1,3,0.333,1,2,0.5,0,1,0,0,0,,2,0,2
19336,Andrew Nicholson,26-356,F,11/28/16,WAS,,SAC,W,0,3,0,0,,0,0,,0,0,,2,2,1,0,1,1
19337,Andrew Nicholson,26-354,F,11/26/16,WAS,,SAS,L,0,7,1,4,0.25,1,2,0.5,0,2,0,0,0,,0,1,1
19338,Joakim Noah,31-283,C,12/4/16,NYK,,SAC,W,1,25,1,4,0.25,1,4,0.25,0,0,,0,4,0,2,3,5
19339,Joakim Noah,31-333,C,1/23/17,NYK,@,IND,W,1,12,1,1,1,1,1,1,0,0,,0,2,0,1,5,6
19340,Joakim Noah,31-258,C,11/9/16,NYK,,BRK,W,1,21,1,2,0.5,1,2,0.5,0,0,,0,0,,2,5,7
19341,Joakim Noah,31-277,C,11/28/16,NYK,,OKC,L,1,26,1,2,0.5,1,2,0.5,0,0,,0,2,0,3,0,3
19342,Joakim Noah,31-296,C,12/17/16,NYK,@,DEN,L,1,11,1,3,0.333,1,3,0.333,0,0,,0,0,,1,3,4
19343,Joakim Noah,31-266,C,11/17/16,NYK,@,WAS,L,1,19,1,3,0.333,1,3,0.333,0,0,,0,0,,3,5,8
19344,Joakim Noah,31-250,C,11/1/16,NYK,@,DET,L,1,31,1,4,0.25,1,4,0.25,0,0,,0,0,,5,7,12
19345,Nerlens Noel,22-250,C-F,12/16/16,PHI,,LAL,L,0,8,1,4,0.25,1,4,0.25,0,0,,0,0,,2,3,5
19346,Lucas Nogueira,24-197,C,2/8/17,TOR,@,MIN,L,0,21,1,1,1,1,1,1,0,0,,0,0,,0,1,1
19347,Steve Novak,33-201,F,12/31/16,MIL,@,CHI,W,0,2,1,1,1,1,1,1,0,0,,0,0,,0,0,0
19348,Jusuf Nurkic,22-203,C,3/14/17,POR,@,NOP,L,1,22,1,8,0.125,1,8,0.125,0,0,,0,0,,4,4,8
19349,Jusuf Nurkic,22-092,C,11/23/16,DEN,@,UTA,L,1,15,1,8,0.125,1,8,0.125,0,0,,0,3,0,2,4,6
19350,Jusuf Nurkic,22-154,C,1/24/17,DEN,,UTA,W,0,8,1,3,0.333,1,3,0.333,0,0,,0,2,0,1,1,2
19351,Jusuf Nurkic,22-129,C,12/30/16,DEN,,PHI,L,0,19,1,6,0.167,1,6,0.167,0,0,,0,0,,2,2,4
19352,Jusuf Nurkic,22-171,C,2/10/17,DEN,@,NYK,W,0,11,1,4,0.25,1,4,0.25,0,0,,0,0,,2,1,3
19353,Jusuf Nurkic,22-146,C,1/16/17,DEN,,ORL,W,0,6,1,2,0.5,1,2,0.5,0,0,,0,0,,1,0,1
19354,Jusuf Nurkic,22-114,C,12/15/16,DEN,,POR,W,0,5,1,2,0.5,1,2,0.5,0,0,,0,0,,1,3,4
19355,David Nwaba,24-052,PG,3/7/17,LAL,@,DAL,L,0,8,1,3,0.333,1,3,0.333,0,0,,0,2,0,0,1,1
19356,David Nwaba,24-066,PG,3/21/17,LAL,,LAC,L,0,14,1,3,0.333,1,3,0.333,0,0,,0,0,,1,2,3
19357,David Nwaba,24-058,PG,3/13/17,LAL,@,DEN,L,1,19,1,2,0.5,1,2,0.5,0,0,,0,0,,0,2,2
19358,Johnny O'Bryant,23-245,F-C,2/1/17,DEN,,MEM,L,0,7,0,4,0,0,3,0,0,1,0,2,2,1,0,1,1
19359,Johnny O'Bryant,23-274,F-C,3/2/17,CHO,@,PHO,L,0,2,1,1,1,1,1,1,0,0,,0,0,,0,0,0
19360,Johnny O'Bryant,23-250,F-C,2/6/17,DEN,,DAL,W,0,2,1,1,1,1,1,1,0,0,,0,0,,0,0,0
19361,Kyle O'Quinn,26-344,F-C,3/5/17,NYK,,GSW,L,0,11,1,1,1,1,1,1,0,0,,0,0,,1,3,4
19362,Kyle O'Quinn,26-236,F-C,11/17/16,NYK,@,WAS,L,0,7,1,1,1,1,1,1,0,0,,0,0,,0,0,0
19363,Kyle O'Quinn,26-289,F-C,1/9/17,NYK,,NOP,L,0,13,1,2,0.5,1,2,0.5,0,0,,0,0,,2,0,2
19364,Kyle O'Quinn,26-233,F-C,11/14/16,NYK,,DAL,W,0,3,1,3,0.333,1,3,0.333,0,0,,0,0,,2,0,2
19365,Kyle O'Quinn,26-249,F-C,11/30/16,NYK,@,MIN,W,1,18,1,2,0.5,1,2,0.5,0,0,,0,1,0,2,6,8
19366,Kyle O'Quinn,26-351,F-C,3/12/17,NYK,@,BRK,L,0,6,1,1,1,1,1,1,0,0,,0,0,,0,0,0
19367,Kyle O'Quinn,26-298,F-C,1/18/17,NYK,@,BOS,W,1,10,1,3,0.333,1,3,0.333,0,0,,0,0,,1,0,1
19368,Kyle O'Quinn,26-213,F-C,10/25/16,NYK,@,CLE,L,0,15,1,3,0.333,1,1,1,0,2,0,0,0,,1,4,5
19369,Kyle O'Quinn,26-230,F-C,11/11/16,NYK,@,BOS,L,0,3,1,3,0.333,1,3,0.333,0,0,,0,0,,1,2,3
19370,Kyle O'Quinn,26-350,F-C,3/11/17,NYK,@,DET,L,0,19,1,3,0.333,1,3,0.333,0,0,,0,0,,2,6,8
19371,Kyle O'Quinn,26-245,F-C,11/26/16,NYK,@,CHO,L,0,16,1,2,0.5,1,2,0.5,0,0,,0,0,,1,4,5
19372,Kyle O'Quinn,26-326,F-C,2/15/17,NYK,@,OKC,L,0,11,1,3,0.333,1,3,0.333,0,0,,0,0,,1,3,4
19373,Kyle O'Quinn,26-279,F-C,12/30/16,NYK,@,NOP,L,0,5,1,3,0.333,1,3,0.333,0,0,,0,0,,1,1,2
19374,Kyle O'Quinn,26-309,F-C,1/29/17,NYK,@,ATL,L,0,26,1,9,0.111,1,9,0.111,0,0,,0,0,,2,10,12
19375,Daniel Ochefu,23-040,C,1/24/17,WAS,,BOS,W,0,1,1,1,1,1,1,1,0,0,,0,0,,1,0,1
19376,Daniel Ochefu,22-330,C,11/9/16,WAS,,BOS,W,0,3,1,1,1,1,1,1,0,0,,0,0,,0,2,2
19377,Daniel Ochefu,23-030,C,1/14/17,WAS,,PHI,W,0,3,1,1,1,1,1,1,0,0,,0,0,,0,0,0
19378,Daniel Ochefu,23-015,C,12/30/16,WAS,,BRK,W,0,2,1,2,0.5,1,2,0.5,0,0,,0,0,,0,3,3
19379,Jahlil Okafor,20-344,C-F,11/23/16,PHI,,MEM,L,0,26,1,6,0.167,1,6,0.167,0,0,,0,1,0,1,0,1
19380,Jahlil Okafor,21-019,C-F,1/3/17,PHI,,MIN,W,0,10,1,3,0.333,1,3,0.333,0,0,,0,2,0,2,2,4
19381,Kelly Olynyk,25-314,C-F,2/27/17,BOS,,ATL,L,0,11,1,3,0.333,1,2,0.5,0,1,0,0,0,,1,2,3
19382,Kelly Olynyk,25-227,C-F,12/2/16,BOS,,SAC,W,0,17,1,3,0.333,1,2,0.5,0,1,0,0,0,,1,4,5
19383,Kelly Olynyk,25-254,C-F,12/29/16,BOS,@,CLE,L,0,13,1,3,0.333,1,2,0.5,0,1,0,0,0,,1,0,1
19384,Kelly Olynyk,25-204,C-F,11/9/16,BOS,@,WAS,L,0,26,1,6,0.167,1,3,0.333,0,3,0,0,0,,0,6,6
19385,Arinze Onuaku,29-173,C,1/2/17,ORL,@,NYK,W,0,2,1,1,1,1,1,1,0,0,,0,0,,1,0,1
19386,Arinze Onuaku,29-139,C,11/29/16,ORL,@,SAS,W,0,2,1,1,1,1,1,1,0,0,,0,0,,0,0,0
19387,Kelly Oubre,20-346,F,11/19/16,WAS,,MIA,L,0,15,1,6,0.167,1,4,0.25,0,2,0,0,0,,2,1,3
19388,Kelly Oubre,21-084,F,3/3/17,WAS,,TOR,L,0,12,1,4,0.25,1,3,0.333,0,1,0,0,0,,0,2,2
19389,Kelly Oubre,20-343,F,11/16/16,WAS,@,PHI,L,0,4,1,2,0.5,1,2,0.5,0,0,,0,0,,0,0,0
19390,Kelly Oubre,21-091,F,3/10/17,WAS,@,SAC,W,0,5,1,2,0.5,1,1,1,0,1,0,0,0,,0,0,0
19391,Kelly Oubre,21-051,F,1/29/17,WAS,@,NOP,W,0,24,1,4,0.25,1,3,0.333,0,1,0,0,0,,2,5,7
19392,Kelly Oubre,21-089,F,3/8/17,WAS,@,DEN,W,0,20,1,4,0.25,1,2,0.5,0,2,0,0,0,,0,5,5
19393,Kelly Oubre,21-019,F,12/28/16,WAS,,IND,W,0,21,1,3,0.333,1,2,0.5,0,1,0,0,0,,0,2,2
19394,Kelly Oubre,21-088,F,3/7/17,WAS,@,PHO,W,0,7,0,2,0,0,2,0,0,0,,2,2,1,0,0,0
19395,Zaza Pachulia,32-273,C,11/9/16,GSW,,DAL,W,1,13,1,2,0.5,1,2,0.5,0,0,,0,0,,0,4,4
19396,Zaza Pachulia,32-289,C,11/25/16,GSW,@,LAL,W,1,21,1,5,0.2,1,5,0.2,0,0,,0,0,,0,6,6
19397,Zaza Pachulia,33-032,C,3/14/17,GSW,,PHI,W,1,12,0,5,0,0,5,0,0,0,,2,2,1,1,4,5
19398,Zaza Pachulia,32-271,C,11/7/16,GSW,,NOP,W,1,11,1,2,0.5,1,2,0.5,0,0,,0,0,,0,1,1
19399,Zaza Pachulia,32-302,C,12/8/16,GSW,@,UTA,W,1,22,1,3,0.333,1,3,0.333,0,0,,0,2,0,2,2,4
19400,Zaza Pachulia,32-324,C,12/30/16,GSW,,DAL,W,1,18,1,6,0.167,1,6,0.167,0,0,,0,0,,1,4,5
19401,Zaza Pachulia,33-032,C,3/14/17,GSW,,PHI,W,1,12,0,5,0,0,5,0,0,0,,2,2,1,1,4,5
19402,Zaza Pachulia,32-271,C,11/7/16,GSW,,NOP,W,1,11,1,2,0.5,1,2,0.5,0,0,,0,0,,0,1,1
19403,Zaza Pachulia,32-302,C,12/8/16,GSW,@,UTA,W,1,22,1,3,0.333,1,3,0.333,0,0,,0,2,0,2,2,4
19404,Zaza Pachulia,32-324,C,12/30/16,GSW,,DAL,W,1,18,1,6,0.167,1,6,0.167,0,0,,0,0,,1,4,5
19405,Zaza Pachulia,33-026,C,3/8/17,GSW,,BOS,L,1,19,1,5,0.2,1,5,0.2,0,0,,0,0,,2,4,6
19406,Zaza Pachulia,32-295,C,12/1/16,GSW,,HOU,L,1,8,0,1,0,0,1,0,0,0,,2,2,1,3,0,3
19407,Georgios Papagiannis,19-251,C,3/11/17,SAC,,DEN,L,0,2,1,1,1,1,1,1,0,0,,0,0,,0,1,1
19408,Georgios Papagiannis,19-125,C,11/5/16,SAC,@,MIL,L,0,6,1,1,1,1,1,1,0,0,,0,0,,0,1,1
19409,Georgios Papagiannis,19-253,C,3/13/17,SAC,,ORL,W,0,12,1,3,0.333,1,3,0.333,0,0,,0,0,,1,3,4
19410,Tony Parker,34-295,G,3/8/17,SAS,,SAC,W,1,16,1,1,1,1,1,1,0,0,,0,0,,0,1,1
19411,Tony Parker,34-269,G,2/10/17,SAS,@,DET,W,1,31,1,4,0.25,1,3,0.333,0,1,0,0,0,,0,1,1
19412,Tony Parker,34-196,G,11/29/16,SAS,,ORL,L,1,29,0,6,0,0,6,0,0,0,,2,2,1,0,2,2
19413,Tony Parker,34-219,G,12/22/16,SAS,@,LAC,L,1,28,1,8,0.125,1,6,0.167,0,2,0,0,0,,0,2,2
19414,Tony Parker,34-235,G,1/7/17,SAS,,CHO,W,1,25,1,8,0.125,1,6,0.167,0,2,0,0,0,,0,4,4
19415,Tony Parker,34-308,G,3/21/17,SAS,@,MIN,W,1,27,0,6,0,0,5,0,0,1,0,2,2,1,0,0,0
19416,Chandler Parsons,28-097,F,1/30/17,MEM,@,PHO,W,1,21,0,3,0,0,3,0,0,0,,2,2,1,0,2,2
19417,Chandler Parsons,28-070,F,1/3/17,MEM,@,LAL,L,1,15,1,6,0.167,1,4,0.25,0,2,0,0,0,,0,2,2
19418,Chandler Parsons,28-065,F,12/29/16,MEM,,OKC,W,1,15,1,3,0.333,1,2,0.5,0,1,0,0,0,,0,0,0
19419,Chandler Parsons,28-111,F,2/13/17,MEM,@,BRK,W,1,25,1,4,0.25,1,3,0.333,0,1,0,0,0,,0,7,7
19420,Chandler Parsons,28-130,F,3/4/17,MEM,@,HOU,L,1,20,1,5,0.2,1,2,0.5,0,3,0,0,2,0,2,5,7
19421,Chandler Parsons,28-057,F,12/21/16,MEM,@,DET,W,1,15,1,5,0.2,1,4,0.25,0,1,0,0,0,,0,2,2
19422,Lamar Patterson,25-178,G-F,2/6/17,ATL,,UTA,L,0,4,0,3,0,0,2,0,0,1,0,2,2,1,0,0,0
19423,Patrick Patterson,27-246,F,11/15/16,TOR,@,CLE,L,0,34,1,6,0.167,1,3,0.333,0,3,0,0,0,,2,4,6
19424,Patrick Patterson,27-361,F,3/10/17,TOR,@,ATL,L,0,19,1,3,0.333,1,2,0.5,0,1,0,0,0,,2,1,3
19425,Adreian Payne,25-294,F-C,12/9/16,MIN,,DET,L,0,12,1,6,0.167,1,5,0.2,0,1,0,0,0,,0,0,0
19426,Cameron Payne,22-182,G,2/6/17,OKC,@,IND,L,0,13,1,4,0.25,1,3,0.333,0,1,0,0,0,,1,2,3
19427,Cameron Payne,22-208,G,3/4/17,CHI,,LAC,L,0,11,1,5,0.2,1,3,0.333,0,2,0,0,0,,0,1,1
19428,Cameron Payne,22-176,G,1/31/17,OKC,@,SAS,L,0,19,0,4,0,0,1,0,0,3,0,2,2,1,0,2,2
19429,Cameron Payne,22-156,G,1/11/17,OKC,,MEM,W,0,11,1,3,0.333,1,2,0.5,0,1,0,0,0,,0,0,0
19430,Elfrid Payton,22-284,G,12/2/16,ORL,@,PHI,W,0,24,1,2,0.5,1,1,1,0,1,0,0,2,0,0,1,1
19431,Elfrid Payton,22-314,G,1/1/17,ORL,@,IND,L,0,29,1,8,0.125,1,6,0.167,0,2,0,0,0,,1,2,3
19432,Elfrid Payton,22-263,G,11/11/16,ORL,,UTA,L,1,24,1,5,0.2,1,5,0.2,0,0,,0,0,,1,2,3
19433,Elfrid Payton,23-007,G,3/1/17,ORL,,NYK,L,1,21,1,4,0.25,1,4,0.25,0,0,,0,0,,0,4,4
19434,Paul Pierce,39-158,F-G,3/20/17,LAC,,NYK,W,0,11,1,2,0.5,1,1,1,0,1,0,0,0,,0,2,2
19435,Marshall Plumlee,24-230,C,3/1/17,NYK,@,ORL,W,0,1,0,0,,0,0,,0,0,,2,2,1,0,0,0
19436,Mason Plumlee,26-358,C-F,2/26/17,DEN,,MEM,L,0,17,1,3,0.333,1,3,0.333,0,0,,0,2,0,0,3,3
19437,Mason Plumlee,26-234,C-F,10/25/16,POR,,UTA,W,1,15,1,4,0.25,1,4,0.25,0,0,,0,0,,0,1,1
19438,Miles Plumlee,28-077,C-F,11/17/16,MIL,@,MIA,L,0,17,1,2,0.5,1,2,0.5,0,0,,0,0,,0,2,2
19439,Miles Plumlee,28-131,C-F,1/10/17,MIL,@,SAS,W,0,3,1,1,1,1,1,1,0,0,,0,0,,0,0,0
19440,Miles Plumlee,28-148,C-F,1/27/17,MIL,@,TOR,L,1,15,1,5,0.2,1,5,0.2,0,0,,0,2,0,3,1,4
19441,Miles Plumlee,28-118,C-F,12/28/16,MIL,@,DET,W,0,3,1,2,0.5,1,2,0.5,0,0,,0,0,,0,0,0
19442,Miles Plumlee,28-081,C-F,11/21/16,MIL,,ORL,W,0,10,1,3,0.333,1,3,0.333,0,0,,0,0,,3,1,4
19443,Miles Plumlee,28-113,C-F,12/23/16,MIL,,WAS,W,0,4,0,0,,0,0,,0,0,,2,2,1,0,0,0
19444,Jakob Poeltl,21-144,C,3/8/17,TOR,@,NOP,W,0,8,1,1,1,1,1,1,0,0,,0,2,0,1,1,2
19445,Jakob Poeltl,21-058,C,12/12/16,TOR,,MIL,W,0,3,1,1,1,1,1,1,0,0,,0,0,,1,0,1
19446,Jakob Poeltl,21-087,C,1/10/17,TOR,,BOS,W,0,6,1,1,1,1,1,1,0,0,,0,0,,0,0,0
19447,Jakob Poeltl,21-049,C,12/3/16,TOR,,ATL,W,0,4,1,2,0.5,1,2,0.5,0,0,,0,1,0,1,0,1
19448,Jakob Poeltl,21-137,C,3/1/17,TOR,,WAS,L,0,7,1,1,1,1,1,1,0,0,,0,0,,1,1,2
19449,Jakob Poeltl,21-011,C,10/26/16,TOR,,DET,W,0,13,1,4,0.25,1,4,0.25,0,0,,0,0,,2,0,2
19450,Jakob Poeltl,21-044,C,11/28/16,TOR,,PHI,W,0,4,0,0,,0,0,,0,0,,2,4,0.5,1,0,1
19451,Jakob Poeltl,21-123,C,2/15/17,TOR,,CHO,W,0,12,1,3,0.333,1,3,0.333,0,0,,0,0,,2,4,6
19452,Jakob Poeltl,21-094,C,1/17/17,TOR,@,BRK,W,0,15,1,1,1,1,1,1,0,0,,0,0,,0,2,2
19453,Otto Porter,23-277,F,3/7/17,WAS,@,PHO,W,1,24,1,6,0.167,1,5,0.2,0,1,0,0,0,,2,5,7
19454,Bobby Portis,21-283,F,11/19/16,CHI,@,LAC,L,0,20,1,1,1,1,1,1,0,0,,0,0,,1,2,3
19455,Bobby Portis,21-364,F,2/8/17,CHI,@,GSW,L,0,6,1,2,0.5,1,2,0.5,0,0,,0,1,0,0,1,1
19456,Bobby Portis,21-339,F,1/14/17,CHI,,NOP,W,0,15,1,3,0.333,1,3,0.333,0,0,,0,0,,1,4,5
19457,Bobby Portis,21-337,F,1/12/17,CHI,@,NYK,L,0,19,1,4,0.25,1,1,1,0,3,0,0,0,,2,1,3
19458,Bobby Portis,21-359,F,2/3/17,CHI,@,HOU,L,0,5,1,1,1,1,1,1,0,0,,0,0,,1,1,2
19459,Bobby Portis,21-262,F,10/29/16,CHI,,IND,W,0,7,1,4,0.25,1,4,0.25,0,0,,0,0,,2,0,2
19460,Bobby Portis,21-276,F,11/12/16,CHI,,WAS,W,0,6,1,4,0.25,1,4,0.25,0,0,,0,0,,1,2,3
19461,Bobby Portis,21-357,F,2/1/17,CHI,@,OKC,W,0,7,1,2,0.5,1,2,0.5,0,0,,0,0,,0,1,1
19462,Bobby Portis,21-274,F,11/10/16,CHI,@,MIA,W,0,10,1,1,1,1,1,1,0,0,,0,0,,0,3,3
19463,Dwight Powell,25-189,F-C,1/25/17,DAL,,NYK,W,0,10,1,1,1,1,1,1,0,0,,0,0,,2,1,3
19464,Dwight Powell,25-124,F-C,11/21/16,DAL,@,SAS,L,0,19,1,4,0.25,1,4,0.25,0,0,,0,0,,1,5,6
19465,Dwight Powell,25-169,F-C,1/5/17,DAL,,PHO,L,0,9,1,4,0.25,1,4,0.25,0,0,,0,0,,2,3,5
19466,Dwight Powell,25-224,F-C,3/1/17,DAL,@,ATL,L,0,11,0,0,,0,0,,0,0,,2,2,1,1,2,3
19467,Dwight Powell,25-183,F-C,1/19/17,DAL,@,MIA,L,0,10,0,3,0,0,2,0,0,1,0,2,2,1,1,3,4
19468,Dwight Powell,25-100,F-C,10/28/16,DAL,,HOU,L,0,20,1,1,1,1,1,1,0,0,,0,0,,2,2,4
19469,Dwight Powell,25-234,F-C,3/11/17,DAL,,PHO,L,0,10,1,1,1,1,1,1,0,0,,0,0,,0,3,3
19470,Dwight Powell,25-173,F-C,1/9/17,DAL,@,MIN,L,0,6,0,1,0,0,1,0,0,0,,2,2,1,0,0,0
19471,Norman Powell,23-230,G,1/10/17,TOR,,BOS,W,0,4,1,1,1,1,1,1,0,0,,0,0,,0,0,0
19472,Norman Powell,23-159,G,10/31/16,TOR,,DEN,W,0,2,1,1,1,1,1,1,0,0,,0,0,,0,1,1
19473,Norman Powell,23-212,G,12/23/16,TOR,@,UTA,W,0,19,1,3,0.333,1,2,0.5,0,1,0,0,0,,0,1,1
19474,Norman Powell,23-227,G,1/7/17,TOR,@,CHI,L,0,12,0,5,0,0,2,0,0,3,0,2,2,1,0,0,0
19475,Norman Powell,23-170,G,11/11/16,TOR,@,CHO,W,0,10,0,1,0,0,1,0,0,0,,2,2,1,0,3,3
19476,Norman Powell,23-223,G,1/3/17,TOR,@,SAS,L,0,8,0,4,0,0,3,0,0,1,0,2,2,1,0,2,2
19477,Norman Powell,23-221,G,1/1/17,TOR,@,LAL,W,0,8,1,2,0.5,1,1,1,0,1,0,0,0,,0,0,0
19478,Norman Powell,23-217,G,12/28/16,TOR,@,GSW,L,0,7,1,2,0.5,1,1,1,0,1,0,0,2,0,0,0,0
19479,Norman Powell,23-263,G,2/12/17,TOR,,DET,L,0,8,1,3,0.333,1,2,0.5,0,1,0,0,0,,0,3,3
19480,Tim Quarterman,22-024,G,11/20/16,POR,@,BRK,W,0,2,1,1,1,1,1,1,0,0,,0,0,,1,0,1
19481,Tim Quarterman,22-022,G,11/18/16,POR,@,NOP,L,0,2,1,1,1,1,1,1,0,0,,0,0,,0,0,0
19482,Chasson Randle,24-037,G,3/14/17,NYK,,IND,W,0,7,0,1,0,0,0,,0,1,0,2,2,1,0,1,1
19483,Julius Randle,22-065,F,2/2/17,LAL,@,WAS,L,0,6,1,4,0.25,1,4,0.25,0,0,,0,0,,1,1,2
19484,Julius Randle,22-013,F,12/12/16,LAL,@,SAC,L,1,28,1,7,0.143,1,6,0.167,0,1,0,0,0,,4,4,8
19485,Julius Randle,22-047,F,1/15/17,LAL,,DET,L,1,31,1,6,0.167,1,6,0.167,0,0,,0,0,,1,9,10
19486,Zach Randolph,35-108,F,11/1/16,MEM,@,MIN,L,0,10,1,6,0.167,1,5,0.2,0,1,0,0,0,,0,2,2
19487,J.J. Redick,32-166,G,12/7/16,LAC,,GSW,L,1,22,1,4,0.25,1,2,0.5,0,2,0,0,0,,0,1,1
19488,Willie Reed,26-250,F-C,1/21/17,MIA,,MIL,W,0,18,1,2,0.5,1,2,0.5,0,0,,0,0,,1,4,5
19489,Willie Reed,26-291,F-C,3/3/17,MIA,@,ORL,L,0,8,1,3,0.333,1,3,0.333,0,0,,0,0,,2,2,4
19490,Willie Reed,26-167,F-C,10/30/16,MIA,,SAS,L,0,13,1,3,0.333,1,3,0.333,0,0,,0,0,,3,1,4
19491,Willie Reed,26-212,F-C,12/14/16,MIA,,IND,W,0,7,1,1,1,1,1,1,0,0,,0,0,,1,3,4
19492,Willie Reed,26-264,F-C,2/4/17,MIA,,PHI,W,0,14,1,4,0.25,1,4,0.25,0,0,,0,0,,1,0,1
19493,Willie Reed,26-246,F-C,1/17/17,MIA,,HOU,W,0,16,1,3,0.333,1,3,0.333,0,0,,0,0,,1,5,6
19494,Willie Reed,26-257,F-C,1/28/17,MIA,,DET,W,0,19,1,2,0.5,1,2,0.5,0,0,,0,0,,2,3,5
19495,Willie Reed,26-273,F-C,2/13/17,MIA,,ORL,L,0,12,1,4,0.25,1,4,0.25,0,0,,0,0,,1,0,1
19496,Willie Reed,26-299,F-C,3/11/17,MIA,,TOR,W,0,15,1,2,0.5,1,2,0.5,0,0,,0,0,,1,1,2
19497,Willie Reed,26-271,F-C,2/11/17,MIA,@,PHI,L,0,14,1,3,0.333,1,3,0.333,0,0,,0,0,,3,3,6
19498,Willie Reed,26-220,F-C,12/22/16,MIA,,LAL,W,0,6,1,2,0.5,1,2,0.5,0,0,,0,0,,2,0,2
19499,Willie Reed,26-270,F-C,2/10/17,MIA,@,BRK,W,0,9,1,3,0.333,1,3,0.333,0,0,,0,0,,0,3,3
19500,Willie Reed,26-292,F-C,3/4/17,MIA,,CLE,W,0,12,1,5,0.2,1,5,0.2,0,0,,0,0,,1,0,1
19501,Josh Richardson,23-165,G,2/27/17,MIA,@,DAL,L,0,8,1,2,0.5,1,2,0.5,0,0,,0,0,,0,0,0
19502,Josh Richardson,23-163,G,2/25/17,MIA,,IND,W,0,14,1,3,0.333,1,2,0.5,0,1,0,0,0,,1,3,4
19503,Malachi Richardson,21-023,G,1/28/17,SAC,@,CHO,W,0,13,1,2,0.5,1,1,1,0,1,0,0,0,,0,0,0
19504,Malachi Richardson,21-030,G,2/4/17,SAC,,GSW,W,0,6,1,1,1,1,1,1,0,0,,0,0,,0,0,0
19505,Austin Rivers,24-123,G,12/2/16,LAC,@,NOP,W,0,20,1,9,0.111,1,5,0.2,0,4,0,0,0,,0,2,2
19506,Austin Rivers,24-107,G,11/16/16,LAC,,MEM,L,0,18,1,4,0.25,1,3,0.333,0,1,0,0,0,,0,1,1
19507,Austin Rivers,24-103,G,11/12/16,LAC,@,MIN,W,0,16,1,4,0.25,1,3,0.333,0,1,0,0,0,,0,0,0
19508,Austin Rivers,24-226,G,3/15/17,LAC,,MIL,L,0,15,1,7,0.143,1,4,0.25,0,3,0,0,0,,0,1,1
19509,Austin Rivers,24-116,G,11/25/16,LAC,@,DET,L,0,17,1,3,0.333,1,3,0.333,0,0,,0,0,,0,1,1
19510,Andre Roberson,25-025,G-F,12/29/16,OKC,@,MEM,L,1,24,1,3,0.333,1,3,0.333,0,0,,0,0,,0,5,5
19511,Andre Roberson,25-053,G-F,1/26/17,OKC,,DAL,W,1,29,0,3,0,0,1,0,0,2,0,2,6,0.333,1,7,8
19512,Andre Roberson,25-091,G-F,3/5/17,OKC,@,DAL,L,1,23,1,3,0.333,1,1,1,0,2,0,0,0,,4,4,8
19513,Andre Roberson,25-106,G-F,3/20/17,OKC,,GSW,L,1,25,1,2,0.5,1,1,1,0,1,0,0,2,0,1,2,3
19514,Andre Roberson,24-335,G-F,11/3/16,OKC,@,GSW,L,1,18,1,6,0.167,1,4,0.25,0,2,0,0,0,,1,2,3
19515,Andre Roberson,25-088,G-F,3/2/17,OKC,@,POR,L,1,31,0,2,0,0,0,,0,2,0,2,2,1,1,3,4
19516,Andre Roberson,25-031,G-F,1/4/17,OKC,@,CHO,L,1,30,1,3,0.333,1,2,0.5,0,1,0,0,0,,1,1,2
19517,Andre Roberson,24-334,G-F,11/2/16,OKC,@,LAC,W,1,24,1,5,0.2,1,4,0.25,0,1,0,0,2,0,2,2,4
19518,Brian Roberts,31-035,G,1/7/17,CHO,@,SAS,L,0,4,1,1,1,1,1,1,0,0,,0,0,,0,1,1
19519,Brian Roberts,31-089,G,3/2/17,CHO,@,PHO,L,0,12,0,3,0,0,2,0,0,1,0,2,3,0.667,0,3,3
19520,Brian Roberts,30-340,G,11/7/16,CHO,,IND,W,0,4,1,2,0.5,1,1,1,0,1,0,0,0,,0,1,1
19521,Brian Roberts,31-102,G,3/15/17,CHO,@,IND,L,0,4,1,2,0.5,1,1,1,0,1,0,0,0,,0,0,0
19522,Brian Roberts,31-025,G,12/28/16,CHO,@,ORL,W,0,6,0,0,,0,0,,0,0,,2,2,1,0,0,0
19523,Brian Roberts,31-063,G,2/4/17,CHO,@,UTA,L,0,13,1,5,0.2,1,4,0.25,0,1,0,0,0,,0,1,1
19524,Brian Roberts,31-085,G,2/26/17,CHO,@,LAC,L,0,10,1,3,0.333,1,1,1,0,2,0,0,0,,0,1,1
19525,Brian Roberts,31-084,G,2/25/17,CHO,@,SAC,W,0,12,1,2,0.5,1,2,0.5,0,0,,0,0,,0,0,0
19526,Brian Roberts,31-074,G,2/15/17,CHO,@,TOR,L,0,5,1,2,0.5,1,1,1,0,1,0,0,0,,0,1,1
19527,Brian Roberts,31-095,G,3/8/17,CHO,@,MIA,L,0,10,1,3,0.333,1,2,0.5,0,1,0,0,0,,0,2,2
19528,Glenn Robinson,23-031,G-F,2/8/17,IND,,CLE,L,0,15,1,3,0.333,1,3,0.333,0,0,,0,0,,1,1,2
19529,Glenn Robinson,22-294,G-F,10/28/16,IND,@,BRK,L,0,13,1,4,0.25,1,4,0.25,0,0,,0,0,,1,1,2
19530,Glenn Robinson,22-342,G-F,12/15/16,IND,@,NOP,L,1,33,1,7,0.143,1,4,0.25,0,3,0,0,0,,1,5,6
19531,Glenn Robinson,22-355,G-F,12/28/16,IND,@,WAS,L,1,20,1,4,0.25,1,4,0.25,0,0,,0,0,,0,1,1
19532,Glenn Robinson,23-010,G-F,1/18/17,IND,@,SAC,W,1,19,1,4,0.25,1,2,0.5,0,2,0,0,0,,0,1,1
19533,Glenn Robinson,23-061,G-F,3/10/17,IND,@,MIL,L,0,15,1,2,0.5,1,1,1,0,1,0,0,0,,1,1,2
19534,Glenn Robinson,22-302,G-F,11/5/16,IND,,CHI,W,0,8,1,1,1,1,1,1,0,0,,0,2,0,1,1,2
19535,Glenn Robinson,23-057,G-F,3/6/17,IND,@,CHO,L,0,28,1,5,0.2,1,3,0.333,0,2,0,0,0,,2,4,6
19536,Glenn Robinson,22-349,G-F,12/22/16,IND,,BOS,L,1,35,1,9,0.111,1,7,0.143,0,2,0,0,0,,2,4,6
19537,Glenn Robinson,23-034,G-F,2/11/17,IND,,MIL,L,0,15,1,4,0.25,1,4,0.25,0,0,,0,0,,3,1,4
19538,Glenn Robinson,22-334,G-F,12/7/16,IND,@,PHO,W,0,12,0,2,0,0,2,0,0,0,,2,2,1,1,1,2
19539,Thomas Robinson,25-258,F,11/30/16,LAL,@,CHI,W,0,9,1,2,0.5,1,2,0.5,0,0,,0,0,,3,3,6
19540,Thomas Robinson,25-311,F,1/22/17,LAL,@,DAL,L,0,6,1,1,1,1,1,1,0,0,,0,0,,0,1,1
19541,Thomas Robinson,25-303,F,1/14/17,LAL,@,LAC,L,0,9,1,4,0.25,1,4,0.25,0,0,,0,2,0,0,3,3
19542,Thomas Robinson,26-000,F,3/17/17,LAL,,MIL,L,0,5,0,2,0,0,2,0,0,0,,2,4,0.5,1,1,2
19543,Thomas Robinson,25-265,F,12/7/16,LAL,@,HOU,L,0,15,0,1,0,0,1,0,0,0,,2,4,0.5,1,3,4
19544,Sergio Rodriguez,30-258,G,2/25/17,PHI,@,NYK,L,0,15,1,8,0.125,1,6,0.167,0,2,0,0,0,,0,0,0
19545,Sergio Rodriguez,30-257,G,2/24/17,PHI,,WAS,W,0,18,1,7,0.143,1,5,0.2,0,2,0,0,0,,0,2,2
19546,Sergio Rodriguez,30-155,G,11/14/16,PHI,@,HOU,L,1,27,1,8,0.125,1,7,0.143,0,1,0,0,0,,0,2,2
19547,Sergio Rodriguez,30-213,G,1/11/17,PHI,,NYK,W,0,14,1,7,0.143,1,4,0.25,0,3,0,0,0,,1,0,1
19548,Sergio Rodriguez,30-241,G,2/8/17,PHI,,SAS,L,0,17,1,7,0.143,1,2,0.5,0,5,0,0,0,,0,1,1
19549,Sergio Rodriguez,30-150,G,11/9/16,PHI,@,IND,L,1,31,1,14,0.071,1,7,0.143,0,7,0,0,0,,1,1,2
19550,Rajon Rondo,30-308,G,12/26/16,CHI,,IND,W,1,24,1,6,0.167,1,3,0.333,0,3,0,0,0,,4,5,9
19551,Rajon Rondo,30-333,G,1/20/17,CHI,@,ATL,L,0,18,1,5,0.2,1,4,0.25,0,1,0,0,0,,2,1,3
19552,Rajon Rondo,30-285,G,12/3/16,CHI,@,DAL,L,1,24,1,4,0.25,1,3,0.333,0,1,0,0,0,,1,1,2
19553,Rajon Rondo,31-018,G,3/12/17,CHI,@,BOS,L,0,19,1,5,0.2,1,5,0.2,0,0,,0,0,,1,2,3
19554,Derrick Rose,28-070,G,12/13/16,NYK,@,PHO,L,1,10,0,6,0,0,5,0,0,1,0,2,2,1,0,1,1
19555,Terrence Ross,25-340,F-G,1/10/17,TOR,,BOS,W,0,21,1,4,0.25,1,1,1,0,3,0,0,0,,0,0,0
19556,Terry Rozier,22-328,G,2/8/17,BOS,@,SAC,L,0,13,0,6,0,0,3,0,0,3,0,2,2,1,1,0,1
19557,Terry Rozier,22-288,G,12/30/16,BOS,,MIA,W,0,21,1,1,1,1,1,1,0,0,,0,1,0,0,5,5
19558,Terry Rozier,22-335,G,2/15/17,BOS,,PHI,W,0,19,1,6,0.167,1,5,0.2,0,1,0,0,0,,0,1,1
19559,Terry Rozier,22-260,G,12/2/16,BOS,,SAC,W,0,16,1,7,0.143,1,5,0.2,0,2,0,0,0,,1,2,3
19560,Terry Rozier,22-333,G,2/13/17,BOS,@,DAL,W,0,19,1,3,0.333,1,3,0.333,0,0,,0,0,,0,4,4
19561,Terry Rozier,22-274,G,12/16/16,BOS,,CHO,W,0,16,1,3,0.333,1,3,0.333,0,0,,0,0,,0,5,5
19562,Ricky Rubio,26-029,G,11/19/16,MIN,@,MEM,L,1,34,0,5,0,0,3,0,0,2,0,2,4,0.5,2,2,4
19563,Damjan Rudez,30-266,F,3/10/17,ORL,@,CHO,L,0,12,1,7,0.143,1,2,0.5,0,5,0,0,0,,0,0,0
19564,Brandon Rush,31-246,G-F,3/10/17,MIN,,GSW,W,1,20,1,3,0.333,1,2,0.5,0,1,0,0,0,,2,1,3
19565,Brandon Rush,31-253,G-F,3/17/17,MIN,@,MIA,L,1,35,0,2,0,0,0,,0,2,0,2,2,1,0,4,4
19566,D'Angelo Russell,20-351,G,2/8/17,LAL,@,DET,L,1,23,1,2,0.5,1,2,0.5,0,0,,0,0,,0,1,1
19567,Domantas Sabonis,20-278,F,2/5/17,OKC,,POR,W,1,34,0,6,0,0,5,0,0,1,0,2,2,1,1,6,7
19568,Domantas Sabonis,20-301,F,2/28/17,OKC,,UTA,W,1,11,1,4,0.25,1,3,0.333,0,1,0,0,0,,0,1,1
19569,Domantas Sabonis,20-246,F,1/4/17,OKC,@,CHO,L,1,17,1,4,0.25,1,4,0.25,0,0,,0,0,,1,2,3
19570,Domantas Sabonis,20-276,F,2/3/17,OKC,,MEM,W,1,11,1,4,0.25,1,2,0.5,0,2,0,0,0,,0,1,1
19571,Domantas Sabonis,20-274,F,2/1/17,OKC,,CHI,L,1,22,1,10,0.1,1,8,0.125,0,2,0,0,0,,1,4,5
19572,Domantas Sabonis,20-312,F,3/11/17,OKC,,UTA,W,0,12,1,1,1,1,1,1,0,0,,0,0,,1,1,2
19573,Domantas Sabonis,20-240,F,12/29/16,OKC,@,MEM,L,1,21,1,5,0.2,1,3,0.333,0,2,0,0,0,,1,2,3
19574,Domantas Sabonis,20-303,F,3/2/17,OKC,@,POR,L,1,10,1,2,0.5,1,1,1,0,1,0,0,0,,0,1,1
19575,Dario Saric,22-256,F,12/20/16,PHI,,NOP,L,0,16,0,2,0,0,0,,0,2,0,2,2,1,0,3,3
19576,Dario Saric,22-238,F,12/2/16,PHI,,ORL,L,0,16,1,5,0.2,1,3,0.333,0,2,0,0,0,,0,0,0
19577,Dario Saric,22-250,F,12/14/16,PHI,,TOR,L,0,13,0,2,0,0,0,,0,2,0,2,2,1,1,5,6
19578,Tomas Satoransky,25-008,G,11/7/16,WAS,,HOU,L,0,13,1,4,0.25,1,2,0.5,0,2,0,0,0,,1,0,1
19579,Tomas Satoransky,25-054,G,12/23/16,WAS,@,MIL,L,0,8,1,1,1,1,1,1,0,0,,0,0,,0,0,0
19580,Tomas Satoransky,25-086,G,1/24/17,WAS,,BOS,W,0,14,1,1,1,1,1,1,0,0,,0,0,,0,1,1
19581,Tomas Satoransky,25-101,G,2/8/17,WAS,@,BRK,W,0,15,1,2,0.5,1,2,0.5,0,0,,0,0,,0,2,2
19582,Tomas Satoransky,25-003,G,11/2/16,WAS,,TOR,L,0,10,1,2,0.5,1,2,0.5,0,0,,0,0,,0,2,2
19583,Tomas Satoransky,25-080,G,1/18/17,WAS,,MEM,W,0,14,1,1,1,1,1,1,0,0,,0,0,,2,1,3
19584,Tomas Satoransky,25-031,G,11/30/16,WAS,@,OKC,L,0,12,1,3,0.333,1,2,0.5,0,1,0,0,0,,0,1,1
19585,Tomas Satoransky,25-136,G,3/15/17,WAS,,DAL,L,0,6,1,1,1,1,1,1,0,0,,0,0,,0,0,0
19586,Tomas Satoransky,24-363,G,10/27/16,WAS,@,ATL,L,0,4,1,1,1,1,1,1,0,0,,0,0,,1,0,1
19587,Tomas Satoransky,25-119,G,2/26/17,WAS,,UTA,L,0,7,1,3,0.333,1,3,0.333,0,0,,0,0,,0,0,0
19588,Tomas Satoransky,25-134,G,3/13/17,WAS,@,MIN,L,0,5,1,1,1,1,1,1,0,0,,0,1,0,0,0,0
19589,Luis Scola,36-186,F,11/2/16,BRK,,DET,W,0,14,1,2,0.5,1,1,1,0,1,0,0,0,,0,3,3
19590,Luis Scola,36-228,F,12/14/16,BRK,,LAL,W,0,12,1,4,0.25,1,4,0.25,0,0,,0,0,,3,2,5
19591,Luis Scola,36-226,F,12/12/16,BRK,@,HOU,L,0,5,1,3,0.333,1,3,0.333,0,0,,0,0,,0,0,0
19592,Luis Scola,36-215,F,12/1/16,BRK,,MIL,L,0,7,1,1,1,1,1,1,0,0,,0,0,,3,1,4
19593,Luis Scola,36-236,F,12/22/16,BRK,,GSW,L,0,3,1,1,1,1,1,1,0,0,,0,0,,0,1,1
19594,Luis Scola,36-213,F,11/29/16,BRK,,LAC,W,0,6,1,2,0.5,1,2,0.5,0,0,,0,2,0,0,1,1
19595,Mike Scott,28-214,F,2/15/17,ATL,@,LAC,L,0,12,1,2,0.5,1,2,0.5,0,0,,0,0,,0,0,0
19596,Mike Scott,28-139,F,12/2/16,ATL,,DET,L,0,12,1,4,0.25,1,2,0.5,0,2,0,0,0,,1,2,3
19597,Mike Scott,28-205,F,2/6/17,ATL,,UTA,L,0,12,1,1,1,1,1,1,0,0,,0,0,,1,2,3
19598,Mike Scott,28-203,F,2/4/17,ATL,,ORL,W,0,5,1,3,0.333,1,3,0.333,0,0,,0,0,,1,0,1
19599,Thabo Sefolosha,32-318,G-F,3/16/17,ATL,,MEM,L,1,14,0,0,,0,0,,0,0,,2,2,1,0,1,1
19600,Thabo Sefolosha,32-209,G-F,11/27/16,ATL,@,LAL,L,0,20,1,3,0.333,1,2,0.5,0,1,0,0,0,,1,4,5
19601,Thabo Sefolosha,32-270,G-F,1/27/17,ATL,,WAS,L,1,16,0,2,0,0,1,0,0,1,0,2,2,1,0,2,2
19602,Thabo Sefolosha,32-318,G-F,3/16/17,ATL,,MEM,L,1,14,0,0,,0,0,,0,0,,2,2,1,0,1,1
19603,Wayne Selden,22-169,G-F,3/18/17,MEM,,SAS,W,0,1,0,0,,0,0,,0,0,,2,2,1,0,0,0
19604,Wayne Selden,22-165,G-F,3/14/17,NOP,,POR,W,1,15,0,1,0,0,0,,0,1,0,2,4,0.5,0,3,3
19605,Kevin Seraphin,27-019,F,12/26/16,IND,@,CHI,L,0,9,1,3,0.333,1,3,0.333,0,0,,0,0,,0,2,2
19606,Kevin Seraphin,27-040,F,1/16/17,IND,,NOP,W,0,11,1,2,0.5,1,2,0.5,0,0,,0,0,,0,6,6
19607,Kevin Seraphin,27-097,F,3/14/17,IND,@,NYK,L,0,6,1,1,1,1,1,1,0,0,,0,0,,1,1,2
19608,Kevin Seraphin,26-336,F,11/7/16,IND,@,CHO,L,0,8,1,3,0.333,1,3,0.333,0,0,,0,0,,0,3,3
19609,Kevin Seraphin,27-091,F,3/8/17,IND,,DET,W,0,3,1,2,0.5,1,2,0.5,0,0,,0,0,,1,2,3
19610,Kevin Seraphin,27-010,F,12/17/16,IND,@,DET,W,0,3,1,2,0.5,1,2,0.5,0,0,,0,0,,0,1,1
19611,Kevin Seraphin,27-088,F,3/5/17,IND,@,ATL,W,0,5,1,4,0.25,1,4,0.25,0,0,,0,0,,1,0,1
19612,Kevin Seraphin,27-061,F,2/6/17,IND,,OKC,W,0,15,1,2,0.5,1,2,0.5,0,0,,0,0,,0,2,2
19613,Kevin Seraphin,27-047,F,1/23/17,IND,,NYK,L,0,5,1,2,0.5,1,2,0.5,0,0,,0,0,,0,1,1
19614,Kevin Seraphin,27-044,F,1/20/17,IND,@,LAL,L,0,11,1,4,0.25,1,4,0.25,0,0,,0,0,,0,1,1
19615,Ramon Sessions,30-253,G,12/20/16,CHO,,LAL,W,0,7,1,2,0.5,1,2,0.5,0,0,,0,0,,0,0,0
19616,Ramon Sessions,30-218,G,11/15/16,CHO,@,MIN,W,0,13,0,2,0,0,0,,0,2,0,2,2,1,0,1,1
19617,Iman Shumpert,26-198,G,1/10/17,CLE,@,UTA,L,0,21,1,5,0.2,1,3,0.333,0,2,0,0,0,,1,1,2
19618,Iman Shumpert,26-143,G,11/16/16,CLE,@,IND,L,1,28,1,6,0.167,1,5,0.2,0,1,0,0,0,,1,2,3
19619,Iman Shumpert,26-162,G,12/5/16,CLE,@,TOR,W,0,20,1,1,1,1,1,1,0,0,,0,0,,0,0,0
19620,Iman Shumpert,26-121,G,10/25/16,CLE,,NYK,W,0,14,1,3,0.333,1,2,0.5,0,1,0,0,0,,1,1,2
19621,Iman Shumpert,26-248,G,3/1/17,CLE,@,BOS,L,1,21,1,4,0.25,1,1,1,0,3,0,0,0,,0,0,0
19622,Iman Shumpert,26-156,G,11/29/16,CLE,@,MIL,L,0,17,1,3,0.333,1,1,1,0,2,0,0,0,,2,0,2
19623,Pascal Siakam,22-270,F,10/31/16,TOR,,DEN,W,1,15,1,4,0.25,1,4,0.25,0,0,,0,0,,1,3,4
19624,Pascal Siakam,22-334,F,1/3/17,TOR,@,SAS,L,1,26,1,4,0.25,1,4,0.25,0,0,,0,0,,1,1,2
19625,Pascal Siakam,22-351,F,1/20/17,TOR,@,CHO,L,0,19,1,2,0.5,1,2,0.5,0,0,,0,0,,2,2,4
19626,Pascal Siakam,23-010,F,2/14/17,TOR,@,CHI,L,0,5,1,2,0.5,1,2,0.5,0,0,,0,0,,0,0,0
19627,Pascal Siakam,22-293,F,11/23/16,TOR,@,HOU,W,1,21,1,3,0.333,1,3,0.333,0,0,,0,0,,0,1,1
19628,Pascal Siakam,22-309,F,12/9/16,TOR,@,BOS,W,1,14,1,3,0.333,1,3,0.333,0,0,,0,0,,1,3,4
19629,Pascal Siakam,22-349,F,1/18/17,TOR,@,PHI,L,1,11,1,2,0.5,1,2,0.5,0,0,,0,0,,0,1,1
19630,Pascal Siakam,22-291,F,11/21/16,TOR,@,LAC,L,1,13,1,2,0.5,1,2,0.5,0,0,,0,0,,0,1,1
19631,Pascal Siakam,23-002,F,2/6/17,TOR,,LAC,W,1,16,1,4,0.25,1,4,0.25,0,0,,0,0,,0,4,4
19632,Jonathon Simmons,27-170,G-F,3/3/17,SAS,@,NOP,W,0,12,1,4,0.25,1,3,0.333,0,1,0,0,0,,0,2,2
19633,Jonathon Simmons,27-085,G-F,12/8/16,SAS,@,CHI,L,0,14,1,7,0.143,1,4,0.25,0,3,0,0,0,,0,2,2
19634,Jonathon Simmons,27-048,G-F,11/1/16,SAS,,UTA,L,1,29,1,7,0.143,1,4,0.25,0,3,0,0,0,,0,2,2
19635,Jonathon Simmons,27-063,G-F,11/16/16,SAS,@,SAC,W,0,18,0,0,,0,0,,0,0,,2,2,1,0,0,0
19636,Jonathon Simmons,27-129,G-F,1/21/17,SAS,@,CLE,W,0,8,1,1,1,1,1,1,0,0,,0,0,,0,0,0
19637,Jonathon Simmons,27-171,G-F,3/4/17,SAS,,MIN,W,0,16,1,3,0.333,1,3,0.333,0,0,,0,0,,0,2,2
19638,Jonathon Simmons,27-147,G-F,2/8/17,SAS,@,PHI,W,0,11,1,3,0.333,1,3,0.333,0,0,,0,0,,0,2,2
19639,Kyle Singler,28-257,F,1/16/17,OKC,@,LAC,L,0,7,1,1,1,1,1,1,0,0,,0,0,,0,1,1
19640,Kyle Singler,28-224,F,12/14/16,OKC,@,UTA,L,0,16,1,2,0.5,1,2,0.5,0,0,,0,0,,0,2,2
19641,Kyle Singler,28-182,F,11/2/16,OKC,@,LAC,W,0,5,1,2,0.5,1,1,1,0,1,0,0,0,,0,2,2
19642,Kyle Singler,28-221,F,12/11/16,OKC,,BOS,W,0,7,1,2,0.5,1,2,0.5,0,0,,0,0,,0,0,0
19643,Kyle Singler,28-239,F,12/29/16,OKC,@,MEM,L,0,6,1,1,1,1,1,1,0,0,,0,0,,0,0,0
19644,Kyle Singler,28-270,F,1/29/17,OKC,@,CLE,L,0,16,1,5,0.2,1,3,0.333,0,2,0,0,0,,1,1,2
19645,Kyle Singler,28-229,F,12/19/16,OKC,,ATL,L,0,12,1,1,1,1,1,1,0,0,,0,0,,0,1,1
19646,Marcus Smart,22-258,G,11/19/16,BOS,@,DET,W,0,31,1,9,0.111,1,4,0.25,0,5,0,0,0,,2,5,7
19647,Marcus Smart,22-316,G,1/16/17,BOS,,CHO,W,0,27,1,5,0.2,1,4,0.25,0,1,0,0,0,,1,4,5
19648,Ish Smith,28-184,G,1/5/17,DET,,CHO,W,0,19,1,6,0.167,1,5,0.2,0,1,0,0,0,,0,5,5
19649,Ish Smith,28-202,G,1/23/17,DET,,SAC,L,0,13,1,2,0.5,1,2,0.5,0,0,,0,0,,0,2,2
19650,Ish Smith,28-236,G,2/26/17,DET,,BOS,L,0,14,1,5,0.2,1,5,0.2,0,0,,0,0,,0,4,4
19651,Ish Smith,28-176,G,12/28/16,DET,,MIL,L,0,21,1,5,0.2,1,4,0.25,0,1,0,0,0,,0,0,0
19652,Ish Smith,28-155,G,12/7/16,DET,@,CHO,L,0,22,1,7,0.143,1,7,0.143,0,0,,0,0,,0,3,3
19653,Ish Smith,28-125,G,11/7/16,DET,@,LAC,L,1,24,1,9,0.111,1,9,0.111,0,0,,0,0,,0,1,1
19654,Ish Smith,28-246,G,3/8/17,DET,@,IND,L,0,25,1,6,0.167,1,5,0.2,0,1,0,0,0,,0,4,4
19655,J.R. Smith,31-184,G-F,3/12/17,CLE,@,HOU,L,0,22,1,6,0.167,1,2,0.5,0,4,0,0,0,,0,2,2
19656,J.R. Smith,31-087,G-F,12/5/16,CLE,@,TOR,W,1,10,1,2,0.5,1,1,1,0,1,0,0,0,,0,0,0
19657,J.R. Smith,31-191,G-F,3/19/17,CLE,@,LAL,W,0,27,1,7,0.143,1,2,0.5,0,5,0,0,0,,0,4,4
19658,Jason Smith,30-273,F-C,11/30/16,WAS,@,OKC,L,0,11,1,4,0.25,1,4,0.25,0,0,,0,0,,1,0,1
19659,Jason Smith,30-335,F-C,1/31/17,WAS,,NYK,W,0,15,1,2,0.5,1,1,1,0,1,0,0,0,,2,3,5
19660,Jason Smith,30-252,F-C,11/9/16,WAS,,BOS,W,0,14,1,3,0.333,1,3,0.333,0,0,,0,0,,0,3,3
19661,Jason Smith,30-331,F-C,1/27/17,WAS,@,ATL,W,0,14,1,2,0.5,1,2,0.5,0,0,,0,1,0,0,3,3
19662,Jason Smith,30-264,F-C,11/21/16,WAS,,PHO,W,0,7,1,3,0.333,1,3,0.333,0,0,,0,0,,0,1,1
19663,Jason Smith,30-281,F-C,12/8/16,WAS,,DEN,W,0,5,1,1,1,1,1,1,0,0,,0,0,,0,1,1
19664,Jason Smith,30-242,F-C,10/30/16,WAS,@,MEM,L,0,5,1,1,1,1,1,1,0,0,,0,0,,0,0,0
19665,Jason Smith,30-278,F-C,12/5/16,WAS,@,BRK,W,0,8,1,2,0.5,1,2,0.5,0,0,,0,0,,0,1,1
19666,Jason Smith,30-239,F-C,10/27/16,WAS,@,ATL,L,0,9,1,2,0.5,1,2,0.5,0,0,,0,0,,1,4,5
19667,Jason Smith,30-259,F-C,11/16/16,WAS,@,PHI,L,0,3,1,2,0.5,1,2,0.5,0,0,,0,0,,0,0,0
19668,Tony Snell,25-030,G-F,12/10/16,MIL,@,WAS,L,1,33,1,6,0.167,1,2,0.5,0,4,0,0,0,,0,6,6
19669,Tony Snell,25-071,G-F,1/20/17,MIL,@,ORL,L,1,24,1,3,0.333,1,1,1,0,2,0,0,0,,0,1,1
19670,Marreese Speights,29-211,C-F,3/3/17,LAC,@,MIL,L,0,10,1,4,0.25,1,1,1,0,3,0,0,0,,0,1,1
19671,Marreese Speights,29-115,C-F,11/27/16,LAC,@,IND,L,0,17,1,6,0.167,1,4,0.25,0,2,0,0,0,,1,6,7
19672,Nik Stauskas,23-105,G,1/20/17,PHI,,POR,W,1,22,1,3,0.333,1,3,0.333,0,0,,0,0,,0,2,2
19673,Nik Stauskas,23-099,G,1/14/17,PHI,@,WAS,L,1,29,1,9,0.111,1,2,0.5,0,7,0,0,0,,0,2,2
19674,Nik Stauskas,23-025,G,11/1/16,PHI,,ORL,L,0,22,1,6,0.167,1,4,0.25,0,2,0,0,0,,0,0,0
19675,Nik Stauskas,23-068,G,12/14/16,PHI,,TOR,L,0,18,0,3,0,0,1,0,0,2,0,2,2,1,0,0,0
19676,Lance Stephenson,26-057,G-F,11/1/16,NOP,,MIL,L,0,15,1,3,0.333,1,3,0.333,0,0,,0,0,,0,3,3
19677,Lance Stephenson,26-054,G-F,10/29/16,NOP,@,SAS,L,0,18,1,4,0.25,1,2,0.5,0,2,0,0,0,,0,0,0
19678,Jarnell Stokes,22-308,F-C,11/10/16,DEN,,GSW,L,0,6,1,1,1,1,1,1,0,0,,0,0,,1,1,2
19679,Rodney Stuckey,30-211,G,11/18/16,IND,,PHO,L,0,13,1,4,0.25,1,4,0.25,0,0,,0,0,,0,1,1
19680,Rodney Stuckey,30-249,G,12/26/16,IND,@,CHI,L,0,6,1,2,0.5,1,2,0.5,0,0,,0,0,,0,0,0
19681,Rodney Stuckey,30-300,G,2/15/17,IND,@,CLE,L,0,5,1,2,0.5,1,2,0.5,0,0,,0,0,,0,0,0
19682,Walter Tavares,24-221,C,10/29/16,ATL,@,PHI,W,0,4,1,1,1,1,1,1,0,0,,0,2,0,0,1,1
19683,Jeff Teague,28-246,G,2/11/17,IND,,MIL,L,1,32,1,2,0.5,1,2,0.5,0,0,,0,0,,0,3,3
19684,Mirza Teletovic,31-127,F,1/23/17,MIL,,HOU,W,0,18,1,4,0.25,1,1,1,0,3,0,0,0,,0,2,2
19685,Mirza Teletovic,31-124,F,1/20/17,MIL,@,ORL,L,0,15,1,3,0.333,1,1,1,0,2,0,0,0,,0,1,1
19686,Mirza Teletovic,31-167,F,3/4/17,MIL,,TOR,W,0,8,1,3,0.333,1,2,0.5,0,1,0,0,0,,0,0,0
19687,Mirza Teletovic,31-042,F,10/30/16,MIL,@,DET,L,0,16,1,3,0.333,1,2,0.5,0,1,0,0,0,,1,1,2
19688,Garrett Temple,30-264,G,1/27/17,SAC,@,IND,L,1,33,0,4,0,0,3,0,0,1,0,2,2,1,0,0,0
19689,Garrett Temple,30-307,G,3/11/17,SAC,,DEN,L,0,18,1,5,0.2,1,1,1,0,4,0,0,0,,1,1,2
19690,Garrett Temple,30-177,G,11/1/16,SAC,@,MIA,L,0,30,1,5,0.2,1,4,0.25,0,1,0,0,0,,2,2,4
19691,Garrett Temple,30-186,G,11/10/16,SAC,,LAL,L,0,17,0,3,0,0,3,0,0,0,,2,2,1,1,1,2
19692,Jason Terry,39-096,G,12/20/16,MIL,,CLE,L,0,12,1,5,0.2,1,2,0.5,0,3,0,0,0,,1,1,2
19693,Jason Terry,39-127,G,1/20/17,MIL,@,ORL,L,0,12,1,3,0.333,1,2,0.5,0,1,0,0,0,,0,0,0
19694,Jason Terry,39-088,G,12/12/16,MIL,@,TOR,L,0,9,1,5,0.2,1,2,0.5,0,3,0,0,0,,0,0,0
19695,Jason Terry,39-139,G,2/1/17,MIL,@,UTA,L,0,17,1,3,0.333,1,1,1,0,2,0,0,0,,0,2,2
19696,Jason Terry,39-132,G,1/25/17,MIL,,PHI,L,0,10,1,1,1,1,1,1,0,0,,0,0,,0,0,0
19697,Lance Thomas,28-330,F,3/20/17,NYK,@,LAC,L,0,15,1,3,0.333,1,3,0.333,0,0,,0,0,,0,1,1
19698,Lance Thomas,28-191,F,11/1/16,NYK,@,DET,L,0,26,1,6,0.167,1,6,0.167,0,0,,0,0,,0,4,4
19699,Lance Thomas,28-240,F,12/20/16,NYK,,IND,W,0,6,1,1,1,1,1,1,0,0,,0,0,,0,1,1
19700,Lance Thomas,28-184,F,10/25/16,NYK,@,CLE,L,0,17,1,4,0.25,1,4,0.25,0,0,,0,0,,0,1,1
19701,Lance Thomas,28-294,F,2/12/17,NYK,,SAS,W,0,17,1,2,0.5,1,2,0.5,0,0,,0,0,,0,2,2
19702,Lance Thomas,28-330,F,3/20/17,NYK,@,LAC,L,0,15,1,3,0.333,1,3,0.333,0,0,,0,0,,0,1,1
19703,Hollis Thompson,25-218,G-F,11/7/16,PHI,,UTA,L,0,18,1,4,0.25,1,2,0.5,0,2,0,0,0,,0,2,2
19704,Hollis Thompson,25-243,G-F,12/2/16,PHI,,ORL,L,0,25,1,7,0.143,1,3,0.333,0,4,0,0,0,,1,1,2
19705,Hollis Thompson,25-239,G-F,11/28/16,PHI,@,TOR,L,0,11,1,3,0.333,1,2,0.5,0,1,0,0,0,,1,1,2
19706,Hollis Thompson,25-342,G-F,3/11/17,NOP,@,CHO,W,1,14,1,4,0.25,1,1,1,0,3,0,0,0,,2,3,5
19707,Tristan Thompson,25-316,F-C,1/23/17,CLE,@,NOP,L,1,28,1,5,0.2,1,5,0.2,0,0,,0,0,,2,5,7
19708,Tristan Thompson,25-230,F-C,10/29/16,CLE,,ORL,W,1,27,1,4,0.25,1,4,0.25,0,0,,0,2,0,4,8,12
19709,Tristan Thompson,25-248,F-C,11/16/16,CLE,@,IND,L,1,28,1,2,0.5,1,2,0.5,0,0,,0,2,0,3,9,12
19710,Tristan Thompson,26-003,F-C,3/16/17,CLE,,UTA,W,1,28,1,4,0.25,1,4,0.25,0,0,,0,2,0,5,3,8
19711,Tristan Thompson,25-297,F-C,1/4/17,CLE,,CHI,L,1,33,1,5,0.2,1,5,0.2,0,0,,0,0,,9,2,11
19712,Tristan Thompson,25-295,F-C,1/2/17,CLE,,NOP,W,1,28,1,2,0.5,1,2,0.5,0,0,,0,0,,3,6,9
19713,Tristan Thompson,25-312,F-C,1/19/17,CLE,,PHO,W,1,20,1,6,0.167,1,6,0.167,0,0,,0,2,0,0,6,6
19714,Tristan Thompson,25-243,F-C,11/11/16,CLE,@,WAS,W,1,23,1,4,0.25,1,4,0.25,0,0,,0,0,,4,3,7
19715,Tristan Thompson,25-271,F-C,12/9/16,CLE,,MIA,W,1,28,1,2,0.5,1,2,0.5,0,0,,0,0,,3,5,8
19716,Marcus Thornton,29-173,G,11/25/16,WAS,@,ORL,W,0,8,0,3,0,0,2,0,0,1,0,2,2,1,0,0,0
19717,Marcus Thornton,29-190,G,12/12/16,WAS,@,MIA,L,0,13,0,3,0,0,2,0,0,1,0,2,2,1,0,1,1
19718,Marcus Thornton,29-188,G,12/10/16,WAS,,MIL,W,0,11,1,3,0.333,1,3,0.333,0,0,,0,0,,1,1,2
19719,Marcus Thornton,29-197,G,12/19/16,WAS,@,IND,L,0,16,1,2,0.5,1,1,1,0,1,0,0,0,,0,0,0
19720,Marcus Thornton,29-159,G,11/11/16,WAS,,CLE,L,1,21,0,5,0,0,3,0,0,2,0,2,2,1,0,1,1
19721,Marcus Thornton,29-174,G,11/26/16,WAS,,SAS,L,0,15,1,3,0.333,1,2,0.5,0,1,0,0,0,,2,2,4
19722,Mike Tobey,22-128,C,2/15/17,CHO,@,TOR,L,0,11,1,3,0.333,1,3,0.333,0,0,,0,0,,2,1,3
19723,Anthony Tolliver,31-278,F-C,3/6/17,SAC,@,DEN,L,0,23,1,6,0.167,1,3,0.333,0,3,0,0,0,,1,2,3
19724,Anthony Tolliver,31-148,F-C,10/27/16,SAC,,SAS,L,0,15,0,2,0,0,0,,0,2,0,2,2,1,0,0,0
19725,P.J. Tucker,31-259,F,1/19/17,PHO,@,CLE,L,0,29,1,5,0.2,1,4,0.25,0,1,0,0,0,,0,5,5
19726,P.J. Tucker,31-237,F,12/28/16,PHO,@,SAS,L,1,16,1,3,0.333,1,1,1,0,2,0,0,0,,0,2,2
19727,P.J. Tucker,31-252,F,1/12/17,PHO,,DAL,L,0,26,1,5,0.2,1,3,0.333,0,2,0,0,0,,2,6,8
19728,P.J. Tucker,31-298,F,2/27/17,TOR,@,NYK,W,0,26,1,4,0.25,1,4,0.25,0,0,,0,0,,3,2,5
19729,P.J. Tucker,31-297,F,2/26/17,TOR,,POR,W,0,21,1,1,1,1,1,1,0,0,,0,0,,0,1,1
19730,P.J. Tucker,31-312,F,3/13/17,TOR,,DAL,W,0,13,1,6,0.167,1,3,0.333,0,3,0,0,0,,0,4,4
19731,Evan Turner,28-142,G,3/18/17,POR,@,ATL,W,0,19,1,9,0.111,1,8,0.125,0,1,0,0,0,,4,4,8
19732,Evan Turner,28-015,G,11/11/16,POR,,SAC,W,0,23,1,4,0.25,1,4,0.25,0,0,,0,0,,0,4,4
19733,Evan Turner,28-076,G,1/11/17,POR,,CLE,W,0,28,1,7,0.143,1,5,0.2,0,2,0,0,0,,1,7,8
19734,Beno Udrih,34-167,G,12/19/16,DET,@,CHI,L,0,6,1,1,1,1,1,1,0,0,,0,0,,0,0,0
19735,Beno Udrih,34-157,G,12/9/16,DET,@,MIN,W,0,4,0,0,,0,0,,0,0,,2,2,1,0,0,0
19736,Tyler Ulis,21-014,G,1/19/17,PHO,@,CLE,L,0,10,1,3,0.333,1,2,0.5,0,1,0,0,0,,0,1,1
19737,Tyler Ulis,20-297,G,10/28/16,PHO,@,OKC,L,0,2,1,1,1,1,1,1,0,0,,0,0,,0,0,0
19738,Tyler Ulis,20-356,G,12/26/16,PHO,@,HOU,L,0,6,1,2,0.5,1,2,0.5,0,0,,0,0,,0,1,1
19739,Tyler Ulis,21-036,G,2/10/17,PHO,,CHI,W,0,2,1,1,1,1,1,1,0,0,,0,0,,0,0,0
19740,Tyler Ulis,20-295,G,10/26/16,PHO,,SAC,L,0,14,1,3,0.333,1,3,0.333,0,0,,0,0,,0,1,1
19741,Tyler Ulis,20-345,G,12/15/16,PHO,,SAS,L,0,5,1,2,0.5,1,2,0.5,0,0,,0,0,,0,1,1
19742,Tyler Ulis,20-364,G,1/3/17,PHO,,MIA,W,0,13,1,4,0.25,1,4,0.25,0,0,,0,0,,1,0,1
19743,Tyler Ulis,21-052,G,2/26/17,PHO,@,MIL,L,0,14,1,7,0.143,1,5,0.2,0,2,0,0,0,,0,1,1
19744,Tyler Ulis,20-312,G,11/12/16,PHO,,BRK,L,0,11,1,3,0.333,1,3,0.333,0,0,,0,0,,0,0,0
19745,Tyler Ulis,20-337,G,12/7/16,PHO,,IND,L,0,6,1,2,0.5,1,2,0.5,0,0,,0,0,,0,0,0
19746,Tyler Ulis,21-041,G,2/15/17,PHO,,LAL,W,0,6,1,1,1,1,1,1,0,0,,0,0,,0,0,0
19747,Jonas Valanciunas,24-301,C,3/3/17,TOR,@,WAS,W,1,13,1,2,0.5,1,2,0.5,0,0,,0,0,,1,2,3
19748,Jonas Valanciunas,24-211,C,12/3/16,TOR,,ATL,W,1,21,1,4,0.25,1,4,0.25,0,0,,0,0,,3,2,5
19749,Jonas Valanciunas,24-242,C,1/3/17,TOR,@,SAS,L,1,22,1,5,0.2,1,5,0.2,0,0,,0,0,,1,5,6
19750,Denzel Valentine,23-024,G,12/10/16,CHI,,MIA,W,0,5,0,1,0,0,1,0,0,0,,2,2,1,0,1,1
19751,Denzel Valentine,23-019,G,12/5/16,CHI,,POR,L,0,22,1,6,0.167,1,1,1,0,5,0,0,0,,0,4,4
19752,Denzel Valentine,23-045,G,12/31/16,CHI,,MIL,L,0,2,1,2,0.5,1,1,1,0,1,0,0,0,,0,0,0
19753,Fred VanVleet,22-281,G,12/2/16,TOR,,LAL,W,0,4,1,2,0.5,1,1,1,0,1,0,0,0,,0,0,0
19754,Fred VanVleet,22-313,G,1/3/17,TOR,@,SAS,L,0,5,1,2,0.5,1,2,0.5,0,0,,0,0,,0,0,0
19755,Fred VanVleet,23-011,G,3/8/17,TOR,@,NOP,W,0,4,1,2,0.5,1,2,0.5,0,0,,0,0,,0,1,1
19756,Fred VanVleet,22-330,G,1/20/17,TOR,@,CHO,L,0,5,1,6,0.167,1,4,0.25,0,2,0,0,0,,1,1,2
19757,Fred VanVleet,23-002,G,2/27/17,TOR,@,NYK,W,0,8,1,2,0.5,1,2,0.5,0,0,,0,0,,0,3,3
19758,Fred VanVleet,22-328,G,1/18/17,TOR,@,PHI,L,0,6,1,2,0.5,1,2,0.5,0,0,,0,0,,0,2,2
19759,Anderson Varejao,34-059,F-C,11/26/16,GSW,,MIN,W,0,4,1,2,0.5,1,2,0.5,0,0,,0,0,,0,1,1
19760,Anderson Varejao,34-126,F-C,2/1/17,GSW,,CHO,W,0,6,1,2,0.5,1,2,0.5,0,0,,0,0,,1,0,1
19761,Anderson Varejao,34-043,F-C,11/10/16,GSW,@,DEN,W,0,5,0,1,0,0,1,0,0,0,,2,2,1,2,2,4
19762,Anderson Varejao,34-106,F-C,1/12/17,GSW,,DET,W,0,6,1,2,0.5,1,2,0.5,0,0,,0,1,0,0,1,1
19763,Greivis Vasquez,29-287,G,10/29/16,BRK,@,MIL,L,0,7,1,4,0.25,1,3,0.333,0,1,0,0,0,,0,1,1
19764,Rashad Vaughn,20-071,G,10/26/16,MIL,,CHO,L,0,8,1,3,0.333,1,2,0.5,0,1,0,0,0,,0,1,1
19765,Rashad Vaughn,20-155,G,1/18/17,MIL,@,HOU,L,0,3,1,3,0.333,1,2,0.5,0,1,0,0,0,,0,0,0
19766,Rashad Vaughn,20-179,G,2/11/17,MIL,@,IND,W,0,25,1,5,0.2,1,4,0.25,0,1,0,0,0,,0,1,1
19767,Rashad Vaughn,20-206,G,3/10/17,MIL,,IND,W,0,25,1,5,0.2,1,3,0.333,0,2,0,0,0,,1,3,4
19768,Noah Vonleh,21-140,F,1/11/17,POR,,CLE,W,0,4,0,1,0,0,1,0,0,0,,2,2,1,1,2,3
19769,Noah Vonleh,21-098,F,11/30/16,POR,,IND,W,0,2,1,1,1,1,1,1,0,0,,0,0,,0,1,1
19770,Noah Vonleh,21-133,F,1/4/17,POR,@,GSW,L,0,7,1,3,0.333,1,3,0.333,0,0,,0,0,,2,2,4
19771,Noah Vonleh,21-169,F,2/9/17,POR,,BOS,L,1,16,1,3,0.333,1,3,0.333,0,0,,0,0,,3,6,9
19772,Noah Vonleh,21-192,F,3/4/17,POR,,BRK,W,1,16,1,5,0.2,1,5,0.2,0,0,,0,0,,1,4,5
19773,Noah Vonleh,21-090,F,11/22/16,POR,@,NYK,L,0,6,0,0,,0,0,,0,0,,2,2,1,0,2,2
19774,Noah Vonleh,21-190,F,3/2/17,POR,,OKC,W,1,16,1,4,0.25,1,4,0.25,0,0,,0,0,,1,4,5
19775,Noah Vonleh,21-088,F,11/20/16,POR,@,BRK,W,0,15,1,1,1,1,1,1,0,0,,0,0,,0,3,3
19776,Noah Vonleh,21-110,F,12/12/16,POR,@,LAC,L,0,15,1,3,0.333,1,3,0.333,0,0,,0,0,,2,2,4
19777,Noah Vonleh,21-128,F,12/30/16,POR,@,SAS,L,0,9,1,1,1,1,1,1,0,0,,0,0,,0,2,2
19778,Nikola Vucevic,26-021,C,11/14/16,ORL,@,IND,L,1,25,1,10,0.1,1,10,0.1,0,0,,0,0,,0,12,12
19779,Sasha Vujacic,32-239,G,11/2/16,NYK,,HOU,L,0,10,1,3,0.333,1,2,0.5,0,1,0,0,0,,0,2,2
19780,Sasha Vujacic,32-295,G,12/28/16,NYK,@,ATL,L,1,27,1,7,0.143,1,4,0.25,0,3,0,0,0,,1,4,5
19781,Sasha Vujacic,32-238,G,11/1/16,NYK,@,DET,L,0,5,1,2,0.5,1,2,0.5,0,0,,0,0,,0,2,2
19782,Sasha Vujacic,32-276,G,12/9/16,NYK,@,SAC,W,0,9,1,1,1,1,1,1,0,0,,0,0,,0,0,0
19783,Dion Waiters,24-333,G,11/7/16,MIA,@,OKC,L,1,27,1,9,0.111,1,8,0.125,0,1,0,0,0,,0,1,1
19784,Taurean Waller-Prince,22-235,F,11/12/16,ATL,,PHI,W,0,3,1,2,0.5,1,2,0.5,0,0,,0,0,,0,1,1
19785,Taurean Waller-Prince,22-291,F,1/7/17,ATL,@,DAL,W,0,14,1,3,0.333,1,3,0.333,0,0,,0,0,,0,1,1
19786,Taurean Waller-Prince,22-313,F,1/29/17,ATL,,NYK,W,0,4,1,2,0.5,1,2,0.5,0,0,,0,0,,0,0,0
19787,Taurean Waller-Prince,22-231,F,11/8/16,ATL,@,CLE,W,0,9,1,2,0.5,1,2,0.5,0,0,,0,0,,0,4,4
19788,Taurean Waller-Prince,22-279,F,12/26/16,ATL,@,MIN,L,0,10,1,3,0.333,1,3,0.333,0,0,,0,0,,0,2,2
19789,Taurean Waller-Prince,22-311,F,1/27/17,ATL,,WAS,L,0,12,1,4,0.25,1,2,0.5,0,2,0,0,0,,0,3,3
19790,Taurean Waller-Prince,22-304,F,1/20/17,ATL,,CHI,W,0,9,1,6,0.167,1,4,0.25,0,2,0,0,0,,0,0,0
19791,Taurean Waller-Prince,22-351,F,3/8/17,ATL,,BRK,W,0,14,1,5,0.2,1,4,0.25,0,1,0,0,0,,1,0,1
19792,Taurean Waller-Prince,22-300,F,1/16/17,ATL,@,NYK,W,0,7,1,1,1,1,1,1,0,0,,0,0,,0,0,0
19793,Taurean Waller-Prince,22-241,F,11/18/16,ATL,@,CHO,L,0,17,1,2,0.5,1,2,0.5,0,0,,0,0,,0,4,4
19794,Taurean Waller-Prince,22-346,F,3/3/17,ATL,,CLE,L,0,12,1,2,0.5,1,2,0.5,0,0,,0,0,,0,2,2
19795,Taurean Waller-Prince,22-256,F,12/3/16,ATL,@,TOR,L,0,9,1,4,0.25,1,3,0.333,0,1,0,0,0,,0,0,0
19796,T.J. Warren,23-074,F,11/18/16,PHO,@,IND,W,1,9,1,2,0.5,1,2,0.5,0,0,,0,0,,0,0,0
19797,T.J. Warren,23-120,F,1/3/17,PHO,,MIA,W,1,17,1,3,0.333,1,2,0.5,0,1,0,0,0,,0,0,0
19798,T.J. Warren,23-103,F,12/17/16,PHO,@,OKC,L,0,14,1,1,1,1,1,1,0,0,,0,0,,1,1,2
19799,C.J. Watson,32-296,G,2/7/17,ORL,@,HOU,L,0,23,1,5,0.2,1,3,0.333,0,2,0,0,0,,0,3,3
19800,C.J. Watson,32-228,G,12/1/16,ORL,@,MEM,L,0,12,0,3,0,0,1,0,0,2,0,2,3,0.667,0,0,0
19801,C.J. Watson,32-224,G,11/27/16,ORL,,MIL,L,0,21,0,6,0,0,4,0,0,2,0,2,2,1,0,1,1
19802,C.J. Watson,32-220,G,11/23/16,ORL,,PHO,L,0,14,1,4,0.25,1,2,0.5,0,2,0,0,1,0,0,2,2
19803,Briante Weber,24-041,PG,2/8/17,GSW,,CHI,W,0,7,1,2,0.5,1,2,0.5,0,0,,0,0,,0,2,2
19804,Briante Weber,24-071,PG,3/10/17,CHO,,ORL,W,0,7,1,4,0.25,1,4,0.25,0,0,,0,0,,0,0,0
19805,Briante Weber,24-063,PG,3/2/17,CHO,@,PHO,L,0,2,0,0,,0,0,,0,0,,2,2,1,0,0,0
19806,Briante Weber,24-079,PG,3/18/17,CHO,,WAS,W,0,14,1,3,0.333,1,3,0.333,0,0,,0,0,,1,1,2
19807,Briante Weber,24-046,PG,2/13/17,GSW,@,DEN,L,0,24,1,3,0.333,1,2,0.5,0,1,0,0,0,,0,1,1
19808,David West,36-134,F,1/10/17,GSW,,MIA,W,0,12,1,4,0.25,1,4,0.25,0,0,,0,0,,1,4,5
19809,David West,36-185,F,3/2/17,GSW,@,CHI,L,0,16,1,4,0.25,1,4,0.25,0,0,,0,0,,1,4,5
19810,David West,36-132,F,1/8/17,GSW,@,SAC,W,0,15,1,3,0.333,1,3,0.333,0,0,,0,0,,1,4,5
19811,David West,36-100,F,12/7/16,GSW,@,LAC,W,0,11,0,1,0,0,1,0,0,0,,2,2,1,0,5,5
19812,David West,36-197,F,3/14/17,GSW,,PHI,W,0,11,1,1,1,1,1,1,0,0,,0,0,,0,3,3
19813,David West,36-066,F,11/3/16,GSW,,OKC,W,0,6,1,2,0.5,1,2,0.5,0,0,,0,0,,0,2,2
19814,David West,36-180,F,2/25/17,GSW,,BRK,W,0,14,1,5,0.2,1,5,0.2,0,0,,0,0,,0,3,3
19815,David West,36-126,F,1/2/17,GSW,,DEN,W,0,13,1,4,0.25,1,4,0.25,0,0,,0,0,,1,1,2
19816,David West,36-108,F,12/15/16,GSW,,NYK,W,0,10,1,1,1,1,1,1,0,0,,0,0,,1,3,4
19817,David West,36-076,F,11/13/16,GSW,,PHO,W,0,6,1,2,0.5,1,2,0.5,0,0,,0,0,,0,1,1
19818,David West,36-106,F,12/13/16,GSW,@,NOP,W,0,12,1,4,0.25,1,4,0.25,0,0,,0,0,,0,3,3
19819,David West,36-057,F,10/25/16,GSW,,SAS,L,0,11,1,2,0.5,1,2,0.5,0,0,,0,0,,1,1,2
19820,David West,36-089,F,11/26/16,GSW,,MIN,W,0,9,1,2,0.5,1,2,0.5,0,0,,0,2,0,1,1,2
19821,David West,36-136,F,1/12/17,GSW,,DET,W,0,9,1,4,0.25,1,3,0.333,0,1,0,0,0,,0,0,0
19822,David West,36-088,F,11/25/16,GSW,@,LAL,W,0,11,1,1,1,1,1,1,0,0,,0,0,,1,1,2
19823,Okaro White,24-182,F,2/11/17,MIA,@,PHI,L,0,18,1,2,0.5,1,1,1,0,1,0,0,0,,0,0,0
19824,Okaro White,24-205,F,3/6/17,MIA,@,CLE,W,0,22,1,6,0.167,1,4,0.25,0,2,0,0,0,,2,3,5
19825,Isaiah Whitehead,22-009,G,3/17/17,BRK,,BOS,L,0,23,0,7,0,0,5,0,0,2,0,2,2,1,0,2,2
19826,Isaiah Whitehead,21-334,G,2/5/17,BRK,,TOR,L,1,15,1,4,0.25,1,3,0.333,0,1,0,0,0,,0,1,1
19827,Isaiah Whitehead,21-323,G,1/25/17,BRK,,MIA,L,0,15,0,5,0,0,5,0,0,0,,2,2,1,0,3,3
19828,Hassan Whiteside,27-256,C,2/24/17,MIA,@,ATL,W,1,25,1,9,0.111,1,9,0.111,0,0,,0,0,,2,8,10
19829,C.J. Wilcox,26-076,G,3/16/17,ORL,@,GSW,L,0,12,1,7,0.143,1,6,0.167,0,1,0,0,0,,1,1,2
19830,C.J. Wilcox,25-345,G,12/9/16,ORL,@,CHO,L,0,8,1,3,0.333,1,1,1,0,2,0,0,0,,0,2,2
19831,C.J. Wilcox,26-057,G,2/25/17,ORL,,ATL,W,0,3,1,2,0.5,1,1,1,0,1,0,0,0,,0,0,0
19832,Alan Williams,23-324,F-C,12/17/16,PHO,@,OKC,L,0,2,1,3,0.333,1,3,0.333,0,0,,0,0,,2,0,2
19833,Alan Williams,23-289,F-C,11/12/16,PHO,,BRK,L,0,2,1,1,1,1,1,1,0,0,,0,0,,0,0,0
19834,Alan Williams,23-322,F-C,12/15/16,PHO,,SAS,L,0,7,1,3,0.333,1,3,0.333,0,0,,0,0,,4,0,4
19835,Alan Williams,23-277,F-C,10/31/16,PHO,@,LAC,L,0,4,1,1,1,1,1,1,0,0,,0,0,,0,1,1
19836,Alan Williams,23-310,F-C,12/3/16,PHO,@,GSW,L,0,4,1,3,0.333,1,3,0.333,0,0,,0,2,0,1,0,1
19837,Alan Williams,23-354,F-C,1/16/17,PHO,,UTA,L,0,4,1,2,0.5,1,2,0.5,0,0,,0,0,,0,0,0
19838,Alan Williams,24-018,F-C,2/15/17,PHO,,LAL,W,0,5,1,2,0.5,1,2,0.5,0,0,,0,0,,0,6,6
19839,Alan Williams,24-014,F-C,2/11/17,PHO,@,HOU,L,0,10,0,2,0,0,2,0,0,0,,2,2,1,1,3,4
19840,Alan Williams,23-333,F-C,12/26/16,PHO,@,HOU,L,0,6,0,0,,0,0,,0,0,,2,2,1,0,1,1
19841,Deron Williams,32-232,G,2/13/17,DAL,,BOS,L,1,13,1,1,1,1,1,1,0,0,,0,0,,0,1,1
19842,Deron Williams,32-266,G,3/19/17,CLE,@,LAL,W,0,17,1,3,0.333,1,3,0.333,0,0,,0,0,,0,0,0
19843,Deron Williams,32-250,G,3/3/17,CLE,@,ATL,W,0,17,1,1,1,1,1,1,0,0,,0,0,,0,1,1
19844,Derrick Williams,25-255,F,2/4/17,MIA,,PHI,W,0,8,1,2,0.5,1,1,1,0,1,0,0,0,,0,1,1
19845,Derrick Williams,25-297,F,3/18/17,CLE,@,LAC,L,0,24,1,5,0.2,1,3,0.333,0,2,0,0,0,,0,4,4
19846,Derrick Williams,25-228,F,1/8/17,MIA,@,LAC,L,1,21,1,5,0.2,1,4,0.25,0,1,0,0,0,,0,3,3
19847,Derrick Williams,25-288,F,3/9/17,CLE,@,DET,L,0,8,1,4,0.25,1,1,1,0,3,0,0,0,,0,1,1
19848,Derrick Williams,25-176,F,11/17/16,MIA,,MIL,W,1,15,1,5,0.2,1,4,0.25,0,1,0,0,0,,2,0,2
19849,Reggie Williams,30-087,F,12/10/16,NOP,@,LAC,L,0,16,1,4,0.25,1,3,0.333,0,1,0,0,0,,0,2,2
19850,Reggie Williams,30-164,F,2/25/17,NOP,@,DAL,L,0,16,1,3,0.333,1,2,0.5,0,1,0,0,0,,0,0,0
19851,Troy Williams,21-322,F,11/16/16,MEM,@,LAC,W,0,9,1,1,1,1,1,1,0,0,,0,0,,0,0,0
19852,Troy Williams,21-352,F,12/16/16,MEM,,SAC,L,1,16,1,3,0.333,1,3,0.333,0,0,,0,0,,0,2,2
19853,Troy Williams,21-325,F,11/19/16,MEM,,MIN,W,0,2,1,1,1,1,1,1,0,0,,0,0,,0,0,0
19854,Justise Winslow,20-263,F,12/14/16,MIA,,IND,W,0,21,1,5,0.2,1,4,0.25,0,1,0,0,2,0,0,2,2
19855,Jeff Withey,26-345,C,2/15/17,UTA,,POR,W,0,2,1,4,0.25,1,4,0.25,0,0,,0,0,,2,0,2
19856,Jeff Withey,27-011,C,3/18/17,UTA,@,CHI,L,0,11,0,0,,0,0,,0,0,,2,2,1,0,3,3
19857,Jeff Withey,26-338,C,2/8/17,UTA,@,NOP,W,0,5,1,1,1,1,1,1,0,0,,0,0,,0,1,1
19858,Jeff Withey,26-263,C,11/25/16,UTA,,ATL,W,0,15,1,2,0.5,1,2,0.5,0,0,,0,2,0,1,2,3
19859,Jeff Withey,26-278,C,12/10/16,UTA,,SAC,W,0,12,0,2,0,0,2,0,0,0,,2,2,1,1,6,7
19860,Jeff Withey,26-276,C,12/8/16,UTA,,GSW,L,0,6,1,4,0.25,1,4,0.25,0,0,,0,0,,3,1,4
19861,Jeff Withey,27-004,C,3/11/17,UTA,@,OKC,L,1,23,1,5,0.2,1,5,0.2,0,0,,0,0,,2,3,5
19862,Jeff Withey,26-274,C,12/6/16,UTA,,PHO,W,0,10,1,2,0.5,1,2,0.5,0,0,,0,0,,1,1,2
19863,Jeff Withey,26-361,C,3/3/17,UTA,,BRK,W,0,2,0,0,,0,0,,0,0,,2,4,0.5,0,0,0
19864,Jeff Withey,26-255,C,11/17/16,UTA,,CHI,L,0,6,1,1,1,1,1,1,0,0,,0,0,,0,0,0
19865,Jeff Withey,26-271,C,12/3/16,UTA,,DEN,W,0,4,1,1,1,1,1,1,0,0,,0,0,,1,0,1
19866,Jeff Withey,27-013,C,3/20/17,UTA,@,IND,L,0,11,1,2,0.5,1,2,0.5,0,0,,0,0,,1,2,3
19867,Metta World Peace,36-354,F,11/1/16,LAL,@,IND,L,0,3,0,0,,0,0,,0,0,,2,4,0.5,0,0,0
19868,Metta World Peace,37-024,F,12/7/16,LAL,@,HOU,L,0,7,0,1,0,0,0,,0,1,0,2,2,1,0,0,0
19869,Metta World Peace,37-085,F,2/6/17,LAL,@,NYK,W,0,2,1,3,0.333,1,2,0.5,0,1,0,0,2,0,0,0,0
19870,Metta World Peace,37-016,F,11/29/16,LAL,@,NOP,L,0,12,1,5,0.2,1,2,0.5,0,3,0,0,0,,0,3,3
19871,Brandan Wright,29-119,F-C,2/1/17,MEM,@,DEN,W,0,5,1,2,0.5,1,1,1,0,1,0,0,0,,1,1,2
19872,Delon Wright,24-294,G,2/14/17,TOR,@,CHI,L,0,10,1,2,0.5,1,1,1,0,1,0,0,0,,0,1,1
19873,Delon Wright,24-304,G,2/24/17,TOR,,BOS,W,0,12,1,5,0.2,1,5,0.2,0,0,,0,0,,0,1,1
19874,James Young,21-094,G-F,11/18/16,BOS,,GSW,L,0,12,1,3,0.333,1,1,1,0,2,0,0,0,,0,3,3
19875,James Young,21-176,G-F,2/8/17,BOS,@,SAC,L,0,2,1,1,1,1,1,1,0,0,,0,0,,0,0,0
19876,Joe Young,24-233,G,2/15/17,IND,@,CLE,L,0,3,1,2,0.5,1,1,1,0,1,0,0,0,,0,0,0
19877,Joe Young,24-156,G,11/30/16,IND,@,POR,L,0,3,0,1,0,0,0,,0,1,0,2,2,1,0,0,0
19878,Joe Young,24-151,G,11/25/16,IND,,BRK,W,0,9,1,3,0.333,1,2,0.5,0,1,0,0,0,,0,1,1
19879,Joe Young,24-144,G,11/18/16,IND,,PHO,L,0,3,1,2,0.5,1,1,1,0,1,0,0,0,,0,0,0
19880,Nick Young,31-221,G-F,1/8/17,LAL,,ORL,W,1,19,1,7,0.143,1,3,0.333,0,4,0,0,0,,0,1,1
19881,Thaddeus Young,28-267,F,3/15/17,IND,,CHO,W,1,37,1,6,0.167,1,5,0.2,0,1,0,0,0,,1,4,5
19882,Thaddeus Young,28-249,F,2/25/17,IND,@,MIA,L,1,26,1,2,0.5,1,2,0.5,0,0,,0,0,,3,2,5
19883,Cody Zeller,24-072,F-C,12/16/16,CHO,@,BOS,L,1,27,1,7,0.143,1,7,0.143,0,0,,0,0,,6,4,10
19884,Tyler Zeller,26-341,F-C,12/23/16,BOS,,OKC,L,0,7,1,2,0.5,1,2,0.5,0,0,,0,0,,0,0,0
19885,Tyler Zeller,27-023,F-C,2/9/17,BOS,@,POR,W,0,7,1,1,1,1,1,1,0,0,,0,0,,2,1,3
19886,Tyler Zeller,26-311,F-C,11/23/16,BOS,@,BRK,W,0,8,1,2,0.5,1,2,0.5,0,0,,0,0,,1,3,4
19887,Tyler Zeller,26-332,F-C,12/14/16,BOS,@,SAS,L,0,12,1,3,0.333,1,3,0.333,0,0,,0,0,,0,1,1
19888,Tyler Zeller,26-309,F-C,11/21/16,BOS,@,MIN,W,0,9,1,1,1,1,1,1,0,0,,0,0,,0,3,3
19889,Tyler Zeller,26-307,F-C,11/19/16,BOS,@,DET,W,0,4,1,3,0.333,1,3,0.333,0,0,,0,0,,1,0,1
19890,Tyler Zeller,26-286,F-C,10/29/16,BOS,@,CHO,W,0,12,1,1,1,1,1,1,0,0,,0,0,,0,4,4
19891,Tyler Zeller,27-029,F-C,2/15/17,BOS,,PHI,W,0,9,1,1,1,1,1,1,0,0,,0,0,,0,2,2
19892,Tyler Zeller,27-052,F-C,3/10/17,BOS,@,DEN,L,0,2,1,1,1,1,1,1,0,0,,0,0,,0,0,0
19893,Stephen Zimmerman,20-092,C,12/10/16,ORL,,DEN,L,0,7,1,2,0.5,1,2,0.5,0,0,,0,0,,0,1,1
19894,Stephen Zimmerman,20-061,C,11/9/16,ORL,,MIN,L,0,3,1,1,1,1,1,1,0,0,,0,1,0,0,0,0
19895,Stephen Zimmerman,20-169,C,2/25/17,ORL,,ATL,W,0,2,1,1,1,1,1,1,0,0,,0,0,,0,1,1
19896,Stephen Zimmerman,20-188,C,3/16/17,ORL,@,GSW,L,0,7,1,3,0.333,1,3,0.333,0,0,,0,0,,2,3,5
19897,Paul Zipser,23-025,G-F,3/15/17,CHI,,MEM,L,0,6,1,3,0.333,1,2,0.5,0,1,0,0,0,,0,3,3
19898,Paul Zipser,22-342,G-F,1/25/17,CHI,,ATL,L,0,23,0,4,0,0,1,0,0,3,0,2,2,1,0,3,3
19899,Ivica Zubac,19-310,C,1/22/17,LAL,@,DAL,L,0,19,1,2,0.5,1,2,0.5,0,0,,0,0,,1,3,4
19900,Ivica Zubac,19-264,C,12/7/16,LAL,@,HOU,L,0,5,0,2,0,0,2,0,0,0,,2,2,1,0,0,0
19901,Ivica Zubac,19-362,C,3/15/17,LAL,@,HOU,L,1,11,1,2,0.5,1,2,0.5,0,0,,0,0,,0,2,2
19902,Ivica Zubac,19-310,C,1/22/17,LAL,@,DAL,L,0,19,1,2,0.5,1,2,0.5,0,0,,0,0,,1,3,4
19903,Ivica Zubac,19-264,C,12/7/16,LAL,@,HOU,L,0,5,0,2,0,0,2,0,0,0,,2,2,1,0,0,0
19904,Alex Abrines,23-096,G-F,11/5/16,OKC,,MIN,W,0,17,0,1,0,0,1,0,0,0,,1,1,1,0,2,2
19905,Alexis Ajinca,28-304,C,3/6/17,NOP,@,UTA,L,0,17,0,2,0,0,2,0,0,0,,1,2,0.5,2,2,4
19906,Cole Aldrich,28-058,C,12/28/16,MIN,@,DEN,L,0,4,0,1,0,0,1,0,0,0,,1,2,0.5,2,1,3
19907,Al-Farouq Aminu,26-174,F,3/14/17,POR,@,NOP,L,0,24,0,3,0,0,0,,0,3,0,1,2,0.5,1,9,10
19908,Al-Farouq Aminu,26-036,F,10/27/16,POR,,LAC,L,1,25,0,6,0,0,1,0,0,5,0,1,2,0.5,0,8,8
19909,Alan Anderson,34-080,G-F,1/4/17,LAC,,MEM,W,0,6,0,0,,0,0,,0,0,,1,3,0.333,0,0,0
19910,Justin Anderson,23-121,G,3/20/17,PHI,@,ORL,L,0,27,0,2,0,0,0,,0,2,0,1,2,0.5,0,7,7
19911,Omer Asik,30-154,C,12/5/16,NOP,,MEM,L,1,13,0,3,0,0,3,0,0,0,,1,2,0.5,0,3,3
19912,Luke Babbitt,27-164,F,12/1/16,MIA,@,UTA,W,1,8,0,0,,0,0,,0,0,,1,2,0.5,0,0,0
19913,Luke Babbitt,27-159,F,11/26/16,MIA,,MEM,L,0,16,0,4,0,0,2,0,0,2,0,1,2,0.5,0,2,2
19914,Ron Baker,23-330,G,2/23/17,NYK,@,CLE,L,0,2,0,0,,0,0,,0,0,,1,2,0.5,0,1,1
19915,Ron Baker,23-283,G,1/7/17,NYK,@,IND,L,0,12,0,1,0,0,0,,0,1,0,1,2,0.5,0,2,2
19916,Ron Baker,23-308,G,2/1/17,NYK,@,BRK,W,0,5,0,4,0,0,3,0,0,1,0,1,3,0.333,0,0,0
19917,Will Barton,25-322,G,11/23/16,DEN,@,UTA,L,1,17,0,6,0,0,4,0,0,2,0,1,4,0.25,1,4,5
19918,Will Barton,26-016,G,1/22/17,DEN,@,MIN,L,0,26,0,2,0,0,2,0,0,0,,1,2,0.5,0,2,2
19919,Brandon Bass,31-312,F,3/8/17,LAC,@,MIN,L,0,7,0,4,0,0,4,0,0,0,,1,2,0.5,3,1,4
19920,Kent Bazemore,27-144,G-F,11/22/16,ATL,,NOP,L,1,18,0,6,0,0,3,0,0,3,0,1,2,0.5,1,0,1
19921,Malik Beasley,19-360,G,11/20/16,DEN,,UTA,W,0,2,0,0,,0,0,,0,0,,1,2,0.5,0,0,0
19922,DeAndre' Bembry,22-146,F,11/27/16,ATL,@,LAL,L,0,3,0,1,0,0,0,,0,1,0,1,2,0.5,0,0,0
19923,Davis Bertans,24-023,F,12/5/16,SAS,@,MIL,W,0,8,0,3,0,0,0,,0,3,0,1,2,0.5,0,1,1
19924,Patrick Beverley,28-138,G,11/27/16,HOU,@,POR,W,1,35,0,5,0,0,2,0,0,3,0,1,2,0.5,1,2,3
19925,Nemanja Bjelica,28-173,F,10/29/16,MIN,@,SAC,L,0,13,0,3,0,0,0,,0,3,0,1,2,0.5,0,2,2
19926,Tarik Black,25-105,C-F,3/7/17,LAL,@,DAL,L,1,13,0,3,0,0,3,0,0,0,,1,2,0.5,3,1,4
19927,Joel Bolomboy,22-327,F,12/20/16,UTA,@,GSW,L,0,4,0,1,0,0,1,0,0,0,,1,2,0.5,1,1,2
19928,Corey Brewer,30-293,F-G,12/23/16,HOU,@,MEM,L,0,5,0,3,0,0,3,0,0,0,,1,2,0.5,1,0,1
19929,Corey Brewer,30-275,F-G,12/5/16,HOU,,BOS,W,0,13,0,3,0,0,0,,0,3,0,1,2,0.5,0,2,2
19930,Nicolas Brussino,24-015,G-F,3/17/17,DAL,@,PHI,L,0,18,0,4,0,0,1,0,0,3,0,1,1,1,0,2,2
19931,Nicolas Brussino,23-245,G-F,11/2/16,DAL,@,UTA,L,0,2,0,1,0,0,1,0,0,0,,1,2,0.5,0,0,0
19932,Jimmy Butler,27-117,G-F,1/9/17,CHI,,OKC,L,1,29,0,6,0,0,4,0,0,2,0,1,2,0.5,0,2,2
19933,Kentavious Caldwell-Pope,23-263,G,11/7/16,DET,@,LAC,L,1,23,0,6,0,0,6,0,0,0,,1,3,0.333,0,1,1
19934,Michael Carter-Williams,25-077,G,12/26/16,CHI,,IND,W,0,19,0,5,0,0,3,0,0,2,0,1,2,0.5,0,5,5
19935,Rakeem Christmas,25-090,F,3/1/17,IND,@,SAS,L,0,13,0,1,0,0,1,0,0,0,,1,2,0.5,1,0,1
19936,Pat Connaughton,23-308,G,11/9/16,POR,@,LAC,L,0,8,0,0,,0,0,,0,0,,1,2,0.5,0,1,1
19937,Robert Covington,26-015,F,12/29/16,PHI,@,UTA,L,1,32,0,11,0,0,4,0,0,7,0,1,2,0.5,3,4,7
19938,Jamal Crawford,36-269,G,12/14/16,LAC,@,ORL,W,0,19,0,5,0,0,3,0,0,2,0,1,2,0.5,0,1,1
19939,Deyonta Davis,20-084,F-C,2/24/17,MEM,@,IND,L,0,3,0,0,,0,0,,0,0,,1,2,0.5,0,1,1
19940,Ed Davis,27-165,F,11/17/16,POR,@,HOU,L,0,12,0,2,0,0,2,0,0,0,,1,2,0.5,3,3,6
19941,Dewayne Dedmon,27-081,C,11/1/16,SAS,,UTA,L,0,12,0,3,0,0,3,0,0,0,,1,2,0.5,1,4,5
19942,Dewayne Dedmon,27-089,C,11/9/16,SAS,,HOU,L,0,4,0,0,,0,0,,0,0,,1,2,0.5,0,0,0
19943,Malcolm Delaney,27-249,G,11/15/16,ATL,@,MIA,W,0,15,0,3,0,0,3,0,0,0,,1,1,1,0,2,2
19944,Boris Diaw,34-266,F-C,1/7/17,UTA,@,MIN,W,0,11,0,3,0,0,2,0,0,1,0,1,2,0.5,0,1,1
19945,Spencer Dinwiddie,23-336,G,3/8/17,BRK,@,ATL,L,0,23,0,1,0,0,1,0,0,0,,1,2,0.5,0,2,2
19946,Monta Ellis,31-086,G,1/20/17,IND,@,LAL,L,0,24,0,1,0,0,1,0,0,0,,1,2,0.5,1,1,2
19947,James Ennis,26-210,F,1/27/17,MEM,@,POR,L,0,15,0,3,0,0,1,0,0,2,0,1,2,0.5,0,2,2
19948,Tyler Ennis,22-075,G,11/7/16,HOU,@,WAS,W,0,8,0,2,0,0,0,,0,2,0,1,2,0.5,0,0,0
19949,Kenneth Faried,27-081,F,2/8/17,DEN,@,ATL,L,1,10,0,2,0,0,2,0,0,0,,1,2,0.5,1,1,2
19950,Cristiano Felicio,24-181,F-C,1/4/17,CHI,@,CLE,W,0,11,0,2,0,0,2,0,0,0,,1,2,0.5,2,4,6
19951,Cristiano Felicio,24-162,F-C,12/16/16,CHI,,MIL,L,0,20,0,2,0,0,2,0,0,0,,1,2,0.5,4,1,5
19952,Cristiano Felicio,24-206,F-C,1/29/17,CHI,,PHI,W,0,16,0,0,,0,0,,0,0,,1,2,0.5,0,6,6
19953,Dorian Finney-Smith,23-275,F,2/3/17,DAL,@,POR,W,0,33,0,5,0,0,3,0,0,2,0,1,2,0.5,1,4,5
19954,Dorian Finney-Smith,23-317,F,3/17/17,DAL,@,PHI,L,0,18,0,4,0,0,3,0,0,1,0,1,2,0.5,0,1,1
19955,Dorian Finney-Smith,23-215,F,12/5/16,DAL,,CHO,L,1,26,0,5,0,0,1,0,0,4,0,1,2,0.5,0,2,2
19956,Bryn Forbes,23-239,G,3/19/17,SAS,,SAC,W,0,11,0,5,0,0,3,0,0,2,0,1,2,0.5,0,0,0
19957,Randy Foye,33-121,G,1/23/17,BRK,,SAS,L,1,30,0,4,0,0,2,0,0,2,0,1,2,0.5,0,3,3
19958,Randy Foye,33-103,G,1/5/17,BRK,@,IND,L,0,15,0,3,0,0,0,,0,3,0,1,1,1,0,3,3
19959,Tim Frazier,26-055,G,12/26/16,NOP,,DAL,W,0,4,0,0,,0,0,,0,0,,1,2,0.5,0,1,1
19960,Langston Galloway,25-034,G,1/12/17,NOP,@,BRK,W,0,17,0,6,0,0,4,0,0,2,0,1,1,1,0,4,4
19961,Aaron Gordon,21-140,F,2/3/17,ORL,,TOR,W,1,28,0,7,0,0,6,0,0,1,0,1,2,0.5,0,3,3
19962,Treveon Graham,23-060,G,12/28/16,CHO,@,ORL,W,0,4,0,0,,0,0,,0,0,,1,2,0.5,0,0,0
19963,Treveon Graham,23-135,G,3/13/17,CHO,,CHI,L,0,9,0,1,0,0,0,,0,1,0,1,2,0.5,0,0,0
19964,Jerami Grant,22-319,F,1/25/17,OKC,@,NOP,W,0,20,0,2,0,0,1,0,0,1,0,1,2,0.5,1,4,5
19965,Jerami Grant,22-261,F,11/28/16,OKC,@,NYK,W,0,14,0,0,,0,0,,0,0,,1,4,0.25,1,1,2
19966,Jerian Grant,24-042,G,11/20/16,CHI,@,LAL,W,0,5,0,0,,0,0,,0,0,,1,1,1,0,0,0
19967,Gerald Green,30-312,G-F,12/3/16,BOS,@,PHI,W,0,3,0,2,0,0,1,0,0,1,0,1,2,0.5,0,0,0
19968,Gerald Green,30-316,G-F,12/7/16,BOS,@,ORL,W,0,8,0,2,0,0,1,0,0,1,0,1,2,0.5,0,1,1
19969,Devin Harris,34-018,G,3/17/17,DAL,@,PHI,L,0,15,0,5,0,0,4,0,0,1,0,1,2,0.5,0,3,3
19970,Manny Harris,27-173,G,3/13/17,DAL,@,TOR,L,0,3,0,1,0,0,1,0,0,0,,1,2,0.5,1,1,2
19971,Aaron Harrison,22-031,G,11/28/16,CHO,@,MEM,W,0,4,0,1,0,0,1,0,0,0,,1,2,0.5,0,0,0
19972,Udonis Haslem,36-180,F-C,12/6/16,MIA,,NYK,L,0,4,0,0,,0,0,,0,0,,1,2,0.5,0,0,0
19973,Udonis Haslem,36-167,F-C,11/23/16,MIA,@,DET,L,0,7,0,3,0,0,2,0,0,1,0,1,2,0.5,0,0,0
19974,John Henson,26-003,C-F,12/31/16,MIL,@,CHI,W,1,14,0,2,0,0,2,0,0,0,,1,2,0.5,0,3,3
19975,Juan Hernangomez,21-051,F,11/18/16,DEN,,TOR,L,0,8,0,0,,0,0,,0,0,,1,2,0.5,0,3,3
19976,Juan Hernangomez,21-080,F,12/17/16,DEN,,NYK,W,0,2,0,0,,0,0,,0,0,,1,2,0.5,0,0,0
19977,Mario Hezonja,21-272,F-G,11/23/16,ORL,,PHO,L,0,4,0,1,0,0,0,,0,1,0,1,2,0.5,0,0,0
19978,Roy Hibbert,29-343,C,11/18/16,CHO,,ATL,W,0,17,0,1,0,0,1,0,0,0,,1,2,0.5,1,2,3
19979,Roy Hibbert,30-006,C,12/17/16,CHO,@,ATL,W,0,10,0,1,0,0,1,0,0,0,,1,2,0.5,0,2,2
19980,Nene Hilario,34-083,F-C,12/5/16,HOU,,BOS,W,0,8,0,2,0,0,1,0,0,1,0,1,2,0.5,0,1,1
19981,Solomon Hill,25-311,F,1/23/17,NOP,,CLE,W,1,28,0,3,0,0,1,0,0,2,0,1,2,0.5,0,2,2
19982,Darrun Hilliard,23-257,G,12/26/16,DET,,CLE,W,0,2,0,2,0,0,2,0,0,0,,1,2,0.5,0,1,1
19983,Jrue Holiday,26-216,G,1/14/17,NOP,@,CHI,L,1,29,0,7,0,0,3,0,0,4,0,1,2,0.5,0,3,3
19984,Marcelo Huertas,33-242,G,1/22/17,LAL,@,DAL,L,0,8,0,1,0,0,1,0,0,0,,1,2,0.5,0,2,2
19985,Kris Humphries,32-033,F-C,3/11/17,ATL,@,MEM,W,1,20,0,3,0,0,3,0,0,0,,1,2,0.5,1,7,8
19986,Joe Ingles,29-098,F-G,1/8/17,UTA,@,MEM,L,0,17,0,1,0,0,0,,0,1,0,1,3,0.333,1,3,4
19987,Jonas Jerebko,30-003,F,3/5/17,BOS,@,PHO,L,1,20,0,4,0,0,1,0,0,3,0,1,2,0.5,3,2,5
19988,Jonas Jerebko,30-017,F,3/19/17,BOS,@,PHI,L,0,16,0,2,0,0,1,0,0,1,0,1,2,0.5,0,1,1
19989,Joe Johnson,35-195,G-F,1/10/17,UTA,,CLE,W,0,13,0,5,0,0,1,0,0,4,0,1,2,0.5,1,1,2
19990,Joe Johnson,35-138,G-F,11/14/16,UTA,,MEM,L,0,15,0,4,0,0,3,0,0,1,0,1,2,0.5,1,0,1
19991,Stanley Johnson,20-156,F,11/1/16,DET,,NYK,W,0,17,0,4,0,0,4,0,0,0,,1,2,0.5,2,3,5
19992,Stanley Johnson,20-292,F,3/17/17,DET,,TOR,L,0,12,0,2,0,0,2,0,0,0,,1,2,0.5,0,1,1
19993,Wesley Johnson,29-181,F-G,1/8/17,LAC,,MIA,W,0,14,0,4,0,0,2,0,0,2,0,1,2,0.5,1,5,6
19994,Wesley Johnson,29-217,F-G,2/13/17,LAC,@,UTA,W,0,10,0,1,0,0,0,,0,1,0,1,2,0.5,0,2,2
19995,Damian Jones,21-230,F-C,2/15/17,GSW,,SAC,W,0,6,0,0,,0,0,,0,0,,1,2,0.5,2,0,2
19996,James Jones,36-077,F-G,12/20/16,CLE,@,MIL,W,0,2,0,0,,0,0,,0,0,,1,2,0.5,0,0,0
19997,Tyus Jones,20-276,G,2/10/17,MIN,,NOP,L,0,10,0,2,0,0,0,,0,2,0,1,2,0.5,0,0,0
19998,Cory Joseph,25-084,G,11/12/16,TOR,,NYK,W,0,20,0,3,0,0,2,0,0,1,0,1,2,0.5,0,1,1
19999,Frank Kaminsky,23-241,F-C,12/1/16,CHO,,DAL,W,1,22,0,4,0,0,4,0,0,0,,1,2,0.5,1,2,3
20000,Ryan Kelly,25-336,F,3/11/17,ATL,@,MEM,W,0,3,0,1,0,0,1,0,0,0,,1,2,0.5,0,1,1
20001,Kosta Koufos,27-357,C,2/15/17,SAC,@,GSW,L,1,11,0,2,0,0,2,0,0,0,,1,2,0.5,0,2,2
20002,Kosta Koufos,27-266,C,11/16/16,SAC,,SAS,L,1,15,0,4,0,0,4,0,0,0,,1,2,0.5,1,4,5
20003,Mindaugas Kuzminskas,27-104,F,1/31/17,NYK,@,WAS,L,0,14,0,5,0,0,3,0,0,2,0,1,2,0.5,0,1,1
20004,Mindaugas Kuzminskas,27-055,F,12/13/16,NYK,@,PHO,L,0,4,0,3,0,0,1,0,0,2,0,1,2,0.5,0,0,0
20005,Joffrey Lauvergne,25-164,C-F,3/13/17,CHI,@,CHO,W,0,3,0,2,0,0,2,0,0,0,,1,2,0.5,2,0,2
20006,Ty Lawson,29-002,G,11/5/16,SAC,@,MIL,L,1,20,0,4,0,0,4,0,0,0,,1,2,0.5,1,1,2
20007,Jake Layman,22-285,F,12/17/16,POR,@,GSW,L,0,12,0,5,0,0,2,0,0,3,0,1,2,0.5,0,0,0
20008,Jake Layman,22-310,F,1/11/17,POR,,CLE,W,0,4,0,1,0,0,0,,0,1,0,1,2,0.5,0,0,0
20009,Courtney Lee,31-039,G,11/11/16,NYK,@,BOS,L,1,22,0,4,0,0,3,0,0,1,0,1,1,1,1,0,1
20010,David Lee,33-281,F,2/4/17,SAS,,DEN,W,0,21,0,5,0,0,5,0,0,0,,1,2,0.5,2,3,5
20011,David Lee,33-314,F,3/9/17,SAS,@,OKC,L,0,11,0,3,0,0,3,0,0,0,,1,2,0.5,1,1,2
20012,Alex Len,23-230,C,2/1/17,PHO,,LAC,L,0,6,0,2,0,0,2,0,0,0,,1,2,0.5,2,1,3
20013,Alex Len,23-186,C,12/19/16,PHO,@,MIN,L,0,20,0,1,0,0,1,0,0,0,,1,2,0.5,1,4,5
20014,Shaun Livingston,31-059,G,11/9/16,GSW,,DAL,W,0,21,0,2,0,0,2,0,0,0,,1,4,0.25,0,0,0
20015,Kevon Looney,20-289,F-C,11/21/16,GSW,@,IND,W,0,10,0,1,0,0,1,0,0,0,,1,2,0.5,1,6,7
20016,Kevin Love,28-144,F,1/29/17,CLE,,OKC,W,1,12,0,4,0,0,1,0,0,3,0,1,2,0.5,0,8,8
20017,Trey Lyles,21-072,F,1/16/17,UTA,@,PHO,W,0,6,0,0,,0,0,,0,0,,1,2,0.5,0,3,3
20018,Trey Lyles,21-091,F,2/4/17,UTA,,CHO,W,0,11,0,2,0,0,1,0,0,1,0,1,2,0.5,1,4,5
20019,Ian Mahinmi,30-111,C,2/24/17,WAS,@,PHI,L,0,7,0,0,,0,0,,0,0,,1,4,0.25,0,3,3
20020,Ian Mahinmi,30-021,C,11/26/16,WAS,,SAS,L,0,14,0,1,0,0,1,0,0,0,,1,2,0.5,0,1,1
20021,Ian Mahinmi,30-116,C,3/1/17,WAS,@,TOR,W,0,21,0,4,0,0,4,0,0,0,,1,2,0.5,2,3,5
20022,Thon Maker,19-295,F-C,12/16/16,MIL,@,CHI,W,0,4,0,0,,0,0,,0,0,,1,2,0.5,0,2,2
20023,Jarell Martin,22-181,F,11/21/16,MEM,@,CHO,W,0,8,0,1,0,0,0,,0,1,0,1,2,0.5,0,0,0
20024,Luc Mbah a Moute,30-048,F,10/27/16,LAC,@,POR,W,1,17,0,2,0,0,2,0,0,0,,1,2,0.5,1,2,3
20025,Luc Mbah a Moute,30-193,F,3/21/17,LAC,@,LAL,W,1,17,0,2,0,0,1,0,0,1,0,1,2,0.5,1,1,2
20026,Patrick McCaw,21-034,G,11/28/16,GSW,,ATL,W,0,4,0,1,0,0,0,,0,1,0,1,2,0.5,0,0,0
20027,Sheldon McClellan,24-024,G,1/14/17,WAS,,PHI,W,0,7,0,2,0,0,1,0,0,1,0,1,2,0.5,0,0,0
20028,Chris McCullough,22-024,F,3/1/17,WAS,@,TOR,W,0,2,0,0,,0,0,,0,0,,1,2,0.5,0,0,0
20029,JaVale McGee,28-338,C,12/22/16,GSW,@,BRK,W,0,4,0,0,,0,0,,0,0,,1,2,0.5,0,0,0
20030,JaVale McGee,28-317,C,12/1/16,GSW,,HOU,L,0,4,0,0,,0,0,,0,0,,1,2,0.5,0,1,1
20031,Ben McLemore,23-303,G,12/10/16,SAC,@,UTA,L,1,26,0,5,0,0,2,0,0,3,0,1,4,0.25,1,1,2
20032,Jordan McRae,25-284,G,1/6/17,CLE,@,BRK,W,0,10,0,5,0,0,2,0,0,3,0,1,2,0.5,0,1,1
20033,Josh McRoberts,29-276,F,11/30/16,MIA,@,DEN,W,1,16,0,4,0,0,4,0,0,0,,1,2,0.5,1,2,3
20034,Salah Mejri,30-161,C,11/23/16,DAL,,LAC,L,0,5,0,1,0,0,1,0,0,0,,1,2,0.5,2,1,3
20035,Salah Mejri,30-259,C,3/1/17,DAL,@,ATL,L,0,13,0,0,,0,0,,0,0,,1,2,0.5,1,2,3
20036,Salah Mejri,30-273,C,3/15/17,DAL,@,WAS,W,0,6,0,1,0,0,1,0,0,0,,1,2,0.5,1,2,3
20037,Jordan Mickey,22-128,F,11/14/16,BOS,@,NOP,L,0,9,0,2,0,0,2,0,0,0,,1,2,0.5,1,3,4
20038,Jordan Mickey,22-244,F,3/10/17,BOS,@,DEN,L,0,2,0,0,,0,0,,0,0,,1,2,0.5,0,0,0
20039,Patty Mills,28-116,G,12/5/16,SAS,@,MIL,W,0,21,0,8,0,0,3,0,0,5,0,1,2,0.5,0,1,1
20040,Nikola Mirotic,25-351,F,1/27/17,CHI,,MIA,L,0,15,0,2,0,0,0,,0,2,0,1,2,0.5,0,5,5
20041,E'Twaun Moore,27-291,G,12/15/16,NOP,,IND,W,0,18,0,5,0,0,2,0,0,3,0,1,2,0.5,0,0,0
20042,Donatas Motiejunas,26-114,F-C,1/12/17,NOP,@,BRK,W,0,19,0,7,0,0,4,0,0,3,0,1,2,0.5,0,3,3
20043,Shabazz Muhammad,24-026,F-G,12/9/16,MIN,,DET,L,0,17,0,2,0,0,1,0,0,1,0,1,2,0.5,1,2,3
20044,Jamal Murray,19-246,G,10/26/16,DEN,@,NOP,W,0,13,0,2,0,0,1,0,0,1,0,1,2,0.5,0,4,4
20045,Jamal Murray,19-251,G,10/31/16,DEN,@,TOR,L,0,12,0,4,0,0,3,0,0,1,0,1,1,1,0,2,2
20046,Mike Muscala,25-258,F-C,3/16/17,ATL,,MEM,L,0,9,0,1,0,0,0,,0,1,0,1,2,0.5,0,1,1
20047,Raul Neto,24-286,G,3/1/17,UTA,,MIN,L,0,8,0,0,,0,0,,0,0,,1,2,0.5,0,1,1
20048,Andrew Nicholson,27-054,F,1/31/17,WAS,,NYK,W,0,2,0,0,,0,0,,0,0,,1,2,0.5,1,1,2
20049,Joakim Noah,31-325,C,1/15/17,NYK,@,TOR,L,1,23,0,1,0,0,1,0,0,0,,1,4,0.25,3,4,7
20050,Lucas Nogueira,24-120,C,11/23/16,TOR,@,HOU,W,0,17,0,1,0,0,1,0,0,0,,1,2,0.5,2,0,2
20051,Lucas Nogueira,24-118,C,11/21/16,TOR,@,LAC,L,0,13,0,1,0,0,1,0,0,0,,1,2,0.5,0,0,0
20052,Jusuf Nurkic,22-161,C,1/31/17,DEN,@,LAL,L,1,12,0,7,0,0,7,0,0,0,,1,2,0.5,2,2,4
20053,Johnny O'Bryant,23-278,F-C,3/6/17,CHO,,IND,W,0,14,0,4,0,0,3,0,0,1,0,1,2,0.5,1,1,2
20054,Kelly Oubre,21-063,F,2/10/17,WAS,,IND,W,0,21,0,2,0,0,0,,0,2,0,1,2,0.5,0,4,4
20055,Kelly Oubre,20-353,F,11/26/16,WAS,,SAS,L,0,3,0,1,0,0,0,,0,1,0,1,2,0.5,0,1,1
20056,Tony Parker,34-261,G,2/2/17,SAS,,PHI,W,1,26,0,5,0,0,5,0,0,0,,1,2,0.5,0,4,4
20057,Patrick Patterson,27-249,F,11/18/16,TOR,@,DEN,W,0,30,0,4,0,0,0,,0,4,0,1,2,0.5,0,6,6
20058,Miles Plumlee,28-058,C-F,10/29/16,MIL,,BRK,W,1,8,0,1,0,0,1,0,0,0,,1,2,0.5,0,1,1
20059,Miles Plumlee,28-072,C-F,11/12/16,MIL,,MEM,W,0,9,0,0,,0,0,,0,0,,1,2,0.5,0,1,1
20060,Jakob Poeltl,21-016,C,10/31/16,TOR,,DEN,W,0,17,0,3,0,0,3,0,0,0,,1,2,0.5,1,4,5
20061,Dwight Powell,25-242,F-C,3/19/17,DAL,@,BRK,W,0,12,0,0,,0,0,,0,0,,1,2,0.5,1,1,2
20062,Norman Powell,23-205,G,12/16/16,TOR,,ATL,L,0,12,0,1,0,0,0,,0,1,0,1,2,0.5,0,0,0
20063,Norman Powell,23-215,G,12/26/16,TOR,@,POR,W,0,11,0,2,0,0,1,0,0,1,0,1,2,0.5,0,1,1
20064,Ronnie Price,33-269,G,3/17/17,PHO,,ORL,L,0,20,0,2,0,0,1,0,0,1,0,1,2,0.5,1,2,3
20065,Willie Reed,26-210,F-C,12/12/16,MIA,,WAS,W,0,5,0,1,0,0,1,0,0,0,,1,2,0.5,0,1,1
20066,Malachi Richardson,21-015,G,1/20/17,SAC,@,MEM,L,0,6,0,1,0,0,0,,0,1,0,1,2,0.5,0,1,1
20067,Andre Roberson,25-023,G-F,12/27/16,OKC,@,MIA,W,1,22,0,3,0,0,3,0,0,0,,1,2,0.5,0,3,3
20068,Andre Roberson,25-042,G-F,1/15/17,OKC,@,SAC,W,1,27,0,6,0,0,4,0,0,2,0,1,4,0.25,5,0,5
20069,Andre Roberson,25-058,G-F,1/31/17,OKC,@,SAS,L,1,24,0,4,0,0,0,,0,4,0,1,2,0.5,2,4,6
20070,Andre Roberson,24-327,G-F,10/26/16,OKC,@,PHI,W,1,32,0,2,0,0,2,0,0,0,,1,4,0.25,2,5,7
20071,Brian Roberts,30-354,G,11/21/16,CHO,,MEM,L,0,3,0,2,0,0,1,0,0,1,0,1,2,0.5,1,1,2
20072,Brian Roberts,31-048,G,1/20/17,CHO,,TOR,W,0,5,0,1,0,0,1,0,0,0,,1,2,0.5,0,1,1
20073,Sergio Rodriguez,30-264,G,3/3/17,PHI,,NYK,W,0,16,0,5,0,0,3,0,0,2,0,1,2,0.5,0,0,0
20074,Ricky Rubio,26-072,G,1/1/17,MIN,,POR,L,1,27,0,5,0,0,3,0,0,2,0,1,1,1,0,0,0
20075,Tomas Satoransky,25-122,G,3/1/17,WAS,@,TOR,W,0,18,0,2,0,0,1,0,0,1,0,1,2,0.5,1,4,5
20076,Dennis Schroder,23-066,G,11/20/16,ATL,@,NYK,L,1,21,0,8,0,0,5,0,0,3,0,1,2,0.5,0,2,2
20077,Luis Scola,36-209,F,11/25/16,BRK,@,IND,L,0,11,0,1,0,0,0,,0,1,0,1,2,0.5,1,2,3
20078,Luis Scola,36-279,F,2/3/17,BRK,,IND,L,0,11,0,3,0,0,2,0,0,1,0,1,2,0.5,1,3,4
20079,Luis Scola,36-273,F,1/28/17,BRK,@,MIN,L,0,5,0,0,,0,0,,0,0,,1,2,0.5,0,2,2
20080,Ramon Sessions,30-296,G,2/1/17,CHO,@,GSW,L,0,8,0,3,0,0,2,0,0,1,0,1,2,0.5,0,0,0
20081,Jonathon Simmons,27-091,G-F,12/14/16,SAS,,BOS,W,0,6,0,0,,0,0,,0,0,,1,2,0.5,0,0,0
20082,Lance Stephenson,26-158,G-F,2/10/17,MIN,,NOP,L,0,12,0,3,0,0,2,0,0,1,0,1,2,0.5,0,3,3
20083,Jarnell Stokes,22-306,F-C,11/8/16,DEN,@,MEM,L,0,1,0,0,,0,0,,0,0,,1,2,0.5,0,0,0
20084,Jason Terry,39-113,G,1/6/17,MIL,,NYK,L,0,18,0,0,,0,0,,0,0,,1,1,1,0,2,2
20085,Hollis Thompson,25-259,G-F,12/18/16,PHI,,BRK,W,0,17,0,3,0,0,1,0,0,2,0,1,2,0.5,0,3,3
20086,Hollis Thompson,25-336,G-F,3/5/17,NOP,@,LAL,W,1,25,0,4,0,0,3,0,0,1,0,1,2,0.5,2,1,3
20087,P.J. Tucker,31-309,F,3/10/17,TOR,@,ATL,L,0,25,0,3,0,0,1,0,0,2,0,1,2,0.5,1,4,5
20088,Beno Udrih,34-127,G,11/9/16,DET,@,PHO,L,0,16,0,5,0,0,4,0,0,1,0,1,1,1,0,1,1
20089,Anderson Varejao,34-027,F-C,10/25/16,GSW,,SAS,L,0,3,0,0,,0,0,,0,0,,1,2,0.5,0,0,0
20090,Noah Vonleh,21-101,F,12/3/16,POR,,MIA,W,0,4,0,0,,0,0,,0,0,,1,2,0.5,0,2,2
20091,Noah Vonleh,21-173,F,2/13/17,POR,,ATL,L,1,14,0,1,0,0,1,0,0,0,,1,2,0.5,0,4,4
20092,Sasha Vujacic,32-231,G,10/25/16,NYK,@,CLE,L,0,3,0,1,0,0,0,,0,1,0,1,2,0.5,0,0,0
20093,Taurean Waller-Prince,22-348,F,3/5/17,ATL,,IND,L,0,9,0,1,0,0,1,0,0,0,,1,2,0.5,0,2,2
20094,Taurean Waller-Prince,22-344,F,3/1/17,ATL,,DAL,W,0,12,0,1,0,0,0,,0,1,0,1,2,0.5,0,1,1
20095,Taurean Waller-Prince,22-276,F,12/23/16,ATL,@,DEN,W,0,1,0,0,,0,0,,0,0,,1,2,0.5,0,0,0
20096,C.J. Watson,32-198,G,11/1/16,ORL,@,PHI,W,0,8,0,0,,0,0,,0,0,,1,2,0.5,0,0,0
20097,David West,36-130,F,1/6/17,GSW,,MEM,L,0,11,0,1,0,0,1,0,0,0,,1,2,0.5,0,4,4
20098,Alan Williams,24-007,F-C,2/4/17,PHO,,MIL,L,0,3,0,1,0,0,1,0,0,0,,1,2,0.5,0,0,0
20099,Alan Williams,23-320,F-C,12/13/16,PHO,,NYK,W,0,9,0,0,,0,0,,0,0,,1,2,0.5,0,1,1
20100,Deron Williams,32-263,G,3/16/17,CLE,,UTA,W,0,25,0,3,0,0,2,0,0,1,0,1,2,0.5,0,3,3
20101,Reggie Williams,30-093,F,12/16/16,NOP,@,HOU,L,0,12,0,4,0,0,2,0,0,2,0,1,2,0.5,1,0,1
20102,Justise Winslow,20-278,F,12/29/16,MIA,@,CHO,L,1,29,0,9,0,0,9,0,0,0,,1,2,0.5,1,4,5
20103,Jeff Withey,26-313,C,1/14/17,UTA,,ORL,W,0,0,0,0,,0,0,,0,0,,1,2,0.5,0,0,0
20104,Delon Wright,24-318,G,3/10/17,TOR,@,ATL,L,0,13,0,2,0,0,2,0,0,0,,1,2,0.5,0,2,2
20105,Delon Wright,24-312,G,3/4/17,TOR,@,MIL,L,0,11,0,3,0,0,1,0,0,2,0,1,2,0.5,0,0,0
20106,Joe Young,24-210,G,1/23/17,IND,,NYK,L,0,6,0,2,0,0,2,0,0,0,,1,2,0.5,0,0,0
20107,Tyler Zeller,26-318,F-C,11/30/16,BOS,,DET,L,0,5,0,0,,0,0,,0,0,,1,2,0.5,1,0,1
20108,Ivica Zubac,19-240,C,11/13/16,LAL,@,MIN,L,0,8,0,2,0,0,2,0,0,0,,1,2,0.5,0,2,2
20109,Ivica Zubac,19-322,C,2/3/17,LAL,@,BOS,L,0,4,0,0,,0,0,,0,0,,1,2,0.5,0,2,2
20110,Alex Abrines,23-216,G-F,3/5/17,OKC,@,DAL,L,1,10,0,3,0,0,1,0,0,2,0,0,0,,0,0,0
20111,Alex Abrines,23-138,G-F,12/17/16,OKC,,PHO,W,0,12,0,2,0,0,0,,0,2,0,0,0,,1,0,1
20112,Alex Abrines,23-165,G-F,1/13/17,OKC,@,MIN,L,0,4,0,1,0,0,1,0,0,0,,0,0,,0,0,0
20113,Alex Abrines,23-181,G-F,1/29/17,OKC,@,CLE,L,0,8,0,1,0,0,0,,0,1,0,0,0,,0,0,0
20114,Alex Abrines,23-132,G-F,12/11/16,OKC,,BOS,W,0,5,0,0,,0,0,,0,0,,0,0,,0,0,0
20115,Alex Abrines,23-117,G-F,11/26/16,OKC,,DET,W,0,1,0,0,,0,0,,0,0,,0,0,,0,0,0
20116,Alex Abrines,23-114,G-F,11/23/16,OKC,@,SAC,L,0,4,0,2,0,0,0,,0,2,0,0,0,,0,0,0
20117,Alex Abrines,23-113,G-F,11/22/16,OKC,@,LAL,L,0,7,0,2,0,0,1,0,0,1,0,0,0,,0,0,0
20118,Quincy Acy,26-020,F,10/26/16,DAL,@,IND,L,0,1,0,0,,0,0,,0,0,,0,0,,0,0,0
20119,Quincy Acy,26-109,F,1/23/17,BRK,,SAS,L,0,11,0,1,0,0,0,,0,1,0,0,0,,0,0,0
20120,Quincy Acy,26-027,F,11/2/16,DAL,@,UTA,L,0,2,0,1,0,0,0,,0,1,0,0,0,,0,1,1
20121,Quincy Acy,26-159,F,3/14/17,BRK,,OKC,L,0,19,0,4,0,0,1,0,0,3,0,0,0,,1,3,4
20122,Quincy Acy,26-122,F,2/5/17,BRK,,TOR,L,0,2,0,1,0,0,0,,0,1,0,0,0,,0,1,1
20123,Arron Afflalo,31-056,G,12/10/16,SAC,@,UTA,L,0,4,0,0,,0,0,,0,0,,0,0,,0,0,0
20124,Alexis Ajinca,28-221,C,12/13/16,NOP,,GSW,L,1,13,0,1,0,0,1,0,0,0,,0,0,,0,1,1
20125,Alexis Ajinca,28-251,C,1/12/17,NOP,@,BRK,W,0,3,0,0,,0,0,,0,0,,0,0,,0,1,1
20126,Alexis Ajinca,28-229,C,12/21/16,NOP,,OKC,L,1,5,0,0,,0,0,,0,0,,0,0,,0,1,1
20127,Alexis Ajinca,28-303,C,3/5/17,NOP,@,LAL,W,0,11,0,3,0,0,3,0,0,0,,0,0,,0,1,1
20128,Alexis Ajinca,28-228,C,12/20/16,NOP,@,PHI,W,1,12,0,2,0,0,2,0,0,0,,0,0,,1,6,7
20129,Alexis Ajinca,28-173,C,10/26/16,NOP,,DEN,L,0,11,0,2,0,0,2,0,0,0,,0,0,,1,0,1
20130,Alexis Ajinca,28-319,C,3/21/17,NOP,,MEM,W,0,14,0,3,0,0,3,0,0,0,,0,0,,3,6,9
20131,Alexis Ajinca,28-205,C,11/27/16,NOP,@,DAL,L,0,4,0,3,0,0,3,0,0,0,,0,0,,1,1,2
20132,Alexis Ajinca,28-296,C,2/26/17,NOP,@,OKC,L,0,5,0,1,0,0,1,0,0,0,,0,0,,0,1,1
20133,Cole Aldrich,28-098,C,2/6/17,MIN,,MIA,L,0,5,0,0,,0,0,,0,0,,0,0,,1,1,2
20134,Cole Aldrich,28-124,C,3/4/17,MIN,@,SAS,L,0,2,0,0,,0,0,,0,0,,0,0,,0,0,0
20135,Cole Aldrich,28-009,C,11/9/16,MIN,@,ORL,W,0,12,0,2,0,0,2,0,0,0,,0,0,,1,4,5
20136,Cole Aldrich,28-064,C,1/3/17,MIN,@,PHI,L,0,8,0,2,0,0,2,0,0,0,,0,0,,0,2,2
20137,Cole Aldrich,28-083,C,1/22/17,MIN,,DEN,W,0,6,0,0,,0,0,,0,0,,0,0,,0,0,0
20138,Cole Aldrich,28-121,C,3/1/17,MIN,@,UTA,W,0,5,0,0,,0,0,,0,0,,0,0,,0,1,1
20139,Cole Aldrich,28-062,C,1/1/17,MIN,,POR,L,0,10,0,1,0,0,1,0,0,0,,0,0,,2,4,6
20140,Cole Aldrich,28-080,C,1/19/17,MIN,@,LAC,W,0,5,0,1,0,0,1,0,0,0,,0,0,,0,1,1
20141,Cole Aldrich,28-096,C,2/4/17,MIN,,MEM,L,0,3,0,0,,0,0,,0,0,,0,0,,1,0,1
20142,Cole Aldrich,28-119,C,2/27/17,MIN,@,SAC,W,0,1,0,0,,0,0,,0,0,,0,0,,0,0,0
20143,Cole Aldrich,28-060,C,12/30/16,MIN,,MIL,W,0,5,0,0,,0,0,,0,0,,0,0,,0,1,1
20144,Cole Aldrich,28-076,C,1/15/17,MIN,@,DAL,L,0,5,0,0,,0,0,,0,0,,0,0,,0,3,3
20145,Cole Aldrich,28-095,C,2/3/17,MIN,@,DET,L,0,8,0,0,,0,0,,0,0,,0,0,,0,1,1
20146,Cole Aldrich,28-116,C,2/24/17,MIN,,DAL,W,0,3,0,0,,0,0,,0,0,,0,0,,0,1,1
20147,Cole Aldrich,28-074,C,1/13/17,MIN,,OKC,W,0,9,0,0,,0,0,,0,0,,0,1,0,0,2,2
20148,Cole Aldrich,28-093,C,2/1/17,MIN,@,CLE,L,0,3,0,1,0,0,1,0,0,0,,0,0,,1,1,2
20149,Cole Aldrich,28-106,C,2/14/17,MIN,,CLE,L,0,5,0,1,0,0,1,0,0,0,,0,0,,0,0,0
20150,Cole Aldrich,28-141,C,3/21/17,MIN,,SAS,L,0,2,0,1,0,0,1,0,0,0,,0,0,,0,0,0
20151,Cole Aldrich,28-053,C,12/23/16,MIN,,SAC,L,0,5,0,1,0,0,1,0,0,0,,0,0,,1,1,2
20152,Cole Aldrich,27-364,C,10/29/16,MIN,@,SAC,L,0,12,0,0,,0,0,,0,0,,0,0,,1,4,5
20153,Cole Aldrich,28-070,C,1/9/17,MIN,,DAL,W,0,4,0,0,,0,0,,0,0,,0,0,,1,1,2
20154,Cole Aldrich,28-089,C,1/28/17,MIN,,BRK,W,0,2,0,1,0,0,1,0,0,0,,0,0,,0,0,0
20155,Cole Aldrich,28-028,C,11/28/16,MIN,,UTA,L,0,4,0,0,,0,0,,0,0,,0,0,,1,0,1
20156,Cole Aldrich,28-047,C,12/17/16,MIN,,HOU,L,0,14,0,0,,0,0,,0,0,,0,0,,2,3,5
20157,Cole Aldrich,28-068,C,1/7/17,MIN,,UTA,L,0,4,0,1,0,0,1,0,0,0,,0,0,,0,2,2
20158,Cole Aldrich,28-087,C,1/26/17,MIN,,IND,L,0,5,0,0,,0,0,,0,0,,0,0,,0,0,0
20159,Cole Aldrich,28-100,C,2/8/17,MIN,,TOR,W,0,5,0,0,,0,0,,0,0,,0,0,,0,0,0
20160,Cole Aldrich,28-128,C,3/8/17,MIN,,LAC,W,0,3,0,1,0,0,1,0,0,0,,0,0,,1,1,2
20161,Cole Aldrich,28-026,C,11/26/16,MIN,@,GSW,L,0,10,0,0,,0,0,,0,0,,0,0,,1,2,3
20162,Lavoy Allen,27-343,F-C,1/12/17,IND,@,DEN,L,0,3,0,0,,0,0,,0,0,,0,0,,0,0,0
20163,Lavoy Allen,27-336,F-C,1/5/17,IND,,BRK,W,0,2,0,0,,0,0,,0,0,,0,0,,0,0,0
20164,Lavoy Allen,27-304,F-C,12/4/16,IND,@,LAC,W,0,3,0,0,,0,0,,0,0,,0,0,,0,0,0
20165,Lavoy Allen,27-332,F-C,1/1/17,IND,,ORL,W,0,3,0,0,,0,0,,0,0,,0,0,,0,0,0
20166,Lavoy Allen,27-268,F-C,10/29/16,IND,@,CHI,L,0,6,0,1,0,0,1,0,0,0,,0,0,,0,1,1
20167,Lavoy Allen,27-322,F-C,12/22/16,IND,,BOS,L,0,6,0,0,,0,0,,0,0,,0,0,,1,1,2
20168,Lavoy Allen,27-267,F-C,10/28/16,IND,@,BRK,L,0,6,0,2,0,0,1,0,0,1,0,0,2,0,0,1,1
20169,Lavoy Allen,27-297,F-C,11/27/16,IND,,LAC,W,0,16,0,3,0,0,3,0,0,0,,0,0,,3,0,3
20170,Lavoy Allen,27-320,F-C,12/20/16,IND,@,NYK,L,0,11,0,1,0,0,1,0,0,0,,0,0,,0,3,3
20171,Lavoy Allen,28-036,F-C,3/12/17,IND,,MIA,W,0,3,0,1,0,0,1,0,0,0,,0,0,,1,1,2
20172,Lavoy Allen,27-319,F-C,12/19/16,IND,,WAS,W,0,6,0,1,0,0,1,0,0,0,,0,0,,0,0,0
20173,Lavoy Allen,27-352,F-C,1/21/17,IND,@,UTA,L,0,6,0,0,,0,0,,0,0,,0,0,,0,1,1
20174,Lavoy Allen,27-279,F-C,11/9/16,IND,,PHI,W,0,13,0,3,0,0,3,0,0,0,,0,0,,2,1,3
20175,Lavoy Allen,27-293,F-C,11/23/16,IND,,ATL,L,0,7,0,0,,0,0,,0,0,,0,0,,0,1,1
20176,Lavoy Allen,27-317,F-C,12/17/16,IND,@,DET,W,0,10,0,1,0,0,1,0,0,0,,0,0,,2,0,2
20177,Lavoy Allen,27-351,F-C,1/20/17,IND,@,LAL,L,0,2,0,0,,0,0,,0,0,,0,0,,0,1,1
20178,Lavoy Allen,27-291,F-C,11/21/16,IND,,GSW,L,0,17,0,5,0,0,5,0,0,0,,0,0,,2,1,3
20179,Tony Allen,35-035,G-F,2/15/17,MEM,,NOP,L,1,19,0,4,0,0,4,0,0,0,,0,0,,1,2,3
20180,Tony Allen,35-010,G-F,1/21/17,MEM,,HOU,L,1,25,0,6,0,0,5,0,0,1,0,0,0,,2,2,4
20181,Chris Andersen,38-132,F-C,11/16/16,CLE,@,IND,L,0,6,0,1,0,0,1,0,0,0,,0,0,,2,3,5
20182,Chris Andersen,38-159,F-C,12/13/16,CLE,,MEM,W,0,3,0,0,,0,0,,0,0,,0,0,,0,0,0
20183,Alan Anderson,34-115,G-F,2/8/17,LAC,@,NYK,W,0,6,0,1,0,0,0,,0,1,0,0,0,,0,0,0
20184,Alan Anderson,34-052,G-F,12/7/16,LAC,,GSW,L,0,13,0,2,0,0,0,,0,2,0,0,0,,1,0,1
20185,Alan Anderson,34-108,G-F,2/1/17,LAC,@,PHO,W,0,12,0,1,0,0,0,,0,1,0,0,0,,0,3,3
20186,Alan Anderson,34-068,G-F,12/23/16,LAC,,DAL,L,0,8,0,1,0,0,0,,0,1,0,0,0,,0,0,0
20187,Alan Anderson,34-136,G-F,3/1/17,LAC,,HOU,L,0,3,0,1,0,0,1,0,0,0,,0,0,,0,0,0
20188,Alan Anderson,34-065,G-F,12/20/16,LAC,,DEN,W,0,7,0,2,0,0,1,0,0,1,0,0,0,,0,1,1
20189,Alan Anderson,34-059,G-F,12/14/16,LAC,@,ORL,W,0,9,0,1,0,0,1,0,0,0,,0,0,,0,0,0
20190,Alan Anderson,34-057,G-F,12/12/16,LAC,,POR,W,0,12,0,2,0,0,1,0,0,1,0,0,0,,0,2,2
20191,Justin Anderson,23-076,G,2/3/17,DAL,@,POR,W,0,3,0,1,0,0,0,,0,1,0,0,0,,0,1,1
20192,Justin Anderson,23-061,G,1/19/17,DAL,@,MIA,L,0,4,0,0,,0,0,,0,0,,0,0,,0,0,0
20193,Justin Anderson,23-115,G,3/14/17,PHI,@,GSW,L,0,7,0,0,,0,0,,0,0,,0,0,,0,0,0
20194,Justin Anderson,23-057,G,1/15/17,DAL,,MIN,W,0,1,0,0,,0,0,,0,0,,0,0,,0,0,0
20195,Justin Anderson,23-072,G,1/30/17,DAL,,CLE,W,0,3,0,1,0,0,0,,0,1,0,0,0,,0,1,1
20196,Justin Anderson,23-098,G,2/25/17,PHI,@,NYK,L,0,4,0,1,0,0,0,,0,1,0,0,0,,0,1,1
20197,Justin Anderson,23-054,G,1/12/17,DAL,@,PHO,W,0,2,0,1,0,0,0,,0,1,0,0,0,,0,1,1
20198,Justin Anderson,23-088,G,2/15/17,DAL,@,DET,L,0,6,0,0,,0,0,,0,0,,0,0,,0,1,1
20199,Justin Anderson,23-110,G,3/9/17,PHI,@,POR,L,0,8,0,1,0,0,0,,0,1,0,0,0,,0,1,1
20200,Justin Anderson,22-361,G,11/14/16,DAL,@,NYK,L,0,23,0,11,0,0,6,0,0,5,0,0,0,,3,4,7
20201,Justin Anderson,23-110,G,3/9/17,PHI,@,POR,L,0,8,0,1,0,0,0,,0,1,0,0,0,,0,1,1
20202,Kyle Anderson,23-055,F-G,11/14/16,SAS,,MIA,W,0,6,0,1,0,0,1,0,0,0,,0,0,,1,1,2
20203,Kyle Anderson,23-131,F-G,1/29/17,SAS,,DAL,L,0,14,0,1,0,0,1,0,0,0,,0,0,,0,3,3
20204,Kyle Anderson,23-176,F-G,3/15/17,SAS,,POR,L,0,11,0,1,0,0,1,0,0,0,,0,0,,0,3,3
20205,Kyle Anderson,23-109,F-G,1/7/17,SAS,,CHO,W,0,4,0,0,,0,0,,0,0,,0,0,,0,0,0
20206,Kyle Anderson,23-174,F-G,3/13/17,SAS,,ATL,W,0,5,0,0,,0,0,,0,0,,0,0,,0,1,1
20207,Kyle Anderson,23-050,F-G,11/9/16,SAS,,HOU,L,0,13,0,2,0,0,2,0,0,0,,0,0,,1,4,5
20208,Kyle Anderson,23-070,F-G,11/29/16,SAS,,ORL,L,0,3,0,0,,0,0,,0,0,,0,0,,0,1,1
20209,Kyle Anderson,23-089,F-G,12/18/16,SAS,,NOP,W,0,12,0,1,0,0,1,0,0,0,,0,0,,0,1,1
20210,Kyle Anderson,23-143,F-G,2/10/17,SAS,@,DET,W,0,1,0,1,0,0,1,0,0,0,,0,0,,0,0,0
20211,Kyle Anderson,23-046,F-G,11/5/16,SAS,,LAC,L,1,16,0,0,,0,0,,0,0,,0,0,,0,2,2
20212,Kyle Anderson,23-064,F-G,11/23/16,SAS,@,CHO,W,0,0,0,0,,0,0,,0,0,,0,0,,0,0,0
20213,Kyle Anderson,23-085,F-G,12/14/16,SAS,,BOS,W,0,6,0,0,,0,0,,0,0,,0,0,,0,2,2
20214,Kyle Anderson,23-103,F-G,1/1/17,SAS,@,ATL,L,0,8,0,0,,0,0,,0,0,,0,0,,0,1,1
20215,Kyle Anderson,23-182,F-G,3/21/17,SAS,@,MIN,W,0,4,0,0,,0,0,,0,0,,0,0,,0,1,1
20216,Kyle Anderson,23-121,F-G,1/19/17,SAS,,DEN,W,0,1,0,0,,0,0,,0,0,,0,0,,0,0,0
20217,Kyle Anderson,23-137,F-G,2/4/17,SAS,,DEN,W,0,12,0,3,0,0,2,0,0,1,0,0,0,,0,1,1
20218,Kyle Anderson,23-059,F-G,11/18/16,SAS,@,LAL,W,0,13,0,2,0,0,1,0,0,1,0,0,0,,0,1,1
20219,Kyle Anderson,23-079,F-G,12/8/16,SAS,@,CHI,L,0,0,0,0,,0,0,,0,0,,0,0,,0,1,1
20220,Kyle Anderson,23-099,F-G,12/28/16,SAS,,PHO,W,1,22,0,6,0,0,5,0,0,1,0,0,0,,1,3,4
20221,Kyle Anderson,23-119,F-G,1/17/17,SAS,,MIN,W,0,4,0,0,,0,0,,0,0,,0,0,,0,0,0
20222,Kyle Anderson,23-157,F-G,2/24/17,SAS,@,LAC,W,0,2,0,0,,0,0,,0,0,,0,0,,0,0,0
20223,Kyle Anderson,23-096,F-G,12/25/16,SAS,,CHI,W,0,2,0,0,,0,0,,0,0,,0,0,,0,1,1
20224,Kyle Anderson,23-133,F-G,1/31/17,SAS,,OKC,W,0,2,0,0,,0,0,,0,0,,0,0,,0,1,1
20225,Ryan Anderson,28-259,F,1/20/17,HOU,,GSW,L,1,9,0,1,0,0,0,,0,1,0,0,0,,0,2,2
20226,Ryan Anderson,28-273,F,2/3/17,HOU,,CHI,W,1,33,0,7,0,0,1,0,0,6,0,0,2,0,1,3,4
20227,Ryan Anderson,28-313,F,3/15/17,HOU,,LAL,W,1,16,0,5,0,0,1,0,0,4,0,0,0,,2,0,2
20228,Giannis Antetokounmpo,22-035,F-G,1/10/17,MIL,@,SAS,W,1,9,0,3,0,0,2,0,0,1,0,0,0,,0,2,2
20229,Joel Anthony,34-190,C,2/15/17,SAS,@,ORL,W,0,6,0,0,,0,0,,0,0,,0,0,,1,1,2
20230,Joel Anthony,34-167,C,1/23/17,SAS,@,BRK,W,0,5,0,1,0,0,1,0,0,0,,0,0,,1,3,4
20231,Joel Anthony,34-185,C,2/10/17,SAS,@,DET,W,0,1,0,0,,0,0,,0,0,,0,0,,0,0,0
20232,Joel Anthony,34-181,C,2/6/17,SAS,@,MEM,L,0,3,0,0,,0,0,,0,0,,0,0,,0,1,1
20233,Joel Anthony,34-216,C,3/13/17,SAS,,ATL,W,0,2,0,0,,0,0,,0,0,,0,0,,1,0,1
20234,Joel Anthony,34-212,C,3/9/17,SAS,@,OKC,L,0,5,0,0,,0,0,,0,0,,0,0,,0,2,2
20235,Joel Anthony,34-211,C,3/8/17,SAS,,SAC,W,0,4,0,0,,0,0,,0,0,,0,0,,0,1,1
20236,Joel Anthony,34-175,C,1/31/17,SAS,,OKC,W,0,3,0,0,,0,0,,0,0,,0,0,,0,0,0
20237,Joel Anthony,34-207,C,3/4/17,SAS,,MIN,W,0,0,0,0,,0,0,,0,0,,0,0,,0,0,0
20238,Darrell Arthur,28-338,F,2/26/17,DEN,,MEM,L,0,12,0,1,0,0,0,,0,1,0,0,0,,0,1,1
20239,Darrell Arthur,28-336,F,2/24/17,DEN,,BRK,W,0,13,0,1,0,0,0,,0,1,0,0,0,,0,2,2
20240,Darrell Arthur,28-267,F,12/17/16,DEN,,NYK,W,0,4,0,1,0,0,0,,0,1,0,0,0,,0,0,0
20241,Omer Asik,30-164,C,12/15/16,NOP,,IND,W,0,7,0,1,0,0,1,0,0,0,,0,0,,1,3,4
20242,Omer Asik,30-160,C,12/11/16,NOP,@,PHO,W,0,4,0,0,,0,0,,0,0,,0,0,,0,0,0
20243,Omer Asik,30-159,C,12/10/16,NOP,@,LAC,L,0,18,0,1,0,0,1,0,0,0,,0,1,0,2,2,4
20244,Omer Asik,30-221,C,2/10/17,NOP,@,MIN,W,0,5,0,0,,0,0,,0,0,,0,0,,0,1,1
20245,Omer Asik,30-205,C,1/25/17,NOP,,OKC,L,0,4,0,0,,0,0,,0,0,,0,0,,0,0,0
20246,Omer Asik,30-123,C,11/4/16,NOP,,PHO,L,0,25,0,2,0,0,2,0,0,0,,0,0,,2,10,12
20247,Omer Asik,30-138,C,11/19/16,NOP,,CHO,W,1,13,0,0,,0,0,,0,0,,0,0,,2,3,5
20248,Omer Asik,30-153,C,12/4/16,NOP,@,OKC,L,1,16,0,1,0,0,1,0,0,0,,0,2,0,0,3,3
20249,Omer Asik,30-192,C,1/12/17,NOP,@,BRK,W,1,5,0,0,,0,0,,0,0,,0,0,,0,1,1
20250,Omer Asik,30-121,C,11/2/16,NOP,@,MEM,L,0,35,0,2,0,0,2,0,0,0,,0,0,,2,9,11
20251,Omer Asik,30-170,C,12/21/16,NOP,,OKC,L,0,9,0,1,0,0,1,0,0,0,,0,0,,1,1,2
20252,Omer Asik,30-135,C,11/16/16,NOP,@,ORL,L,1,20,0,1,0,0,1,0,0,0,,0,2,0,2,8,10
20253,Omer Asik,30-117,C,10/29/16,NOP,@,SAS,L,1,15,0,0,,0,0,,0,0,,0,0,,1,6,7
20254,D.J. Augustin,29-065,G,1/14/17,ORL,@,UTA,L,0,12,0,4,0,0,2,0,0,2,0,0,0,,0,2,2
20255,D.J. Augustin,29-073,G,1/22/17,ORL,,GSW,L,0,5,0,2,0,0,2,0,0,0,,0,0,,0,1,1
20256,D.J. Augustin,29-038,G,12/18/16,ORL,,TOR,L,1,13,0,4,0,0,3,0,0,1,0,0,0,,1,2,3
20257,Luke Babbitt,27-219,F,1/25/17,MIA,@,BRK,W,1,14,0,3,0,0,1,0,0,2,0,0,0,,0,3,3
20258,Luke Babbitt,27-181,F,12/18/16,MIA,,BOS,L,0,5,0,2,0,0,1,0,0,1,0,0,0,,0,0,0
20259,Luke Babbitt,27-233,F,2/8/17,MIA,@,MIL,W,1,20,0,6,0,0,1,0,0,5,0,0,0,,2,0,2
20260,Luke Babbitt,27-179,F,12/16/16,MIA,,LAC,L,0,8,0,2,0,0,0,,0,2,0,0,0,,0,2,2
20261,Luke Babbitt,27-252,F,2/27/17,MIA,@,DAL,L,1,16,0,1,0,0,0,,0,1,0,0,0,,0,5,5
20262,Luke Babbitt,27-268,F,3/15/17,MIA,,NOP,W,1,16,0,4,0,0,0,,0,4,0,0,0,,0,3,3
20263,Luke Babbitt,27-150,F,11/17/16,MIA,,MIL,W,0,3,0,0,,0,0,,0,0,,0,0,,0,1,1
20264,Luke Babbitt,27-265,F,3/12/17,MIA,@,IND,L,1,11,0,2,0,0,1,0,0,1,0,0,0,,0,0,0
20265,Luke Babbitt,27-148,F,11/15/16,MIA,,ATL,L,0,6,0,2,0,0,1,0,0,1,0,0,0,,0,2,2
20266,Luke Babbitt,27-211,F,1/17/17,MIA,,HOU,W,1,17,0,3,0,0,0,,0,3,0,0,0,,0,4,4
20267,Luke Babbitt,27-147,F,11/14/16,MIA,@,SAS,L,0,8,0,0,,0,0,,0,0,,0,0,,0,0,0
20268,Luke Babbitt,27-145,F,11/12/16,MIA,,UTA,L,1,5,0,3,0,0,0,,0,3,0,0,0,,0,1,1
20269,Luke Babbitt,27-185,F,12/22/16,MIA,,LAL,W,0,6,0,1,0,0,0,,0,1,0,0,0,,0,1,1
20270,Luke Babbitt,27-200,F,1/6/17,MIA,@,LAL,L,1,8,0,3,0,0,1,0,0,2,0,0,0,,0,0,0
20271,Luke Babbitt,27-236,F,2/11/17,MIA,@,PHI,L,1,7,0,0,,0,0,,0,0,,0,0,,0,3,3
20272,Ron Baker,23-288,G,1/12/17,NYK,,CHI,W,0,0,0,0,,0,0,,0,0,,0,0,,0,0,0
20273,Ron Baker,23-336,G,3/1/17,NYK,@,ORL,W,0,17,0,2,0,0,1,0,0,1,0,0,0,,0,1,1
20274,Ron Baker,23-258,G,12/13/16,NYK,@,PHO,L,0,15,0,3,0,0,2,0,0,1,0,0,0,,1,0,1
20275,Ron Baker,23-301,G,1/25/17,NYK,@,DAL,L,0,4,0,2,0,0,1,0,0,1,0,0,0,,0,1,1
20276,Ron Baker,23-251,G,12/6/16,NYK,@,MIA,W,0,1,0,0,,0,0,,0,0,,0,0,,0,0,0
20277,Ron Baker,23-346,G,3/11/17,NYK,@,DET,L,0,2,0,0,,0,0,,0,0,,0,0,,0,0,0
20278,Ron Baker,23-229,G,11/14/16,NYK,,DAL,W,0,3,0,2,0,0,0,,0,2,0,0,0,,0,0,0
20279,Ron Baker,23-294,G,1/18/17,NYK,@,BOS,W,1,11,0,0,,0,0,,0,0,,0,0,,0,1,1
20280,Ron Baker,23-313,G,2/6/17,NYK,,LAL,L,0,1,0,0,,0,0,,0,0,,0,0,,0,0,0
20281,Ron Baker,23-341,G,3/6/17,NYK,@,ORL,W,1,17,0,2,0,0,1,0,0,1,0,0,0,,0,0,0
20282,Ron Baker,23-267,G,12/22/16,NYK,,ORL,W,0,1,0,1,0,0,1,0,0,0,,0,0,,0,1,1
20283,Ron Baker,23-311,G,2/4/17,NYK,,CLE,L,0,2,0,0,,0,0,,0,0,,0,0,,0,0,0
20284,Wade Baldwin,20-277,G,12/31/16,MEM,@,SAC,W,0,2,0,1,0,0,0,,0,1,0,0,0,,0,0,0
20285,Wade Baldwin,20-275,G,12/29/16,MEM,,OKC,W,0,4,0,1,0,0,1,0,0,0,,0,0,,0,1,1
20286,Wade Baldwin,20-260,G,12/14/16,MEM,,CLE,W,0,3,0,0,,0,0,,0,0,,0,0,,0,0,0
20287,Wade Baldwin,20-215,G,10/30/16,MEM,,WAS,W,0,18,0,5,0,0,5,0,0,0,,0,0,,0,0,0
20288,Wade Baldwin,20-256,G,12/10/16,MEM,,GSW,W,0,2,0,1,0,0,0,,0,1,0,0,0,,0,0,0
20289,Wade Baldwin,20-235,G,11/19/16,MEM,,MIN,W,0,2,0,0,,0,0,,0,0,,0,0,,0,0,0
20290,Wade Baldwin,20-254,G,12/8/16,MEM,,POR,W,0,3,0,0,,0,0,,0,0,,0,0,,0,0,0
20291,Wade Baldwin,20-234,G,11/18/16,MEM,@,DAL,W,0,4,0,1,0,0,1,0,0,0,,0,0,,0,0,0
20292,Wade Baldwin,20-307,G,1/30/17,MEM,@,PHO,W,0,5,0,1,0,0,1,0,0,0,,0,0,,0,0,0
20293,Leandro Barbosa,34-067,G,2/3/17,PHO,@,SAC,W,0,14,0,2,0,0,1,0,0,1,0,0,0,,0,0,0
20294,Leandro Barbosa,34-025,G,12/23/16,PHO,,PHI,W,0,12,0,0,,0,0,,0,0,,0,0,,0,0,0
20295,Leandro Barbosa,34-041,G,1/8/17,PHO,,CLE,L,0,4,0,0,,0,0,,0,0,,0,0,,0,0,0
20296,Leandro Barbosa,34-023,G,12/21/16,PHO,,HOU,L,0,6,0,4,0,0,2,0,0,2,0,0,0,,0,1,1
20297,Leandro Barbosa,34-005,G,12/3/16,PHO,@,GSW,L,0,6,0,2,0,0,2,0,0,0,,0,0,,0,0,0
20298,Leandro Barbosa,34-057,G,1/24/17,PHO,,MIN,L,0,4,0,2,0,0,1,0,0,1,0,0,0,,0,1,1
20299,Leandro Barbosa,33-350,G,11/12/16,PHO,,BRK,L,0,6,0,1,0,0,0,,0,1,0,0,0,,0,0,0
20300,Leandro Barbosa,33-365,G,11/27/16,PHO,,DEN,L,0,8,0,3,0,0,2,0,0,1,0,0,0,,0,1,1
20301,Leandro Barbosa,33-350,G,11/12/16,PHO,,BRK,L,0,6,0,1,0,0,0,,0,1,0,0,0,,0,0,0
20302,Leandro Barbosa,33-365,G,11/27/16,PHO,,DEN,L,0,8,0,3,0,0,2,0,0,1,0,0,0,,0,1,1
20303,Leandro Barbosa,33-363,G,11/25/16,PHO,,MIN,L,0,12,0,6,0,0,4,0,0,2,0,0,0,,1,2,3
20304,Leandro Barbosa,34-031,G,12/29/16,PHO,,TOR,W,0,5,0,3,0,0,2,0,0,1,0,0,0,,1,1,2
20305,J.J. Barea,32-197,G,1/9/17,DAL,@,MIN,L,0,14,0,4,0,0,3,0,0,1,0,0,0,,0,2,2
20306,Matt Barnes,36-237,F,11/1/16,SAC,@,MIA,L,1,23,0,7,0,0,2,0,0,5,0,0,0,,3,5,8
20307,Matt Barnes,36-325,F,1/28/17,SAC,@,CHO,W,0,15,0,4,0,0,2,0,0,2,0,0,0,,0,4,4
20308,Matt Barnes,36-305,F,1/8/17,SAC,,GSW,L,0,18,0,4,0,0,1,0,0,3,0,0,0,,0,3,3
20309,Matt Barnes,36-364,F,3/8/17,GSW,,BOS,L,0,13,0,3,0,0,1,0,0,2,0,0,0,,0,5,5
20310,Matt Barnes,36-259,F,11/23/16,SAC,,OKC,W,1,29,0,3,0,0,0,,0,3,0,0,0,,1,3,4
20311,Brandon Bass,31-224,F,12/10/16,LAC,,NOP,W,0,11,0,2,0,0,2,0,0,0,,0,0,,1,2,3
20312,Brandon Bass,31-211,F,11/27/16,LAC,@,IND,L,0,3,0,0,,0,0,,0,0,,0,0,,0,0,0
20313,Brandon Bass,31-183,F,10/30/16,LAC,,UTA,W,0,2,0,0,,0,0,,0,0,,0,0,,0,0,0
20314,Brandon Bass,31-203,F,11/19/16,LAC,,CHI,W,0,3,0,1,0,0,1,0,0,0,,0,0,,0,0,0
20315,Brandon Bass,31-249,F,1/4/17,LAC,,MEM,W,0,5,0,1,0,0,1,0,0,0,,0,0,,1,1,2
20316,Brandon Bass,31-324,F,3/20/17,LAC,,NYK,W,0,6,0,1,0,0,1,0,0,0,,0,0,,1,1,2
20317,Aron Baynes,29-364,C,12/7/16,DET,@,CHO,L,0,14,0,3,0,0,3,0,0,0,,0,0,,1,2,3
20318,Aron Baynes,30-076,C,2/23/17,DET,,CHO,W,0,5,0,0,,0,0,,0,0,,0,0,,0,0,0
20319,Aron Baynes,30-090,C,3/9/17,DET,,CLE,W,0,4,0,0,,0,0,,0,0,,0,0,,0,1,1
20320,Aron Baynes,29-346,C,11/19/16,DET,,BOS,L,0,17,0,4,0,0,4,0,0,0,,0,0,,1,5,6
20321,Aron Baynes,30-032,C,1/10/17,DET,@,SAC,L,0,6,0,2,0,0,2,0,0,0,,0,0,,1,1,2
20322,Aron Baynes,29-332,C,11/5/16,DET,,DEN,W,0,12,0,1,0,0,1,0,0,0,,0,0,,0,3,3
20323,Aron Baynes,30-066,C,2/13/17,DET,@,MIL,L,0,5,0,0,,0,0,,0,0,,0,0,,0,0,0
20324,Aron Baynes,29-343,C,11/16/16,DET,@,NYK,L,0,12,0,1,0,0,1,0,0,0,,0,0,,1,1,2
20325,Aron Baynes,30-102,C,3/21/17,DET,@,BRK,L,0,17,0,0,,0,0,,0,0,,0,0,,0,6,6
20326,Kent Bazemore,27-157,G-F,12/5/16,ATL,,OKC,L,1,18,0,7,0,0,4,0,0,3,0,0,0,,2,3,5
20327,Kent Bazemore,27-126,G-F,11/4/16,ATL,@,WAS,L,1,27,0,7,0,0,4,0,0,3,0,0,0,,1,2,3
20328,Malik Beasley,20-077,G,2/11/17,DEN,@,CLE,L,0,3,0,1,0,0,1,0,0,0,,0,0,,0,0,0
20329,Malik Beasley,19-345,G,11/5/16,DEN,@,DET,L,0,5,0,2,0,0,2,0,0,0,,0,0,,0,0,0
20330,Malik Beasley,20-074,G,2/8/17,DEN,@,ATL,L,0,0,0,0,,0,0,,0,0,,0,0,,0,0,0
20331,Malik Beasley,19-356,G,11/16/16,DEN,,PHO,W,0,1,0,0,,0,0,,0,0,,0,0,,0,0,0
20332,Malik Beasley,19-353,G,11/13/16,DEN,@,POR,L,0,6,0,3,0,0,2,0,0,1,0,0,0,,0,0,0
20333,Malik Beasley,20-056,G,1/21/17,DEN,,LAC,W,0,3,0,1,0,0,0,,0,1,0,0,0,,0,0,0
20334,Malik Beasley,20-079,G,2/13/17,DEN,,GSW,W,0,7,0,1,0,0,0,,0,1,0,0,0,,0,0,0
20335,Malik Beasley,19-346,G,11/6/16,DEN,@,BOS,W,0,2,0,1,0,0,1,0,0,0,,0,0,,0,0,0
20336,Michael Beasley,28-018,F,1/27/17,MIL,@,TOR,L,0,7,0,2,0,0,1,0,0,1,0,0,0,,0,1,1
20337,Michael Beasley,27-312,F,11/16/16,MIL,@,ATL,L,0,4,0,2,0,0,2,0,0,0,,0,0,,0,0,0
20338,Marco Belinelli,30-346,G-F,3/6/17,CHO,,IND,W,0,14,0,4,0,0,4,0,0,0,,0,0,,0,2,2
20339,Marco Belinelli,30-273,G-F,12/23/16,CHO,,CHI,W,0,7,0,1,0,0,1,0,0,0,,0,0,,0,0,0
20340,DeAndre' Bembry,22-124,F,11/5/16,ATL,,HOU,W,0,2,0,0,,0,0,,0,0,,0,0,,0,0,0
20341,DeAndre' Bembry,22-207,F,1/27/17,ATL,,WAS,L,0,8,0,2,0,0,2,0,0,0,,0,0,,0,2,2
20342,DeAndre' Bembry,22-162,F,12/13/16,ATL,,ORL,L,0,2,0,0,,0,0,,0,0,,0,0,,0,0,0
20343,DeAndre' Bembry,22-224,F,2/13/17,ATL,@,POR,W,0,4,0,0,,0,0,,0,0,,0,0,,0,0,0
20344,DeAndre' Bembry,22-152,F,12/3/16,ATL,@,TOR,L,0,7,0,2,0,0,2,0,0,0,,0,0,,0,0,0
20345,DeAndre' Bembry,22-221,F,2/10/17,ATL,@,SAC,L,0,19,0,2,0,0,0,,0,2,0,0,0,,0,1,1
20346,DeAndre' Bembry,22-193,F,1/13/17,ATL,,BOS,L,0,6,0,0,,0,0,,0,0,,0,0,,0,3,3
20347,DeAndre' Bembry,22-215,F,2/4/17,ATL,,ORL,W,0,23,0,4,0,0,2,0,0,2,0,0,0,,1,4,5
20348,DeAndre' Bembry,22-131,F,11/12/16,ATL,,PHI,W,0,3,0,2,0,0,2,0,0,0,,0,0,,1,0,1
20349,DeAndre' Bembry,22-184,F,1/4/17,ATL,@,ORL,W,0,2,0,0,,0,0,,0,0,,0,0,,0,1,1
20350,Dragan Bender,19-046,F,1/2/17,PHO,@,LAC,L,0,5,0,1,0,0,1,0,0,0,,0,0,,0,2,2
20351,Dragan Bender,19-065,F,1/21/17,PHO,@,NYK,W,0,10,0,2,0,0,0,,0,2,0,0,0,,0,1,1
20352,Dragan Bender,18-349,F,10/31/16,PHO,@,LAC,L,0,7,0,1,0,0,1,0,0,0,,0,0,,0,1,1
20353,Dragan Bender,19-024,F,12/11/16,PHO,,NOP,L,0,6,0,2,0,0,0,,0,2,0,0,0,,1,0,1
20354,Dragan Bender,18-348,F,10/30/16,PHO,,GSW,L,0,3,0,2,0,0,0,,0,2,0,0,0,,0,0,0
20355,Dragan Bender,18-346,F,10/28/16,PHO,@,OKC,L,0,7,0,1,0,0,1,0,0,0,,0,0,,0,1,1
20356,Dragan Bender,19-020,F,12/7/16,PHO,,IND,L,0,11,0,0,,0,0,,0,0,,0,0,,0,3,3
20357,Dragan Bender,18-365,F,11/16/16,PHO,@,DEN,L,0,2,0,1,0,0,0,,0,1,0,0,0,,0,0,0
20358,Dragan Bender,19-034,F,12/21/16,PHO,,HOU,L,0,2,0,0,,0,0,,0,0,,0,0,,0,0,0
20359,Dragan Bender,19-013,F,11/30/16,PHO,,ATL,W,0,12,0,2,0,0,0,,0,2,0,0,0,,0,1,1
20360,Dragan Bender,19-030,F,12/17/16,PHO,@,OKC,L,0,10,0,1,0,0,0,,0,1,0,0,0,,0,3,3
20361,Dragan Bender,19-049,F,1/5/17,PHO,@,DAL,W,0,13,0,1,0,0,0,,0,1,0,0,0,,0,1,1
20362,Dragan Bender,18-358,F,11/9/16,PHO,,DET,W,0,8,0,4,0,0,2,0,0,2,0,0,0,,0,0,0
20363,Dragan Bender,19-010,F,11/27/16,PHO,,DEN,L,0,14,0,2,0,0,1,0,0,1,0,0,0,,0,1,1
20364,Dragan Bender,19-066,F,1/22/17,PHO,@,TOR,W,0,4,0,2,0,0,2,0,0,0,,0,0,,1,0,1
20365,Anthony Bennett,23-243,F,11/12/16,BRK,@,PHO,W,0,2,0,0,,0,0,,0,0,,0,0,,0,1,1
20366,Anthony Bennett,23-283,F,12/22/16,BRK,,GSW,L,0,3,0,0,,0,0,,0,0,,0,0,,0,0,0
20367,Anthony Bennett,23-235,F,11/4/16,BRK,,CHO,L,0,4,0,1,0,0,0,,0,1,0,0,0,,0,0,0
20368,Anthony Bennett,23-262,F,12/1/16,BRK,,MIL,L,0,3,0,1,0,0,1,0,0,0,,0,0,,0,1,1
20369,Anthony Bennett,23-279,F,12/18/16,BRK,@,PHI,L,0,13,0,1,0,0,1,0,0,0,,0,0,,1,3,4
20370,Anthony Bennett,23-254,F,11/23/16,BRK,,BOS,L,0,2,0,0,,0,0,,0,0,,0,0,,0,1,1
20371,Ben Bentil,21-343,F,3/7/17,DAL,,LAL,W,0,3,0,3,0,0,2,0,0,1,0,0,0,,0,0,0
20372,Ben Bentil,21-341,F,3/5/17,DAL,,OKC,W,0,3,0,0,,0,0,,0,0,,0,0,,0,2,2
20373,Ben Bentil,21-337,F,3/1/17,DAL,@,ATL,L,0,4,0,0,,0,0,,0,0,,0,0,,0,0,0
20374,Davis Bertans,23-358,F,11/4/16,SAS,@,UTA,W,0,16,0,4,0,0,1,0,0,3,0,0,0,,1,2,3
20375,Davis Bertans,24-111,F,3/3/17,SAS,@,NOP,W,0,2,0,1,0,0,0,,0,1,0,0,0,,0,0,0
20376,Davis Bertans,24-048,F,12/30/16,SAS,,POR,W,0,3,0,1,0,0,0,,0,1,0,0,0,,0,0,0
20377,Davis Bertans,24-086,F,2/6/17,SAS,@,MEM,L,0,15,0,5,0,0,2,0,0,3,0,0,0,,0,1,1
20378,Davis Bertans,24-129,F,3/21/17,SAS,@,MIN,W,0,6,0,1,0,0,1,0,0,0,,0,0,,1,0,1
20379,Davis Bertans,24-024,F,12/6/16,SAS,@,MIN,W,0,2,0,0,,0,0,,0,0,,0,0,,0,0,0
20380,Davis Bertans,24-046,F,12/28/16,SAS,,PHO,W,0,3,0,0,,0,0,,0,0,,0,0,,0,0,0
20381,Davis Bertans,24-066,F,1/17/17,SAS,,MIN,W,0,3,0,0,,0,0,,0,0,,0,0,,0,0,0
20382,Davis Bertans,24-043,F,12/25/16,SAS,,CHI,W,0,2,0,1,0,0,0,,0,1,0,0,0,,0,0,0
20383,Davis Bertans,24-063,F,1/14/17,SAS,@,PHO,L,0,4,0,1,0,0,0,,0,1,0,0,0,,0,0,0
20384,Davis Bertans,24-002,F,11/14/16,SAS,,MIA,W,0,0,0,1,0,0,0,,0,1,0,0,0,,0,0,0
20385,Davis Bertans,24-041,F,12/23/16,SAS,@,POR,W,0,7,0,0,,0,0,,0,0,,0,0,,0,0,0
20386,Davis Bertans,23-365,F,11/11/16,SAS,,DET,W,0,1,0,0,,0,0,,0,0,,0,0,,0,1,1
20387,Davis Bertans,24-017,F,11/29/16,SAS,,ORL,L,0,6,0,1,0,0,1,0,0,0,,0,0,,0,0,0
20388,Davis Bertans,24-038,F,12/20/16,SAS,@,HOU,W,0,2,0,0,,0,0,,0,0,,0,0,,0,0,0
20389,Davis Bertans,24-093,F,2/13/17,SAS,@,IND,W,0,0,0,0,,0,0,,0,0,,0,0,,0,0,0
20390,Davis Bertans,23-363,F,11/9/16,SAS,,HOU,L,0,10,0,0,,0,0,,0,0,,0,0,,0,1,1
20391,Davis Bertans,24-014,F,11/26/16,SAS,@,WAS,W,0,11,0,2,0,0,0,,0,2,0,0,0,,0,1,1
20392,Davis Bertans,24-036,F,12/18/16,SAS,,NOP,W,0,12,0,3,0,0,1,0,0,2,0,0,0,,2,1,3
20393,Davis Bertans,23-359,F,11/5/16,SAS,,LAC,L,0,16,0,3,0,0,1,0,0,2,0,0,0,,0,1,1
20394,Davis Bertans,24-033,F,12/15/16,SAS,@,PHO,W,0,3,0,0,,0,0,,0,0,,0,0,,0,0,0
20395,Davis Bertans,24-054,F,1/5/17,SAS,@,DEN,W,0,5,0,0,,0,0,,0,0,,0,0,,0,1,1
20396,Patrick Beverley,28-183,G,1/11/17,HOU,@,MIN,L,1,34,0,5,0,0,4,0,0,1,0,0,0,,0,3,3
20397,Bismack Biyombo,24-155,C-F,1/30/17,ORL,@,MIN,L,0,15,0,0,,0,0,,0,0,,0,2,0,1,5,6
20398,Bismack Biyombo,24-087,C-F,11/23/16,ORL,,PHO,L,0,22,0,2,0,0,2,0,0,0,,0,0,,1,6,7
20399,Bismack Biyombo,24-127,C-F,1/2/17,ORL,@,NYK,W,1,19,0,1,0,0,1,0,0,0,,0,0,,0,2,2
20400,Nemanja Bjelica,28-260,F,1/24/17,MIN,@,PHO,W,0,13,0,4,0,0,2,0,0,2,0,0,0,,1,1,2
20401,Nemanja Bjelica,28-180,F,11/5/16,MIN,@,OKC,L,0,11,0,2,0,0,0,,0,2,0,0,0,,0,0,0
20402,Nemanja Bjelica,28-303,F,3/8/17,MIN,,LAC,W,0,19,0,3,0,0,2,0,0,1,0,0,0,,2,3,5
20403,Nemanja Bjelica,28-277,F,2/10/17,MIN,,NOP,L,0,12,0,2,0,0,0,,0,2,0,0,0,,1,2,3
20404,Nemanja Bjelica,28-260,F,1/24/17,MIN,@,PHO,W,0,13,0,4,0,0,2,0,0,2,0,0,0,,1,1,2
20405,Nemanja Bjelica,28-205,F,11/30/16,MIN,,NYK,L,0,16,0,5,0,0,1,0,0,4,0,0,0,,0,0,0
20406,Nemanja Bjelica,28-224,F,12/19/16,MIN,,PHO,W,0,13,0,2,0,0,0,,0,2,0,0,0,,0,1,1
20407,Nemanja Bjelica,28-184,F,11/9/16,MIN,@,ORL,W,0,7,0,1,0,0,0,,0,1,0,0,0,,0,2,2
20408,Nemanja Bjelica,28-218,F,12/13/16,MIN,@,CHI,W,0,9,0,2,0,0,1,0,0,1,0,0,0,,1,2,3
20409,Tarik Black,25-061,C-F,1/22/17,LAL,@,DAL,L,0,10,0,2,0,0,2,0,0,0,,0,0,,0,0,0
20410,Tarik Black,25-119,C-F,3/21/17,LAL,,LAC,L,0,8,0,3,0,0,3,0,0,0,,0,0,,3,0,3
20411,Tarik Black,25-113,C-F,3/15/17,LAL,@,HOU,L,0,9,0,1,0,0,1,0,0,0,,0,0,,1,5,6
20412,Tarik Black,25-024,C-F,12/16/16,LAL,@,PHI,W,0,3,0,0,,0,0,,0,0,,0,0,,0,1,1
20413,Tarik Black,25-094,C-F,2/24/17,LAL,@,OKC,L,1,13,0,1,0,0,1,0,0,0,,0,0,,1,0,1
20414,Bojan Bogdanovic,27-249,G-F,12/23/16,BRK,@,CLE,L,1,20,0,5,0,0,3,0,0,2,0,0,0,,0,2,2
20415,Andrew Bogut,32-038,C,1/5/17,DAL,,PHO,L,0,20,0,0,,0,0,,0,0,,0,0,,0,0,0
20416,Andrew Bogut,32-036,C,1/3/17,DAL,,WAS,W,0,20,0,3,0,0,3,0,0,0,,0,0,,2,4,6
20417,Andrew Bogut,32-098,C,3/6/17,CLE,,MIA,L,0,1,0,0,,0,0,,0,0,,0,0,,0,0,0
20418,Andrew Bogut,32-029,C,12/27/16,DAL,,HOU,L,1,11,0,0,,0,0,,0,0,,0,0,,2,4,6
20419,Andrew Bogut,32-062,C,1/29/17,DAL,@,SAS,W,0,8,0,0,,0,0,,0,0,,0,0,,0,2,2
20420,Andrew Bogut,32-007,C,12/5/16,DAL,,CHO,L,1,11,0,1,0,0,1,0,0,0,,0,0,,1,5,6
20421,Joel Bolomboy,22-302,F,11/25/16,UTA,,ATL,W,0,2,0,0,,0,0,,0,0,,0,0,,0,2,2
20422,Joel Bolomboy,22-296,F,11/19/16,UTA,@,HOU,L,0,3,0,0,,0,0,,0,0,,0,0,,0,1,1
20423,Joel Bolomboy,22-289,F,11/12/16,UTA,@,MIA,W,0,1,0,0,,0,0,,0,0,,0,0,,0,0,0
20424,Joel Bolomboy,22-284,F,11/7/16,UTA,@,PHI,W,0,2,0,0,,0,0,,0,0,,0,0,,0,3,3
20425,Joel Bolomboy,22-279,F,11/2/16,UTA,,DAL,W,0,1,0,0,,0,0,,0,0,,0,0,,0,0,0
20426,Corey Brewer,31-012,F-G,3/17/17,LAL,,MIL,L,0,7,0,1,0,0,1,0,0,0,,0,0,,0,1,1
20427,Corey Brewer,30-290,F-G,12/20/16,HOU,,SAS,L,0,6,0,0,,0,0,,0,0,,0,0,,1,0,1
20428,Corey Brewer,30-287,F-G,12/17/16,HOU,@,MIN,W,0,10,0,3,0,0,2,0,0,1,0,0,0,,0,1,1
20429,Corey Brewer,30-330,F-G,1/29/17,HOU,@,IND,L,0,7,0,1,0,0,0,,0,1,0,0,0,,0,1,1
20430,Corey Brewer,30-316,F-G,1/15/17,HOU,@,BRK,W,0,18,0,5,0,0,2,0,0,3,0,0,0,,1,1,2
20431,Corey Brewer,30-328,F-G,1/27/17,HOU,@,PHI,W,0,11,0,2,0,0,2,0,0,0,,0,0,,0,0,0
20432,Corey Brewer,30-269,F-G,11/29/16,HOU,@,UTA,L,0,18,0,4,0,0,2,0,0,2,0,0,0,,0,2,2
20433,Corey Brewer,30-252,F-G,11/12/16,HOU,,SAS,L,1,16,0,3,0,0,0,,0,3,0,0,0,,0,0,0
20434,Corey Brewer,30-267,F-G,11/27/16,HOU,@,POR,W,0,15,0,2,0,0,2,0,0,0,,0,0,,0,4,4
20435,Corey Brewer,30-282,F-G,12/12/16,HOU,,BRK,W,0,10,0,2,0,0,1,0,0,1,0,0,0,,0,0,0
20436,Corey Brewer,30-249,F-G,11/9/16,HOU,@,SAS,W,1,14,0,5,0,0,1,0,0,4,0,0,0,,1,1,2
20437,Corey Brewer,30-324,F-G,1/23/17,HOU,@,MIL,L,0,7,0,1,0,0,0,,0,1,0,0,0,,0,0,0
20438,Corey Brewer,30-245,F-G,11/5/16,HOU,@,ATL,L,0,15,0,3,0,0,1,0,0,2,0,0,0,,0,0,0
20439,Corey Brewer,30-291,F-G,12/21/16,HOU,@,PHO,W,0,14,0,4,0,0,2,0,0,2,0,0,0,,0,2,2
20440,Corey Brewer,30-307,F-G,1/6/17,HOU,@,ORL,W,0,16,0,4,0,0,2,0,0,2,0,0,0,,0,1,1
20441,Malcolm Brogdon,23-342,G,11/17/16,MIL,@,MIA,L,0,17,0,7,0,0,6,0,0,1,0,0,0,,1,3,4
20442,Aaron Brooks,31-326,G,12/5/16,IND,@,GSW,L,0,12,0,1,0,0,0,,0,1,0,0,0,,0,1,1
20443,Aaron Brooks,31-340,G,12/19/16,IND,,WAS,W,0,9,0,2,0,0,0,,0,2,0,0,0,,1,0,1
20444,Aaron Brooks,32-013,G,1/27/17,IND,,SAC,W,0,11,0,4,0,0,1,0,0,3,0,0,0,,0,1,1
20445,Aaron Brooks,32-053,G,3/8/17,IND,,DET,W,0,3,0,0,,0,0,,0,0,,0,0,,0,0,0
20446,Aaron Brooks,32-012,G,1/26/17,IND,@,MIN,W,0,13,0,2,0,0,1,0,0,1,0,0,0,,0,3,3
20447,Aaron Brooks,31-336,G,12/15/16,IND,@,NOP,L,0,13,0,3,0,0,1,0,0,2,0,0,0,,0,1,1
20448,Aaron Brooks,32-042,G,2/25/17,IND,@,MIA,L,0,1,0,0,,0,0,,0,0,,0,0,,0,0,0
20449,Aaron Brooks,32-041,G,2/24/17,IND,,MEM,W,0,2,0,2,0,0,1,0,0,1,0,0,0,,0,0,0
20450,Aaron Brooks,31-349,G,12/28/16,IND,@,WAS,L,0,10,0,2,0,0,2,0,0,0,,0,0,,0,0,0
20451,Aaron Brooks,32-065,G,3/20/17,IND,,UTA,W,0,11,0,1,0,0,0,,0,1,0,0,1,0,0,1,1
20452,Aaron Brooks,31-328,G,12/7/16,IND,@,PHO,W,0,12,0,2,0,0,2,0,0,0,,0,0,,0,0,0
20453,Aaron Brooks,32-060,G,3/15/17,IND,,CHO,W,0,2,0,0,,0,0,,0,0,,0,0,,0,0,0
20454,Anthony Brown,24-048,F-G,11/27/16,NOP,@,DAL,L,0,10,0,3,0,0,0,,0,3,0,0,0,,0,2,2
20455,Anthony Brown,24-046,F-G,11/25/16,NOP,@,POR,L,0,9,0,1,0,0,0,,0,1,0,0,0,,0,1,1
20456,Anthony Brown,24-043,F-G,11/22/16,NOP,@,ATL,W,0,8,0,1,0,0,0,,0,1,0,0,0,,1,0,1
20457,Anthony Brown,24-059,F-G,12/8/16,NOP,,PHI,L,0,18,0,7,0,0,4,0,0,3,0,0,0,,0,2,2
20458,Bobby Brown,32-113,G,1/15/17,HOU,@,BRK,W,0,4,0,3,0,0,1,0,0,2,0,0,0,,0,0,0
20459,Bobby Brown,32-152,G,2/23/17,HOU,@,NOP,W,0,3,0,1,0,0,0,,0,1,0,0,0,,0,0,0
20460,Bobby Brown,32-038,G,11/1/16,HOU,@,CLE,L,0,5,0,2,0,0,1,0,0,1,0,0,0,,0,0,0
20461,Bobby Brown,32-034,G,10/28/16,HOU,@,DAL,W,0,1,0,1,0,0,1,0,0,0,,0,0,,0,0,0
20462,Bobby Brown,32-097,G,12/30/16,HOU,,LAC,W,0,2,0,1,0,0,0,,0,1,0,0,0,,0,0,0
20463,Bobby Brown,32-136,G,2/7/17,HOU,,ORL,W,0,2,0,0,,0,0,,0,0,,0,0,,0,0,0
20464,Bobby Brown,32-094,G,12/27/16,HOU,@,DAL,W,0,3,0,0,,0,0,,0,0,,0,0,,0,1,1
20465,Bobby Brown,32-129,G,1/31/17,HOU,,SAC,W,0,2,0,2,0,0,0,,0,2,0,0,0,,0,0,0
20466,Bobby Brown,32-174,G,3/17/17,HOU,@,NOP,L,0,3,0,1,0,0,0,,0,1,0,0,0,,0,0,0
20467,Bobby Brown,32-051,G,11/14/16,HOU,,PHI,W,0,5,0,2,0,0,1,0,0,1,0,0,0,,0,1,1
20468,Bobby Brown,32-119,G,1/21/17,HOU,@,MEM,W,0,1,0,0,,0,0,,0,0,,0,0,,0,0,0
20469,Bobby Brown,32-042,G,11/5/16,HOU,@,ATL,L,0,3,0,1,0,0,1,0,0,0,,0,0,,0,0,0
20470,Bobby Brown,32-116,G,1/18/17,HOU,,MIL,W,0,2,0,1,0,0,1,0,0,0,,0,0,,0,1,1
20471,Bobby Brown,32-158,G,3/1/17,HOU,@,LAC,W,0,1,0,0,,0,0,,0,0,,0,0,,0,0,0
20472,Bobby Brown,32-039,G,11/2/16,HOU,@,NYK,W,0,4,0,2,0,0,1,0,0,1,0,0,0,,0,0,0
20473,Jaylen Brown,20-074,F,1/6/17,BOS,,PHI,W,0,5,0,0,,0,0,,0,0,,0,0,,0,1,1
20474,Jaylen Brown,20-039,F,12/2/16,BOS,,SAC,W,0,4,0,1,0,0,1,0,0,0,,0,0,,0,0,0
20475,Jaylen Brown,20-037,F,11/30/16,BOS,,DET,L,0,4,0,2,0,0,2,0,0,0,,0,0,,0,0,0
20476,Jaylen Brown,20-019,F,11/12/16,BOS,@,IND,W,0,7,0,1,0,0,0,,0,1,0,0,0,,0,2,2
20477,Jaylen Brown,20-144,F,3/17/17,BOS,@,BRK,W,0,16,0,2,0,0,0,,0,2,0,0,0,,0,2,2
20478,Jaylen Brown,20-035,F,11/28/16,BOS,@,MIA,W,0,9,0,2,0,0,1,0,0,1,0,0,0,,1,0,1
20479,Jaylen Brown,20-064,F,12/27/16,BOS,,MEM,W,0,4,0,0,,0,0,,0,0,,0,0,,0,0,0
20480,Jaylen Brown,20-030,F,11/23/16,BOS,@,BRK,W,0,4,0,1,0,0,1,0,0,0,,0,0,,1,2,3
20481,Jaylen Brown,20-062,F,12/25/16,BOS,@,NYK,W,0,6,0,1,0,0,1,0,0,0,,0,0,,0,2,2
20482,Jaylen Brown,20-028,F,11/21/16,BOS,@,MIN,W,0,13,0,1,0,0,0,,0,1,0,0,2,0,0,2,2
20483,Jaylen Brown,20-075,F,1/7/17,BOS,,NOP,W,0,14,0,4,0,0,4,0,0,0,,0,0,,0,4,4
20484,Nicolas Brussino,23-336,G-F,2/1/17,DAL,,PHI,W,0,5,0,1,0,0,1,0,0,0,,0,0,,1,0,1
20485,Nicolas Brussino,24-005,G-F,3/7/17,DAL,,LAL,W,0,3,0,0,,0,0,,0,0,,0,0,,0,1,1
20486,Nicolas Brussino,23-238,G-F,10/26/16,DAL,@,IND,L,0,1,0,0,,0,0,,0,0,,0,0,,0,0,0
20487,Nicolas Brussino,23-334,G-F,1/30/17,DAL,,CLE,W,0,2,0,0,,0,0,,0,0,,0,0,,0,0,0
20488,Nicolas Brussino,24-003,G-F,3/5/17,DAL,,OKC,W,0,3,0,1,0,0,0,,0,1,0,0,0,,0,0,0
20489,Nicolas Brussino,23-259,G-F,11/16/16,DAL,@,BOS,L,0,0,0,0,,0,0,,0,0,,0,0,,0,0,0
20490,Nicolas Brussino,23-299,G-F,12/26/16,DAL,@,NOP,L,0,0,0,0,,0,0,,0,0,,0,0,,0,0,0
20491,Nicolas Brussino,23-333,G-F,1/29/17,DAL,@,SAS,W,0,5,0,1,0,0,0,,0,1,0,0,0,,0,1,1
20492,Nicolas Brussino,24-001,G-F,3/3/17,DAL,,MEM,W,0,4,0,0,,0,0,,0,0,,0,0,,0,2,2
20493,Nicolas Brussino,23-276,G-F,12/3/16,DAL,,CHI,W,0,2,0,0,,0,0,,0,0,,0,0,,1,0,1
20494,Nicolas Brussino,23-292,G-F,12/19/16,DAL,@,DEN,L,0,1,0,0,,0,0,,0,0,,0,0,,0,0,0
20495,Nicolas Brussino,23-273,G-F,11/30/16,DAL,,SAS,L,0,0,0,0,,0,0,,0,0,,0,0,,0,0,0
20496,Nicolas Brussino,23-291,G-F,12/18/16,DAL,,SAC,W,0,2,0,1,0,0,0,,0,1,0,0,0,,0,0,0
20497,Nicolas Brussino,23-359,G-F,2/24/17,DAL,@,MIN,L,0,11,0,3,0,0,0,,0,3,0,0,0,,1,0,1
20498,Nicolas Brussino,23-249,G-F,11/6/16,DAL,,MIL,W,0,2,0,0,,0,0,,0,0,,0,0,,0,1,1
20499,Nicolas Brussino,23-319,G-F,1/15/17,DAL,,MIN,W,0,1,0,0,,0,0,,0,0,,0,0,,0,0,0
20500,Nicolas Brussino,23-348,G-F,2/13/17,DAL,,BOS,L,0,1,0,1,0,0,0,,0,1,0,0,0,,0,0,0
20501,Nicolas Brussino,23-264,G-F,11/21/16,DAL,@,SAS,L,0,13,0,0,,0,0,,0,0,,0,0,,0,1,1
20502,Nicolas Brussino,23-283,G-F,12/10/16,DAL,@,HOU,L,0,13,0,2,0,0,1,0,0,1,0,0,0,,0,2,2
20503,Nicolas Brussino,23-309,G-F,1/5/17,DAL,,PHO,L,0,10,0,2,0,0,0,,0,2,0,0,0,,1,1,2
20504,Nicolas Brussino,23-336,G-F,2/1/17,DAL,,PHI,W,0,5,0,1,0,0,1,0,0,0,,0,0,,1,0,1
20505,Nicolas Brussino,24-005,G-F,3/7/17,DAL,,LAL,W,0,3,0,0,,0,0,,0,0,,0,0,,0,1,1
20506,Nicolas Brussino,23-238,G-F,10/26/16,DAL,@,IND,L,0,1,0,0,,0,0,,0,0,,0,0,,0,0,0
20507,Reggie Bullock,25-320,G-F,1/30/17,DET,@,BOS,L,0,7,0,1,0,0,1,0,0,0,,0,0,,0,0,0
20508,Reggie Bullock,25-357,G-F,3/8/17,DET,@,IND,L,0,7,0,1,0,0,0,,0,1,0,0,0,,0,0,0
20509,Reggie Bullock,25-350,G-F,3/1/17,DET,@,NOP,L,0,3,0,0,,0,0,,0,0,,0,0,,0,0,0
20510,Reggie Bullock,26-003,G-F,3/19/17,DET,,PHO,W,0,8,0,3,0,0,1,0,0,2,0,0,0,,1,3,4
20511,Reggie Bullock,25-364,G-F,3/15/17,DET,,UTA,L,0,9,0,2,0,0,1,0,0,1,0,0,0,,0,3,3
20512,Reggie Bullock,25-329,G-F,2/8/17,DET,,LAL,W,0,9,0,2,0,0,2,0,0,0,,0,0,,0,0,0
20513,Reggie Bullock,25-252,G-F,11/23/16,DET,,MIA,W,0,3,0,2,0,0,1,0,0,1,0,0,0,,0,0,0
20514,Reggie Bullock,25-360,G-F,3/11/17,DET,,NYK,W,0,7,0,1,0,0,0,,0,1,0,0,0,,0,0,0
20515,Trey Burke,23-356,G,11/2/16,WAS,,TOR,L,0,6,0,0,,0,0,,0,0,,0,0,,0,1,1
20516,Trey Burke,24-009,G,11/21/16,WAS,,PHO,W,0,6,0,3,0,0,3,0,0,0,,0,0,,1,0,1
20517,Trey Burke,24-046,G,12/28/16,WAS,,IND,W,0,11,0,5,0,0,2,0,0,3,0,0,0,,1,1,2
20518,Trey Burke,24-044,G,12/26/16,WAS,,MIL,W,0,4,0,1,0,0,1,0,0,0,,0,0,,0,0,0
20519,Trey Burke,24-057,G,1/8/17,WAS,@,MIL,W,0,11,0,0,,0,0,,0,0,,0,0,,0,2,2
20520,Trey Burke,24-086,G,2/6/17,WAS,,CLE,L,0,6,0,1,0,0,1,0,0,0,,0,0,,0,1,1
20521,Trey Burke,24-115,G,3/7/17,WAS,@,PHO,W,0,4,0,1,0,0,1,0,0,0,,0,0,,0,0,0
20522,Trey Burke,23-361,G,11/7/16,WAS,,HOU,L,0,6,0,0,,0,0,,0,0,,0,0,,0,0,0
20523,Trey Burke,24-052,G,1/3/17,WAS,@,DAL,L,0,9,0,3,0,0,2,0,0,1,0,0,0,,0,0,0
20524,Trey Burke,24-106,G,2/26/17,WAS,,UTA,L,0,5,0,2,0,0,2,0,0,0,,0,0,,0,0,0
20525,Trey Burke,23-358,G,11/4/16,WAS,,ATL,W,0,7,0,3,0,0,3,0,0,0,,0,0,,0,2,2
20526,Alec Burks,25-172,G,1/8/17,UTA,@,MEM,L,0,2,0,0,,0,0,,0,0,,0,0,,0,0,0
20527,Alec Burks,25-166,G,1/2/17,UTA,@,BRK,W,0,3,0,1,0,0,0,,0,1,0,0,0,,0,0,0
20528,Alec Burks,25-180,G,1/16/17,UTA,@,PHO,W,0,9,0,4,0,0,4,0,0,0,,0,1,0,0,0,0
20529,Bruno Caboclo,21-068,F,11/28/16,TOR,,PHI,W,0,4,0,0,,0,0,,0,0,,0,0,,0,1,1
20530,Bruno Caboclo,21-116,F,1/15/17,TOR,,NYK,W,0,0,0,0,,0,0,,0,0,,0,0,,0,0,0
20531,Bruno Caboclo,21-114,F,1/13/17,TOR,,BRK,W,0,2,0,1,0,0,1,0,0,0,,0,0,,1,0,1
20532,Bruno Caboclo,21-104,F,1/3/17,TOR,@,SAS,L,0,3,0,0,,0,0,,0,0,,0,0,,0,0,0
20533,Bruno Caboclo,21-090,F,12/20/16,TOR,,BRK,W,0,2,0,0,,0,0,,0,0,,0,0,,1,0,1
20534,Bruno Caboclo,21-088,F,12/18/16,TOR,@,ORL,W,0,4,0,1,0,0,0,,0,1,0,0,0,,0,0,0
20535,Bruno Caboclo,21-073,F,12/3/16,TOR,,ATL,W,0,4,0,1,0,0,1,0,0,0,,0,0,,1,2,3
20536,Jose Calderon,35-032,G,10/30/16,LAL,@,OKC,L,0,4,0,1,0,0,0,,0,1,0,0,0,,0,0,0
20537,Jose Calderon,35-106,G,1/12/17,LAL,@,SAS,L,0,5,0,1,0,0,1,0,0,0,,0,0,,0,1,1
20538,Jose Calderon,35-161,G,3/8/17,ATL,,BRK,W,0,12,0,2,0,0,0,,0,2,0,0,0,,0,0,0
20539,Jose Calderon,35-104,G,1/10/17,LAL,,POR,L,0,3,0,0,,0,0,,0,0,,0,0,,0,0,0
20540,Jose Calderon,35-133,G,2/8/17,LAL,@,DET,L,0,5,0,0,,0,0,,0,0,,0,0,,0,1,1
20541,Jose Calderon,35-100,G,1/6/17,LAL,,MIA,W,0,5,0,1,0,0,0,,0,1,0,0,0,,1,1,2
20542,Jose Calderon,35-120,G,1/26/17,LAL,@,UTA,L,1,12,0,3,0,0,3,0,0,0,,0,0,,0,1,1
20543,Jose Calderon,35-066,G,12/3/16,LAL,@,MEM,L,1,8,0,2,0,0,1,0,0,1,0,0,0,,0,5,5
20544,Jose Calderon,35-119,G,1/25/17,LAL,@,POR,L,1,15,0,3,0,0,2,0,0,1,0,0,0,,0,1,1
20545,Jose Calderon,35-171,G,3/18/17,ATL,,POR,L,0,3,0,0,,0,0,,0,0,,0,0,,0,0,0
20546,Jose Calderon,35-046,G,11/13/16,LAL,@,MIN,L,0,10,0,2,0,0,1,0,0,1,0,0,0,,1,2,3
20547,Jose Calderon,35-169,G,3/16/17,ATL,,MEM,L,0,18,0,1,0,0,0,,0,1,0,0,0,,0,4,4
20548,Jose Calderon,35-166,G,3/13/17,ATL,@,SAS,L,0,10,0,2,0,0,0,,0,2,0,0,0,,0,0,0
20549,Jose Calderon,35-041,G,11/8/16,LAL,,DAL,L,0,6,0,0,,0,0,,0,0,,0,0,,0,1,1
20550,Jose Calderon,35-111,G,1/17/17,LAL,,DEN,L,0,7,0,1,0,0,1,0,0,0,,0,0,,0,1,1
20551,Kentavious Caldwell-Pope,23-329,G,1/12/17,DET,@,GSW,L,1,4,0,0,,0,0,,0,0,,0,0,,0,0,0
20552,Isaiah Canaan,25-209,G,12/16/16,CHI,,MIL,L,0,12,0,4,0,0,2,0,0,2,0,0,0,,0,0,0
20553,Isaiah Canaan,25-265,G,2/10/17,CHI,@,PHO,L,0,4,0,0,,0,0,,0,0,,0,0,,0,0,0
20554,Isaiah Canaan,25-201,G,12/8/16,CHI,,SAS,W,0,10,0,2,0,0,1,0,0,1,0,0,0,,0,0,0
20555,Isaiah Canaan,25-234,G,1/10/17,CHI,@,WAS,L,0,10,0,0,,0,0,,0,0,,0,0,,0,1,1
20556,Isaiah Canaan,25-224,G,12/31/16,CHI,,MIL,L,0,2,0,0,,0,0,,0,0,,0,0,,0,0,0
20557,Isaiah Canaan,25-289,G,3/6/17,CHI,@,DET,L,0,2,0,0,,0,0,,0,0,,0,0,,0,0,0
20558,Isaiah Canaan,25-159,G,10/27/16,CHI,,BOS,W,0,7,0,3,0,0,0,,0,3,0,0,0,,0,2,2
20559,Isaiah Canaan,25-173,G,11/10/16,CHI,@,MIA,W,0,9,0,1,0,0,0,,0,1,0,0,0,,0,1,1
20560,Isaiah Canaan,25-212,G,12/19/16,CHI,,DET,W,0,5,0,1,0,0,0,,0,1,0,0,0,,0,1,1
20561,Isaiah Canaan,25-269,G,2/14/17,CHI,,TOR,W,0,0,0,0,,0,0,,0,0,,0,0,,0,0,0
20562,Clint Capela,22-244,F-C,1/17/17,HOU,@,MIA,L,1,9,0,3,0,0,3,0,0,0,,0,0,,2,4,6
20563,DeMarre Carroll,30-175,F,1/18/17,TOR,@,PHI,L,1,23,0,6,0,0,2,0,0,4,0,0,0,,0,2,2
20564,DeMarre Carroll,30-100,F,11/4/16,TOR,,MIA,W,1,20,0,2,0,0,1,0,0,1,0,0,0,,0,1,1
20565,DeMarre Carroll,30-217,F,3/1/17,TOR,,WAS,L,1,30,0,3,0,0,3,0,0,0,,0,0,,2,2,4
20566,DeMarre Carroll,30-191,F,2/3/17,TOR,@,ORL,L,1,18,0,3,0,0,1,0,0,2,0,0,0,,1,2,3
20567,Vince Carter,40-002,G-F,1/28/17,MEM,@,UTA,W,0,30,0,7,0,0,4,0,0,3,0,0,0,,0,2,2
20568,Vince Carter,40-015,G-F,2/10/17,MEM,,GSW,L,0,19,0,3,0,0,2,0,0,1,0,0,0,,1,1,2
20569,Vince Carter,40-033,G-F,2/28/17,MEM,,PHO,W,0,2,0,1,0,0,1,0,0,0,,0,0,,0,0,0
20570,Vince Carter,39-281,G-F,11/2/16,MEM,,NOP,W,0,32,0,5,0,0,1,0,0,4,0,0,0,,1,2,3
20571,Michael Carter-Williams,25-021,G,10/31/16,CHI,@,BRK,W,0,5,0,1,0,0,1,0,0,0,,0,0,,0,2,2
20572,Omri Casspi,28-195,F,1/3/17,SAC,@,DEN,W,0,17,0,3,0,0,2,0,0,1,0,0,0,,1,4,5
20573,Omri Casspi,28-129,F,10/29/16,SAC,,MIN,W,0,10,0,1,0,0,0,,0,1,0,0,0,,0,3,3
20574,Willie Cauley-Stein,23-101,F-C,11/27/16,SAC,@,BRK,W,0,3,0,1,0,0,1,0,0,0,,0,0,,0,1,1
20575,Willie Cauley-Stein,23-135,F-C,12/31/16,SAC,,MEM,L,0,3,0,0,,0,0,,0,0,,0,0,,0,0,0
20576,Willie Cauley-Stein,23-074,F-C,10/31/16,SAC,@,ATL,L,0,12,0,2,0,0,2,0,0,0,,0,0,,1,0,1
20577,Willie Cauley-Stein,23-132,F-C,12/28/16,SAC,@,POR,L,0,10,0,0,,0,0,,0,0,,0,2,0,0,2,2
20578,Willie Cauley-Stein,23-113,F-C,12/9/16,SAC,,NYK,L,0,12,0,2,0,0,2,0,0,0,,0,0,,1,0,1
20579,Willie Cauley-Stein,23-153,F-C,1/18/17,SAC,,IND,L,0,6,0,0,,0,0,,0,0,,0,0,,1,0,1
20580,Willie Cauley-Stein,23-148,F-C,1/13/17,SAC,,CLE,L,0,1,0,0,,0,0,,0,0,,0,0,,0,0,0
20581,Willie Cauley-Stein,23-120,F-C,12/16/16,SAC,@,MEM,W,0,2,0,0,,0,0,,0,0,,0,2,0,0,0,0
20582,Willie Cauley-Stein,23-138,F-C,1/3/17,SAC,@,DEN,W,0,1,0,1,0,0,1,0,0,0,,0,0,,0,0,0
20583,Marquese Chriss,19-130,F,11/9/16,PHO,,DET,W,1,14,0,4,0,0,3,0,0,1,0,0,0,,2,3,5
20584,Marquese Chriss,19-127,F,11/6/16,PHO,@,LAL,L,0,1,0,0,,0,0,,0,0,,0,0,,0,0,0
20585,Rakeem Christmas,25-109,F,3/20/17,IND,,UTA,W,0,2,0,1,0,0,1,0,0,0,,0,0,,0,1,1
20586,Rakeem Christmas,24-365,F,11/30/16,IND,@,POR,L,0,2,0,0,,0,0,,0,0,,0,0,,0,0,0
20587,Rakeem Christmas,24-333,F,10/29/16,IND,@,CHI,L,0,7,0,1,0,0,1,0,0,0,,0,0,,0,1,1
20588,Rakeem Christmas,25-099,F,3/10/17,IND,@,MIL,L,0,3,0,1,0,0,1,0,0,0,,0,0,,1,0,1
20589,Rakeem Christmas,25-076,F,2/15/17,IND,@,CLE,L,0,3,0,1,0,0,1,0,0,0,,0,0,,2,2,4
20590,Rakeem Christmas,25-069,F,2/8/17,IND,,CLE,L,0,2,0,0,,0,0,,0,0,,0,0,,0,0,0
20591,Rakeem Christmas,25-065,F,2/4/17,IND,,DET,W,0,2,0,1,0,0,1,0,0,0,,0,0,,0,0,0
20592,Semaj Christon,24-130,G,3/11/17,OKC,,UTA,W,0,17,0,5,0,0,2,0,0,3,0,0,0,,0,1,1
20593,Semaj Christon,24-008,G,11/9/16,OKC,,TOR,L,0,16,0,1,0,0,0,,0,1,0,0,0,,0,3,3
20594,Semaj Christon,24-024,G,11/25/16,OKC,@,DEN,W,0,0,0,0,,0,0,,0,0,,0,0,,0,0,0
20595,Semaj Christon,24-128,G,3/9/17,OKC,,SAS,W,0,19,0,0,,0,0,,0,0,,0,0,,0,1,1
20596,Semaj Christon,24-022,G,11/23/16,OKC,@,SAC,L,0,8,0,0,,0,0,,0,0,,0,0,,0,0,0
20597,Semaj Christon,24-056,G,12/27/16,OKC,@,MIA,W,0,11,0,0,,0,0,,0,0,,0,0,,0,1,1
20598,Semaj Christon,24-102,G,2/11/17,OKC,,GSW,L,0,5,0,1,0,0,0,,0,1,0,0,0,,0,0,0
20599,Semaj Christon,24-126,G,3/7/17,OKC,,POR,L,0,10,0,3,0,0,2,0,0,1,0,0,0,,1,1,2
20600,Semaj Christon,24-021,G,11/22/16,OKC,@,LAL,L,0,4,0,2,0,0,1,0,0,1,0,0,0,,0,0,0
20601,Semaj Christon,24-056,G,12/27/16,OKC,@,MIA,W,0,11,0,0,,0,0,,0,0,,0,0,,0,1,1
20602,Semaj Christon,24-102,G,2/11/17,OKC,,GSW,L,0,5,0,1,0,0,0,,0,1,0,0,0,,0,0,0
20603,Semaj Christon,24-128,G,3/9/17,OKC,,SAS,W,0,19,0,0,,0,0,,0,0,,0,0,,0,1,1
20604,Semaj Christon,24-021,G,11/22/16,OKC,@,LAL,L,0,4,0,2,0,0,1,0,0,1,0,0,0,,0,0,0
20605,Semaj Christon,24-038,G,12/9/16,OKC,,HOU,L,0,12,0,3,0,0,3,0,0,0,,0,0,,1,0,1
20606,Semaj Christon,24-126,G,3/7/17,OKC,,POR,L,0,10,0,3,0,0,2,0,0,1,0,0,0,,1,1,2
20607,Semaj Christon,24-017,G,11/18/16,OKC,,BRK,W,0,11,0,1,0,0,1,0,0,0,,0,0,,0,2,2
20608,Semaj Christon,24-124,G,3/5/17,OKC,@,DAL,L,0,5,0,0,,0,0,,0,0,,0,0,,0,0,0
20609,Semaj Christon,24-122,G,3/3/17,OKC,@,PHO,L,0,0,0,0,,0,0,,0,0,,0,0,,0,0,0
20610,Semaj Christon,24-013,G,11/14/16,OKC,@,DET,L,0,15,0,4,0,0,4,0,0,0,,0,0,,0,2,2
20611,Ian Clark,26-007,G,3/14/17,GSW,,PHI,W,0,12,0,3,0,0,2,0,0,1,0,0,0,,0,3,3
20612,Ian Clark,25-279,G,12/11/16,GSW,@,MIN,W,0,6,0,0,,0,0,,0,0,,0,0,,0,1,1
20613,Ian Clark,25-305,G,1/6/17,GSW,,MEM,L,0,6,0,1,0,0,0,,0,1,0,0,0,,0,0,0
20614,Ian Clark,25-235,G,10/28/16,GSW,@,NOP,W,0,5,0,1,0,0,1,0,0,0,,0,0,,0,0,0
20615,Ian Clark,25-341,G,2/11/17,GSW,@,OKC,W,0,15,0,2,0,0,1,0,0,1,0,0,0,,0,2,2
20616,Ian Clark,25-319,G,1/20/17,GSW,@,HOU,W,0,13,0,1,0,0,0,,0,1,0,0,0,,0,1,1
20617,Ian Clark,25-340,G,2/10/17,GSW,@,MEM,W,0,4,0,0,,0,0,,0,0,,0,0,,0,1,1
20618,Ian Clark,25-317,G,1/18/17,GSW,,OKC,W,0,13,0,3,0,0,2,0,0,1,0,0,0,,1,1,2
20619,Norris Cole,28-154,G,3/16/17,OKC,@,TOR,W,0,3,0,1,0,0,1,0,0,0,,0,0,,0,0,0
20620,Nick Collison,36-016,F,11/11/16,OKC,,LAC,L,0,5,0,1,0,0,1,0,0,0,,0,0,,0,0,0
20621,Nick Collison,36-007,F,11/2/16,OKC,@,LAC,W,0,7,0,0,,0,0,,0,0,,0,0,,0,2,2
20622,Nick Collison,36-054,F,12/19/16,OKC,,ATL,L,0,1,0,0,,0,0,,0,0,,0,0,,0,0,0
20623,Nick Collison,36-048,F,12/13/16,OKC,@,POR,L,0,8,0,0,,0,0,,0,0,,0,0,,0,3,3
20624,Nick Collison,36-108,F,2/11/17,OKC,,GSW,L,0,2,0,0,,0,0,,0,0,,0,0,,0,0,0
20625,Nick Collison,36-021,F,11/16/16,OKC,,HOU,W,0,3,0,0,,0,0,,0,0,,0,0,,0,0,0
20626,Nick Collison,36-019,F,11/14/16,OKC,@,DET,L,0,2,0,0,,0,0,,0,0,,0,0,,0,0,0
20627,Nick Collison,36-098,F,2/1/17,OKC,,CHI,L,0,3,0,0,,0,0,,0,0,,0,0,,0,0,0
20628,Nick Collison,36-018,F,11/13/16,OKC,,ORL,L,0,5,0,1,0,0,1,0,0,0,,0,0,,0,0,0
20629,Nick Collison,36-077,F,1/11/17,OKC,,MEM,W,0,4,0,0,,0,0,,0,0,,0,0,,0,0,0
20630,Pat Connaughton,23-300,G,11/1/16,POR,,GSW,L,0,8,0,0,,0,0,,0,0,,0,0,,0,1,1
20631,Pat Connaughton,23-329,G,11/30/16,POR,,IND,W,0,2,0,0,,0,0,,0,0,,0,0,,0,1,1
20632,Pat Connaughton,24-005,G,1/11/17,POR,,CLE,W,0,4,0,1,0,0,1,0,0,0,,0,0,,1,0,1
20633,Pat Connaughton,23-324,G,11/25/16,POR,,NOP,W,0,1,0,0,,0,0,,0,0,,0,0,,0,0,0
20634,Pat Connaughton,24-004,G,1/10/17,POR,@,LAL,W,0,3,0,0,,0,0,,0,0,,0,0,,0,0,0
20635,Pat Connaughton,23-364,G,1/4/17,POR,@,GSW,L,0,9,0,0,,0,0,,0,0,,0,0,,0,0,0
20636,Pat Connaughton,24-023,G,1/29/17,POR,,GSW,L,0,0,0,0,,0,0,,0,0,,0,0,,0,0,0
20637,Pat Connaughton,24-071,G,3/18/17,POR,@,ATL,W,0,3,0,0,,0,0,,0,0,,0,0,,0,0,0
20638,Pat Connaughton,23-319,G,11/20/16,POR,@,BRK,W,0,3,0,1,0,0,0,,0,1,0,0,0,,0,0,0
20639,Pat Connaughton,23-317,G,11/18/16,POR,@,NOP,L,0,2,0,0,,0,0,,0,0,,0,0,,0,0,0
20640,Pat Connaughton,23-352,G,12/23/16,POR,,SAS,L,0,8,0,0,,0,0,,0,0,,0,0,,0,1,1
20641,Pat Connaughton,24-057,G,3/4/17,POR,,BRK,W,0,6,0,0,,0,0,,0,0,,0,0,,0,1,1
20642,Pat Connaughton,24-012,G,1/18/17,POR,@,CHO,L,0,4,0,1,0,0,0,,0,1,0,0,0,,1,1,2
20643,Pat Connaughton,24-055,G,3/2/17,POR,,OKC,W,0,8,0,0,,0,0,,0,0,,0,0,,0,1,1
20644,Pat Connaughton,23-344,G,12/15/16,POR,@,DEN,L,0,1,0,0,,0,0,,0,0,,0,0,,0,0,0
20645,Quinn Cook,23-363,G,3/21/17,NOP,,MEM,W,0,0,0,0,,0,0,,0,0,,0,0,,0,0,0
20646,Quinn Cook,23-361,G,3/19/17,NOP,,MIN,W,0,1,0,1,0,0,0,,0,1,0,0,0,,0,0,0
20647,Robert Covington,25-323,F,11/1/16,PHI,,ORL,L,1,28,0,6,0,0,2,0,0,4,0,0,0,,0,5,5
20648,Robert Covington,25-320,F,10/29/16,PHI,,ATL,L,1,23,0,5,0,0,0,,0,5,0,0,0,,0,1,1
20649,Jamal Crawford,36-302,G,1/16/17,LAC,,OKC,W,0,23,0,5,0,0,4,0,0,1,0,0,0,,1,3,4
20650,Jamal Crawford,36-341,G,2/24/17,LAC,,SAS,L,0,19,0,2,0,0,1,0,0,1,0,0,0,,0,0,0
20651,Jamal Crawford,36-286,G,12/31/16,LAC,@,OKC,L,0,31,0,4,0,0,2,0,0,2,0,0,0,,0,2,2
20652,Jae Crowder,26-184,F,1/6/17,BOS,,PHI,W,1,30,0,4,0,0,2,0,0,2,0,0,0,,1,1,2
20653,Dante Cunningham,29-194,F,11/2/16,NOP,@,MEM,L,1,5,0,2,0,0,0,,0,2,0,0,0,,0,0,0
20654,Dante Cunningham,29-284,F,1/31/17,NOP,@,TOR,L,1,6,0,0,,0,0,,0,0,,0,0,,1,0,1
20655,Dante Cunningham,29-243,F,12/21/16,NOP,,OKC,L,0,13,0,1,0,0,0,,0,1,0,0,0,,0,1,1
20656,Dante Cunningham,29-187,F,10/26/16,NOP,,DEN,L,0,9,0,2,0,0,1,0,0,1,0,0,0,,0,0,0
20657,Dante Cunningham,29-260,F,1/7/17,NOP,@,BOS,L,1,24,0,4,0,0,1,0,0,3,0,0,0,,1,2,3
20658,Seth Curry,26-068,G,10/30/16,DAL,@,HOU,L,1,24,0,4,0,0,2,0,0,2,0,0,0,,0,3,3
20659,Seth Curry,26-137,G,1/7/17,DAL,,ATL,L,0,13,0,3,0,0,2,0,0,1,0,0,0,,0,0,0
20660,Troy Daniels,25-136,G,11/28/16,MEM,,CHO,L,0,14,0,3,0,0,1,0,0,2,0,0,0,,0,1,1
20661,Troy Daniels,25-206,G,2/6/17,MEM,,SAS,W,0,2,0,3,0,0,0,,0,3,0,0,0,,0,0,0
20662,Troy Daniels,25-231,G,3/3/17,MEM,@,DAL,L,0,15,0,5,0,0,1,0,0,4,0,0,0,,0,1,1
20663,Troy Daniels,25-203,G,2/3/17,MEM,@,OKC,L,0,1,0,0,,0,0,,0,0,,0,0,,0,0,0
20664,Troy Daniels,25-129,G,11/21/16,MEM,@,CHO,W,0,2,0,1,0,0,0,,0,1,0,0,0,,0,0,0
20665,Troy Daniels,25-112,G,11/4/16,MEM,,LAC,L,0,6,0,2,0,0,0,,0,2,0,0,0,,0,0,0
20666,Troy Daniels,25-199,G,1/30/17,MEM,@,PHO,W,0,7,0,1,0,0,0,,0,1,0,0,0,,0,0,0
20667,Troy Daniels,25-156,G,12/18/16,MEM,,UTA,L,1,11,0,1,0,0,1,0,0,0,,0,0,,0,0,0
20668,Troy Daniels,25-109,G,11/1/16,MEM,@,MIN,L,0,12,0,5,0,0,1,0,0,4,0,0,0,,0,0,0
20669,Troy Daniels,25-189,G,1/20/17,MEM,,SAC,W,0,8,0,2,0,0,0,,0,2,0,0,0,,0,0,0
20670,Troy Daniels,25-234,G,3/6/17,MEM,,BRK,L,0,2,0,2,0,0,0,,0,2,0,0,0,,0,0,0
20671,Deyonta Davis,19-338,F-C,11/4/16,MEM,,LAC,L,0,0,0,0,,0,0,,0,0,,0,0,,0,0,0
20672,Deyonta Davis,20-008,F-C,12/10/16,MEM,,GSW,W,0,2,0,0,,0,0,,0,0,,0,0,,0,1,1
20673,Deyonta Davis,20-092,F-C,3/4/17,MEM,@,HOU,L,0,1,0,0,,0,0,,0,0,,0,0,,0,0,0
20674,Deyonta Davis,19-333,F-C,10/30/16,MEM,,WAS,W,0,1,0,0,,0,0,,0,0,,0,0,,0,0,0
20675,Deyonta Davis,19-357,F-C,11/23/16,MEM,@,PHI,W,0,0,0,0,,0,0,,0,0,,0,0,,0,0,0
20676,Deyonta Davis,20-006,F-C,12/8/16,MEM,,POR,W,0,6,0,0,,0,0,,0,0,,0,0,,0,2,2
20677,Deyonta Davis,19-332,F-C,10/29/16,MEM,@,NYK,L,0,1,0,0,,0,0,,0,0,,0,0,,0,0,0
20678,Deyonta Davis,19-355,F-C,11/21/16,MEM,@,CHO,W,0,2,0,1,0,0,1,0,0,0,,0,0,,1,0,1
20679,Deyonta Davis,20-003,F-C,12/5/16,MEM,@,NOP,W,0,6,0,0,,0,0,,0,0,,0,0,,0,1,1
20680,Deyonta Davis,19-329,F-C,10/26/16,MEM,,MIN,W,0,6,0,0,,0,0,,0,0,,0,0,,0,2,2
20681,Deyonta Davis,20-061,F-C,2/1/17,MEM,@,DEN,W,0,5,0,2,0,0,2,0,0,0,,0,2,0,1,1,2
20682,Deyonta Davis,19-352,F-C,11/18/16,MEM,@,DAL,W,0,2,0,0,,0,0,,0,0,,0,0,,0,0,0
20683,Deyonta Davis,19-350,F-C,11/16/16,MEM,@,LAC,W,0,8,0,2,0,0,2,0,0,0,,0,0,,1,2,3
20684,Deyonta Davis,20-050,F-C,1/21/17,MEM,,HOU,L,0,3,0,0,,0,0,,0,0,,0,0,,0,2,2
20685,Deyonta Davis,20-049,F-C,1/20/17,MEM,,SAC,W,0,3,0,1,0,0,1,0,0,0,,0,0,,0,1,1
20686,Deyonta Davis,20-106,F-C,3/18/17,MEM,,SAS,W,0,1,0,0,,0,0,,0,0,,0,0,,0,0,0
20687,Ed Davis,27-195,F,12/17/16,POR,@,GSW,L,0,5,0,0,,0,0,,0,0,,0,0,,0,1,1
20688,Ed Davis,27-149,F,11/1/16,POR,,GSW,L,0,16,0,4,0,0,4,0,0,0,,0,0,,1,2,3
20689,Ed Davis,27-210,F,1/1/17,POR,@,MIN,W,0,8,0,0,,0,0,,0,0,,0,2,0,0,2,2
20690,Ed Davis,27-144,F,10/27/16,POR,,LAC,L,0,13,0,1,0,0,1,0,0,0,,0,0,,0,3,3
20691,Ed Davis,27-157,F,11/9/16,POR,@,LAC,L,0,2,0,0,,0,0,,0,0,,0,0,,0,0,0
20692,Ed Davis,27-204,F,12/26/16,POR,,TOR,L,0,10,0,3,0,0,3,0,0,0,,0,0,,1,4,5
20693,Dewayne Dedmon,27-118,C,12/8/16,SAS,@,CHI,L,0,13,0,0,,0,0,,0,0,,0,0,,1,6,7
20694,Dewayne Dedmon,27-091,C,11/11/16,SAS,,DET,W,0,6,0,0,,0,0,,0,0,,0,0,,1,1,2
20695,Dewayne Dedmon,27-168,C,1/27/17,SAS,@,NOP,L,0,8,0,1,0,0,1,0,0,0,,0,0,,1,4,5
20696,Dewayne Dedmon,27-206,C,3/6/17,SAS,,HOU,W,1,9,0,0,,0,0,,0,0,,0,0,,0,4,4
20697,Dewayne Dedmon,27-112,C,12/2/16,SAS,,WAS,W,0,8,0,2,0,0,2,0,0,0,,0,0,,1,3,4
20698,Dewayne Dedmon,27-130,C,12/20/16,SAS,@,HOU,W,0,11,0,0,,0,0,,0,0,,0,0,,2,1,3
20699,Dewayne Dedmon,27-142,C,1/1/17,SAS,@,ATL,L,0,6,0,1,0,0,1,0,0,0,,0,0,,0,2,2
20700,Dewayne Dedmon,27-094,C,11/14/16,SAS,,MIA,W,0,10,0,3,0,0,3,0,0,0,,0,0,,3,3,6
20701,Sam Dekker,22-247,F,1/8/17,HOU,@,TOR,W,0,11,0,1,0,0,1,0,0,0,,0,2,0,2,1,3
20702,Sam Dekker,22-315,F,3/17/17,HOU,@,NOP,L,0,5,0,0,,0,0,,0,0,,0,0,,0,0,0
20703,Sam Dekker,22-241,F,1/2/17,HOU,,WAS,W,0,17,0,2,0,0,0,,0,2,0,0,0,,1,5,6
20704,Sam Dekker,22-310,F,3/12/17,HOU,,CLE,W,0,5,0,1,0,0,0,,0,1,0,0,0,,0,0,0
20705,Sam Dekker,22-239,F,12/31/16,HOU,,NYK,W,0,13,0,4,0,0,1,0,0,3,0,0,0,,3,2,5
20706,Malcolm Delaney,28-009,G,3/20/17,ATL,@,CHO,L,0,16,0,3,0,0,2,0,0,1,0,0,1,0,0,2,2
20707,Malcolm Delaney,28-005,G,3/16/17,ATL,,MEM,L,0,2,0,1,0,0,1,0,0,0,,0,0,,0,0,0
20708,Malcolm Delaney,27-259,G,11/25/16,ATL,@,UTA,L,0,13,0,4,0,0,2,0,0,2,0,0,0,,0,0,0
20709,Malcolm Delaney,27-360,G,3/6/17,ATL,,GSW,L,0,19,0,3,0,0,2,0,0,1,0,0,0,,1,1,2
20710,Malcolm Delaney,27-285,G,12/21/16,ATL,,MIN,L,0,6,0,2,0,0,2,0,0,0,,0,0,,0,0,0
20711,Matthew Dellavedova,26-134,G,1/20/17,MIL,@,ORL,L,0,13,0,4,0,0,3,0,0,1,0,0,0,,0,1,1
20712,Matthew Dellavedova,26-171,G,2/26/17,MIL,,PHO,W,1,24,0,6,0,0,2,0,0,4,0,0,0,,0,2,2
20713,Matthew Dellavedova,26-070,G,11/17/16,MIL,@,MIA,L,1,32,0,7,0,0,6,0,0,1,0,0,0,,0,4,4
20714,Matthew Dellavedova,26-099,G,12/16/16,MIL,@,CHI,W,1,21,0,3,0,0,2,0,0,1,0,0,0,,0,2,2
20715,Matthew Dellavedova,26-158,G,2/13/17,MIL,,DET,W,1,27,0,2,0,0,2,0,0,0,,0,0,,0,1,1
20716,Luol Deng,31-300,F,2/10/17,LAL,@,MIL,W,0,29,0,3,0,0,2,0,0,1,0,0,0,,0,3,3
20717,Luol Deng,31-197,F,10/30/16,LAL,@,OKC,L,1,22,0,3,0,0,1,0,0,2,0,0,0,,1,1,2
20718,Luol Deng,31-210,F,11/12/16,LAL,@,NOP,W,1,18,0,6,0,0,4,0,0,2,0,0,0,,1,3,4
20719,Luol Deng,31-316,F,2/26/17,LAL,,SAS,L,0,13,0,2,0,0,1,0,0,1,0,0,0,,0,4,4
20720,Cheick Diallo,20-118,F,1/9/17,NOP,@,NYK,W,0,5,0,4,0,0,4,0,0,0,,0,0,,0,0,0
20721,Cheick Diallo,20-187,F,3/19/17,NOP,,MIN,W,0,1,0,1,0,0,1,0,0,0,,0,0,,0,1,1
20722,Cheick Diallo,20-077,F,11/29/16,NOP,,LAL,W,0,1,0,0,,0,0,,0,0,,0,0,,0,0,0
20723,Cheick Diallo,20-169,F,3/1/17,NOP,,DET,W,0,2,0,1,0,0,1,0,0,0,,0,0,,1,0,1
20724,Cheick Diallo,20-046,F,10/29/16,NOP,@,SAS,L,0,6,0,2,0,0,2,0,0,0,,0,0,,1,0,1
20725,Cheick Diallo,20-132,F,1/23/17,NOP,,CLE,W,0,0,0,0,,0,0,,0,0,,0,0,,0,0,0
20726,Boris Diaw,34-264,F-C,1/5/17,UTA,@,TOR,L,0,3,0,0,,0,0,,0,0,,0,0,,0,0,0
20727,Boris Diaw,34-319,F-C,3/1/17,UTA,,MIN,L,0,4,0,1,0,0,1,0,0,0,,0,0,,0,1,1
20728,Boris Diaw,34-197,F-C,10/30/16,UTA,@,LAC,L,1,19,0,2,0,0,1,0,0,1,0,0,0,,0,1,1
20729,Boris Diaw,34-229,F-C,12/1/16,UTA,,MIA,L,1,14,0,4,0,0,2,0,0,2,0,0,0,,0,1,1
20730,Boris Diaw,34-294,F-C,2/4/17,UTA,,CHO,W,1,11,0,2,0,0,2,0,0,0,,0,0,,0,1,1
20731,Boris Diaw,34-195,F-C,10/28/16,UTA,,LAL,W,1,18,0,1,0,0,1,0,0,0,,0,0,,1,2,3
20732,Boris Diaw,34-259,F-C,12/31/16,UTA,,PHO,W,0,14,0,2,0,0,2,0,0,0,,0,0,,0,2,2
20733,Boris Diaw,34-314,F-C,2/24/17,UTA,@,MIL,W,0,10,0,2,0,0,1,0,0,1,0,0,0,,0,0,0
20734,Boris Diaw,34-287,F-C,1/28/17,UTA,,MEM,L,0,18,0,3,0,0,1,0,0,2,0,0,0,,0,1,1
20735,Boris Diaw,34-269,F-C,1/10/17,UTA,,CLE,W,0,2,0,1,0,0,1,0,0,0,,0,0,,0,0,0
20736,Gorgui Dieng,27-058,C,3/17/17,MIN,@,MIA,L,1,28,0,7,0,0,7,0,0,0,,0,0,,1,4,5
20737,Spencer Dinwiddie,23-281,G,1/12/17,BRK,,NOP,L,0,25,0,5,0,0,1,0,0,4,0,0,0,,0,7,7
20738,Spencer Dinwiddie,23-310,G,2/10/17,BRK,,MIA,L,1,19,0,3,0,0,2,0,0,1,0,0,0,,0,3,3
20739,Spencer Dinwiddie,23-254,G,12/16/16,BRK,@,ORL,L,0,5,0,0,,0,0,,0,0,,0,0,,0,0,0
20740,Spencer Dinwiddie,23-290,G,1/21/17,BRK,@,CHO,L,1,23,0,4,0,0,3,0,0,1,0,0,0,,1,4,5
20741,Spencer Dinwiddie,23-252,G,12/14/16,BRK,,LAL,W,0,13,0,3,0,0,2,0,0,1,0,0,0,,1,0,1
20742,Spencer Dinwiddie,23-250,G,12/12/16,BRK,@,HOU,L,0,3,0,1,0,0,1,0,0,0,,0,0,,0,0,0
20743,Spencer Dinwiddie,23-284,G,1/15/17,BRK,,HOU,L,1,24,0,3,0,0,2,0,0,1,0,0,0,,1,1,2
20744,Toney Douglas,30-264,G,12/5/16,MEM,@,NOP,W,0,8,0,1,0,0,0,,0,1,0,0,0,,0,2,2
20745,Toney Douglas,31-000,G,3/16/17,MEM,@,ATL,W,0,2,0,1,0,0,1,0,0,0,,0,0,,0,0,0
20746,Toney Douglas,30-320,G,1/30/17,MEM,@,PHO,W,0,5,0,1,0,0,1,0,0,0,,0,0,,0,1,1
20747,Toney Douglas,30-334,G,2/13/17,MEM,@,BRK,W,0,19,0,3,0,0,1,0,0,2,0,0,0,,1,2,3
20748,Toney Douglas,30-358,G,3/9/17,MEM,,LAC,L,0,12,0,2,0,0,2,0,0,0,,0,0,,0,2,2
20749,Jared Dudley,31-209,F-G,2/4/17,PHO,,MIL,L,0,7,0,3,0,0,1,0,0,2,0,0,0,,0,1,1
20750,Jared Dudley,31-204,F-G,1/30/17,PHO,,MEM,L,0,5,0,0,,0,0,,0,0,,0,0,,0,0,0
20751,Jared Dudley,31-202,F-G,1/28/17,PHO,,DEN,L,0,7,0,1,0,0,0,,0,1,0,0,0,,0,1,1
20752,Jared Dudley,31-242,F-G,3/9/17,PHO,,LAL,L,0,17,0,2,0,0,0,,0,2,0,0,0,,0,3,3
20753,Jared Dudley,31-240,F-G,3/7/17,PHO,,WAS,L,0,6,0,1,0,0,1,0,0,0,,0,0,,0,0,0
20754,Jared Dudley,31-176,F-G,1/2/17,PHO,@,LAC,L,0,5,0,1,0,0,0,,0,1,0,0,0,,0,0,0
20755,Jared Dudley,31-238,F-G,3/5/17,PHO,,BOS,W,0,18,0,6,0,0,2,0,0,4,0,0,0,,0,4,4
20756,Mike Dunleavy,36-081,F-G,12/5/16,CLE,@,TOR,W,0,7,0,2,0,0,2,0,0,0,,0,0,,0,0,0
20757,Mike Dunleavy,36-105,F-G,12/29/16,CLE,,BOS,W,0,3,0,0,,0,0,,0,0,,0,0,,0,1,1
20758,Mike Dunleavy,36-146,F-G,2/8/17,ATL,,DEN,W,0,8,0,1,0,0,0,,0,1,0,0,0,,0,1,1
20759,Mike Dunleavy,36-123,F-G,1/16/17,ATL,@,NYK,W,0,19,0,5,0,0,3,0,0,2,0,0,0,,0,3,3
20760,Mike Dunleavy,36-057,F-G,11/11/16,CLE,@,WAS,W,0,13,0,3,0,0,0,,0,3,0,0,0,,0,0,0
20761,Kris Dunn,22-248,G,11/21/16,MIN,,BOS,L,0,10,0,2,0,0,2,0,0,0,,0,0,,0,1,1
20762,Kris Dunn,22-246,G,11/19/16,MIN,@,MEM,L,0,18,0,4,0,0,2,0,0,2,0,0,0,,0,1,1
20763,Kris Dunn,22-294,G,1/6/17,MIN,@,WAS,L,0,13,0,1,0,0,1,0,0,0,,0,0,,0,0,0
20764,Kris Dunn,22-291,G,1/3/17,MIN,@,PHI,L,0,18,0,2,0,0,2,0,0,0,,0,0,,0,2,2
20765,Kris Dunn,22-331,G,2/12/17,MIN,,CHI,W,0,12,0,2,0,0,1,0,0,1,0,0,0,,0,1,1
20766,Kris Dunn,22-257,G,11/30/16,MIN,,NYK,L,0,10,0,1,0,0,0,,0,1,0,0,0,,0,0,0
20767,Kris Dunn,22-305,G,1/17/17,MIN,@,SAS,L,0,9,0,2,0,0,2,0,0,0,,0,0,,0,0,0
20768,Kris Dunn,22-329,G,2/10/17,MIN,,NOP,L,0,9,0,2,0,0,0,,0,2,0,0,0,,0,0,0
20769,Kris Dunn,22-351,G,3/4/17,MIN,@,SAS,L,0,10,0,1,0,0,1,0,0,0,,0,0,,0,1,1
20770,Kris Dunn,22-255,G,11/28/16,MIN,,UTA,L,0,9,0,2,0,0,2,0,0,0,,0,0,,0,0,0
20771,Kris Dunn,22-287,G,12/30/16,MIN,,MIL,W,0,13,0,1,0,0,1,0,0,0,,0,0,,0,1,1
20772,Kris Dunn,22-303,G,1/15/17,MIN,@,DAL,L,0,13,0,3,0,0,1,0,0,2,0,0,0,,0,1,1
20773,Kris Dunn,22-320,G,2/1/17,MIN,@,CLE,L,0,10,0,0,,0,0,,0,0,,0,0,,0,0,0
20774,Kris Dunn,22-235,G,11/8/16,MIN,@,BRK,L,1,16,0,1,0,0,0,,0,1,0,0,0,,0,3,3
20775,Kris Dunn,22-360,G,3/13/17,MIN,,WAS,W,0,9,0,1,0,0,1,0,0,0,,0,0,,0,0,0
20776,Kevin Durant,28-152,F-G,2/28/17,GSW,@,WAS,L,1,2,0,1,0,0,1,0,0,0,,0,0,,0,0,0
20777,Henry Ellenson,19-310,F,11/18/16,DET,@,CLE,L,0,6,0,0,,0,0,,0,0,,0,0,,0,0,0
20778,Henry Ellenson,19-306,F,11/14/16,DET,,OKC,W,0,1,0,1,0,0,1,0,0,0,,0,0,,0,0,0
20779,Henry Ellenson,19-297,F,11/5/16,DET,,DEN,W,0,2,0,0,,0,0,,0,0,,0,0,,0,1,1
20780,Henry Ellenson,19-350,F,12/28/16,DET,,MIL,L,0,4,0,1,0,0,0,,0,1,0,0,0,,0,0,0
20781,Henry Ellenson,19-287,F,10/26/16,DET,@,TOR,L,0,2,0,1,0,0,1,0,0,0,,0,0,,1,1,2
20782,Henry Ellenson,19-348,F,12/26/16,DET,,CLE,W,0,2,0,2,0,0,2,0,0,0,,0,0,,0,0,0
20783,Henry Ellenson,19-341,F,12/19/16,DET,@,CHI,L,0,7,0,3,0,0,0,,0,3,0,0,0,,0,2,2
20784,Wayne Ellington,29-082,G,1/19/17,MIA,,DAL,W,0,19,0,4,0,0,1,0,0,3,0,0,0,,1,1,2
20785,Wayne Ellington,29-059,G,12/27/16,MIA,,OKC,L,0,13,0,3,0,0,0,,0,3,0,0,0,,0,0,0
20786,Monta Ellis,31-092,G,1/26/17,IND,@,MIN,W,0,14,0,6,0,0,5,0,0,1,0,0,0,,0,1,1
20787,Monta Ellis,31-098,G,2/1/17,IND,@,ORL,W,0,21,0,3,0,0,3,0,0,0,,0,0,,0,2,2
20788,Monta Ellis,31-095,G,1/29/17,IND,,HOU,W,0,16,0,3,0,0,2,0,0,1,0,0,0,,0,2,2
20789,Monta Ellis,31-044,G,12/9/16,IND,@,DAL,L,1,22,0,5,0,0,3,0,0,2,0,0,0,,0,2,2
20790,James Ennis,26-246,F,3/4/17,MEM,@,HOU,L,0,1,0,0,,0,0,,0,0,,0,0,,0,0,0
20791,James Ennis,26-245,F,3/3/17,MEM,@,DAL,L,0,5,0,0,,0,0,,0,0,,0,0,,1,2,3
20792,James Ennis,26-186,F,1/3/17,MEM,@,LAL,L,0,14,0,2,0,0,1,0,0,1,0,0,0,,0,3,3
20793,James Ennis,26-238,F,2/24/17,MEM,@,IND,L,0,10,0,1,0,0,1,0,0,0,,0,0,,1,1,2
20794,James Ennis,26-198,F,1/15/17,MEM,,CHI,L,0,22,0,3,0,0,3,0,0,0,,0,0,,0,3,3
20795,James Ennis,26-136,F,11/14/16,MEM,@,UTA,W,1,22,0,2,0,0,1,0,0,1,0,0,0,,1,2,3
20796,Tyler Ennis,22-063,G,10/26/16,HOU,@,LAL,L,0,12,0,1,0,0,1,0,0,0,,0,0,,0,0,0
20797,Tyler Ennis,22-112,G,12/14/16,HOU,,SAC,W,0,6,0,1,0,0,1,0,0,0,,0,0,,0,1,1
20798,Tyler Ennis,22-147,G,1/18/17,HOU,,MIL,W,0,2,0,1,0,0,1,0,0,0,,0,0,,0,0,0
20799,Tyler Ennis,22-188,G,2/28/17,LAL,,CHO,L,0,4,0,1,0,0,0,,0,1,0,0,0,,0,0,0
20800,Tyler Ennis,22-205,G,3/17/17,LAL,,MIL,L,0,3,0,0,,0,0,,0,0,,0,0,,0,0,0
20801,Tyler Ennis,22-128,G,12/30/16,HOU,,LAC,W,0,2,0,0,,0,0,,0,0,,0,0,,0,1,1
20802,Tyler Ennis,22-150,G,1/21/17,HOU,@,MEM,W,0,1,0,0,,0,0,,0,0,,0,0,,0,0,0
20803,Tyler Ennis,22-065,G,10/28/16,HOU,@,DAL,W,0,15,0,2,0,0,1,0,0,1,0,0,0,,0,1,1
20804,Tyler Ennis,22-063,G,10/26/16,HOU,@,LAL,L,0,12,0,1,0,0,1,0,0,0,,0,0,,0,0,0
20805,Tyler Ennis,22-112,G,12/14/16,HOU,,SAC,W,0,6,0,1,0,0,1,0,0,0,,0,0,,0,1,1
20806,Tyler Ennis,22-147,G,1/18/17,HOU,,MIL,W,0,2,0,1,0,0,1,0,0,0,,0,0,,0,0,0
20807,Tyler Ennis,22-188,G,2/28/17,LAL,,CHO,L,0,4,0,1,0,0,0,,0,1,0,0,0,,0,0,0
20808,Tyler Ennis,22-205,G,3/17/17,LAL,,MIL,L,0,3,0,0,,0,0,,0,0,,0,0,,0,0,0
20809,Tyler Ennis,22-108,G,12/10/16,HOU,,DAL,W,0,1,0,0,,0,0,,0,0,,0,0,,0,0,0
20810,Tyler Ennis,22-144,G,1/15/17,HOU,@,BRK,W,0,4,0,2,0,0,2,0,0,0,,0,0,,0,0,0
20811,Tyler Ennis,22-105,G,12/7/16,HOU,,LAL,W,0,3,0,0,,0,0,,0,0,,0,0,,0,0,0
20812,Tyler Ennis,22-140,G,1/11/17,HOU,@,MIN,L,0,1,0,0,,0,0,,0,0,,0,0,,0,1,1
20813,Tyler Ennis,22-171,G,2/11/17,HOU,,PHO,W,0,10,0,1,0,0,1,0,0,0,,0,0,,0,3,3
20814,Tyreke Evans,27-177,G-F,3/15/17,SAC,@,PHO,W,0,14,0,4,0,0,3,0,0,1,0,0,2,0,0,2,2
20815,Tyreke Evans,27-140,G-F,2/6/17,NOP,,PHO,W,0,8,0,3,0,0,2,0,0,1,0,0,0,,0,4,4
20816,Dante Exum,21-135,G,11/25/16,UTA,,ATL,W,0,5,0,2,0,0,1,0,0,1,0,0,0,,0,0,0
20817,Dante Exum,21-133,G,11/23/16,UTA,,DEN,W,0,8,0,1,0,0,0,,0,1,0,0,0,,0,0,0
20818,Dante Exum,21-187,G,1/16/17,UTA,@,PHO,W,0,8,0,1,0,0,0,,0,1,0,0,0,,0,0,0
20819,Dante Exum,21-250,G,3/20/17,UTA,@,IND,L,0,6,0,2,0,0,2,0,0,0,,0,0,,0,1,1
20820,Dante Exum,21-116,G,11/6/16,UTA,@,NYK,W,0,11,0,1,0,0,0,,0,1,0,0,0,,0,0,0
20821,Dante Exum,21-228,G,2/26/17,UTA,@,WAS,W,0,11,0,1,0,0,0,,0,1,0,0,0,,1,1,2
20822,Dante Exum,21-158,G,12/18/16,UTA,@,MEM,W,1,14,0,3,0,0,1,0,0,2,0,0,0,,0,2,2
20823,Kenneth Faried,27-064,F,1/22/17,DEN,@,MIN,L,1,14,0,0,,0,0,,0,0,,0,0,,0,2,2
20824,Kenneth Faried,27-030,F,12/19/16,DEN,,DAL,W,0,10,0,1,0,0,1,0,0,0,,0,2,0,0,3,3
20825,Kay Felder,21-333,G,2/25/17,CLE,,CHI,L,0,9,0,4,0,0,4,0,0,0,,0,0,,0,0,0
20826,Kay Felder,21-331,G,2/23/17,CLE,,NYK,W,0,3,0,1,0,0,1,0,0,0,,0,0,,0,1,1
20827,Kay Felder,21-267,G,12/21/16,CLE,,MIL,W,0,2,0,2,0,0,2,0,0,0,,0,0,,0,0,0
20828,Kay Felder,21-306,G,1/29/17,CLE,,OKC,W,0,12,0,3,0,0,3,0,0,0,,0,0,,0,0,0
20829,Kay Felder,21-323,G,2/15/17,CLE,,IND,W,0,3,0,0,,0,0,,0,0,,0,0,,0,0,0
20830,Kay Felder,21-229,G,11/13/16,CLE,,CHO,W,0,5,0,3,0,0,3,0,0,0,,0,0,,0,0,0
20831,Kay Felder,21-283,G,1/6/17,CLE,@,BRK,W,0,4,0,2,0,0,1,0,0,1,0,0,0,,0,1,1
20832,Kay Felder,21-319,G,2/11/17,CLE,,DEN,W,0,1,0,0,,0,0,,0,0,,0,0,,0,0,0
20833,Kay Felder,21-316,G,2/8/17,CLE,@,IND,W,0,6,0,0,,0,0,,0,0,,0,0,,0,1,1
20834,Kay Felder,21-314,G,2/6/17,CLE,@,WAS,W,0,9,0,1,0,0,1,0,0,0,,0,0,,0,2,2
20835,Kay Felder,21-245,G,11/29/16,CLE,@,MIL,L,0,6,0,0,,0,0,,0,0,,0,0,,0,0,0
20836,Cristiano Felicio,24-169,F-C,12/23/16,CHI,@,CHO,L,0,14,0,2,0,0,2,0,0,0,,0,2,0,4,2,6
20837,Cristiano Felicio,24-118,F-C,11/2/16,CHI,@,BOS,L,0,10,0,1,0,0,1,0,0,0,,0,0,,0,1,1
20838,Cristiano Felicio,24-141,F-C,11/25/16,CHI,@,PHI,W,0,7,0,5,0,0,5,0,0,0,,0,0,,3,2,5
20839,Cristiano Felicio,24-136,F-C,11/20/16,CHI,@,LAL,W,0,2,0,1,0,0,1,0,0,0,,0,0,,1,0,1
20840,Cristiano Felicio,24-135,F-C,11/19/16,CHI,@,LAC,L,0,2,0,0,,0,0,,0,0,,0,0,,0,1,1
20841,Raymond Felton,32-245,G,2/26/17,LAC,,CHO,W,0,12,0,2,0,0,1,0,0,1,0,0,0,,1,1,2
20842,Raymond Felton,32-138,G,11/11/16,LAC,@,OKC,W,0,11,0,1,0,0,1,0,0,0,,0,0,,0,0,0
20843,Raymond Felton,32-243,G,2/24/17,LAC,,SAS,L,0,14,0,2,0,0,2,0,0,0,,0,0,,0,0,0
20844,Raymond Felton,32-154,G,11/27/16,LAC,@,IND,L,0,18,0,6,0,0,4,0,0,2,0,0,0,,0,1,1
20845,Raymond Felton,32-175,G,12/18/16,LAC,@,WAS,L,0,11,0,3,0,0,3,0,0,0,,0,0,,1,1,2
20846,Yogi Ferrell,23-198,G,11/23/16,BRK,,BOS,L,0,8,0,3,0,0,2,0,0,1,0,0,0,,0,1,1
20847,Yogi Ferrell,23-195,G,11/20/16,BRK,,POR,L,0,12,0,3,0,0,1,0,0,2,0,0,0,,0,0,0
20848,Dorian Finney-Smith,23-240,F,12/30/16,DAL,@,GSW,L,1,21,0,3,0,0,1,0,0,2,0,0,0,,0,2,2
20849,Dorian Finney-Smith,23-175,F,10/26/16,DAL,@,IND,L,0,0,0,0,,0,0,,0,0,,0,0,,0,1,1
20850,Dorian Finney-Smith,23-258,F,1/17/17,DAL,@,CHI,W,0,8,0,0,,0,0,,0,0,,0,0,,0,1,1
20851,Dorian Finney-Smith,23-296,F,2/24/17,DAL,@,MIN,L,0,16,0,2,0,0,1,0,0,1,0,0,0,,0,3,3
20852,Dorian Finney-Smith,23-210,F,11/30/16,DAL,,SAS,L,1,18,0,3,0,0,1,0,0,2,0,0,0,,2,1,3
20853,Dorian Finney-Smith,23-256,F,1/15/17,DAL,,MIN,W,0,13,0,0,,0,0,,0,0,,0,0,,0,1,1
20854,Dorian Finney-Smith,23-271,F,1/30/17,DAL,,CLE,W,0,13,0,1,0,0,0,,0,1,0,0,0,,0,1,1
20855,Dorian Finney-Smith,23-285,F,2/13/17,DAL,,BOS,L,0,10,0,0,,0,0,,0,0,,0,0,,0,0,0
20856,Dorian Finney-Smith,23-233,F,12/23/16,DAL,@,LAC,W,1,30,0,8,0,0,2,0,0,6,0,0,0,,2,4,6
20857,Dorian Finney-Smith,23-321,F,3/21/17,DAL,,GSW,L,0,16,0,4,0,0,1,0,0,3,0,0,0,,0,0,0
20858,Dorian Finney-Smith,23-281,F,2/9/17,DAL,,UTA,W,0,14,0,2,0,0,1,0,0,1,0,0,2,0,1,2,3
20859,Dorian Finney-Smith,23-184,F,11/4/16,DAL,,POR,L,0,1,0,0,,0,0,,0,0,,0,0,,0,0,0
20860,Dorian Finney-Smith,23-182,F,11/2/16,DAL,@,UTA,L,0,2,0,0,,0,0,,0,0,,0,0,,0,0,0
20861,Dorian Finney-Smith,23-244,F,1/3/17,DAL,,WAS,W,1,26,0,1,0,0,0,,0,1,0,0,0,,0,6,6
20862,Dorian Finney-Smith,23-177,F,10/28/16,DAL,,HOU,L,0,1,0,0,,0,0,,0,0,,0,0,,0,0,0
20863,Bryn Forbes,23-104,G,11/4/16,SAS,@,UTA,W,0,3,0,0,,0,0,,0,0,,0,0,,0,0,0
20864,Bryn Forbes,23-152,G,12/22/16,SAS,@,LAC,L,0,1,0,1,0,0,0,,0,1,0,0,0,,0,0,0
20865,Bryn Forbes,23-202,G,2/10/17,SAS,@,DET,W,0,1,0,0,,0,0,,0,0,,0,0,,0,0,0
20866,Bryn Forbes,23-101,G,11/1/16,SAS,,UTA,L,0,1,0,0,,0,0,,0,0,,0,0,,0,0,0
20867,Bryn Forbes,23-144,G,12/14/16,SAS,,BOS,W,0,0,0,0,,0,0,,0,0,,0,0,,0,0,0
20868,Bryn Forbes,23-194,G,2/2/17,SAS,,PHI,W,0,3,0,1,0,0,1,0,0,0,,0,0,,0,0,0
20869,Bryn Forbes,23-136,G,12/6/16,SAS,@,MIN,W,0,2,0,1,0,0,0,,0,1,0,0,0,,0,0,0
20870,Bryn Forbes,23-126,G,11/26/16,SAS,@,WAS,W,0,1,0,0,,0,0,,0,0,,0,0,,0,1,1
20871,Bryn Forbes,23-094,G,10/25/16,SAS,@,GSW,W,0,4,0,0,,0,0,,0,0,,0,0,,0,0,0
20872,Bryn Forbes,23-116,G,11/16/16,SAS,@,SAC,W,0,3,0,2,0,0,1,0,0,1,0,0,0,,0,0,0
20873,Bryn Forbes,23-178,G,1/17/17,SAS,,MIN,W,0,0,0,0,,0,0,,0,0,,0,0,,0,0,0
20874,Bryn Forbes,23-111,G,11/11/16,SAS,,DET,W,0,1,0,0,,0,0,,0,0,,0,0,,0,0,0
20875,Bryn Forbes,23-153,G,12/23/16,SAS,@,POR,W,0,2,0,0,,0,0,,0,0,,0,0,,0,0,0
20876,Bryn Forbes,23-228,G,3/8/17,SAS,,SAC,W,0,0,0,0,,0,0,,0,0,,0,0,,0,0,0
20877,Randy Foye,33-100,G,1/2/17,BRK,,UTA,L,0,11,0,1,0,0,0,,0,1,0,0,0,,0,1,1
20878,Randy Foye,33-074,G,12/7/16,BRK,,DEN,W,0,10,0,0,,0,0,,0,0,,0,0,,0,0,0
20879,Randy Foye,33-167,G,3/10/17,BRK,@,DAL,L,1,23,0,6,0,0,2,0,0,4,0,0,0,,0,1,1
20880,Randy Foye,33-089,G,12/22/16,BRK,,GSW,L,0,3,0,0,,0,0,,0,0,,0,0,,0,1,1
20881,Randy Foye,33-108,G,1/10/17,BRK,,ATL,L,0,8,0,1,0,0,0,,0,1,0,0,0,,0,1,1
20882,Randy Foye,33-161,G,3/4/17,BRK,@,POR,L,1,16,0,1,0,0,0,,0,1,0,0,0,,0,1,1
20883,Tim Frazier,26-033,G,12/4/16,NOP,@,OKC,L,0,16,0,5,0,0,5,0,0,0,,0,0,,1,3,4
20884,Tim Frazier,26-078,G,1/18/17,NOP,,ORL,W,0,3,0,1,0,0,0,,0,1,0,0,0,,0,0,0
20885,Tim Frazier,26-076,G,1/16/17,NOP,@,IND,L,0,5,0,0,,0,0,,0,0,,0,0,,0,1,1
20886,Tim Frazier,26-130,G,3/11/17,NOP,@,CHO,W,0,10,0,2,0,0,1,0,0,1,0,0,0,,0,3,3
20887,Tim Frazier,26-069,G,1/9/17,NOP,@,NYK,W,0,5,0,1,0,0,0,,0,1,0,0,0,,0,0,0
20888,Tim Frazier,26-103,G,2/12/17,NOP,@,SAC,L,0,11,0,2,0,0,2,0,0,0,,0,0,,1,0,1
20889,Channing Frye,33-185,C-F,11/18/16,CLE,,DET,W,0,9,0,1,0,0,0,,0,1,0,0,0,,0,2,2
20890,Channing Frye,33-211,C-F,12/14/16,CLE,@,MEM,L,1,23,0,4,0,0,2,0,0,2,0,0,0,,0,3,3
20891,Channing Frye,33-244,C-F,1/16/17,CLE,@,GSW,L,0,16,0,3,0,0,1,0,0,2,0,0,0,,0,2,2
20892,Langston Galloway,25-092,G,3/11/17,SAC,,DEN,L,0,2,0,1,0,0,1,0,0,0,,0,0,,0,1,1
20893,Langston Galloway,25-087,G,3/6/17,SAC,@,DEN,L,0,5,0,1,0,0,1,0,0,0,,0,0,,0,1,1
20894,Langston Galloway,24-324,G,10/28/16,NOP,,GSW,L,0,14,0,7,0,0,3,0,0,4,0,0,0,,0,0,0
20895,Langston Galloway,25-080,G,2/27/17,SAC,,MIN,L,0,2,0,1,0,0,0,,0,1,0,0,0,,0,0,0
20896,Langston Galloway,25-078,G,2/25/17,SAC,,CHO,L,0,12,0,2,0,0,1,0,0,1,0,0,0,,0,1,1
20897,Langston Galloway,25-049,G,1/27/17,NOP,,SAS,W,0,6,0,2,0,0,0,,0,2,0,0,0,,0,0,0
20898,Langston Galloway,24-328,G,11/1/16,NOP,,MIL,L,0,8,0,0,,0,0,,0,0,,0,0,,0,1,1
20899,Pau Gasol,36-142,F-C,11/25/16,SAS,@,BOS,W,1,17,0,5,0,0,4,0,0,1,0,0,0,,0,5,5
20900,Michael Gbinije,24-173,G,11/25/16,DET,,LAC,W,0,6,0,0,,0,0,,0,0,,0,0,,0,1,1
20901,Michael Gbinije,24-153,G,11/5/16,DET,,DEN,W,0,2,0,1,0,0,1,0,0,0,,0,0,,0,0,0
20902,Michael Gbinije,24-145,G,10/28/16,DET,,ORL,W,0,5,0,1,0,0,0,,0,1,0,0,0,,0,0,0
20903,Michael Gbinije,24-246,G,2/6/17,DET,,PHI,W,0,3,0,0,,0,0,,0,0,,0,0,,0,0,0
20904,Michael Gbinije,24-204,G,12/26/16,DET,,CLE,W,0,2,0,1,0,0,1,0,0,0,,0,0,,1,0,1
20905,Michael Gbinije,24-195,G,12/17/16,DET,,IND,L,0,5,0,1,0,0,1,0,0,0,,0,0,,0,0,0
20906,Michael Gbinije,24-180,G,12/2/16,DET,@,ATL,W,0,4,0,3,0,0,1,0,0,2,0,0,0,,0,0,0
20907,Alonzo Gee,29-197,G,12/12/16,DEN,@,DAL,L,0,4,0,0,,0,0,,0,0,,0,0,,1,0,1
20908,Alonzo Gee,29-193,G,12/8/16,DEN,@,WAS,L,0,0,0,0,,0,0,,0,0,,0,0,,0,0,0
20909,Alonzo Gee,29-173,G,11/18/16,DEN,,TOR,L,0,1,0,0,,0,0,,0,0,,0,2,0,1,0,1
20910,Alonzo Gee,29-190,G,12/5/16,DEN,@,PHI,W,0,1,0,0,,0,0,,0,0,,0,0,,0,0,0
20911,Alonzo Gee,29-171,G,11/16/16,DEN,,PHO,W,0,4,0,0,,0,0,,0,0,,0,0,,0,0,0
20912,Alonzo Gee,29-188,G,12/3/16,DEN,@,UTA,L,0,4,0,1,0,0,1,0,0,0,,0,0,,0,0,0
20913,Alonzo Gee,29-187,G,12/2/16,DEN,,HOU,L,0,9,0,1,0,0,1,0,0,0,,0,0,,1,1,2
20914,Alonzo Gee,29-185,G,11/30/16,DEN,,MIA,L,0,2,0,0,,0,0,,0,0,,0,0,,0,0,0
20915,Alonzo Gee,29-182,G,11/27/16,DEN,@,PHO,W,0,12,0,1,0,0,1,0,0,0,,0,0,,0,3,3
20916,Alonzo Gee,29-221,G,1/5/17,DEN,,SAS,L,0,4,0,1,0,0,1,0,0,0,,0,0,,0,1,1
20917,Jonathan Gibson,29-040,G,12/18/16,DAL,,SAC,W,0,2,0,0,,0,0,,0,0,,0,0,,0,0,0
20918,Jonathan Gibson,29-019,G,11/27/16,DAL,,NOP,W,0,3,0,1,0,0,0,,0,1,0,0,0,,0,0,0
20919,Jonathan Gibson,29-034,G,12/12/16,DAL,,DEN,W,0,3,0,0,,0,0,,0,0,,0,0,,0,0,0
20920,Jonathan Gibson,29-032,G,12/10/16,DAL,@,HOU,L,0,14,0,5,0,0,2,0,0,3,0,0,0,,0,0,0
20921,Jonathan Gibson,29-048,G,12/26/16,DAL,@,NOP,L,0,0,0,0,,0,0,,0,0,,0,0,,0,0,0
20922,Manu Ginobili,39-133,G,12/8/16,SAS,@,CHI,L,0,18,0,9,0,0,5,0,0,4,0,0,0,,0,2,2
20923,Archie Goodwin,22-091,G,11/16/16,NOP,@,ORL,L,0,4,0,0,,0,0,,0,0,,0,0,,0,0,0
20924,Aaron Gordon,21-072,F,11/27/16,ORL,,MIL,L,1,32,0,12,0,0,9,0,0,3,0,0,0,,4,4,8
20925,Eric Gordon,27-332,G,11/21/16,HOU,@,DET,W,0,29,0,5,0,0,2,0,0,3,0,0,0,,0,1,1
20926,Treveon Graham,23-137,G,3/15/17,CHO,@,IND,L,0,9,0,2,0,0,2,0,0,0,,0,0,,1,0,1
20927,Treveon Graham,23-094,G,1/31/17,CHO,@,POR,L,0,6,0,1,0,0,1,0,0,0,,0,0,,1,0,1
20928,Treveon Graham,23-083,G,1/20/17,CHO,,TOR,W,0,5,0,2,0,0,2,0,0,0,,0,0,,1,2,3
20929,Treveon Graham,23-031,G,11/29/16,CHO,,DET,L,0,4,0,0,,0,0,,0,0,,0,0,,0,1,1
20930,Treveon Graham,23-081,G,1/18/17,CHO,,POR,W,0,3,0,1,0,0,1,0,0,0,,0,0,,0,0,0
20931,Treveon Graham,23-124,G,3/2/17,CHO,@,PHO,L,0,2,0,0,,0,0,,0,0,,0,0,,0,0,0
20932,Treveon Graham,23-120,G,2/26/17,CHO,@,LAC,L,0,7,0,0,,0,0,,0,0,,0,0,,0,1,1
20933,Treveon Graham,23-073,G,1/10/17,CHO,@,HOU,L,0,4,0,0,,0,0,,0,0,,0,0,,0,1,1
20934,Treveon Graham,23-109,G,2/15/17,CHO,@,TOR,L,0,5,0,2,0,0,1,0,0,1,0,0,0,,0,1,1
20935,Treveon Graham,23-070,G,1/7/17,CHO,@,SAS,L,0,9,0,0,,0,0,,0,0,,0,0,,0,0,0
20936,Treveon Graham,23-004,G,11/2/16,CHO,,PHI,W,0,1,0,0,,0,0,,0,0,,0,0,,0,0,0
20937,Treveon Graham,23-067,G,1/4/17,CHO,,OKC,W,0,1,0,0,,0,0,,0,0,,0,0,,0,0,0
20938,Treveon Graham,23-098,G,2/4/17,CHO,@,UTA,L,0,3,0,0,,0,0,,0,0,,0,0,,0,0,0
20939,Jerami Grant,22-362,F,3/9/17,OKC,,SAS,W,0,2,0,0,,0,0,,0,0,,0,0,,0,1,1
20940,Jerami Grant,22-356,F,3/3/17,OKC,@,PHO,L,0,12,0,6,0,0,2,0,0,4,0,0,0,,2,0,2
20941,Jerami Grant,23-006,F,3/18/17,OKC,,SAC,W,0,1,0,0,,0,0,,0,0,,0,0,,0,0,0
20942,Jerami Grant,23-002,F,3/14/17,OKC,@,BRK,W,0,2,0,0,,0,0,,0,0,,0,0,,0,0,0
20943,Jerami Grant,22-364,F,3/11/17,OKC,,UTA,W,0,12,0,3,0,0,2,0,0,1,0,0,0,,2,1,3
20944,Jerian Grant,24-026,G,11/4/16,CHI,,NYK,L,0,6,0,4,0,0,3,0,0,1,0,0,0,,0,0,0
20945,Jerian Grant,24-047,G,11/25/16,CHI,@,PHI,W,0,7,0,2,0,0,2,0,0,0,,0,0,,0,1,1
20946,Jerian Grant,24-100,G,1/17/17,CHI,,DAL,L,0,4,0,1,0,0,0,,0,1,0,0,0,,0,0,0
20947,Jerian Grant,24-062,G,12/10/16,CHI,,MIA,W,0,6,0,2,0,0,2,0,0,0,,0,0,,0,1,1
20948,Jerian Grant,24-080,G,12/28/16,CHI,,BRK,W,0,3,0,1,0,0,0,,0,1,0,0,0,,0,0,0
20949,Jerian Grant,24-154,G,3/12/17,CHI,@,BOS,L,1,9,0,2,0,0,1,0,0,1,0,0,0,,1,1,2
20950,Jerian Grant,24-058,G,12/6/16,CHI,@,DET,L,0,4,0,0,,0,0,,0,0,,0,0,,0,0,0
20951,Jerian Grant,24-152,G,3/10/17,CHI,,HOU,L,1,12,0,5,0,0,0,,0,5,0,0,0,,2,0,2
20952,Jerian Grant,24-034,G,11/12/16,CHI,,WAS,W,0,6,0,1,0,0,1,0,0,0,,0,0,,0,0,0
20953,Gerald Green,31-020,G-F,2/15/17,BOS,,PHI,W,0,6,0,3,0,0,2,0,0,1,0,0,0,,0,0,0
20954,Gerald Green,30-290,G-F,11/11/16,BOS,,NYK,W,0,3,0,1,0,0,1,0,0,0,,0,0,,1,0,1
20955,Gerald Green,30-358,G-F,1/18/17,BOS,,NYK,L,0,5,0,3,0,0,2,0,0,1,0,0,0,,0,0,0
20956,Gerald Green,30-288,G-F,11/9/16,BOS,@,WAS,L,0,11,0,3,0,0,1,0,0,2,0,0,0,,0,1,1
20957,Gerald Green,30-356,G-F,1/16/17,BOS,,CHO,W,0,4,0,0,,0,0,,0,0,,0,0,,0,0,0
20958,JaMychal Green,26-227,F,2/3/17,MEM,@,OKC,L,1,24,0,1,0,0,0,,0,1,0,0,0,,1,3,4
20959,Jeff Green,30-080,F,11/16/16,ORL,,NOP,W,1,20,0,9,0,0,5,0,0,4,0,0,0,,0,2,2
20960,Justin Hamilton,26-347,C,3/14/17,BRK,,OKC,L,0,2,0,0,,0,0,,0,0,,0,0,,0,0,0
20961,Justin Hamilton,26-213,C,10/31/16,BRK,,CHI,L,0,17,0,4,0,0,2,0,0,2,0,0,0,,2,5,7
20962,Justin Hamilton,26-334,C,3/1/17,BRK,@,SAC,W,0,12,0,2,0,0,0,,0,2,0,0,0,,0,0,0
20963,Justin Hamilton,26-246,C,12/3/16,BRK,@,MIL,L,0,18,0,6,0,0,3,0,0,3,0,0,0,,1,2,3
20964,Justin Hamilton,26-299,C,1/25/17,BRK,,MIA,L,0,9,0,2,0,0,0,,0,2,0,0,0,,1,0,1
20965,Justin Hamilton,26-238,C,11/25/16,BRK,@,IND,L,0,17,0,2,0,0,1,0,0,1,0,0,0,,1,1,2
20966,A.J. Hammons,24-121,C,12/26/16,DAL,@,NOP,L,0,0,0,0,,0,0,,0,0,,0,0,,0,0,0
20967,A.J. Hammons,24-090,C,11/25/16,DAL,@,CLE,L,0,6,0,1,0,0,1,0,0,0,,0,2,0,0,1,1
20968,A.J. Hammons,24-088,C,11/23/16,DAL,,LAC,L,0,3,0,1,0,0,1,0,0,0,,0,0,,2,0,2
20969,A.J. Hammons,24-113,C,12/18/16,DAL,,SAC,W,0,16,0,4,0,0,3,0,0,1,0,0,2,0,0,3,3
20970,A.J. Hammons,24-083,C,11/18/16,DAL,,MEM,L,0,3,0,0,,0,0,,0,0,,0,0,,0,1,1
20971,A.J. Hammons,24-079,C,11/14/16,DAL,@,NYK,L,0,3,0,0,,0,0,,0,0,,0,0,,0,1,1
20972,A.J. Hammons,24-109,C,12/14/16,DAL,,DET,L,0,1,0,0,,0,0,,0,0,,0,2,0,0,0,0
20973,A.J. Hammons,24-069,C,11/4/16,DAL,,POR,L,0,1,0,0,,0,0,,0,0,,0,0,,0,0,0
20974,A.J. Hammons,24-105,C,12/10/16,DAL,@,HOU,L,0,4,0,0,,0,0,,0,0,,0,0,,0,1,1
20975,A.J. Hammons,24-062,C,10/28/16,DAL,,HOU,L,0,1,0,0,,0,0,,0,0,,0,0,,0,0,0
20976,A.J. Hammons,24-102,C,12/7/16,DAL,,SAC,L,0,11,0,2,0,0,2,0,0,0,,0,2,0,0,5,5
20977,Tim Hardaway,24-252,G,11/23/16,ATL,@,IND,W,0,22,0,6,0,0,4,0,0,2,0,0,0,,0,1,1
20978,Tim Hardaway,24-287,G,12/28/16,ATL,,NYK,W,0,13,0,7,0,0,5,0,0,2,0,0,0,,1,2,3
20979,Maurice Harkless,23-255,F-G,1/21/17,POR,@,BOS,W,0,13,0,2,0,0,1,0,0,1,0,0,0,,0,0,0
20980,Maurice Harkless,23-250,F-G,1/16/17,POR,@,WAS,L,1,19,0,5,0,0,2,0,0,3,0,0,0,,0,1,1
20981,Maurice Harkless,23-167,F-G,10/25/16,POR,,UTA,W,1,22,0,2,0,0,1,0,0,1,0,0,0,,0,1,1
20982,Justin Harper,27-185,F,3/3/17,PHI,,NYK,W,0,5,0,1,0,0,0,,0,1,0,0,0,,0,1,1
20983,Montrezl Harrell,22-363,F-C,1/23/17,HOU,@,MIL,L,0,4,0,1,0,0,1,0,0,0,,0,0,,0,0,0
20984,Montrezl Harrell,23-020,F-C,2/15/17,HOU,,MIA,L,0,3,0,1,0,0,1,0,0,0,,0,0,,0,1,1
20985,Montrezl Harrell,23-032,F-C,2/27/17,HOU,,IND,L,0,4,0,0,,0,0,,0,0,,0,0,,0,0,0
20986,Montrezl Harrell,22-321,F-C,12/12/16,HOU,,BRK,W,0,4,0,0,,0,0,,0,0,,0,0,,0,1,1
20987,Devin Harris,33-296,G,12/19/16,DAL,@,DEN,L,0,5,0,1,0,0,1,0,0,0,,0,0,,0,1,1
20988,Devin Harris,33-327,G,1/19/17,DAL,@,MIA,L,0,17,0,3,0,0,3,0,0,0,,0,0,,0,0,0
20989,Devin Harris,33-345,G,2/6/17,DAL,@,DEN,L,0,17,0,4,0,0,3,0,0,1,0,0,0,,0,1,1
20990,Devin Harris,33-277,G,11/30/16,DAL,,SAS,L,0,11,0,3,0,0,1,0,0,2,0,0,0,,0,1,1
20991,Devin Harris,33-289,G,12/12/16,DAL,,DEN,W,0,16,0,0,,0,0,,0,0,,0,0,,0,1,1
20992,Devin Harris,33-287,G,12/10/16,DAL,@,HOU,L,0,4,0,1,0,0,0,,0,1,0,0,0,,0,0,0
20993,Gary Harris,22-171,G,3/4/17,DEN,,CHO,L,1,22,0,1,0,0,0,,0,1,0,0,0,,0,0,0
20994,Gary Harris,22-124,G,1/16/17,DEN,,ORL,W,1,3,0,1,0,0,1,0,0,0,,0,0,,0,0,0
20995,Joe Harris,25-123,G,1/8/17,BRK,,PHI,L,1,16,0,4,0,0,1,0,0,3,0,0,0,,0,5,5
20996,Joe Harris,25-132,G,1/17/17,BRK,,TOR,L,1,18,0,3,0,0,2,0,0,1,0,0,0,,0,0,0
20997,Joe Harris,25-110,G,12/26/16,BRK,,CHO,W,1,12,0,2,0,0,0,,0,2,0,0,0,,0,2,2
20998,Joe Harris,25-058,G,11/4/16,BRK,,CHO,L,0,23,0,4,0,0,2,0,0,2,0,0,0,,0,3,3
20999,Joe Harris,25-107,G,12/23/16,BRK,@,CLE,L,0,16,0,4,0,0,1,0,0,3,0,0,0,,0,3,3
21000,Manny Harris,27-170,G,3/10/17,DAL,,BRK,W,0,2,0,2,0,0,1,0,0,1,0,0,0,,0,0,0
21001,Aaron Harrison,22-032,G,11/29/16,CHO,,DET,L,0,4,0,1,0,0,0,,0,1,0,0,0,,0,1,1
21002,Aaron Harrison,22-024,G,11/21/16,CHO,,MEM,L,0,3,0,1,0,0,0,,0,1,0,0,0,,0,0,0
21003,Aaron Harrison,22-010,G,11/7/16,CHO,,IND,W,0,3,0,1,0,0,1,0,0,0,,0,0,,0,1,1
21004,Aaron Harrison,22-064,G,12/31/16,CHO,,CLE,L,0,2,0,0,,0,0,,0,0,,0,0,,0,1,1
21005,Andrew Harrison,22-105,G,2/10/17,MEM,,GSW,L,0,2,0,1,0,0,0,,0,1,0,0,0,,0,0,0
21006,Andrew Harrison,22-007,G,11/4/16,MEM,,LAC,L,0,3,0,1,0,0,0,,0,1,0,0,0,,0,0,0
21007,Andrew Harrison,22-138,G,3/15/17,MEM,@,CHI,W,0,11,0,2,0,0,1,0,0,1,0,0,0,,1,0,1
21008,Andrew Harrison,22-101,G,2/6/17,MEM,,SAS,W,0,2,0,0,,0,0,,0,0,,0,0,,0,1,1
21009,Andrew Harrison,22-082,G,1/18/17,MEM,@,WAS,L,0,9,0,1,0,0,0,,0,1,0,0,0,,0,1,1
21010,Andrew Harrison,22-127,G,3/4/17,MEM,@,HOU,L,0,1,0,0,,0,0,,0,0,,0,0,,0,0,0
21011,Udonis Haslem,36-165,F-C,11/21/16,MIA,@,PHI,L,0,4,0,0,,0,0,,0,0,,0,0,,0,2,2
21012,Udonis Haslem,36-159,F-C,11/15/16,MIA,,ATL,L,0,1,0,0,,0,0,,0,0,,0,0,,0,0,0
21013,Udonis Haslem,36-145,F-C,11/1/16,MIA,,SAC,W,0,16,0,3,0,0,3,0,0,0,,0,0,,1,3,4
21014,Udonis Haslem,36-201,F-C,12/27/16,MIA,,OKC,L,0,5,0,0,,0,0,,0,0,,0,0,,0,0,0
21015,Udonis Haslem,36-194,F-C,12/20/16,MIA,,ORL,L,0,0,0,0,,0,0,,0,0,,0,0,,0,0,0
21016,Udonis Haslem,36-232,F-C,1/27/17,MIA,@,CHI,W,0,11,0,0,,0,0,,0,0,,0,0,,0,3,3
21017,Udonis Haslem,36-170,F-C,11/26/16,MIA,,MEM,L,0,1,0,0,,0,0,,0,0,,0,0,,0,1,1
21018,Udonis Haslem,36-218,F-C,1/13/17,MIA,@,MIL,L,0,3,0,0,,0,0,,0,0,,0,2,0,0,0,0
21019,Spencer Hawes,28-309,C-F,3/3/17,MIL,,LAC,W,0,3,0,1,0,0,1,0,0,0,,0,0,,0,0,0
21020,Spencer Hawes,28-324,C-F,3/18/17,MIL,@,GSW,L,0,6,0,3,0,0,2,0,0,1,0,0,0,,0,1,1
21021,Spencer Hawes,28-319,C-F,3/13/17,MIL,@,MEM,L,0,2,0,0,,0,0,,0,0,,0,0,,0,0,0
21022,Spencer Hawes,28-201,C-F,11/15/16,CHO,@,MIN,W,0,4,0,0,,0,0,,0,0,,0,0,,0,1,1
21023,Spencer Hawes,28-317,C-F,3/11/17,MIL,,MIN,W,0,4,0,0,,0,0,,0,0,,0,0,,0,2,2
21024,Spencer Hawes,28-316,C-F,3/10/17,MIL,,IND,W,0,4,0,1,0,0,1,0,0,0,,0,0,,0,1,1
21025,Spencer Hawes,28-211,C-F,11/25/16,CHO,@,NYK,L,0,0,0,0,,0,0,,0,0,,0,0,,0,0,0
21026,Gerald Henderson,29-051,G,1/29/17,PHI,@,CHI,L,0,9,0,3,0,0,3,0,0,0,,0,0,,1,1,2
21027,Gerald Henderson,28-325,G,10/29/16,PHI,,ATL,L,1,18,0,5,0,0,4,0,0,1,0,0,0,,0,1,1
21028,Gerald Henderson,28-355,G,11/28/16,PHI,@,TOR,L,1,17,0,7,0,0,5,0,0,2,0,0,0,,0,1,1
21029,Gerald Henderson,29-098,G,3/17/17,PHI,,DAL,W,0,7,0,3,0,0,2,0,0,1,0,0,0,,0,1,1
21030,John Henson,25-309,C-F,11/1/16,MIL,@,NOP,W,0,16,0,0,,0,0,,0,0,,0,0,,1,4,5
21031,John Henson,25-307,C-F,10/30/16,MIL,@,DET,L,0,12,0,3,0,0,3,0,0,0,,0,0,,1,2,3
21032,John Henson,26-080,C-F,3/18/17,MIL,@,GSW,L,0,10,0,2,0,0,2,0,0,0,,0,0,,1,1,2
21033,John Henson,25-314,C-F,11/6/16,MIL,@,DAL,L,0,6,0,0,,0,0,,0,0,,0,0,,0,1,1
21034,Juan Hernangomez,21-041,F,11/8/16,DEN,@,MEM,L,0,10,0,0,,0,0,,0,0,,0,0,,0,1,1
21035,Juan Hernangomez,21-111,F,1/17/17,DEN,@,LAL,W,0,7,0,1,0,0,0,,0,1,0,0,0,,1,0,1
21036,Juan Hernangomez,21-039,F,11/6/16,DEN,@,BOS,W,0,2,0,0,,0,0,,0,0,,0,0,,0,1,1
21037,Juan Hernangomez,21-068,F,12/5/16,DEN,@,PHI,W,0,5,0,0,,0,0,,0,0,,0,0,,0,1,1
21038,Juan Hernangomez,21-128,F,2/3/17,DEN,,MIL,W,0,3,0,0,,0,0,,0,0,,0,0,,0,1,1
21039,Juan Hernangomez,21-148,F,2/23/17,DEN,@,SAC,L,0,2,0,0,,0,0,,0,0,,0,0,,0,0,0
21040,Juan Hernangomez,21-028,F,10/26/16,DEN,@,NOP,W,0,1,0,0,,0,0,,0,0,,0,0,,0,0,0
21041,Juan Hernangomez,21-066,F,12/3/16,DEN,@,UTA,L,0,6,0,1,0,0,0,,0,1,0,0,0,,0,0,0
21042,Juan Hernangomez,21-097,F,1/3/17,DEN,,SAC,L,0,1,0,0,,0,0,,0,0,,0,0,,0,1,1
21043,Juan Hernangomez,21-065,F,12/2/16,DEN,,HOU,L,0,8,0,2,0,0,1,0,0,1,0,0,0,,0,4,4
21044,Juan Hernangomez,21-086,F,12/23/16,DEN,,ATL,L,0,0,0,0,,0,0,,0,0,,0,0,,0,0,0
21045,Juan Hernangomez,21-063,F,11/30/16,DEN,,MIA,L,0,8,0,1,0,0,1,0,0,0,,0,0,,0,0,0
21046,Willy Hernangomez,22-207,C,12/20/16,NYK,,IND,W,0,2,0,0,,0,0,,0,0,,0,0,,0,0,0
21047,Willy Hernangomez,22-222,C,1/4/17,NYK,,MIL,L,0,3,0,1,0,0,1,0,0,0,,0,0,,0,1,1
21048,Willy Hernangomez,22-169,C,11/12/16,NYK,@,TOR,L,0,4,0,0,,0,0,,0,0,,0,0,,0,1,1
21049,Willy Hernangomez,22-158,C,11/1/16,NYK,@,DET,L,0,5,0,0,,0,0,,0,0,,0,0,,0,1,1
21050,Willy Hernangomez,22-193,C,12/6/16,NYK,@,MIA,W,0,3,0,0,,0,0,,0,0,,0,0,,0,2,2
21051,Willy Hernangomez,22-215,C,12/28/16,NYK,@,ATL,L,0,10,0,1,0,0,1,0,0,0,,0,0,,1,1,2
21052,Willy Hernangomez,22-230,C,1/12/17,NYK,,CHI,W,0,7,0,0,,0,0,,0,0,,0,0,,0,0,0
21053,Willy Hernangomez,22-212,C,12/25/16,NYK,,BOS,L,0,3,0,0,,0,0,,0,0,,0,0,,0,0,0
21054,Willy Hernangomez,22-229,C,1/11/17,NYK,@,PHI,L,0,3,0,0,,0,0,,0,0,,0,0,,0,0,0
21055,Willy Hernangomez,22-247,C,1/29/17,NYK,@,ATL,L,0,3,0,1,0,0,1,0,0,0,,0,0,,0,0,0
21056,Mario Hezonja,21-278,F-G,11/29/16,ORL,@,SAS,W,0,1,0,0,,0,0,,0,0,,0,0,,0,0,0
21057,Mario Hezonja,21-302,F-G,12/23/16,ORL,,LAL,W,0,2,0,0,,0,0,,0,0,,0,0,,0,0,0
21058,Mario Hezonja,21-301,F-G,12/22/16,ORL,@,NYK,L,0,1,0,0,,0,0,,0,0,,0,0,,0,0,0
21059,Mario Hezonja,21-321,F-G,1/11/17,ORL,@,LAC,L,0,12,0,3,0,0,0,,0,3,0,0,0,,0,0,0
21060,Mario Hezonja,21-263,F-G,11/14/16,ORL,@,IND,L,0,5,0,5,0,0,3,0,0,2,0,0,0,,1,0,1
21061,Mario Hezonja,21-292,F-G,12/13/16,ORL,@,ATL,W,0,2,0,0,,0,0,,0,0,,0,0,,0,0,0
21062,Mario Hezonja,21-312,F-G,1/2/17,ORL,@,NYK,W,0,2,0,0,,0,0,,0,0,,0,0,,0,0,0
21063,Mario Hezonja,22-023,F-G,3/20/17,ORL,,PHI,W,0,19,0,4,0,0,1,0,0,3,0,0,0,,0,2,2
21064,Mario Hezonja,21-281,F-G,12/2/16,ORL,@,PHI,W,0,3,0,2,0,0,2,0,0,0,,0,0,,0,0,0
21065,Mario Hezonja,21-305,F-G,12/26/16,ORL,,MEM,W,0,5,0,1,0,0,0,,0,1,0,0,0,,0,1,1
21066,Mario Hezonja,21-252,F-G,11/3/16,ORL,,SAC,W,0,12,0,2,0,0,1,0,0,1,0,0,0,,0,3,3
21067,Roy Hibbert,30-090,C,3/11/17,DEN,@,SAC,W,0,1,0,0,,0,0,,0,0,,0,0,,0,1,1
21068,Roy Hibbert,30-020,C,12/31/16,CHO,,CLE,L,0,14,0,2,0,0,2,0,0,0,,0,0,,1,1,2
21069,Roy Hibbert,30-079,C,2/28/17,DEN,@,CHI,W,0,2,0,0,,0,0,,0,0,,0,0,,0,0,0
21070,Roy Hibbert,29-322,C,10/28/16,CHO,@,MIA,W,1,4,0,1,0,0,1,0,0,0,,0,0,,0,1,1
21071,Buddy Hield,22-342,G,11/23/16,NOP,,MIN,W,0,13,0,7,0,0,3,0,0,4,0,0,0,,0,0,0
21072,Buddy Hield,23-043,G,1/29/17,NOP,,WAS,L,1,16,0,5,0,0,2,0,0,3,0,0,0,,0,2,2
21073,Buddy Hield,22-341,G,11/22/16,NOP,@,ATL,W,0,8,0,1,0,0,0,,0,1,0,0,0,,0,1,1
21074,Buddy Hield,22-348,G,11/29/16,NOP,,LAL,W,0,1,0,1,0,0,0,,0,1,0,0,0,,0,0,0
21075,Jordan Hill,29-135,C-F,12/9/16,MIN,,DET,L,0,5,0,0,,0,0,,0,0,,0,0,,0,0,0
21076,Jordan Hill,29-233,C-F,3/17/17,MIN,@,MIA,L,0,1,0,0,,0,0,,0,0,,0,0,,0,0,0
21077,Jordan Hill,29-152,C-F,12/26/16,MIN,,ATL,W,0,6,0,1,0,0,1,0,0,0,,0,0,,1,0,1
21078,Solomon Hill,25-353,F,3/6/17,NOP,@,UTA,L,1,20,0,4,0,0,1,0,0,3,0,0,0,,1,4,5
21079,Solomon Hill,25-245,F,11/18/16,NOP,,POR,W,0,18,0,2,0,0,0,,0,2,0,0,0,,0,3,3
21080,Solomon Hill,25-229,F,11/2/16,NOP,@,MEM,L,1,11,0,2,0,0,1,0,0,1,0,0,0,,0,2,2
21081,Solomon Hill,25-239,F,11/12/16,NOP,,LAL,L,0,18,0,3,0,0,3,0,0,0,,0,0,,0,0,0
21082,Darrun Hilliard,23-301,G,2/8/17,DET,,LAL,W,0,2,0,1,0,0,0,,0,1,0,0,0,,0,0,0
21083,Darrun Hilliard,23-206,G,11/5/16,DET,,DEN,W,0,2,0,1,0,0,0,,0,1,0,0,0,,0,0,0
21084,Darrun Hilliard,23-231,G,11/30/16,DET,@,BOS,W,0,13,0,3,0,0,2,0,0,1,0,0,0,,0,1,1
21085,Darrun Hilliard,23-198,G,10/28/16,DET,,ORL,W,0,2,0,0,,0,0,,0,0,,0,0,,0,0,0
21086,Darrun Hilliard,23-275,G,1/13/17,DET,@,UTA,L,0,5,0,0,,0,0,,0,0,,0,0,,0,1,1
21087,Darrun Hilliard,23-272,G,1/10/17,DET,@,SAC,L,0,0,0,0,,0,0,,0,0,,0,0,,0,0,0
21088,Darrun Hilliard,23-340,G,3/19/17,DET,,PHO,W,0,2,0,0,,0,0,,0,0,,0,0,,0,0,0
21089,Darrun Hilliard,23-267,G,1/5/17,DET,,CHO,W,0,15,0,6,0,0,3,0,0,3,0,0,0,,0,0,0
21090,Darrun Hilliard,23-325,G,3/4/17,DET,@,PHI,W,0,3,0,0,,0,0,,0,0,,0,0,,0,0,0
21091,Justin Holiday,27-295,G,1/25/17,NYK,@,DAL,L,0,19,0,5,0,0,3,0,0,2,0,0,0,,0,2,2
21092,Justin Holiday,27-218,G,11/9/16,NYK,,BRK,W,0,5,0,2,0,0,2,0,0,0,,0,0,,0,0,0
21093,Justin Holiday,27-332,G,3/3/17,NYK,@,PHI,L,0,18,0,1,0,0,0,,0,1,0,0,0,,0,2,2
21094,Justin Holiday,27-210,G,11/1/16,NYK,@,DET,L,0,12,0,1,0,0,0,,0,1,0,0,0,,0,3,3
21095,Rondae Hollis-Jefferson,22-025,F,1/28/17,BRK,@,MIN,L,0,8,0,1,0,0,1,0,0,0,,0,0,,0,3,3
21096,Rondae Hollis-Jefferson,21-339,F,12/7/16,BRK,,DEN,W,0,14,0,6,0,0,4,0,0,2,0,0,0,,0,3,3
21097,Rondae Hollis-Jefferson,21-304,F,11/2/16,BRK,,DET,W,1,22,0,4,0,0,3,0,0,1,0,0,0,,0,2,2
21098,Richaun Holmes,23-098,F-C,1/21/17,PHI,@,ATL,L,0,5,0,1,0,0,1,0,0,0,,0,0,,1,0,1
21099,Rodney Hood,24-061,G-F,12/20/16,UTA,@,GSW,L,1,11,0,5,0,0,2,0,0,3,0,0,2,0,0,2,2
21100,Rodney Hood,24-146,G-F,3/15/17,UTA,@,DET,W,1,9,0,3,0,0,2,0,0,1,0,0,0,,0,4,4
21101,Danuel House,23-157,G,11/11/16,WAS,,CLE,L,0,1,0,0,,0,0,,0,0,,0,0,,0,1,1
21102,Marcelo Huertas,33-184,G,11/25/16,LAL,,GSW,L,0,12,0,3,0,0,3,0,0,0,,0,0,,0,0,0
21103,Marcelo Huertas,33-201,G,12/12/16,LAL,@,SAC,L,0,2,0,0,,0,0,,0,0,,0,0,,0,0,0
21104,Marcelo Huertas,33-171,G,11/12/16,LAL,@,NOP,W,0,3,0,1,0,0,0,,0,1,0,0,0,,0,0,0
21105,Marcelo Huertas,33-240,G,1/20/17,LAL,,IND,W,0,1,0,0,,0,0,,0,0,,0,0,,0,0,0
21106,Marcelo Huertas,33-154,G,10/26/16,LAL,,HOU,W,0,5,0,1,0,0,0,,0,1,0,0,0,,0,0,0
21107,Marcelo Huertas,33-188,G,11/29/16,LAL,@,NOP,L,0,11,0,1,0,0,0,,0,1,0,0,4,0,0,1,1
21108,Marcelo Huertas,33-186,G,11/27/16,LAL,,ATL,W,0,1,0,0,,0,0,,0,0,,0,0,,0,0,0
21109,Kris Humphries,31-272,F-C,11/4/16,ATL,@,WAS,L,0,6,0,2,0,0,2,0,0,0,,0,0,,1,1,2
21110,Kris Humphries,31-288,F-C,11/20/16,ATL,@,NYK,L,0,5,0,1,0,0,1,0,0,0,,0,0,,1,1,2
21111,Kris Humphries,31-314,F-C,12/16/16,ATL,@,TOR,W,0,1,0,0,,0,0,,0,0,,0,0,,0,0,0
21112,Kris Humphries,31-336,F-C,1/7/17,ATL,@,DAL,W,0,5,0,1,0,0,1,0,0,0,,0,0,,0,2,2
21113,Kris Humphries,31-352,F-C,1/23/17,ATL,,LAC,L,0,6,0,1,0,0,0,,0,1,0,0,0,,1,2,3
21114,Kris Humphries,31-305,F-C,12/7/16,ATL,,MIA,W,0,4,0,2,0,0,2,0,0,0,,0,0,,2,0,2
21115,Kris Humphries,31-264,F-C,10/27/16,ATL,,WAS,W,0,9,0,1,0,0,1,0,0,0,,0,0,,0,3,3
21116,Kris Humphries,31-283,F-C,11/15/16,ATL,@,MIA,W,0,4,0,1,0,0,0,,0,1,0,0,0,,1,0,1
21117,Kris Humphries,31-330,F-C,1/1/17,ATL,,SAS,W,0,6,0,1,0,0,1,0,0,0,,0,0,,0,2,2
21118,Kris Humphries,31-358,F-C,1/29/17,ATL,,NYK,W,0,10,0,2,0,0,2,0,0,0,,0,0,,1,0,1
21119,Kris Humphries,31-276,F-C,11/8/16,ATL,@,CLE,W,0,4,0,1,0,0,0,,0,1,0,0,0,,0,2,2
21120,Kris Humphries,31-356,F-C,1/27/17,ATL,,WAS,L,0,17,0,2,0,0,1,0,0,1,0,0,0,,0,2,2
21121,R.J. Hunter,23-040,G,12/3/16,CHI,@,DAL,L,0,2,0,0,,0,0,,0,0,,0,0,,0,0,0
21122,R.J. Hunter,23-032,G,11/25/16,CHI,@,PHI,W,0,4,0,0,,0,0,,0,0,,0,0,,0,1,1
21123,R.J. Hunter,23-022,G,11/15/16,CHI,@,POR,W,0,4,0,1,0,0,0,,0,1,0,0,0,,0,0,0
21124,Serge Ibaka,27-176,F-C,3/13/17,TOR,,DAL,W,1,32,0,4,0,0,1,0,0,3,0,0,0,,2,7,9
21125,Andre Iguodala,32-303,G-F,11/26/16,GSW,,MIN,W,0,23,0,2,0,0,1,0,0,1,0,0,0,,0,1,1
21126,Andre Iguodala,32-332,G-F,12/25/16,GSW,@,CLE,L,0,25,0,4,0,0,2,0,0,2,0,0,0,,1,3,4
21127,Ersan Ilyasova,29-168,F,10/30/16,OKC,,LAL,W,0,26,0,6,0,0,1,0,0,5,0,0,0,,1,5,6
21128,Joe Ingles,29-077,F-G,12/18/16,UTA,@,MEM,W,0,13,0,1,0,0,0,,0,1,0,0,0,,0,0,0
21129,Joe Ingles,29-026,F-G,10/28/16,UTA,,LAL,W,0,8,0,1,0,0,1,0,0,0,,0,0,,0,1,1
21130,Joe Ingles,29-040,F-G,11/11/16,UTA,@,ORL,W,0,15,0,0,,0,0,,0,0,,0,0,,0,1,1
21131,Joe Ingles,29-103,F-G,1/13/17,UTA,,DET,W,0,19,0,2,0,0,1,0,0,1,0,0,0,,0,3,3
21132,Joe Ingles,29-035,F-G,11/6/16,UTA,@,NYK,W,0,4,0,1,0,0,0,,0,1,0,0,0,,0,0,0
21133,Joe Ingles,29-046,F-G,11/17/16,UTA,,CHI,L,0,7,0,1,0,0,0,,0,1,0,0,0,,0,1,1
21134,Brandon Ingram,19-146,F,1/26/17,LAL,@,UTA,L,0,20,0,6,0,0,4,0,0,2,0,0,0,,0,2,2
21135,Brandon Ingram,19-145,F,1/25/17,LAL,@,POR,L,0,19,0,5,0,0,2,0,0,3,0,0,0,,1,3,4
21136,Brandon Ingram,19-182,F,3/3/17,LAL,,BOS,L,1,26,0,2,0,0,1,0,0,1,0,0,0,,1,3,4
21137,Jarrett Jack,33-124,G,3/1/17,NOP,,DET,W,0,8,0,0,,0,0,,0,0,,0,0,,0,0,0
21138,Demetrius Jackson,22-170,G,2/24/17,BOS,@,TOR,L,0,0,0,0,,0,0,,0,0,,0,0,,0,0,0
21139,Demetrius Jackson,22-091,G,12/7/16,BOS,@,ORL,W,0,2,0,0,,0,0,,0,0,,0,0,,0,1,1
21140,Demetrius Jackson,22-072,G,11/18/16,BOS,,GSW,L,0,0,0,0,,0,0,,0,0,,0,0,,0,0,0
21141,Pierre Jackson,25-139,G,1/15/17,DAL,,MIN,W,0,1,0,0,,0,0,,0,0,,0,0,,0,0,0
21142,Pierre Jackson,25-129,G,1/5/17,DAL,,PHO,L,0,2,0,2,0,0,2,0,0,0,,0,0,,0,0,0
21143,Al Jefferson,32-074,C-F,3/19/17,IND,@,TOR,L,0,3,0,1,0,0,1,0,0,0,,0,0,,0,0,0
21144,Al Jefferson,32-061,C-F,3/6/17,IND,@,CHO,L,0,7,0,1,0,0,1,0,0,0,,0,0,,0,1,1
21145,Al Jefferson,31-315,C-F,11/14/16,IND,,ORL,W,0,5,0,0,,0,0,,0,0,,0,0,,0,1,1
21146,Richard Jefferson,36-214,F,1/21/17,CLE,,SAS,L,0,16,0,2,0,0,2,0,0,0,,0,0,,1,4,5
21147,Richard Jefferson,36-268,F,3/16/17,CLE,,UTA,W,0,28,0,4,0,0,1,0,0,3,0,0,0,,0,4,4
21148,Richard Jefferson,36-143,F,11/11/16,CLE,@,WAS,W,0,11,0,0,,0,0,,0,0,,0,0,,0,1,1
21149,Richard Jefferson,36-203,F,1/10/17,CLE,@,UTA,L,0,10,0,2,0,0,1,0,0,1,0,0,0,,1,0,1
21150,Richard Jefferson,36-150,F,11/18/16,CLE,,DET,W,0,18,0,3,0,0,2,0,0,1,0,0,0,,0,2,2
21151,Richard Jefferson,36-233,F,2/9/17,CLE,@,OKC,L,0,5,0,1,0,0,1,0,0,0,,0,2,0,0,2,2
21152,John Jenkins,25-251,G,11/12/16,PHO,,BRK,L,0,2,0,1,0,0,0,,0,1,0,0,0,,0,0,0
21153,Brandon Jennings,27-066,G,11/28/16,NYK,,OKC,L,0,13,0,2,0,0,1,0,0,1,0,0,0,,0,1,1
21154,Brandon Jennings,27-168,G,3/10/17,WAS,@,SAC,W,0,13,0,5,0,0,3,0,0,2,0,0,0,,1,1,2
21155,Brandon Jennings,27-093,G,12/25/16,NYK,,BOS,L,0,16,0,2,0,0,1,0,0,1,0,0,0,,0,2,2
21156,Brandon Jennings,27-105,G,1/6/17,NYK,@,MIL,W,0,5,0,1,0,0,0,,0,1,0,0,0,,0,1,1
21157,Brandon Jennings,27-054,G,11/16/16,NYK,,DET,W,0,17,0,4,0,0,2,0,0,2,0,0,0,,0,2,2
21158,Brandon Jennings,27-161,G,3/3/17,WAS,,TOR,L,0,10,0,3,0,0,1,0,0,2,0,0,0,,0,0,0
21159,Jonas Jerebko,29-346,F,2/11/17,BOS,@,UTA,W,0,21,0,1,0,0,1,0,0,0,,0,0,,1,2,3
21160,Jonas Jerebko,29-344,F,2/9/17,BOS,@,POR,W,0,7,0,2,0,0,0,,0,2,0,0,0,,0,3,3
21161,Jonas Jerebko,29-293,F,12/20/16,BOS,@,MEM,W,0,12,0,0,,0,0,,0,0,,0,0,,1,0,1
21162,Jonas Jerebko,30-015,F,3/17/17,BOS,@,BRK,W,0,7,0,1,0,0,0,,0,1,0,0,0,,0,3,3
21163,Jonas Jerebko,29-307,F,1/3/17,BOS,,UTA,W,0,13,0,1,0,0,1,0,0,0,,0,0,,0,1,1
21164,Jonas Jerebko,29-340,F,2/5/17,BOS,,LAC,W,0,10,0,3,0,0,1,0,0,2,0,0,0,,0,2,2
21165,Jonas Jerebko,29-255,F,11/12/16,BOS,@,IND,W,0,21,0,4,0,0,2,0,0,2,0,0,0,,0,5,5
21166,Jonas Jerebko,30-008,F,3/10/17,BOS,@,DEN,L,0,13,0,2,0,0,1,0,0,1,0,0,0,,0,1,1
21167,Jonas Jerebko,29-284,F,12/11/16,BOS,@,OKC,L,0,12,0,1,0,0,0,,0,1,0,0,0,,0,1,1
21168,Jonas Jerebko,29-300,F,12/27/16,BOS,,MEM,W,0,6,0,1,0,0,0,,0,1,0,0,0,,0,1,1
21169,Jonas Jerebko,29-317,F,1/13/17,BOS,@,ATL,W,0,13,0,2,0,0,0,,0,2,0,0,0,,0,2,2
21170,Jonas Jerebko,29-350,F,2/15/17,BOS,,PHI,W,0,10,0,0,,0,0,,0,0,,0,0,,0,1,1
21171,Jonas Jerebko,29-332,F,1/28/17,BOS,@,MIL,W,1,18,0,4,0,0,1,0,0,3,0,0,0,,2,0,2
21172,Jonas Jerebko,29-280,F,12/7/16,BOS,@,ORL,W,0,14,0,2,0,0,0,,0,2,0,0,0,,1,3,4
21173,Amir Johnson,29-242,F,12/29/16,BOS,@,CLE,L,1,15,0,2,0,0,1,0,0,1,0,0,0,,2,4,6
21174,Amir Johnson,29-208,F,11/25/16,BOS,,SAS,L,1,17,0,5,0,0,4,0,0,1,0,0,0,,1,1,2
21175,Amir Johnson,29-257,F,1/13/17,BOS,@,ATL,W,1,14,0,0,,0,0,,0,0,,0,0,,2,2,4
21176,Amir Johnson,29-218,F,12/5/16,BOS,@,HOU,L,0,5,0,1,0,0,1,0,0,0,,0,0,,1,1,2
21177,Amir Johnson,29-268,F,1/24/17,BOS,@,WAS,L,1,4,0,2,0,0,1,0,0,1,0,0,0,,0,0,0
21178,Brice Johnson,22-241,F,2/23/17,LAC,@,GSW,L,0,3,0,1,0,0,1,0,0,0,,0,0,,1,1,2
21179,James Johnson,29-253,F,10/30/16,MIA,,SAS,L,0,14,0,2,0,0,2,0,0,0,,0,0,,0,2,2
21180,James Johnson,29-251,F,10/28/16,MIA,,CHO,L,0,23,0,6,0,0,3,0,0,3,0,0,0,,0,6,6
21181,Joe Johnson,35-209,G-F,1/24/17,UTA,@,DEN,L,0,18,0,5,0,0,3,0,0,2,0,0,0,,0,4,4
21182,Stanley Johnson,20-262,F,2/15/17,DET,,DAL,W,0,17,0,3,0,0,0,,0,3,0,0,0,,0,1,1
21183,Stanley Johnson,20-157,F,11/2/16,DET,@,BRK,L,0,17,0,4,0,0,1,0,0,3,0,0,0,,0,3,3
21184,Stanley Johnson,20-191,F,12/6/16,DET,,CHI,W,0,6,0,1,0,0,1,0,0,0,,0,0,,0,1,1
21185,Stanley Johnson,20-154,F,10/30/16,DET,,MIL,W,0,16,0,0,,0,0,,0,0,,0,0,,0,4,4
21186,Stanley Johnson,20-189,F,12/4/16,DET,,ORL,L,0,2,0,1,0,0,1,0,0,0,,0,0,,1,0,1
21187,Stanley Johnson,20-206,F,12/21/16,DET,,MEM,L,0,17,0,3,0,0,3,0,0,0,,0,0,,1,1,2
21188,Stanley Johnson,20-294,F,3/19/17,DET,,PHO,W,0,7,0,2,0,0,0,,0,2,0,0,0,,0,0,0
21189,Stanley Johnson,20-187,F,12/2/16,DET,@,ATL,W,0,4,0,1,0,0,1,0,0,0,,0,0,,0,2,2
21190,Stanley Johnson,20-221,F,1/5/17,DET,,CHO,W,0,8,0,2,0,0,1,0,0,1,0,0,0,,0,2,2
21191,Stanley Johnson,20-181,F,11/26/16,DET,@,OKC,L,0,2,0,0,,0,0,,0,0,,0,0,,0,2,2
21192,Stanley Johnson,20-217,F,1/1/17,DET,@,MIA,W,0,13,0,1,0,0,0,,0,1,0,0,0,,0,3,3
21193,Stanley Johnson,20-250,F,2/3/17,DET,,MIN,W,0,12,0,2,0,0,1,0,0,1,0,0,0,,1,1,2
21194,Wesley Johnson,29-192,F-G,1/19/17,LAC,,MIN,L,0,11,0,1,0,0,0,,0,1,0,0,0,,0,1,1
21195,Wesley Johnson,29-210,F-G,2/6/17,LAC,@,TOR,L,0,6,0,1,0,0,0,,0,1,0,0,0,,0,0,0
21196,Wesley Johnson,29-233,F-G,3/1/17,LAC,,HOU,L,0,5,0,3,0,0,0,,0,3,0,0,0,,0,2,2
21197,Wesley Johnson,29-114,F-G,11/2/16,LAC,,OKC,L,0,1,0,0,,0,0,,0,0,,0,0,,0,0,0
21198,Wesley Johnson,29-206,F-G,2/2/17,LAC,,GSW,L,0,7,0,1,0,0,1,0,0,0,,0,0,,0,0,0
21199,Wesley Johnson,29-230,F-G,2/26/17,LAC,,CHO,W,0,5,0,1,0,0,0,,0,1,0,0,0,,0,2,2
21200,Wesley Johnson,29-245,F-G,3/13/17,LAC,@,UTA,L,0,11,0,1,0,0,0,,0,1,0,0,0,,0,1,1
21201,Wesley Johnson,29-192,F-G,1/19/17,LAC,,MIN,L,0,11,0,1,0,0,0,,0,1,0,0,0,,0,1,1
21202,Wesley Johnson,29-210,F-G,2/6/17,LAC,@,TOR,L,0,6,0,1,0,0,0,,0,1,0,0,0,,0,0,0
21203,Wesley Johnson,29-233,F-G,3/1/17,LAC,,HOU,L,0,5,0,3,0,0,0,,0,3,0,0,0,,0,2,2
21204,Wesley Johnson,29-114,F-G,11/2/16,LAC,,OKC,L,0,1,0,0,,0,0,,0,0,,0,0,,0,0,0
21205,Wesley Johnson,29-230,F-G,2/26/17,LAC,,CHO,W,0,5,0,1,0,0,0,,0,1,0,0,0,,0,2,2
21206,Wesley Johnson,29-245,F-G,3/13/17,LAC,@,UTA,L,0,11,0,1,0,0,0,,0,1,0,0,0,,0,1,1
21207,Wesley Johnson,29-206,F-G,2/2/17,LAC,,GSW,L,0,7,0,1,0,0,1,0,0,0,,0,0,,0,0,0
21208,Wesley Johnson,29-133,F-G,11/21/16,LAC,,TOR,W,0,12,0,1,0,0,0,,0,1,0,0,0,,1,2,3
21209,Wesley Johnson,29-165,F-G,12/23/16,LAC,,DAL,L,0,5,0,0,,0,0,,0,0,,0,0,,0,0,0
21210,Nikola Jokic,21-268,C-F,11/13/16,DEN,@,POR,L,0,26,0,3,0,0,3,0,0,0,,0,0,,0,5,5
21211,Damian Jones,21-206,F-C,1/22/17,GSW,@,ORL,W,0,7,0,1,0,0,1,0,0,0,,0,0,,0,1,1
21212,Damian Jones,21-163,F-C,12/10/16,GSW,@,MEM,L,0,9,0,0,,0,0,,0,0,,0,0,,0,0,0
21213,Damian Jones,21-226,F-C,2/11/17,GSW,@,OKC,W,0,2,0,1,0,0,1,0,0,0,,0,2,0,1,1,2
21214,Damian Jones,21-225,F-C,2/10/17,GSW,@,MEM,W,0,2,0,0,,0,0,,0,0,,0,0,,1,0,1
21215,Derrick Jones,20-028,F,3/15/17,PHO,,SAC,L,0,3,0,0,,0,0,,0,0,,0,0,,0,2,2
21216,Derrick Jones,19-278,F,11/19/16,PHO,@,PHI,L,0,3,0,0,,0,0,,0,0,,0,0,,0,0,0
21217,Derrick Jones,19-359,F,2/8/17,PHO,@,MEM,L,0,1,0,0,,0,0,,0,0,,0,0,,0,0,0
21218,Derrick Jones,20-018,F,3/5/17,PHO,,BOS,W,0,12,0,0,,0,0,,0,0,,0,0,,0,0,0
21219,Derrick Jones,19-355,F,2/4/17,PHO,,MIL,L,0,3,0,1,0,0,1,0,0,0,,0,0,,0,0,0
21220,Derrick Jones,19-350,F,1/30/17,PHO,,MEM,L,0,5,0,0,,0,0,,0,0,,0,0,,0,0,0
21221,James Jones,36-070,F-G,12/13/16,CLE,,MEM,W,0,3,0,0,,0,0,,0,0,,0,0,,0,0,0
21222,James Jones,36-066,F-G,12/9/16,CLE,,MIA,W,0,4,0,0,,0,0,,0,0,,0,0,,0,0,0
21223,James Jones,36-142,F-G,2/23/17,CLE,,NYK,W,0,3,0,0,,0,0,,0,0,,0,0,,0,0,0
21224,James Jones,36-038,F-G,11/11/16,CLE,@,WAS,W,0,1,0,1,0,0,0,,0,1,0,0,0,,0,1,1
21225,James Jones,36-088,F-G,12/31/16,CLE,@,CHO,W,0,2,0,0,,0,0,,0,0,,0,0,,0,0,0
21226,James Jones,36-030,F-G,11/3/16,CLE,,BOS,W,0,1,0,0,,0,0,,0,0,,0,0,,0,0,0
21227,James Jones,36-058,F-G,12/1/16,CLE,,LAC,L,0,7,0,1,0,0,1,0,0,0,,0,0,,1,0,1
21228,James Jones,36-083,F-G,12/26/16,CLE,@,DET,L,0,14,0,2,0,0,1,0,0,1,0,0,0,,0,1,1
21229,James Jones,36-133,F-G,2/14/17,CLE,@,MIN,W,0,9,0,1,0,0,0,,0,1,0,0,0,,0,0,0
21230,James Jones,36-080,F-G,12/23/16,CLE,,BRK,W,0,16,0,4,0,0,2,0,0,2,0,0,0,,0,1,1
21231,James Jones,36-104,F-G,1/16/17,CLE,@,GSW,L,0,7,0,0,,0,0,,0,0,,0,0,,0,0,0
21232,James Jones,36-130,F-G,2/11/17,CLE,,DEN,W,0,1,0,0,,0,0,,0,0,,0,0,,0,0,0
21233,James Jones,36-165,F-G,3/18/17,CLE,@,LAC,L,0,17,0,2,0,0,1,0,0,1,0,0,0,,0,1,1
21234,James Jones,36-078,F-G,12/21/16,CLE,,MIL,W,0,3,0,0,,0,0,,0,0,,0,0,,0,1,1
21235,James Jones,36-101,F-G,1/13/17,CLE,@,SAC,W,0,1,0,0,,0,0,,0,0,,0,0,,0,1,1
21236,James Jones,36-158,F-G,3/11/17,CLE,@,ORL,W,0,2,0,0,,0,0,,0,0,,0,0,,0,0,0
21237,James Jones,36-050,F-G,11/23/16,CLE,,POR,W,0,4,0,0,,0,0,,0,0,,0,0,,0,1,1
21238,James Jones,36-098,F-G,1/10/17,CLE,@,UTA,L,0,0,0,0,,0,0,,0,0,,0,0,,0,0,0
21239,Terrence Jones,25-063,F,3/13/17,MIL,@,MEM,L,0,2,0,1,0,0,1,0,0,0,,0,0,,0,1,1
21240,Terrence Jones,24-323,F,11/27/16,NOP,@,DAL,L,0,13,0,5,0,0,4,0,0,1,0,0,0,,0,2,2
21241,Tyus Jones,20-315,G,3/21/17,MIN,,SAS,L,0,12,0,1,0,0,1,0,0,0,,0,0,,0,2,2
21242,Tyus Jones,20-212,G,12/8/16,MIN,@,TOR,L,0,1,0,1,0,0,0,,0,1,0,0,0,,0,0,0
21243,Tyus Jones,20-250,G,1/15/17,MIN,@,DAL,L,0,9,0,2,0,0,1,0,0,1,0,0,0,,0,0,0
21244,Tyus Jones,20-313,G,3/19/17,MIN,@,NOP,L,0,11,0,1,0,0,1,0,0,0,,0,0,,1,2,3
21245,Tyus Jones,20-204,G,11/30/16,MIN,,NYK,L,0,6,0,0,,0,0,,0,0,,0,0,,0,0,0
21246,Tyus Jones,20-236,G,1/1/17,MIN,,POR,L,0,0,0,0,,0,0,,0,0,,0,0,,0,0,0
21247,Tyus Jones,20-230,G,12/26/16,MIN,,ATL,W,0,8,0,1,0,0,0,,0,1,0,0,0,,0,1,1
21248,Tyus Jones,20-267,G,2/1/17,MIN,@,CLE,L,0,3,0,0,,0,0,,0,0,,0,0,,0,0,0
21249,Tyus Jones,20-265,G,1/30/17,MIN,,ORL,W,0,0,0,0,,0,0,,0,0,,0,0,,0,0,0
21250,Tyus Jones,20-305,G,3/11/17,MIN,@,MIL,L,0,12,0,2,0,0,2,0,0,0,,0,0,,0,1,1
21251,Tyus Jones,20-221,G,12/17/16,MIN,,HOU,L,0,0,0,0,,0,0,,0,0,,0,0,,0,0,0
21252,Tyus Jones,20-263,G,1/28/17,MIN,,BRK,W,0,2,0,1,0,0,1,0,0,0,,0,0,,0,0,0
21253,Tyus Jones,20-278,G,2/12/17,MIN,,CHI,W,0,3,0,0,,0,0,,0,0,,0,0,,0,0,0
21254,Tyus Jones,20-197,G,11/23/16,MIN,@,NOP,L,0,3,0,0,,0,0,,0,0,,0,0,,0,0,0
21255,Tyus Jones,20-215,G,12/11/16,MIN,,GSW,L,0,0,0,0,,0,0,,0,0,,0,0,,0,0,0
21256,Tyus Jones,20-193,G,11/19/16,MIN,@,MEM,L,0,3,0,0,,0,0,,0,0,,0,0,,0,0,0
21257,Cory Joseph,25-167,G,2/3/17,TOR,@,ORL,L,0,7,0,1,0,0,1,0,0,0,,0,0,,0,2,2
21258,Enes Kanter,24-167,C,11/3/16,OKC,@,GSW,L,0,3,0,1,0,0,1,0,0,0,,0,0,,0,0,0
21259,Ryan Kelly,25-210,F,11/5/16,ATL,,HOU,W,0,2,0,0,,0,0,,0,0,,0,0,,0,0,0
21260,Ryan Kelly,25-238,F,12/3/16,ATL,@,TOR,L,0,4,0,0,,0,0,,0,0,,0,0,,0,1,1
21261,Ryan Kelly,25-237,F,12/2/16,ATL,,DET,L,0,4,0,0,,0,0,,0,0,,0,0,,0,1,1
21262,Ryan Kelly,25-232,F,11/27/16,ATL,@,LAL,L,0,4,0,1,0,0,0,,0,1,0,0,0,,0,2,2
21263,Ryan Kelly,25-345,F,3/20/17,ATL,@,CHO,L,0,11,0,3,0,0,2,0,0,1,0,0,0,,0,1,1
21264,Ryan Kelly,25-343,F,3/18/17,ATL,,POR,L,0,3,0,0,,0,0,,0,0,,0,0,,0,0,0
21265,Ryan Kelly,25-227,F,11/22/16,ATL,,NOP,L,0,7,0,2,0,0,2,0,0,0,,0,0,,0,2,2
21266,Ryan Kelly,25-217,F,11/12/16,ATL,,PHI,W,0,3,0,1,0,0,1,0,0,0,,0,0,,0,0,0
21267,Ryan Kelly,25-324,F,2/27/17,ATL,@,BOS,W,0,3,0,0,,0,0,,0,0,,0,0,,0,0,0
21268,Michael Kidd-Gilchrist,23-106,F,1/10/17,CHO,@,HOU,L,1,34,0,6,0,0,6,0,0,0,,0,0,,1,5,6
21269,Michael Kidd-Gilchrist,23-072,F,12/7/16,CHO,,DET,W,1,20,0,6,0,0,6,0,0,0,,0,0,,2,3,5
21270,Brandon Knight,25-029,G,12/31/16,PHO,@,UTA,L,0,8,0,5,0,0,5,0,0,0,,0,0,,0,0,0
21271,Brandon Knight,25-061,G,2/1/17,PHO,,LAC,L,0,8,0,3,0,0,2,0,0,1,0,0,0,,0,0,0
21272,Kosta Koufos,28-005,C,3/1/17,SAC,,BRK,L,1,24,0,7,0,0,7,0,0,0,,0,0,,2,3,5
21273,Kosta Koufos,27-268,C,11/18/16,SAC,,LAC,L,1,9,0,1,0,0,1,0,0,0,,0,0,,0,1,1
21274,Kosta Koufos,27-282,C,12/2/16,SAC,@,BOS,L,1,9,0,0,,0,0,,0,0,,0,0,,0,3,3
21275,Kosta Koufos,27-311,C,12/31/16,SAC,,MEM,L,1,20,0,4,0,0,4,0,0,0,,0,0,,2,6,8
21276,Mindaugas Kuzminskas,27-028,F,11/16/16,NYK,,DET,W,0,7,0,1,0,0,0,,0,1,0,0,0,,0,1,1
21277,Mindaugas Kuzminskas,27-084,F,1/11/17,NYK,@,PHI,L,0,10,0,2,0,0,0,,0,2,0,0,0,,0,0,0
21278,Mindaugas Kuzminskas,27-127,F,2/23/17,NYK,@,CLE,L,0,7,0,0,,0,0,,0,0,,0,0,,0,0,0
21279,Mindaugas Kuzminskas,27-059,F,12/17/16,NYK,@,DEN,L,0,2,0,0,,0,0,,0,0,,0,0,,0,0,0
21280,Mindaugas Kuzminskas,27-096,F,1/23/17,NYK,@,IND,W,0,11,0,1,0,0,1,0,0,0,,0,0,,0,3,3
21281,Mindaugas Kuzminskas,27-140,F,3/8/17,NYK,@,MIL,L,0,4,0,1,0,0,0,,0,1,0,0,0,,0,0,0
21282,Mindaugas Kuzminskas,27-038,F,11/26/16,NYK,@,CHO,L,0,9,0,2,0,0,2,0,0,0,,0,0,,0,0,0
21283,Mindaugas Kuzminskas,27-135,F,3/3/17,NYK,@,PHI,L,0,5,0,2,0,0,1,0,0,1,0,0,0,,0,1,1
21284,Mindaugas Kuzminskas,27-032,F,11/20/16,NYK,,ATL,W,0,6,0,1,0,0,0,,0,1,0,0,0,,0,1,1
21285,Mindaugas Kuzminskas,27-070,F,12/28/16,NYK,@,ATL,L,0,3,0,0,,0,0,,0,0,,0,0,,0,0,0
21286,Mindaugas Kuzminskas,27-131,F,2/27/17,NYK,,TOR,L,0,2,0,1,0,0,1,0,0,0,,0,0,,0,0,0
21287,Skal Labissiere,20-352,F,3/5/17,SAC,,UTA,L,0,2,0,0,,0,0,,0,0,,0,0,,0,0,0
21288,Skal Labissiere,20-275,F,12/18/16,SAC,@,DAL,L,0,2,0,0,,0,0,,0,0,,0,0,,0,0,0
21289,Skal Labissiere,20-334,F,2/15/17,SAC,@,GSW,L,0,10,0,2,0,0,2,0,0,0,,0,0,,0,0,0
21290,Jeremy Lamb,24-149,G-F,10/26/16,CHO,@,MIL,W,0,9,0,4,0,0,4,0,0,0,,0,0,,0,1,1
21291,Nicolas Laprovittola,26-292,G,11/18/16,SAS,@,LAL,W,0,0,0,0,,0,0,,0,0,,0,0,,0,0,0
21292,Nicolas Laprovittola,26-318,G,12/14/16,SAS,,BOS,W,0,0,0,0,,0,0,,0,0,,0,0,,0,0,0
21293,Nicolas Laprovittola,26-275,G,11/1/16,SAS,,UTA,L,0,1,0,0,,0,0,,0,0,,0,0,,0,0,0
21294,Nicolas Laprovittola,26-273,G,10/30/16,SAS,@,MIA,W,0,1,0,0,,0,0,,0,0,,0,0,,0,0,0
21295,Nicolas Laprovittola,26-327,G,12/23/16,SAS,@,POR,W,0,2,0,1,0,0,0,,0,1,0,0,0,,0,0,0
21296,Nicolas Laprovittola,26-268,G,10/25/16,SAS,@,GSW,W,0,4,0,0,,0,0,,0,0,,0,0,,0,0,0
21297,Nicolas Laprovittola,26-300,G,11/26/16,SAS,@,WAS,W,0,1,0,0,,0,0,,0,0,,0,0,,0,0,0
21298,Nicolas Laprovittola,26-322,G,12/18/16,SAS,,NOP,W,0,4,0,1,0,0,1,0,0,0,,0,0,,0,1,1
21299,Joffrey Lauvergne,25-115,C-F,1/23/17,OKC,@,UTA,W,0,11,0,0,,0,0,,0,0,,0,0,,0,1,1
21300,Joffrey Lauvergne,25-090,C-F,12/29/16,OKC,@,MEM,L,0,10,0,1,0,0,0,,0,1,0,0,0,,0,0,0
21301,Joffrey Lauvergne,25-169,C-F,3/18/17,CHI,,UTA,W,0,7,0,1,0,0,1,0,0,0,,0,0,,0,1,1
21302,Joffrey Lauvergne,25-047,C-F,11/16/16,OKC,,HOU,W,0,4,0,2,0,0,1,0,0,1,0,0,0,,0,1,1
21303,Joffrey Lauvergne,25-028,C-F,10/28/16,OKC,,PHO,W,0,6,0,0,,0,0,,0,0,,0,0,,2,0,2
21304,Joffrey Lauvergne,25-040,C-F,11/9/16,OKC,,TOR,L,0,11,0,2,0,0,1,0,0,1,0,0,0,,0,1,1
21305,Joffrey Lauvergne,25-115,C-F,1/23/17,OKC,@,UTA,W,0,11,0,0,,0,0,,0,0,,0,0,,0,1,1
21306,Joffrey Lauvergne,25-090,C-F,12/29/16,OKC,@,MEM,L,0,10,0,1,0,0,0,,0,1,0,0,0,,0,0,0
21307,Joffrey Lauvergne,25-107,C-F,1/15/17,OKC,@,SAC,W,0,4,0,3,0,0,2,0,0,1,0,0,0,,0,1,1
21308,Ty Lawson,29-005,G,11/8/16,SAC,,NOP,W,0,21,0,5,0,0,3,0,0,2,0,0,0,,0,2,2
21309,Ty Lawson,29-089,G,1/31/17,SAC,@,HOU,L,0,12,0,3,0,0,2,0,0,1,0,0,2,0,0,1,1
21310,Ty Lawson,29-031,G,12/4/16,SAC,@,NYK,L,0,9,0,2,0,0,1,0,0,1,0,0,0,,0,0,0
21311,Ty Lawson,29-008,G,11/11/16,SAC,@,POR,L,1,15,0,4,0,0,3,0,0,1,0,0,0,,0,1,1
21312,Jake Layman,22-291,F,12/23/16,POR,,SAS,L,0,2,0,1,0,0,1,0,0,0,,0,0,,0,0,0
21313,Jake Layman,22-261,F,11/23/16,POR,@,CLE,L,0,4,0,1,0,0,0,,0,1,0,0,0,,0,1,1
21314,Jake Layman,22-283,F,12/15/16,POR,@,DEN,L,0,4,0,1,0,0,0,,0,1,0,0,0,,1,0,1
21315,Jake Layman,22-345,F,2/15/17,POR,@,UTA,L,0,4,0,0,,0,0,,0,0,,0,0,,0,0,0
21316,Jake Layman,22-256,F,11/18/16,POR,@,NOP,L,0,2,0,0,,0,0,,0,0,,0,0,,0,0,0
21317,Jake Layman,22-281,F,12/13/16,POR,,OKC,W,0,6,0,4,0,0,1,0,0,3,0,0,0,,0,0,0
21318,Jake Layman,22-317,F,1/18/17,POR,@,CHO,L,0,4,0,0,,0,0,,0,0,,0,0,,0,0,0
21319,Jake Layman,22-280,F,12/12/16,POR,@,LAC,L,0,0,0,0,,0,0,,0,0,,0,0,,0,0,0
21320,Jake Layman,22-253,F,11/15/16,POR,,CHI,L,0,4,0,2,0,0,0,,0,2,0,0,0,,0,0,0
21321,Jake Layman,22-251,F,11/13/16,POR,,DEN,W,0,4,0,2,0,0,1,0,0,1,0,0,0,,0,0,0
21322,Jake Layman,22-268,F,11/30/16,POR,,IND,W,0,2,0,0,,0,0,,0,0,,0,0,,0,0,0
21323,Jake Layman,22-265,F,11/27/16,POR,,HOU,L,0,6,0,0,,0,0,,0,0,,0,0,,0,0,0
21324,Jake Layman,22-298,F,12/30/16,POR,@,SAS,L,0,3,0,0,,0,0,,0,0,,0,0,,0,0,0
21325,Courtney Lee,31-022,G,10/25/16,NYK,@,CLE,L,1,20,0,5,0,0,3,0,0,2,0,0,0,,1,2,3
21326,David Lee,33-251,F,1/5/17,SAS,@,DEN,W,0,6,0,1,0,0,1,0,0,0,,0,0,,2,3,5
21327,David Lee,33-308,F,3/3/17,SAS,@,NOP,W,0,9,0,0,,0,0,,0,0,,0,0,,0,3,3
21328,Alex Len,23-226,C,1/28/17,PHO,,DEN,L,0,8,0,1,0,0,1,0,0,0,,0,0,,0,2,2
21329,Meyers Leonard,24-309,C-F,1/1/17,POR,@,MIN,W,0,10,0,6,0,0,2,0,0,4,0,0,0,,0,2,2
21330,Meyers Leonard,24-333,C-F,1/25/17,POR,,LAL,W,0,14,0,5,0,0,2,0,0,3,0,0,0,,1,4,5
21331,Meyers Leonard,24-241,C-F,10/25/16,POR,,UTA,W,0,9,0,2,0,0,1,0,0,1,0,0,0,,0,1,1
21332,Meyers Leonard,24-289,C-F,12/12/16,POR,@,LAC,L,0,3,0,0,,0,0,,0,0,,0,0,,0,0,0
21333,Meyers Leonard,25-022,C-F,3/21/17,POR,,MIL,L,0,7,0,1,0,0,1,0,0,0,,0,0,,0,2,2
21334,Meyers Leonard,24-285,C-F,12/8/16,POR,@,MEM,L,1,17,0,3,0,0,1,0,0,2,0,0,0,,1,5,6
21335,Meyers Leonard,24-303,C-F,12/26/16,POR,,TOR,L,0,8,0,1,0,0,0,,0,1,0,0,0,,0,1,1
21336,Meyers Leonard,24-251,C-F,11/4/16,POR,@,DAL,W,0,4,0,1,0,0,1,0,0,0,,0,0,,0,0,0
21337,Meyers Leonard,25-020,C-F,3/19/17,POR,@,MIA,W,0,6,0,2,0,0,1,0,0,1,0,0,0,,0,0,0
21338,Meyers Leonard,24-297,C-F,12/20/16,POR,@,SAC,L,1,19,0,3,0,0,0,,0,3,0,0,0,,1,1,2
21339,Meyers Leonard,24-318,C-F,1/10/17,POR,@,LAL,W,0,3,0,0,,0,0,,0,0,,0,0,,0,1,1
21340,Meyers Leonard,24-248,C-F,11/1/16,POR,,GSW,L,0,10,0,0,,0,0,,0,0,,0,0,,0,2,2
21341,Meyers Leonard,25-016,C-F,3/15/17,POR,@,SAS,W,0,7,0,1,0,0,0,,0,1,0,0,0,,0,1,1
21342,Meyers Leonard,24-262,C-F,11/15/16,POR,,CHI,L,1,15,0,6,0,0,1,0,0,5,0,0,0,,0,2,2
21343,Jon Leuer,27-299,F,3/9/17,DET,,CLE,W,0,13,0,1,0,0,1,0,0,0,,0,0,,0,0,0
21344,Jon Leuer,27-290,F,2/28/17,DET,,POR,W,1,20,0,8,0,0,5,0,0,3,0,0,0,,0,5,5
21345,Jon Leuer,27-189,F,11/19/16,DET,,BOS,L,0,21,0,7,0,0,3,0,0,4,0,0,0,,2,4,6
21346,Jon Leuer,27-239,F,1/8/17,DET,@,POR,W,1,6,0,0,,0,0,,0,0,,0,0,,0,0,0
21347,Caris LeVert,22-104,G-F,12/7/16,BRK,,DEN,W,0,9,0,3,0,0,2,0,0,1,0,0,0,,1,3,4
21348,Caris LeVert,22-130,G-F,1/2/17,BRK,,UTA,L,0,14,0,2,0,0,0,,0,2,0,0,0,,0,0,0
21349,DeAndre Liggins,28-321,G,2/15/17,CLE,,IND,W,0,3,0,0,,0,0,,0,0,,0,0,,0,0,0
21350,DeAndre Liggins,28-269,G,12/25/16,CLE,,GSW,W,1,22,0,1,0,0,1,0,0,0,,0,2,0,0,2,2
21351,DeAndre Liggins,28-302,G,1/27/17,CLE,,BRK,W,0,3,0,0,,0,0,,0,0,,0,0,,0,0,0
21352,DeAndre Liggins,28-350,G,3/16/17,CLE,,UTA,W,0,0,0,0,,0,0,,0,0,,0,0,,0,0,0
21353,DeAndre Liggins,28-217,G,11/3/16,CLE,,BOS,W,0,1,0,0,,0,0,,0,0,,0,0,,0,0,0
21354,DeAndre Liggins,28-300,G,1/25/17,CLE,,SAC,L,0,1,0,1,0,0,0,,0,1,0,0,0,,0,0,0
21355,DeAndre Liggins,28-315,G,2/9/17,CLE,@,OKC,L,0,1,0,0,,0,0,,0,0,,0,0,,0,0,0
21356,DeAndre Liggins,28-215,G,11/1/16,CLE,,HOU,W,0,0,0,0,,0,0,,0,0,,0,0,,0,0,0
21357,DeAndre Liggins,28-298,G,1/23/17,CLE,@,NOP,L,0,8,0,1,0,0,1,0,0,0,,0,0,,0,1,1
21358,DeAndre Liggins,28-345,G,3/11/17,CLE,@,ORL,W,0,2,0,0,,0,0,,0,0,,0,0,,0,1,1
21359,DeAndre Liggins,28-211,G,10/28/16,CLE,@,TOR,W,0,0,0,0,,0,0,,0,0,,0,0,,0,0,0
21360,DeAndre Liggins,28-340,G,3/6/17,CLE,,MIA,L,0,0,0,0,,0,0,,0,0,,0,0,,0,0,0
21361,DeAndre Liggins,28-241,G,11/27/16,CLE,@,PHI,W,0,7,0,0,,0,0,,0,0,,0,0,,0,0,0
21362,DeAndre Liggins,28-261,G,12/17/16,CLE,,LAL,W,0,10,0,0,,0,0,,0,0,,0,0,,0,1,1
21363,DeAndre Liggins,28-291,G,1/16/17,CLE,@,GSW,L,0,17,0,1,0,0,1,0,0,0,,0,0,,1,1,2
21364,DeAndre Liggins,28-307,G,2/1/17,CLE,,MIN,W,0,3,0,0,,0,0,,0,0,,0,0,,0,2,2
21365,DeAndre Liggins,28-331,G,2/25/17,CLE,,CHI,L,0,5,0,1,0,0,1,0,0,0,,0,0,,0,0,0
21366,DeAndre Liggins,28-288,G,1/13/17,CLE,@,SAC,W,0,13,0,1,0,0,1,0,0,0,,0,0,,1,2,3
21367,DeAndre Liggins,28-254,G,12/10/16,CLE,,CHO,W,0,15,0,1,0,0,1,0,0,0,,0,0,,0,0,0
21368,DeAndre Liggins,28-270,G,12/26/16,CLE,@,DET,L,1,18,0,3,0,0,1,0,0,2,0,0,0,,0,1,1
21369,DeAndre Liggins,28-304,G,1/29/17,CLE,,OKC,W,0,2,0,1,0,0,1,0,0,0,,0,0,,0,1,1
21370,Shaun Livingston,31-186,G,3/16/17,GSW,,ORL,W,0,19,0,0,,0,0,,0,0,,0,0,,0,0,0
21371,Shaun Livingston,31-157,G,2/15/17,GSW,,SAC,W,0,15,0,2,0,0,2,0,0,0,,0,0,,0,1,1
21372,Shaun Livingston,31-175,G,3/5/17,GSW,@,NYK,W,0,14,0,4,0,0,4,0,0,0,,0,0,,0,0,0
21373,Shaun Livingston,31-172,G,3/2/17,GSW,@,CHI,L,0,19,0,3,0,0,3,0,0,0,,0,0,,0,3,3
21374,Shawn Long,24-044,F,3/14/17,PHI,@,GSW,L,0,4,0,1,0,0,1,0,0,0,,0,2,0,1,0,1
21375,Shawn Long,24-039,F,3/9/17,PHI,@,POR,L,0,0,0,0,,0,0,,0,0,,0,0,,0,0,0
21376,Kevon Looney,21-030,F-C,3/8/17,GSW,,BOS,L,0,2,0,1,0,0,1,0,0,0,,0,2,0,1,0,1
21377,Kevon Looney,20-311,F-C,12/13/16,GSW,@,NOP,W,0,4,0,0,,0,0,,0,0,,0,0,,1,0,1
21378,Kevon Looney,20-333,F-C,1/4/17,GSW,,POR,W,0,4,0,1,0,0,1,0,0,0,,0,0,,0,0,0
21379,Kevon Looney,21-019,F-C,2/25/17,GSW,,BRK,W,0,2,0,0,,0,0,,0,0,,0,0,,0,0,0
21380,Kevon Looney,20-328,F-C,12/30/16,GSW,,DAL,W,0,4,0,1,0,0,1,0,0,0,,0,0,,0,0,0
21381,Kevon Looney,21-043,F-C,3/21/17,GSW,@,DAL,W,0,4,0,1,0,0,1,0,0,0,,0,0,,0,0,0
21382,Kevon Looney,20-287,F-C,11/19/16,GSW,@,MIL,W,0,4,0,3,0,0,3,0,0,0,,0,0,,1,1,2
21383,Kevon Looney,20-323,F-C,12/25/16,GSW,@,CLE,L,0,5,0,0,,0,0,,0,0,,0,0,,0,1,1
21384,Kevon Looney,20-351,F-C,1/22/17,GSW,@,ORL,W,0,6,0,1,0,0,1,0,0,0,,0,0,,0,3,3
21385,Kevon Looney,20-262,F-C,10/25/16,GSW,,SAS,L,0,4,0,0,,0,0,,0,0,,0,0,,0,0,0
21386,Kevon Looney,20-318,F-C,12/20/16,GSW,,UTA,W,0,9,0,2,0,0,1,0,0,1,0,0,0,,0,4,4
21387,Kevon Looney,21-004,F-C,2/10/17,GSW,@,MEM,W,0,12,0,1,0,0,1,0,0,0,,0,0,,0,2,2
21388,Kevon Looney,20-299,F-C,12/1/16,GSW,,HOU,L,0,1,0,0,,0,0,,0,0,,0,0,,0,0,0
21389,Kevon Looney,20-347,F-C,1/18/17,GSW,,OKC,W,0,4,0,1,0,0,1,0,0,0,,0,0,,0,0,0
21390,Kevon Looney,21-032,F-C,3/10/17,GSW,@,MIN,L,0,2,0,0,,0,0,,0,0,,0,0,,0,1,1
21391,John Lucas III,33-362,G,11/17/16,MIN,,PHI,W,0,1,0,0,,0,0,,0,0,,0,0,,0,0,0
21392,John Lucas III,33-358,G,11/13/16,MIN,,LAL,W,0,1,0,0,,0,0,,0,0,,0,0,,0,0,0
21393,John Lucas III,33-354,G,11/9/16,MIN,@,ORL,W,0,1,0,0,,0,0,,0,0,,0,0,,0,0,0
21394,John Lucas III,33-364,G,11/19/16,MIN,@,MEM,L,0,1,0,0,,0,0,,0,0,,0,0,,0,0,0
21395,Timothe Luwawu-Cabarrot,21-275,F,2/8/17,PHI,,SAS,L,0,4,0,1,0,0,0,,0,1,0,0,0,,0,1,1
21396,Timothe Luwawu-Cabarrot,21-180,F,11/5/16,PHI,,CLE,L,0,4,0,1,0,0,1,0,0,0,,0,0,,0,0,0
21397,Timothe Luwawu-Cabarrot,21-203,F,11/28/16,PHI,@,TOR,L,0,9,0,1,0,0,0,,0,1,0,0,0,,0,1,1
21398,Timothe Luwawu-Cabarrot,21-234,F,12/29/16,PHI,@,UTA,L,0,15,0,1,0,0,1,0,0,0,,0,0,,0,1,1
21399,Timothe Luwawu-Cabarrot,21-177,F,11/2/16,PHI,@,CHO,L,0,3,0,1,0,0,0,,0,1,0,0,0,,0,0,0
21400,Timothe Luwawu-Cabarrot,21-219,F,12/14/16,PHI,,TOR,L,0,5,0,0,,0,0,,0,0,,0,0,,0,0,0
21401,Timothe Luwawu-Cabarrot,21-275,F,2/8/17,PHI,,SAS,L,0,4,0,1,0,0,0,,0,1,0,0,0,,0,1,1
21402,Timothe Luwawu-Cabarrot,21-180,F,11/5/16,PHI,,CLE,L,0,4,0,1,0,0,1,0,0,0,,0,0,,0,0,0
21403,Timothe Luwawu-Cabarrot,21-177,F,11/2/16,PHI,@,CHO,L,0,3,0,1,0,0,0,,0,1,0,0,0,,0,0,0
21404,Timothe Luwawu-Cabarrot,21-203,F,11/28/16,PHI,@,TOR,L,0,9,0,1,0,0,0,,0,1,0,0,0,,0,1,1
21405,Timothe Luwawu-Cabarrot,21-234,F,12/29/16,PHI,@,UTA,L,0,15,0,1,0,0,1,0,0,0,,0,0,,0,1,1
21406,Trey Lyles,21-084,F,1/28/17,UTA,,MEM,L,1,21,0,3,0,0,1,0,0,2,0,0,0,,0,1,1
21407,Trey Lyles,21-102,F,2/15/17,UTA,,POR,W,0,2,0,0,,0,0,,0,0,,0,0,,0,0,0
21408,Trey Lyles,21-135,F,3/20/17,UTA,@,IND,L,0,4,0,2,0,0,2,0,0,0,,0,0,,1,0,1
21409,Trey Lyles,21-031,F,12/6/16,UTA,,PHO,W,0,13,0,3,0,0,1,0,0,2,0,0,0,,1,2,3
21410,Trey Lyles,21-096,F,2/9/17,UTA,@,DAL,L,0,7,0,0,,0,0,,0,0,,0,0,,0,0,0
21411,Trey Lyles,20-363,F,11/2/16,UTA,,DAL,W,0,23,0,3,0,0,2,0,0,1,0,0,0,,0,4,4
21412,Trey Lyles,21-121,F,3/6/17,UTA,,NOP,W,0,4,0,1,0,0,1,0,0,0,,0,0,,0,0,0
21413,Trey Lyles,21-043,F,12/18/16,UTA,@,MEM,W,0,10,0,2,0,0,0,,0,2,0,0,2,0,0,2,2
21414,Trey Lyles,21-059,F,1/3/17,UTA,@,BOS,L,0,6,0,2,0,0,0,,0,2,0,0,0,,0,0,0
21415,Trey Lyles,21-120,F,3/5/17,UTA,@,SAC,W,0,2,0,0,,0,0,,0,0,,0,0,,0,1,1
21416,Trey Lyles,21-058,F,1/2/17,UTA,@,BRK,W,0,12,0,4,0,0,2,0,0,2,0,0,0,,0,2,2
21417,Trey Lyles,21-118,F,3/3/17,UTA,,BRK,W,0,14,0,6,0,0,3,0,0,3,0,0,0,,0,3,3
21418,Shelvin Mack,26-215,G,11/23/16,UTA,,DEN,W,0,12,0,3,0,0,3,0,0,0,,0,0,,0,2,2
21419,Shelvin Mack,26-263,G,1/10/17,UTA,,CLE,W,0,9,0,2,0,0,1,0,0,1,0,0,0,,0,1,1
21420,Shelvin Mack,26-260,G,1/7/17,UTA,@,MIN,W,0,15,0,3,0,0,2,0,0,1,0,0,0,,0,1,1
21421,Shelvin Mack,26-295,G,2/11/17,UTA,,BOS,L,0,5,0,1,0,0,0,,0,1,0,0,0,,0,1,1
21422,Shelvin Mack,26-290,G,2/6/17,UTA,@,ATL,W,0,1,0,0,,0,0,,0,0,,0,0,,0,0,0
21423,Shelvin Mack,26-277,G,1/24/17,UTA,@,DEN,L,0,12,0,3,0,0,3,0,0,0,,0,0,,0,2,2
21424,Ian Mahinmi,30-097,C,2/10/17,WAS,,IND,W,0,13,0,2,0,0,2,0,0,0,,0,0,,0,3,3
21425,Ian Mahinmi,30-126,C,3/11/17,WAS,@,POR,W,0,15,0,1,0,0,1,0,0,0,,0,0,,0,3,3
21426,Ian Mahinmi,30-135,C,3/20/17,WAS,@,BOS,L,0,17,0,1,0,0,1,0,0,0,,0,0,,1,3,4
21427,Thon Maker,19-289,F-C,12/10/16,MIL,@,WAS,L,0,0,0,0,,0,0,,0,0,,0,0,,0,0,0
21428,Thon Maker,19-280,F-C,12/1/16,MIL,@,BRK,W,0,3,0,1,0,0,0,,0,1,0,0,0,,0,0,0
21429,Thon Maker,19-309,F-C,12/30/16,MIL,@,MIN,L,0,6,0,1,0,0,1,0,0,0,,0,0,,0,0,0
21430,Thon Maker,19-335,F-C,1/25/17,MIL,,PHI,L,0,1,0,0,,0,0,,0,0,,0,0,,0,0,0
21431,Thon Maker,20-024,F-C,3/21/17,MIL,@,POR,W,1,3,0,0,,0,0,,0,0,,0,0,,0,0,0
21432,Thon Maker,19-266,F-C,11/17/16,MIL,@,MIA,L,0,1,0,1,0,0,1,0,0,0,,0,0,,0,0,0
21433,Thon Maker,20-007,F-C,3/4/17,MIL,,TOR,W,1,9,0,2,0,0,1,0,0,1,0,0,0,,1,1,2
21434,Thon Maker,19-330,F-C,1/20/17,MIL,@,ORL,L,0,5,0,0,,0,0,,0,0,,0,0,,1,0,1
21435,Thon Maker,20-020,F-C,3/17/17,MIL,@,LAL,W,1,10,0,3,0,0,1,0,0,2,0,0,0,,1,0,1
21436,Thon Maker,19-345,F-C,2/4/17,MIL,@,PHO,W,0,3,0,1,0,0,1,0,0,0,,0,0,,0,0,0
21437,Thon Maker,19-248,F-C,10/30/16,MIL,@,DET,L,0,2,0,0,,0,0,,0,0,,0,0,,0,1,1
21438,Thon Maker,19-325,F-C,1/15/17,MIL,@,ATL,L,0,1,0,1,0,0,1,0,0,0,,0,0,,1,0,1
21439,Thon Maker,20-014,F-C,3/11/17,MIL,,MIN,W,1,5,0,1,0,0,1,0,0,0,,0,0,,1,1,2
21440,Boban Marjanovic,28-116,C,12/9/16,DET,@,MIN,W,0,4,0,0,,0,0,,0,0,,0,0,,0,0,0
21441,Boban Marjanovic,28-072,C,10/26/16,DET,@,TOR,L,0,5,0,1,0,0,1,0,0,0,,0,0,,0,1,1
21442,Boban Marjanovic,28-106,C,11/29/16,DET,@,CHO,W,0,2,0,1,0,0,1,0,0,0,,0,0,,0,1,1
21443,Boban Marjanovic,28-146,C,1/8/17,DET,@,POR,W,0,0,0,0,,0,0,,0,0,,0,0,,0,0,0
21444,Boban Marjanovic,28-182,C,2/13/17,DET,@,MIL,L,0,9,0,1,0,0,1,0,0,0,,0,0,,1,3,4
21445,Boban Marjanovic,28-100,C,11/23/16,DET,,MIA,W,0,3,0,3,0,0,3,0,0,0,,0,0,,1,0,1
21446,Jarell Martin,22-164,F,11/4/16,MEM,,LAC,L,0,13,0,1,0,0,1,0,0,0,,0,0,,1,3,4
21447,Jarell Martin,22-224,F,1/3/17,MEM,@,LAL,L,0,5,0,1,0,0,0,,0,1,0,0,0,,0,2,2
21448,Jarell Martin,22-179,F,11/19/16,MEM,,MIN,W,0,2,0,0,,0,0,,0,0,,0,0,,0,0,0
21449,Jarell Martin,22-221,F,12/31/16,MEM,@,SAC,W,0,13,0,3,0,0,3,0,0,0,,0,0,,0,2,2
21450,Jarell Martin,22-219,F,12/29/16,MEM,,OKC,W,0,4,0,0,,0,0,,0,0,,0,0,,0,1,1
21451,Jarell Martin,22-176,F,11/16/16,MEM,@,LAC,W,0,2,0,1,0,0,1,0,0,0,,0,0,,1,0,1
21452,Jarell Martin,22-217,F,12/27/16,MEM,@,BOS,L,0,7,0,2,0,0,1,0,0,1,0,0,0,,1,0,1
21453,Jarell Martin,22-174,F,11/14/16,MEM,@,UTA,W,0,11,0,0,,0,0,,0,0,,0,0,,1,0,1
21454,Jarell Martin,22-242,F,1/21/17,MEM,,HOU,L,0,3,0,1,0,0,0,,0,1,0,0,0,,0,1,1
21455,Jarell Martin,22-241,F,1/20/17,MEM,,SAC,W,0,3,0,2,0,0,2,0,0,0,,0,0,,0,0,0
21456,Luc Mbah a Moute,30-137,F,1/24/17,LAC,@,PHI,L,1,18,0,1,0,0,0,,0,1,0,0,0,,0,2,2
21457,Luc Mbah a Moute,30-146,F,2/2/17,LAC,,GSW,L,0,4,0,0,,0,0,,0,0,,0,0,,0,2,2
21458,Luc Mbah a Moute,30-168,F,2/24/17,LAC,,SAS,L,1,19,0,1,0,0,1,0,0,0,,0,0,,0,1,1
21459,Luc Mbah a Moute,30-181,F,3/9/17,LAC,@,MEM,W,1,12,0,1,0,0,0,,0,1,0,0,0,,0,1,1
21460,James Michael McAdoo,24-012,F,1/16/17,GSW,,CLE,W,0,5,0,1,0,0,1,0,0,0,,0,0,,0,1,1
21461,James Michael McAdoo,24-006,F,1/10/17,GSW,,MIA,W,0,0,0,0,,0,0,,0,0,,0,0,,0,0,0
21462,James Michael McAdoo,24-069,F,3/14/17,GSW,,PHI,W,0,8,0,2,0,0,2,0,0,0,,0,2,0,3,0,3
21463,James Michael McAdoo,23-322,F,11/21/16,GSW,@,IND,W,0,8,0,4,0,0,4,0,0,0,,0,0,,1,0,1
21464,James Michael McAdoo,23-353,F,12/22/16,GSW,@,BRK,W,0,3,0,1,0,0,1,0,0,0,,0,0,,0,0,0
21465,James Michael McAdoo,23-348,F,12/17/16,GSW,,POR,W,0,9,0,1,0,0,0,,0,1,0,0,0,,0,1,1
21466,James Michael McAdoo,24-040,F,2/13/17,GSW,@,DEN,L,0,14,0,1,0,0,1,0,0,0,,0,0,,0,1,1
21467,James Michael McAdoo,24-063,F,3/8/17,GSW,,BOS,L,0,5,0,0,,0,0,,0,0,,0,0,,1,0,1
21468,James Michael McAdoo,23-310,F,11/9/16,GSW,,DAL,W,0,4,0,1,0,0,0,,0,1,0,0,0,,0,1,1
21469,James Michael McAdoo,23-346,F,12/15/16,GSW,,NYK,W,0,3,0,0,,0,0,,0,0,,0,0,,0,1,1
21470,James Michael McAdoo,24-061,F,3/6/17,GSW,@,ATL,W,0,3,0,0,,0,0,,0,0,,0,0,,0,0,0
21471,James Michael McAdoo,23-305,F,11/4/16,GSW,@,LAL,L,0,4,0,0,,0,0,,0,0,,0,0,,0,0,0
21472,James Michael McAdoo,24-018,F,1/22/17,GSW,@,ORL,W,0,4,0,0,,0,0,,0,0,,0,0,,0,0,0
21473,James Michael McAdoo,24-060,F,3/5/17,GSW,@,NYK,W,0,3,0,1,0,0,1,0,0,0,,0,0,,1,1,2
21474,James Michael McAdoo,23-304,F,11/3/16,GSW,,OKC,W,0,7,0,2,0,0,2,0,0,0,,0,0,,0,0,0
21475,James Michael McAdoo,23-338,F,12/7/16,GSW,@,LAC,W,0,3,0,1,0,0,1,0,0,0,,0,2,0,0,2,2
21476,Patrick McCaw,21-079,G,1/12/17,GSW,,DET,W,0,4,0,0,,0,0,,0,0,,0,0,,0,0,0
21477,Patrick McCaw,21-037,G,12/1/16,GSW,,HOU,L,0,9,0,0,,0,0,,0,0,,0,0,,0,1,1
21478,Patrick McCaw,21-049,G,12/13/16,GSW,@,NOP,W,0,2,0,0,,0,0,,0,0,,0,0,,1,0,1
21479,Patrick McCaw,21-073,G,1/6/17,GSW,,MEM,L,0,3,0,1,0,0,0,,0,1,0,0,0,,0,0,0
21480,Patrick McCaw,21-109,G,2/11/17,GSW,@,OKC,W,0,2,0,0,,0,0,,0,0,,0,0,,0,0,0
21481,Patrick McCaw,21-047,G,12/11/16,GSW,@,MIN,W,0,7,0,0,,0,0,,0,0,,0,0,,0,0,0
21482,Patrick McCaw,21-071,G,1/4/17,GSW,,POR,W,0,1,0,0,,0,0,,0,0,,0,0,,1,0,1
21483,Patrick McCaw,21-108,G,2/10/17,GSW,@,MEM,W,0,8,0,0,,0,0,,0,0,,0,0,,0,0,0
21484,Patrick McCaw,21-029,G,11/23/16,GSW,,LAL,W,0,15,0,1,0,0,1,0,0,0,,0,2,0,0,1,1
21485,Patrick McCaw,21-061,G,12/25/16,GSW,@,CLE,L,0,0,0,0,,0,0,,0,0,,0,0,,0,0,0
21486,Patrick McCaw,21-102,G,2/4/17,GSW,@,SAC,L,0,9,0,2,0,0,0,,0,2,0,0,0,,0,1,1
21487,Patrick McCaw,21-043,G,12/7/16,GSW,@,LAC,W,0,8,0,2,0,0,0,,0,2,0,0,0,,0,0,0
21488,Patrick McCaw,21-056,G,12/20/16,GSW,,UTA,W,0,11,0,1,0,0,1,0,0,0,,0,0,,0,0,0
21489,Patrick McCaw,21-053,G,12/17/16,GSW,,POR,W,0,16,0,4,0,0,2,0,0,2,0,0,0,,1,1,2
21490,Sheldon McClellan,24-057,G,2/16/17,WAS,@,IND,W,0,1,0,0,,0,0,,0,0,,0,0,,0,0,0
21491,Sheldon McClellan,24-041,G,1/31/17,WAS,,NYK,W,0,2,0,1,0,0,1,0,0,0,,0,0,,0,0,0
21492,Sheldon McClellan,23-341,G,11/26/16,WAS,,SAS,L,0,1,0,0,,0,0,,0,0,,0,0,,0,0,0
21493,Sheldon McClellan,24-020,G,1/10/17,WAS,,CHI,W,0,7,0,0,,0,0,,0,0,,0,0,,0,1,1
21494,Sheldon McClellan,24-034,G,1/24/17,WAS,,BOS,W,0,1,0,0,,0,0,,0,0,,0,0,,0,0,0
21495,Sheldon McClellan,24-016,G,1/6/17,WAS,,MIN,W,0,11,0,1,0,0,1,0,0,0,,0,0,,1,0,1
21496,Sheldon McClellan,24-033,G,1/23/17,WAS,@,CHO,W,0,13,0,3,0,0,1,0,0,2,0,0,0,,0,2,2
21497,Sheldon McClellan,24-082,G,3/13/17,WAS,@,MIN,L,0,1,0,0,,0,0,,0,0,,0,0,,0,0,0
21498,Sheldon McClellan,24-013,G,1/3/17,WAS,@,DAL,L,0,6,0,1,0,0,0,,0,1,0,0,0,,0,1,1
21499,Sheldon McClellan,24-031,G,1/21/17,WAS,@,DET,L,0,5,0,1,0,0,1,0,0,0,,0,0,,0,2,2
21500,Sheldon McClellan,24-070,G,3/1/17,WAS,@,TOR,W,0,2,0,0,,0,0,,0,0,,0,0,,0,0,0
21501,Sheldon McClellan,24-082,G,3/13/17,WAS,@,MIN,L,0,1,0,0,,0,0,,0,0,,0,0,,0,0,0
21502,Sheldon McClellan,24-013,G,1/3/17,WAS,@,DAL,L,0,6,0,1,0,0,0,,0,1,0,0,0,,0,1,1
21503,Sheldon McClellan,24-031,G,1/21/17,WAS,@,DET,L,0,5,0,1,0,0,1,0,0,0,,0,0,,0,2,2
21504,Sheldon McClellan,24-070,G,3/1/17,WAS,@,TOR,W,0,2,0,0,,0,0,,0,0,,0,0,,0,0,0
21505,T.J. McConnell,24-245,G,11/25/16,PHI,,CHI,L,0,12,0,2,0,0,2,0,0,0,,0,0,,0,1,1
21506,T.J. McConnell,24-349,G,3/9/17,PHI,@,POR,L,1,31,0,8,0,0,7,0,0,1,0,0,0,,2,1,3
21507,T.J. McConnell,24-243,G,11/23/16,PHI,,MEM,L,0,8,0,0,,0,0,,0,0,,0,0,,0,3,3
21508,T.J. McConnell,24-227,G,11/7/16,PHI,,UTA,L,0,20,0,2,0,0,2,0,0,0,,0,0,,0,2,2
21509,T.J. McConnell,24-255,G,12/5/16,PHI,,DEN,L,0,15,0,1,0,0,1,0,0,0,,0,0,,0,2,2
21510,T.J. McConnell,24-215,G,10/26/16,PHI,,OKC,L,0,16,0,0,,0,0,,0,0,,0,0,,0,2,2
21511,Chris McCullough,21-278,F,11/9/16,BRK,@,NYK,L,0,3,0,2,0,0,2,0,0,0,,0,0,,1,0,1
21512,Chris McCullough,21-269,F,10/31/16,BRK,,CHI,L,0,10,0,2,0,0,1,0,0,1,0,0,0,,1,2,3
21513,Chris McCullough,21-300,F,12/1/16,BRK,,MIL,L,0,3,0,1,0,0,1,0,0,0,,0,0,,0,0,0
21514,Chris McCullough,21-296,F,11/27/16,BRK,,SAC,L,0,4,0,1,0,0,0,,0,1,0,0,0,,0,1,1
21515,Chris McCullough,22-008,F,2/13/17,BRK,,MEM,L,0,1,0,0,,0,0,,0,0,,0,0,,0,0,0
21516,Chris McCullough,21-292,F,11/23/16,BRK,,BOS,L,0,2,0,1,0,0,1,0,0,0,,0,0,,0,1,1
21517,K.J. McDaniels,23-325,G-F,12/30/16,HOU,,LAC,W,0,2,0,0,,0,0,,0,0,,0,0,,0,0,0
21518,K.J. McDaniels,24-033,G-F,3/14/17,BRK,,OKC,L,0,2,0,0,,0,0,,0,0,,0,0,,0,0,0
21519,K.J. McDaniels,23-282,G-F,11/17/16,HOU,,POR,W,0,5,0,0,,0,0,,0,0,,0,0,,0,1,1
21520,K.J. McDaniels,23-357,G-F,1/31/17,HOU,,SAC,W,0,4,0,1,0,0,1,0,0,0,,0,0,,0,1,1
21521,K.J. McDaniels,23-355,G-F,1/29/17,HOU,@,IND,L,0,3,0,0,,0,0,,0,0,,0,0,,0,0,0
21522,K.J. McDaniels,23-277,G-F,11/12/16,HOU,,SAS,L,0,10,0,3,0,0,1,0,0,2,0,0,0,,0,2,2
21523,K.J. McDaniels,23-316,G-F,12/21/16,HOU,@,PHO,W,0,2,0,1,0,0,1,0,0,0,,0,0,,0,0,0
21524,K.J. McDaniels,23-347,G-F,1/21/17,HOU,@,MEM,W,0,1,0,0,,0,0,,0,0,,0,0,,0,1,1
21525,K.J. McDaniels,23-274,G-F,11/9/16,HOU,@,SAS,W,0,5,0,0,,0,0,,0,0,,0,0,,0,0,0
21526,K.J. McDaniels,23-346,G-F,1/20/17,HOU,,GSW,L,0,3,0,0,,0,0,,0,0,,0,0,,0,0,0
21527,K.J. McDaniels,24-023,G-F,3/4/17,BRK,@,POR,L,0,5,0,0,,0,0,,0,0,,0,0,,0,0,0
21528,K.J. McDaniels,23-305,G-F,12/10/16,HOU,,DAL,W,0,1,0,0,,0,0,,0,0,,0,0,,0,0,0
21529,K.J. McDaniels,23-302,G-F,12/7/16,HOU,,LAL,W,0,7,0,4,0,0,3,0,0,1,0,0,0,,0,2,2
21530,K.J. McDaniels,24-016,G-F,2/25/17,BRK,@,GSW,L,0,2,0,0,,0,0,,0,0,,0,0,,0,0,0
21531,K.J. McDaniels,23-337,G-F,1/11/17,HOU,@,MIN,L,0,1,0,1,0,0,1,0,0,0,,0,0,,0,0,0
21532,Doug McDermott,25-076,F,3/20/17,OKC,,GSW,L,0,14,0,2,0,0,1,0,0,1,0,0,0,,0,0,0
21533,Doug McDermott,25-067,F,3/11/17,OKC,,UTA,W,0,5,0,0,,0,0,,0,0,,0,0,,0,0,0
21534,JaVale McGee,28-351,C,1/4/17,GSW,,POR,W,0,2,0,1,0,0,1,0,0,0,,0,0,,0,0,0
21535,JaVale McGee,28-314,C,11/28/16,GSW,,ATL,W,0,5,0,1,0,0,1,0,0,0,,0,0,,2,0,2
21536,JaVale McGee,28-290,C,11/4/16,GSW,@,LAL,L,0,4,0,2,0,0,2,0,0,0,,0,0,,0,0,0
21537,JaVale McGee,28-311,C,11/25/16,GSW,@,LAL,W,0,6,0,0,,0,0,,0,0,,0,0,,0,2,2
21538,Rodney McGruder,25-190,G,2/4/17,MIA,,PHI,W,1,15,0,2,0,0,1,0,0,1,0,0,2,0,0,0,0
21539,Rodney McGruder,25-134,G,12/10/16,MIA,@,CHI,L,1,25,0,2,0,0,2,0,0,0,,0,0,,0,1,1
21540,Rodney McGruder,25-153,G,12/29/16,MIA,@,CHO,L,0,14,0,0,,0,0,,0,0,,0,0,,0,1,1
21541,Rodney McGruder,25-095,G,11/1/16,MIA,,SAC,W,0,14,0,0,,0,0,,0,0,,0,0,,1,0,1
21542,Rodney McGruder,25-093,G,10/30/16,MIA,,SAS,L,0,16,0,2,0,0,1,0,0,1,0,0,0,,0,0,0
21543,Ben McLemore,23-334,G,1/10/17,SAC,,DET,W,0,2,0,0,,0,0,,0,0,,0,0,,0,0,0
21544,Ben McLemore,23-288,G,11/25/16,SAC,,HOU,L,0,4,0,0,,0,0,,0,0,,0,0,,0,0,0
21545,Ben McLemore,23-328,G,1/4/17,SAC,,MIA,L,1,6,0,3,0,0,2,0,0,1,0,0,0,,0,0,0
21546,Ben McLemore,23-283,G,11/20/16,SAC,,TOR,W,0,3,0,2,0,0,2,0,0,0,,0,0,,0,0,0
21547,Ben McLemore,23-305,G,12/12/16,SAC,,LAL,W,1,4,0,0,,0,0,,0,0,,0,0,,0,0,0
21548,Ben McLemore,23-342,G,1/18/17,SAC,,IND,L,0,4,0,0,,0,0,,0,0,,0,0,,1,0,1
21549,Ben McLemore,23-337,G,1/13/17,SAC,,CLE,L,0,1,0,1,0,0,1,0,0,0,,0,0,,0,0,0
21550,Jordan McRae,25-232,G,11/15/16,CLE,,TOR,W,0,10,0,1,0,0,1,0,0,0,,0,0,,0,1,1
21551,Jordan McRae,25-257,G,12/10/16,CLE,,CHO,W,0,1,0,1,0,0,0,,0,1,0,0,0,,0,0,0
21552,Jordan McRae,25-305,G,1/27/17,CLE,,BRK,W,0,10,0,0,,0,0,,0,0,,0,0,,0,0,0
21553,Jordan McRae,25-324,G,2/15/17,CLE,,IND,W,0,3,0,1,0,0,1,0,0,0,,0,0,,0,0,0
21554,Jordan McRae,25-297,G,1/19/17,CLE,,PHO,W,0,2,0,0,,0,0,,0,0,,0,0,,0,0,0
21555,Jordan McRae,25-320,G,2/11/17,CLE,,DEN,W,0,1,0,0,,0,0,,0,0,,0,0,,0,0,0
21556,Jordan McRae,25-228,G,11/11/16,CLE,@,WAS,W,0,1,0,0,,0,0,,0,0,,0,0,,0,0,0
21557,Jordan McRae,25-220,G,11/3/16,CLE,,BOS,W,0,1,0,0,,0,0,,0,0,,0,0,,0,0,0
21558,Jordan McRae,25-291,G,1/13/17,CLE,@,SAC,W,0,1,0,0,,0,0,,0,0,,0,0,,0,0,0
21559,Jordan McRae,25-264,G,12/17/16,CLE,,LAL,W,0,1,0,0,,0,0,,0,0,,0,0,,0,0,0
21560,Jordan McRae,25-288,G,1/10/17,CLE,@,UTA,L,0,0,0,0,,0,0,,0,0,,0,0,,0,0,0
21561,Jordan McRae,25-307,G,1/29/17,CLE,,OKC,W,0,2,0,0,,0,0,,0,0,,0,0,,0,1,1
21562,Josh McRoberts,29-261,F,11/15/16,MIA,,ATL,L,0,9,0,3,0,0,3,0,0,0,,0,0,,1,4,5
21563,Josh McRoberts,29-260,F,11/14/16,MIA,@,SAS,L,0,14,0,6,0,0,5,0,0,1,0,0,0,,0,3,3
21564,Jodie Meeks,29-138,G,1/6/17,ORL,,HOU,L,0,14,0,2,0,0,0,,0,2,0,0,0,,0,1,1
21565,Jodie Meeks,29-115,G,12/14/16,ORL,,LAC,L,0,13,0,3,0,0,1,0,0,2,0,0,0,,0,2,2
21566,Salah Mejri,30-265,C,3/7/17,DAL,,LAL,W,0,3,0,0,,0,0,,0,0,,0,0,,0,1,1
21567,Salah Mejri,30-157,C,11/19/16,DAL,@,ORL,L,0,2,0,0,,0,0,,0,0,,0,0,,0,0,0
21568,Salah Mejri,30-228,C,1/29/17,DAL,@,SAS,W,0,8,0,0,,0,0,,0,0,,0,0,,0,0,0
21569,Salah Mejri,30-156,C,11/18/16,DAL,,MEM,L,0,11,0,1,0,0,1,0,0,0,,0,2,0,1,2,3
21570,Salah Mejri,30-173,C,12/5/16,DAL,,CHO,L,0,8,0,0,,0,0,,0,0,,0,0,,0,1,1
21571,Salah Mejri,30-206,C,1/7/17,DAL,,ATL,L,0,2,0,0,,0,0,,0,0,,0,0,,0,1,1
21572,Salah Mejri,30-279,C,3/21/17,DAL,,GSW,L,0,8,0,3,0,0,3,0,0,0,,0,0,,2,0,2
21573,Salah Mejri,30-171,C,12/3/16,DAL,,CHI,W,0,3,0,2,0,0,0,,0,2,0,0,0,,1,1,2
21574,Salah Mejri,30-186,C,12/18/16,DAL,,SAC,W,1,23,0,0,,0,0,,0,0,,0,0,,1,6,7
21575,Salah Mejri,30-202,C,1/3/17,DAL,,WAS,W,0,4,0,0,,0,0,,0,0,,0,0,,0,1,1
21576,Salah Mejri,30-198,C,12/30/16,DAL,@,GSW,L,0,3,0,0,,0,0,,0,0,,0,0,,1,1,2
21577,Salah Mejri,30-219,C,1/20/17,DAL,,UTA,L,0,12,0,1,0,0,1,0,0,0,,0,0,,1,1,2
21578,Salah Mejri,30-257,C,2/27/17,DAL,,MIA,W,0,3,0,1,0,0,1,0,0,0,,0,0,,3,1,4
21579,Salah Mejri,30-168,C,11/30/16,DAL,,SAS,L,0,6,0,0,,0,0,,0,0,,0,0,,0,1,1
21580,Salah Mejri,30-255,C,2/25/17,DAL,,NOP,W,0,6,0,0,,0,0,,0,0,,0,0,,0,0,0
21581,Salah Mejri,30-163,C,11/25/16,DAL,@,CLE,L,0,6,0,1,0,0,1,0,0,0,,0,0,,0,1,1
21582,Salah Mejri,30-195,C,12/27/16,DAL,,HOU,L,0,5,0,0,,0,0,,0,0,,0,0,,2,2,4
21583,Salah Mejri,30-140,C,11/2/16,DAL,@,UTA,L,0,5,0,0,,0,0,,0,0,,0,0,,0,1,1
21584,Salah Mejri,30-178,C,12/10/16,DAL,@,HOU,L,1,12,0,1,0,0,1,0,0,0,,0,0,,1,2,3
21585,Salah Mejri,30-194,C,12/26/16,DAL,@,NOP,L,0,16,0,0,,0,0,,0,0,,0,0,,0,5,5
21586,Salah Mejri,30-229,C,1/30/17,DAL,,CLE,W,0,2,0,0,,0,0,,0,0,,0,0,,0,0,0
21587,Salah Mejri,30-245,C,2/15/17,DAL,@,DET,L,0,5,0,0,,0,0,,0,0,,0,0,,0,0,0
21588,Jordan Mickey,22-116,F,11/2/16,BOS,,CHI,W,0,6,0,1,0,0,1,0,0,0,,0,0,,0,0,0
21589,Jordan Mickey,22-230,F,2/24/17,BOS,@,TOR,L,0,0,0,0,,0,0,,0,0,,0,0,,0,0,0
21590,Jordan Mickey,22-132,F,11/18/16,BOS,,GSW,L,0,3,0,1,0,0,1,0,0,0,,0,0,,0,0,0
21591,Jordan Mickey,22-219,F,2/13/17,BOS,@,DAL,W,0,1,0,0,,0,0,,0,0,,0,0,,0,1,1
21592,Jordan Mickey,22-214,F,2/8/17,BOS,@,SAC,L,0,2,0,0,,0,0,,0,0,,0,0,,0,1,1
21593,Jordan Mickey,22-242,F,3/8/17,BOS,@,GSW,W,0,1,0,0,,0,0,,0,0,,0,0,,0,1,1
21594,Jordan Mickey,22-199,F,1/24/17,BOS,@,WAS,L,0,6,0,1,0,0,1,0,0,0,,0,0,,1,1,2
21595,Jordan Mickey,22-240,F,3/6/17,BOS,@,LAC,L,0,3,0,0,,0,0,,0,0,,0,0,,0,0,0
21596,Jordan Mickey,22-239,F,3/5/17,BOS,@,PHO,L,0,9,0,2,0,0,2,0,0,0,,0,0,,1,2,3
21597,Jordan Mickey,22-237,F,3/3/17,BOS,@,LAL,W,0,3,0,0,,0,0,,0,0,,0,0,,0,0,0
21598,C.J. Miles,29-286,G-F,1/29/17,IND,,HOU,W,1,20,0,5,0,0,0,,0,5,0,0,0,,0,2,2
21599,C.J. Miles,29-214,G-F,11/18/16,IND,,PHO,L,1,9,0,2,0,0,2,0,0,0,,0,0,,0,0,0
21600,C.J. Miles,29-236,G-F,12/10/16,IND,,POR,W,0,14,0,3,0,0,1,0,0,2,0,0,0,,0,2,2
21601,C.J. Miles,29-214,G-F,11/18/16,IND,,PHO,L,1,9,0,2,0,0,2,0,0,0,,0,0,,0,0,0
21602,Mike Miller,36-353,F-G,2/6/17,DEN,,DAL,W,0,2,0,0,,0,0,,0,0,,0,0,,0,0,0
21603,Mike Miller,36-351,F-G,2/4/17,DEN,@,SAS,L,0,6,0,0,,0,0,,0,0,,0,0,,0,1,1
21604,Mike Miller,36-263,F-G,11/8/16,DEN,@,MEM,L,0,0,0,0,,0,0,,0,0,,0,0,,0,0,0
21605,Mike Miller,36-348,F-G,2/1/17,DEN,,MEM,L,0,8,0,1,0,0,0,,0,1,0,0,0,,0,2,2
21606,Mike Miller,36-260,F-G,11/5/16,DEN,@,DET,L,0,4,0,0,,0,0,,0,0,,0,0,,0,1,1
21607,Mike Miller,37-009,F-G,2/28/17,DEN,@,CHI,W,0,2,0,0,,0,0,,0,0,,0,0,,0,0,0
21608,Mike Miller,37-005,F-G,2/24/17,DEN,,BRK,W,0,3,0,0,,0,0,,0,0,,0,0,,0,1,1
21609,Mike Miller,37-004,F-G,2/23/17,DEN,@,SAC,L,0,2,0,0,,0,0,,0,0,,0,0,,0,0,0
21610,Mike Miller,36-328,F-G,1/12/17,DEN,,IND,W,0,3,0,1,0,0,0,,0,1,0,0,0,,0,1,1
21611,Mike Miller,36-321,F-G,1/5/17,DEN,,SAS,L,0,4,0,0,,0,0,,0,0,,0,0,,0,1,1
21612,Mike Miller,36-358,F-G,2/11/17,DEN,@,CLE,L,0,12,0,2,0,0,0,,0,2,0,0,0,,0,2,2
21613,Mike Miller,36-287,F-G,12/2/16,DEN,,HOU,L,0,4,0,0,,0,0,,0,0,,0,0,,0,2,2
21614,Patty Mills,28-179,G,2/6/17,SAS,@,MEM,L,0,15,0,4,0,0,3,0,0,1,0,0,0,,0,0,0
21615,Patty Mills,28-152,G,1/10/17,SAS,,MIL,L,0,15,0,3,0,0,2,0,0,1,0,0,0,,0,2,2
21616,Nikola Mirotic,25-296,F,12/3/16,CHI,@,DAL,L,1,13,0,4,0,0,2,0,0,2,0,0,0,,0,5,5
21617,Nikola Mirotic,25-268,F,11/5/16,CHI,@,IND,L,0,13,0,6,0,0,2,0,0,4,0,0,0,,0,0,0
21618,E'Twaun Moore,27-336,G,1/29/17,NOP,,WAS,L,0,22,0,3,0,0,1,0,0,2,0,0,0,,0,1,1
21619,E'Twaun Moore,27-273,G,11/27/16,NOP,@,DAL,L,1,22,0,4,0,0,3,0,0,1,0,0,0,,2,3,5
21620,Anthony Morrow,31-095,G,12/31/16,OKC,,LAC,W,0,5,0,2,0,0,1,0,0,1,0,0,0,,0,0,0
21621,Anthony Morrow,31-132,G,2/6/17,OKC,@,IND,L,0,14,0,3,0,0,0,,0,3,0,0,0,,0,2,2
21622,Anthony Morrow,31-037,G,11/3/16,OKC,@,GSW,L,0,9,0,2,0,0,0,,0,2,0,0,0,,0,0,0
21623,Anthony Morrow,31-154,G,2/28/17,CHI,,DEN,L,0,4,0,0,,0,0,,0,0,,0,0,,0,0,0
21624,Anthony Morrow,31-052,G,11/18/16,OKC,,BRK,W,0,0,0,0,,0,0,,0,0,,0,0,,0,0,0
21625,Anthony Morrow,31-113,G,1/18/17,OKC,@,GSW,L,0,4,0,1,0,0,0,,0,1,0,0,0,,0,0,0
21626,Anthony Morrow,31-050,G,11/16/16,OKC,,HOU,W,0,1,0,1,0,0,1,0,0,0,,0,0,,0,0,0
21627,Donatas Motiejunas,26-175,F-C,3/14/17,NOP,,POR,W,0,2,0,0,,0,0,,0,0,,0,0,,0,1,1
21628,Donatas Motiejunas,26-169,F-C,3/8/17,NOP,,TOR,L,0,6,0,3,0,0,2,0,0,1,0,0,0,,3,2,5
21629,Donatas Motiejunas,26-167,F-C,3/6/17,NOP,@,UTA,L,0,4,0,0,,0,0,,0,0,,0,0,,0,0,0
21630,Donatas Motiejunas,26-139,F-C,2/6/17,NOP,,PHO,W,0,6,0,1,0,0,1,0,0,0,,0,0,,0,1,1
21631,Donatas Motiejunas,26-162,F-C,3/1/17,NOP,,DET,W,0,6,0,2,0,0,1,0,0,1,0,0,0,,1,4,5
21632,Donatas Motiejunas,26-137,F-C,2/4/17,NOP,@,WAS,L,0,5,0,1,0,0,0,,0,1,0,0,0,,0,0,0
21633,Donatas Motiejunas,26-134,F-C,2/1/17,NOP,@,DET,L,0,12,0,0,,0,0,,0,0,,0,0,,0,3,3
21634,Donatas Motiejunas,26-118,F-C,1/16/17,NOP,@,IND,L,0,8,0,2,0,0,1,0,0,1,0,0,0,,0,1,1
21635,Donatas Motiejunas,26-182,F-C,3/21/17,NOP,,MEM,W,0,5,0,1,0,0,1,0,0,0,,0,0,,0,0,0
21636,Timofey Mozgov,30-157,C,12/20/16,LAL,@,CHO,L,1,11,0,2,0,0,2,0,0,0,,0,0,,4,2,6
21637,Timofey Mozgov,30-125,C,11/18/16,LAL,,SAS,L,1,14,0,3,0,0,3,0,0,0,,0,0,,3,1,4
21638,Timofey Mozgov,30-201,C,2/2/17,LAL,@,WAS,L,1,17,0,1,0,0,1,0,0,0,,0,0,,0,1,1
21639,Timofey Mozgov,30-166,C,12/29/16,LAL,,DAL,L,1,16,0,3,0,0,3,0,0,0,,0,0,,1,3,4
21640,Timofey Mozgov,30-180,C,1/12/17,LAL,@,SAS,L,1,10,0,4,0,0,4,0,0,0,,0,0,,3,1,4
21641,Timofey Mozgov,30-193,C,1/25/17,LAL,@,POR,L,1,14,0,3,0,0,3,0,0,0,,0,0,,2,3,5
21642,Emmanuel Mudiay,21-008,G,3/13/17,DEN,,LAL,W,0,3,0,0,,0,0,,0,0,,0,0,,0,0,0
21643,Emmanuel Mudiay,20-308,G,1/7/17,DEN,@,OKC,L,1,26,0,9,0,0,5,0,0,4,0,0,0,,1,0,1
21644,Emmanuel Mudiay,20-290,G,12/20/16,DEN,@,LAC,L,1,26,0,9,0,0,4,0,0,5,0,0,0,,2,3,5
21645,Shabazz Muhammad,24-063,F-G,1/15/17,MIN,@,DAL,L,0,12,0,6,0,0,5,0,0,1,0,0,0,,0,1,1
21646,Shabazz Muhammad,24-012,F-G,11/25/16,MIN,@,PHO,W,0,7,0,3,0,0,2,0,0,1,0,0,0,,1,3,4
21647,Dejounte Murray,20-146,G,2/12/17,SAS,@,NYK,L,0,0,0,0,,0,0,,0,0,,0,0,,0,0,0
21648,Dejounte Murray,20-056,G,11/14/16,SAS,,MIA,W,0,0,0,0,,0,0,,0,0,,0,0,,0,0,0
21649,Dejounte Murray,20-140,G,2/6/17,SAS,@,MEM,L,0,3,0,1,0,0,0,,0,1,0,0,0,,0,0,0
21650,Dejounte Murray,20-053,G,11/11/16,SAS,,DET,W,0,1,0,0,,0,0,,0,0,,0,0,,0,0,0
21651,Dejounte Murray,20-136,G,2/2/17,SAS,,PHI,W,0,5,0,2,0,0,1,0,0,1,0,0,0,,0,0,0
21652,Dejounte Murray,20-110,G,1/7/17,SAS,,CHO,W,0,4,0,2,0,0,2,0,0,0,,0,0,,0,0,0
21653,Dejounte Murray,20-134,G,1/31/17,SAS,,OKC,W,0,1,0,1,0,0,1,0,0,0,,0,0,,0,0,0
21654,Dejounte Murray,20-043,G,11/1/16,SAS,,UTA,L,0,1,0,0,,0,0,,0,0,,0,0,,0,0,0
21655,Dejounte Murray,20-068,G,11/26/16,SAS,@,WAS,W,0,1,0,0,,0,0,,0,0,,0,2,0,0,0,0
21656,Dejounte Murray,20-130,G,1/27/17,SAS,@,NOP,L,0,2,0,2,0,0,2,0,0,0,,0,0,,0,0,0
21657,Dejounte Murray,20-160,G,2/26/17,SAS,@,LAL,W,0,11,0,2,0,0,2,0,0,0,,0,0,,0,0,0
21658,Dejounte Murray,20-040,G,10/29/16,SAS,,NOP,W,0,9,0,2,0,0,1,0,0,1,0,0,2,0,0,2,2
21659,Dejounte Murray,20-158,G,2/24/17,SAS,@,LAC,W,0,0,0,0,,0,0,,0,0,,0,0,,0,0,0
21660,Dejounte Murray,20-060,G,11/18/16,SAS,@,LAL,W,0,0,0,0,,0,0,,0,0,,0,0,,0,0,0
21661,Dejounte Murray,20-058,G,11/16/16,SAS,@,SAC,W,0,3,0,2,0,0,2,0,0,0,,0,0,,0,1,1
21662,Jamal Murray,20-000,G,2/23/17,DEN,@,SAC,L,0,19,0,6,0,0,3,0,0,3,0,0,0,,0,2,2
21663,Jamal Murray,19-311,G,12/30/16,DEN,,PHI,L,0,12,0,2,0,0,0,,0,2,0,0,0,,0,1,1
21664,Jamal Murray,19-328,G,1/16/17,DEN,,ORL,W,0,5,0,0,,0,0,,0,0,,0,0,,0,0,0
21665,Jamal Murray,19-254,G,11/3/16,DEN,@,MIN,W,1,29,0,8,0,0,4,0,0,4,0,0,0,,0,3,3
21666,Jamal Murray,19-284,G,12/3/16,DEN,@,UTA,L,0,18,0,4,0,0,3,0,0,1,0,0,0,,0,4,4
21667,Jamal Murray,19-249,G,10/29/16,DEN,,POR,L,0,12,0,2,0,0,2,0,0,0,,0,0,,0,1,1
21668,Mike Muscala,25-152,F-C,11/30/16,ATL,@,PHO,L,1,29,0,5,0,0,5,0,0,0,,0,0,,0,3,3
21669,Mike Muscala,25-198,F-C,1/15/17,ATL,,MIL,W,0,1,0,1,0,0,1,0,0,0,,0,0,,0,0,0
21670,Mike Muscala,25-224,F-C,2/10/17,ATL,@,SAC,L,0,11,0,0,,0,0,,0,0,,0,0,,0,1,1
21671,Mike Muscala,25-196,F-C,1/13/17,ATL,,BOS,L,0,18,0,7,0,0,5,0,0,2,0,0,0,,5,1,6
21672,Mike Muscala,25-255,F-C,3/13/17,ATL,@,SAS,L,0,3,0,0,,0,0,,0,0,,0,0,,1,2,3
21673,Mike Muscala,25-253,F-C,3/11/17,ATL,@,MEM,W,0,16,0,1,0,0,1,0,0,0,,0,0,,0,2,2
21674,Mike Muscala,25-241,F-C,2/27/17,ATL,@,BOS,W,0,6,0,1,0,0,0,,0,1,0,0,0,,0,1,1
21675,Mike Muscala,25-171,F-C,12/19/16,ATL,@,OKC,W,0,11,0,2,0,0,2,0,0,0,,0,0,,0,1,1
21676,Mike Muscala,25-239,F-C,2/25/17,ATL,@,ORL,L,0,3,0,0,,0,0,,0,0,,0,0,,0,0,0
21677,Shabazz Napier,25-191,G,1/21/17,POR,@,BOS,W,0,0,0,0,,0,0,,0,0,,0,0,,0,0,0
21678,Shabazz Napier,25-250,G,3/21/17,POR,,MIL,L,0,3,0,1,0,0,1,0,0,0,,0,0,,0,0,0
21679,Shabazz Napier,25-139,G,11/30/16,POR,,IND,W,0,2,0,0,,0,0,,0,0,,0,0,,0,0,0
21680,Shabazz Napier,25-188,G,1/18/17,POR,@,CHO,L,0,4,0,1,0,0,0,,0,1,0,0,0,,0,1,1
21681,Shabazz Napier,25-247,G,3/18/17,POR,@,ATL,W,0,3,0,1,0,0,1,0,0,0,,0,0,,0,0,0
21682,Shabazz Napier,25-136,G,11/27/16,POR,,HOU,L,0,5,0,2,0,0,0,,0,2,0,0,0,,0,1,1
21683,Shabazz Napier,25-229,G,2/28/17,POR,@,DET,L,0,13,0,2,0,0,1,0,0,1,0,0,0,,0,4,4
21684,Shabazz Napier,25-110,G,11/1/16,POR,,GSW,L,0,10,0,1,0,0,0,,0,1,0,0,0,,0,0,0
21685,Shabazz Napier,25-181,G,1/11/17,POR,,CLE,W,0,4,0,2,0,0,1,0,0,1,0,0,0,,0,0,0
21686,Shabazz Napier,25-107,G,10/29/16,POR,@,DEN,W,0,0,0,0,,0,0,,0,0,,0,0,,0,0,0
21687,Shabazz Napier,25-105,G,10/27/16,POR,,LAC,L,0,1,0,0,,0,0,,0,0,,0,0,,0,0,0
21688,Shabazz Napier,25-240,G,3/11/17,POR,,WAS,L,0,14,0,1,0,0,1,0,0,0,,0,0,,0,0,0
21689,Shabazz Napier,25-126,G,11/17/16,POR,@,HOU,L,0,6,0,4,0,0,0,,0,4,0,0,0,,0,1,1
21690,Shabazz Napier,25-154,G,12/15/16,POR,@,DEN,L,0,1,0,0,,0,0,,0,0,,0,0,,0,0,0
21691,Shabazz Napier,25-201,G,1/31/17,POR,,CHO,W,0,4,0,1,0,0,1,0,0,0,,0,0,,0,0,0
21692,Shabazz Napier,25-151,G,12/12/16,POR,@,LAC,L,0,0,0,0,,0,0,,0,0,,0,0,,0,0,0
21693,Maurice Ndour,24-205,F,1/9/17,NYK,,NOP,L,0,15,0,1,0,0,0,,0,1,0,0,0,,1,2,3
21694,Maurice Ndour,24-254,F,2/27/17,NYK,,TOR,L,0,4,0,0,,0,0,,0,0,,0,0,,0,0,0
21695,Maurice Ndour,24-250,F,2/23/17,NYK,@,CLE,L,0,2,0,0,,0,0,,0,0,,0,0,,0,0,0
21696,Maurice Ndour,24-237,F,2/10/17,NYK,,DEN,L,0,3,0,2,0,0,2,0,0,0,,0,0,,1,1,2
21697,Maurice Ndour,24-139,F,11/4/16,NYK,@,CHI,W,0,7,0,1,0,0,1,0,0,0,,0,0,,1,1,2
21698,Maurice Ndour,24-172,F,12/7/16,NYK,,CLE,L,0,10,0,2,0,0,2,0,0,0,,0,0,,0,1,1
21699,Maurice Ndour,24-233,F,2/6/17,NYK,,LAL,L,0,1,0,0,,0,0,,0,0,,0,0,,0,0,0
21700,Maurice Ndour,24-165,F,11/30/16,NYK,@,MIN,W,0,4,0,0,,0,0,,0,0,,0,0,,0,0,0
21701,Maurice Ndour,24-237,F,2/10/17,NYK,,DEN,L,0,3,0,2,0,0,2,0,0,0,,0,0,,1,1,2
21702,Gary Neal,32-109,G,1/20/17,ATL,,CHI,W,0,6,0,3,0,0,2,0,0,1,0,0,0,,0,0,0
21703,Jameer Nelson,34-312,G,12/17/16,DEN,,NYK,W,0,16,0,3,0,0,2,0,0,1,0,0,0,,0,0,0
21704,Jameer Nelson,34-358,G,2/1/17,DEN,,MEM,L,1,4,0,1,0,0,1,0,0,0,,0,0,,0,1,1
21705,Jameer Nelson,34-275,G,11/10/16,DEN,,GSW,L,0,16,0,4,0,0,2,0,0,2,0,0,0,,1,2,3
21706,Jameer Nelson,34-288,G,11/23/16,DEN,@,UTA,L,0,18,0,4,0,0,1,0,0,3,0,0,0,,0,1,1
21707,Raul Neto,24-240,G,1/14/17,UTA,,ORL,W,0,7,0,0,,0,0,,0,0,,0,0,,0,1,1
21708,Raul Neto,24-179,G,11/14/16,UTA,,MEM,L,0,2,0,1,0,0,0,,0,1,0,0,0,,0,1,1
21709,Raul Neto,24-209,G,12/14/16,UTA,,OKC,W,0,2,0,0,,0,0,,0,0,,0,0,,0,0,0
21710,Raul Neto,24-305,G,3/20/17,UTA,@,IND,L,0,6,0,2,0,0,2,0,0,0,,0,0,,0,0,0
21711,Raul Neto,24-172,G,11/7/16,UTA,@,PHI,W,0,2,0,1,0,0,1,0,0,0,,0,0,,0,0,0
21712,Raul Neto,24-265,G,2/8/17,UTA,@,NOP,W,0,3,0,0,,0,0,,0,0,,0,0,,0,0,0
21713,Raul Neto,24-300,G,3/15/17,UTA,@,DET,W,0,7,0,2,0,0,2,0,0,0,,0,0,,0,0,0
21714,Raul Neto,24-167,G,11/2/16,UTA,,DAL,W,0,1,0,0,,0,0,,0,0,,0,0,,0,0,0
21715,Raul Neto,24-263,G,2/6/17,UTA,@,ATL,W,0,1,0,0,,0,0,,0,0,,0,0,,0,0,0
21716,Raul Neto,24-164,G,10/30/16,UTA,@,LAC,L,0,4,0,0,,0,0,,0,0,,0,0,,0,1,1
21717,Raul Neto,24-201,G,12/6/16,UTA,,PHO,W,0,2,0,1,0,0,1,0,0,0,,0,0,,0,0,0
21718,Raul Neto,24-224,G,12/29/16,UTA,,PHI,W,0,1,0,0,,0,0,,0,0,,0,0,,0,0,0
21719,Raul Neto,24-250,G,1/24/17,UTA,@,DEN,L,0,4,0,1,0,0,1,0,0,0,,0,0,,0,0,0
21720,Raul Neto,24-247,G,1/21/17,UTA,,IND,W,0,12,0,3,0,0,1,0,0,2,0,0,0,,0,0,0
21721,Raul Neto,24-218,G,12/23/16,UTA,,TOR,L,0,17,0,0,,0,0,,0,0,,0,0,,0,1,1
21722,Raul Neto,24-246,G,1/20/17,UTA,@,DAL,W,0,14,0,2,0,0,1,0,0,1,0,0,0,,0,0,0
21723,Raul Neto,24-288,G,3/3/17,UTA,,BRK,W,0,2,0,0,,0,0,,0,0,,0,0,,0,0,0
21724,Georges Niang,23-157,F,11/21/16,IND,,GSW,L,0,7,0,6,0,0,4,0,0,2,0,0,0,,0,1,1
21725,Georges Niang,23-133,F,10/28/16,IND,@,BRK,L,0,2,0,0,,0,0,,0,0,,0,0,,0,1,1
21726,Georges Niang,23-156,F,11/20/16,IND,@,OKC,W,0,2,0,1,0,0,1,0,0,0,,0,0,,0,0,0
21727,Georges Niang,23-204,F,1/7/17,IND,,NYK,W,0,1,0,0,,0,0,,0,0,,0,0,,0,0,0
21728,Georges Niang,23-198,F,1/1/17,IND,,ORL,W,0,1,0,1,0,0,1,0,0,0,,0,0,,0,0,0
21729,Georges Niang,23-152,F,11/16/16,IND,,CLE,W,0,1,0,1,0,0,0,,0,1,0,0,0,,0,1,1
21730,Georges Niang,23-183,F,12/17/16,IND,@,DET,W,0,3,0,0,,0,0,,0,0,,0,0,,0,1,1
21731,Georges Niang,23-150,F,11/14/16,IND,,ORL,W,0,2,0,1,0,0,1,0,0,0,,0,0,,0,2,2
21732,Georges Niang,23-166,F,11/30/16,IND,@,POR,L,0,3,0,0,,0,0,,0,0,,0,0,,0,0,0
21733,Georges Niang,23-143,F,11/7/16,IND,@,CHO,L,0,9,0,2,0,0,2,0,0,0,,0,0,,1,3,4
21734,Georges Niang,23-163,F,11/27/16,IND,,LAC,W,0,2,0,1,0,0,0,,0,1,0,0,0,,0,0,0
21735,Georges Niang,23-141,F,11/5/16,IND,,CHI,W,0,3,0,1,0,0,0,,0,1,0,0,0,,0,0,0
21736,Georges Niang,23-218,F,1/21/17,IND,@,UTA,L,0,1,0,0,,0,0,,0,0,,0,0,,0,0,0
21737,Georges Niang,23-139,F,11/3/16,IND,@,MIL,L,0,2,0,1,0,0,1,0,0,0,,0,0,,0,0,0
21738,Andrew Nicholson,26-332,F,11/4/16,WAS,,ATL,W,0,7,0,2,0,0,2,0,0,0,,0,2,0,0,0,0
21739,Andrew Nicholson,27-067,F,2/13/17,WAS,,OKC,W,0,3,0,1,0,0,1,0,0,0,,0,0,,0,0,0
21740,Andrew Nicholson,27-008,F,12/16/16,WAS,,DET,W,0,5,0,0,,0,0,,0,0,,0,0,,0,0,0
21741,Andrew Nicholson,27-050,F,1/27/17,WAS,@,ATL,W,0,5,0,2,0,0,2,0,0,0,,0,0,,0,0,0
21742,Andrew Nicholson,27-006,F,12/14/16,WAS,,CHO,W,0,5,0,2,0,0,2,0,0,0,,0,0,,0,0,0
21743,Andrew Nicholson,27-101,F,3/19/17,BRK,,DAL,L,0,12,0,1,0,0,1,0,0,0,,0,0,,0,4,4
21744,Andrew Nicholson,27-000,F,12/8/16,WAS,,DEN,W,0,6,0,2,0,0,2,0,0,0,,0,0,,0,0,0
21745,Andrew Nicholson,27-022,F,12/30/16,WAS,,BRK,W,0,5,0,1,0,0,0,,0,1,0,0,0,,0,1,1
21746,Andrew Nicholson,26-337,F,11/9/16,WAS,,BOS,W,0,5,0,0,,0,0,,0,0,,0,0,,0,2,2
21747,Andrew Nicholson,26-363,F,12/5/16,WAS,@,BRK,W,0,7,0,2,0,0,1,0,0,1,0,0,0,,0,0,0
21748,Andrew Nicholson,27-015,F,12/23/16,WAS,@,MIL,L,0,8,0,1,0,0,0,,0,1,0,0,0,,1,2,3
21749,Joakim Noah,31-263,C,11/14/16,NYK,,DAL,W,1,15,0,2,0,0,2,0,0,0,,0,0,,4,2,6
21750,Joakim Noah,31-337,C,1/27/17,NYK,,CHO,W,1,12,0,1,0,0,1,0,0,0,,0,0,,1,1,2
21751,Joakim Noah,31-243,C,10/25/16,NYK,@,CLE,L,1,20,0,1,0,0,1,0,0,0,,0,0,,1,5,6
21752,Joakim Noah,31-331,C,1/21/17,NYK,,PHO,L,1,20,0,4,0,0,4,0,0,0,,0,0,,7,8,15
21753,Joakim Noah,31-275,C,11/26/16,NYK,@,CHO,L,1,12,0,0,,0,0,,0,0,,0,0,,0,3,3
21754,Joakim Noah,31-309,C,12/30/16,NYK,@,NOP,L,1,16,0,3,0,0,3,0,0,0,,0,0,,3,3,6
21755,Joakim Noah,31-341,C,1/31/17,NYK,@,WAS,L,1,15,0,1,0,0,1,0,0,0,,0,0,,2,2,4
21756,Joakim Noah,31-251,C,11/2/16,NYK,,HOU,L,1,18,0,2,0,0,2,0,0,0,,0,2,0,1,1,2
21757,Nerlens Noel,22-343,C-F,3/19/17,DAL,@,BRK,W,0,21,0,0,,0,0,,0,0,,0,0,,0,4,4
21758,Lucas Nogueira,24-236,C,3/19/17,TOR,,IND,W,0,5,0,2,0,0,1,0,0,1,0,0,0,,0,2,2
21759,Lucas Nogueira,24-113,C,11/16/16,TOR,,GSW,L,0,13,0,0,,0,0,,0,0,,0,0,,0,5,5
21760,Lucas Nogueira,24-233,C,3/16/17,TOR,,OKC,L,0,6,0,0,,0,0,,0,0,,0,0,,0,0,0
21761,Lucas Nogueira,24-112,C,11/15/16,TOR,@,CLE,L,0,10,0,0,,0,0,,0,0,,0,0,,1,3,4
21762,Lucas Nogueira,24-230,C,3/13/17,TOR,,DAL,W,0,4,0,0,,0,0,,0,0,,0,0,,0,2,2
21763,Lucas Nogueira,24-216,C,2/27/17,TOR,@,NYK,W,0,0,0,0,,0,0,,0,0,,0,0,,0,0,0
21764,Lucas Nogueira,24-161,C,1/3/17,TOR,@,SAS,L,0,22,0,5,0,0,4,0,0,1,0,0,0,,1,2,3
21765,Lucas Nogueira,24-215,C,2/26/17,TOR,,POR,W,0,10,0,0,,0,0,,0,0,,0,0,,0,2,2
21766,Lucas Nogueira,24-122,C,11/25/16,TOR,@,MIL,W,0,16,0,1,0,0,1,0,0,0,,0,0,,0,1,1
21767,Lucas Nogueira,24-213,C,2/24/17,TOR,,BOS,W,0,11,0,0,,0,0,,0,0,,0,0,,0,1,1
21768,Lucas Nogueira,24-136,C,12/9/16,TOR,@,BOS,W,0,22,0,0,,0,0,,0,0,,0,0,,2,6,8
21769,Lucas Nogueira,24-156,C,12/29/16,TOR,@,PHO,L,0,22,0,0,,0,0,,0,0,,0,0,,1,0,1
21770,Lucas Nogueira,24-204,C,2/15/17,TOR,,CHO,W,0,16,0,0,,0,0,,0,0,,0,0,,0,4,4
21771,Lucas Nogueira,24-155,C,12/28/16,TOR,@,GSW,L,0,17,0,1,0,0,0,,0,1,0,0,0,,3,2,5
21772,Lucas Nogueira,24-117,C,11/20/16,TOR,@,SAC,L,0,11,0,1,0,0,1,0,0,0,,0,0,,0,0,0
21773,Steve Novak,33-198,F,12/28/16,MIL,@,DET,W,0,3,0,1,0,0,0,,0,1,0,0,0,,0,1,1
21774,Steve Novak,33-193,F,12/23/16,MIL,,WAS,W,0,4,0,1,0,0,0,,0,1,0,0,0,,0,0,0
21775,Steve Novak,33-191,F,12/21/16,MIL,@,CLE,L,0,3,0,0,,0,0,,0,0,,0,0,,0,1,1
21776,Steve Novak,33-186,F,12/16/16,MIL,@,CHI,W,0,3,0,1,0,0,0,,0,1,0,0,0,,0,0,0
21777,Steve Novak,33-169,F,11/29/16,MIL,,CLE,W,0,2,0,1,0,0,0,,0,1,0,0,0,,0,1,1
21778,Steve Novak,33-145,F,11/5/16,MIL,,SAC,W,0,4,0,1,0,0,0,,0,1,0,0,0,,0,0,0
21779,Jusuf Nurkic,22-085,C,11/16/16,DEN,,PHO,W,1,15,0,4,0,0,4,0,0,0,,0,0,,2,4,6
21780,Jusuf Nurkic,22-081,C,11/12/16,DEN,,DET,L,1,17,0,2,0,0,2,0,0,0,,0,0,,2,0,2
21781,David Nwaba,24-050,PG,3/5/17,LAL,,NOP,L,0,9,0,0,,0,0,,0,0,,0,0,,0,1,1
21782,David Nwaba,24-045,PG,2/28/17,LAL,,CHO,L,0,5,0,1,0,0,1,0,0,0,,0,0,,0,1,1
21783,Johnny O'Bryant,23-252,F-C,2/8/17,DEN,@,ATL,L,0,0,0,0,,0,0,,0,0,,0,0,,0,0,0
21784,Johnny O'Bryant,23-280,F-C,3/8/17,CHO,@,MIA,L,0,4,0,1,0,0,1,0,0,0,,0,0,,0,0,0
21785,Johnny O'Bryant,23-259,F-C,2/15/17,DEN,,MIN,L,0,5,0,1,0,0,1,0,0,0,,0,0,,2,1,3
21786,Kyle O'Quinn,26-312,F-C,2/1/17,NYK,@,BRK,W,0,6,0,2,0,0,2,0,0,0,,0,0,,2,0,2
21787,Kyle O'Quinn,26-282,F-C,1/2/17,NYK,,ORL,L,0,17,0,3,0,0,3,0,0,0,,0,0,,3,6,9
21788,Kyle O'Quinn,26-305,F-C,1/25/17,NYK,@,DAL,L,0,6,0,1,0,0,1,0,0,0,,0,0,,2,0,2
21789,Kyle O'Quinn,26-301,F-C,1/21/17,NYK,,PHO,L,0,5,0,1,0,0,1,0,0,0,,0,0,,0,1,1
21790,Kyle O'Quinn,26-220,F-C,11/1/16,NYK,@,DET,L,0,11,0,1,0,0,1,0,0,0,,0,0,,0,2,2
21791,Kyle O'Quinn,26-359,F-C,3/20/17,NYK,@,LAC,L,0,3,0,0,,0,0,,0,0,,0,0,,0,1,1
21792,Kyle O'Quinn,26-266,F-C,12/17/16,NYK,@,DEN,L,0,7,0,1,0,0,0,,0,1,0,0,0,,0,0,0
21793,Daniel Ochefu,23-032,C,1/16/17,WAS,,POR,W,0,3,0,1,0,0,1,0,0,0,,0,0,,0,3,3
21794,Daniel Ochefu,22-317,C,10/27/16,WAS,@,ATL,L,0,4,0,2,0,0,2,0,0,0,,0,0,,0,1,1
21795,Daniel Ochefu,23-076,C,3/1/17,WAS,@,TOR,W,0,2,0,0,,0,0,,0,0,,0,0,,0,0,0
21796,Daniel Ochefu,23-004,C,12/19/16,WAS,@,IND,L,0,5,0,1,0,0,1,0,0,0,,0,0,,0,1,1
21797,Daniel Ochefu,23-073,C,2/26/17,WAS,,UTA,L,0,1,0,1,0,0,1,0,0,0,,0,0,,0,0,0
21798,Daniel Ochefu,23-003,C,12/18/16,WAS,,LAC,W,0,9,0,1,0,0,1,0,0,0,,0,0,,1,0,1
21799,Daniel Ochefu,23-047,C,1/31/17,WAS,,NYK,W,0,2,0,1,0,0,1,0,0,0,,0,0,,0,0,0
21800,Daniel Ochefu,23-001,C,12/16/16,WAS,,DET,W,0,1,0,0,,0,0,,0,0,,0,0,,0,0,0
21801,Daniel Ochefu,23-004,C,12/19/16,WAS,@,IND,L,0,5,0,1,0,0,1,0,0,0,,0,0,,0,1,1
21802,Daniel Ochefu,23-073,C,2/26/17,WAS,,UTA,L,0,1,0,1,0,0,1,0,0,0,,0,0,,0,0,0
21803,Jahlil Okafor,20-332,C-F,11/11/16,PHI,,IND,W,0,3,0,2,0,0,2,0,0,0,,0,0,,0,1,1
21804,Victor Oladipo,24-221,G,12/11/16,OKC,,BOS,W,1,10,0,2,0,0,2,0,0,0,,0,0,,0,3,3
21805,Kelly Olynyk,25-213,C-F,11/18/16,BOS,,GSW,L,1,17,0,5,0,0,3,0,0,2,0,0,0,,1,2,3
21806,Kelly Olynyk,25-325,C-F,3/10/17,BOS,@,DEN,L,0,11,0,2,0,0,1,0,0,1,0,0,0,,0,2,2
21807,Kelly Olynyk,25-248,C-F,12/23/16,BOS,,OKC,L,0,13,0,1,0,0,0,,0,1,0,0,0,,0,1,1
21808,Kelly Olynyk,25-320,C-F,3/5/17,BOS,@,PHO,L,0,22,0,5,0,0,3,0,0,2,0,0,0,,1,3,4
21809,Arinze Onuaku,29-172,C,1/1/17,ORL,@,IND,L,0,4,0,0,,0,0,,0,0,,0,0,,1,0,1
21810,Arinze Onuaku,29-158,C,12/18/16,ORL,,TOR,L,0,7,0,2,0,0,2,0,0,0,,0,0,,0,3,3
21811,Arinze Onuaku,29-153,C,12/13/16,ORL,@,ATL,W,0,2,0,0,,0,0,,0,0,,0,0,,0,0,0
21812,Arinze Onuaku,29-124,C,11/14/16,ORL,@,IND,L,0,4,0,0,,0,0,,0,0,,0,0,,0,0,0
21813,Arinze Onuaku,29-117,C,11/7/16,ORL,@,CHI,L,0,6,0,0,,0,0,,0,0,,0,0,,0,1,1
21814,Arinze Onuaku,29-175,C,1/4/17,ORL,,ATL,L,0,2,0,0,,0,0,,0,0,,0,0,,0,0,0
21815,Chinanu Onuaku,20-071,F-C,1/11/17,HOU,@,MIN,L,0,1,0,0,,0,0,,0,0,,0,0,,0,0,0
21816,Kelly Oubre,21-092,F,3/11/17,WAS,@,POR,W,0,10,0,0,,0,0,,0,0,,0,0,,0,1,1
21817,Kelly Oubre,21-024,F,1/2/17,WAS,@,HOU,L,0,23,0,4,0,0,3,0,0,1,0,0,0,,1,6,7
21818,Kelly Oubre,20-336,F,11/9/16,WAS,,BOS,W,0,3,0,0,,0,0,,0,0,,0,0,,0,2,2
21819,Kelly Oubre,20-352,F,11/25/16,WAS,@,ORL,W,0,15,0,3,0,0,1,0,0,2,0,0,0,,2,1,3
21820,Kelly Oubre,21-033,F,1/11/17,WAS,@,BOS,L,0,13,0,2,0,0,2,0,0,0,,0,0,,0,2,2
21821,Kelly Oubre,20-329,F,11/2/16,WAS,,TOR,L,0,7,0,0,,0,0,,0,0,,0,0,,0,0,0
21822,Kelly Oubre,21-086,F,3/5/17,WAS,,ORL,W,0,6,0,1,0,0,1,0,0,0,,0,0,,0,2,2
21823,Kelly Oubre,21-061,F,2/8/17,WAS,@,BRK,W,1,33,0,5,0,0,2,0,0,3,0,0,2,0,1,2,3
21824,Zaza Pachulia,32-268,C,11/4/16,GSW,@,LAL,L,1,19,0,0,,0,0,,0,0,,0,0,,2,1,3
21825,Georgios Papagiannis,19-220,C,2/8/17,SAC,,BOS,W,0,1,0,0,,0,0,,0,0,,0,0,,0,0,0
21826,Georgios Papagiannis,19-181,C,12/31/16,SAC,,MEM,L,0,3,0,0,,0,0,,0,0,,0,0,,0,0,0
21827,Georgios Papagiannis,19-255,C,3/15/17,SAC,@,PHO,W,0,13,0,2,0,0,2,0,0,0,,0,0,,0,3,3
21828,Georgios Papagiannis,19-239,C,2/27/17,SAC,,MIN,L,0,2,0,0,,0,0,,0,0,,0,0,,0,0,0
21829,Georgios Papagiannis,19-237,C,2/25/17,SAC,,CHO,L,0,5,0,0,,0,0,,0,0,,0,0,,0,0,0
21830,Tony Parker,34-271,G,2/12/17,SAS,@,NYK,L,1,31,0,3,0,0,2,0,0,1,0,0,0,,0,1,1
21831,Chandler Parsons,28-062,F,12/26/16,MEM,@,ORL,L,1,12,0,4,0,0,2,0,0,2,0,0,0,,0,1,1
21832,Chandler Parsons,28-012,F,11/6/16,MEM,,POR,L,1,22,0,8,0,0,5,0,0,3,0,0,0,,1,2,3
21833,Chandler Parsons,28-124,F,2/26/17,MEM,@,DEN,W,1,21,0,3,0,0,1,0,0,2,0,0,0,,0,4,4
21834,Lamar Patterson,25-196,G-F,2/24/17,ATL,,MIA,L,0,10,0,3,0,0,2,0,0,1,0,0,0,,0,1,1
21835,Lamar Patterson,25-176,G-F,2/4/17,ATL,,ORL,W,0,5,0,0,,0,0,,0,0,,0,0,,0,0,0
21836,Patrick Patterson,27-302,F,1/10/17,TOR,,BOS,W,1,21,0,3,0,0,1,0,0,2,0,0,0,,0,2,2
21837,Patrick Patterson,27-326,F,2/3/17,TOR,@,ORL,L,1,7,0,1,0,0,0,,0,1,0,0,0,,0,0,0
21838,Patrick Patterson,27-290,F,12/29/16,TOR,@,PHO,L,0,9,0,3,0,0,1,0,0,2,0,0,0,,0,0,0
21839,Patrick Patterson,27-352,F,3/1/17,TOR,,WAS,L,0,21,0,6,0,0,2,0,0,4,0,0,0,,0,4,4
21840,Adreian Payne,25-348,F-C,2/1/17,MIN,@,CLE,L,0,3,0,1,0,0,1,0,0,0,,0,0,,0,1,1
21841,Adreian Payne,25-344,F-C,1/28/17,MIN,,BRK,W,0,2,0,0,,0,0,,0,0,,0,0,,0,1,1
21842,Adreian Payne,25-264,F-C,11/9/16,MIN,@,ORL,W,0,1,0,1,0,0,0,,0,1,0,0,0,,0,1,1
21843,Adreian Payne,25-310,F-C,12/25/16,MIN,@,OKC,L,0,4,0,1,0,0,1,0,0,0,,0,0,,0,1,1
21844,Cameron Payne,22-217,G,3/13/17,CHI,@,CHO,W,0,11,0,6,0,0,2,0,0,4,0,0,0,,0,2,2
21845,Cameron Payne,22-191,G,2/15/17,OKC,,NYK,W,0,12,0,6,0,0,3,0,0,3,0,0,0,,0,2,2
21846,Cameron Payne,22-187,G,2/11/17,OKC,,GSW,L,0,9,0,2,0,0,2,0,0,0,,0,0,,0,1,1
21847,Cameron Payne,22-154,G,1/9/17,OKC,@,CHI,W,0,15,0,6,0,0,5,0,0,1,0,0,0,,0,4,4
21848,Cameron Payne,22-181,G,2/5/17,OKC,,POR,W,0,15,0,6,0,0,4,0,0,2,0,0,0,,0,0,0
21849,Paul Pierce,39-159,F-G,3/21/17,LAC,@,LAL,W,0,7,0,0,,0,0,,0,0,,0,0,,0,2,2
21850,Paul Pierce,39-070,F-G,12/22/16,LAC,,SAS,W,1,10,0,3,0,0,1,0,0,2,0,0,0,,0,0,0
21851,Paul Pierce,39-058,F-G,12/10/16,LAC,,NOP,W,0,4,0,0,,0,0,,0,0,,0,0,,0,0,0
21852,Paul Pierce,39-052,F-G,12/4/16,LAC,,IND,L,0,8,0,2,0,0,1,0,0,1,0,0,0,,0,1,1
21853,Marshall Plumlee,24-154,C,12/15/16,NYK,@,GSW,L,0,2,0,0,,0,0,,0,0,,0,0,,0,0,0
21854,Marshall Plumlee,24-240,C,3/11/17,NYK,@,DET,L,0,2,0,0,,0,0,,0,0,,0,0,,0,1,1
21855,Marshall Plumlee,24-232,C,3/3/17,NYK,@,PHI,L,0,3,0,2,0,0,2,0,0,0,,0,0,,1,0,1
21856,Marshall Plumlee,24-129,C,11/20/16,NYK,,ATL,W,0,5,0,0,,0,0,,0,0,,0,0,,0,1,1
21857,Marshall Plumlee,24-209,C,2/8/17,NYK,,LAC,L,0,0,0,0,,0,0,,0,0,,0,0,,0,0,0
21858,Marshall Plumlee,24-207,C,2/6/17,NYK,,LAL,L,0,2,0,0,,0,0,,0,0,,0,0,,0,0,0
21859,Marshall Plumlee,24-201,C,1/31/17,NYK,@,WAS,L,0,5,0,0,,0,0,,0,0,,0,0,,1,0,1
21860,Marshall Plumlee,24-189,C,1/19/17,NYK,,WAS,L,0,11,0,1,0,0,1,0,0,0,,0,0,,3,0,3
21861,Miles Plumlee,28-120,C-F,12/30/16,MIL,@,MIN,L,0,3,0,0,,0,0,,0,0,,0,0,,0,0,0
21862,Miles Plumlee,28-087,C-F,11/27/16,MIL,@,ORL,W,0,3,0,1,0,0,1,0,0,0,,0,0,,0,0,0
21863,Miles Plumlee,28-139,C-F,1/18/17,MIL,@,HOU,L,0,3,0,1,0,0,1,0,0,0,,0,0,,0,1,1
21864,Miles Plumlee,28-163,C-F,2/11/17,CHO,,LAC,L,0,12,0,1,0,0,1,0,0,0,,0,0,,0,2,2
21865,Miles Plumlee,28-137,C-F,1/16/17,MIL,,PHI,L,0,1,0,0,,0,0,,0,0,,0,0,,0,1,1
21866,Miles Plumlee,28-106,C-F,12/16/16,MIL,@,CHI,W,0,5,0,1,0,0,1,0,0,0,,0,0,,1,0,1
21867,Miles Plumlee,28-136,C-F,1/15/17,MIL,@,ATL,L,0,6,0,0,,0,0,,0,0,,0,0,,0,1,1
21868,Miles Plumlee,28-102,C-F,12/12/16,MIL,@,TOR,L,0,3,0,0,,0,0,,0,0,,0,0,,0,0,0
21869,Miles Plumlee,28-055,C-F,10/26/16,MIL,,CHO,L,1,8,0,2,0,0,2,0,0,0,,0,0,,0,1,1
21870,Miles Plumlee,28-091,C-F,12/1/16,MIL,@,BRK,W,0,3,0,1,0,0,1,0,0,0,,0,0,,0,0,0
21871,Miles Plumlee,28-125,C-F,1/4/17,MIL,@,NYK,W,0,4,0,2,0,0,2,0,0,0,,0,0,,0,1,1
21872,Miles Plumlee,28-070,C-F,11/10/16,MIL,,NOP,L,1,11,0,3,0,0,3,0,0,0,,0,0,,0,0,0
21873,Miles Plumlee,28-089,C-F,11/29/16,MIL,,CLE,W,0,2,0,0,,0,0,,0,0,,0,0,,0,0,0
21874,Jakob Poeltl,21-048,C,12/2/16,TOR,,LAL,W,0,6,0,1,0,0,1,0,0,0,,0,0,,0,2,2
21875,Jakob Poeltl,21-082,C,1/5/17,TOR,,UTA,W,0,6,0,0,,0,0,,0,0,,0,0,,0,1,1
21876,Jakob Poeltl,21-135,C,2/27/17,TOR,@,NYK,W,0,1,0,0,,0,0,,0,0,,0,0,,0,0,0
21877,Jakob Poeltl,21-153,C,3/17/17,TOR,@,DET,W,0,13,0,2,0,0,2,0,0,0,,0,0,,3,3,6
21878,Jakob Poeltl,21-097,C,1/20/17,TOR,@,CHO,L,0,9,0,0,,0,0,,0,0,,0,0,,1,3,4
21879,Jakob Poeltl,21-134,C,2/26/17,TOR,,POR,W,0,6,0,1,0,0,1,0,0,0,,0,2,0,1,0,1
21880,Jakob Poeltl,21-095,C,1/18/17,TOR,@,PHI,L,0,4,0,0,,0,0,,0,0,,0,0,,0,1,1
21881,Jakob Poeltl,21-066,C,12/20/16,TOR,,BRK,W,0,5,0,1,0,0,1,0,0,0,,0,2,0,1,1,2
21882,Jakob Poeltl,21-064,C,12/18/16,TOR,@,ORL,W,0,5,0,1,0,0,1,0,0,0,,0,2,0,1,1,2
21883,Jakob Poeltl,21-092,C,1/15/17,TOR,,NYK,W,0,4,0,1,0,0,1,0,0,0,,0,0,,0,0,0
21884,Jakob Poeltl,21-060,C,12/14/16,TOR,@,PHI,W,0,7,0,1,0,0,1,0,0,0,,0,0,,0,0,0
21885,Jakob Poeltl,21-018,C,11/2/16,TOR,@,WAS,W,0,17,0,0,,0,0,,0,0,,0,0,,1,4,5
21886,Jakob Poeltl,21-140,C,3/4/17,TOR,@,MIL,L,0,2,0,0,,0,0,,0,0,,0,0,,0,0,0
21887,Jakob Poeltl,21-157,C,3/21/17,TOR,,CHI,W,0,13,0,0,,0,0,,0,0,,0,0,,3,2,5
21888,Jakob Poeltl,21-084,C,1/7/17,TOR,@,CHI,L,0,1,0,0,,0,0,,0,0,,0,0,,0,1,1
21889,Jakob Poeltl,21-113,C,2/5/17,TOR,@,BRK,W,0,7,0,1,0,0,1,0,0,0,,0,0,,0,0,0
21890,Otto Porter,23-271,F,3/1/17,WAS,@,TOR,W,1,19,0,4,0,0,2,0,0,2,0,0,0,,0,3,3
21891,Bobby Portis,21-273,F,11/9/16,CHI,@,ATL,L,0,14,0,3,0,0,3,0,0,0,,0,0,,0,2,2
21892,Bobby Portis,21-325,F,12/31/16,CHI,,MIL,L,0,2,0,0,,0,0,,0,0,,0,0,,0,0,0
21893,Bobby Portis,21-286,F,11/22/16,CHI,@,DEN,L,0,8,0,3,0,0,2,0,0,1,0,0,0,,0,1,1
21894,Bobby Portis,21-319,F,12/25/16,CHI,@,SAS,L,0,2,0,0,,0,0,,0,0,,0,0,,0,1,1
21895,Bobby Portis,21-342,F,1/17/17,CHI,,DAL,L,0,7,0,1,0,0,1,0,0,0,,0,0,,0,1,1
21896,Bobby Portis,21-313,F,12/19/16,CHI,,DET,W,0,7,0,2,0,0,2,0,0,0,,0,0,,0,1,1
21897,Bobby Portis,21-268,F,11/4/16,CHI,,NYK,L,0,3,0,1,0,0,1,0,0,0,,0,0,,0,0,0
21898,Bobby Portis,21-362,F,2/6/17,CHI,@,SAC,W,0,6,0,1,0,0,1,0,0,0,,0,0,,0,0,0
21899,Bobby Portis,21-299,F,12/5/16,CHI,,POR,L,0,6,0,0,,0,0,,0,0,,0,0,,0,1,1
21900,Dwight Powell,25-098,F-C,10/26/16,DAL,@,IND,L,0,16,0,2,0,0,2,0,0,0,,0,2,0,3,4,7
21901,Dwight Powell,25-098,F-C,10/26/16,DAL,@,IND,L,0,16,0,2,0,0,2,0,0,0,,0,2,0,3,4,7
21902,Dwight Powell,25-219,F-C,2/24/17,DAL,@,MIN,L,0,7,0,3,0,0,2,0,0,1,0,0,0,,1,1,2
21903,Dwight Powell,25-179,F-C,1/15/17,DAL,,MIN,W,0,17,0,2,0,0,1,0,0,1,0,0,0,,0,3,3
21904,Dwight Powell,25-210,F-C,2/15/17,DAL,@,DET,L,0,0,0,0,,0,0,,0,0,,0,0,,0,0,0
21905,Dwight Powell,25-208,F-C,2/13/17,DAL,,BOS,L,0,17,0,1,0,0,1,0,0,0,,0,0,,1,2,3
21906,Dwight Powell,25-109,F-C,11/6/16,DAL,,MIL,W,0,10,0,1,0,0,0,,0,1,0,0,0,,1,2,3
21907,Dwight Powell,25-204,F-C,2/9/17,DAL,,UTA,W,0,7,0,1,0,0,1,0,0,0,,0,0,,0,0,0
21908,Dwight Powell,25-228,F-C,3/5/17,DAL,,OKC,W,0,3,0,1,0,0,0,,0,1,0,0,0,,0,1,1
21909,Dwight Powell,25-202,F-C,2/7/17,DAL,,POR,L,0,12,0,0,,0,0,,0,0,,0,0,,0,2,2
21910,Norman Powell,23-225,G,1/5/17,TOR,,UTA,W,0,8,0,4,0,0,4,0,0,0,,0,0,,1,1,2
21911,Norman Powell,23-237,G,1/17/17,TOR,@,BRK,W,0,18,0,2,0,0,2,0,0,0,,0,0,,0,2,2
21912,Norman Powell,23-259,G,2/8/17,TOR,@,MIN,L,0,7,0,0,,0,0,,0,0,,0,0,,0,0,0
21913,Norman Powell,23-197,G,12/8/16,TOR,,MIN,W,0,7,0,0,,0,0,,0,0,,0,0,,1,0,1
21914,Norman Powell,23-154,G,10/26/16,TOR,,DET,W,0,2,0,2,0,0,0,,0,2,0,0,0,,0,1,1
21915,Norman Powell,23-194,G,12/5/16,TOR,,CLE,L,0,5,0,0,,0,0,,0,0,,0,0,,0,1,1
21916,Ronnie Price,33-267,G,3/15/17,PHO,,SAC,L,0,11,0,2,0,0,1,0,0,1,0,0,0,,0,1,1
21917,Ronnie Price,33-254,G,3/2/17,PHO,,CHO,W,0,1,0,0,,0,0,,0,0,,0,0,,0,0,0
21918,Ronnie Price,33-252,G,2/28/17,PHO,@,MEM,L,0,2,0,0,,0,0,,0,0,,0,0,,0,0,0
21919,Ronnie Price,33-234,G,2/10/17,PHO,,CHI,W,0,2,0,0,,0,0,,0,0,,0,0,,0,0,0
21920,Tim Quarterman,22-047,G,12/13/16,POR,,OKC,W,0,4,0,1,0,0,0,,0,1,0,0,0,,0,1,1
21921,Tim Quarterman,22-029,G,11/25/16,POR,,NOP,W,0,1,0,0,,0,0,,0,0,,0,0,,0,1,1
21922,Tim Quarterman,22-064,G,12/30/16,POR,@,SAS,L,0,3,0,0,,0,0,,0,0,,0,0,,0,1,1
21923,Tim Quarterman,22-057,G,12/23/16,POR,,SAS,L,0,2,0,0,,0,0,,0,0,,0,0,,0,0,0
21924,Tim Quarterman,22-019,G,11/15/16,POR,,CHI,L,0,4,0,0,,0,0,,0,0,,0,0,,0,0,0
21925,Tim Quarterman,22-051,G,12/17/16,POR,@,GSW,L,0,8,0,2,0,0,0,,0,2,0,0,0,,0,1,1
21926,Tim Quarterman,22-049,G,12/15/16,POR,@,DEN,L,0,1,0,0,,0,0,,0,0,,0,0,,0,0,0
21927,Chasson Randle,24-024,G,3/1/17,NYK,@,ORL,W,0,2,0,0,,0,0,,0,0,,0,0,,0,0,0
21928,Chasson Randle,24-039,G,3/16/17,NYK,,BRK,L,0,6,0,0,,0,0,,0,0,,0,0,,0,0,0
21929,Chasson Randle,23-359,G,1/29/17,PHI,@,CHI,L,0,5,0,2,0,0,1,0,0,1,0,0,0,,0,0,0
21930,Willie Reed,26-180,F-C,11/12/16,MIA,,UTA,L,0,2,0,0,,0,0,,0,0,,0,0,,0,1,1
21931,Willie Reed,26-221,F-C,12/23/16,MIA,@,NOP,L,0,12,0,1,0,0,1,0,0,0,,0,0,,1,7,8
21932,Willie Reed,26-178,F-C,11/10/16,MIA,,CHI,L,0,11,0,3,0,0,3,0,0,0,,0,0,,2,2,4
21933,Willie Reed,26-218,F-C,12/20/16,MIA,,ORL,L,0,11,0,2,0,0,1,0,0,1,0,0,0,,1,3,4
21934,Willie Reed,26-172,F-C,11/4/16,MIA,@,TOR,L,0,10,0,1,0,0,1,0,0,0,,0,2,0,1,1,2
21935,Willie Reed,26-214,F-C,12/16/16,MIA,,LAC,L,0,6,0,2,0,0,2,0,0,0,,0,2,0,1,1,2
21936,Willie Reed,26-198,F-C,11/30/16,MIA,@,DEN,W,0,16,0,1,0,0,1,0,0,0,,0,2,0,1,6,7
21937,Willie Reed,26-187,F-C,11/19/16,MIA,@,WAS,W,0,5,0,0,,0,0,,0,0,,0,0,,0,0,0
21938,Josh Richardson,23-162,G,2/24/17,MIA,@,ATL,W,0,13,0,5,0,0,2,0,0,3,0,0,0,,0,0,0
21939,Josh Richardson,23-050,G,11/4/16,MIA,@,TOR,L,0,12,0,4,0,0,2,0,0,2,0,0,0,,0,1,1
21940,Malachi Richardson,20-295,G,10/26/16,SAC,@,PHO,W,0,2,0,1,0,0,1,0,0,0,,0,0,,0,0,0
21941,Malachi Richardson,21-029,G,2/3/17,SAC,,PHO,L,0,9,0,3,0,0,3,0,0,0,,0,0,,0,0,0
21942,Malachi Richardson,21-008,G,1/13/17,SAC,,CLE,L,0,1,0,0,,0,0,,0,0,,0,0,,0,0,0
21943,Malachi Richardson,21-040,G,2/14/17,SAC,@,LAL,W,0,6,0,1,0,0,0,,0,1,0,0,0,,0,1,1
21944,Malachi Richardson,21-025,G,1/30/17,SAC,@,PHI,L,0,6,0,1,0,0,0,,0,1,0,0,0,,0,0,0
21945,Malachi Richardson,20-348,G,12/18/16,SAC,@,DAL,L,0,2,0,0,,0,0,,0,0,,0,0,,0,0,0
21946,Andre Roberson,25-029,G-F,1/2/17,OKC,@,MIL,L,1,19,0,2,0,0,0,,0,2,0,0,0,,0,4,4
21947,Andre Roberson,25-010,G-F,12/14/16,OKC,@,UTA,L,1,32,0,3,0,0,0,,0,3,0,0,0,,1,4,5
21948,Andre Roberson,25-071,G-F,2/13/17,OKC,@,WAS,L,1,16,0,2,0,0,1,0,0,1,0,0,0,,0,0,0
21949,Brian Roberts,31-107,G,3/20/17,CHO,,ATL,W,0,2,0,1,0,0,0,,0,1,0,0,0,,0,0,0
21950,Brian Roberts,31-028,G,12/31/16,CHO,,CLE,L,0,2,0,0,,0,0,,0,0,,0,0,,0,0,0
21951,Brian Roberts,31-066,G,2/7/17,CHO,,BRK,W,0,13,0,1,0,0,0,,0,1,0,0,0,,0,1,1
21952,Brian Roberts,31-100,G,3/13/17,CHO,,CHI,L,0,5,0,1,0,0,1,0,0,0,,0,0,,0,0,0
21953,Brian Roberts,31-006,G,12/9/16,CHO,,ORL,W,0,7,0,1,0,0,1,0,0,0,,0,0,,0,0,0
21954,Brian Roberts,30-361,G,11/28/16,CHO,@,MEM,W,0,4,0,2,0,0,2,0,0,0,,0,0,,0,0,0
21955,Brian Roberts,30-359,G,11/26/16,CHO,,NYK,W,0,6,0,1,0,0,1,0,0,0,,0,0,,0,0,0
21956,Brian Roberts,31-046,G,1/18/17,CHO,,POR,W,0,3,0,0,,0,0,,0,0,,0,0,,0,0,0
21957,Brian Roberts,31-070,G,2/11/17,CHO,,LAC,L,0,6,0,1,0,0,1,0,0,0,,0,0,,1,2,3
21958,Glenn Robinson,23-026,G-F,2/3/17,IND,@,BRK,W,0,15,0,2,0,0,2,0,0,0,,0,0,,1,3,4
21959,Glenn Robinson,22-320,G-F,11/23/16,IND,,ATL,L,0,10,0,2,0,0,0,,0,2,0,0,0,,1,2,3
21960,Glenn Robinson,23-036,G-F,2/13/17,IND,,SAS,L,1,22,0,2,0,0,1,0,0,1,0,0,0,,1,2,3
21961,Glenn Robinson,22-300,G-F,11/3/16,IND,@,MIL,L,0,7,0,0,,0,0,,0,0,,0,0,,0,0,0
21962,Glenn Robinson,23-033,G-F,2/10/17,IND,@,WAS,L,0,12,0,1,0,0,0,,0,1,0,0,0,,0,3,3
21963,Glenn Robinson,22-313,G-F,11/16/16,IND,,CLE,W,0,1,0,0,,0,0,,0,0,,0,0,,0,0,0
21964,Glenn Robinson,22-331,G-F,12/4/16,IND,@,LAC,W,0,14,0,1,0,0,1,0,0,0,,0,0,,0,1,1
21965,Glenn Robinson,23-013,G-F,1/21/17,IND,@,UTA,L,1,14,0,3,0,0,2,0,0,1,0,0,0,,0,0,0
21966,Glenn Robinson,22-292,G-F,10/26/16,IND,,DAL,W,0,10,0,3,0,0,2,0,0,1,0,0,0,,0,0,0
21967,Glenn Robinson,22-311,G-F,11/14/16,IND,,ORL,W,0,2,0,1,0,0,0,,0,1,0,0,0,,0,1,1
21968,Thomas Robinson,25-353,F,3/5/17,LAL,,NOP,L,0,2,0,0,,0,0,,0,0,,0,0,,0,0,0
21969,Thomas Robinson,25-236,F,11/8/16,LAL,,DAL,L,0,2,0,0,,0,0,,0,0,,0,0,,0,0,0
21970,Thomas Robinson,25-234,F,11/6/16,LAL,,PHO,W,0,5,0,1,0,0,1,0,0,0,,0,0,,1,0,1
21971,Thomas Robinson,25-232,F,11/4/16,LAL,,GSW,W,0,1,0,0,,0,0,,0,0,,0,0,,0,0,0
21972,Thomas Robinson,25-292,F,1/3/17,LAL,,MEM,W,0,4,0,2,0,0,2,0,0,0,,0,0,,0,0,0
21973,Thomas Robinson,25-309,F,1/20/17,LAL,,IND,W,0,2,0,0,,0,0,,0,0,,0,0,,0,1,1
21974,Thomas Robinson,25-225,F,10/28/16,LAL,@,UTA,L,0,2,0,1,0,0,1,0,0,0,,0,0,,0,0,0
21975,Thomas Robinson,25-306,F,1/17/17,LAL,,DEN,L,0,0,0,0,,0,0,,0,0,,0,0,,0,0,0
21976,Thomas Robinson,25-251,F,11/23/16,LAL,@,GSW,L,0,12,0,4,0,0,4,0,0,0,,0,0,,0,1,1
21977,Thomas Robinson,25-241,F,11/13/16,LAL,@,MIN,L,0,4,0,1,0,0,1,0,0,0,,0,0,,0,1,1
21978,Thomas Robinson,25-355,F,3/7/17,LAL,@,DAL,L,0,8,0,2,0,0,2,0,0,0,,0,0,,0,6,6
21979,Thomas Robinson,25-261,F,12/3/16,LAL,@,MEM,L,0,12,0,1,0,0,1,0,0,0,,0,0,,1,3,4
21980,Sergio Rodriguez,30-158,G,11/17/16,PHI,@,MIN,L,1,24,0,4,0,0,2,0,0,2,0,0,0,,0,0,0
21981,Sergio Rodriguez,30-281,G,3/20/17,PHI,@,ORL,L,0,19,0,8,0,0,7,0,0,1,0,0,0,,1,2,3
21982,Sergio Rodriguez,30-166,G,11/25/16,PHI,,CHI,L,0,14,0,4,0,0,2,0,0,2,0,0,0,,1,2,3
21983,Rajon Rondo,30-330,G,1/17/17,CHI,,DAL,L,0,23,0,4,0,0,4,0,0,0,,0,0,,0,3,3
21984,Rajon Rondo,30-264,G,11/12/16,CHI,,WAS,W,1,25,0,6,0,0,6,0,0,0,,0,0,,1,6,7
21985,Rajon Rondo,30-345,G,2/1/17,CHI,@,OKC,W,0,17,0,4,0,0,4,0,0,0,,0,0,,0,0,0
21986,Rajon Rondo,30-360,G,2/16/17,CHI,,BOS,W,0,20,0,5,0,0,4,0,0,1,0,0,0,,1,6,7
21987,Rajon Rondo,30-312,G,12/30/16,CHI,@,IND,L,1,11,0,2,0,0,1,0,0,1,0,0,0,,0,1,1
21988,Rajon Rondo,30-334,G,1/21/17,CHI,,SAC,W,0,6,0,0,,0,0,,0,0,,0,0,,0,0,0
21989,Terrence Ross,26-033,F-G,3/10/17,ORL,@,CHO,L,1,28,0,5,0,0,1,0,0,4,0,0,0,,0,1,1
21990,Terrence Ross,25-266,F-G,10/28/16,TOR,,CLE,L,0,14,0,2,0,0,1,0,0,1,0,0,0,,0,2,2
21991,Terry Rozier,22-358,G,3/10/17,BOS,@,DEN,L,0,8,0,2,0,0,1,0,0,1,0,0,0,,1,1,2
21992,Terry Rozier,22-280,G,12/22/16,BOS,@,IND,W,0,7,0,3,0,0,0,,0,3,0,0,0,,0,0,0
21993,Terry Rozier,22-261,G,12/3/16,BOS,@,PHI,W,0,10,0,3,0,0,2,0,0,1,0,0,0,,1,2,3
21994,Terry Rozier,22-278,G,12/20/16,BOS,@,MEM,W,0,7,0,4,0,0,3,0,0,1,0,0,0,,0,1,1
21995,Terry Rozier,22-317,G,1/28/17,BOS,@,MIL,W,0,17,0,4,0,0,1,0,0,3,0,0,0,,0,1,1
21996,Terry Rozier,23-003,G,3/20/17,BOS,,WAS,W,0,12,0,3,0,0,2,0,0,1,0,0,0,,0,1,1
21997,Terry Rozier,22-299,G,1/10/17,BOS,@,TOR,L,0,3,0,1,0,0,0,,0,1,0,0,0,,0,0,0
21998,Terry Rozier,22-351,G,3/3/17,BOS,@,LAL,W,0,12,0,2,0,0,0,,0,2,0,0,0,,1,4,5
21999,Terry Rozier,22-349,G,3/1/17,BOS,,CLE,W,0,10,0,5,0,0,3,0,0,2,0,0,0,,0,5,5
22000,Terry Rozier,23-000,G,3/17/17,BOS,@,BRK,W,0,23,0,8,0,0,4,0,0,4,0,0,0,,2,4,6
22001,Terry Rozier,23-000,G,3/17/17,BOS,@,BRK,W,0,23,0,8,0,0,4,0,0,4,0,0,0,,2,4,6
22002,Terry Rozier,22-295,G,1/6/17,BOS,,PHI,W,0,11,0,1,0,0,1,0,0,0,,0,0,,2,1,3
22003,Ricky Rubio,26-033,G,11/23/16,MIN,@,NOP,L,1,22,0,2,0,0,2,0,0,0,,0,0,,1,0,1
22004,Ricky Rubio,26-090,G,1/19/17,MIN,@,LAC,W,1,17,0,3,0,0,2,0,0,1,0,0,0,,1,3,4
22005,Damjan Rudez,30-262,F,3/6/17,ORL,,NYK,L,0,4,0,1,0,0,0,,0,1,0,0,0,,0,0,0
22006,Damjan Rudez,30-253,F,2/25/17,ORL,,ATL,W,0,3,0,0,,0,0,,0,0,,0,0,,0,0,0
22007,Damjan Rudez,30-149,F,11/13/16,ORL,@,OKC,W,0,10,0,2,0,0,0,,0,2,0,0,0,,0,1,1
22008,Damjan Rudez,30-173,F,12/7/16,ORL,,BOS,L,0,5,0,1,0,0,0,,0,1,0,0,0,,0,1,1
22009,Damjan Rudez,30-192,F,12/26/16,ORL,,MEM,W,0,3,0,2,0,0,1,0,0,1,0,0,0,,0,0,0
22010,Damjan Rudez,30-219,F,1/22/17,ORL,,GSW,L,0,4,0,1,0,0,0,,0,1,0,0,0,,0,0,0
22011,Damjan Rudez,30-243,F,2/15/17,ORL,,SAS,L,0,4,0,0,,0,0,,0,0,,0,0,,0,0,0
22012,Damjan Rudez,30-168,F,12/2/16,ORL,@,PHI,W,0,3,0,1,0,0,0,,0,1,0,0,0,,0,1,1
22013,Damjan Rudez,30-189,F,12/23/16,ORL,,LAL,W,0,8,0,1,0,0,1,0,0,0,,0,0,,0,0,0
22014,Damjan Rudez,30-217,F,1/20/17,ORL,,MIL,W,0,2,0,0,,0,0,,0,0,,0,0,,0,0,0
22015,Damjan Rudez,30-145,F,11/9/16,ORL,,MIN,L,0,3,0,0,,0,0,,0,0,,0,0,,0,0,0
22016,Damjan Rudez,30-165,F,11/29/16,ORL,@,SAS,W,0,2,0,1,0,0,0,,0,1,0,0,0,,0,0,0
22017,Damjan Rudez,30-188,F,12/22/16,ORL,@,NYK,L,0,1,0,0,,0,0,,0,0,,0,0,,0,0,0
22018,Damjan Rudez,30-215,F,1/18/17,ORL,@,NOP,L,0,6,0,2,0,0,0,,0,2,0,0,0,,0,0,0
22019,Damjan Rudez,30-235,F,2/7/17,ORL,@,HOU,L,0,7,0,2,0,0,0,,0,2,0,0,0,,0,0,0
22020,Damjan Rudez,30-143,F,11/7/16,ORL,@,CHI,L,0,10,0,2,0,0,2,0,0,0,,0,0,,0,1,1
22021,Damjan Rudez,30-159,F,11/23/16,ORL,,PHO,L,0,8,0,2,0,0,0,,0,2,0,0,0,,0,1,1
22022,Damjan Rudez,30-232,F,2/4/17,ORL,@,ATL,L,0,6,0,1,0,0,0,,0,1,0,0,0,,0,1,1
22023,Damjan Rudez,30-272,F,3/16/17,ORL,@,GSW,L,0,7,0,1,0,0,0,,0,1,0,0,0,,0,0,0
22024,Damjan Rudez,30-157,F,11/21/16,ORL,@,MIL,L,0,5,0,2,0,0,0,,0,2,0,0,0,,0,0,0
22025,Damjan Rudez,30-213,F,1/16/17,ORL,@,DEN,L,0,0,0,0,,0,0,,0,0,,0,0,,0,0,0
22026,Damjan Rudez,30-227,F,1/30/17,ORL,@,MIN,L,0,10,0,1,0,0,0,,0,1,0,0,0,,0,2,2
22027,Damjan Rudez,30-267,F,3/11/17,ORL,,CLE,L,0,2,0,1,0,0,0,,0,1,0,0,0,,0,0,0
22028,Damjan Rudez,30-155,F,11/19/16,ORL,,DAL,W,0,12,0,1,0,0,0,,0,1,0,0,0,,0,0,0
22029,Damjan Rudez,30-179,F,12/13/16,ORL,@,ATL,W,0,12,0,3,0,0,0,,0,3,0,0,0,,1,0,1
22030,Damjan Rudez,30-205,F,1/8/17,ORL,@,LAL,L,0,1,0,0,,0,0,,0,0,,0,0,,0,0,0
22031,Damjan Rudez,30-201,F,1/4/17,ORL,,ATL,L,0,2,0,1,0,0,0,,0,1,0,0,0,,0,1,1
22032,Brandon Rush,31-121,G-F,11/5/16,MIN,@,OKC,L,0,19,0,6,0,0,1,0,0,5,0,0,0,,0,3,3
22033,Brandon Rush,31-184,G-F,1/7/17,MIN,,UTA,L,0,2,0,0,,0,0,,0,0,,0,0,,0,0,0
22034,Brandon Rush,31-119,G-F,11/3/16,MIN,,DEN,L,0,12,0,1,0,0,1,0,0,0,,0,0,,0,1,1
22035,Brandon Rush,31-157,G-F,12/11/16,MIN,,GSW,L,0,13,0,1,0,0,1,0,0,0,,0,0,,0,4,4
22036,Brandon Rush,31-216,G-F,2/8/17,MIN,,TOR,W,1,20,0,3,0,0,2,0,0,1,0,0,0,,0,1,1
22037,Brandon Rush,31-257,G-F,3/21/17,MIN,,SAS,L,1,18,0,2,0,0,1,0,0,1,0,0,0,,0,1,1
22038,Brandon Rush,31-111,G-F,10/26/16,MIN,@,MEM,L,0,14,0,3,0,0,2,0,0,1,0,0,0,,0,2,2
22039,Brandon Rush,31-142,G-F,11/26/16,MIN,@,GSW,L,0,5,0,1,0,0,0,,0,1,0,0,0,,0,0,0
22040,Brandon Rush,31-233,G-F,2/25/17,MIN,@,HOU,L,1,33,0,5,0,0,2,0,0,3,0,0,0,,0,5,5
22041,Brandon Rush,31-141,G-F,11/25/16,MIN,@,PHO,W,0,5,0,0,,0,0,,0,0,,0,0,,0,0,0
22042,Brandon Rush,31-192,G-F,1/15/17,MIN,@,DAL,L,0,3,0,1,0,0,1,0,0,0,,0,0,,0,0,0
22043,Brandon Rush,31-139,G-F,11/23/16,MIN,@,NOP,L,0,8,0,1,0,0,0,,0,1,0,0,0,,0,0,0
22044,Brandon Rush,31-137,G-F,11/21/16,MIN,,BOS,L,0,2,0,1,0,0,1,0,0,0,,0,0,,0,1,1
22045,D'Angelo Russell,20-332,G,1/20/17,LAL,,IND,W,1,1,0,0,,0,0,,0,0,,0,0,,0,0,0
22046,Domantas Sabonis,20-180,F,10/30/16,OKC,,LAL,W,1,7,0,1,0,0,1,0,0,0,,0,0,,0,0,0
22047,Domantas Sabonis,20-244,F,1/2/17,OKC,@,MIL,L,1,26,0,1,0,0,0,,0,1,0,0,0,,0,2,2
22048,Domantas Sabonis,20-253,F,1/11/17,OKC,,MEM,W,1,11,0,1,0,0,1,0,0,0,,0,0,,0,2,2
22049,Domantas Sabonis,20-279,F,2/6/17,OKC,@,IND,L,1,10,0,1,0,0,1,0,0,0,,0,0,,1,1,2
22050,Domantas Sabonis,20-265,F,1/23/17,OKC,@,UTA,W,1,18,0,5,0,0,3,0,0,2,0,0,0,,0,3,3
22051,Domantas Sabonis,20-230,F,12/19/16,OKC,,ATL,L,1,13,0,3,0,0,1,0,0,2,0,0,0,,0,4,4
22052,Larry Sanders,28-113,C-F,3/14/17,CLE,,DET,W,0,2,0,1,0,0,1,0,0,0,,0,0,,0,0,0
22053,Tomas Satoransky,25-106,G,2/13/17,WAS,,OKC,W,0,17,0,3,0,0,2,0,0,1,0,0,0,,0,1,1
22054,Tomas Satoransky,25-026,G,11/25/16,WAS,@,ORL,W,0,12,0,4,0,0,1,0,0,3,0,0,0,,1,2,3
22055,Tomas Satoransky,25-050,G,12/19/16,WAS,@,IND,L,0,7,0,1,0,0,0,,0,1,0,0,0,,1,1,2
22056,Tomas Satoransky,25-128,G,3/7/17,WAS,@,PHO,W,0,8,0,1,0,0,0,,0,1,0,0,0,,0,1,1
22057,Tomas Satoransky,25-049,G,12/18/16,WAS,,LAC,W,0,8,0,0,,0,0,,0,0,,0,0,,0,0,0
22058,Tomas Satoransky,25-083,G,1/21/17,WAS,@,DET,L,0,6,0,0,,0,0,,0,0,,0,0,,0,0,0
22059,Tomas Satoransky,25-047,G,12/16/16,WAS,,DET,W,0,6,0,0,,0,0,,0,0,,0,0,,0,0,0
22060,Tomas Satoransky,25-099,G,2/6/17,WAS,,CLE,L,0,12,0,1,0,0,1,0,0,0,,0,0,,0,1,1
22061,Tomas Satoransky,25-124,G,3/3/17,WAS,,TOR,L,0,5,0,1,0,0,1,0,0,0,,0,0,,2,0,2
22062,Tomas Satoransky,25-141,G,3/20/17,WAS,@,BOS,L,0,8,0,1,0,0,1,0,0,0,,0,2,0,0,0,0
22063,Tomas Satoransky,25-036,G,12/5/16,WAS,@,BRK,W,0,4,0,1,0,0,1,0,0,0,,0,0,,0,0,0
22064,Tomas Satoransky,25-139,G,3/18/17,WAS,@,CHO,L,0,5,0,0,,0,0,,0,0,,0,0,,0,1,1
22065,Tomas Satoransky,25-000,G,10/30/16,WAS,@,MEM,L,0,1,0,0,,0,0,,0,0,,0,0,,0,0,0
22066,Tomas Satoransky,25-121,G,2/28/17,WAS,,GSW,W,0,11,0,1,0,0,1,0,0,0,,0,0,,0,0,0
22067,Tomas Satoransky,25-029,G,11/28/16,WAS,,SAC,W,0,13,0,2,0,0,1,0,0,1,0,0,0,,0,1,1
22068,Tomas Satoransky,25-061,G,12/30/16,WAS,,BRK,W,0,12,0,1,0,0,0,,0,1,0,0,0,,0,0,0
22069,Tomas Satoransky,25-091,G,1/29/17,WAS,@,NOP,W,0,9,0,0,,0,0,,0,0,,0,0,,0,0,0
22070,Tomas Satoransky,25-109,G,2/16/17,WAS,@,IND,W,0,10,0,1,0,0,0,,0,1,0,0,0,,1,0,1
22071,Tomas Satoransky,25-132,G,3/11/17,WAS,@,POR,W,0,6,0,0,,0,0,,0,0,,0,0,,0,0,0
22072,Tomas Satoransky,25-027,G,11/26/16,WAS,,SAS,L,0,12,0,3,0,0,1,0,0,2,0,0,0,,1,0,1
22073,Luis Scola,36-207,F,11/23/16,BRK,,BOS,L,0,12,0,2,0,0,1,0,0,1,0,0,0,,2,2,4
22074,Luis Scola,36-258,F,1/13/17,BRK,@,TOR,L,0,5,0,0,,0,0,,0,0,,0,0,,0,1,1
22075,Luis Scola,36-289,F,2/13/17,BRK,,MEM,L,0,15,0,2,0,0,0,,0,2,0,0,0,,1,3,4
22076,Luis Scola,36-198,F,11/14/16,BRK,@,LAC,L,0,15,0,1,0,0,0,,0,1,0,0,0,,0,3,3
22077,Luis Scola,36-268,F,1/23/17,BRK,,SAS,L,0,8,0,2,0,0,1,0,0,1,0,0,0,,0,2,2
22078,Mike Scott,28-186,F,1/18/17,ATL,@,DET,L,0,14,0,3,0,0,1,0,0,2,0,0,0,,0,2,2
22079,Mike Scott,28-137,F,11/30/16,ATL,@,PHO,L,0,4,0,1,0,0,0,,0,1,0,0,0,,0,1,1
22080,Mike Scott,28-178,F,1/10/17,ATL,@,BRK,W,0,4,0,0,,0,0,,0,0,,0,0,,0,0,0
22081,Mike Scott,28-200,F,2/1/17,ATL,@,MIA,L,0,14,0,3,0,0,1,0,0,2,0,0,0,,0,1,1
22082,Mike Scott,28-191,F,1/23/17,ATL,,LAC,L,0,4,0,1,0,0,1,0,0,0,,0,0,,0,0,0
22083,Mike Scott,28-189,F,1/21/17,ATL,,PHI,W,0,6,0,2,0,0,0,,0,2,0,0,0,,0,1,1
22084,Mike Scott,28-140,F,12/3/16,ATL,@,TOR,L,0,13,0,4,0,0,2,0,0,2,0,0,0,,0,4,4
22085,Thabo Sefolosha,32-261,G-F,1/18/17,ATL,@,DET,L,1,12,0,3,0,0,2,0,0,1,0,0,0,,0,1,1
22086,Thabo Sefolosha,32-250,G-F,1/7/17,ATL,@,DAL,W,1,18,0,3,0,0,3,0,0,0,,0,0,,0,1,1
22087,Thabo Sefolosha,32-320,G-F,3/18/17,ATL,,POR,L,1,19,0,6,0,0,3,0,0,3,0,0,0,,2,3,5
22088,Kevin Seraphin,26-326,F,10/28/16,IND,@,BRK,L,0,3,0,0,,0,0,,0,0,,0,2,0,0,0,0
22089,Kevin Seraphin,27-021,F,12/28/16,IND,@,WAS,L,0,9,0,2,0,0,2,0,0,0,,0,0,,0,3,3
22090,Kevin Seraphin,27-042,F,1/18/17,IND,@,SAC,W,0,6,0,1,0,0,1,0,0,0,,0,0,,0,1,1
22091,Kevin Seraphin,27-015,F,12/22/16,IND,,BOS,L,0,1,0,0,,0,0,,0,0,,0,0,,0,0,0
22092,Kevin Seraphin,26-334,F,11/5/16,IND,,CHI,W,0,3,0,1,0,0,1,0,0,0,,0,0,,0,0,0
22093,Kevin Seraphin,27-063,F,2/8/17,IND,,CLE,L,0,13,0,3,0,0,3,0,0,0,,0,0,,0,1,1
22094,Kevin Seraphin,27-079,F,2/24/17,IND,,MEM,W,0,2,0,2,0,0,1,0,0,1,0,0,0,,0,0,0
22095,Kevin Seraphin,27-045,F,1/21/17,IND,@,UTA,L,0,1,0,0,,0,0,,0,0,,0,0,,0,1,1
22096,Ramon Sessions,30-289,G,1/25/17,CHO,,GSW,L,0,10,0,4,0,0,3,0,0,1,0,0,0,,0,0,0
22097,Ramon Sessions,30-224,G,11/21/16,CHO,,MEM,L,0,14,0,1,0,0,1,0,0,0,,0,2,0,0,2,2
22098,Iman Shumpert,26-225,G,2/6/17,CLE,@,WAS,W,1,24,0,2,0,0,1,0,0,1,0,0,0,,0,2,2
22099,Pascal Siakam,22-323,F,12/23/16,TOR,@,UTA,W,1,6,0,1,0,0,1,0,0,0,,0,0,,0,2,2
22100,Pascal Siakam,22-344,F,1/13/17,TOR,,BRK,W,0,11,0,1,0,0,1,0,0,0,,0,0,,0,1,1
22101,Pascal Siakam,22-312,F,12/12/16,TOR,,MIL,W,1,16,0,4,0,0,3,0,0,1,0,0,0,,1,2,3
22102,Pascal Siakam,22-328,F,12/28/16,TOR,@,GSW,L,1,4,0,1,0,0,1,0,0,0,,0,0,,1,0,1
22103,Pascal Siakam,22-326,F,12/26/16,TOR,@,POR,W,1,6,0,1,0,0,1,0,0,0,,0,0,,0,0,0
22104,Pascal Siakam,22-323,F,12/23/16,TOR,@,UTA,W,1,6,0,1,0,0,1,0,0,0,,0,0,,0,2,2
22105,Pascal Siakam,22-344,F,1/13/17,TOR,,BRK,W,0,11,0,1,0,0,1,0,0,0,,0,0,,0,1,1
22106,Pascal Siakam,23-037,F,3/13/17,TOR,,DAL,W,0,3,0,1,0,0,1,0,0,0,,0,0,,1,0,1
22107,Pascal Siakam,22-336,F,1/5/17,TOR,,UTA,W,0,4,0,2,0,0,2,0,0,0,,0,0,,1,2,3
22108,Jonathon Simmons,27-065,G-F,11/18/16,SAS,@,LAL,W,0,3,0,0,,0,0,,0,0,,0,0,,0,0,0
22109,Jonathon Simmons,27-149,G-F,2/10/17,SAS,@,DET,W,0,15,0,1,0,0,1,0,0,0,,0,0,,0,2,2
22110,Jonathon Simmons,27-109,G-F,1/1/17,SAS,@,ATL,L,0,19,0,2,0,0,0,,0,2,0,0,0,,1,2,3
22111,Jonathon Simmons,27-168,G-F,3/1/17,SAS,,IND,W,0,11,0,0,,0,0,,0,0,,0,0,,0,1,1
22112,Jonathon Simmons,27-182,G-F,3/15/17,SAS,,POR,L,0,5,0,0,,0,0,,0,0,,0,0,,0,0,0
22113,Jonathon Simmons,27-070,G-F,11/23/16,SAS,@,CHO,W,0,14,0,0,,0,0,,0,0,,0,0,,0,2,2
22114,Jonathon Simmons,27-180,G-F,3/13/17,SAS,,ATL,W,0,2,0,2,0,0,2,0,0,0,,0,0,,0,0,0
22115,Jonathon Simmons,27-068,G-F,11/21/16,SAS,,DAL,W,0,9,0,2,0,0,1,0,0,1,0,0,2,0,0,1,1
22116,Kyle Singler,28-273,F,2/1/17,OKC,,CHI,L,0,3,0,0,,0,0,,0,0,,0,0,,0,0,0
22117,Kyle Singler,28-203,F,11/23/16,OKC,@,SAC,L,0,1,0,0,,0,0,,0,0,,0,0,,0,1,1
22118,Kyle Singler,28-237,F,12/27/16,OKC,@,MIA,W,0,10,0,0,,0,0,,0,0,,0,0,,0,0,0
22119,Kyle Singler,28-198,F,11/18/16,OKC,,BRK,W,0,13,0,2,0,0,0,,0,2,0,0,0,,0,1,1
22120,Kyle Singler,28-235,F,12/25/16,OKC,,MIN,W,0,5,0,0,,0,0,,0,0,,0,0,,0,0,0
22121,Kyle Singler,28-267,F,1/26/17,OKC,,DAL,W,0,7,0,1,0,0,0,,0,1,0,0,0,,0,1,1
22122,Kyle Singler,28-193,F,11/13/16,OKC,,ORL,L,0,0,0,0,,0,0,,0,0,,0,0,,0,0,0
22123,Kyle Singler,28-189,F,11/9/16,OKC,,TOR,L,0,7,0,1,0,0,0,,0,1,0,0,0,,0,3,3
22124,Kyle Singler,28-185,F,11/5/16,OKC,,MIN,W,0,3,0,3,0,0,3,0,0,0,,0,0,,0,0,0
22125,Kyle Singler,28-254,F,1/13/17,OKC,@,MIN,L,0,6,0,1,0,0,1,0,0,0,,0,0,,0,0,0
22126,Kyle Singler,28-305,F,3/5/17,OKC,@,DAL,L,0,3,0,0,,0,0,,0,0,,0,0,,0,0,0
22127,Marcus Smart,22-289,G,12/20/16,BOS,@,MEM,W,0,22,0,3,0,0,1,0,0,2,0,0,0,,1,1,2
22128,Ish Smith,28-180,G,1/1/17,DET,@,MIA,W,0,15,0,7,0,0,5,0,0,2,0,0,0,,0,4,4
22129,J.R. Smith,31-079,G-F,11/27/16,CLE,@,PHI,W,1,39,0,11,0,0,4,0,0,7,0,0,0,,1,4,5
22130,Jason Smith,30-248,F-C,11/5/16,WAS,@,ORL,L,0,11,0,0,,0,0,,0,0,,0,0,,1,0,1
22131,Jason Smith,31-013,F-C,3/15/17,WAS,,DAL,L,0,7,0,2,0,0,2,0,0,0,,0,0,,0,2,2
22132,Jason Smith,30-247,F-C,11/4/16,WAS,,ATL,W,0,14,0,3,0,0,3,0,0,0,,0,0,,1,3,4
22133,Jason Smith,30-312,F-C,1/8/17,WAS,@,MIL,W,0,5,0,3,0,0,3,0,0,0,,0,0,,1,2,3
22134,Jason Smith,31-009,F-C,3/11/17,WAS,@,POR,W,0,9,0,1,0,0,1,0,0,0,,0,0,,0,0,0
22135,Jason Smith,30-255,F-C,11/12/16,WAS,@,CHI,L,0,17,0,4,0,0,4,0,0,0,,0,0,,2,3,5
22136,Jason Smith,30-254,F-C,11/11/16,WAS,,CLE,L,0,15,0,1,0,0,1,0,0,0,,0,0,,0,3,3
22137,Jason Smith,30-359,F-C,2/24/17,WAS,@,PHI,L,0,4,0,1,0,0,1,0,0,0,,0,0,,1,0,1
22138,Tony Snell,25-053,G-F,1/2/17,MIL,,OKC,W,1,31,0,2,0,0,1,0,0,1,0,0,0,,0,3,3
22139,Tony Snell,25-106,G-F,2/24/17,MIL,,UTA,L,1,28,0,2,0,0,1,0,0,1,0,0,0,,0,0,0
22140,Marreese Speights,29-209,C-F,3/1/17,LAC,,HOU,L,0,8,0,1,0,0,0,,0,1,0,0,0,,0,1,1
22141,Nik Stauskas,23-056,G,12/2/16,PHI,,ORL,L,0,25,0,6,0,0,3,0,0,3,0,0,0,,0,1,1
22142,Nik Stauskas,23-103,G,1/18/17,PHI,,TOR,W,1,16,0,2,0,0,0,,0,2,0,0,0,,0,1,1
22143,Lance Stephenson,26-191,G-F,3/15/17,MIN,@,BOS,L,0,2,0,0,,0,0,,0,0,,0,0,,0,0,0
22144,Diamond Stone,19-264,C,10/31/16,LAC,,PHO,W,0,4,0,1,0,0,1,0,0,0,,0,0,,0,0,0
22145,Diamond Stone,19-263,C,10/30/16,LAC,,UTA,W,0,2,0,0,,0,0,,0,0,,0,0,,0,1,1
22146,Diamond Stone,20-005,C,2/15/17,LAC,,ATL,W,0,3,0,0,,0,0,,0,0,,0,0,,0,1,1
22147,Diamond Stone,20-003,C,2/13/17,LAC,@,UTA,W,0,1,0,2,0,0,2,0,0,0,,0,0,,0,1,1
22148,Diamond Stone,19-314,C,12/20/16,LAC,,DEN,W,0,2,0,2,0,0,2,0,0,0,,0,0,,0,0,0
22149,Rodney Stuckey,30-328,G,3/15/17,IND,,CHO,W,0,16,0,2,0,0,1,0,0,1,0,0,0,,0,3,3
22150,Rodney Stuckey,30-190,G,10/28/16,IND,@,BRK,L,0,4,0,1,0,0,1,0,0,0,,0,0,,0,1,1
22151,Rodney Stuckey,30-323,G,3/10/17,IND,@,MIL,L,0,13,0,3,0,0,1,0,0,2,0,0,2,0,0,3,3
22152,Rodney Stuckey,30-319,G,3/6/17,IND,@,CHO,L,0,9,0,2,0,0,1,0,0,1,0,0,0,,0,1,1
22153,Rodney Stuckey,30-216,G,11/23/16,IND,,ATL,L,0,17,0,5,0,0,4,0,0,1,0,0,2,0,0,1,1
22154,Rodney Stuckey,30-314,G,3/1/17,IND,@,SAS,L,0,17,0,4,0,0,3,0,0,1,0,0,0,,0,1,1
22155,Rodney Stuckey,30-332,G,3/19/17,IND,@,TOR,L,0,10,0,3,0,0,2,0,0,1,0,0,0,,0,1,1
22156,Jared Sullinger,24-331,F,1/29/17,TOR,,ORL,L,0,7,0,1,0,0,0,,0,1,0,0,0,,1,0,1
22157,Jared Sullinger,24-327,F,1/25/17,TOR,@,MEM,L,0,15,0,6,0,0,4,0,0,2,0,0,0,,1,2,3
22158,Jared Sullinger,24-326,F,1/24/17,TOR,,SAS,L,1,12,0,4,0,0,3,0,0,1,0,0,0,,1,1,2
22159,Jared Sullinger,24-341,F,2/8/17,TOR,@,MIN,L,0,6,0,2,0,0,1,0,0,1,0,0,0,,1,1,2
22160,Jared Sullinger,24-339,F,2/6/17,TOR,,LAC,W,0,6,0,0,,0,0,,0,0,,0,0,,0,0,0
22161,Jared Sullinger,24-338,F,2/5/17,TOR,@,BRK,W,0,5,0,0,,0,0,,0,0,,0,0,,0,1,1
22162,Jeff Teague,28-141,G,10/29/16,IND,@,CHI,L,1,28,0,7,0,0,6,0,0,1,0,0,0,,1,3,4
22163,Mirza Teletovic,31-148,F,2/13/17,MIL,,DET,W,0,10,0,3,0,0,0,,0,3,0,0,0,,0,2,2
22164,Mirza Teletovic,31-122,F,1/18/17,MIL,@,HOU,L,0,8,0,5,0,0,1,0,0,4,0,0,0,,0,0,0
22165,Mirza Teletovic,31-164,F,3/1/17,MIL,,DEN,L,0,8,0,2,0,0,2,0,0,0,,0,0,,0,1,1
22166,Mirza Teletovic,31-055,F,11/12/16,MIL,,MEM,W,0,5,0,0,,0,0,,0,0,,0,0,,0,1,1
22167,Mirza Teletovic,31-096,F,12/23/16,MIL,,WAS,W,0,24,0,9,0,0,3,0,0,6,0,0,0,,0,2,2
22168,Mirza Teletovic,31-120,F,1/16/17,MIL,,PHI,L,0,4,0,3,0,0,1,0,0,2,0,0,0,,0,2,2
22169,Mirza Teletovic,31-114,F,1/10/17,MIL,@,SAS,W,0,5,0,1,0,0,1,0,0,0,,0,0,,0,0,0
22170,Mirza Teletovic,31-161,F,2/26/17,MIL,,PHO,W,0,9,0,2,0,0,1,0,0,1,0,0,0,,0,0,0
22171,Mirza Teletovic,31-131,F,1/27/17,MIL,@,TOR,L,0,6,0,2,0,0,1,0,0,1,0,0,0,,1,0,1
22172,Mirza Teletovic,31-150,F,2/15/17,MIL,@,BRK,W,0,6,0,3,0,0,2,0,0,1,0,0,0,,1,0,1
22173,Garrett Temple,30-187,G,11/11/16,SAC,@,POR,L,0,19,0,0,,0,0,,0,0,,0,0,,0,4,4
22174,Garrett Temple,30-208,G,12/2/16,SAC,@,BOS,L,0,26,0,3,0,0,2,0,0,1,0,0,0,,1,2,3
22175,Garrett Temple,30-172,G,10/27/16,SAC,,SAS,L,0,12,0,2,0,0,0,,0,2,0,0,0,,0,0,0
22176,Garrett Temple,30-179,G,11/3/16,SAC,@,ORL,L,0,13,0,2,0,0,1,0,0,1,0,0,0,,1,2,3
22177,Jason Terry,39-073,G,11/27/16,MIL,@,ORL,W,0,14,0,3,0,0,1,0,0,2,0,0,0,,0,2,2
22178,Jason Terry,39-071,G,11/25/16,MIL,,TOR,L,0,23,0,1,0,0,0,,0,1,0,0,1,0,0,1,1
22179,Jason Terry,39-102,G,12/26/16,MIL,@,WAS,L,0,14,0,1,0,0,1,0,0,0,,0,0,,0,2,2
22180,Jason Terry,39-083,G,12/7/16,MIL,,POR,W,0,10,0,1,0,0,0,,0,1,0,0,0,,0,0,0
22181,Jason Terry,39-081,G,12/5/16,MIL,,SAS,L,0,13,0,2,0,0,0,,0,2,0,0,0,,0,1,1
22182,Jason Terry,39-097,G,12/21/16,MIL,@,CLE,L,0,12,0,0,,0,0,,0,0,,0,0,,0,0,0
22183,Jason Terry,39-062,G,11/16/16,MIL,@,ATL,L,0,9,0,2,0,0,0,,0,2,0,0,0,,0,0,0
22184,Jason Terry,39-184,G,3/18/17,MIL,@,GSW,L,0,5,0,3,0,0,1,0,0,2,0,0,0,,1,0,1
22185,Jason Terry,39-125,G,1/18/17,MIL,@,HOU,L,0,11,0,2,0,0,0,,0,2,0,0,0,,0,0,0
22186,Jason Terry,39-052,G,11/6/16,MIL,@,DAL,L,0,24,0,6,0,0,3,0,0,3,0,0,0,,0,3,3
22187,Lance Thomas,28-321,F,3/11/17,NYK,@,DET,L,0,13,0,2,0,0,0,,0,2,0,0,0,,0,4,4
22188,Lance Thomas,28-202,F,11/12/16,NYK,@,TOR,L,0,9,0,3,0,0,2,0,0,1,0,0,0,,1,0,1
22189,Lance Thomas,28-266,F,1/15/17,NYK,@,TOR,L,1,2,0,1,0,0,1,0,0,0,,0,0,,0,0,0
22190,Lance Thomas,28-315,F,3/5/17,NYK,,GSW,L,1,27,0,6,0,0,4,0,0,2,0,0,0,,1,6,7
22191,Lance Thomas,28-231,F,12/11/16,NYK,@,LAL,W,0,16,0,2,0,0,1,0,0,1,0,0,0,,0,0,0
22192,Lance Thomas,28-248,F,12/28/16,NYK,@,ATL,L,0,12,0,1,0,0,0,,0,1,0,0,0,,0,1,1
22193,Lance Thomas,28-262,F,1/11/17,NYK,@,PHI,L,0,20,0,3,0,0,1,0,0,2,0,0,0,,0,6,6
22194,Hollis Thompson,25-232,G-F,11/21/16,PHI,,MIA,W,0,11,0,1,0,0,0,,0,1,0,0,0,,0,0,0
22195,Hollis Thompson,25-246,G-F,12/5/16,PHI,,DEN,L,0,15,0,3,0,0,2,0,0,1,0,0,0,,0,2,2
22196,Hollis Thompson,25-261,G-F,12/20/16,PHI,,NOP,L,0,10,0,2,0,0,2,0,0,0,,0,0,,0,2,2
22197,Hollis Thompson,25-328,G-F,2/25/17,NOP,@,DAL,L,1,25,0,4,0,0,1,0,0,3,0,0,0,,0,2,2
22198,Hollis Thompson,25-275,G-F,1/3/17,PHI,,MIN,W,0,4,0,1,0,0,1,0,0,0,,0,0,,0,1,1
22199,Hollis Thompson,25-249,G-F,12/8/16,PHI,@,NOP,W,0,7,0,1,0,0,0,,0,1,0,0,0,,0,1,1
22200,Tristan Thompson,25-226,F-C,10/25/16,CLE,,NYK,W,1,22,0,1,0,0,1,0,0,0,,0,0,,2,4,6
22201,Tristan Thompson,25-240,F-C,11/8/16,CLE,,ATL,L,1,25,0,0,,0,0,,0,0,,0,2,0,0,2,2
22202,Tristan Thompson,25-226,F-C,10/25/16,CLE,,NYK,W,1,22,0,1,0,0,1,0,0,0,,0,0,,2,4,6
22203,Marcus Thornton,29-201,G,12/23/16,WAS,@,MIL,L,0,9,0,3,0,0,2,0,0,1,0,0,0,,0,1,1
22204,Mike Tobey,22-136,C,2/23/17,CHO,@,DET,L,0,14,0,1,0,0,1,0,0,0,,0,0,,0,0,0
22205,Anthony Tolliver,31-194,F-C,12/12/16,SAC,,LAL,W,0,12,0,1,0,0,0,,0,1,0,0,0,,0,1,1
22206,Anthony Tolliver,31-150,F-C,10/29/16,SAC,,MIN,W,0,13,0,1,0,0,0,,0,1,0,0,0,,1,1,2
22207,Anthony Tolliver,31-192,F-C,12/10/16,SAC,@,UTA,L,0,4,0,0,,0,0,,0,0,,0,0,,1,2,3
22208,Anthony Tolliver,31-189,F-C,12/7/16,SAC,@,DAL,W,0,3,0,0,,0,0,,0,0,,0,0,,0,0,0
22209,Anthony Tolliver,31-271,F-C,2/27/17,SAC,,MIN,L,0,21,0,2,0,0,0,,0,2,0,0,0,,0,2,2
22210,Anthony Tolliver,31-172,F-C,11/20/16,SAC,,TOR,W,0,5,0,0,,0,0,,0,0,,0,0,,0,1,1
22211,Anthony Tolliver,31-219,F-C,1/6/17,SAC,,LAC,L,0,8,0,3,0,0,1,0,0,2,0,0,0,,0,3,3
22212,Axel Toupane,24-223,G-F,3/3/17,MIL,,LAC,W,0,2,0,0,,0,0,,0,0,,0,0,,0,0,0
22213,Axel Toupane,24-221,G-F,3/1/17,MIL,,DEN,L,0,5,0,1,0,0,0,,0,1,0,0,0,,0,0,0
22214,P.J. Tucker,31-215,F,12/6/16,PHO,@,UTA,L,1,21,0,0,,0,0,,0,0,,0,0,,0,0,0
22215,P.J. Tucker,31-195,F,11/16/16,PHO,@,DEN,L,0,21,0,5,0,0,2,0,0,3,0,0,0,,2,6,8
22216,P.J. Tucker,31-178,F,10/30/16,PHO,,GSW,L,0,8,0,1,0,0,0,,0,1,0,0,0,,0,3,3
22217,P.J. Tucker,31-310,F,3/11/17,TOR,@,MIA,L,0,14,0,1,0,0,1,0,0,0,,0,0,,0,3,3
22218,P.J. Tucker,31-176,F,10/28/16,PHO,@,OKC,L,0,4,0,1,0,0,0,,0,1,0,0,0,,0,1,1
22219,P.J. Tucker,31-174,F,10/26/16,PHO,,SAC,L,0,6,0,0,,0,0,,0,0,,0,0,,0,0,0
22220,P.J. Tucker,31-200,F,11/21/16,PHO,@,WAS,L,0,21,0,1,0,0,1,0,0,0,,0,0,,2,6,8
22221,P.J. Tucker,31-235,F,12/26/16,PHO,@,HOU,L,1,21,0,2,0,0,2,0,0,0,,0,0,,2,0,2
22222,P.J. Tucker,31-185,F,11/6/16,PHO,@,LAL,L,0,20,0,1,0,0,1,0,0,0,,0,0,,0,1,1
22223,Evan Turner,28-010,G,11/6/16,POR,@,MEM,W,0,23,0,0,,0,0,,0,0,,0,0,,0,0,0
22224,Evan Turner,28-145,G,3/21/17,POR,,MIL,L,0,19,0,4,0,0,4,0,0,0,,0,0,,0,1,1
22225,Beno Udrih,34-213,G,2/3/17,DET,,MIN,W,0,0,0,0,,0,0,,0,0,,0,0,,0,0,0
22226,Beno Udrih,34-148,G,11/30/16,DET,@,BOS,W,0,12,0,3,0,0,3,0,0,0,,0,0,,0,1,1
22227,Beno Udrih,34-209,G,1/30/17,DET,@,BOS,L,0,0,0,0,,0,0,,0,0,,0,0,,0,0,0
22228,Beno Udrih,34-194,G,1/15/17,DET,@,LAL,W,0,0,0,0,,0,0,,0,0,,0,0,,0,0,0
22229,Beno Udrih,34-218,G,2/8/17,DET,,LAL,W,0,4,0,2,0,0,2,0,0,0,,0,0,,0,0,0
22230,Tyler Ulis,20-341,G,12/11/16,PHO,,NOP,L,0,2,0,0,,0,0,,0,0,,0,0,,0,0,0
22231,Tyler Ulis,20-363,G,1/2/17,PHO,@,LAC,L,0,7,0,3,0,0,3,0,0,0,,0,0,,1,0,1
22232,Tyler Ulis,21-016,G,1/21/17,PHO,@,NYK,W,0,5,0,2,0,0,2,0,0,0,,0,0,,1,1,2
22233,Tyler Ulis,20-299,G,10/30/16,PHO,,GSW,L,0,0,0,0,,0,0,,0,0,,0,0,,0,0,0
22234,Tyler Ulis,20-327,G,11/27/16,PHO,,DEN,L,0,4,0,0,,0,0,,0,0,,0,0,,0,0,0
22235,Tyler Ulis,20-358,G,12/28/16,PHO,@,SAS,L,0,3,0,1,0,0,1,0,0,0,,0,0,,0,0,0
22236,Tyler Ulis,21-011,G,1/16/17,PHO,,UTA,L,0,11,0,4,0,0,2,0,0,2,0,0,0,,0,1,1
22237,Tyler Ulis,20-351,G,12/21/16,PHO,,HOU,L,0,5,0,1,0,0,1,0,0,0,,0,0,,0,0,0
22238,Tyler Ulis,21-034,G,2/8/17,PHO,@,MEM,L,0,0,0,0,,0,0,,0,0,,0,0,,0,0,0
22239,Tyler Ulis,21-007,G,1/12/17,PHO,,DAL,L,0,6,0,3,0,0,3,0,0,0,,0,0,,1,0,1
22240,Tyler Ulis,21-030,G,2/4/17,PHO,,MIL,L,0,3,0,1,0,0,1,0,0,0,,0,0,,0,0,0
22241,Jarrod Uthoff,23-298,F,3/13/17,DAL,@,TOR,L,0,3,0,1,0,0,1,0,0,0,,0,0,,1,0,1
22242,Jarrod Uthoff,23-295,F,3/10/17,DAL,,BRK,W,0,2,0,0,,0,0,,0,0,,0,0,,0,0,0
22243,Denzel Valentine,23-110,G,3/6/17,CHI,@,DET,L,0,15,0,3,0,0,1,0,0,2,0,0,0,,0,2,2
22244,Denzel Valentine,23-016,G,12/2/16,CHI,,CLE,W,0,4,0,0,,0,0,,0,0,,0,0,,0,0,0
22245,Denzel Valentine,23-014,G,11/30/16,CHI,,LAL,L,0,6,0,2,0,0,1,0,0,1,0,0,0,,0,0,0
22246,Denzel Valentine,23-039,G,12/25/16,CHI,@,SAS,L,0,2,0,0,,0,0,,0,0,,0,0,,0,0,0
22247,Denzel Valentine,23-106,G,3/2/17,CHI,,GSW,W,0,14,0,1,0,0,0,,0,1,0,0,0,,1,1,2
22248,Denzel Valentine,22-354,G,11/4/16,CHI,,NYK,L,0,0,0,0,,0,0,,0,0,,0,0,,0,0,0
22249,Denzel Valentine,23-006,G,11/22/16,CHI,@,DEN,L,0,14,0,1,0,0,0,,0,1,0,0,0,,0,3,3
22250,Denzel Valentine,23-060,G,1/15/17,CHI,@,MEM,W,0,10,0,1,0,0,0,,0,1,0,0,0,,0,0,0
22251,Denzel Valentine,22-348,G,10/29/16,CHI,,IND,W,0,5,0,1,0,0,0,,0,1,0,0,0,,0,1,1
22252,Denzel Valentine,23-003,G,11/19/16,CHI,@,LAC,L,0,2,0,1,0,0,0,,0,1,0,0,0,,0,0,0
22253,Denzel Valentine,23-059,G,1/14/17,CHI,,NOP,W,0,5,0,0,,0,0,,0,0,,0,0,,0,0,0
22254,Denzel Valentine,23-092,G,2/16/17,CHI,,BOS,W,0,5,0,0,,0,0,,0,0,,0,0,,0,0,0
22255,Denzel Valentine,22-365,G,11/15/16,CHI,@,POR,W,0,16,0,2,0,0,1,0,0,1,0,0,0,,0,4,4
22256,Fred VanVleet,22-299,G,12/20/16,TOR,,BRK,W,0,2,0,2,0,0,2,0,0,0,,0,0,,0,0,0
22257,Fred VanVleet,22-335,G,1/25/17,TOR,@,MEM,L,0,4,0,1,0,0,1,0,0,0,,0,0,,0,1,1
22258,Fred VanVleet,22-334,G,1/24/17,TOR,,SAS,L,0,0,0,0,,0,0,,0,0,,0,0,,0,0,0
22259,Fred VanVleet,22-291,G,12/12/16,TOR,,MIL,W,0,2,0,1,0,0,1,0,0,0,,0,0,,0,0,0
22260,Fred VanVleet,23-022,G,3/19/17,TOR,,IND,W,0,3,0,0,,0,0,,0,0,,0,0,,0,0,0
22261,Fred VanVleet,23-020,G,3/17/17,TOR,@,DET,W,0,6,0,2,0,0,2,0,0,0,,0,0,,0,1,1
22262,Fred VanVleet,22-279,G,11/30/16,TOR,,MEM,W,0,1,0,0,,0,0,,0,0,,0,0,,0,0,0
22263,Fred VanVleet,22-325,G,1/15/17,TOR,,NYK,W,0,5,0,3,0,0,2,0,0,1,0,0,0,,0,0,0
22264,Fred VanVleet,22-341,G,1/31/17,TOR,,NOP,W,0,0,0,0,,0,0,,0,0,,0,0,,0,0,0
22265,Fred VanVleet,22-277,G,11/28/16,TOR,,PHI,W,0,4,0,1,0,0,1,0,0,0,,0,0,,0,0,0
22266,Fred VanVleet,22-339,G,1/29/17,TOR,,ORL,L,0,3,0,0,,0,0,,0,0,,0,0,,0,0,0
22267,Fred VanVleet,22-258,G,11/9/16,TOR,@,OKC,W,0,0,0,0,,0,0,,0,0,,0,0,,0,0,0
22268,Anderson Varejao,34-085,F-C,12/22/16,GSW,@,BRK,W,0,5,0,0,,0,0,,0,0,,0,0,,0,1,1
22269,Anderson Varejao,34-083,F-C,12/20/16,GSW,,UTA,W,0,7,0,1,0,0,1,0,0,0,,0,0,,3,2,5
22270,Anderson Varejao,34-073,F-C,12/10/16,GSW,@,MEM,L,1,18,0,2,0,0,2,0,0,0,,0,0,,3,2,5
22271,Anderson Varejao,34-127,F-C,2/2/17,GSW,@,LAC,W,0,8,0,1,0,0,1,0,0,0,,0,0,,0,2,2
22272,Anderson Varejao,34-066,F-C,12/3/16,GSW,,PHO,W,0,5,0,0,,0,0,,0,0,,0,0,,1,1,2
22273,Anderson Varejao,34-112,F-C,1/18/17,GSW,,OKC,W,0,5,0,0,,0,0,,0,0,,0,0,,0,0,0
22274,Anderson Varejao,34-036,F-C,11/3/16,GSW,,OKC,W,0,5,0,1,0,0,1,0,0,0,,0,0,,0,1,1
22275,Greivis Vasquez,29-284,G,10/26/16,BRK,@,BOS,L,0,18,0,1,0,0,0,,0,1,0,0,0,,0,0,0
22276,Rashad Vaughn,20-092,G,11/16/16,MIL,@,ATL,L,0,14,0,6,0,0,2,0,0,4,0,0,0,,0,1,1
22277,Rashad Vaughn,20-153,G,1/16/17,MIL,,PHI,L,0,2,0,0,,0,0,,0,0,,0,0,,0,0,0
22278,Rashad Vaughn,20-209,G,3/13/17,MIL,@,MEM,L,0,2,0,0,,0,0,,0,0,,0,0,,0,0,0
22279,Rashad Vaughn,20-181,G,2/13/17,MIL,,DET,W,0,1,0,0,,0,0,,0,0,,0,0,,0,0,0
22280,Rashad Vaughn,20-079,G,11/3/16,MIL,,IND,W,0,1,0,0,,0,0,,0,0,,0,0,,0,0,0
22281,Rashad Vaughn,20-122,G,12/16/16,MIL,@,CHI,W,0,5,0,1,0,0,0,,0,1,0,0,0,,0,2,2
22282,Rashad Vaughn,20-172,G,2/4/17,MIL,@,PHO,W,0,4,0,1,0,0,1,0,0,0,,0,0,,0,1,1
22283,Rashad Vaughn,20-202,G,3/6/17,MIL,@,PHI,W,0,4,0,0,,0,0,,0,0,,0,0,,0,1,1
22284,Rashad Vaughn,20-118,G,12/12/16,MIL,@,TOR,L,0,3,0,0,,0,0,,0,0,,0,0,,0,0,0
22285,Rashad Vaughn,20-199,G,3/3/17,MIL,,LAC,W,0,2,0,0,,0,0,,0,0,,0,0,,0,0,0
22286,Rashad Vaughn,20-113,G,12/7/16,MIL,,POR,W,0,9,0,2,0,0,1,0,0,1,0,0,0,,0,1,1
22287,Rashad Vaughn,20-158,G,1/21/17,MIL,@,MIA,L,0,11,0,1,0,0,0,,0,1,0,0,0,,0,0,0
22288,Rashad Vaughn,20-197,G,3/1/17,MIL,,DEN,L,1,5,0,1,0,0,1,0,0,0,,0,0,,0,0,0
22289,Rashad Vaughn,20-107,G,12/1/16,MIL,@,BRK,W,0,3,0,0,,0,0,,0,0,,0,0,,0,0,0
22290,Rashad Vaughn,20-093,G,11/17/16,MIL,@,MIA,L,0,1,0,0,,0,0,,0,0,,0,0,,0,0,0
22291,Rashad Vaughn,20-192,G,2/24/17,MIL,,UTA,L,0,3,0,0,,0,0,,0,0,,0,0,,0,0,0
22292,Noah Vonleh,21-093,F,11/25/16,POR,,NOP,W,0,5,0,2,0,0,2,0,0,0,,0,0,,0,1,1
22293,Noah Vonleh,21-134,F,1/5/17,POR,,LAL,W,0,4,0,1,0,0,1,0,0,0,,0,2,0,0,1,1
22294,Noah Vonleh,21-091,F,11/23/16,POR,@,CLE,L,0,14,0,2,0,0,1,0,0,1,0,0,0,,1,4,5
22295,Noah Vonleh,21-130,F,1/1/17,POR,@,MIN,W,0,7,0,0,,0,0,,0,0,,0,0,,0,1,1
22296,Noah Vonleh,21-167,F,2/7/17,POR,@,DAL,W,1,22,0,2,0,0,2,0,0,0,,0,2,0,1,7,8
22297,Noah Vonleh,21-074,F,11/6/16,POR,@,MEM,W,0,3,0,0,,0,0,,0,0,,0,0,,0,1,1
22298,Noah Vonleh,21-066,F,10/29/16,POR,@,DEN,W,0,7,0,0,,0,0,,0,0,,0,0,,0,4,4
22299,Noah Vonleh,21-086,F,11/18/16,POR,@,NOP,L,0,16,0,1,0,0,1,0,0,0,,0,0,,1,5,6
22300,Noah Vonleh,21-106,F,12/8/16,POR,@,MEM,L,0,7,0,1,0,0,0,,0,1,0,0,0,,0,0,0
22301,Noah Vonleh,21-175,F,2/15/17,POR,@,UTA,L,0,24,0,0,,0,0,,0,0,,0,0,,1,5,6
22302,Noah Vonleh,21-093,F,11/25/16,POR,,NOP,W,0,5,0,2,0,0,2,0,0,0,,0,0,,0,1,1
22303,Noah Vonleh,21-134,F,1/5/17,POR,,LAL,W,0,4,0,1,0,0,1,0,0,0,,0,2,0,0,1,1
22304,Noah Vonleh,21-091,F,11/23/16,POR,@,CLE,L,0,14,0,2,0,0,1,0,0,1,0,0,0,,1,4,5
22305,Noah Vonleh,21-074,F,11/6/16,POR,@,MEM,W,0,3,0,0,,0,0,,0,0,,0,0,,0,1,1
22306,Noah Vonleh,21-130,F,1/1/17,POR,@,MIN,W,0,7,0,0,,0,0,,0,0,,0,0,,0,1,1
22307,Noah Vonleh,21-167,F,2/7/17,POR,@,DAL,W,1,22,0,2,0,0,2,0,0,0,,0,2,0,1,7,8
22308,Sasha Vujacic,32-298,G,12/31/16,NYK,@,HOU,L,0,4,0,1,0,0,0,,0,1,0,0,0,,0,0,0
22309,Sasha Vujacic,32-241,G,11/4/16,NYK,@,CHI,W,0,1,0,1,0,0,0,,0,1,0,0,0,,0,0,0
22310,Sasha Vujacic,32-335,G,2/6/17,NYK,,LAL,L,0,1,0,0,,0,0,,0,0,,0,0,,0,1,1
22311,Sasha Vujacic,32-333,G,2/4/17,NYK,,CLE,L,0,6,0,2,0,0,2,0,0,0,,0,0,,0,0,0
22312,Sasha Vujacic,32-263,G,11/26/16,NYK,@,CHO,L,0,6,0,2,0,0,0,,0,2,0,0,0,,0,1,1
22313,Sasha Vujacic,32-289,G,12/22/16,NYK,,ORL,W,0,1,0,0,,0,0,,0,0,,0,0,,0,0,0
22314,Sasha Vujacic,32-262,G,11/25/16,NYK,,CHO,W,0,4,0,0,,0,0,,0,0,,0,0,,0,0,0
22315,Sasha Vujacic,32-284,G,12/17/16,NYK,@,DEN,L,0,2,0,0,,0,0,,0,0,,0,0,,0,0,0
22316,Sasha Vujacic,32-254,G,11/17/16,NYK,@,WAS,L,0,2,0,0,,0,0,,0,0,,0,0,,0,0,0
22317,Sasha Vujacic,32-282,G,12/15/16,NYK,@,GSW,L,0,2,0,1,0,0,0,,0,1,0,0,0,,0,0,0
22318,Sasha Vujacic,32-323,G,1/25/17,NYK,@,DAL,L,0,0,0,0,,0,0,,0,0,,0,0,,0,0,0
22319,Sasha Vujacic,33-003,G,3/11/17,NYK,@,DET,L,0,4,0,1,0,0,1,0,0,0,,0,0,,0,1,1
22320,Sasha Vujacic,32-356,G,2/27/17,NYK,,TOR,L,0,3,0,2,0,0,0,,0,2,0,0,0,,0,0,0
22321,Sasha Vujacic,32-248,G,11/11/16,NYK,@,BOS,L,0,9,0,3,0,0,1,0,0,2,0,0,0,,0,1,1
22322,Sasha Vujacic,32-274,G,12/7/16,NYK,,CLE,L,0,9,0,2,0,0,1,0,0,1,0,0,0,,0,2,2
22323,Taurean Waller-Prince,22-250,F,11/27/16,ATL,@,LAL,L,0,8,0,1,0,0,0,,0,1,0,0,0,,0,0,0
22324,Taurean Waller-Prince,22-228,F,11/5/16,ATL,,HOU,W,0,2,0,0,,0,0,,0,0,,0,0,,0,0,0
22325,Taurean Waller-Prince,22-353,F,3/10/17,ATL,,TOR,W,0,9,0,0,,0,0,,0,0,,0,0,,0,1,1
22326,Taurean Waller-Prince,22-274,F,12/21/16,ATL,,MIN,L,0,11,0,2,0,0,2,0,0,0,,0,0,,0,1,1
22327,Taurean Waller-Prince,22-219,F,10/27/16,ATL,,WAS,W,0,4,0,0,,0,0,,0,0,,0,0,,0,0,0
22328,Taurean Waller-Prince,22-262,F,12/9/16,ATL,@,MIL,W,0,2,0,1,0,0,1,0,0,0,,0,0,,0,0,0
22329,Taurean Waller-Prince,22-321,F,2/6/17,ATL,,UTA,L,0,4,0,0,,0,0,,0,0,,0,0,,0,0,0
22330,Taurean Waller-Prince,22-297,F,1/13/17,ATL,,BOS,L,0,2,0,0,,0,0,,0,0,,0,0,,0,0,0
22331,T.J. Warren,23-117,F,12/31/16,PHO,@,UTA,L,1,19,0,3,0,0,2,0,0,1,0,0,0,,0,1,1
22332,T.J. Warren,23-161,F,2/13/17,PHO,,NOP,L,1,26,0,3,0,0,3,0,0,0,,0,0,,0,3,3
22333,T.J. Warren,23-105,F,12/19/16,PHO,@,MIN,L,0,10,0,5,0,0,5,0,0,0,,0,0,,1,0,1
22334,C.J. Watson,32-236,G,12/9/16,ORL,@,CHO,L,0,8,0,0,,0,0,,0,0,,0,0,,0,0,0
22335,C.J. Watson,32-262,G,1/4/17,ORL,,ATL,L,0,2,0,1,0,0,0,,0,1,0,0,0,,0,0,0
22336,C.J. Watson,32-200,G,11/3/16,ORL,,SAC,W,0,12,0,1,0,0,1,0,0,0,,0,0,,1,2,3
22337,C.J. Watson,32-229,G,12/2/16,ORL,@,PHI,W,0,6,0,1,0,0,1,0,0,0,,0,0,,0,0,0
22338,C.J. Watson,32-194,G,10/28/16,ORL,@,DET,L,0,8,0,2,0,0,2,0,0,0,,0,0,,1,0,1
22339,C.J. Watson,32-322,G,3/5/17,ORL,@,WAS,L,0,13,0,1,0,0,1,0,0,0,,0,0,,0,0,0
22340,C.J. Watson,32-337,G,3/20/17,ORL,,PHI,W,0,4,0,1,0,0,0,,0,1,0,0,0,,0,2,2
22341,C.J. Watson,32-210,G,11/13/16,ORL,@,OKC,W,0,8,0,0,,0,0,,0,0,,0,0,,0,2,2
22342,C.J. Watson,32-253,G,12/26/16,ORL,,MEM,W,0,20,0,4,0,0,2,0,0,2,0,0,0,,0,1,1
22343,C.J. Watson,32-274,G,1/16/17,ORL,@,DEN,L,0,14,0,1,0,0,1,0,0,0,,0,0,,0,1,1
22344,C.J. Watson,32-320,G,3/3/17,ORL,,MIA,W,0,11,0,2,0,0,2,0,0,0,,0,0,,0,1,1
22345,C.J. Watson,32-208,G,11/11/16,ORL,,UTA,L,0,10,0,2,0,0,2,0,0,0,,0,0,,0,0,0
22346,C.J. Watson,32-272,G,1/14/17,ORL,@,UTA,L,0,8,0,2,0,0,1,0,0,1,0,0,0,,0,0,0
22347,C.J. Watson,32-206,G,11/9/16,ORL,,MIN,L,0,7,0,0,,0,0,,0,0,,0,0,,0,0,0
22348,C.J. Watson,32-266,G,1/8/17,ORL,@,LAL,L,0,1,0,1,0,0,1,0,0,0,,0,0,,0,0,0
22349,C.J. Watson,32-202,G,11/5/16,ORL,,WAS,W,0,13,0,1,0,0,1,0,0,0,,0,0,,0,1,1
22350,Briante Weber,24-044,PG,2/11/17,GSW,@,OKC,W,0,2,0,1,0,0,1,0,0,0,,0,0,,0,0,0
22351,Briante Weber,24-056,PG,2/23/17,GSW,,LAC,W,0,3,0,1,0,0,1,0,0,0,,0,0,,0,0,0
22352,Briante Weber,24-048,PG,2/15/17,GSW,,SAC,W,0,6,0,3,0,0,2,0,0,1,0,0,0,,0,0,0
22353,David West,36-193,F,3/10/17,GSW,@,MIN,L,0,13,0,3,0,0,2,0,0,1,0,0,0,,0,4,4
22354,David West,36-094,F,12/1/16,GSW,,HOU,L,0,3,0,2,0,0,2,0,0,0,,0,0,,0,2,2
22355,David West,36-191,F,3/8/17,GSW,,BOS,L,0,12,0,1,0,0,1,0,0,0,,0,0,,1,3,4
22356,David West,36-091,F,11/28/16,GSW,,ATL,W,0,9,0,1,0,0,1,0,0,0,,0,0,,0,0,0
22357,Okaro White,24-214,F,3/15/17,MIA,,NOP,W,0,10,0,1,0,0,1,0,0,0,,0,0,,1,1,2
22358,Okaro White,24-184,F,2/13/17,MIA,,ORL,L,0,7,0,2,0,0,1,0,0,1,0,0,0,,0,1,1
22359,Okaro White,24-211,F,3/12/17,MIA,@,IND,L,0,5,0,0,,0,0,,0,0,,0,0,,0,1,1
22360,Okaro White,24-202,F,3/3/17,MIA,@,ORL,L,0,5,0,3,0,0,2,0,0,1,0,0,0,,1,1,2
22361,Okaro White,24-161,F,1/21/17,MIA,,MIL,W,0,19,0,2,0,0,2,0,0,0,,0,0,,0,3,3
22362,Okaro White,24-159,F,1/19/17,MIA,,DAL,W,0,9,0,1,0,0,0,,0,1,0,0,0,,0,1,1
22363,Okaro White,24-172,F,2/1/17,MIA,,ATL,W,0,3,0,0,,0,0,,0,0,,0,0,,0,0,0
22364,Okaro White,24-196,F,2/25/17,MIA,,IND,W,0,5,0,0,,0,0,,0,0,,0,0,,1,0,1
22365,Okaro White,24-216,F,3/17/17,MIA,,MIN,W,0,1,0,0,,0,0,,0,0,,0,0,,0,0,0
22366,Isaiah Whitehead,21-332,G,2/3/17,BRK,,IND,L,1,14,0,4,0,0,2,0,0,2,0,0,0,,0,1,1
22367,Isaiah Whitehead,21-232,G,10/26/16,BRK,@,BOS,L,0,4,0,0,,0,0,,0,0,,0,0,,0,1,1
22368,C.J. Wilcox,26-009,G,1/8/17,ORL,@,LAL,L,0,1,0,0,,0,0,,0,0,,0,0,,0,0,0
22369,C.J. Wilcox,25-338,G,12/2/16,ORL,@,PHI,W,0,2,0,0,,0,0,,0,0,,0,0,,1,0,1
22370,C.J. Wilcox,25-335,G,11/29/16,ORL,@,SAS,W,0,2,0,0,,0,0,,0,0,,0,0,,0,0,0
22371,C.J. Wilcox,26-003,G,1/2/17,ORL,@,NYK,W,0,2,0,0,,0,0,,0,0,,0,0,,0,0,0
22372,C.J. Wilcox,25-320,G,11/14/16,ORL,@,IND,L,0,4,0,0,,0,0,,0,0,,0,0,,0,0,0
22373,C.J. Wilcox,25-315,G,11/9/16,ORL,,MIN,L,0,3,0,0,,0,0,,0,0,,0,0,,0,0,0
22374,C.J. Wilcox,25-364,G,12/28/16,ORL,,CHO,L,0,6,0,1,0,0,0,,0,1,0,0,0,,1,1,2
22375,C.J. Wilcox,25-362,G,12/26/16,ORL,,MEM,W,0,3,0,0,,0,0,,0,0,,0,0,,0,1,1
22376,C.J. Wilcox,26-071,G,3/11/17,ORL,,CLE,L,0,2,0,0,,0,0,,0,0,,0,0,,0,0,0
22377,C.J. Wilcox,25-307,G,11/1/16,ORL,@,PHI,W,0,4,0,1,0,0,0,,0,1,0,0,0,,0,0,0
22378,C.J. Wilcox,25-359,G,12/23/16,ORL,,LAL,W,0,3,0,1,0,0,0,,0,1,0,0,0,,0,1,1
22379,C.J. Wilcox,26-070,G,3/10/17,ORL,@,CHO,L,0,9,0,1,0,0,1,0,0,0,,0,0,,1,0,1
22380,C.J. Wilcox,25-304,G,10/29/16,ORL,@,CLE,L,0,9,0,2,0,0,0,,0,2,0,0,0,,0,0,0
22381,C.J. Wilcox,25-343,G,12/7/16,ORL,,BOS,L,0,4,0,1,0,0,0,,0,1,0,0,0,,0,0,0
22382,Alan Williams,23-328,F-C,12/21/16,PHO,,HOU,L,0,2,0,1,0,0,1,0,0,0,,0,0,,1,2,3
22383,Alan Williams,24-011,F-C,2/8/17,PHO,@,MEM,L,0,1,0,0,,0,0,,0,0,,0,0,,0,1,1
22384,Alan Williams,23-293,F-C,11/16/16,PHO,@,DEN,L,0,4,0,1,0,0,1,0,0,0,,0,2,0,2,0,2
22385,Alan Williams,23-364,F-C,1/26/17,PHO,@,DEN,L,0,1,0,1,0,0,1,0,0,0,,0,0,,0,0,0
22386,Alan Williams,23-360,F-C,1/22/17,PHO,@,TOR,W,0,0,0,0,,0,0,,0,0,,0,0,,0,0,0
22387,Alan Williams,23-304,F-C,11/27/16,PHO,,DEN,L,0,2,0,1,0,0,1,0,0,0,,0,0,,0,0,0
22388,Alan Williams,23-335,F-C,12/28/16,PHO,@,SAS,L,0,3,0,0,,0,0,,0,0,,0,0,,0,0,0
22389,Deron Williams,32-143,G,11/16/16,DAL,@,BOS,L,1,10,0,3,0,0,1,0,0,2,0,0,0,,0,0,0
22390,Derrick Williams,25-166,F,11/7/16,MIA,@,OKC,L,0,3,0,0,,0,0,,0,0,,0,0,,0,1,1
22391,Derrick Williams,25-184,F,11/25/16,MIA,@,MEM,W,1,14,0,5,0,0,3,0,0,2,0,0,0,,0,2,2
22392,Derrick Williams,25-245,F,1/25/17,MIA,@,BRK,W,0,1,0,0,,0,0,,0,0,,0,0,,0,0,0
22393,Marvin Williams,30-155,F,11/21/16,CHO,,MEM,L,1,25,0,6,0,0,3,0,0,3,0,0,0,,0,3,3
22394,Reggie Williams,30-095,F,12/18/16,NOP,@,SAS,L,0,6,0,1,0,0,1,0,0,0,,0,0,,0,0,0
22395,Troy Williams,21-324,F,11/18/16,MEM,@,DAL,W,0,2,0,0,,0,0,,0,0,,0,0,,0,0,0
22396,Troy Williams,21-354,F,12/18/16,MEM,,UTA,L,0,5,0,0,,0,0,,0,0,,0,0,,0,0,0
22397,Troy Williams,21-314,F,11/8/16,MEM,,DEN,W,0,4,0,2,0,0,1,0,0,1,0,0,0,,0,0,0
22398,Troy Williams,21-310,F,11/4/16,MEM,,LAC,L,0,6,0,0,,0,0,,0,0,,0,0,,0,0,0
22399,Troy Williams,21-305,F,10/30/16,MEM,,WAS,W,0,1,0,0,,0,0,,0,0,,0,0,,0,0,0
22400,Troy Williams,21-344,F,12/8/16,MEM,,POR,W,1,20,0,3,0,0,2,0,0,1,0,0,0,,0,5,5
22401,Troy Williams,21-324,F,11/18/16,MEM,@,DAL,W,0,2,0,0,,0,0,,0,0,,0,0,,0,0,0
22402,Troy Williams,21-354,F,12/18/16,MEM,,UTA,L,0,5,0,0,,0,0,,0,0,,0,0,,0,0,0
22403,Kyle Wiltjer,24-062,F,12/21/16,HOU,@,PHO,W,0,2,0,0,,0,0,,0,0,,0,0,,0,0,0
22404,Kyle Wiltjer,24-016,F,11/5/16,HOU,@,ATL,L,0,2,0,0,,0,0,,0,0,,0,0,,0,0,0
22405,Kyle Wiltjer,24-146,F,3/15/17,HOU,,LAL,W,0,4,0,1,0,0,0,,0,1,0,0,0,,0,0,0
22406,Kyle Wiltjer,24-013,F,11/2/16,HOU,@,NYK,W,0,4,0,3,0,0,0,,0,3,0,0,0,,0,2,2
22407,Kyle Wiltjer,24-141,F,3/10/17,HOU,@,CHI,W,0,2,0,0,,0,0,,0,0,,0,0,,0,1,1
22408,Kyle Wiltjer,24-008,F,10/28/16,HOU,@,DAL,W,0,1,0,0,,0,0,,0,0,,0,0,,0,0,0
22409,Kyle Wiltjer,24-071,F,12/30/16,HOU,,LAC,W,0,2,0,0,,0,0,,0,0,,0,0,,0,1,1
22410,Kyle Wiltjer,24-068,F,12/27/16,HOU,@,DAL,W,0,3,0,1,0,0,0,,0,1,0,0,0,,0,0,0
22411,Kyle Wiltjer,24-067,F,12/26/16,HOU,,PHO,W,0,6,0,3,0,0,0,,0,3,0,0,0,,1,0,1
22412,Jeff Withey,26-297,C,12/29/16,UTA,,PHI,W,0,1,0,0,,0,0,,0,0,,0,0,,0,0,0
22413,Jeff Withey,26-249,C,11/11/16,UTA,@,ORL,W,0,2,0,0,,0,0,,0,0,,0,0,,0,0,0
22414,Jeff Withey,26-288,C,12/20/16,UTA,@,GSW,L,0,17,0,1,0,0,1,0,0,0,,0,0,,2,3,5
22415,Jeff Withey,26-343,C,2/13/17,UTA,,LAC,L,0,5,0,2,0,0,2,0,0,0,,0,0,,1,0,1
22416,Jeff Withey,27-009,C,3/16/17,UTA,@,CLE,L,0,3,0,1,0,0,1,0,0,0,,0,0,,0,0,0
22417,Jeff Withey,26-247,C,11/9/16,UTA,@,CHO,L,0,4,0,0,,0,0,,0,0,,0,0,,0,0,0
22418,Jeff Withey,27-008,C,3/15/17,UTA,@,DET,W,0,12,0,1,0,0,1,0,0,0,,0,0,,0,1,1
22419,Jeff Withey,26-336,C,2/6/17,UTA,@,ATL,W,0,1,0,0,,0,0,,0,0,,0,0,,0,2,2
22420,Jeff Withey,26-240,C,11/2/16,UTA,,DAL,W,0,9,0,0,,0,0,,0,0,,0,0,,0,1,1
22421,Jeff Withey,26-320,C,1/21/17,UTA,,IND,W,0,1,0,0,,0,0,,0,0,,0,0,,0,1,1
22422,Jeff Withey,26-232,C,10/25/16,UTA,@,POR,L,0,5,0,0,,0,0,,0,0,,0,0,,0,1,1
22423,Christian Wood,21-158,F,3/4/17,CHO,@,DEN,W,0,5,0,0,,0,0,,0,0,,0,0,,0,0,0
22424,Christian Wood,21-156,F,3/2/17,CHO,@,PHO,L,0,2,0,1,0,0,0,,0,1,0,0,0,,0,0,0
22425,Christian Wood,21-174,F,3/20/17,CHO,,ATL,W,0,2,0,0,,0,0,,0,0,,0,0,,0,0,0
22426,Christian Wood,21-169,F,3/15/17,CHO,@,IND,L,0,4,0,0,,0,0,,0,0,,0,0,,0,0,0
22427,Christian Wood,21-126,F,1/31/17,CHO,@,POR,L,0,6,0,1,0,0,0,,0,1,0,0,0,,0,3,3
22428,Christian Wood,21-041,F,11/7/16,CHO,,IND,W,0,3,0,1,0,0,0,,0,1,0,0,0,,0,2,2
22429,Christian Wood,21-162,F,3/8/17,CHO,@,MIA,L,0,2,0,0,,0,0,,0,0,,0,0,,0,0,0
22430,Metta World Peace,37-040,F,12/23/16,LAL,@,ORL,L,0,1,0,0,,0,0,,0,0,,0,0,,0,0,0
22431,Metta World Peace,36-361,F,11/8/16,LAL,,DAL,L,0,3,0,2,0,0,1,0,0,1,0,0,0,,1,0,1
22432,Metta World Peace,37-039,F,12/22/16,LAL,@,MIA,L,0,3,0,1,0,0,0,,0,1,0,0,0,,0,0,0
22433,Metta World Peace,37-122,F,3/15/17,LAL,@,HOU,L,0,1,0,0,,0,0,,0,0,,0,0,,0,0,0
22434,Metta World Peace,37-029,F,12/12/16,LAL,@,SAC,L,0,2,0,0,,0,0,,0,0,,0,0,,0,0,0
22435,Metta World Peace,36-352,F,10/30/16,LAL,@,OKC,L,0,4,0,2,0,0,1,0,0,1,0,0,0,,0,0,0
22436,Metta World Peace,36-348,F,10/26/16,LAL,,HOU,W,0,2,0,0,,0,0,,0,0,,0,0,,0,0,0
22437,Metta World Peace,37-068,F,1/20/17,LAL,,IND,W,0,1,0,0,,0,0,,0,0,,0,0,,0,0,0
22438,Metta World Peace,37-019,F,12/2/16,LAL,@,TOR,L,0,6,0,1,0,0,0,,0,1,0,0,0,,1,0,1
22439,Metta World Peace,37-062,F,1/14/17,LAL,@,LAC,L,0,3,0,2,0,0,0,,0,2,0,0,0,,0,2,2
22440,Metta World Peace,37-058,F,1/10/17,LAL,,POR,L,0,3,0,1,0,0,1,0,0,0,,0,0,,0,0,0
22441,Metta World Peace,37-012,F,11/25/16,LAL,,GSW,L,0,3,0,0,,0,0,,0,0,,0,0,,0,0,0
22442,Metta World Peace,37-054,F,1/6/17,LAL,,MIA,W,0,2,0,1,0,0,0,,0,1,0,0,0,,0,0,0
22443,Brandan Wright,29-164,F-C,3/18/17,MEM,,SAS,W,0,6,0,0,,0,0,,0,0,,0,0,,0,0,0
22444,Delon Wright,24-329,G,3/21/17,TOR,,CHI,W,0,5,0,0,,0,0,,0,0,,0,0,,0,1,1
22445,Delon Wright,24-325,G,3/17/17,TOR,@,DET,W,0,6,0,4,0,0,4,0,0,0,,0,0,,0,0,0
22446,James Young,21-099,G-F,11/23/16,BOS,@,BRK,W,0,2,0,0,,0,0,,0,0,,0,0,,0,0,0
22447,James Young,21-079,G-F,11/3/16,BOS,@,CLE,L,0,2,0,0,,0,0,,0,0,,0,0,,0,0,0
22448,James Young,21-078,G-F,11/2/16,BOS,,CHI,W,0,1,0,0,,0,0,,0,0,,0,0,,0,1,1
22449,James Young,21-092,G-F,11/16/16,BOS,,DAL,W,0,7,0,1,0,0,0,,0,1,0,0,0,,0,0,0
22450,James Young,21-177,G-F,2/9/17,BOS,@,POR,W,0,5,0,1,0,0,1,0,0,0,,0,0,,0,0,0
22451,James Young,21-199,G-F,3/3/17,BOS,@,LAL,W,0,12,0,1,0,0,0,,0,1,0,0,0,,0,0,0
22452,James Young,21-195,G-F,2/27/17,BOS,,ATL,L,0,3,0,0,,0,0,,0,0,,0,0,,0,0,0
22453,James Young,21-090,G-F,11/14/16,BOS,@,NOP,L,0,6,0,0,,0,0,,0,0,,0,0,,0,0,0
22454,James Young,21-194,G-F,2/26/17,BOS,@,DET,W,0,6,0,2,0,0,0,,0,2,0,0,0,,0,0,0
22455,James Young,21-162,G-F,1/25/17,BOS,,HOU,W,0,3,0,1,0,0,0,,0,1,0,0,0,,0,0,0
22456,James Young,21-087,G-F,11/11/16,BOS,,NYK,W,0,3,0,1,0,0,0,,0,1,0,0,0,,0,2,2
22457,James Young,21-085,G-F,11/9/16,BOS,@,WAS,L,0,4,0,2,0,0,2,0,0,0,,0,0,,0,0,0
22458,James Young,21-108,G-F,12/2/16,BOS,,SAC,W,0,2,0,0,,0,0,,0,0,,0,0,,0,1,1
22459,James Young,21-082,G-F,11/6/16,BOS,,DEN,L,0,9,0,1,0,0,1,0,0,0,,0,0,,0,1,1
22460,Joe Young,24-121,G,10/26/16,IND,,DAL,W,0,3,0,0,,0,0,,0,0,,0,0,,0,0,0
22461,Joe Young,24-142,G,11/16/16,IND,,CLE,W,0,1,0,1,0,0,0,,0,1,0,0,0,,0,0,0
22462,Joe Young,24-188,G,1/1/17,IND,,ORL,W,0,3,0,0,,0,0,,0,0,,0,0,,0,0,0
22463,Joe Young,24-140,G,11/14/16,IND,,ORL,W,0,2,0,2,0,0,2,0,0,0,,0,0,,0,0,0
22464,Joe Young,24-173,G,12/17/16,IND,@,DET,W,0,3,0,1,0,0,0,,0,1,0,0,0,,0,0,0
22465,Joe Young,24-138,G,11/12/16,IND,,BOS,L,0,1,0,1,0,0,0,,0,1,0,0,0,,0,0,0
22466,Joe Young,24-222,G,2/4/17,IND,,DET,W,0,2,0,1,0,0,1,0,0,0,,0,0,,0,0,0
22467,Joe Young,24-216,G,1/29/17,IND,,HOU,W,0,3,0,1,0,0,0,,0,1,0,0,0,,0,0,0
22468,Joe Young,24-153,G,11/27/16,IND,,LAC,W,0,2,0,0,,0,0,,0,0,,0,0,,0,0,0
22469,Joe Young,24-129,G,11/3/16,IND,@,MIL,L,0,2,0,0,,0,0,,0,0,,0,0,,0,0,0
22470,Joe Young,24-261,G,3/15/17,IND,,CHO,W,0,2,0,0,,0,0,,0,0,,0,0,,0,0,0
22471,Joe Young,24-147,G,11/21/16,IND,,GSW,L,0,8,0,5,0,0,4,0,0,1,0,0,0,,1,3,4
22472,Joe Young,24-194,G,1/7/17,IND,,NYK,W,0,1,0,1,0,0,0,,0,1,0,0,0,,0,0,0
22473,Joe Young,24-243,G,2/25/17,IND,@,MIA,L,0,1,0,0,,0,0,,0,0,,0,0,,0,0,0
22474,Joe Young,24-192,G,1/5/17,IND,,BRK,W,0,2,0,3,0,0,1,0,0,2,0,0,0,,0,1,1
22475,Joe Young,24-242,G,2/24/17,IND,,MEM,W,0,2,0,1,0,0,1,0,0,0,,0,0,,0,0,0
22476,Nick Young,31-287,G-F,3/15/17,LAL,@,HOU,L,1,24,0,9,0,0,2,0,0,7,0,0,0,,0,3,3
22477,Nick Young,31-181,G-F,11/29/16,LAL,@,NOP,L,1,2,0,0,,0,0,,0,0,,0,0,,0,0,0
22478,Thaddeus Young,28-139,F,11/7/16,IND,@,CHO,L,1,16,0,4,0,0,4,0,0,0,,0,0,,0,5,5
22479,Cody Zeller,24-039,F-C,11/13/16,CHO,@,CLE,L,1,14,0,4,0,0,4,0,0,0,,0,0,,2,2,4
22480,Tyler Zeller,27-050,F-C,3/8/17,BOS,@,GSW,W,0,1,0,0,,0,0,,0,0,,0,0,,0,0,0
22481,Tyler Zeller,26-313,F-C,11/25/16,BOS,,SAS,L,0,2,0,0,,0,0,,0,0,,0,0,,0,0,0
22482,Tyler Zeller,26-336,F-C,12/18/16,BOS,@,MIA,W,0,4,0,2,0,0,1,0,0,1,0,0,0,,0,1,1
22483,Tyler Zeller,27-022,F-C,2/8/17,BOS,@,SAC,L,0,8,0,0,,0,0,,0,0,,0,0,,0,2,2
22484,Tyler Zeller,27-048,F-C,3/6/17,BOS,@,LAC,L,0,6,0,0,,0,0,,0,0,,0,0,,0,1,1
22485,Tyler Zeller,27-017,F-C,2/3/17,BOS,,LAL,W,0,4,0,2,0,0,2,0,0,0,,0,0,,0,3,3
22486,Tyler Zeller,27-047,F-C,3/5/17,BOS,@,PHO,L,0,6,0,1,0,0,1,0,0,0,,0,0,,1,4,5
22487,Tyler Zeller,26-327,F-C,12/9/16,BOS,,TOR,L,0,5,0,3,0,0,3,0,0,0,,0,0,,1,2,3
22488,Tyler Zeller,27-043,F-C,3/1/17,BOS,,CLE,W,0,5,0,1,0,0,1,0,0,0,,0,0,,0,0,0
22489,Tyler Zeller,26-325,F-C,12/7/16,BOS,@,ORL,W,0,7,0,1,0,0,1,0,0,0,,0,0,,0,1,1
22490,Tyler Zeller,26-321,F-C,12/3/16,BOS,@,PHI,W,0,4,0,0,,0,0,,0,0,,0,0,,0,0,0
22491,Tyler Zeller,27-040,F-C,2/26/17,BOS,@,DET,W,0,4,0,0,,0,0,,0,0,,0,0,,0,0,0
22492,Tyler Zeller,26-320,F-C,12/2/16,BOS,,SAC,W,0,4,0,1,0,0,1,0,0,0,,0,0,,1,0,1
22493,Tyler Zeller,26-302,F-C,11/14/16,BOS,@,NOP,L,0,5,0,2,0,0,2,0,0,0,,0,0,,0,0,0
22494,Tyler Zeller,26-345,F-C,12/27/16,BOS,,MEM,W,0,6,0,1,0,0,1,0,0,0,,0,0,,1,0,1
22495,Stephen Zimmerman,20-104,C,12/22/16,ORL,@,NYK,L,0,1,0,2,0,0,2,0,0,0,,0,0,,0,0,0
22496,Stephen Zimmerman,20-095,C,12/13/16,ORL,@,ATL,W,0,2,0,1,0,0,1,0,0,0,,0,0,,1,0,1
22497,Stephen Zimmerman,20-180,C,3/8/17,ORL,,CHI,W,0,13,0,3,0,0,3,0,0,0,,0,0,,0,0,0
22498,Stephen Zimmerman,20-177,C,3/5/17,ORL,@,WAS,L,0,5,0,1,0,0,1,0,0,0,,0,0,,0,1,1
22499,Stephen Zimmerman,20-159,C,2/15/17,ORL,,SAS,L,0,4,0,1,0,0,1,0,0,0,,0,0,,0,1,1
22500,Stephen Zimmerman,20-049,C,10/28/16,ORL,@,DET,L,0,8,0,1,0,0,1,0,0,0,,0,0,,2,2,4
22501,Stephen Zimmerman,20-108,C,12/26/16,ORL,,MEM,W,0,3,0,0,,0,0,,0,0,,0,0,,0,3,3
22502,Stephen Zimmerman,20-105,C,12/23/16,ORL,,LAL,W,0,3,0,1,0,0,1,0,0,0,,0,0,,0,1,1
22503,Stephen Zimmerman,20-183,C,3/11/17,ORL,,CLE,L,0,2,0,0,,0,0,,0,0,,0,0,,1,0,1
22504,Paul Zipser,22-289,G-F,12/3/16,CHI,@,DAL,L,0,4,0,1,0,0,1,0,0,0,,0,0,,0,0,0
22505,Paul Zipser,22-354,G-F,2/6/17,CHI,@,SAC,W,0,24,0,3,0,0,1,0,0,2,0,0,0,,1,1,2
22506,Paul Zipser,22-271,G-F,11/15/16,CHI,@,POR,W,0,4,0,3,0,0,2,0,0,1,0,0,0,,0,1,1
22507,Paul Zipser,22-263,G-F,11/7/16,CHI,,ORL,W,0,6,0,1,0,0,0,,0,1,0,0,0,,0,2,2
22508,Paul Zipser,22-261,G-F,11/5/16,CHI,@,IND,L,0,8,0,0,,0,0,,0,0,,0,0,,0,1,1
22509,Paul Zipser,22-256,G-F,10/31/16,CHI,@,BRK,W,0,4,0,1,0,0,1,0,0,0,,0,0,,1,1,2
22510,Paul Zipser,22-326,G-F,1/9/17,CHI,,OKC,L,0,8,0,3,0,0,3,0,0,0,,0,0,,0,1,1
22511,Paul Zipser,22-254,G-F,10/29/16,CHI,,IND,W,0,3,0,0,,0,0,,0,0,,0,0,,0,1,1
22512,Paul Zipser,22-311,G-F,12/25/16,CHI,@,SAS,L,0,2,0,0,,0,0,,0,0,,0,2,0,0,1,1
22513,Paul Zipser,22-305,G-F,12/19/16,CHI,,DET,W,0,7,0,3,0,0,3,0,0,0,,0,0,,1,0,1
22514,Paul Zipser,22-356,G-F,2/8/17,CHI,@,GSW,L,1,10,0,1,0,0,0,,0,1,0,0,0,,1,2,3
22515,Ivica Zubac,19-269,C,12/12/16,LAL,@,SAC,L,0,2,0,1,0,0,1,0,0,0,,0,0,,0,0,0
22516,Ivica Zubac,19-231,C,11/4/16,LAL,,GSW,W,0,1,0,0,,0,0,,0,0,,0,0,,0,0,0
22517,Ivica Zubac,19-277,C,12/20/16,LAL,@,CHO,L,0,3,0,1,0,0,1,0,0,0,,0,0,,0,1,1
22518,Ivica Zubac,19-333,C,2/14/17,LAL,,SAC,L,0,10,0,1,0,0,1,0,0,0,,0,0,,0,5,5